X,Y,GBCITY,GBPROV,CODE,NAME,ENAME,CLASSEN,CLASS,A1,A2,A3,A4,A5,A6,A7,A8,A9,A10,A11,A12,A13,A14,A15,A16,A17
117.035649387585821,32.619078721711595,3404,34,340402,ͨ,Datong,Qu,3,129039,66416,62623,36978,124894,63703,61191,30164,16107,14057,86974,44654,42320,11901,5655,6246,109401
117.006187051593685,32.666034319699065,3404,34,340403,,Tianjiaan,Qu,3,404713,208538,196175,115817,367830,184575,183255,73582,39135,34447,304597,155969,148628,26534,13434,13100,319495
116.844330003468741,32.595136423138356,3404,34,340404,лҼ,Xiejiaji,Qu,3,256873,131055,125818,73601,251900,127700,124200,52109,27609,24500,184651,93052,91599,20113,10394,9719,217633
116.803633491647744,32.660510131700541,3404,34,340405,˹ɽ,Bagongshan,Qu,3,166452,85469,80983,48751,164823,84076,80747,33228,17612,15616,120885,61499,59386,12339,6358,5981,138179
116.84414420363693,32.762707609673264,3404,34,340406,˼,Panji,Qu,3,400151,209727,190424,102408,397349,207413,189936,114235,61442,52793,260214,135077,125137,25702,13208,12494,362518
118.48393606182313,31.715902070736739,3405,34,340502,ׯ,Jinjiazhuang,Qu,3,86261,45063,41198,29293,83959,43130,40829,15431,8129,7302,64334,33669,30665,6496,3265,3231,59181
118.493629197826749,31.672482504394544,3405,34,340504,ɽ,Yushan,Qu,3,132943,68312,64631,44933,129538,65863,63675,23076,12108,10968,100808,51371,49437,9059,4833,4226,97886
118.586003312370181,31.661792779804813,3405,34,340505,ɽ,Xiangshan,Qu,3,168830,87052,81778,50202,162879,83262,79617,34287,18250,16037,122151,63070,59081,12392,5732,6660,131268
116.831034590320684,33.908444518733575,3406,34,340604,ɽ,Lieshan,Qu,3,147622,77398,70224,42029,137815,69926,67889,31950,17108,14842,108429,56767,51662,7243,3523,3720,127573
117.800736858120246,30.9284258378527,3407,34,340702,ͭɽ,Tongguanshan,Qu,3,246887,127268,119619,78046,230925,116761,114164,43548,22832,20716,188164,96593,91571,15175,7843,7332,194448
117.879944746949846,30.94012700324798,3407,34,340703,ʨɽ,Shizishan,Qu,3,51280,26867,24413,16579,50121,25984,24137,8367,4355,4012,40175,20995,19180,2738,1517,1221,43077
117.781834975558638,30.90502350706214,3407,34,340711,,Jiaoqu,Qu,3,64310,33995,30315,20350,62031,31976,30055,13104,6898,6206,46021,24247,21774,5185,2850,2335,50031
117.044749766798702,30.507151867962715,3408,34,340802,ӭ,Yingjiang,Qu,3,150221,74574,75647,47193,139025,68907,70118,25554,13336,12218,113516,55771,57745,11151,5467,5684,106594
118.302881401216183,29.710089808331539,3410,34,341002,Ϫ,Tunxi,Qu,3,155233,77206,78027,47856,142728,71135,71593,27254,13773,13481,116327,57944,58383,11652,5489,6163,118282
118.123876072909525,30.290872652278058,3410,34,341003,ɽ,Huangshan,Qu,3,159845,83820,76025,50914,154849,80625,74224,33318,16900,16418,112583,59924,52659,13944,6996,6948,143517
118.324849214133735,29.800886351350684,3410,34,341004,,Huizhou,Qu,3,91122,46978,44144,28507,89783,45990,43793,19752,10133,9619,64343,33849,30494,7027,2996,4031,82959
118.306977821536378,32.312138725104596,3411,34,341102,,Langya,Qu,3,246424,124512,121912,73849,230393,115648,114745,49958,26405,23553,180693,90518,90175,15773,7589,8184,178498
118.300650718159815,32.319067093153166,3411,34,341103,,Nanqiao,Qu,3,247311,126605,120706,73912,243906,124337,119569,64501,34119,30382,162278,82963,79315,20532,9523,11009,227121
115.81877025571923,32.894592932248059,3412,34,341202,,Yingzhou,Qu,3,582400,294749,287651,160266,551627,278080,273547,144975,77305,67670,398093,199939,198154,39332,17505,21827,525093
115.845471835500518,32.904060317474709,3412,34,341203,򣶫,Yingdong,Qu,3,547576,283322,264254,144181,539733,277201,262532,146326,78197,68129,358290,185276,173014,42960,19849,23111,515383
115.792931654752138,32.960407757697602,3412,34,341204,Ȫ,Yingquan,Qu,3,589081,300489,288592,160210,580579,294907,285672,157310,84466,72844,386242,195767,190475,45529,20256,25273,558893
116.986226169317518,33.631883403301529,3413,34,341302,,Yongqiao,Qu,3,1601181,819067,782114,436292,1568053,799803,768250,436112,234163,201949,1040267,527937,512330,124802,56967,67835,1437201
117.859155598880136,31.6077278660592,3414,34,341402,ӳ,Juchao,Qu,3,778864,396961,381903,225908,752321,380533,371788,180578,96660,83918,533142,270587,262555,65144,29714,35430,683009
116.494090653871027,31.757560407092516,3415,34,341502,,Jinan,Qu,3,745254,383576,361678,209501,723335,370363,352972,186861,101179,85682,505328,256264,249064,53065,26133,26932,682308
116.474744109400817,31.757120712900011,3415,34,341503,ԣ,Yuan,Qu,3,813783,424326,389457,228233,800867,415609,385258,213859,119718,94141,540227,275915,264312,59697,28693,31004,792879
115.773797035569117,33.876375763252959,3416,34,341602,۳,Qiaocheng,Qu,3,1351939,697126,654813,375566,1339865,689907,649958,354775,195479,159296,895669,457342,438327,101495,44305,57190,1291091
117.479377040357946,30.658272938111494,3417,34,341702,,Guichi,Qu,3,555489,280395,275094,162103,538695,270669,268026,137364,70916,66448,376081,190541,185540,42044,18938,23106,520891
118.753065647451081,30.94808326607199,3418,34,341802,,Xuanzhou,Qu,3,822707,428470,394237,240250,802052,413353,388699,177545,91684,85861,582612,306729,275883,62550,30057,32493,729574
117.037551524629762,30.507143313680899,3408,34,340803,,Daguan,Qu,3,167860,84790,83070,53589,153005,75781,77224,28060,14516,13544,127973,64497,63476,11827,5777,6050,119357
117.044534297444798,30.563733600979138,3408,34,340811,,Jiaoqu,Qu,3,264670,134520,130150,75639,255525,128593,126932,63598,32836,30762,183646,93871,89775,17426,7813,9613,211556
116.858510158481664,33.982550853117203,3406,34,340602,ż,Duji,Qu,3,293910,152171,141739,76841,270636,137387,133249,69227,37075,32152,205994,106059,99935,18689,9037,9652,277409
116.772486483861471,33.977357735685054,3406,34,340603,ɽ,Xiangshan,Qu,3,299663,152875,146788,83180,265469,132902,132567,60411,32141,28270,224715,113541,111174,14537,7193,7344,242271
118.502785301832191,31.702716055412129,3405,34,340503,ɽ,Huashan,Qu,3,179542,92567,86975,56565,167034,83782,83252,28505,14721,13784,139756,71902,67854,11281,5944,5337,143856
117.356779899924391,32.938100173717643,3403,34,340303,,Zhongshi,Qu,3,118178,58910,59268,37519,113049,55285,57764,19330,9967,9363,86250,43150,43100,12598,5793,6805,88883
117.36540687302859,32.950211076525534,3403,34,340302,,Dongshi,Qu,3,242240,125137,117103,70997,212267,106102,106165,36739,19106,17633,187137,97156,89981,18364,8875,9489,180764
117.294864535510598,32.936043478398943,3403,34,340304,,Xishi,Qu,3,226322,113712,112610,70011,213406,106391,107015,37899,19486,18413,171165,85841,85324,17258,8385,8873,158466
117.350545082708862,32.970783760912646,3403,34,340311,,Jiaoqu,Qu,3,222659,115685,106974,60119,219670,113616,106054,57958,31122,26836,147914,76801,71113,16787,7762,9025,195135
118.356248218513585,31.329935598404735,3402,34,340204,,Xinwu,Qu,3,232347,120176,112171,70515,205119,102430,102689,33908,17491,16417,179163,93145,86018,19276,9540,9736,161088
117.291866562371581,31.871635236198287,3401,34,340102,,Dongshi,Qu,3,249125,127260,121865,84248,235457,118406,117051,39163,20693,18470,187399,95216,92183,22563,11351,11212,168393
117.285167654882045,31.872497688913725,3401,34,340103,,Zhongshi,Qu,3,243430,124573,118857,79461,224137,111786,112351,37220,19721,17499,186262,95083,91179,19948,9769,10179,165281
117.253502187262001,31.850420957599546,3401,34,340104,,Xishi,Qu,3,387009,208577,178432,104461,289632,144621,145011,47979,25249,22730,314440,170524,143916,24590,12804,11786,287402
117.271107110919843,31.888091449532489,3401,34,340111,,Jiaoqu,Qu,3,779511,419339,360172,227714,671090,349876,321214,144391,78918,65473,596509,321698,274811,38611,18723,19888,461770
116.333503723144531,34.425952911376953,3413,34,341321,ɽ,Dangshan,County,3,862356,438757,423599,227322,852380,433007,419373,251137,136416,114721,541530,272200,269330,69689,30141,39548,844703
116.933830261230469,34.187709808349609,3413,34,341322,,Xiaoxian,County,3,1196377,613516,582861,322173,1180669,603354,577315,342796,186298,156498,753621,382429,371192,99960,44789,55171,1173111
116.753561233998042,33.915729187739416,3406,34,340621,Ϫ,Suixi,County,3,1136969,586004,550965,301647,1128522,581147,547375,321690,178397,143293,724745,366355,358390,90534,41252,49282,1109079
117.552772521972656,33.541908264160156,3413,34,341323,,Lingbi,County,3,1051325,538524,512801,261686,1040307,531323,508984,310810,165893,144917,654478,333116,321362,86037,39515,46522,1025741
116.207382202148438,33.515228271484375,3416,34,341621,,Guoyang,County,3,1293192,671530,621662,341817,1287768,667666,620102,347835,191989,155846,846819,434649,412170,98538,44892,53646,1269901
117.883697509765625,33.476448059082031,3413,34,341324,,Sixian,County,3,805184,408835,396349,210783,797060,403567,393493,219276,113821,105455,520153,265101,255052,65755,29913,35842,785621
117.313629150390625,33.315540313720703,3403,34,340323,,Guzhen,County,3,595513,307008,288505,150422,582417,299591,282826,167228,89483,77745,379209,194233,184976,49076,23292,25784,572713
116.546112060546875,33.2657470703125,3416,34,341622,ɳ,Mengcheng,County,3,1106749,577814,528935,284154,1100719,573987,526732,308472,173299,135173,714476,365718,348758,83801,38797,45004,1078174
115.612815856933594,33.160621643066406,3412,34,341222,̫,Taihe,County,3,1371482,708352,663130,384267,1365174,703720,661454,377531,211340,166191,882490,447389,435101,111461,49623,61838,1347884
117.89312744140625,33.135883331298828,3403,34,340322,,Wuhe,County,3,648856,335592,313264,168233,644462,332555,311907,182246,98817,83429,413108,211660,201448,53502,25115,28387,632751
116.202049255371094,33.145614624023438,3416,34,341623,,Lixin,County,3,1327028,701702,625326,329208,1325623,700540,625083,358313,203099,155214,867963,450789,417174,100752,47814,52938,1307465
115.253158569335938,33.069385528564453,3412,34,341221,Ȫ,Linquan,County,3,1690872,865299,825573,432001,1685864,862184,823680,502787,274657,228130,1074328,542718,531610,113757,47924,65833,1672497
117.198371887207031,32.958576202392578,3403,34,340321,Զ,Huaiyuan,County,3,1234561,649422,585139,300426,1223841,641978,581863,359089,195396,163693,783506,408915,374591,91966,45111,46855,1201573
117.5606689453125,32.865882873535156,3411,34,341126,,Fengyang,County,3,683049,356744,326305,172873,673028,349870,323158,189594,102571,87023,441850,229473,212377,51605,24700,26905,654775
116.713348388671875,32.694984436035156,3404,34,340421,̨,Fengtai,County,3,683421,363436,319985,176935,676559,358053,318506,188342,105561,82781,443053,231515,211538,52026,26360,25666,635568
118.997184753417969,32.696300506591797,3411,34,341181,쳤,Tianchang,City,3,590745,297550,293195,164368,583878,293472,290406,134579,70617,63962,405736,205276,200460,50430,21657,28773,543669
115.583526611328125,32.631965637207031,3412,34,341225,,Funan,County,3,1272431,658889,613542,330239,1269303,656468,612835,379461,210346,169115,803679,408888,394791,89291,39655,49636,1257727
116.259254455566406,32.635677337646484,3412,34,341226,,Yingshang,County,3,1309243,685953,623290,346925,1302618,681045,621573,363816,201769,162047,839565,431059,408506,105862,53125,52737,1290202
116.770370483398438,32.578639984130859,3415,34,341521,,Shouxian,County,3,1112569,579646,532923,301575,1103580,573345,530235,281116,150845,130271,739946,382473,357473,91507,46328,45179,1077435
117.672798156738281,32.525428771972656,3411,34,341125,Զ,Dingyuan,County,3,801966,418365,383601,212774,798795,416055,382740,242510,132953,109557,497271,255504,241767,62185,29908,32277,789235
117.1536865234375,32.482257843017578,3401,34,340121,,Changfeng,County,3,894204,465022,429182,230237,886773,459764,427009,254830,136080,118750,569707,295136,274571,69667,33806,35861,869197
118.428794860839844,32.453353881835938,3411,34,341122,,Laian,County,3,449188,228047,221141,126361,445645,225659,219986,118775,62569,56206,296300,150072,146228,34113,15406,18707,429677
116.268394470214844,32.334701538085938,3415,34,341522,,Huoqiu,County,3,1461066,763088,697978,399845,1443042,752253,690789,375934,203726,172208,985539,509557,475982,99593,49805,49788,1443016
118.259559631347656,32.097381591796875,3411,34,341124,ȫ,Quanjiao,County,3,413220,211515,201705,123034,407961,208244,199717,109664,59999,49665,269027,135906,133121,34529,15610,18919,388011
117.454933166503906,31.887754440307617,3401,34,340122,ʶ,Feidong,County,3,1006886,524429,482457,268323,994907,516570,478337,261691,146553,115138,665062,341280,323782,80133,36596,43537,950268
118.103965759277344,31.715297698974609,3414,34,341423,ɽ,Hanshan,County,3,405070,207612,197458,115034,400453,204205,196248,105319,57415,47904,267315,135554,131761,32436,14643,17793,396141
117.150054931640625,31.715974807739258,3401,34,340123,,Feixi,County,3,907219,476334,430885,239631,888757,463922,424835,217051,118233,98818,627681,327927,299754,62487,30174,32313,859088
118.361122131347656,31.712297439575195,3414,34,341424,,Hexian,County,3,591560,306176,285384,172423,584169,301324,282845,146737,83232,63505,390146,198735,191411,54677,24209,30468,559584
115.873565673828125,31.690950393676758,3415,34,341524,կ,Jinzhai,County,3,582067,305306,276761,166950,570867,297781,273086,136996,75857,61139,409296,211196,198100,35775,18253,17522,567723
118.466094970703125,31.542194366455078,3405,34,340521,Ϳ,Dangtu,County,3,629340,324639,304701,179510,623648,320585,303063,159589,86766,72823,418830,214794,204036,50921,23079,27842,603366
116.929862976074219,31.45933723449707,3415,34,341523,,Shucheng,County,3,906984,465691,441293,255408,894547,457296,437251,224770,120807,103963,613952,313097,300855,68262,31787,36475,872331
116.322044372558594,31.411638259887695,3415,34,341525,ɽ,Huoshan,County,3,332930,171158,161772,98950,325548,166563,158985,80215,43103,37112,225919,114990,110929,26796,13065,13731,318781
117.909385681152344,31.293697357177734,3414,34,341422,Ϊ,Wuwei,County,3,1252081,647888,604193,338952,1240688,640125,600563,322346,175205,147141,839547,431582,407965,90188,41101,49087,1210286
117.28546142578125,31.24372673034668,3414,34,341421,®,Lujiang,County,3,1145874,600162,545712,298547,1113534,572143,541391,276716,146685,130031,793486,417601,375885,75672,35876,39796,1093806
118.556198120117188,31.143373489379883,3402,34,340221,ߺ,Wuhu,County,3,497564,260016,237548,144212,490525,254295,236230,117644,63740,53904,343980,180315,163665,35940,15961,19979,473419
119.175689697265625,31.126441955566406,3418,34,341821,Ϫ,Langxi,County,3,316592,165884,150708,93758,311519,161736,149783,71177,36924,34253,221972,117154,104818,23443,11806,11637,300486
118.191383361816406,31.074180603027344,3402,34,340222,,Fanchang,County,3,430530,223357,207173,128846,422712,218731,203981,104305,56038,48267,295626,152894,142732,30599,14425,16174,416529
116.938606262207031,31.048425674438477,3408,34,340881,ͩ,Tongcheng,City,3,660772,321098,339674,190077,635837,304648,331189,174172,90596,83576,435530,206908,228622,51070,23594,27476,629173
117.778823852539062,30.954809188842773,3407,34,340721,ͭ,Tongling,County,3,322239,166420,155819,95742,316658,162296,154362,74048,38388,35660,224677,117222,107455,23514,10810,12704,310322
118.326622009277344,30.918655395507812,3402,34,340223,,Nanling,County,3,490130,253156,236974,144946,483499,248935,234564,115101,60230,54871,338418,175488,162930,36611,17438,19173,471081
119.419227600097656,30.895648956298828,3418,34,341822,,Guangde,County,3,485757,254626,231131,138809,471053,246230,224823,99747,50975,48772,350008,185562,164446,36002,18089,17913,472222
116.358184814453125,30.857160568237305,3408,34,340828,,Yuexi,County,3,361632,186393,175239,100316,351380,179771,171609,94730,49459,45271,241267,124197,117070,25635,12737,12898,350864
117.200950622558594,30.694673538208008,3408,34,340823,,Zongyang,County,3,757951,373410,384541,225796,752774,369742,383032,225027,118968,106059,475692,228295,247397,57232,26147,31085,727608
118.395027160644531,30.686710357666016,3418,34,341823,,Jingxian,County,3,333586,176388,157198,105594,328947,173423,155524,65126,33236,31890,238108,128010,110098,30352,15142,15210,309160
117.845710754394531,30.648202896118164,3417,34,341723,,Qingyang,County,3,253280,130621,122659,78981,247175,126874,120301,52284,26641,25643,178924,93310,85614,22072,10670,11402,237472
116.565277099609375,30.637092590332031,3408,34,340824,Ǳɽ,Qianshan,County,3,515261,260308,254953,143098,500440,250510,249930,135955,71015,64940,341464,171342,170122,37842,17951,19891,498434
119.005485534667969,30.634422302246094,3418,34,341881,,Ningguo,City,3,381842,199915,181927,111831,372191,194076,178115,73874,37522,36352,278142,147971,130171,29826,14422,15404,348776
116.266044616699219,30.428731918334961,3408,34,340825,̫,Taihu,County,3,498882,254184,244698,136574,482869,242873,239996,140435,74314,66121,317906,160418,157488,40541,19452,21089,491504
116.82342529296875,30.715436935424805,3408,34,340822,,Huaining,County,3,673677,336292,337385,186626,658156,325615,332541,189763,101293,88470,431297,211307,219990,52617,23692,28925,649713
118.540695190429688,30.28620719909668,3418,34,341825,캵,Jingde,County,3,142064,74126,67938,41280,140058,72996,67062,28941,14821,14120,101003,53367,47636,12120,5938,6182,133632
117.469589233398438,30.213550567626953,3417,34,341722,ʯ̨,Shitai,County,3,105506,54924,50582,30630,103864,53862,50002,23276,11913,11363,73464,38882,34582,8766,4129,4637,101644
116.111305236816406,30.154102325439453,3408,34,340826,,Susong,County,3,649975,336065,313910,184791,629674,319573,310101,201953,112232,89721,399729,201292,198437,48293,22541,25752,629726
116.681076049804688,30.129318237304688,3408,34,340827,,Wangjiang,County,3,479099,233037,246062,140948,469782,226399,243383,142552,74972,67580,300175,142001,158174,36372,16064,20308,465008
117.017677307128906,30.097610473632812,3417,34,341721,,Dongzhi,County,3,475194,239137,236057,136138,463356,231885,231471,117124,60144,56980,321920,162868,159052,36150,16125,20025,449075
118.589889526367188,30.067173004150391,3418,34,341824,Ϫ,Jixi,County,3,177091,91409,85682,53488,174785,89904,84881,32694,16841,15853,128932,67520,61412,15465,7048,8417,169826
117.923469543457031,29.924446105957031,3410,34,341023,,Yixian,County,3,93919,48072,45847,29052,92293,46982,45311,19286,9847,9439,66171,34520,31651,8462,3705,4757,88500
118.433944702148438,29.86384391784668,3410,34,341021,,Shexian,County,3,454593,230647,223946,143800,443598,224290,219308,105225,54422,50803,306870,158252,148618,42498,17973,24525,432119
117.713722229003906,29.859928131103516,3410,34,341024,,Qimen,County,3,173405,88659,84746,54197,170507,86584,83923,39377,20326,19051,119561,61606,57955,14467,6727,7740,163259
118.17095947265625,29.779264450073242,3410,34,341022,,Xiuning,County,3,242260,123149,119111,75482,239836,121558,118278,54542,27958,26584,165532,85191,80341,22186,10000,12186,228913
118.378238127297692,31.329016853009463,3402,34,340202,,Jinghu,Qu,3,180382,90175,90207,56119,165077,82076,83001,26821,13831,12990,136580,68260,68320,16981,8084,8897,115968
118.376084171918563,31.349376822923258,3402,34,340207,𯽭,Jiujiang,Qu,3,164440,87909,76531,48552,144023,72729,71294,27676,14445,13231,124933,68226,56707,11831,5238,6593,139606
115.346870422363281,33.258968353271484,3412,34,341282,,Jieshou,City,3,640878,327384,313494,188680,637019,324989,312030,171564,96083,75481,419621,209792,209829,49693,21509,28184,622064
117.985786437988281,32.780071258544922,3411,34,341182,,Mingguang,City,3,569585,290126,279459,159150,565538,287281,278257,141473,73093,68380,382524,195890,186634,45588,21143,24445,553198
118.383901833758301,31.312031592891529,3402,34,340203,,Matang,Qu,3,120028,61300,58728,38755,118234,59972,58262,21533,11417,10116,89003,45463,43540,9492,4420,5072,78954
115.988822937011719,40.465835571289062,1102,11,110229,,Yanqing,County,3,275433,142031,133402,89104,265100,134175,130925,55518,28575,26943,196030,100680,95350,23885,12776,11109,240509
116.845588684082031,40.377464294433594,1102,11,110228,,Miyun,County,3,420019,210890,209129,135062,407628,203728,203900,79745,41130,38615,304754,152531,152223,35520,17229,18291,360376
116.6435546875,40.300975799560547,1102,11,110227,,Huairou,County,3,296002,152357,143645,95267,278700,140436,138264,51850,26475,25375,219995,113766,106229,24157,12116,12041,219636
116.223678588867188,40.222099304199219,1101,11,110114,ƽ,Changping,Qu,3,614821,328384,286437,171034,495923,248876,247047,79548,41343,38205,493865,267285,226580,41408,19756,21652,379283
117.1104736328125,40.150508880615234,1102,11,110226,ƽ,Pinggu,County,3,396701,197646,199055,113163,385248,192303,192945,88107,46887,41220,274004,134667,139337,34590,16092,18498,355166
116.655975341796875,40.120716094970703,1101,11,110113,˳,Shunyi,Qu,3,636479,325122,311357,179649,585370,291280,294090,119002,61765,57237,468012,241263,226749,49465,22094,27371,463237
116.300819396972656,39.983272552490234,1101,11,110108,,Haidian,Qu,3,2240124,1195796,1044328,614648,1708315,840269,868046,236081,123406,112675,1841908,992621,849287,162135,79769,82366,1277022
116.092666625976562,39.935695648193359,1101,11,110109,ͷ,Mentougou,Qu,3,266591,138307,128284,86818,256102,129361,126741,40647,21029,19618,201403,105172,96231,24541,12106,12435,182707
116.16204833984375,39.906204223632812,1101,11,110107,ʯɽ,Shijingshan,Qu,3,489439,260316,229123,153046,429593,216457,213136,59204,30871,28333,392526,210572,181954,37709,18873,18836,275533
116.444625854492188,39.914554595947266,1101,11,110105,,Chaoyang,Qu,3,2289756,1216155,1073601,712624,1979644,993548,986096,249526,130661,118865,1857733,992634,865099,182497,92860,89637,1230987
116.658805847167969,39.905921936035156,1101,11,110112,ͨ,Tongzhou,Qu,3,673952,339349,334603,205049,630961,311721,319240,113314,58434,54880,505665,255312,250353,54973,25603,29370,503193
116.283988952636719,39.849449157714844,1101,11,110106,̨,Fengtai,Qu,3,1369480,719896,649584,431537,1215762,607640,608122,164536,85802,78734,1095694,579933,515761,109250,54161,55089,655088
116.336898803710938,39.722496032714844,1102,11,110224,,Daxing,County,3,671444,350691,320753,180621,602419,301974,300445,121249,62861,58388,504221,265555,238666,45974,22275,23699,489275
115.988372802734375,39.700729370117188,1101,11,110111,ɽ,Fangshan,Qu,3,814367,422230,392137,236802,753256,375799,377457,149399,77659,71740,609967,317591,292376,55001,26980,28021,671197
116.354469299316406,39.923740386962891,1101,11,110102,,Xicheng,Qu,3,706691,360472,346219,230554,630535,305665,324870,77320,40140,37180,541655,278982,262673,87716,41350,46366,488039
116.406417846679688,39.928936004638672,1101,11,110101,,Dongcheng,Qu,3,535558,269492,266066,169723,489295,235784,253511,60348,31068,29280,409521,208316,201205,65689,30108,35581,383762
116.356544494628906,39.883224487304688,1101,11,110104,,Xuanwu,Qu,3,526132,272000,254132,173619,480961,235666,245295,57474,29522,27952,404251,211970,192281,64407,30508,33899,370015
116.411605834960938,39.886341094970703,1101,11,110103,,Chongwen,Qu,3,346205,173384,172821,118524,328133,160988,167145,40900,21248,19652,261358,131818,129540,43947,20318,23629,242662
106.427177429199219,29.833593368530273,5001,50,500109,,Beibei,Qu,3,646577,331829,314748,198989,588368,295982,292386,97357,49498,47859,491275,255124,236151,57945,27207,30738,579057
106.4722900390625,29.47404670715332,5001,50,500104,ɿ,Dadukou,Qu,3,247021,126831,120190,76017,229523,114039,115484,35227,18020,17207,188985,98176,90809,22809,10635,12174,189143
106.911125183105469,28.958202362060547,5001,50,500110,ʢ,Wansheng,Qu,3,265743,134695,131048,76797,263070,132410,130660,56616,28882,27734,188804,95954,92850,20323,9859,10464,242596
106.57958984375,29.545766830444336,5001,50,500108,ϰ,Nanan,Qu,3,592566,309695,282871,172518,495636,246411,249225,72709,37110,35599,472382,251417,220965,47475,21168,26307,414803
106.505622863769531,29.526088714599609,5001,50,500107,,Jiulongpo,Qu,3,878777,460901,417876,283704,784459,395940,388519,121248,62048,59200,691869,366904,324965,65660,31949,33711,622613
108.423268062294866,30.815738123014732,5001,50,500101,,Wanzhou,Qu,3,1648870,846050,802820,496424,1602126,818411,783715,333428,173339,160089,1189755,612069,577686,125687,60642,65045,1502636
107.390510388637082,29.704920326105832,5001,50,500102,,Fuling,Qu,3,1134080,583474,550606,333084,1095579,560509,535070,226633,117532,109101,817429,423046,394383,90018,42896,47122,987230
106.546446790859719,29.574791609262942,5001,50,500105,,Jiangbei,Qu,3,609619,318532,291087,193275,547901,275549,272352,74010,37982,36028,481169,255507,225662,54440,25043,29397,433510
106.449871515210575,29.567893375288008,5001,50,500106,ɳƺ,Shapingba,Qu,3,789359,409216,380143,236143,662100,330342,331758,101068,51536,49532,623621,328239,295382,64670,29441,35229,605048
105.755219353934109,29.496151741948633,5001,50,500111,˫,Shuangqiao,Qu,3,42033,21631,20402,13282,40818,20768,20050,9449,5096,4353,29949,15203,14746,2635,1332,1303,37523
106.621637541186544,29.72655275671163,5001,50,500112,山,Yubei,Qu,3,843482,438255,405227,273504,817197,418020,399177,152073,78128,73945,624354,328247,296107,67055,31880,35175,704655
106.526441912332373,29.379571587772155,5001,50,500113,,Banan,Qu,3,886447,459755,426692,281809,864659,445276,419383,148996,75674,73322,659537,346364,313173,77914,37717,40197,803467
108.787074090587367,29.534677823896956,5001,50,500114,ǭ,Qianjiang,Qu,3,442385,230537,211848,135333,435206,226040,209166,122202,66759,55443,290041,147949,142092,30142,15829,14313,415896
107.077783266190934,29.824243863936019,5002,50,500221,,Changshou,County,3,874307,446313,427994,274117,865100,439350,425750,174252,90539,83713,628027,321731,306296,72028,34043,37985,827594
106.630087881217335,29.019219959060536,5002,50,500222,뽭,Qijiang,County,3,962813,497701,465112,277354,951391,489933,461458,208085,106883,101202,676627,353529,323098,78101,37289,40812,910599
105.832652033714268,30.191229911402825,5002,50,500223,,Tongnan,County,3,860016,448491,411525,237629,858573,447608,410965,233929,130200,103729,562711,287794,274917,63376,30497,32879,834578
106.051326050719879,29.85252662323327,5002,50,500224,ͭ,Tongliang,County,3,794104,409757,384347,239498,790282,407033,383249,165916,88572,77344,561430,289445,271985,66758,31740,35018,763993
105.711932939152845,29.710423003349511,5002,50,500225,,Dazu,County,3,905409,477300,428109,246841,897585,471809,425776,221961,125982,95979,614815,318373,296442,68633,32945,35688,877463
105.578797023436508,29.4137989424271,5002,50,500226,ٲ,Rongchang,County,3,659556,336839,322717,214580,651574,331221,320353,157031,82977,74054,443467,225998,217469,59058,27864,31194,615422
106.217573489515942,29.599361436352982,5002,50,500227,ɽ,Bishan,County,3,608473,313089,295384,192007,599816,307607,292209,122617,63471,59146,432415,223810,208605,53441,25808,27633,559912
107.815684320079555,30.689925829057142,5002,50,500228,ƽ,Liangping,County,3,850064,443147,406917,250203,840034,435943,404091,202543,110088,92455,586886,303490,283396,60635,29569,31066,815346
108.719352970796663,31.95299246986864,5002,50,500229,ǿ,Chengkou,County,3,225841,122134,103707,60918,224628,121187,103441,56443,29722,26721,156188,85035,71153,13210,7377,5833,217705
107.724455175760966,29.846616725620784,5002,50,500230,ᶼ,Fengdu,County,3,774054,403318,370736,230408,772278,402014,370264,169274,88441,80833,539388,283923,255465,65392,30954,34438,742938
107.351950541114235,30.342427292569585,5002,50,500231,潭,Dianjiang,County,3,862323,449119,413204,242362,852817,441887,410930,209249,114034,95215,589650,304262,285388,63424,30823,32601,838280
107.737389364463979,29.314590430303561,5002,50,500232,¡,Wulong,County,3,397697,212977,184720,109677,349677,181799,167878,83259,42966,40293,284391,154999,129392,30047,15012,15035,379727
108.026252912164594,30.299313330226212,5002,50,500233,,Zhongxian,County,3,954075,490111,463964,285090,941119,481422,459697,216828,113428,103400,654833,336915,317918,82414,39768,42646,921154
108.453081139363974,31.197808305462122,5002,50,500234,,Kai,County,3,1408116,736646,671470,417725,1403523,733585,669938,392966,214717,178249,917692,472954,444738,97458,48975,48483,1362407
108.724699102127204,30.955507837092355,5002,50,500235,,Yunyang,County,3,1219647,638673,580974,329428,1214667,635137,579530,342133,182593,159540,795132,415098,380034,82382,40982,41400,1171324
109.583284344701127,31.062758129817738,5002,50,500236,,Fengjie,County,3,871743,453447,418296,267289,863716,448372,415344,270072,143761,126311,540333,277605,262728,61338,32081,29257,821757
109.935977251371853,31.093165545179268,5002,50,500237,ɽ,Wushan,County,3,571959,302177,269782,158632,567387,298964,268423,152235,81082,71153,379615,200133,179482,40109,20962,19147,548826
109.677155512632112,31.412139884180476,5002,50,500238,Ϫ,Wuxi,County,3,483759,254777,228982,133840,427151,219099,208052,128409,66472,61937,321741,170113,151628,33609,18192,15417,468049
108.094976568139927,30.010418740472726,5002,50,500240,ʯ,Shizhutujiazuzhzhixian,County,3,484876,248402,236474,149932,476889,243386,233503,127326,66347,60979,321241,164388,156853,36309,17667,18642,470642
108.995058137190028,28.448658568546392,5002,50,500241,ɽ,Xiushantujiazumiaozuzhzhixi,County,3,507522,264950,242572,144207,506300,264188,242112,164771,87998,76773,300818,155665,145153,41933,21287,20646,485718
108.767140486658036,28.852067291400864,5002,50,500242,,Youyangtujiazumiaozuzhzhixi,County,3,594287,312786,281501,189844,591512,310918,280594,183904,101360,82544,357017,184082,172935,53366,27344,26022,569108
108.180204248900239,29.275101489914036,5002,50,500243,ˮ,Pengshuimiaozutujiazuzhzhix,County,3,590228,313113,277115,171183,588677,311963,276714,166154,92771,73383,383872,199839,184033,40202,20503,19699,564545
106.24541346027155,29.286498383555795,5003,50,500381,,Jiangjin,City,3,1322890,686106,636784,422399,1277638,660657,616981,267296,137517,129779,923924,481780,442144,131670,66809,64861,1234080
106.262659045208878,30.0052943637445,5003,50,500382,ϴ,Hechuan,City,3,1420520,732503,688017,430576,1407004,723747,683257,295066,155577,139489,1003075,518708,484367,122379,58218,64161,1337197
105.885847410078597,29.359887758378434,5003,50,500383,,Yongchuan,City,3,984730,507848,476882,314659,951549,485798,465751,198804,104966,93838,700476,361220,339256,85450,41662,43788,888890
107.086829945115568,29.152940739130244,5003,50,500384,ϴ,Nanchuan,City,3,631853,326307,305546,175870,619751,318034,301717,127957,66078,61879,458238,238103,220135,45658,22126,23532,596770
106.554411289741481,29.563357327080432,5001,50,500103,,Yuzhong,Qu,3,664942,341997,322945,204411,566371,276706,289665,73373,37383,35990,521340,273907,247433,70229,30707,39522,401394
118.081208880265081,24.454976332513727,3502,35,350203,˼,Siming,Qu,3,136579,70516,66063,34715,97937,47772,50165,14566,7594,6972,111693,58584,53109,10320,4338,5982,82936
118.100868553218305,24.477138023901141,3502,35,350204,Ԫ,Kaiyuan,Qu,3,527037,277167,249870,161389,416232,207427,208805,65616,34943,30673,436085,230591,205494,25336,11633,13703,231024
119.290576930564157,26.093943840554868,3501,35,350102,¥,Gulou,Qu,3,559858,284814,275044,152505,455247,223560,231687,69668,36883,32785,449207,228111,221096,40983,19820,21163,283984
119.294057565524071,26.063980113508599,3501,35,350103,̨,Taijiang,Qu,3,368400,187706,180694,107900,328675,162762,165913,51610,27211,24399,283668,145094,138574,33122,15401,17721,193709
119.316152030921828,26.038102349241363,3501,35,350104,ɽ,Cangshan,Qu,3,482039,244768,237271,111321,367055,182755,184300,65464,34570,30894,383641,195368,188273,32934,14830,18104,301851
119.326593935801583,26.074573350343137,3501,35,350111,,Jinan,Qu,3,510611,266406,244205,143732,411654,208709,202945,63994,34175,29819,417621,218370,199251,28996,13861,15135,212889
118.533432006835938,27.921215057373047,3507,35,350722,ֳ,Pucheng,County,3,321272,166806,154466,100709,316856,163923,152933,65985,34754,31231,224022,115968,108054,31265,16084,15181,296029
117.329093933105469,27.544401168823242,3507,35,350723,,Guangze,County,3,142214,74467,67747,40516,139106,72199,66907,35025,18431,16594,97461,51068,46393,9728,4968,4760,128272
118.777336120605469,27.526847839355469,3507,35,350724,Ϫ,Songxi,County,3,142453,74654,67799,41152,141368,73910,67458,36328,19158,17170,95632,49968,45664,10493,5528,4965,128690
119.501075744628906,27.4603271484375,3509,35,350924,,Shouning,County,3,230571,122473,108098,56210,227338,120231,107107,66263,35837,30426,146457,76642,69815,17851,9994,7857,219258
118.8494873046875,27.365158081054688,3507,35,350725,,Zhenghe,County,3,193169,103879,89290,47594,189350,100787,88563,55940,31402,24538,124858,65433,59425,12371,7044,5327,179910
119.893516540527344,27.237302780151367,3509,35,350926,,Zherong,County,3,92434,49800,42634,24616,91145,48915,42230,23112,12128,10984,61409,32966,28443,7913,4706,3207,79814
119.335563659667969,27.106180191040039,3509,35,350925,,Zhouning,County,3,168887,89422,79465,40043,166459,87917,78542,46676,25609,21067,108707,56029,52678,13504,7784,5720,155345
118.982902526855469,26.909835815429688,3509,35,350923,,Pingnan,County,3,168482,89937,78545,42584,165163,87967,77196,44795,24196,20599,111386,58988,52398,12301,6753,5548,152317
117.163619995117188,26.897195816040039,3504,35,350429,̩,Taining,County,3,114187,59521,54666,31150,111351,57592,53759,27640,14748,12892,78984,41108,37876,7563,3665,3898,104312
119.994354248046875,26.884050369262695,3509,35,350921,ϼ,Xiapu,County,3,456474,246379,210095,122076,446823,239860,206963,109876,59321,50555,309481,167107,142374,37117,19951,17166,413396
116.839698791503906,26.82890510559082,3504,35,350430,,Jianning,County,3,133918,68657,65261,37541,131132,66729,64403,33337,17402,15935,91960,47111,44849,8621,4144,4477,121439
117.795845031738281,26.78917121887207,3507,35,350721,˳,Shunchang,County,3,231599,120682,110917,67767,227483,117639,109844,52185,27230,24955,162382,84638,77744,17032,8814,8218,200452
117.460174560546875,26.729646682739258,3504,35,350428,,Jiangle,County,3,158491,83271,75220,41885,153206,79384,73822,38080,20494,17586,109607,57431,52176,10804,5346,5458,134051
118.740951538085938,26.578418731689453,3509,35,350922,,Gutian,County,3,398990,212753,186237,103039,385678,203763,181915,92053,49629,42424,277237,147566,129671,29700,15558,14142,364009
119.546630859375,26.486408233642578,3501,35,350123,Դ,Luoyuan,County,3,232351,123963,108388,63474,222635,117034,105601,56261,29749,26512,157566,84646,72920,18524,9568,8956,200390
117.784164428710938,26.395797729492188,3504,35,350427,ɳ,Shaxian,County,3,228548,120889,107659,64928,219151,115079,104072,49292,26919,22373,161777,85178,76599,17479,8792,8687,194826
117.2003173828125,26.355621337890625,3504,35,350421,Ϫ,Mingxi,County,3,109102,56641,52461,29704,107214,55217,51997,26074,13652,12422,75244,39303,35941,7784,3686,4098,94419
116.653022766113281,26.262119293212891,3504,35,350424,,Ninghua,County,3,298434,152586,145848,81331,295529,150656,144873,81170,44363,36807,194576,97545,97031,22688,10678,12010,276849
118.861488342285156,26.213560104370117,3501,35,350124,,Minqing,County,3,288598,152287,136311,75908,275611,143801,131810,65171,36421,28750,201521,104638,96883,21906,11228,10678,254143
119.537261962890625,26.195575714111328,3501,35,350122,,Lianjiang,County,3,599962,310781,289181,154655,581624,297387,284237,133223,73403,59820,423150,217813,205337,43589,19565,24024,542279
118.185127258300781,26.170085906982422,3504,35,350426,Ϫ,Youxi,County,3,392759,208981,183778,99990,385531,203932,181599,116475,64070,52405,248910,130022,118888,27374,14889,12485,370042
116.819160461425781,26.178108215332031,3504,35,350423,,Qingliu,County,3,135660,71930,63730,37523,130688,67393,63295,33224,17779,15445,92384,49568,42816,10052,4583,5469,120403
119.14422607421875,26.146316528320312,3501,35,350121,,Minhou,County,3,580048,304434,275614,153673,556515,286949,269566,114589,61918,52671,418142,220969,197173,47317,21547,25770,515446
118.936698913574219,25.870216369628906,3501,35,350125,̩,Yongtai,County,3,324344,168196,156148,83962,317817,164130,153687,86946,48036,38910,213209,108088,105121,24189,12072,12117,304456
116.351722717285156,25.836233139038086,3508,35,350821,͡,Changting,County,3,403121,199309,203812,100984,396319,194708,201611,123113,64612,58501,248690,121914,126776,31318,12783,18535,378743
116.741615295410156,25.715612411499023,3508,35,350825,,Liancheng,County,3,297498,152808,144690,75604,290193,147229,142964,84541,44339,40202,192380,99934,92446,20577,8535,12042,281139
117.838386535644531,25.690732955932617,3504,35,350425,,Datian,County,3,331019,173228,157791,86559,323192,168702,154490,104249,56765,47484,206895,106084,100811,19875,10379,9496,309436
118.227226257324219,25.490888595581055,3505,35,350526,»,Dehua,County,3,301834,155765,146069,84851,284659,145088,139571,80211,42130,38081,206724,106459,100265,14899,7176,7723,235717
118.684188842773438,25.36378288269043,3503,35,350322,,Xianyou,County,3,855439,426921,428518,224553,835449,416051,419398,256518,137593,118925,539404,263454,275950,59517,25874,33643,796991
118.283645629882812,25.320919036865234,3505,35,350525,,Yongchun,County,3,516781,266627,250154,140977,505873,259654,246219,137962,74639,63323,347453,177559,169894,31366,14429,16937,472929
116.090599060058594,25.103876113891602,3508,35,350824,ƽ,Wuping,County,3,329916,167551,162365,85762,320777,160671,160106,88546,46567,41979,215385,110462,104923,25985,10522,15463,311529
118.178001403808594,25.054912567138672,3505,35,350524,Ϫ,Anxi,County,3,1011437,513544,497893,232540,979003,492491,486512,316214,164702,151512,643354,324855,318499,51869,23987,27882,963507
116.416572570800781,25.055995941162109,3508,35,350823,Ϻ,Shanghang,County,3,433700,214956,218744,111352,420580,205114,215466,123397,64576,58821,275141,136647,138494,35162,13733,21429,407067
118.800468444824219,25.027946472167969,3505,35,350521,ݰ,Huian,County,3,897381,435136,462245,233352,845344,404034,441310,250080,127328,122752,588315,286821,301494,58986,20987,37999,799029
117.538955688476562,25.004552841186523,3506,35,350629,,Huaan,County,3,159099,82597,76502,43231,156477,80574,75903,35460,18425,17035,113019,59262,53757,10620,4910,5710,153645
118.380523681640625,24.958784103393555,3505,35,350583,ϰ,Nanan,City,3,1385276,700218,685058,330536,1261278,621744,639534,387925,210365,177560,909081,452857,456224,88270,36996,51274,1196057
118.585044860839844,24.812587738037109,3505,35,350582,,Jinjiang,City,3,1479259,772066,707193,278862,1046296,529012,517284,275865,149065,126800,1135500,593030,542470,67894,29971,37923,922454
118.146148681640625,24.728546142578125,3502,35,350212,ͬ,Tongan,Qu,3,580813,296517,284296,147734,531462,269421,262041,120385,66722,53663,420087,213130,206957,40341,16665,23676,496793
116.723281860351562,24.725421905517578,3508,35,350822,,Yongding,County,3,411587,213180,198407,110149,393581,198851,194730,105592,55827,49765,275811,144457,131354,30184,12896,17288,370552
117.735458374023438,24.629264831542969,3506,35,350625,̩,Changtai,County,3,190288,97577,92711,50137,185547,94309,91238,43575,22876,20699,133834,69124,64710,12879,5577,7302,177153
117.354057312011719,24.506256103515625,3506,35,350627,Ͼ,Nanjing,County,3,342165,176348,165817,94025,332956,170567,162389,74347,38627,35720,242390,126319,116071,25428,11402,14026,319899
117.301651000976562,24.369050979614258,3506,35,350628,ƽ,Pinghe,County,3,532649,281453,251196,133930,526362,277079,249283,132675,74819,57856,362784,189876,172908,37190,16758,20432,512439
117.610328674316406,24.119541168212891,3506,35,350623,,Zhangpu,County,3,795347,406417,388930,199353,782632,397906,384726,192919,102564,90355,551385,282680,268705,51043,21173,29870,759663
117.327255249023438,23.958919525146484,3506,35,350622,,Yunxiao,County,3,403617,210310,193307,104551,398104,206690,191414,99407,54446,44961,276853,144155,132698,27357,11709,15648,362290
117.171943664550781,23.704898834228516,3506,35,350624,گ,Zhaoan,County,3,568156,294171,273985,142424,563468,290614,272854,138245,75080,63165,386890,201062,185828,43021,18029,24992,548556
119.448020935058594,25.98969841003418,3501,35,350105,β,Mawei,Qu,3,203527,102944,100583,50441,169591,85183,84408,32121,17583,14538,159457,80118,79339,11949,5243,6706,124353
117.603057861328125,26.230964660644531,3504,35,350403,Ԫ,Sanyuan,Qu,3,180231,95210,85021,52958,163307,84798,78509,33496,18079,15417,135990,71305,64685,10745,5826,4919,126399
118.091888427734375,24.509067535400391,3502,35,350206,,Huli,Qu,3,413316,215867,197449,107930,272893,138633,134260,41305,22831,18474,364090,189472,174618,7921,3564,4357,99637
118.089424133300781,24.569950103759766,3502,35,350211,,Jimei,Qu,3,148678,74864,73814,35297,107709,54250,53459,21000,11024,9976,120192,60655,59537,7486,3185,4301,94427
119.1055908203125,25.449045181274414,3503,35,350303,,Hanjiang,Qu,3,213110,104205,108905,50740,189341,91908,97433,44040,22949,21091,154252,75454,78798,14818,5802,9016,156752
117.679542541503906,24.516548156738281,3506,35,350603,,Longwen,Qu,3,134690,69531,65159,32506,120639,61585,59054,26286,13859,12427,99429,51598,47831,8975,4074,4901,111026
118.040514497340837,24.567977851784143,3502,35,350205,,Xinglin,Qu,3,227007,116906,110101,54715,167500,84868,82632,31898,16636,15262,184618,95594,89024,10491,4676,5815,128219
118.963241577148438,25.343595504760742,3503,35,350321,,Putian,County,3,1428558,672956,755602,331509,1357766,637537,720229,405959,206241,199718,913933,423659,490274,108666,43056,65610,1319094
118.032157897949219,27.757020950317383,3507,35,350782,ɽ,Wuyishan,City,3,212156,112006,100150,58918,202233,105092,97141,45575,23810,21765,153440,81367,72073,13141,6829,6312,178347
118.113273620605469,27.330394744873047,3507,35,350784,,Jianyang,City,3,317848,167066,150782,92511,302435,157214,145221,67404,35456,31948,227464,120001,107463,22980,11609,11371,268538
117.483688354492188,27.342056274414062,3507,35,350781,,Shaowu,City,3,288401,151117,137284,88496,279311,144387,134924,60462,32600,27862,207360,108138,99222,20579,10379,10200,230321
120.205299377441406,27.329774856567383,3509,35,350982,,Fuding,City,3,521070,276419,244651,141295,509564,267992,241572,133353,70181,63172,346448,184268,162180,41269,21970,19299,483079
119.646682739257812,27.090551376342773,3509,35,350981,,Fuan,City,3,554057,296379,257678,143718,540717,288535,252182,140936,77847,63089,369228,194637,174591,43893,23895,19998,498007
118.32061767578125,27.042112350463867,3507,35,350783,,Jianou,City,3,478651,249624,229027,135259,472290,245451,226839,104640,55837,48803,340488,176761,163727,33523,17026,16497,441382
117.360816955566406,25.973606109619141,3504,35,350481,,Yongan,City,3,334852,180109,154743,97894,314085,163824,150261,68163,36584,31579,244244,132030,112214,22445,11495,10950,262309
119.523590087890625,25.954448699951172,3501,35,350182,,Changle,City,3,689815,358963,330852,188190,638893,329571,309322,152903,86476,66427,493666,253801,239865,43246,18686,24560,517782
119.381233215332031,25.71861457824707,3501,35,350181,,Fuqing,City,3,1174540,597890,576650,287222,1097187,554625,542562,291000,158514,132486,799963,400871,399092,83577,38505,45072,1010523
117.406631469726562,25.293899536132812,3508,35,350881,ƽ,Zhangping,City,3,264757,140779,123978,74176,254751,133273,121478,62629,33447,29182,185755,99428,86327,16373,7904,8469,232695
118.637275695800781,24.737598419189453,3505,35,350581,ʯʨ,Shishi,City,3,498786,264700,234086,92678,334749,171137,163612,81911,44213,37698,396932,211393,185539,19943,9094,10849,263290
117.811378479003906,24.448442459106445,3506,35,350681,,Longhai,City,3,816318,415936,400382,214411,783200,394789,388411,189542,99302,90240,570375,292001,278374,56401,24633,31768,741831
119.781294106517052,25.508329656947019,3501,35,350128,ƽ̶,Pingtan,County,3,371922,187000,184922,95990,367221,183955,183266,123677,64605,59072,225316,111639,113677,22929,10756,12173,334193
119.011818567811702,25.434579849243164,3503,35,350302,,Chengxiang,Qu,3,230816,112373,118443,57043,192927,94107,98820,40340,21544,18796,176190,85046,91144,14286,5783,8503,130047
117.614000828680545,26.282231649763887,3504,35,350402,÷,Meilie,Qu,3,156874,82821,74053,49910,143111,74017,69094,27671,15043,12628,121232,63453,57779,7971,4325,3646,107478
118.575763764492947,24.921113086733481,3505,35,350502,,Licheng,Qu,3,292157,148808,143349,66097,210581,103990,106591,38405,20872,17533,234108,119676,114432,19644,8260,11384,156466
118.622336706826843,24.903895314094125,3505,35,350503,,Fengze,Qu,3,397847,215651,182196,85366,252715,128126,124589,46125,24988,21137,337857,184948,152909,13865,5715,8150,137105
118.637163672879495,24.981325025702432,3505,35,350504,彭,Luojiang,Qu,3,160071,81407,78664,38389,134703,66567,68136,38461,21249,17212,112395,56391,56004,9215,3767,5448,129062
118.89086774092182,25.148080188021055,3505,35,350505,Ȫ,Quangang,Qu,3,342211,170960,171251,87491,330206,163187,167019,103576,54648,48928,216329,107057,109272,22306,9255,13051,321445
117.644447169783462,24.514091267505059,3506,35,350602,ܼ,Xiangcheng,Qu,3,433194,222066,211128,118291,380786,190346,190440,69580,36231,33349,332418,171385,161033,31196,14450,16746,307692
117.417539252819211,23.688068121277226,3506,35,350626,ɽ,Dongshan,County,3,206152,103689,102463,50076,201666,100996,100670,46694,24811,21883,143604,73363,70241,15854,5515,10339,190536
118.175460688293128,26.6364732105726,3507,35,350702,ƽ,Yanping,Qu,3,488818,257352,231466,148700,458381,237686,220695,94996,51316,43680,357963,187103,170860,35859,18933,16926,388854
117.026527531921715,25.103579966307283,3508,35,350802,,Xinluo,Qu,3,543731,298481,245250,143975,460013,236987,223026,93742,49389,44353,417457,234038,183419,32532,15054,17478,367811
119.522553380190274,26.661660893798171,3509,35,350902,,Jiaocheng,Qu,3,400293,213131,187162,100240,383339,202273,181066,92275,47935,44340,277435,148490,128945,30583,16706,13877,350465
118.064771614778167,24.446122984752442,3502,35,350202,,Gulangyu,Qu,3,19640,9860,9780,5760,16605,7965,8640,2436,1253,1183,14860,7618,7242,2344,989,1355,13034
103.853507995605469,36.042518615722656,6201,62,620102,ǹ,Chengguan,Qu,3,936888,482507,454381,287645,811141,403850,407291,141396,72527,68869,732445,377029,355416,63047,32951,30096,582923
103.73504638671875,36.065044403076172,6201,62,620103,,Qilihe,Qu,3,478457,253988,224469,135056,426107,216255,209852,82845,43064,39781,365409,194767,170642,30203,16157,14046,343951
103.620887756347656,36.102371215820312,6201,62,620104,,Xigu,Qu,3,336029,174395,161634,103373,315310,159314,155996,59717,31046,28671,256403,132454,123949,19909,10895,9014,269780
103.701515197753906,36.123561859130859,6201,62,620105,,Anning,Qu,3,195704,105911,89793,44344,132986,67176,65810,25185,13300,11885,162514,88233,74281,8005,4378,3627,154427
107.197372436523438,35.674453735351562,6228,62,622827,ԭ,Zhenyuan,County,3,491696,254128,237568,109990,477491,243143,234348,144681,76646,68035,320987,164118,156869,26028,13364,12664,490825
103.386711120605469,35.662456512451172,6229,62,622926,,Dongxiangzuzhzhixian,County,3,256828,134074,122754,47120,251357,129697,121660,78828,42152,36676,166704,86334,80370,11296,5588,5708,255981
95.789054870605469,40.534412384033203,6221,62,622126,,Anxi,County,3,99615,53413,46202,29608,93182,48163,45019,24494,12860,11634,71324,38459,32865,3797,2094,1703,73237
98.901069641113281,39.986385345458984,6221,62,622123,,Jinta,County,3,136173,70668,65505,37090,130978,67039,63939,35086,18974,16112,94537,48434,46103,6550,3260,3290,122629
94.875648498535156,39.513816833496094,6221,62,622124,౱ɹ,Subeimengguzuzhzhixian,County,3,13046,7661,5385,3163,10548,5385,5163,2487,1284,1203,10135,6184,3951,424,193,231,8629
94.358221869468451,39.648208656101865,6221,62,622125,,Akesaihasakezuzhzhixian,County,3,8891,5219,3672,2082,7361,3823,3538,1911,997,914,6768,4126,2642,212,96,116,5216
99.823379516601562,39.356884002685547,6222,62,622225,̨,Gaotai,County,3,162159,83734,78425,42018,152191,76911,75280,40028,21353,18675,115251,59094,56157,6880,3287,3593,144644
100.163665771484375,39.148624420166016,6222,62,622224,,Linze,County,3,144875,74008,70867,39896,140240,71181,69059,37486,19486,18000,101233,51513,49720,6156,3009,3147,132363
99.608932495117188,38.837013244628906,6222,62,622222,ԣ,Sunanyuguzuzhzhixian,County,3,36678,19179,17499,9871,34004,17172,16832,8320,4206,4114,26861,14266,12595,1497,707,790,30235
101.087959289550781,38.781105041503906,6222,62,622226,ɽ,Shandan,County,3,191158,98171,92987,50799,182532,92737,89795,47480,25003,22477,135964,69300,66664,7714,3868,3846,175493
103.061973571777344,38.618953704833984,6223,62,622322,,Minqin,County,3,302085,155964,146121,70726,287503,145737,141766,87403,47896,39507,197481,99904,97577,17201,8164,9037,281450
100.810539245605469,38.431976318359375,6222,62,622223,,Minle,County,3,230196,118809,111387,58000,222498,113487,109011,59248,31738,27510,161452,82445,79007,9496,4626,4870,217908
101.969123840332031,38.246646881103516,6203,62,620321,,Yongchang,County,3,246668,129067,117601,65576,236230,120554,115676,61403,33946,27457,174687,89976,84711,10578,5145,5433,224015
102.888771057128906,37.463005065917969,6223,62,622323,,Gulang,County,3,367048,187728,179320,81469,357116,180587,176529,115391,61118,54273,237309,119710,117599,14348,6900,7448,359938
104.049850463867188,37.159866333007812,6204,62,620423,̩,Jingtai,County,3,227043,116166,110877,54602,224424,114217,110207,67198,35855,31343,150193,75534,74659,9652,4777,4875,207149
103.1348876953125,36.979804992675781,6223,62,622326,ף,Tianzhucangzuzhzhixian,County,3,221347,116487,104860,51650,212342,108983,103359,60318,31661,28657,152993,80857,72136,8036,3969,4067,208100
103.257881164550781,36.731590270996094,6201,62,620121,,Yongdeng,County,3,478039,244998,233041,120600,469171,237803,231368,125418,66262,59156,330218,167676,162542,22403,11060,11343,448576
107.300224304199219,36.563152313232422,6228,62,622822,,Huan,County,3,321116,166504,154612,71084,318243,164683,153560,102515,53617,48898,204176,105056,99120,14425,7831,6594,313245
104.679473876953125,36.567676544189453,6204,62,620421,Զ,Jingyuan,County,3,463076,237699,225377,94489,450490,228870,221620,145772,75632,70140,298361,152432,145929,18943,9635,9308,449245
107.976181030273438,36.455558776855469,6228,62,622823,,Huachi,County,3,127684,66680,61004,29101,123154,63454,59700,37124,19597,17527,85047,44077,40970,5513,3006,2507,119890
103.940910339355469,36.329769134521484,6201,62,620122,,Gaolan,County,3,161212,82615,78597,39155,158467,80477,77990,44907,23965,20942,107586,54390,53196,8719,4260,4459,152551
107.881576538085938,36.003719329833984,6228,62,622821,,Qingyang,County,3,318929,165759,153170,79022,307914,158217,149697,87949,46229,41720,218341,112498,105843,12639,7032,5607,301082
103.316139221191406,35.936923980712891,6229,62,622923,,Yongjing,County,3,192033,99529,92504,45715,188545,96902,91643,51240,26910,24330,130755,67514,63241,10038,5105,4933,185142
104.111259460449219,35.846298217773438,6201,62,620123,,Yuzhong,County,3,415513,215551,199962,99995,402473,206091,196382,103418,54386,49032,287564,149171,138393,24531,11994,12537,394501
108.016944885253906,35.814388275146484,6228,62,622824,ˮ,Heshui,County,3,154778,79713,75065,37603,151606,77428,74178,48937,25776,23161,99006,50261,48745,6835,3676,3159,150368
105.048057556152344,35.696533203125,6204,62,620422,,Huining,County,3,568634,290495,278139,118115,562745,286146,276599,192171,98830,93341,349621,178510,171111,26842,13155,13687,554825
103.203895568847656,35.595081329345703,6229,62,622901,,Linxia,City,3,202498,104017,98481,50250,195327,98286,97041,49718,26552,23166,141458,71835,69623,11322,5630,5692,190576
104.62835693359375,35.581962585449219,6224,62,622421,,Dingxi,County,3,449293,230786,218507,109197,438031,223380,214651,132871,69016,63855,290840,149120,141720,25582,12650,12932,423967
105.734764099121094,35.522682189941406,6227,62,622727,,Jingning,County,3,437059,223409,213650,96695,430103,217806,212297,131906,70174,61732,278264,140300,137964,26889,12935,13954,428666
107.932807922363281,35.51171875,6228,62,622826,,Ning,County,3,483069,249288,233781,111962,469648,239739,229909,142713,76853,65860,314959,159106,155853,25397,13329,12068,477578
102.988967895507812,35.484645843505859,6229,62,622921,,Linxia,County,3,348091,180515,167576,74018,347417,179878,167539,99068,52973,46095,230321,118857,111464,18702,8685,10017,341715
108.378936767578125,35.501468658447266,6228,62,622825,,Zhengning,County,3,206019,106282,99737,51102,202776,103781,98995,64127,34946,29181,130817,65258,65559,11075,6078,4997,202733
103.573722839355469,35.477294921875,6229,62,622924,,Guanghe,County,3,197428,101688,95740,35505,193897,98696,95201,65071,34605,30466,122204,62081,60123,10153,5002,5151,194728
103.345649719238281,35.420059204101562,6229,62,622925,,Hezheng,County,3,182924,94584,88340,38648,181645,93466,88179,56619,29718,26901,117192,60617,56575,9113,4249,4864,180675
103.861503601074219,35.372020721435547,6224,62,622427,,Lintao,County,3,516498,265549,250949,118545,507848,259987,247861,139327,72620,66707,349118,179944,169174,28053,12985,15068,505248
103.706375122070312,35.369205474853516,6229,62,622922,,Kangle,County,3,231721,120335,111386,47237,228964,118040,110924,69638,37226,32412,150594,77749,72845,11489,5360,6129,228583
107.363388061523438,35.331951141357422,6227,62,622722,,Jingchuan,County,3,306267,154844,151423,77015,299810,149991,149819,94684,50693,43991,194278,95001,99277,17305,9150,8155,296588
107.041206359863281,35.305091857910156,6227,62,622724,,Chongxin,County,3,99449,53186,46263,22144,92917,47612,45305,26773,14038,12735,67967,36513,31454,4709,2635,2074,91292
106.641738891601562,35.217933654785156,6227,62,622725,ͤ,Huating,County,3,168944,89841,79103,43648,157417,80692,76725,40802,21122,19680,120545,64581,55964,7597,4138,3459,159688
105.249488830566406,35.21392822265625,6224,62,622424,ͨμ,Tongwei,County,3,432897,223205,209692,89040,428675,219727,208948,136663,71346,65317,270690,139757,130933,25544,12102,13442,431369
102.519599914550781,35.207229614257812,6230,62,623027,ĺ,Xiahe,County,3,77262,39178,38084,14887,72427,34912,37515,21093,10791,10302,50858,26239,24619,5311,2148,3163,72038
106.044967651367188,35.199565887451172,6227,62,622726,ׯ,Zhuanglang,County,3,395850,201742,194108,86538,388653,195820,192833,117751,63053,54698,256117,128024,128093,21982,10665,11317,388710
104.210166931152344,35.139488220214844,6224,62,622426,μԴ,Weiyuan,County,3,336982,177061,159921,79564,331994,173221,158773,88338,46263,42075,229347,121946,107401,19297,8852,10445,335463
107.624221801757812,35.071182250976562,6227,62,622723,̨,Lingtai,County,3,204537,104616,99921,58421,203797,104100,99697,58697,31247,27450,134268,67145,67123,11572,6224,5348,193518
104.639785766601562,35.011665344238281,6224,62,622425,¤,Longxi,County,3,468779,242769,226010,110868,462961,237876,225085,139514,73797,65717,303234,156526,146708,26031,12446,13585,459992
106.210289001464844,34.995304107666016,6205,62,620525,żҴ,Zhangjiachuanhuizuzhzhixian,County,3,294569,150520,144049,60070,289600,146427,143173,97755,49844,47911,182771,93524,89247,14043,7152,6891,292100
105.6834716796875,34.862144470214844,6205,62,620522,ذ,Qinan,County,3,545273,276759,268514,116425,538129,270856,267273,172632,89755,82877,340822,171336,169486,31819,15668,16151,541181
104.466217041015625,34.85516357421875,6224,62,622428,,Zhang,County,3,186286,96741,89545,39635,184427,95263,89164,58821,30297,28524,118928,62492,56436,8537,3952,4585,185433
106.136308824315279,34.746873871953945,6205,62,620521,ˮ,Qingshui,County,3,279207,143451,135756,63548,274068,139626,134442,83457,43279,40178,183119,93632,89487,12631,6540,6091,274947
105.340171813964844,34.743206024169922,6205,62,620523,ʹ,Gangu,County,3,553377,283547,269830,118302,547169,278174,268995,177818,92935,84883,345239,175439,169800,30320,15173,15147,549013
104.896675109863281,34.723365783691406,6205,62,620524,ɽ,Wushan,County,3,399911,209064,190847,89468,395249,205672,189577,115580,60850,54730,262658,137493,125165,21673,10721,10952,393486
103.355209350585938,34.686973571777344,6230,62,623021,̶,Lintan,County,3,141030,72659,68371,33867,140235,71954,68281,42261,21909,20352,92624,48127,44497,6145,2623,3522,137681
103.507583618164062,34.589683532714844,6230,62,623022,׿,Zhuoni,County,3,95659,49383,46276,21818,94456,48319,46137,28480,14607,13873,62429,32922,29507,4750,1854,2896,92773
102.489883422851562,34.595008850097656,6230,62,623026,µ,Luqu,County,3,29675,14936,14739,6464,28411,13772,14639,9150,4660,4490,18809,9661,9148,1716,615,1101,26942
104.0306396484375,34.431011199951172,6224,62,622429,,Min,County,3,429514,224040,205474,97682,427247,222165,205082,115067,59842,55225,294793,155369,139424,19654,8829,10825,422381
105.179794311523438,34.192531585693359,6226,62,622628,,Li,County,3,483449,255880,227569,103016,477234,250831,226403,138995,72983,66012,316307,168713,147594,28147,14184,13963,477664
103.225196838378906,34.065582275390625,6230,62,623024,,Diebu,County,3,51165,26145,25020,11078,48541,23791,24750,13918,7153,6765,34504,17964,16540,2743,1028,1715,46737
104.403762817382812,34.048122406005859,6226,62,622623,崲,Dangchang,County,3,272785,142806,129979,60909,270315,140829,129486,72545,37189,35356,186558,99279,87279,13682,6338,7344,269414
105.297142028808594,34.019767761230469,6226,62,622627,,Xihe,County,3,365662,193246,172416,77122,358903,187632,171271,105493,55607,49886,237346,126302,111044,22823,11337,11486,356972
102.076828002929688,33.995193481445312,6230,62,623025,,Maqu,County,3,41399,21718,19681,8607,39653,20120,19533,13565,6948,6617,26053,14113,11940,1781,657,1124,36588
106.314155578613281,33.908473968505859,6226,62,622629,,Liangdang,County,3,49782,26612,23170,13437,49165,26135,23030,12543,6356,6187,33678,18310,15368,3561,1946,1615,46232
104.381515502929688,33.787643432617188,6230,62,623023,,Zhouqu,County,3,127889,65614,62275,28995,126184,64182,62002,38432,19641,18791,82804,42980,39824,6653,2993,3660,125003
106.092216491699219,33.766456604003906,6226,62,622630,,Hui,County,3,215236,113547,101689,52972,211993,110895,101098,52342,26886,25456,148393,79083,69310,14501,7578,6923,203279
105.730918884277344,33.748489379882812,6226,62,622624,,Cheng,County,3,251670,132467,119203,61286,243968,126912,117056,64006,33134,30872,171424,91333,80091,16240,8000,8240,237287
104.913604736328125,33.397064208984375,6226,62,622621,䶼,Wudu,County,3,517148,271026,246122,123432,511638,266954,244684,137780,70595,67185,348796,184884,163912,30572,15547,15025,499586
105.590240478515625,33.332447052001953,6226,62,622625,,Kang,County,3,194839,104127,90712,48944,192749,102480,90269,44045,22418,21627,135054,73745,61309,15740,7964,7776,189375
104.656639099121094,32.957187652587891,6226,62,622626,,Wen,County,3,234908,122902,112006,59206,232927,121313,111614,59374,30128,29246,160466,85086,75380,15068,7688,7380,229360
94.65087890625,40.140525817871094,6221,62,622103,ػ,Dunhuang,City,3,187578,96679,90899,57284,182687,92769,89918,44961,23485,21476,135912,69625,66287,6705,3569,3136,158216
97.564002990722656,39.823661804199219,6221,62,622101,,Yumen,City,3,188931,99832,89099,58718,177431,90662,86769,41494,21785,19709,139369,73412,65957,8068,4635,3433,155147
98.559059143066406,39.746994018554688,6221,62,622102,Ȫ,Jiuquan,City,3,346258,177943,168315,101273,325443,163314,162129,79915,41894,38021,250686,128060,122626,15657,7989,7668,281230
100.454544067382812,38.93463134765625,6222,62,622201,Ҵ,Zhangye,City,3,486688,248469,238219,133838,465320,238135,227185,115735,60138,55597,349848,177079,172769,21105,11252,9853,435610
102.633460998535156,37.926910400390625,6223,62,622301,,Wuwei,City,3,946506,488872,457634,243266,910097,463029,447068,250971,139825,111146,651187,326609,324578,44348,22438,21910,882595
107.6356201171875,35.736419677734375,6228,62,622801,,Xifeng,City,3,317669,163228,154441,78303,302363,154359,148004,86737,47159,39578,216177,108485,107692,14755,7584,7171,306057
106.681266784667969,35.537017822265625,6227,62,622701,ƽ,Pingliang,City,3,454996,236426,218570,116705,436196,223770,212426,111587,60241,51346,318613,163132,155481,24796,13053,11743,422273
98.286813727245971,39.803278753276089,6202,62,620201,Ͻ,Districts,Qu,3,159541,85959,73582,51729,149655,77298,72357,28227,14701,13526,125292,67886,57406,6022,3372,2650,125747
102.152516048757022,38.482479474852639,6203,62,620302,,Jinchuan,Qu,3,204902,106725,98177,65884,198047,101233,96814,41313,21954,19359,155753,80552,75201,7836,4219,3617,157319
104.163271424464682,36.547650864128428,6204,62,620402,,Baiyin,Qu,3,274554,145506,129048,81368,260124,133421,126703,53557,28715,24842,207059,109130,97929,13938,7661,6277,232472
104.788605481411892,36.723571964499421,6204,62,620403,ƽ,Pingchuan,Qu,3,186428,98166,88262,47822,178509,92102,86407,51996,27498,24498,128181,67246,60935,6251,3422,2829,156335
105.7367776460801,34.585173989992398,6205,62,620502,س,Qincheng,Qu,3,604070,312699,291371,149123,581034,297311,283723,155262,80738,74524,414935,213911,201024,33873,18050,15823,589823
105.890354924077613,34.568677554349847,6205,62,620503,,Beidao,Qu,3,542916,281809,261107,131752,528031,271522,256509,141610,74668,66942,370879,191296,179583,30427,15845,14582,527298
102.914685856784757,34.989016893117672,6230,62,623001,,Hezuo,City,3,76027,39589,36438,17588,68152,33990,34162,18399,9330,9069,53440,28449,24991,4188,1810,2378,65977
102.873100739911919,35.712152892253179,6229,62,622927,ʯɽ屣,Jishishandongxiangzubaoanzu,County,3,216939,112987,103952,43719,213691,110240,103451,65974,34437,31537,138971,72712,66259,11994,5838,6156,213996
102.865591630091657,36.337659070464049,6201,62,620111,,Honggu,Qu,3,140681,75860,64821,38086,129951,66449,63502,29605,15442,14163,105380,57400,47980,5696,3018,2678,116141
114.275741577148438,22.732732772827148,4403,44,440307,,Longgang,Qu,3,1714908,806398,908510,230156,632136,330219,301917,128879,75360,53519,1565741,722758,842983,20288,8280,12008,142728
116.077751159667969,24.339513778686523,4414,44,441402,÷,Meijiang,Qu,3,313821,160925,152896,80057,280139,139997,140142,61601,32619,28982,227725,117500,110225,24495,10806,13689,159495
113.743118286132812,25.090053558349609,4402,44,440224,ʻ,Renhua,County,3,163213,84292,78921,44782,159008,80947,78061,42619,22234,20385,108816,56788,52028,11778,5270,6508,133024
114.063148498535156,24.945762634277344,4402,44,440222,ʼ,Shixing,County,3,205684,102216,103468,55666,201277,99695,101582,56917,30049,26868,131256,65385,65871,17511,6782,10729,189199
113.269264221191406,24.784229278564453,4402,44,440232,Դ,Ruyuanyaozuzizhixian,County,3,177894,93768,84126,44262,169206,86603,82603,47347,24650,22697,117381,63269,54112,13166,5849,7317,153377
112.378120422363281,24.779701232910156,4418,44,441882,,Lianzhou,City,3,409360,212292,197068,111557,402143,208255,193888,112749,58857,53892,262917,138544,124373,33694,14891,18803,382327
112.282501220703125,24.71881103515625,4418,44,441826,,Liannanyaozuzizhixian,County,3,133814,69313,64501,35718,131567,68104,63463,38226,20439,17787,86368,44814,41554,9220,4060,5160,121429
113.597885131835938,24.689008712768555,4402,44,440221,,Qujiang,County,3,366031,189210,176821,93851,347420,177205,170215,93798,49059,44739,244291,128625,115666,27942,11526,16416,301793
116.170181274414062,24.651355743408203,4414,44,441427,,Jiaoling,County,3,203173,104781,98392,54163,193539,96503,97036,48689,24985,23704,134770,71789,62981,19714,8007,11707,179135
112.073402404785156,24.569299697875977,4418,44,441825,ɽ׳,Lianshanzhuangzuyaozuzizhix,County,3,99070,52175,46895,25190,97531,51171,46360,30574,15902,14672,61164,32732,28432,7332,3541,3791,88407
115.889816284179688,24.56593132019043,4414,44,441426,ƽԶ,Pingyuan,County,3,215856,109330,106526,56821,211790,106500,105290,59212,31399,27813,136445,69970,66475,20199,7961,12238,192063
112.638267517089844,24.485013961791992,4418,44,441823,ɽ,Yangshan,County,3,400776,204214,196562,100864,396834,201460,195374,140694,73848,66846,226956,116099,110857,33126,14267,18859,375185
114.932357788085938,24.439733505249023,4416,44,441624,ƽ,Heping,County,3,350760,175919,174841,92706,344356,171381,172975,113159,58242,54917,208358,105267,103091,29243,12410,16833,335243
114.482353210449219,24.35772705078125,4416,44,441623,ƽ,Lianping,County,3,287382,147847,139535,74036,279058,140487,138571,86091,44826,41265,178185,93515,84670,23106,9506,13600,265946
116.688629150390625,24.354482650756836,4414,44,441422,,Dapu,County,3,352013,176348,175665,103009,344135,170967,173168,107692,56762,50930,201409,101224,100185,42912,18362,24550,318783
114.13189697265625,24.344467163085938,4402,44,440229,Դ,Wengyuan,County,3,310956,159731,151225,83291,303847,154754,149093,94979,50508,44471,191417,99416,92001,24560,9807,14753,282357
115.255584716796875,24.099714279174805,4416,44,441622,,Longchuan,County,3,586155,289438,296717,146744,568767,277701,291066,193602,101008,92594,338512,165911,172601,54041,22519,31522,539042
114.197479248046875,24.060644149780273,4402,44,440233,·,Xinfeng,County,3,179388,91760,87628,46290,175734,89437,86297,55447,29756,25691,108221,55058,53163,15720,6946,8774,162222
115.762504577636719,23.932161331176758,4414,44,441424,廪,Wuhua,County,3,879286,435885,443401,210008,863607,425793,437814,338722,181768,156954,472682,225352,247330,67882,28765,39117,848389
112.179237365722656,23.912185668945312,4412,44,441224,,Huaiji,County,3,736444,366196,370248,162437,723825,355672,368153,289341,151965,137376,401223,194688,206535,45880,19543,26337,717034
113.531051635742188,23.871894836425781,4418,44,441821,,Fogang,County,3,255341,133296,122045,67186,245254,125404,119850,81148,43575,37573,151806,80005,71801,22387,9716,12671,225145
116.170494079589844,23.767244338989258,4414,44,441423,˳,Fengshun,County,3,449769,226583,223186,114773,442497,221780,220717,146641,75530,71111,260224,131380,128844,42904,19673,23231,412144
114.243087768554688,23.739284515380859,4413,44,441324,,Longmen,County,3,267949,139849,128100,68631,258899,133936,124963,76028,39653,36375,169109,89813,79296,22812,10383,12429,232437
117.004814147949219,23.678913116455078,4451,44,445122,ƽ,Raoping,County,3,885290,449733,435557,203926,872196,440829,431367,250457,132691,117766,566906,289517,277389,67927,27525,40402,847256
115.173057556152344,23.64305305480957,4416,44,441621,Ͻ,Zijin,County,3,502077,253938,248139,118774,494930,249064,245866,171711,90559,81152,283296,142757,140539,47070,20622,26448,471461
112.431320190429688,23.63804817199707,4412,44,441223,,Guangning,County,3,399611,201236,198375,116001,393673,197988,195685,116421,64545,51876,243066,119196,123870,40124,17495,22629,378773
111.508102416992188,23.445098876953125,4412,44,441225,⿪,Fengkai,County,3,385692,197786,187906,94865,379902,193431,186471,126740,67779,58961,228158,117116,111042,30794,12891,17903,367448
115.836448669433594,23.43455696105957,4452,44,445222,,Jiexi,County,3,716789,364467,352322,158736,706570,358697,347873,236867,124414,112453,419479,212003,207476,60443,28050,32393,687957
115.65142822265625,23.310922622680664,4415,44,441523,½,Luhe,County,3,229623,116531,113092,46355,226750,114524,112226,90806,47290,43516,121923,60405,61518,16894,8836,8058,213654
116.594062805175781,23.260953903198242,4405,44,440582,,Chaoyang,City,3,2470812,1256428,1214384,457612,2410522,1214486,1196036,886798,467905,418893,1436242,724407,711835,147772,64116,83656,2356905
111.521430969238281,23.242223739624023,4453,44,445322,,Yunan,County,3,379299,196521,182778,108198,373041,191943,181098,123391,66608,56783,221009,113474,107535,34899,16439,18460,347359
114.278060913085938,23.17521858215332,4413,44,441322,,Boluo,County,3,780477,398162,382315,169588,638255,325241,313014,186441,98893,87548,538079,274762,263317,55957,24507,31450,559487
111.771018981933594,23.146791458129883,4412,44,441226,,Deqing,County,3,308589,160695,147894,82021,302113,156273,145840,88927,47083,41844,193290,101993,91297,26372,11619,14753,288575
116.28851318359375,23.039129257202148,4452,44,445224,,Huilai,County,3,961658,489148,472510,178538,953739,482702,471037,346808,182963,163845,556351,281765,274586,58499,24420,34079,899481
114.712326049804688,22.987819671630859,4413,44,441323,ݶ,Huidong,County,3,713141,362120,351021,139042,637992,325970,312022,212028,112220,99808,451805,228291,223514,49308,21609,27699,529459
115.334808349609375,22.975711822509766,4415,44,441521,,Haifeng,County,3,649412,337937,311475,133379,623478,324126,299352,212292,115456,96836,391386,200189,191197,45734,22292,23442,562359
112.225082397460938,22.702915191650391,4453,44,445321,,Xinxing,County,3,384890,193497,191393,101072,367743,183324,184419,115861,61396,54465,233906,118611,115295,35123,13490,21633,352411
113.876068115234375,22.576671600341797,4403,44,440306,,Baoan,Qu,3,2735129,1309172,1425957,356077,935811,495382,440429,187212,109154,78058,2521521,1188548,1332973,26396,11470,14926,209179
112.694450378417969,22.358921051025391,4407,44,440783,ƽ,Kaiping,City,3,668692,326560,342132,178032,625856,304055,321801,169107,88344,80763,438258,213191,225067,61327,25025,36302,538019
111.627403259277344,21.75042724609375,4417,44,441721,,Yangxi,County,3,380272,202233,178039,96302,376684,199773,176911,121426,70213,51213,223898,114691,109207,34948,17329,17619,354224
111.001571655273438,21.511053085327148,4409,44,440923,,Dianbai,County,3,1459219,776369,682850,314643,1442261,765813,676448,528232,297164,231068,829844,428369,401475,101143,50836,50307,1265415
110.250892639160156,21.382980346679688,4408,44,440823,Ϫ,Suixi,County,3,807015,426131,380884,190744,796266,420037,376229,277144,151973,125171,467154,242843,224311,62717,31315,31402,754984
110.16278076171875,20.329675674438477,4408,44,440825,,Xuwen,County,3,616478,323584,292894,142244,611775,320477,291298,204291,113061,91230,370354,190920,179434,41833,19603,22230,575364
112.977593937046464,23.73398448760236,4418,44,441827,,Qingxin,County,3,531226,273383,257843,135660,511436,260631,250805,168554,90165,78389,313113,160907,152206,49559,22311,27248,474852
116.679658650664209,23.460403178273292,4451,44,445121,,Chaoan,County,3,1153196,584772,568424,254568,1111018,557978,553040,321361,168201,153160,738957,376741,362216,92878,39830,53048,1081327
116.418006896972656,23.573299407958984,4452,44,445221,Ҷ,Jiedong,County,3,1068986,551570,517416,238670,1036209,528818,507391,338581,181469,157112,650005,335919,314086,80400,34182,46218,1028803
112.012063972172797,23.07763448506789,4453,44,445323,ư,Yunan,County,3,260869,133496,127373,66497,256892,130695,126197,84742,44995,39747,154016,78631,75385,22111,9870,12241,248662
114.927833557128906,23.856061935424805,4416,44,441625,Դ,Dongyuan,County,3,312282,160830,151452,80927,304346,154796,149550,104633,54367,50266,175570,91995,83575,32079,14468,17611,291141
116.064529418945312,24.275104522705078,4414,44,441421,÷,Mei,County,3,516761,261127,255634,139948,505930,252877,253053,138854,72485,66369,321948,166138,155810,55959,22504,33455,442074
112.002578735351562,21.870895385742188,4417,44,441723,,Yangdong,County,3,409982,219444,190538,101715,386158,201656,184502,114338,64035,50303,259490,138785,120705,36154,16624,19530,365003
113.346794128417969,25.13487434387207,4402,44,440281,ֲ,Lechang,City,3,423444,223788,199656,115436,401758,204865,196893,112464,59799,52665,280845,150041,130804,30135,13948,16187,363714
114.302085876464844,25.118843078613281,4402,44,440282,,Nanxiong,City,3,372844,185330,187514,105117,364091,179034,185057,105493,56213,49280,235697,117183,118514,31654,11934,19720,340158
113.402076721191406,24.172937393188477,4418,44,441881,Ӣ,Yingde,City,3,810446,421964,388482,207758,786716,403371,383345,254539,134337,120202,487449,257686,229763,68458,29941,38517,718077
115.727348327636719,24.138690948486328,4414,44,441481,,Xingning,City,3,871507,436749,434758,226803,858419,427630,430789,268984,145499,123485,524674,260179,264495,77849,31071,46778,782021
113.581100463867188,23.555425643920898,4401,44,440184,ӻ,Conghua,City,3,517552,264150,253402,123821,477522,243277,234245,147097,77630,69467,335003,170868,164135,35452,15652,19800,433225
116.768043518066406,23.463153839111328,4405,44,440583,κ,Chenghai,City,3,860003,428157,431846,186050,813453,403984,409469,224616,115159,109457,568608,284907,283701,66779,28091,38688,763934
113.202911376953125,23.376836776733398,4401,44,440114,,Huadu,Qu,3,713363,370500,342863,165623,589245,295898,293347,152344,81800,70544,517629,270670,246959,43390,18030,25360,487467
112.694534301757812,23.348709106445312,4412,44,441284,Ļ,Sihui,City,3,409804,209936,199868,108137,371084,185922,185162,96230,52923,43307,278602,143376,135226,34972,13637,21335,296480
116.168014526367188,23.300182342529297,4452,44,445281,,Puning,City,3,1856402,954242,902160,338894,1763125,901115,862010,670441,354316,316125,1082743,552657,530086,103218,47269,55949,1702423
113.829154968261719,23.292558670043945,4401,44,440183,,Zengcheng,City,3,899644,466540,433104,195356,744121,378855,365266,221349,117504,103845,623859,324438,299421,54436,24598,29838,649584
112.886070251464844,23.165868759155273,4406,44,440683,ˮ,Sanshui,City,3,440119,230835,209284,113087,360738,179829,180909,89024,47927,41097,319909,171028,148881,31186,11880,19306,324781
112.449607849121094,23.028011322021484,4412,44,441283,Ҫ,Gaoyao,City,3,625125,314474,310651,169138,596837,299180,297657,179590,97966,81624,390657,194803,195854,54878,21705,33173,577896
115.641082763671875,22.948467254638672,4415,44,441581,½,Lufeng,City,3,1164767,600959,563808,215219,1160552,598258,562294,488151,258563,229588,616622,312965,303657,59994,29431,30563,1086903
113.366096496582031,22.943788528442383,4401,44,440113,خ,Fanyu,Qu,3,1630461,809594,820867,320765,1082019,539163,542856,262183,139821,122362,1298261,640968,657293,70017,28805,41212,842857
112.87799072265625,22.904581069946289,4406,44,440684,,Gaoming,City,3,301041,159746,141295,79421,256661,129652,127009,62134,33579,28555,217379,117545,99834,21528,8622,12906,217654
113.253921508789062,22.847860336303711,4406,44,440681,˳,Shunde,City,3,1694152,893580,800572,357689,1246076,622643,623433,293741,158243,135498,1317054,701057,615997,83357,34280,49077,1006320
114.462692260742188,22.799276351928711,4413,44,441381,,Huiyang,City,3,862822,429006,433816,160141,599852,305556,294296,168884,91727,77157,646175,317821,328354,47763,19458,28305,437507
111.570350646972656,22.766914367675781,4453,44,445381,޶,Luoding,City,3,866190,449131,417059,231612,846925,436772,410153,303456,170400,133056,496757,249333,247424,65977,29398,36579,814449
112.960189819335938,22.767238616943359,4407,44,440784,ɽ,Heshan,City,3,405779,202461,203318,99868,342902,170380,172522,79513,41464,38049,292084,145990,146094,34182,15007,19175,311759
113.038398742675781,22.526580810546875,4407,44,440782,»,Xinhui,City,3,932425,467557,464868,246842,839155,414322,424833,205366,107032,98334,648434,327343,321091,78625,33182,45443,773143
110.938804626464844,22.363494873046875,4409,44,440983,,Xinyi,City,3,907978,464088,443890,242219,899732,458479,441253,357409,192207,165202,476414,235924,240490,74155,35957,38198,829402
112.794418334960938,22.251373291015625,4407,44,440781,̨ɽ,Taishan,City,3,948716,478773,469943,266485,911211,456993,454218,218976,117247,101729,633983,319257,314726,95757,42269,53488,857810
112.307472229003906,22.191947937011719,4407,44,440785,ƽ,Enping,City,3,464898,240765,224133,118080,454831,233725,221106,129827,71201,58626,296921,151321,145600,38150,18243,19907,389010
111.790679931640625,22.175907135009766,4417,44,441781,,Yangchun,City,3,840581,440930,399651,227112,821924,427380,394544,241758,133637,108121,525348,273906,251442,73475,33387,40088,781372
110.853813171386719,21.919214248657227,4409,44,440981,,Gaozhou,City,3,1219132,639497,579635,321145,1189238,619880,569358,438829,250783,188046,678771,340091,338680,101532,48623,52909,1145935
110.626785278320312,21.651071548461914,4409,44,440982,,Huazhou,City,3,1007796,529550,478246,252696,989219,516349,472870,381146,216375,164771,546407,273072,273335,80243,40103,40140,945032
110.283317565917969,21.610107421875,4408,44,440881,,Lianjiang,City,3,1205764,642214,563550,290120,1191909,633372,558537,442534,249326,193208,663287,342319,320968,99943,50569,49374,1096856
110.778610229492188,21.446510314941406,4408,44,440883,⴨,Wuchuan,City,3,822482,429336,393146,184684,813612,423537,390075,316834,178658,138176,447565,221501,226064,58083,29177,28906,780641
110.087913513183594,20.901958465576172,4408,44,440882,,Leizhou,City,3,1268298,674213,594085,280783,1261037,669571,591466,484809,267178,217631,705444,368496,336948,78045,38539,39506,1214089
113.170797793901329,23.045675866324213,4406,44,440682,Ϻ,Nanhai,City,3,2133741,1111731,1022010,430715,1351234,680093,671141,323918,174137,149781,1721057,900475,820582,88766,37119,51647,991002
113.441534554241159,23.107126957699361,4401,44,440112,,Huangpu,Qu,3,389413,215355,174058,99485,274541,142585,131956,52746,28768,23978,323284,180306,142978,13383,6281,7102,173568
113.603482739143331,24.814506006202819,4402,44,440202,,Beijiang,Qu,3,139684,76522,63162,39886,119087,59458,59629,23236,12287,10949,106457,59267,47190,9991,4968,5023,91822
113.56834394797437,24.804575478263764,4402,44,440203,佭,Wujiang,Qu,3,191655,96784,94871,56104,171786,86182,85604,35152,18508,16644,145044,72917,72127,11459,5359,6100,125902
113.637093756783202,24.809158798851023,4402,44,440204,䥽,Zhenjiang,Qu,3,204640,109209,95431,61567,183437,94294,89143,36074,19251,16823,157086,84364,72722,11480,5594,5886,127283
114.133204822635093,22.560773703191199,4403,44,440303,޺,Luohu,Qu,3,774805,399739,375066,194274,509403,247266,262137,88251,49753,38498,672413,343310,329103,14141,6676,7465,190443
114.043603237218747,22.539283813973348,4403,44,440304,,Futian,Qu,3,909571,479965,429606,233258,595033,294857,300176,106199,59430,46769,789248,413681,375567,14124,6854,7270,227609
113.922100841039821,22.531844891758311,4403,44,440305,ɽ,Nanshan,Qu,3,722095,383463,338632,149641,383266,200593,182673,73030,41566,31464,639736,337477,302259,9329,4420,4909,122111
114.299006233268315,22.604994293539498,4403,44,440308,,Yantian,Qu,3,152323,75655,76668,25332,68273,35045,33228,11758,6863,4895,138908,68095,70813,1657,697,960,21316
113.565032574718103,22.286360458662131,4404,44,440402,,Xiangzhou,Qu,3,833908,414067,419841,199373,574248,288936,285312,116294,64331,51963,694697,339001,355696,22917,10735,12182,273232
113.287728162230863,22.213206903378865,4404,44,440421,,Doumen,County,3,401529,204346,197183,102857,361835,185562,176273,97608,52253,45355,277065,139757,137308,26856,12336,14520,282709
117.023172014386589,23.42425716376848,4405,44,440523,ϰ,Nanao,County,3,70352,35650,34702,18144,69441,34997,34444,19542,9990,9552,45903,23743,22160,4907,1917,2990,66381
113.110466803022149,23.04887373079244,4406,44,440602,,Cheng,Qu,3,296706,146982,149724,89791,262928,129040,133888,43773,23114,20659,228588,112900,115688,24345,10968,13377,208345
113.082617279970648,22.636327614226399,4407,44,440703,,Pengjiang,Qu,3,347293,176217,171076,94327,292386,144610,147776,53977,28755,25222,270955,137482,133473,22361,9980,12381,223731
113.086687712003439,22.588500037841062,4407,44,440704,,Jianghai,Qu,3,189024,95476,93548,44031,160172,79714,80458,36050,18913,17137,140762,71355,69407,12212,5208,7004,130227
110.356992595296475,21.27488001611918,4408,44,440802,࿲,Chikan,Qu,3,225997,114581,111416,57488,199158,100844,98314,44715,24580,20135,165569,82369,83200,15713,7632,8081,153908
110.39871452363262,21.195506591479685,4408,44,440803,ϼɽ,Xiashan,Qu,3,383643,197349,186294,105831,356720,181472,175248,80897,45348,35549,278746,139735,139011,24000,12266,11734,267246
110.467911868190129,21.241298951848623,4408,44,440804,ͷ,Potou,Qu,3,329405,174890,154515,76786,324147,170914,153233,117265,65064,52201,189195,98212,90983,22945,11614,11331,312431
110.31527066696033,21.268774368069987,4408,44,440811,,Mazhang,Qu,3,411620,220367,191253,88488,385031,203612,181419,136887,75728,61159,246428,131056,115372,28305,13583,14722,378679
110.890219191592578,21.668694315292047,4409,44,440902,ï,Maonan,Qu,3,644301,335713,308588,160763,620984,321268,299716,185630,102983,82647,417634,212435,205199,41037,20295,20742,549875
112.543629111973473,23.136110924590231,4412,44,441203,,Dinghu,Qu,3,140092,70595,69497,37643,125396,62089,63307,37833,20594,17239,90792,45686,45106,11467,4315,7152,112852
112.463492481327833,23.059790323975335,4412,44,441202,,Duanzhou,Qu,3,367742,183491,184251,93978,304299,151831,152468,61135,33657,27478,285987,140458,145529,20620,9376,11244,221278
114.403868962523688,23.090821170410397,4413,44,441302,ݳ,Huicheng,Qu,3,591686,292216,299470,128248,424793,214755,210038,97584,53223,44361,469653,228198,241455,24449,10795,13654,253581
115.364450822838009,22.781092741361505,4415,44,441502,,Cheng,Qu,3,409677,211746,197931,85880,401523,207319,194204,131859,71399,60460,253046,129079,123967,24772,11268,13504,307360
114.688093093625767,23.716396247917807,4416,44,441602,Դ,Yuancheng,Qu,3,227773,115330,112443,52645,215341,108377,106964,58339,31276,27063,154160,77470,76690,15274,6584,8690,143560
111.958518898745226,21.844608390073134,4417,44,441702,,Jiangcheng,Qu,3,538069,276769,261300,130578,503210,257139,246071,133377,74937,58440,363417,182731,180686,41275,19101,22174,391938
113.030693720581766,23.715653132202871,4418,44,441802,,Qingcheng,Qu,3,506680,258819,247861,130826,479874,243093,236781,125789,69319,56470,340193,171580,168613,40698,17920,22778,390309
113.750683880248786,23.0474747653811,4419,44,441901,Ͻ,Districts,Qu,3,6445777,3035742,3410035,716001,2256147,1156524,1099623,556605,309067,247538,5754417,2670203,3084214,134755,56472,78283,1408030
113.371624897194792,22.528494681199795,4420,44,442001,Ͻ,Districts,Qu,3,2363322,1175587,1187735,433293,1568448,787470,780978,380940,203315,177625,1873142,924291,948851,109240,47981,61259,1251167
116.638873004516839,23.664893246093509,4451,44,445102,,Xiangqiao,Qu,3,363582,181260,182322,95175,334961,165712,169249,75910,39598,36312,258686,128647,130039,28986,13015,15971,229669
116.364118842303213,23.530060185007187,4452,44,445202,ų,Rongcheng,Qu,3,633570,324831,308739,138626,592740,300272,292468,193769,104071,89698,401763,204096,197667,38038,16664,21374,560100
112.038085271117438,22.933829211792233,4453,44,445302,Ƴ,Yuncheng,Qu,3,261636,136789,124847,70569,248120,127054,121066,69353,37896,31457,172615,90665,81950,19668,8228,11440,225678
113.282399964501153,23.129740293230316,4401,44,440102,ɽ,Dongshan,Qu,3,556264,282654,273610,158050,488952,237769,251183,71364,37336,34028,427649,218054,209595,57251,27264,29987,400643
113.237729669271999,23.127053706453086,4401,44,440103,,Liwan,Qu,3,474830,240287,234543,143462,441274,216877,224397,65462,33936,31526,352059,180603,171456,57309,25748,31561,333108
113.251486846389881,23.129555011383609,4401,44,440104,Խ,Yuexiu,Qu,3,341422,169300,172122,102471,312217,151840,160377,44840,23153,21687,253514,126454,127060,43068,19693,23375,254201
113.263993371042503,23.102665983380479,4401,44,440105,,Haizhu,Qu,3,1237273,652802,584471,331426,987574,499329,488245,154851,82231,72620,993266,528775,464491,89156,41796,47360,629569
113.313556988793408,23.149604533717337,4401,44,440106,,Tianhe,Qu,3,1109320,609296,500024,262234,749416,383625,365791,142840,77332,65508,925419,511482,413937,41061,20482,20579,439333
113.232134302252931,23.091143044781269,4401,44,440107,,Fangcun,Qu,3,323758,175678,148080,82165,246265,125302,120963,42286,22344,19942,259568,143715,115853,21904,9619,12285,151392
113.234154941638437,23.184206648917201,4401,44,440111,,Baiyun,Qu,3,1748722,919586,829136,389228,1243020,635451,607569,275780,147471,128309,1393210,737105,656105,79732,35010,44722,738934
116.679945963738874,23.339483852997347,4405,44,440506,,Dahao,Qu,3,184746,92311,92435,33567,181540,90190,91350,63317,32722,30595,109188,54966,54222,12241,4623,7618,161362
116.695054167509056,23.388286489248276,4405,44,440507,,Longhu,Qu,3,255888,127939,127949,61769,220852,110108,110744,59298,31037,28261,185793,92069,93724,10797,4833,5964,144491
116.667036229372016,23.381421166658402,4405,44,440508,԰,Jinyuan,Qu,3,459687,228337,231350,120718,440074,216917,223157,102114,52954,49160,321574,158886,162688,35999,16497,19502,325535
116.642914825677863,23.380678969621659,4405,44,440509,ƽ,Shengping,Qu,3,290768,148086,142682,72711,271087,134458,136629,68278,35238,33040,197884,102498,95386,24606,10350,14256,202992
113.104537745210109,23.022131441219244,4406,44,440603,ʯ,Shiwan,Qu,3,471950,251991,219959,90987,274327,140131,134196,60175,33249,26926,397264,212924,184340,14511,5818,8693,153726
116.644081210125407,23.296558390964048,4405,44,440510,,Hepu,Qu,3,79023,39516,39507,15257,77319,38286,39033,29091,14617,14474,44354,22512,21842,5578,2387,3191,73638
110.642791748046875,26.044479370117188,4503,45,450329,Դ,Ziyuan,County,3,156946,82384,74562,45157,156320,82004,74316,31357,16167,15190,112388,59535,52853,13201,6682,6519,154875
111.063064575195312,25.938592910766602,4503,45,450324,ȫ,Quanzhou,County,3,652963,356160,296803,208651,650608,354573,296035,144110,83831,60279,449093,241446,207647,59760,30883,28877,636748
110.005073547363281,25.795944213867188,4503,45,450328,ʤ,Longshenggezuzizhixian,County,3,160796,85225,75571,44639,158983,83898,75085,30894,15374,15520,116091,62883,53208,13811,6968,6843,153513
109.603500366210938,25.784385681152344,4522,45,452228,,Sanjiangdongzuzhzhixian,County,3,304149,159263,144886,76964,302999,158525,144474,76779,40857,35922,204093,107327,96766,23277,11079,12198,293771
110.661033630371094,25.610227584838867,4503,45,450325,˰,Xingan,County,3,353920,186027,167893,102247,347943,182420,165523,67284,35632,31652,256678,135408,121270,29958,14987,14971,345873
111.143722534179688,25.485748291015625,4503,45,450327,,Guanyang,County,3,231288,126029,105259,75450,230801,125709,105092,51823,30742,21081,159024,84360,74664,20441,10927,9514,229926
110.318344116210938,25.408830642700195,4503,45,450323,鴨,Lingchuan,County,3,318036,166347,151689,90201,313977,163560,150417,65238,33945,31293,224508,119634,104874,28290,12768,15522,297775
110.203315734863281,25.235349655151367,4503,45,450322,ٹ,Lingui,County,3,424182,222054,202128,102772,420174,219313,200861,98465,52814,45651,291003,153842,137161,34714,15398,19316,411458
109.371414184570312,25.235450744628906,4522,45,452227,ڰ,Rongan,County,3,283029,151970,131059,77167,280091,150020,130071,65276,33973,31303,193832,106470,87362,23921,11527,12394,269343
109.233467102050781,25.073822021484375,4522,45,452229,ˮ,Rongshuimiaozuzhzhixian,County,3,425608,222457,203151,103892,421501,220302,201199,103680,54432,49248,289258,152512,136746,32670,15513,17157,407331
107.171485900878906,25.000459671020508,4527,45,452726,,Tiane,County,3,141649,74420,67229,33917,139962,73139,66823,35789,19406,16383,97434,51203,46231,8426,3811,4615,132945
107.531990051269531,24.982995986938477,4527,45,452725,ϵ,Nandan,County,3,318844,176857,141987,79861,292817,154713,138104,71937,39290,32647,230702,130282,100420,16205,7285,8920,248598
109.962692260742188,24.974830627441406,4503,45,450326,,Yongfu,County,3,235368,126360,109008,64922,233166,124703,108463,50698,27109,23589,162695,88931,73764,21975,10320,11655,229753
110.811317443847656,24.831043243408203,4503,45,450332,,Gongchengyaozuzizhixian,County,3,271216,144757,126459,72606,269083,143222,125861,57986,31318,26668,191622,103079,88543,21608,10360,11248,266872
108.248001098632812,24.824583053588867,4527,45,452724,ë,Huanjiangmaonanzuzhzhixian,County,3,332067,177714,154353,91298,326881,173754,153127,79700,41635,38065,231361,126779,104582,21006,9300,11706,313747
111.249595642089844,24.825145721435547,4524,45,452428,,Fuchuanyaozuzhzhixian,County,3,273507,144446,129061,68897,272253,143747,128506,80225,44017,36208,174971,91586,83385,18311,8843,9468,265121
106.559318542480469,24.787696838378906,4526,45,452629,ҵ,Leye,County,3,144816,75292,69524,33543,144134,74767,69367,46762,24975,21787,90239,46791,43448,7815,3526,4289,138928
108.889289855957031,24.787172317504883,4527,45,452723,޳,Luochengmulaozuzhzhixian,County,3,322116,170602,151514,82632,314533,163603,150930,75973,38941,37032,221596,120760,100836,24547,10901,13646,316919
105.337753295898438,24.777456283569336,4526,45,452631,¡ָ,Longlingezuzhzhixian,County,3,347462,182491,164971,78287,340815,176577,164238,97911,51108,46803,232586,123852,108734,16965,7531,9434,335904
110.478706359863281,24.776788711547852,4503,45,450321,˷,Yangshuo,County,3,264640,138900,125740,74323,259408,136235,123173,58037,30068,27969,182334,97639,84695,24269,11193,13076,255487
109.234840393066406,24.669523239135742,4502,45,450222,,Liucheng,County,3,356148,188751,167397,93920,347296,181606,165690,84276,43150,41126,243480,132568,110912,28392,13033,15359,331606
110.630035400390625,24.634757995605469,4503,45,450330,ƽ,Pingle,County,3,394575,207826,186749,98404,393048,206857,186191,98119,52569,45550,264677,140679,123998,31779,14578,17201,387662
107.042396545410156,24.544801712036133,4527,45,452727,ɽ,Fengshan,County,3,164807,85033,79774,41062,164280,84697,79583,45875,24254,21621,108325,56358,51967,10607,4421,6186,161331
111.288795471191406,24.529445648193359,4524,45,452427,ɽ,Zhongshan,County,3,460021,247304,212717,102259,454295,242278,212017,133963,72009,61954,294144,159213,134931,31914,16082,15832,443078
107.360687255859375,24.519634246826172,4527,45,452728,,Donglan,County,3,246715,127616,119099,64963,245082,126452,118630,61676,33815,27861,167849,86424,81425,17190,7377,9813,238490
105.087738037109375,24.499752044677734,4526,45,452632,,Xilin,County,3,139282,72391,66891,32626,138589,71863,66726,38694,20543,18151,94171,49041,45130,6417,2807,3610,127559
110.392166137695312,24.494077682495117,4503,45,450331,,Lipu,County,3,346169,181540,164629,98156,330476,173724,156752,64176,32627,31549,249207,133742,115465,32786,15171,17615,331186
109.736625671386719,24.480524063110352,4522,45,452223,¹կ,Luzhai,County,3,418665,230275,188390,110581,396016,210175,185841,96165,50138,46027,290492,165092,125400,32008,15045,16963,384409
111.525840759277344,24.416290283203125,4524,45,452402,,Hezhou,City,3,850023,446208,403815,197444,834786,436839,397947,250437,132717,117720,539540,285205,254335,60046,28286,31760,808960
106.566535949707031,24.348548889160156,4526,45,452628,,Lingyun,County,3,175573,91420,84153,41848,174967,91054,83913,51009,27359,23650,113066,59095,53971,11498,4966,6532,170240
106.231513977050781,24.297996520996094,4526,45,452630,,Tianlin,County,3,236799,122762,114037,57041,234367,120879,113488,56997,29631,27366,166772,87621,79151,13030,5510,7520,217749
109.323326110839844,24.267496109008789,4502,45,450221,,Liujiang,County,3,523300,279274,244026,130426,492582,258405,234177,127187,67537,59650,359973,195500,164473,36140,16237,19903,456019
110.517860412597656,24.208091735839844,4504,45,450423,ɽ,Mengshan,County,3,187918,99409,88509,48347,187370,99029,88341,47777,25567,22210,123915,66200,57715,16226,7642,8584,181354
110.805549621582031,24.168153762817383,4524,45,452424,ƽ,Zhaoping,County,3,353298,189087,164211,83685,351560,187865,163695,104118,55963,48155,219841,119229,100612,29339,13895,15444,343027
107.245925903320312,24.149255752563477,4527,45,452729,,Bamayaozuzhzhixian,County,3,218724,112108,106616,53732,216802,111127,105675,58008,31033,26975,146778,75373,71405,13938,5702,8236,211619
110.188041687011719,24.127109527587891,4522,45,452230,,Jinxiuyaozuzhzhixian,County,3,134934,71977,62957,36795,132693,70219,62474,30852,15854,14998,92759,50909,41850,11323,5214,6109,125036
108.663818359375,24.069070816040039,4522,45,452231,ó,Xincheng,County,3,343556,179063,164493,91215,342272,178351,163921,78249,39709,38540,236584,126898,109686,28723,12456,16267,335488
109.682456970214844,23.95805549621582,4522,45,452224,,Xiangzhou,County,3,293548,156401,137147,79966,291625,155055,136570,71577,37861,33716,195607,106633,88974,26364,11907,14457,279915
108.092605590820312,23.934783935546875,4527,45,452730,,Duanyaozuzhzhixian,County,3,543019,283579,259440,140781,541115,282294,258821,130778,69254,61524,366083,194721,171362,46158,19604,26554,532283
107.993881225585938,23.737270355224609,4527,45,452731,,Dahuayaozuzhzhixian,County,3,367970,191436,176534,95413,365886,189782,176104,90145,47866,42279,250462,132020,118442,27363,11550,15813,352567
106.907516479492188,23.741903305053711,4526,45,452622,,Tianyang,County,3,291973,149886,142087,82611,288514,147442,141072,54096,27567,26529,214151,112814,101337,23726,9505,14221,274331
109.240478515625,23.741493225097656,4522,45,452226,,Laibin,County,3,839790,442330,397460,195629,831152,436601,394551,246689,131383,115306,538089,285092,252997,55012,25855,29157,776697
108.168014526367188,23.712688446044922,4521,45,452127,ɽ,Mashan,County,3,399439,207337,192102,100262,398064,206592,191472,111439,59625,51814,257551,134800,122751,30449,12912,17537,394005
107.114158630371094,23.605627059936523,4526,45,452623,ﶫ,Tiandong,County,3,360123,185799,174324,97407,355837,183205,172632,85036,45220,39816,251524,131454,120070,23563,9125,14438,339651
109.655029296875,23.59674072265625,4522,45,452225,,Wuxuan,County,3,347794,184797,162997,87069,345810,183454,162356,104722,56516,48206,216668,116367,100301,26404,11914,14490,331531
110.383468627929688,23.548955917358398,4508,45,450821,ƽ,Pingnan,County,3,1055782,571329,484453,265741,1046406,564082,482324,334828,188245,146583,644537,343682,300855,76417,39402,37015,1042052
108.591140747070312,23.442163467407227,4521,45,452124,,Shanglin,County,3,379986,199028,180958,97614,378276,198136,180140,108042,56978,51064,241231,129373,111858,30713,12677,18036,374128
111.231065799910468,23.417545799288099,4504,45,450421,,Cangwu,County,3,646855,346112,300743,156080,637068,340279,296789,191965,103927,88038,408024,220951,187073,46866,21234,25632,630662
105.840087890625,23.412696838378906,4526,45,452627,,Napo,County,3,170158,87794,82364,43356,169375,87181,82194,37695,19602,18093,119375,62210,57165,13088,5982,7106,165534
110.07574462890625,23.395591735839844,4508,45,450881,ƽ,Guiping,City,3,1359035,716617,642418,353915,1348356,709667,638689,426818,235819,190999,834299,432743,401556,97918,48055,49863,1322098
110.902755737304688,23.376171112060547,4504,45,450422,,Teng,County,3,848648,454961,393687,207337,845629,452784,392845,267983,143622,124361,517664,280076,237588,63001,31263,31738,833391
106.611793518066406,23.331172943115234,4526,45,452625,±,Debao,County,3,276335,145119,131216,76274,275488,144560,130928,63264,33035,30229,185581,99418,86163,27490,12666,14824,270949
107.576522827148438,23.323421478271484,4526,45,452624,ƽ,Pingguo,County,3,392800,204629,188171,108572,388509,201885,186624,101469,54816,46653,262466,137949,124517,28865,11864,17001,374198
108.815628051757812,23.219667434692383,4521,45,452123,,Binyang,County,3,852881,452111,400770,208421,831147,436171,394976,252604,136426,116178,541620,290486,251134,58657,25199,33458,804825
107.681976318359375,23.180402755737305,4521,45,452126,¡,Longan,County,3,313306,167173,146133,83331,311723,166169,145554,77708,42627,35081,207702,112818,94884,27896,11728,16168,305204
108.266983032226562,23.162984848022461,4501,45,450122,,Wuming,County,3,603085,317627,285458,164370,592630,311780,280850,142252,77894,64358,413514,219994,193520,47319,19739,27580,579132
106.419563293457031,23.142971038818359,4526,45,452626,,Jingxi,County,3,456292,236465,219827,120185,453909,234759,219150,123714,65690,58024,291050,151924,139126,41528,18851,22677,445083
107.132400512695312,23.084743499755859,4521,45,452131,,Tiandeng,County,3,311400,160191,151209,86078,309466,159089,150377,84339,46750,37589,198961,101201,97760,28100,12240,15860,306584
110.992713928222656,22.927024841308594,4504,45,450481,Ϫ,Cenxi,City,3,731623,384212,347411,177167,727576,381706,345870,232832,127630,105202,447538,232939,214599,51253,23643,27610,709536
110.552001953125,22.866632461547852,4509,45,450921,,Rong,County,3,621498,326270,295228,176082,614230,322221,292009,199734,107184,92550,367662,192421,175241,54102,26665,27437,603151
107.196342468261719,22.844766616821289,4521,45,452130,,Daxin,County,3,314323,162092,152231,82158,311320,160075,151245,67175,35368,31807,219709,115193,104516,27439,11531,15908,307874
108.49224853515625,22.756786346435547,4501,45,450121,,Yongning,County,3,851904,464270,387634,222958,820366,442273,378093,210895,119916,90979,579238,316163,263075,61771,28191,33580,787239
110.356742858886719,22.712158203125,4509,45,450981,,Beiliu,City,3,1049035,557967,491068,268435,1037989,552108,485881,324359,183592,140767,653097,339710,313387,71579,34665,36914,1036635
109.265220642089844,22.684795379638672,4521,45,452122,,Heng,County,3,889733,471459,418274,242880,881375,466946,414429,256500,143928,112572,558787,293917,264870,74446,33614,40832,847623
107.903144836425781,22.643337249755859,4521,45,452128,,Fusui,County,3,366397,196130,170267,100292,362233,193368,168865,83446,46413,37033,255458,138422,117036,27493,11295,16198,349044
109.299705505371094,22.425373077392578,4507,45,450721,ɽ,Lingshan,County,3,1140799,619567,521232,268695,1136303,616967,519336,393302,223116,170186,665280,355585,309695,82217,40866,41351,1106345
107.351387023925781,22.410097122192383,4521,45,452129,,Chongzuo,County,3,306242,162684,143558,79699,301466,159983,141483,72065,40086,31979,213037,113978,99059,21140,8620,12520,293021
106.853111267089844,22.349828720092773,4521,45,452133,,Longzhou,County,3,255790,132656,123134,64546,249872,129045,120827,55105,28335,26770,182535,96794,85741,18150,7527,10623,247547
110.270950317382812,22.331388473510742,4509,45,450922,½,Luchuan,County,3,718439,378502,339937,167388,709651,373972,335679,238056,129924,108132,431265,223667,207598,49118,24911,24207,689703
109.987800598144531,22.276893615722656,4509,45,450923,,Bobai,County,3,1247518,674783,572735,283011,1242369,671758,570611,442711,254682,188029,724101,377327,346774,80706,42774,37932,1223006
109.551612854003906,22.27191162109375,4507,45,450722,ֱ,Pubei,County,3,718104,390039,328065,174963,714966,387863,327103,218908,123813,95095,446704,239563,207141,52492,26663,25829,702547
107.978790283203125,22.152637481689453,4506,45,450621,˼,Shangsi,County,3,205307,115056,90251,51316,203551,113753,89798,58031,35167,22864,132638,73279,59359,14638,6610,8028,185538
107.066513061523438,22.140283584594727,4521,45,452132,,Ningming,County,3,342993,182261,160732,86456,341323,180985,160338,88541,48454,40087,232469,124104,108365,21983,9703,12280,328647
108.366264343261719,21.757761001586914,4506,45,450603,,Fangcheng,Qu,3,316111,175576,140535,81078,313543,173761,139782,84806,50714,34092,207570,112828,94742,23735,12034,11701,289188
109.18927001953125,21.672203063964844,4505,45,450521,,Hepu,County,3,864601,461940,402661,205734,853699,456387,397312,263849,148906,114943,531699,279037,252662,69053,33997,35056,819551
109.874740600585938,22.748634338378906,4509,45,450924,ҵ,Xingye,County,3,531496,285228,246268,142337,510929,273417,237512,154445,89777,64668,330137,173218,156919,46914,22233,24681,525713
108.856513977050781,23.800994873046875,4522,45,452201,ɽ,Heshan,City,3,131249,69205,62044,34835,127444,65859,61585,30183,15577,14606,93878,50355,43523,7188,3273,3915,118338
106.740562438964844,22.102802276611328,4521,45,452101,ƾ,Pingxiang,City,3,107046,57445,49601,28837,101801,53434,48367,24776,13170,11606,76343,41705,34638,5927,2570,3357,92689
108.648956298828125,24.499111175537109,4527,45,452702,,Yizhou,City,3,549434,288084,261350,151337,526273,275239,251034,113718,59053,54665,393598,210589,183009,42118,18442,23676,533560
108.049110412597656,24.691082000732422,4527,45,452701,ӳ,Hechi,City,3,318348,167526,150822,89452,295293,153267,142026,61584,32099,29485,238104,127040,111064,18660,8387,10273,271078
106.616058349609375,23.91765022277832,4526,45,452601,ɫ,Baise,City,3,340483,177310,163173,88092,307155,157674,149481,61289,31628,29661,259534,137331,122203,19660,8351,11309,295196
107.988250732421875,21.536901473999023,4506,45,450681,,Dongxing,City,3,108131,58939,49192,28032,104852,57019,47833,27223,15942,11281,73296,39239,34057,7612,3758,3854,89309
108.276536974727392,22.865538261832967,4501,45,450111,"н
",Shijiao,Qu,3,484900,261823,223077,132180,455595,241428,214167,111080,64235,46845,346257,186011,160246,27563,11577,15986,356723
109.352196346812804,24.357745474512488,4502,45,450211,"н
",Jiaoqu,Qu,3,256730,139812,116918,62428,214982,112677,102305,53143,28180,24963,190826,105717,85109,12761,5915,6846,137217
110.302091186886557,25.087563610987313,4503,45,450311,"ɽ
",Yanshan,Qu,3,67833,34745,33088,16566,64516,32900,31616,14714,7569,7145,47302,24694,22608,5817,2482,3335,61435
111.307501760398821,23.455387601194975,4504,45,450411,"н
",Jiaoqu,Qu,3,80480,41669,38811,18831,73975,38174,35801,20478,11186,9292,53453,27569,25884,6549,2914,3635,66668
109.118124045599089,21.482486650012756,4505,45,450502,"
",Haicheng,Qu,3,273413,140976,132437,75016,251786,126532,125254,51571,27937,23634,204818,105459,99359,17024,7580,9444,175662
109.208490168223221,21.443479088711346,4505,45,450503,"
",Yinhai,Qu,3,138852,73379,65473,34604,134277,70052,64225,39453,21176,18277,90097,47781,42316,9302,4422,4880,113327
109.454075159927868,21.594503223252907,4505,45,450512,"ɽ
",Tieshangang,Qu,3,146370,76189,70181,35578,145759,75762,69997,46473,24397,22076,88140,46025,42115,11757,5767,5990,141620
108.357118469359321,21.634751849461928,4506,45,450602,"ۿ
",Gangkou,Qu,3,106403,58403,48000,29179,101333,54572,46761,25041,14738,10303,75216,40749,34467,6146,2916,3230,79177
108.636735928611159,21.954938988337485,4507,45,450702,"
",Qinnan,Qu,3,508922,277715,231207,127946,488435,266203,222232,135978,79425,56553,335334,179465,155869,37610,18825,18785,434003
108.646615745059933,22.104124216713874,4507,45,450703,"ձ
",Qinbei,Qu,3,526582,300713,225869,128312,524726,299562,225164,156304,97541,58763,329368,182745,146623,40910,20427,20483,508206
109.613359463767409,23.100816601949969,4508,45,450802,"۱
",Gangbei,Qu,3,1020701,527012,493689,251338,997082,513315,483767,329349,177211,152138,625349,320668,304681,66003,29133,36870,940698
109.758592765564288,22.954595318508211,4508,45,450803,"
",Gangnan,Qu,3,392427,204286,188141,110373,387358,201699,185659,131849,74300,57549,224543,113872,110671,36035,16114,19921,378824
110.145708146473751,22.63362701270697,4509,45,450902,"
",Yuzhou,Qu,3,918229,491729,426500,223110,809507,430897,378610,218774,128059,90715,640000,335941,304059,59455,27729,31726,843241
108.312697202930039,22.81872352218511,4501,45,450102,,Xingning,Qu,3,131865,68230,63635,34603,103875,51523,52352,18511,9850,8661,103233,53759,49474,10121,4621,5500,84703
108.344095958963237,22.825859603101744,4501,45,450103,³,Xincheng,Qu,3,426346,218606,207740,112373,314883,155078,159805,54188,28697,25491,348927,178589,170338,23231,11320,11911,256674
108.303277576120067,22.833566570491712,4501,45,450104,Ǳ,Chengbei,Qu,3,392726,205483,187243,91214,260681,130484,130197,45104,24281,20823,328913,172123,156790,18709,9079,9630,271975
108.308415554380048,22.808733008901818,4501,45,450105,,Jiangnan,Qu,3,192545,101224,91321,56769,165980,84019,81961,30393,16699,13694,152700,80053,72647,9452,4472,4980,108246
108.308130111143385,22.818438078948443,4501,45,450106,,Yongxin,Qu,3,138319,69550,68769,42514,124369,62301,62068,20996,11255,9741,106494,53655,52839,10829,4640,6189,83993
109.415216149371119,24.335980434653603,4502,45,450202,,Chengzhong,Qu,3,74764,38329,36435,20986,65356,31381,33975,9805,5053,4752,58407,30275,28132,6552,3001,3551,53067
109.42285307843494,24.307554087582716,4502,45,450203,,Yufeng,Qu,3,273589,138924,134665,78460,234893,117495,117398,41912,22282,19630,217484,110220,107264,14193,6422,7771,157066
109.382971337768325,24.310099730603991,4502,45,450204,,Liunan,Qu,3,325893,169654,156239,98444,298267,150688,147579,52711,28101,24610,252011,131514,120497,21171,10039,11132,193473
109.403760755775394,24.358042674171305,4502,45,450205,,Liubei,Qu,3,289416,148190,141226,89165,261755,131752,130003,42508,22467,20041,230290,117654,112636,16618,8069,8549,190817
110.26848855715653,25.281414015665401,4503,45,450302,,Xiufeng,Qu,3,125924,63694,62230,38267,106589,52971,53618,17646,9229,8417,100039,50802,49237,8239,3663,4576,74563
110.296188100231845,25.294449094759663,4503,45,450303,,Diecai,Qu,3,134401,68978,65423,43253,126533,63078,63455,20368,10612,9756,103495,53435,50060,10538,4931,5607,93388
110.265229787382964,25.25480072918128,4503,45,450304,ɽ,Xiangshan,Qu,3,249135,123787,125348,77501,223268,110109,113159,36597,19209,17388,197735,97750,99985,14803,6828,7975,160961
110.292929330458279,25.25860262725044,4503,45,450305,,Qixing,Qu,3,227278,122800,104478,56810,163024,81436,81588,26943,14112,12831,190815,104259,86556,9520,4429,5091,138153
111.292318831021177,23.49078617813672,4504,45,450403,,Wanxiu,Qu,3,113969,57172,56797,34968,105752,52293,53459,16440,8611,7829,85725,43392,42333,11804,5169,6635,87663
111.270910096294401,23.484291393444323,4504,45,450404,ɽ,Dieshan,Qu,3,186594,94583,92011,52321,161622,80393,81229,28569,15046,13523,146594,74453,72141,11431,5084,6347,121680
106.668769836425781,26.435298919677734,5201,52,520111,Ϫ,Huaxi,Qu,3,337177,178423,158754,84334,299555,154870,144685,79493,41284,38209,238019,127451,110568,19665,9688,9977,277266
106.761344909667969,26.633636474609375,5201,52,520112,ڵ,Wudang,Qu,3,319619,173057,146562,88829,293287,152391,140896,73082,38097,34985,228299,125489,102810,18238,9471,8767,251360
106.625259399414062,26.692140579223633,5201,52,520113,,Baiyun,Qu,3,187695,99670,88025,57755,177606,91950,85656,41481,21488,19993,136795,73218,63577,9419,4964,4455,127064
106.691118542604571,26.507548858911861,5201,52,520114,С,Xiaohe,Qu,3,142987,75829,67158,43548,131582,67074,64508,28113,14580,13533,107482,57287,50195,7392,3962,3430,98780
104.845114469936135,26.592638403581997,5202,52,520201,ɽ,Zhongshan,Qu,3,453293,239418,213875,127149,430055,224001,206054,114035,61339,52696,324356,170298,154058,14902,7781,7121,328799
106.932246330895083,27.700154971400384,5203,52,520302,컨,Honghuagang,Qu,3,691694,358839,332855,200864,647758,328668,319090,156838,81638,75200,499914,259775,240139,34942,17426,17516,428170
107.594375610351562,28.891901016235352,5203,52,520325,,Daozhengelaozumiaozuzhzhixi,County,3,286715,149516,137199,80663,284542,147916,136626,82229,43424,38805,186849,96664,90185,17637,9428,8209,279757
105.694190979003906,28.590175628662109,5203,52,520381,ˮ,Chishui,City,3,251780,130227,121553,77223,249888,128857,121031,62798,32781,30017,167529,87173,80356,21453,10273,11180,235115
108.496139526367188,28.558544158935547,5222,52,522228,غ,Yanhetujiazuzhzhixian,County,3,474331,245039,229292,130153,473176,244100,229076,166745,88414,78331,280876,143088,137788,26710,13537,13173,469311
107.434112548828125,28.554243087768555,5203,52,520324,,Zhengan,County,3,504832,262951,241881,135048,502284,260904,241380,156009,84015,71994,317975,163034,154941,30848,15902,14946,496877
107.883186340332031,28.528335571289062,5203,52,520326,,Wuchuangelaozumiaozuzhzhixi,County,3,386164,199992,186172,102912,384873,198953,185920,130144,68725,61419,234268,119720,114548,21752,11547,10205,376568
106.208526611328125,28.32853889465332,5203,52,520330,ϰˮ,Xishui,County,3,591208,305661,285547,154590,587302,302580,284722,196094,103636,92458,353675,182017,171658,41439,20008,21431,571527
108.117881774902344,28.26416015625,5222,52,522227,½,Dejiang,County,3,388639,199991,188648,106062,388029,199529,188500,129779,68664,61115,237534,120557,116977,21326,10770,10556,381519
109.194389343261719,28.161096572875977,5222,52,522229,,Songtaomiaozuzhzhixian,County,3,547488,287279,260209,137141,544835,285187,259648,192540,100737,91803,317248,167160,150088,37700,19382,18318,538316
106.823074340820312,28.145660400390625,5203,52,520322,ͩ,Tongzi,County,3,575580,299492,276088,148903,572272,297042,275230,179799,94468,85331,357708,186356,171352,38073,18668,19405,547735
108.400253295898438,27.999862670898438,5222,52,522226,ӡ,Yinjiangtujiazumiaozuzhzhix,County,3,335263,172297,162966,99860,334249,171503,162746,106300,56601,49699,205663,104096,101567,23300,11600,11700,331178
107.721145629882812,27.97120475769043,5203,52,520327,,Fenggang,County,3,370253,191304,178949,103215,367178,189126,178052,118304,62593,55711,231882,118973,112909,20067,9738,10329,361935
107.183258056640625,27.957305908203125,5203,52,520323,,Suiyang,County,3,457104,236364,220740,118391,454675,234547,220128,140737,74222,66515,288438,148396,140042,27929,13746,14183,441084
108.241828918457031,27.940149307250977,5222,52,522225,˼,Sinan,County,3,543389,275805,267584,158287,540524,273974,266550,177517,94205,83312,330290,164608,165682,35582,16992,18590,535462
106.417869567871094,27.824314117431641,5203,52,520382,ʻ,Renhuai,City,3,520759,270091,250668,127347,514091,265334,248757,166323,87048,79275,320352,166657,153695,34084,16386,17698,502912
107.481575012207031,27.767532348632812,5203,52,520328,̶,Meitan,County,3,411613,212681,198932,119332,407475,209969,197506,121279,64237,57042,263828,135756,128072,26506,12688,13818,393980
108.844459533691406,27.692777633666992,5222,52,522222,,Jiangkou,County,3,189288,101101,88187,52309,188607,100626,87981,58900,32418,26482,117766,62126,55640,12622,6557,6065,186219
106.830429077148438,27.547763824462891,5203,52,520321,,Zunyi,County,3,1243193,648257,594936,323302,1227947,637950,589997,381733,204140,177593,786832,408902,377930,74628,35215,39413,1167321
108.21966552734375,27.526378631591797,5222,52,522224,ʯ,Shiqian,County,3,334508,174492,160016,92380,333939,174023,159916,102779,56154,46625,210766,107995,102771,20963,10343,10620,330464
109.206527709960938,27.517147064208984,5222,52,522230,ɽ,Wanshante,Qu,3,54674,29108,25566,16887,54382,28901,25481,14059,7766,6293,35424,18569,16855,5191,2773,2418,51653
106.219123840332031,27.467777252197266,5224,52,522424,ɳ,Jinsha,County,3,496063,264094,231969,135723,491486,260572,230914,134746,72411,62335,327400,175423,151977,33917,16260,17657,464780
105.277694702148438,27.306295394897461,5224,52,522401,Ͻ,Bijie,City,3,1128230,589537,538693,286633,1111303,578601,532702,371511,195084,176427,686707,361121,325586,70012,33332,36680,1053585
108.911544799804688,27.235931396484375,5222,52,522223,,Yupingdongzuzhzhixian,County,3,126462,68213,58249,36040,125091,67113,57978,33826,19324,14502,82906,43902,39004,9730,4987,4743,119361
107.8853759765625,27.223583221435547,5203,52,520329,,Yuqing,County,3,252965,131161,121804,75859,250666,129515,121151,66882,36044,30838,169175,87006,82169,16908,8111,8797,244192
108.742767333984375,27.206205368041992,5226,52,522626,᯹,Cengong,County,3,187734,99124,88610,51086,187324,98780,88544,61133,33405,27728,114061,59279,54782,12540,6440,6100,182297
105.600410461425781,27.144189834594727,5224,52,522422,,Dafang,County,3,851729,449694,402035,217143,849296,447440,401856,283184,150449,132735,518904,275490,243414,49641,23755,25886,815062
104.723968505859375,27.12652587890625,5224,52,522428,,Hezhang,County,3,611243,319713,291530,149643,610057,318698,291359,212510,111067,101443,368181,193841,174340,30552,14805,15747,597481
106.739036560058594,27.100357055664062,5201,52,520122,Ϣ,Xifeng,County,3,221583,117341,104242,62807,218965,115474,103491,61075,32356,28719,146172,77900,68272,14336,7085,7251,206750
107.470222473144531,27.066226959228516,5227,52,522725,Ͱ,Wengan,County,3,390245,205671,184574,105309,381614,199001,182613,117343,62737,54606,250218,131720,118498,22684,11214,11470,373986
106.967384338378906,27.05980110168457,5201,52,520121,,Kaiyang,County,3,389252,204975,184277,107090,383915,201040,182875,114143,59586,54557,252281,133860,118421,22828,11529,11299,361133
108.418449401855469,27.043220520019531,5226,52,522625,Զ,Zhenyuan,County,3,222766,117949,104817,59724,219980,115786,104194,63383,34203,29180,145906,77176,68730,13477,6570,6907,209646
108.121131896972656,27.027334213256836,5226,52,522623,ʩ,Shibing,County,3,137171,72155,65016,35369,136110,71280,64830,40922,21637,19285,87857,46492,41365,8392,4026,4366,131194
106.027244567871094,27.026601791381836,5224,52,522423,ǭ,Qianxi,County,3,697075,369911,327164,180385,692836,366795,326041,216905,115230,101675,437454,234040,203414,42716,20641,22075,647649
108.67041015625,26.961570739746094,5226,52,522624,,Sansui,County,3,170167,89355,80812,47227,169404,88744,80660,54778,29264,25514,103808,54397,49411,11581,5694,5887,164888
109.200431823730469,26.904390335083008,5226,52,522627,,Tianzhu,County,3,348302,187034,161268,93386,345078,184743,160335,106713,59730,46983,216620,115317,101303,24969,11987,12982,337070
107.892196655273438,26.896940231323242,5226,52,522622,ƽ,Huangping,County,3,292121,154114,138007,79684,288069,150713,137356,84050,45951,38099,186950,97873,89077,21121,10290,10831,281685
104.28753662109375,26.847024917602539,5224,52,522427,,Weiningyizuhuizumiaozuzhzhi,County,3,1056009,557529,498480,252144,1050060,552625,497435,359534,186342,173192,652943,348416,304527,43532,22771,20761,1036606
106.5882568359375,26.842826843261719,5201,52,520123,,Xiuwen,County,3,262039,138196,123843,72030,256829,134527,122302,75763,38869,36894,170615,91547,79068,15661,7780,7881,230655
105.367500305175781,26.777124404907227,5224,52,522426,Ӻ,Nayong,County,3,661772,345714,316058,167709,659691,344011,315680,227397,118823,108574,397592,209409,188183,36783,17482,19301,653295
107.508094787597656,26.70783805847168,5227,52,522702,Ȫ,Fuquan,City,3,292720,155972,136748,76582,286030,150659,135371,86401,44862,41539,190081,103145,86936,16238,7965,8273,273819
109.193901062011719,26.676836013793945,5226,52,522628,,Jinping,County,3,190429,99432,90997,50089,189910,99036,90874,64457,34605,29852,114568,59510,55058,11404,5317,6087,182976
108.312217712402344,26.667882919311523,5226,52,522630,̨,Taijiang,County,3,142386,74201,68185,34811,141455,73443,68012,42188,22766,19422,92023,47284,44739,8175,4151,4024,136473
105.766136169433594,26.666446685791016,5224,52,522425,֯,Zhijin,County,3,825350,440893,384457,199629,822228,438671,383557,248848,132910,115938,533068,287242,245826,43434,20741,22693,812377
108.587898254394531,26.64982795715332,5226,52,522629,,Jianhe,County,3,189085,99891,89194,47550,187516,98673,88843,59939,33215,26724,118735,61302,57433,10411,5374,5037,183439
107.231895446777344,26.577915191650391,5227,52,522723,,Guiding,County,3,267809,140331,127478,66827,262915,136771,126144,78543,40288,38255,172698,92389,80309,16568,7654,8914,251112
104.869239807128906,26.366428375244141,5202,52,520221,ˮ,Shuicheng,County,3,678228,363125,315103,167113,672158,357936,314222,212640,115067,97573,430220,230778,199442,35368,17280,18088,656138
106.462287902832031,26.554271697998047,5201,52,520181,,Qingzhen,City,3,471305,248079,223226,124397,455025,236725,218300,137311,70761,66550,308106,164543,143563,25888,12775,13113,413635
107.590240478515625,26.497434616088867,5226,52,522635,齭,Majiang,County,3,203481,107982,95499,50168,201622,106514,95108,57914,30673,27241,132329,71359,60970,13238,5950,7288,197476
106.973335266113281,26.451709747314453,5227,52,522730,,Longli,County,3,192436,101582,90854,49211,189610,99984,89626,58032,30194,27838,122558,65565,56993,11846,5823,6023,179692
106.258186340332031,26.415121078491211,5204,52,520421,ƽ,Pingba,County,3,323959,169706,154253,89752,316939,163726,153213,89767,47307,42460,213644,112310,101334,20548,10089,10459,289202
108.069320678710938,26.385341644287109,5226,52,522634,ɽ,Leishan,County,3,132004,71979,60025,33485,130988,71219,59769,39870,23094,16776,84345,44829,39516,7789,4056,3733,129624
105.749885559082031,26.308774948120117,5204,52,520422,ն,Puding,County,3,353803,186484,167319,88736,350824,183673,167151,115236,61590,53646,214925,113586,101339,23642,11308,12334,332124
109.141761779785156,26.227846145629883,5226,52,522631,ƽ,Liping,County,3,458533,241140,217393,111154,454893,238718,216175,145402,79133,66269,287427,149310,138117,25704,12697,13007,445109
105.477981567382812,26.207828521728516,5202,52,520203,֦,Liuzhite,Qu,3,541762,284274,257488,145098,535851,279608,256243,165141,88894,76247,341653,178221,163432,34968,17159,17809,497506
107.794464111328125,26.203371047973633,5226,52,522636,կ,Danzhai,County,3,135400,72126,63274,35775,134704,71620,63084,39247,22541,16706,87218,45320,41898,8935,4265,4670,132460
106.658912658691406,26.138755798339844,5227,52,522731,ˮ,Huishui,County,3,388896,200942,187954,92530,387273,199689,187584,124719,64846,59873,239768,124823,114945,24409,11273,13136,373809
105.764450073242188,26.059928894042969,5204,52,520423,,Zhenningbuyizumiaozuzhzhixi,County,3,308569,162512,146057,75213,305945,160693,145252,97123,52326,44797,192710,101476,91234,18736,8710,10026,295247
106.4521484375,26.025890350341797,5227,52,522729,˳,Changshun,County,3,226235,119432,106803,55171,222940,116473,106467,70837,36680,34157,140679,75517,65162,14719,7235,7484,218797
107.870094299316406,25.98777961730957,5227,52,522732,ˮ,Sandushuizuzhzhixian,County,3,297442,156395,141047,69403,295807,155282,140525,95848,51700,44148,184714,96665,88049,16880,8030,8850,291214
105.62420654296875,25.934774398803711,5204,52,520424,벼,Guanlingbuyizumiaozuzhzhixi,County,3,280755,147716,133039,68546,279315,146625,132690,94189,51100,43089,169008,88424,80584,17558,8192,9366,271921
108.520591735839844,25.932214736938477,5226,52,522632,Ž,Rongjiang,County,3,300369,158728,141641,71015,298537,157365,141172,95556,51856,43700,189085,99155,89930,15728,7717,8011,292957
107.318275451660156,25.835638046264648,5227,52,522727,ƽ,Pingtang,County,3,267368,140363,127005,70181,266540,139743,126797,81038,44144,36894,168936,88258,80678,17394,7961,9433,259682
105.212326049804688,25.825469970703125,5223,52,522324,¡,Qinglong,County,3,258031,136653,121378,63587,252102,131238,120864,86337,46239,40098,157269,83486,73783,14425,6928,7497,241465
107.547164916992188,25.830177307128906,5227,52,522726,ɽ,Dushan,County,3,317910,165351,152559,81221,315111,163396,151715,97839,52101,45738,199135,103899,95236,20936,9351,11585,305636
104.950302124023438,25.783966064453125,5223,52,522323,հ,Puan,County,3,259881,136769,123112,65989,256996,134290,122706,88019,46950,41069,156492,82327,74165,15370,7492,7878,249920
106.077804565429688,25.750606536865234,5204,52,520425,岼,Ziyunmiaozubuyizuzhzhixian,County,3,297348,156064,141284,72095,296671,155539,141132,100912,54433,46479,179184,93461,85723,17252,8170,9082,291095
108.911796569824219,25.747940063476562,5226,52,522633,ӽ,Congjiang,County,3,301513,159210,142303,69879,300472,158401,142071,85825,47264,38561,195378,101829,93549,20310,10117,10193,295890
105.182052612304688,25.432624816894531,5223,52,522322,,Xingren,County,3,425091,220915,204176,105878,423726,219823,203903,150582,78998,71584,250796,130971,119825,23713,10946,12767,411878
106.742584228515625,25.435613632202148,5227,52,522728,޵,Luodian,County,3,293994,151814,142180,69544,290843,149732,141111,82622,43631,38991,194372,100672,93700,17000,7511,9489,286037
107.883926391601562,25.423194885253906,5227,52,522722,,Libo,County,3,171366,90130,81236,43183,167798,87527,80271,48208,25288,22920,113319,60424,52895,9839,4418,5421,152884
105.652114868164062,25.388889312744141,5223,52,522325,,Zhenfeng,County,3,314785,159996,154789,77740,314030,159349,154681,109748,57276,52472,184888,93552,91336,20149,9168,10981,302540
106.090835571289062,25.174385070800781,5223,52,522326,,Wangmo,County,3,273113,140731,132382,58727,272364,140115,132249,83905,43165,40740,175113,91270,83843,14095,6296,7799,265375
105.463050842285156,25.107334136962891,5223,52,522328,,Anlong,County,3,399384,207346,192038,101312,393849,203391,190458,131398,68596,62802,244024,128446,115578,23962,10304,13658,384770
105.81011962890625,24.992801666259766,5223,52,522327,,Ceheng,County,3,215030,110686,104344,49088,213425,109305,104120,68223,35208,33015,135987,70675,65312,10820,4803,6017,201060
104.471977233886719,25.717674255371094,5202,52,520222,,Pan,County,3,1070802,561196,509606,272221,1059858,551659,508199,361346,191011,170335,656976,343548,313428,52480,26637,25843,1029010
109.188262939453125,27.715539932250977,5222,52,522201,ͭ,Tongren,City,3,308583,163632,144951,86853,295690,155483,140207,83044,45282,37762,203118,106736,96382,22421,11614,10807,285520
107.978218078613281,26.582258224487305,5226,52,522601,,Kaili,City,3,433236,230692,202544,113066,406166,212727,193439,105922,58275,47647,302152,159898,142254,25162,12519,12643,356248
107.515838623046875,26.271051406860352,5227,52,522701,,Duyun,City,3,463426,241421,222005,124745,442603,228351,214252,112228,60343,51885,320541,166833,153708,30657,14245,16412,416740
104.892341613769531,25.092161178588867,5223,52,522301,,Xingyi,City,3,719605,375079,344526,183467,701273,362591,338682,213427,114049,99378,464107,241967,222140,42071,19063,23008,656679
105.932154646687337,26.247767688485258,5204,52,520402,,Xixiu,Qu,3,767307,395894,371413,202789,747436,381310,366126,218601,113802,104799,498740,258232,240508,49966,23860,26106,632705
106.710708618164062,26.571908950805664,5201,52,520102,,Nanming,Qu,3,687804,363329,324475,208890,606996,306124,300872,121514,62314,59200,524553,279969,244584,41737,21046,20691,377457
106.705802917480469,26.591642379760742,5201,52,520103,,Yunyan,Qu,3,698988,355920,343068,215223,627453,313373,314080,120921,62255,58666,530794,270816,259978,47273,22849,24424,384831
110.347391080669695,20.005526356818436,4601,46,460102,,Zhendong,Qu,3,356529,183308,173221,95393,309783,155767,154016,66118,36950,29168,272325,138302,134023,18086,8056,10030,221427
110.281621917026612,19.987077268565034,4601,46,460103,»,Xinhua,Qu,3,317508,165163,152345,85160,258253,130386,127867,54074,30417,23657,250274,128654,121620,13160,6092,7068,148783
110.163314691681691,19.991589000379054,4601,46,460104,Ӣ,Xiuying,Qu,3,156155,83303,72852,38359,134222,68766,65456,37771,20607,17164,110352,59002,51350,8032,3694,4338,105369
110.35699462890625,20.001897811889648,4690,46,469004,ɽ,Qiongshan,City,3,678149,355557,322592,155040,635899,328270,307629,180836,100315,80521,442152,231404,210748,55161,23838,31323,567167
109.687759399414062,19.904939651489258,4690,46,469028,ٸ,Lingao,County,3,389734,207943,181791,84999,375263,199928,175335,116763,64008,52755,245441,130486,114955,27530,13449,14081,377584
110.0091552734375,19.727413177490234,4690,46,469027,,Chengmai,County,3,434598,239547,195051,101197,425074,232973,192101,131400,75231,56169,268857,147414,121443,34341,16902,17439,396878
110.323265075683594,19.696670532226562,4690,46,469025,,Dingan,County,3,279335,150426,128909,70272,274542,147328,127214,76206,42896,33310,178597,96071,82526,24532,11459,13073,263159
110.757026672363281,19.616434097290039,4690,46,469005,Ĳ,Wenchang,City,3,509271,260432,248839,130738,493935,250854,243081,120209,64943,55266,326562,169770,156792,62500,25719,36781,444948
109.57232666015625,19.510597229003906,4690,46,469003,,Danzhou,City,3,835465,442636,392829,172917,814243,427746,386497,272065,150649,121416,514236,269371,244865,49164,22616,26548,752372
110.10064697265625,19.360172271728516,4690,46,469026,Ͳ,Tunchang,County,3,251121,134701,116420,56960,227915,123126,104789,69619,38280,31339,165425,88376,77049,16077,8045,8032,230016
109.044776916503906,19.250839233398438,4690,46,469031,,Changjianglizuzhzhixian,County,3,219502,116444,103058,49665,216215,113924,102291,62828,33904,28924,144728,76733,67995,11946,5807,6139,200559
110.465080261230469,19.244199752807617,4690,46,469002,�,Qionghai,City,3,449845,236560,213285,112812,432036,225931,206105,105378,60000,45378,300226,157217,143009,44241,19343,24898,392588
109.450668334960938,19.222614288330078,4690,46,469030,ɳ,Baishalizuzhzhixian,County,3,164494,89567,74927,39258,159957,86246,73711,47356,25677,21679,109661,60299,49362,7477,3591,3886,149762
108.639488220214844,19.097909927368164,4690,46,469007,,Dongfang,City,3,358318,188840,169478,78392,351386,184439,166947,109396,59968,49428,231705,121277,110428,17217,7595,9622,331855
109.841972351074219,19.036140441894531,4690,46,469036,,Qiongzhonglizumiaozuzhzhixi,County,3,171598,93271,78327,43720,168771,91302,77469,48605,26283,22322,113755,62155,51600,9238,4833,4405,148778
110.405662536621094,18.803552627563477,4690,46,469006,,Wanning,City,3,513604,272751,240853,117663,502796,266162,236634,149959,84554,65405,325521,170299,155222,38124,17898,20226,471630
109.172988891601562,18.746927261352539,4690,46,469033,ֶ,Ledonglizuzhzhixian,County,3,447382,237916,209466,95168,437713,230842,206871,139225,75396,63829,285670,152519,133151,22487,10001,12486,417758
109.700942993164062,18.637233734130859,4690,46,469035,ͤ,Baotinglizumiaozuzhzhixian,County,3,139506,74947,64559,33500,135621,72232,63389,36719,19207,17512,96121,52341,43780,6666,3399,3267,122200
110.038581848144531,18.504781723022461,4690,46,469034,ˮ,Lingshuilizuzhzhixian,County,3,303272,161287,141985,64353,299173,158348,140825,89827,48426,41401,194761,104561,90200,18684,8300,10384,291647
109.52593994140625,18.776466369628906,4690,46,469001,ͨʲ,Tongshen,City,3,100836,53146,47690,23723,89643,47086,42557,24092,12792,11300,72620,38418,34202,4124,1936,2188,85571
109.506565468542703,18.242540768651523,4602,46,460201,Ͻ,Districts,Qu,3,482296,254293,228003,101420,449379,232100,217279,135184,72037,63147,326370,172771,153599,20742,9485,11257,384526
112.204507473461149,16.980627268970583,4690,46,469037,ɳȺ,Xishaqundao,Prefectur,3,517,407,110,1,10,6,4,2,2,0,513,403,110,2,2,0,298
112.631493897889698,8.830501122372841,4690,46,469038,ɳȺ,Nanshaqundao,Prefectur,3,0,0,0,0,0,0,0,0,0,0,0,0,0,0,0,0,0
114.269998535230272,16.054845766554244,4690,46,469039,ɳȺĵ亣,Zhongshaqundaodedaojiaojiqi,Prefectur,3,0,0,0,0,0,0,0,0,0,0,0,0,0,0,0,0,0
117.650970458984375,40.545143127441406,1308,13,130804,ӥӪӿ,Yingshouyingzikuangqu,Qu,3,68735,35225,33510,22351,66888,33604,33284,13676,6957,6719,50113,25649,24464,4946,2619,2327,60164
118.268524169921875,39.673057556152344,1302,13,130205,ƽ,Kaiping,Qu,3,266378,137266,129112,81446,255208,128260,126948,44501,22863,21638,201750,104718,97032,20127,9685,10442,224514
119.754486083984375,40.003311157226562,1303,13,130303,ɽ,Shanhaiguan,Qu,3,158399,80343,78056,52686,153098,76375,76723,27833,14272,13561,117920,59933,57987,12646,6138,6508,124562
117.742637634277344,41.947471618652344,1308,13,130828,Χɹ,Weichangmanzumengguzuzizhix,County,3,451994,231726,220268,132312,446891,228346,218545,106270,55895,50375,319776,161789,157987,25948,14042,11906,428002
114.604293823242188,41.848537445068359,1307,13,130723,,Kangbao,County,3,226461,114888,111573,76200,224001,113237,110764,51321,25705,25616,159013,80469,78544,16127,8714,7413,212690
115.695831298828125,41.664588928222656,1307,13,130724,Դ,Guyuan,County,3,177143,91398,85745,59711,174973,89743,85230,40437,20638,19799,124259,63831,60428,12447,6929,5518,166516
117.718246459960938,41.305198669433594,1308,13,130825,¡,Longhua,County,3,373773,194794,178979,108668,368545,191666,176879,84858,45936,38922,263320,135325,127995,25595,13533,12062,357697
116.638999938964844,41.203357696533203,1308,13,130826,,Fengningmanzuzizhixian,County,3,341561,177673,163888,102815,336115,174390,161725,77841,40614,37227,237169,122805,114364,26551,14254,12297,326799
114.707344055175781,41.154544830322266,1307,13,130722,ű,Zhangbei,County,3,297741,149648,148093,104476,293471,147268,146203,67599,34025,33574,206192,102647,103545,23950,12976,10974,270099
113.960281372070312,41.077018737792969,1307,13,130725,,Shangyi,County,3,157766,78890,78876,53736,155709,77558,78151,37086,18621,18465,108744,53818,54926,11936,6451,5485,147768
118.678962707519531,40.994533538818359,1308,13,130823,ƽȪ,Pingquan,County,3,436917,224522,212395,123793,430516,221211,209305,97797,51585,46212,307066,156643,150423,32054,16294,15760,425400
115.264137268066406,40.967319488525391,1307,13,130733,,Chongli,County,3,108361,55958,52403,37213,106573,54741,51832,24305,12296,12009,75408,38775,36633,8648,4887,3761,94595
117.335716247558594,40.925727844238281,1308,13,130824,ƽ,Luanping,County,3,309532,160237,149295,89128,306280,158186,148094,71304,36541,34763,213947,111140,102807,24281,12556,11725,295330
115.826240539550781,40.901748657226562,1307,13,130732,,Chicheng,County,3,242181,128205,113976,79790,238963,126182,112781,48459,24821,23638,170568,90377,80191,23154,13007,10147,226380
118.157630920410156,40.751472473144531,1308,13,130821,е,Chengde,County,3,447345,234915,212430,128165,436078,227208,208870,99930,53443,46487,312377,163366,149011,35038,18106,16932,425403
114.717056274414062,40.746429443359375,1307,13,130729,ȫ,Wanquan,County,3,207403,107365,100038,66701,205385,106042,99343,49030,25768,23262,140234,72161,68073,18139,9436,8703,192775
114.40631103515625,40.670883178710938,1307,13,130728,,Huaian,County,3,224710,114967,109743,73153,221735,113446,108289,51261,26358,24903,155090,79088,76002,18359,9521,8838,212348
115.119167157806217,40.661009771738271,1307,13,130721,,Xuanhua,County,3,291878,154565,137313,93969,282620,148701,133919,64004,34008,29996,205450,108825,96625,22424,11732,10692,258377
118.476432800292969,40.596584320068359,1308,13,130827,,Kuanchengmanzuzizhixian,County,3,221887,115898,105989,63304,218087,113237,104850,52079,28170,23909,153381,79169,74212,16427,8559,7868,214058
117.494514465332031,40.416725158691406,1308,13,130822,¡,Xinglong,County,3,303861,157152,146709,85532,300537,155069,145468,68716,35438,33278,210873,109235,101638,24272,12479,11793,290043
118.948829650878906,40.402706146240234,1303,13,130321,,Qinglongmanzuzizhixianxian,County,3,482424,252184,230240,131980,476108,247707,228401,118023,65040,52983,327122,167809,159313,37279,19335,17944,469634
115.496253967285156,40.420841217041016,1307,13,130730,,Huailai,County,3,323387,167187,156200,100573,317910,163525,154385,73386,37706,35680,225614,116940,108674,24387,12541,11846,299673
115.210121154785156,40.375015258789062,1307,13,130731,¹,Zhuolu,County,3,326101,173236,152865,102337,319745,168471,151274,67206,35012,32194,233600,124756,108844,25295,13468,11827,310355
118.306015014648438,40.138698577880859,1302,13,130227,Ǩ,Qianxi,County,3,353616,182237,171379,102604,348066,178938,169128,81990,43028,38962,245713,126157,119556,25913,13052,12861,334840
114.171592712402344,40.120815277099609,1307,13,130727,ԭ,Yangyuan,County,3,257496,133494,124002,81454,254668,131638,123030,64612,34308,30304,171439,88024,83415,21445,11162,10283,238214
119.232192993164062,39.880443572998047,1303,13,130323,,Funing,County,3,504064,257067,246997,149164,497142,253032,244110,112773,58493,54280,351167,179016,172151,40124,19558,20566,485973
117.749000549316406,39.884754180908203,1302,13,130229,,Yutian,County,3,650408,329978,320430,179857,637859,323463,314396,141407,73907,67500,452893,229287,223606,56108,26784,29324,623088
118.868331909179688,39.874622344970703,1303,13,130324,¬,Lulong,County,3,403547,205941,197606,124132,397256,202434,194822,91800,47370,44430,277490,142274,135216,34257,16297,17960,390085
114.567695617675781,39.844413757324219,1307,13,130726,ε,Weixian,County,3,447059,238003,209056,138621,439868,232500,207368,104437,54959,49478,307020,164177,142843,35602,18867,16735,408093
118.133003234863281,39.831710815429688,1302,13,130221,,Fengrun,County,3,715835,362869,352966,208853,700927,354403,346524,155577,79520,76057,500268,254785,245483,59990,28564,31426,667129
118.693368010273346,39.75018020106377,1302,13,130223,,Luanxian,County,3,536151,274476,261675,158409,523529,268354,255175,116214,59543,56671,375989,193056,182933,43948,21877,22071,516174
119.167755126953125,39.706165313720703,1303,13,130322,,Changli,County,3,546440,276632,269808,169020,532849,270344,262505,101380,51815,49565,394397,200172,194225,50663,24645,26018,519850
118.685829162597656,39.508682250976562,1302,13,130224,,Luannan,County,3,570535,290761,279774,171039,560146,284302,275844,112874,57983,54891,402052,206396,195656,55609,26382,29227,550981
116.289901733398438,39.439319610595703,1310,13,131022,̰,Guan,County,3,400240,203229,197011,96732,390850,197402,193448,94078,49115,44963,276141,140266,135875,30021,13848,16173,385820
118.922218322753906,39.426113128662109,1302,13,130225,ͤ,Leting,County,3,497117,252619,244498,157523,483990,244535,239455,90086,45603,44483,359660,185028,174632,47371,21988,25383,470585
115.708122253417969,39.393245697021484,1306,13,130623,ˮ,Laishui,County,3,327983,167497,160486,89214,322185,164054,158131,70445,36000,34445,234948,120815,114133,22590,10682,11908,317692
114.684608459472656,39.351966857910156,1306,13,130630,Դ,Laiyuan,County,3,250790,134642,116148,75701,242651,128884,113767,53455,28162,25293,178392,96527,81865,18943,9953,8990,238198
115.496307373046875,39.349430084228516,1306,13,130633,,Yixian,County,3,541399,278913,262486,145699,529751,272147,257604,118291,60641,57650,383909,199277,184632,39199,18995,20204,518817
116.486846923828125,39.323291778564453,1310,13,131023,,Yongqing,County,3,373056,192649,180407,92679,356534,180862,175672,86769,45008,41761,259212,134673,124539,27075,12968,14107,349663
118.470169067382812,39.282470703125,1302,13,130230,ƺ,Tanghai,County,3,138343,69706,68637,45181,135554,67786,67768,28307,14347,13960,98991,49844,49147,11045,5515,5530,128869
115.767448425292969,39.279354095458984,1306,13,130626,,Dingxing,County,3,538039,271451,266588,128532,530594,268092,262502,133356,69984,63372,365353,183559,181794,39330,17908,21422,524208
115.869575500488281,39.053279876708984,1306,13,130629,ݳ,Rongcheng,County,3,244167,122911,121256,59616,237536,119851,117685,56814,30304,26510,168697,83944,84753,18656,8663,9993,232421
115.656227111816406,39.019001007080078,1306,13,130625,ˮ,Xushui,County,3,553557,279589,273968,141400,541500,272828,268672,127208,65272,61936,386713,196051,190662,39636,18266,21370,529303
116.098854064941406,38.975173950195312,1306,13,130638,,Xiongxian,County,3,323474,163030,160444,83561,320554,161406,159148,77707,40366,37341,221591,111673,109918,24176,10991,13185,314324
115.319206237792969,38.948173522949219,1306,13,130621,,Mancheng,County,3,391000,201252,189748,97493,374032,188790,185242,90620,46766,43854,273703,141842,131861,26677,12644,14033,361950
115.935394287109375,38.921417236328125,1306,13,130632,,Anxin,County,3,393001,196887,196114,110063,386467,192887,193580,89298,46214,43084,274359,136300,138059,29344,14373,14971,374281
116.466957092285156,38.865547180175781,1310,13,131026,İ,Wenan,County,3,461868,237410,224458,118891,443113,225543,217570,128013,68571,59442,304017,154448,149569,29838,14391,15447,434192
114.182792663574219,38.856327056884766,1306,13,130624,ƽ,Fuping,County,3,192950,98481,94469,56706,190240,97025,93215,43777,22233,21544,132309,67547,64762,16864,8701,8163,187166
115.127838134765625,38.837028503417969,1306,13,130636,˳ƽ,Shunping,County,3,282936,143862,139074,77198,278090,141328,136762,59029,30389,28640,202295,103475,98820,21612,9998,11614,268654
115.485939025878906,38.767181396484375,1306,13,130622,Է,Qingyuan,County,3,605580,306279,299301,154907,593011,299664,293347,143176,74115,69061,415327,210307,205020,47077,21857,25220,582601
114.9554443359375,38.745880126953125,1306,13,130627,,Tangxian,County,3,515915,261916,253999,128690,507804,256819,250985,121340,62436,58904,359733,183122,176611,34842,16358,18484,506487
115.119026184082031,38.710880279541016,1306,13,130631,,Wangdu,County,3,251636,127915,123721,63381,244859,123326,121533,53614,28021,25593,181036,92319,88717,16986,7575,9411,242057
116.625999450683594,38.703262329101562,1310,13,131025,,Dacheng,County,3,446577,227226,219351,114254,439046,223142,215904,129812,68754,61058,287832,144100,143732,28933,14372,14561,433223
115.779212951660156,38.697837829589844,1306,13,130628,,Gaoyang,County,3,308850,156874,151976,81462,295502,149922,145580,63468,32811,30657,218785,111223,107562,26597,12840,13757,283276
114.690727233886719,38.624443054199219,1306,13,130634,,Quyang,County,3,522421,266992,255429,128674,509996,258396,251600,128399,66245,62154,363260,186611,176649,30762,14136,16626,512443
116.821121215820312,38.583663940429688,1309,13,130922,,Qingxian,County,3,382228,193183,189045,107488,375207,189841,185366,95968,50256,45712,259685,129322,130363,26575,13605,12970,369226
115.541450500488281,38.495235443115234,1306,13,130635,,Lixian,County,3,511086,253572,257514,115270,465456,236650,228806,111628,59755,51873,361349,176455,184894,38109,17362,20747,452434
115.436386108398438,38.461597442626953,1306,13,130637,Ұ,Boye,County,3,241774,121934,119840,64769,238075,120088,117987,53115,27827,25288,169972,85610,84362,18687,8497,10190,231941
114.540603637695312,38.437572479248047,1301,13,130125,,Xingtang,County,3,395382,198143,197239,103689,387323,193939,193384,101535,51266,50269,266510,135085,131425,27337,11792,15545,383409
115.838531494140625,38.434967041015625,1309,13,130926,,Suning,County,3,325257,166246,159011,83111,315019,158823,156196,75463,39231,36232,225186,115983,109203,24608,11032,13576,305897
116.890611540937499,38.253501508869967,1309,13,130921,,Cangxian,County,3,643114,326566,316548,175917,632650,320215,312435,153223,80532,72691,444094,223865,220229,45797,22169,23628,629193
114.368110656738281,38.308197021484375,1301,13,130126,,Lingshou,County,3,314656,160589,154067,79315,304416,154117,150299,81617,41414,40203,211513,109359,102154,21526,9816,11710,303010
114.198753356933594,38.256168365478516,1301,13,130131,ƽɽ,Pingshan,County,3,444084,229545,214539,116448,435472,224574,210898,109300,56347,52953,300628,156381,144247,34156,16817,17339,431041
115.740699768066406,38.247371673583984,1311,13,131124,,Raoyang,County,3,293413,148493,144920,75283,289680,146398,143282,64799,33418,31381,203769,103931,99838,24845,11144,13701,288061
115.490158081054688,38.238243103027344,1311,13,131125,ƽ,Anping,County,3,322650,163118,159532,85139,314954,158637,156317,66766,34531,32235,229185,116555,112630,26699,12032,14667,309469
116.121566772460938,38.192920684814453,1309,13,130929,,Xianxian,County,3,541988,276345,265643,138812,528751,266871,261880,130076,67534,62542,374376,191454,182922,37536,17357,20179,521686
115.183555603027344,38.185417175292969,1301,13,130128,,Shenze,County,3,249797,127212,122585,66495,245776,123979,121797,59466,30692,28774,172115,88000,84115,18216,8520,9696,237570
114.959548950195312,38.176509857177734,1301,13,130130,޼,Wuji,County,3,483538,243430,240108,119171,475061,239598,235463,117855,61764,56091,331536,166711,164825,34147,14955,19192,473494
114.561119079589844,38.143074035644531,1301,13,130123,,Zhengding,County,3,593951,294579,299372,145087,562872,279047,283825,145752,73694,72058,409648,205134,204514,38551,15751,22800,543286
117.496498107910156,38.145587921142578,1309,13,130924,,Haixing,County,3,198024,101321,96703,55273,195608,99642,95966,53156,28498,24658,129579,65419,64160,15289,7404,7885,188718
117.102210998535156,38.05828857421875,1309,13,130930,ϴ,Mengcunhuizuzizhixian,County,3,181304,92576,88728,46677,178914,91203,87711,49051,26522,22529,119151,59687,59464,13102,6367,6735,176690
117.229202270507812,38.057159423828125,1309,13,130925,ɽ,Yanshan,County,3,402952,206998,195954,101431,397037,203595,193442,103023,55226,47797,272235,138022,134213,27694,13750,13944,396152
115.980354309082031,38.043594360351562,1311,13,131123,ǿ,Wuqiang,County,3,212158,107858,104300,52858,206661,103938,102723,47043,24263,22780,149856,76932,72924,15259,6663,8596,203698
116.70745849609375,38.038654327392578,1309,13,130927,Ƥ,Nanpi,County,3,337931,172409,165522,90611,329976,167684,162292,79530,43073,36457,233588,117437,116151,24813,11899,12914,325947
114.138389587402344,38.036121368408203,1301,13,130121,,Jingxing,County,3,328549,169854,158695,88527,318452,163414,155038,81119,43429,37690,223880,115625,108255,23550,10800,12750,304410
114.651573181152344,37.881870269775391,1301,13,130124,,Luancheng,County,3,376187,190273,185914,87865,367807,186088,181719,100917,53506,47411,249646,125599,124047,25624,11168,14456,354264
116.545738220214844,37.876747131347656,1309,13,130923,,Dongguang,County,3,343807,174454,169353,98505,333688,168048,165640,79673,41116,38557,239202,121667,117535,24932,11671,13261,331501
116.144706726074219,37.868179321289062,1311,13,131128,,Fucheng,County,3,325742,165689,160053,91107,316201,160145,156056,72535,38060,34475,234058,118796,115262,19149,8833,10316,321659
115.890663146972656,37.805992126464844,1311,13,131122,,Wuyi,County,3,319532,162882,156650,88539,305593,154160,151433,71886,37280,34606,225436,115636,109800,22210,9966,12244,310347
114.768157958984375,37.751472473144531,1301,13,130133,,Zhaoxian,County,3,550957,282469,268488,131280,542610,277805,264805,142811,77549,65262,369257,186903,182354,38889,18017,20872,542567
114.508506774902344,37.747486114501953,1301,13,130132,Ԫ,Yuanshi,County,3,386518,196075,190443,88435,378551,191980,186571,107472,57310,50162,256255,128750,127505,22791,10015,12776,375382
116.270881652832031,37.686882019042969,1311,13,131127,,Jingxian,County,3,489817,248098,241719,132927,478467,240897,237570,114804,59318,55486,343095,174084,169011,31918,14696,17222,474935
114.383392333984375,37.660778045654297,1301,13,130129,޻,Zanhuang,County,3,230532,120298,110234,58186,224332,115906,108426,54834,28973,25861,162651,84935,77716,13047,6390,6657,227709
116.382240295410156,37.620555877685547,1309,13,130928,,Wuqiao,County,3,278693,140924,137769,77658,267319,133175,134144,56236,28755,27481,201445,102893,98552,21012,9276,11736,267132
114.913520812988281,37.617744445800781,1305,13,130528,,Ningjin,County,3,712692,362769,349923,175439,698633,354549,344084,176933,93320,83613,486083,246921,239162,49676,22528,27148,691544
114.613105773925781,37.601776123046875,1301,13,130127,,Gaoyi,County,3,177537,90071,87466,43204,174335,88259,86076,45230,24490,20740,120935,60701,60234,11372,4880,6492,167666
115.242912292480469,37.531551361083984,1305,13,130530,º,Xinhe,County,3,162888,81384,81504,46423,159904,79687,80217,37850,19149,18701,113033,57060,55973,12005,5175,6830,160292
115.717178344726562,37.503692626953125,1311,13,131121,ǿ,Zaoqiang,County,3,376990,190924,186066,102901,364074,182191,181883,76194,39295,36899,272511,139696,132815,28285,11933,16352,364809
114.684928894042969,37.491306304931641,1305,13,130524,,Baixiang,County,3,181104,91949,89155,42753,177284,89697,87587,43063,23275,19788,125201,63227,61974,12840,5447,7393,178065
114.504280090332031,37.433498382568359,1305,13,130522,ٳ,Lincheng,County,3,191355,97415,93940,49740,184669,93589,91080,44226,22939,21287,134983,68894,66089,12146,5582,6564,181084
114.774497985839844,37.353778839111328,1305,13,130525,¡Ң,Longyao,County,3,473148,239652,233496,111949,449350,226243,223107,113851,60070,53781,328368,166306,162062,30929,13276,17653,461664
115.975006103515625,37.343025207519531,1311,13,131126,ʳ,Gucheng,County,3,451467,228418,223049,116809,440024,220987,219037,104718,55294,49424,317910,160339,157571,28839,12785,16054,443083
114.516410827636719,37.292942047119141,1305,13,130523,,Neiqiu,County,3,255402,131553,123849,62841,246870,125357,121513,57756,29912,27844,182959,95142,87817,14687,6499,8188,242183
115.029342651367188,37.213653564453125,1305,13,130529,¹,Julu,County,3,356085,178769,177316,89387,352790,176940,175850,87769,45048,42721,242149,121807,120342,26167,11914,14253,345352
114.682960510253906,37.123218536376953,1305,13,130526,,Renxian,County,3,303308,154022,149286,70235,300078,152334,147744,76968,40906,36062,206155,103892,102263,20185,9224,10961,297881
115.665779113769531,37.066368103027344,1305,13,130534,,Qinghe,County,3,365073,182835,182238,87682,353914,176395,177519,94144,50230,43914,248739,122707,126032,22190,9898,12292,341555
115.153167724609375,37.068370819091797,1305,13,130531,,Guangzong,County,3,262551,133097,129454,69229,259569,131369,128200,64499,33242,31257,180054,91490,88564,17998,8365,9633,259543
115.034591674804688,37.067031860351562,1305,13,130532,ƽ,Pingxiang,County,3,283360,144401,138959,63510,273258,138175,135083,69272,36164,33108,194895,99036,95859,19193,9201,9992,276504
114.574676513671875,37.031574249267578,1305,13,130521,̨,Xingtai,County,3,463419,238544,224875,120003,446184,226698,219486,112034,58058,53976,321619,166811,154808,29766,13675,16091,433395
114.690650939941406,36.998817443847656,1305,13,130527,Ϻ,Nanhe,County,3,314106,159647,154459,71904,312206,158568,153638,87626,46068,41558,208847,105769,103078,17633,7810,9823,307967
115.262458801269531,36.9837646484375,1305,13,130533,,Weixian,County,3,530259,268630,261629,134132,519630,262516,257114,125453,65147,60306,368046,186813,181233,36760,16670,20090,527077
114.874153137207031,36.927013397216797,1304,13,130431,,Jize,County,3,252643,129866,122777,57836,247420,125743,121677,67452,35384,32068,169598,87466,82132,15593,7016,8577,249987
115.498214721679688,36.863964080810547,1305,13,130535,,Linxi,County,3,313118,159328,153790,78795,308289,156176,152113,82312,43458,38854,211829,107283,104546,18977,8587,10390,307931
115.173225402832031,36.822780609130859,1304,13,130430,,Qiuxian,County,3,200564,100376,100188,51529,197038,98409,98629,48184,24849,23335,138854,69494,69360,13526,6033,7493,196867
114.481224060058594,36.788471221923828,1304,13,130429,,Yongnian,County,3,828897,419557,409340,196131,815013,412090,402923,223591,117377,106214,557297,280730,276567,48009,21450,26559,811755
114.959281921386719,36.778961181640625,1304,13,130435,,Quzhou,County,3,392896,197577,195319,93566,390285,196388,193897,106974,55181,51793,258182,129638,128544,27740,12758,14982,385697
114.524246215820312,36.591098785400391,1304,13,130421,,Handan,County,3,392608,198097,194511,94389,384512,191627,192885,103502,53397,50105,265491,134839,130652,23615,9861,13754,367475
113.66424560546875,36.563667297363281,1304,13,130426,,Shexian,County,3,383284,198958,184326,109396,369430,188746,180684,107421,57430,49991,255722,131507,124215,20141,10021,10120,370385
115.305709838867188,36.536941528320312,1304,13,130433,,Guantao,County,3,280877,141738,139139,72991,276185,138719,137466,67005,35381,31624,195145,97886,97259,18727,8471,10256,271449
114.945838928222656,36.476337432861328,1304,13,130432,ƽ,Guangping,County,3,244997,121778,123219,53003,243270,120869,122401,61800,31564,30236,166343,83002,83341,16854,7212,9642,241837
114.200386047363281,36.445751190185547,1304,13,130406,,Fengfengkuangqu,Qu,3,507347,272459,234888,130197,461013,231129,229884,109158,57803,51355,368508,200434,168074,29681,14222,15459,455916
114.696548461914062,36.437999725341797,1304,13,130424,ɰ,Chengan,County,3,352944,174891,178053,85728,349447,173028,176419,89020,45445,43575,239085,119535,119550,24839,9911,14928,343782
114.376289367675781,36.350864410400391,1304,13,130427,,Cixian,County,3,634470,322668,311802,150381,621744,312860,308884,165703,86930,78773,434802,220931,213871,33965,14807,19158,615169
114.934379577636719,36.3536376953125,1304,13,130434,κ,Weixian,County,3,778238,393294,384944,172768,773487,390514,382973,212070,111039,101031,519087,261394,257693,47081,20861,26220,769642
114.610359191894531,36.339252471923828,1304,13,130423,,Linzhang,County,3,572777,286853,285924,131332,564402,281812,282590,155653,80270,75383,383422,192866,190556,33702,13717,19985,560131
115.154594421386719,36.273532867431641,1304,13,130425,,Daming,County,3,713584,359567,354017,157879,702777,352942,349835,173102,91019,82083,492673,246678,245995,47809,21870,25939,702117
115.276344299316406,40.487117767333984,1307,13,130706,»԰,Xiahuayuan,Qu,3,68134,35420,32714,23845,66456,33935,32521,12761,6576,6185,49707,25901,23806,5666,2943,2723,58260
117.956352233886719,40.184040069580078,1302,13,130281,,Zunhua,City,3,683662,348121,335541,190708,669717,339720,329997,160335,82055,78280,471743,241211,230532,51584,24855,26729,651268
118.6895751953125,40.007976531982422,1302,13,130283,Ǩ,Qianan,City,3,632704,323330,309374,178124,623602,318201,305401,159711,83518,76193,427707,217793,209914,45286,22019,23267,601934
118.107353210449219,39.570568084716797,1302,13,130282,,Fengnan,City,3,550872,285442,265430,157479,527157,267024,260133,119270,61791,57479,387900,201674,186226,43702,21977,21725,513150
115.959281921386719,39.494915008544922,1306,13,130681,,Zhuozhou,City,3,546754,275834,270920,150100,531393,267447,263946,107045,55963,51082,401619,202282,199337,38090,17589,20501,474202
116.3955078125,39.108413696289062,1310,13,131081,,Bazhou,City,3,557901,285321,272580,142880,542916,275086,267830,141222,74809,66413,380817,193305,187512,35862,17207,18655,516388
116.095947265625,38.718372344970703,1309,13,130982,,Renqiu,City,3,768900,390649,378251,213593,745669,377662,368007,179255,93533,85722,536604,271213,265391,53041,25903,27138,715129
114.973724365234375,38.522022247314453,1306,13,130682,,Dingzhou,City,3,1107903,559214,548689,276896,1076121,541481,534640,258361,134134,124227,772215,390799,381416,77327,34281,43046,1043170
116.087509155273438,38.441627502441406,1309,13,130984,Ӽ,Hejian,City,3,757581,383621,373960,201608,746843,377592,369251,177029,92177,84852,524802,265247,259555,55750,26197,29553,721884
115.294952392578125,38.417217254638672,1306,13,130683,,Anguo,City,3,378830,189944,188886,100494,370105,186113,183992,77340,40592,36748,272502,136308,136194,28988,13044,15944,352946
117.354042053222656,38.376750946044922,1309,13,130983,,Huanghua,City,3,483273,251128,232145,137756,474410,245322,229088,127455,72971,54484,319858,160165,159693,35960,17992,17968,445806
114.660285949707031,38.351760864257812,1301,13,130184,,Xinle,City,3,439644,220811,218833,105429,427003,214294,212709,112198,57674,54524,300697,151631,149066,26749,11506,15243,420138
114.303390502929688,38.087924957275391,1301,13,130185,¹Ȫ,Luquan,City,3,397449,202340,195109,99997,374844,188430,186414,91642,47316,44326,277708,142535,135173,28099,12489,15610,339982
116.575614929199219,38.067249298095703,1309,13,130981,ͷ,Botou,City,3,550888,280209,270679,148197,532854,269706,263148,119821,63370,56451,399852,203016,196836,31215,13823,17392,519199
114.8326416015625,38.038864135742188,1301,13,130182,޻,Gaocheng,City,3,758269,380317,377952,183352,733584,366680,366904,198365,101060,97305,506915,256557,250358,52989,22700,30289,729858
115.030029296875,38.032367706298828,1301,13,130183,,Jinzhou,City,3,520942,265012,255930,132094,505837,257240,248597,131274,68981,62293,353173,179006,174167,36495,17025,19470,499486
115.533195495605469,38.016307830810547,1311,13,131182,,Shenzhou,City,3,568558,289086,279472,152193,555807,280299,275508,123985,64544,59441,394670,203096,191574,49903,21446,28457,548371
115.20172119140625,37.907676696777344,1301,13,130181,,Xinji,City,3,623219,314536,308683,165712,597397,299047,298350,138259,71529,66730,432372,218596,213776,52588,24411,28177,599609
115.551254272460938,37.569503784179688,1311,13,131181,,Jizhou,City,3,373825,187005,186820,108324,358753,178059,180694,83168,42391,40777,258777,131255,127522,31880,13359,18521,354179
115.376495361328125,37.360607147216797,1305,13,130581,Ϲ,Nangong,City,3,467356,234978,232378,120938,449744,224391,225353,117539,60468,57071,317086,160766,156320,32731,13744,18987,463222
114.49957275390625,36.855659484863281,1305,13,130582,ɳ,Shahe,City,3,474260,243171,231089,112077,454166,228375,225791,151250,78612,72638,296866,152380,144486,26144,12179,13965,442626
114.200920104980469,36.695079803466797,1304,13,130481,䰲,Wuan,City,3,720196,373108,347088,188920,696267,353310,342957,199750,107045,92705,481684,248311,233373,38762,17752,21010,667437
114.060527156312119,38.069151495503469,1301,13,130107,,Jingxingkuangqu,Qu,3,100545,50467,50078,31347,97182,48529,48653,21157,11106,10051,71733,35837,35896,7655,3524,4131,78584
119.601847455636474,39.921075351812704,1303,13,130302,,Haigang,Qu,3,584806,294287,290519,183931,527082,261600,265482,91538,47222,44316,458103,229833,228270,35165,17232,17933,410061
119.471329271039451,39.81792388334086,1303,13,130304,,Beidaihe,Qu,3,74282,36725,37557,23472,66157,32805,33352,12191,6278,5913,56622,27734,28888,5469,2713,2756,59329
115.450065347548332,38.878733485650677,1306,13,130602,,Xinshi,Qu,3,393351,196514,196837,113931,364646,180255,184391,63792,32591,31201,305732,152389,153343,23827,11534,12293,292206
115.855028693615978,39.326123848137847,1306,13,130684,߱,Gaobeidian,City,3,538582,268027,270555,132370,521178,259104,262074,124766,64867,59899,376200,185733,190467,37616,17427,20189,491325
114.891815062041516,40.813400231782062,1307,13,130702,Ŷ,Qiaodong,Qu,3,281044,140840,140204,94218,262291,129834,132457,46457,23722,22735,214009,106842,107167,20578,10276,10302,178131
114.87474317374128,40.821706838434224,1307,13,130703,,Qiaoxi,Qu,3,237049,117900,119149,79439,221648,110099,111549,39725,20453,19272,177650,87972,89678,19674,9475,10199,158065
117.930899110068495,40.959916313710082,1308,13,130802,˫,Shuangqiao,Qu,3,275061,137521,137540,79581,244196,121357,122839,43589,22572,21017,213672,106122,107550,17800,8827,8973,207625
117.733000298730673,40.942427516802589,1308,13,130803,˫,Shuangluan,Qu,3,93455,48475,44980,29315,90145,45803,44342,18190,9406,8784,69618,36165,33453,5647,2904,2743,82744
116.87222080784673,38.315850569284848,1309,13,130902,»,Xinhua,Qu,3,175898,87853,88045,53106,168082,83424,84658,35039,18209,16830,130898,64648,66250,9961,4996,4965,133961
116.837517567951664,38.293530792021357,1309,13,130903,˺,Yunhe,Qu,3,267663,135795,131868,73342,236592,117398,119194,49658,26049,23609,204585,103065,101520,13420,6681,6739,197404
116.672151021153539,39.503679005268431,1310,13,131002,,Anci,Qu,3,342057,174250,167807,85800,315857,159677,156180,72964,37395,35569,246595,125836,120759,22498,11019,11479,307885
116.67949758599805,39.527581827411517,1310,13,131003,,Guangyang,Qu,3,373331,188844,184487,104945,347264,174266,172998,73395,38065,35330,278157,139928,138229,21779,10851,10928,307696
115.705538430376336,37.733951115234944,1311,13,131102,ҳ,Taocheng,Qu,3,422761,212417,210344,116964,381628,190581,191047,83050,43168,39882,314374,158090,156284,25337,11159,14178,377526
114.529155167286817,38.041759783357897,1301,13,130102,,Changan,Qu,3,491074,249148,241926,135146,409112,201969,207143,68482,35028,33454,392210,198549,193661,30382,15571,14811,351589
114.493574438063931,38.035227270736847,1301,13,130103,Ŷ,Qiaodong,Qu,3,298668,155403,143265,84187,250524,124067,126457,41482,21286,20196,236698,124434,112264,20488,9683,10805,182320
114.468445554704473,38.04772405237248,1301,13,130105,»,Xinhua,Qu,3,362110,185923,176187,101674,300048,146849,153199,51617,26676,24941,287791,148561,139230,22702,10686,12016,228731
114.460969967449586,38.018884048559038,1301,13,130104,,Qiaoxi,Qu,3,279666,141353,138313,73719,218154,106348,111806,37238,19211,18027,225461,114171,111290,16967,7971,8996,176495
114.460923550580347,38.102451506343563,1301,13,130106,,Jiaoqu,Qu,3,437912,223182,214730,110648,363110,180438,182672,78052,40201,37851,338495,174061,164434,21365,8920,12445,252097
118.158183892744034,39.612030147270069,1302,13,130202,·,Lunan,Qu,3,330195,169172,161023,96488,303263,150938,152325,51624,26758,24866,253040,129886,123154,25531,12528,13003,268761
118.203883955569125,39.626272787472793,1302,13,130203,·,Lubei,Qu,3,567476,280749,286727,174613,519305,255773,263532,79547,40573,38974,445161,219692,225469,42768,20484,22284,464900
118.432590717800068,39.71980582748732,1302,13,130204,ұ,Guye,Qu,3,383209,193901,189308,123132,373307,186137,187170,59798,30377,29421,286967,146672,140295,36444,16852,19592,348323
114.481613415760279,36.619579867789909,1304,13,130403,̨,Congtai,Qu,3,302460,149410,153050,85636,275825,136097,139728,50495,26135,24360,232771,113999,118772,19194,9276,9918,228149
114.471373087670258,36.576351406935522,1304,13,130402,ɽ,Hanshan,Qu,3,284540,143450,141090,82083,258711,128093,130618,48422,25302,23120,219320,110056,109264,16798,8092,8706,210551
114.432661654443891,36.603715912101208,1304,13,130404,,Fuxing,Qu,3,235387,128563,106824,67037,208128,104457,103671,42611,22330,20281,182719,101271,81448,10057,4962,5095,176254
114.507465130032855,37.058065794582184,1305,13,130502,Ŷ,Qiaodong,Qu,3,219201,108316,110885,64324,200124,99430,100694,40265,20721,19544,167355,82196,85159,11581,5399,6182,141504
114.461239899128699,37.058015097258618,1305,13,130503,,Qiaoxi,Qu,3,317081,164345,152736,87681,280468,139731,140737,60662,31502,29160,242969,126112,116857,13450,6731,6719,239879
115.498161718356556,38.871624146608085,1306,13,130603,,Beishi,Qu,3,267657,136136,131521,67146,209189,102091,107098,38223,19481,18742,213012,109085,103927,16422,7570,8852,193120
115.513027213499484,38.849117250958358,1306,13,130604,,Nanshi,Qu,3,241488,122975,118513,64780,209685,103723,105962,38117,19581,18536,187248,95858,91390,16123,7536,8587,175648
115.048590423210186,40.60765150919152,1307,13,130705,,Xuanhua,Qu,3,317121,160888,156233,108736,303618,151819,151799,56980,29151,27829,239345,121045,118300,20796,10692,10104,231276
116.94092571767149,39.893020933220505,1310,13,131028,󳧻,Dachanghuizuzizhixian,County,3,112658,56839,55819,30177,109148,54599,54549,26218,13558,12660,77351,39338,38013,9089,3943,5146,103479
117.059171143020862,39.989095341316876,1310,13,131082,,Sanhe,City,3,456882,229788,227094,115642,424770,212945,211825,103021,53483,49538,319458,160763,158695,34403,15542,18861,411719
116.987731198538953,39.766153445606072,1310,13,131024,,Xianghe,County,3,308874,154698,154176,81505,302625,151300,151325,71617,36531,35086,210727,106279,104448,26530,11888,14642,289767
114.812975310769374,36.554926656772935,1304,13,130428,,Feixiang,County,3,308105,154329,153776,74307,305667,153028,152639,74366,37500,36866,210620,106791,103829,23119,10038,13081,304101
118.159189022779628,39.82852939453872,1302,13,130206,,Xinqu,Qu,3,164053,82003,82050,53150,156931,77340,79591,31176,16036,15140,121436,60173,61263,11441,5794,5647,141388
129.511993408203125,48.264469146728516,2307,23,230707,,Xinqing,Qu,3,50852,25788,25064,17646,50738,25686,25052,9504,4841,4663,38021,19149,18872,3327,1798,1529,46447
129.351333618164062,48.227497100830078,2307,23,230715,,Hongxing,Qu,3,25489,13040,12449,8833,25327,12892,12435,4645,2405,2240,18931,9604,9327,1913,1031,882,23832
123.920354505759335,47.339380472510143,2302,23,230202,ɳ,Longsha,Qu,3,342511,169737,172774,109814,332961,165336,167625,53109,27291,25818,265593,130226,135367,23809,12220,11589,278361
123.934752458850753,47.3729756963901,2302,23,230203,,Jianhua,Qu,3,236028,118033,117995,73889,218625,108752,109873,36386,18800,17586,183695,91289,92406,15947,7944,8003,193706
124.006282404072209,47.350653402571801,2302,23,230204,,Tiefeng,Qu,3,332341,167609,164732,103159,322851,161229,161622,50126,25935,24191,256472,128601,127871,25743,13073,12670,294831
122.901132215027559,47.522676092126829,2302,23,230207,ɽ,Nianzishan,Qu,3,82507,41805,40702,26962,41023,415,40608,13178,6716,6462,63135,31808,31327,6194,3281,2913,77616
130.928474694799519,45.296518775069586,2303,23,230302,,Jiguan,Qu,3,336078,170771,165307,101452,311322,156780,154542,53144,27940,25204,264780,133476,131304,18154,9355,8799,281622
130.282610828181333,47.312354766637512,2304,23,230402,,Xiangyang,Qu,3,96562,48138,48424,34148,96325,48024,48301,16559,8399,8160,72886,36123,36763,7117,3616,3501,82790
130.223566657925772,47.317816762009123,2304,23,230403,ũ,Gongnong,Qu,3,135973,68841,67132,44694,133634,67446,66188,22839,11859,10980,105558,52991,52567,7576,3991,3585,121141
130.2630279253151,47.289804952744213,2304,23,230404,ɽ,Nanshan,Qu,3,132464,68036,64428,43066,131742,67453,64289,24495,12534,11961,100239,51412,48827,7730,4090,3640,115713
130.343498002541708,47.31812714926312,2304,23,230406,ɽ,Dongshan,Qu,3,176946,90676,86270,55275,173618,89371,84247,31626,16323,15303,134160,68449,65711,11160,5904,5256,142667
130.249014625241955,47.351582660461794,2304,23,230407,ɽ,Xingshan,Qu,3,58587,30129,28458,20701,58415,30002,28413,10385,5333,5052,44403,22789,21614,3799,2007,1792,50604
131.13030838822948,46.6267116016991,2305,23,230502,ɽ,Jianshan,Qu,3,190485,95983,94502,60954,185194,93193,92001,33498,17406,16092,146086,72936,73150,10901,5641,5260,159840
125.069477749500294,46.616338628768169,2306,23,230602,ͼ,Saertu,Qu,3,313526,162153,151373,102556,282682,142076,140606,49990,25843,24147,251687,130041,121646,11849,6269,5580,174953
128.893576140574964,47.725797548502307,2307,23,230702,,Yichun,Qu,3,144562,72074,72488,46990,138248,69186,69062,22937,11817,11120,112191,55473,56718,9434,4784,4650,117607
129.240969498104334,48.121483760983025,2307,23,230710,Ӫ,Wuying,Qu,3,40707,20734,19973,14416,40599,20643,19956,7264,3789,3475,30436,15338,15098,3007,1607,1400,36608
129.421082710044374,48.596982640504685,2307,23,230714,,Wuyiling,Qu,3,24743,12774,11969,8669,24583,12631,11952,4470,2323,2147,18641,9569,9072,1632,882,750,21671
130.820795274051932,45.837940778705274,2309,23,230902,,Xinxing,Qu,3,195352,101318,94034,59734,194610,100759,93851,41944,21673,20271,145479,75623,69856,7929,4022,3907,118653
130.89574840313,45.761988274572843,2309,23,230903,ɽ,Taoshan,Qu,3,157484,82247,75237,47634,147927,75089,72838,30679,15818,14861,121517,63834,57683,5288,2595,2693,102300
129.604932510702128,44.564341752834849,2310,23,231002,,Dongan,Qu,3,185506,93587,91919,61279,180793,89921,90872,28704,14755,13949,143744,72511,71233,13058,6321,6737,179334
129.641412551370138,44.597416989707177,2310,23,231003,,Yangming,Qu,3,163290,82711,80579,52125,158733,80071,78662,26576,13825,12751,125610,63323,62287,11104,5563,5541,159656
129.591313295519399,44.621250616276953,2310,23,231004,,Aimin,Qu,3,271779,136090,135689,81826,246841,124044,122797,39977,20526,19451,214657,106856,107801,17145,8708,8437,250891
129.551675451331079,44.571326160621069,2310,23,231005,,Xian,Qu,3,186619,93242,93377,59471,180262,89893,90369,28964,14851,14113,144029,71722,72307,13626,6669,6957,146333
127.417667322258652,50.23896826966719,2311,23,231102,,Aihui,Qu,3,192764,97488,95276,61675,186332,93887,92445,35886,18391,17495,146936,74072,72864,9942,5025,4917,148404
126.967062021716629,46.60205740037788,2312,23,231202,,Beilin,Qu,3,800207,405382,394825,226350,789133,399195,389938,159902,82846,77056,597815,301403,296412,42490,21133,21357,742799
123.626643013486429,52.018079684146748,2327,23,232704,,Huzhong,Qu,3,44546,22986,21560,14771,44182,22708,21474,8231,4256,3975,34643,17901,16742,1672,829,843,38628
124.394061154249442,51.695885206135145,2327,23,232703,,Xinlin,Qu,3,50083,25751,24332,16889,49828,25585,24243,9689,5004,4685,38265,19599,18666,2129,1148,981,44025
129.565677934146521,48.449752023878148,2307,23,230712,,Tangwanghe,Qu,3,35905,18282,17623,12459,35812,18209,17603,6653,3423,3230,27058,13705,13353,2194,1154,1040,32131
130.38540384030776,46.788218287066513,2308,23,230804,ǰ,Qianjin,Qu,3,155331,77139,78192,46190,140028,69451,70577,22350,11514,10836,122321,60157,62164,10660,5468,5192,143744
130.406776795188563,46.837761594502524,2308,23,230805,,Dongfeng,Qu,3,109587,54912,54675,35876,107982,54072,53910,17776,9210,8566,84625,41984,42641,7186,3718,3468,92232
130.404822430233025,46.775613040909889,2308,23,230803,,Xiangyang,Qu,3,113414,55075,58339,32801,95183,47056,48127,15209,7838,7371,91093,43732,47361,7112,3505,3607,96104
130.349726358813371,46.826998289606507,2308,23,230802,,Yonghong,Qu,3,175624,87660,87964,59392,173996,86941,87055,29751,15397,14354,134456,66567,67889,11417,5696,5721,140424
130.096761622258356,46.677092944805743,2308,23,230811,,Jiaoqu,Qu,3,305988,158583,147405,93233,302192,155147,147045,59893,30937,28956,231675,120144,111531,14420,7502,6918,241705
124.110162386319089,50.422028494664168,2327,23,232701,Ӹ,Jiagedaji,Qu,3,140605,71978,68627,44866,137195,69547,67648,24569,12768,11801,108845,55429,53416,7191,3781,3410,107481
124.283829468825871,50.803415028796714,2327,23,232702,,Songling,Qu,3,36292,18614,17678,11782,36172,18524,17648,7292,3760,3532,27678,14132,13546,1322,722,600,30793
126.491264343261719,48.243183135986328,2311,23,231181,,Beian,City,3,442474,226743,215731,142450,435207,221258,213949,82145,41905,40240,336677,172079,164598,23652,12759,10893,395789
132.524871826171875,47.655132293701172,2308,23,230881,ͬ,Tongjiang,City,3,164595,85426,79169,51816,163203,84419,78784,34472,17979,16493,124208,64220,59988,5915,3227,2688,141274
126.933883666992188,47.457500457763672,2312,23,231283,,Hailun,City,3,720008,368751,351257,194880,715560,366086,349474,146325,74793,71532,539250,275939,263311,34433,18019,16414,693544
132.018539428710938,47.249191284179688,2308,23,230882,,Fujin,City,3,420579,215650,204929,123677,419376,214856,204520,85703,44406,41297,315372,161024,154348,19504,10220,9284,383282
127.982627868652344,46.989025115966797,2307,23,230781,,Tieli,City,3,354601,181024,173577,114706,353610,180356,173254,67686,34969,32717,264775,134327,130448,22140,11728,10412,321063
125.348778881676694,46.400499657884644,2312,23,231281,,Anda,City,3,473091,243349,229742,141285,463989,237196,226793,94784,49090,45694,356304,182766,173538,22003,11493,10510,423956
125.98175048828125,46.063438415527344,2312,23,231282,ض,Zhaodong,City,3,832657,424694,407963,227308,828777,422244,406533,179815,93108,86707,614490,311842,302648,38352,19744,18608,796939
126.959335327148438,45.520961761474609,2301,23,230181,,Acheng,City,3,638894,327774,311120,190145,625227,318504,306723,116660,60074,56586,488014,250502,237512,34220,17198,17022,567097
131.775588989257812,45.576747894287109,2303,23,230382,ɽ,Mishan,City,3,438277,224565,213712,134023,425744,217528,208216,78389,40398,37991,334793,171049,163744,25095,13118,11977,388925
126.303352355957031,45.348514556884766,2301,23,230182,˫,Shuangcheng,City,3,749182,382673,366509,209621,743073,378850,364223,153817,79578,74239,555790,283695,272095,39575,19400,20175,720621
127.952018737792969,45.204421997070312,2301,23,230183,־,Shangzhi,City,3,582764,298966,283798,173151,578273,296406,281867,117931,60275,57656,433327,222120,211207,31506,16571,14935,538025
131.157440185546875,44.406414031982422,2310,23,231081,Һ,Suifenhe,City,3,69052,35945,33107,22494,66172,33818,32354,13090,6774,6316,53579,27983,25596,2383,1188,1195,47234
126.172012329101562,48.501861572265625,2311,23,231182,,Wudalianchi,City,3,338689,176002,162687,107551,331997,170259,161738,67443,34805,32638,254556,131873,122683,16690,9324,7366,302920
128.99542236328125,47.965061187744141,2307,23,230716,ϸ,Shangganling,Qu,3,22956,11634,11322,8163,22925,11605,11320,4080,2095,1985,16846,8430,8416,2030,1109,921,21445
128.787887573242188,47.827129364013672,2307,23,230704,Ѻ,Youhao,Qu,3,67648,34393,33255,24040,67092,34066,33026,11423,5999,5424,50269,25207,25062,5956,3187,2769,60163
128.630905151367188,47.721805572509766,2307,23,230706,,Cuiluan,Qu,3,49706,25167,24539,17030,49583,25072,24511,9406,4782,4624,36723,18424,18299,3577,1961,1616,44738
128.74920654296875,47.695995330810547,2307,23,230711,,Wumahe,Qu,3,37104,18932,18172,12303,36971,18832,18139,6292,3252,3040,27910,14227,13683,2902,1453,1449,30540
129.090560913085938,47.623584747314453,2307,23,230708,Ϫ,Meixi,Qu,3,41634,21398,20236,14151,41617,21382,20235,7343,3873,3470,31056,15780,15276,3235,1745,1490,38152
129.265243530273438,47.460563659667969,2307,23,230705,,Xilin,Qu,3,48054,24710,23344,17135,47890,24575,23315,8143,4280,3863,36835,18847,17988,3076,1583,1493,43727
129.388763427734375,47.395610809326172,2307,23,230709,ɽ,Jinshantun,Qu,3,46318,23653,22665,16370,46205,23550,22655,8223,4243,3980,34724,17586,17138,3371,1824,1547,43569
123.752388000488281,47.308124542236328,2302,23,230208,÷˹Ӷ,Meilisidawoerzu,Qu,3,170293,87876,82417,53252,168938,86908,82030,32326,16488,15838,128886,66582,62304,9081,4806,4275,158455
130.209981247379829,47.252045881661161,2304,23,230405,˰,Xingan,Qu,3,94108,48442,45666,31300,93856,48257,45599,17028,8708,8320,72004,37046,34958,5076,2688,2388,78974
123.624725341796875,47.200511932373047,2302,23,230206,,Fulaerji,Qu,3,285762,144870,140892,93738,278586,140130,138456,46214,23722,22492,218618,110007,108611,20930,11141,9789,254796
123.809295654296875,47.155754089355469,2302,23,230205,Ϫ,Angangxi,Qu,3,90647,46261,44386,28912,89849,45679,44170,15144,7798,7346,69548,35440,34108,5955,3023,2932,82647
129.248733520507812,47.120517730712891,2307,23,230703,ϲ,Nancha,Qu,3,140846,71594,69252,47921,139137,70560,68577,23321,12006,11315,106530,53869,52661,10995,5719,5276,129614
128.975143432617188,47.013416290283203,2307,23,230713,,Dailing,Qu,3,37492,18898,18594,13147,37322,18801,18521,6392,3292,3100,28167,14108,14059,2933,1498,1435,33492
124.831898675305766,46.638729710078081,2306,23,230604,ú·,Ranghulu,Qu,3,428092,217293,210799,144039,405642,203810,201832,73459,38342,35117,338059,170002,168057,16574,8949,7625,332592
131.331588745117188,46.588157653808594,2305,23,230505,ķ̨,Sifangtai,Qu,3,68346,35432,32914,22422,68131,35228,32903,13251,6878,6373,51283,26542,24741,3812,2012,1800,57777
131.393997192382812,46.574123382568359,2305,23,230506,ɽ,Baoshan,Qu,3,147219,75562,71657,48933,146263,74810,71453,27566,14147,13419,111174,56896,54278,8479,4519,3960,126664
131.135025024414062,46.545299530029297,2305,23,230503,붫,Lingdong,Qu,3,81244,41565,39679,27038,80677,41318,39359,14719,7515,7204,59872,30436,29436,6653,3614,3039,65352
125.140468064065757,46.492046518746655,2306,23,230603,,Longfeng,Qu,3,233881,119907,113974,78211,223942,112538,111404,42633,21958,20675,181182,92777,88405,10066,5172,4894,160430
124.929695129394531,46.397891998291016,2306,23,230605,,Honggang,Qu,3,170972,87163,83809,57931,164812,82984,81828,30802,15984,14818,134224,68008,66216,5946,3171,2775,125057
124.809524536132812,46.031478881835938,2306,23,230606,ͬ,Datong,Qu,3,233580,118249,115331,70695,231454,116833,114621,53080,27130,25950,170589,86035,84554,9911,5084,4827,205432
131.03033447265625,45.79376220703125,2309,23,230904,Ӻ,Qiezihe,Qu,3,133868,70935,62933,47346,131677,68901,62776,29678,15405,14273,99298,52968,46330,4892,2562,2330,85766
126.617469787597656,45.590915679931641,2301,23,230108,ƽ,Pingfang,Qu,3,172011,86714,85297,58150,169825,85130,84695,26375,13611,12764,132901,66305,66596,12735,6798,5937,137384
130.73016357421875,45.370311737060547,2303,23,230304,ε,Didao,Qu,3,121216,62424,58792,41631,121130,62359,58771,19655,10292,9363,92691,47482,45209,8870,4650,4220,115086
130.962783813476562,45.347328186035156,2303,23,230306,Ӻ,Chengzihe,Qu,3,146449,75750,70699,48457,144872,74402,70470,25479,13263,12216,111804,57656,54148,9166,4831,4335,125714
130.868072509765625,45.216606140136719,2303,23,230303,ɽ,Hengshan,Qu,3,177109,91735,85374,60315,176715,91379,85336,29804,15378,14426,133866,69227,64639,13439,7130,6309,162536
130.491119384765625,45.207065582275391,2303,23,230307,ɽ,Mashan,Qu,3,34500,17847,16653,11093,34445,17797,16648,5874,3008,2866,26161,13562,12599,2465,1277,1188,32898
130.667104239718327,45.076946741537348,2303,23,230305,,Lishu,Qu,3,95430,49020,46410,31920,95313,48917,46396,15732,8133,7599,72467,37102,35365,7231,3785,3446,90485
122.5245361328125,52.971099853515625,2327,23,232723,Į,Mohe,County,3,80982,41941,39041,26516,80026,41150,38876,16619,8637,7982,61692,31900,29792,2671,1404,1267,67039
124.698005676269531,52.343669891357422,2327,23,232722,,Tahe,County,3,93194,47831,45363,30295,92195,46989,45206,18619,9552,9067,70752,36215,34537,3823,2064,1759,75288
126.639434814453125,51.720142364501953,2327,23,232721,,Huma,County,3,60140,31391,28749,18912,59138,30598,28540,11998,6216,5782,45678,23916,21762,2464,1259,1205,44410
128.489456176757812,49.578174591064453,2311,23,231123,ѷ,Xunke,County,3,101816,52628,49188,31967,70669,21646,49023,21807,11127,10680,75571,39132,36439,4438,2369,2069,84604
127.289848327636719,49.420074462890625,2311,23,231124,,Sunwu,County,3,95867,49549,46318,30297,95096,48895,46201,20452,10513,9939,71451,36949,34502,3964,2087,1877,75219
125.223846435546875,49.16387939453125,2311,23,231121,۽,Nenjiang,County,3,500201,256514,243687,159020,498285,254997,243288,95579,49087,46492,380385,194233,186152,24237,13194,11043,453271
130.35260009765625,48.847198486328125,2307,23,230722,,Jiayin,County,3,81004,42033,38971,25264,79965,41183,38782,16623,8646,7977,60860,31565,29295,3521,1822,1699,68585
124.865921020507812,48.472450256347656,2302,23,230281,ګ,Nehe,City,3,672295,343873,328422,197918,667593,340480,327113,132529,68011,64518,505500,257530,247970,34266,18332,15934,649726
134.267898559570312,48.367725372314453,2308,23,230833,Զ,Fuyuan,County,3,77474,40167,37307,23700,77031,39823,37208,16764,8737,8027,58205,30108,28097,2505,1322,1183,64413
126.214515686035156,48.0318603515625,2302,23,230230,˶,Kedong,County,3,264563,135582,128981,77588,262995,134473,128522,53936,27527,26409,198375,101303,97072,12252,6752,5500,258670
125.832649230957031,48.031093597412109,2302,23,230229,ɽ,Keshan,County,3,450687,230253,220434,130965,445028,227184,217844,90358,46847,43511,337613,171296,166317,22716,12110,10606,435058
123.518692016601562,47.910236358642578,2302,23,230225,,Gannan,County,3,360555,184896,175659,105659,358077,183512,174565,72693,37362,35331,270518,138104,132414,17344,9430,7914,349888
125.2635498046875,47.888320922851562,2302,23,230223,,Yian,County,3,447706,229113,218593,133739,445199,227425,217774,92612,47207,45405,332780,169764,163016,22314,12142,10172,434931
124.44976806640625,47.801769256591797,2302,23,230227,ԣ,Fuyu,County,3,284964,146297,138667,87055,281200,143328,137872,55402,28338,27064,215603,110577,105026,13959,7382,6577,268818
126.051513671875,47.598175048828125,2302,23,230231,Ȫ,Baiquan,County,3,517996,266132,251864,144403,517072,265392,251680,111368,57336,54032,382118,195346,186772,24510,13450,11060,509055
130.793716430664062,47.564624786376953,2304,23,230421,ܱ,Luobei,County,3,228353,116717,111636,74784,223862,113999,109863,43098,22116,20982,171660,87197,84463,13595,7404,6191,193328
123.200614929199219,47.342124938964844,2302,23,230221,,Longjiang,County,3,570606,293328,277278,162651,566673,290925,275748,116576,59529,57047,423397,217744,205653,30633,16055,14578,547317
131.835800170898438,47.287429809570312,2304,23,230422,,Suibin,County,3,176086,90363,85723,55047,174440,89315,85125,36810,18845,17965,129480,65980,63500,9796,5538,4258,160455
127.105728149414062,47.240325927734375,2312,23,231226,,Suileng,County,3,294955,150994,143961,88910,294482,150608,143874,57922,30220,27702,221933,112625,109308,15100,8149,6951,272680
124.794038013199838,47.181976318359375,2306,23,230623,ֵ,Lindian,County,3,228630,116385,112245,69352,227465,115652,111813,50663,25920,24743,167088,84686,82402,10879,5779,5100,219434
125.853065490722656,47.173919677734375,2312,23,231225,ˮ,Mingshui,County,3,294482,151035,143447,80490,293661,150372,143289,69631,36435,33196,210854,107151,103703,13997,7449,6548,287122
130.691726684570312,47.005836486816406,2308,23,230826,봨,Huachuan,County,3,185412,95096,90316,56068,184505,94569,89936,37277,19251,18026,138705,70917,67788,9430,4928,4502,174978
127.471321105957031,46.876853942871094,2312,23,231224,찲,Qingan,County,3,358363,183687,174676,101259,355109,181947,173162,73116,38038,35078,269297,137522,131775,15950,8127,7823,345636
124.421175449486299,46.859660726866018,2306,23,230624,Ŷɹ,Duerbotemengguzuzizhixian,County,3,220531,112953,107578,65951,218383,111417,106966,46080,23425,22655,163616,84079,79537,10835,5449,5386,210853
126.474769592285156,46.833145141601562,2312,23,231221,,Wangkui,County,3,442867,226700,216167,120186,441698,225993,215705,88975,46165,42810,330537,168347,162190,23355,12188,11167,433252
134.01313435195155,46.795746082453377,2305,23,230524,ĺ,Raohe,County,3,150007,78131,71876,48965,148441,76946,71495,29741,15321,14420,113068,58855,54213,7198,3955,3243,115698
131.806320190429688,46.780399322509766,2305,23,230522,,Youyi,County,3,110033,56421,53612,37578,137547,84964,52583,17973,9321,8652,84160,42651,41509,7900,4449,3451,92070
131.117630004882812,46.715354919433594,2305,23,230521,,Jixian,County,3,301932,155707,146225,92908,297387,152359,145028,57338,29624,27714,227890,117400,110490,16704,8683,8021,261594
129.853713989257812,46.720756530761719,2308,23,230828,ԭ,Tangyuan,County,3,228405,118325,110080,70467,225352,115730,109622,43629,22401,21228,171388,88889,82499,13388,7035,6353,224631
126.116607666015625,46.681449890136719,2312,23,231223,,Qinggang,County,3,410534,210749,199785,112595,409565,210161,199404,89853,46536,43317,300982,153925,147057,19699,10288,9411,395557
123.410736083984375,46.389175415039062,2302,23,230224,̩,Tailai,County,3,310160,162020,148140,90498,301359,154361,146998,59135,30251,28884,233423,122665,110758,17602,9104,8498,298287
132.214996337890625,46.337440490722656,2305,23,230523,,Baoqing,County,3,399083,204472,194611,121721,395572,202380,193192,84438,43481,40957,290988,148084,142904,23657,12907,10750,350479
129.559310913085938,46.321563720703125,2301,23,230123,,Yilan,County,3,364108,187045,177063,104918,194331,18576,175755,74325,38307,36018,271432,139080,132352,18351,9658,8693,345850
126.286949157714844,46.254039764404297,2312,23,231222,,Lanxi,County,3,428377,220028,208349,117047,425943,218740,207203,96460,51695,44765,310758,157437,153321,21159,10896,10263,400198
130.557601928710938,46.229042053222656,2308,23,230822,,Huanan,County,3,421901,217361,204540,121421,417522,214524,202998,86435,44606,41829,314089,161486,152603,21377,11269,10108,401107
127.378082275390625,46.071315765380859,2301,23,230126,,Bayan,County,3,611556,311342,300214,165503,608964,309625,299339,139533,71606,67927,443430,225482,217948,28593,14254,14339,587679
126.587905883789062,45.972469329833984,2301,23,230121,,Hulan,County,3,632204,321316,310888,181858,625476,318118,307358,124181,64111,60070,476592,241765,234827,31431,15440,15991,589486
128.750848607032566,45.974893765556303,2301,23,230128,ͨ,Tonghe,County,3,203515,104722,98793,62471,1138849,1040202,98647,41040,21358,19682,151394,77461,73933,11081,5903,5178,190758
128.004348754882812,45.946216583251953,2301,23,230127,ľ,Mulan,County,3,258972,133315,125657,75807,257423,132529,124894,53962,27704,26258,192753,99039,93714,12257,6572,5685,249724
128.808334350585938,45.851799011230469,2301,23,230124,,Fangzheng,County,3,225513,116301,109212,64707,224234,115224,109010,46264,23736,22528,167739,86285,81454,11510,6280,5230,194300
132.942459106445312,45.770717620849609,2303,23,230381,,Hulin,City,3,311509,160842,150667,102230,308810,158936,149874,56984,29587,27397,235937,120527,115410,18588,10728,7860,251409
127.460861206054688,45.746604919433594,2301,23,230125,,Binxian,County,3,538710,276729,261981,154156,534066,273918,260148,102616,53494,49122,407007,207961,199046,29087,15274,13813,514597
130.50958251953125,45.763446807861328,2309,23,230921,,Boli,County,3,320736,164495,156241,96780,317500,162255,155245,62720,32167,30553,238927,122418,116509,19089,9910,9179,290077
125.28570556640625,45.703227996826172,2306,23,230621,,Zhaozhou,County,3,371451,189004,182447,104905,368624,187319,181305,82796,42903,39893,270630,136931,133699,18025,9170,8855,356756
125.099266052246094,45.516269683837891,2306,23,230622,Դ,Zhaoyuan,County,3,377388,192958,184430,106790,372207,188731,183476,82589,42440,40149,275124,140582,134542,19675,9936,9739,357101
128.304061889648438,45.454566955566406,2301,23,230129,,Yanshou,County,3,237655,122870,114785,68774,236353,122098,114255,49543,25384,24159,176817,91348,85469,11295,6138,5157,222321
130.23272705078125,45.294143676757812,2310,23,231025,ֿ,Linkou,County,3,418136,216005,202131,122552,414931,213626,201305,79850,40812,39038,312938,161883,151055,25348,13310,12038,400494
131.093521118164062,45.258838653564453,2303,23,230321,,Jidong,County,3,285489,148578,136911,85389,280385,144040,136345,56063,28662,27401,213767,111812,101955,15659,8104,7555,245542
130.495346069335938,44.916923522949219,2310,23,231085,,Muleng,City,3,310096,158623,151473,94236,309615,158212,151403,59573,30670,28903,231688,118186,113502,18835,9767,9068,303968
127.146415710449219,44.898670196533203,2301,23,230184,峣,Wuchang,City,3,888782,454587,434195,250256,882040,451183,430857,183739,94479,89260,658419,336708,321711,46624,23400,23224,838114
129.370071411132812,44.586097717285156,2310,23,231083,,Hailin,City,3,435677,222525,213152,138238,432194,220358,211836,74023,38010,36013,332375,169478,162897,29279,15037,14242,429445
129.471237182617188,44.327552795410156,2310,23,231084,,Ningan,City,3,437328,223201,214127,130249,432342,219879,212463,79071,40581,38490,331484,169429,162055,26773,13191,13582,426038
131.142181396484375,44.046001434326172,2310,23,231024,,Dongning,County,3,207012,106370,100642,65190,203799,104018,99781,40703,20924,19779,153219,78876,74343,13090,6570,6520,192463
126.603142945893936,45.743023338929525,2301,23,230102,,Daoli,Qu,3,748313,375690,372623,239810,713980,353219,360761,107897,55848,52049,579761,291059,288702,60655,28783,31872,550649
126.696045688247494,45.760185196126805,2301,23,230103,ϸ,Nangang,Qu,3,977432,494414,483018,283633,838624,414316,424308,126162,65466,60696,782096,394712,387384,69174,34236,34938,708893
126.615060337662328,45.788973024655597,2301,23,230104,,Daowai,Qu,3,383718,191762,191956,126958,369305,183314,185991,54155,28002,26153,298125,149568,148557,31438,14192,17246,296211
126.749984742329616,45.822241981764456,2301,23,230105,̫ƽ,Taiping,Qu,3,421806,214802,207004,134132,404601,203454,201147,65121,33828,31293,327447,166466,160981,29238,14508,14730,270907
126.75994811727864,45.729385056134092,2301,23,230106,㷻,Xiangfang,Qu,3,367382,184902,182480,111558,340357,170157,170200,55067,28655,26412,288341,144163,144178,23974,12084,11890,255308
126.629476793723029,45.712763335456614,2301,23,230107,,Dongli,Qu,3,410842,211325,199517,123121,367433,184497,182936,54650,28235,26415,327156,167987,159169,29036,15103,13933,304575
113.156242130614174,35.24513903572133,4108,41,410803,"վ",Zhongzhanqu,Qu,3,110995,57455,53540,29113,107637,54446,53191,24168,12763,11405,78595,40977,37618,8232,3715,4517,86294
113.322141474762972,35.274012559321939,4108,41,410804,"",Macunqu,Qu,3,128842,68673,60169,31345,121807,61962,59845,32327,17272,15055,88480,47542,40938,8035,3859,4176,111478
113.281471252441406,34.816905975341797,4101,41,410106,"Ͻ",Shangjiequ,Qu,3,77014,39370,37644,25450,73190,36623,36567,14616,7566,7050,57009,29097,27912,5389,2707,2682,57765
114.122642517089844,32.101341247558594,4115,41,411503,"ƽ",Pinqiaoqu,Qu,3,694088,357399,336689,213403,686204,351044,335160,183390,97314,86076,463844,238171,225673,46854,21914,24940,628357
112.601821899414062,34.901260375976562,4103,41,410306,"",Jiliqu,Qu,3,70593,36464,34129,19940,65848,32922,32926,14804,7635,7169,51847,27086,24761,3942,1743,2199,57694
115.493728637695312,35.90814208984375,4109,41,410926,"",Fanxian,County,3,479818,249314,230504,120352,473524,244427,229097,125686,70087,55599,323149,165728,157421,30983,13499,17484,453799
115.200668334960938,36.074424743652344,4109,41,410923,"",Nanle,County,3,468360,236898,231462,111694,466274,235602,230672,124181,65134,59047,307839,154977,152862,36340,16787,19553,462860
113.81585693359375,36.068801879882812,4105,41,410581,"",Linzhou,City,3,982254,501659,480595,260421,975310,497311,477999,269228,145410,123818,655542,330827,324715,57484,25422,32062,936283
115.847824096679688,36.000911712646484,4109,41,410927,"̨ǰ",Taiqian,County,3,325872,166116,159756,82392,324716,165386,159330,84528,46974,37554,218708,109044,109664,22636,10098,12538,318751
114.898391723632812,35.950855255126953,4105,41,410527,"ڻ",Neihuang,County,3,678730,346338,332392,168658,673399,342186,331213,181272,97346,83926,448057,226903,221154,49401,22089,27312,668198
114.352691650390625,35.914340972900391,4105,41,410523,"",Tangyin,County,3,432806,217165,215641,112253,430121,215304,214817,113559,59622,53937,290833,146029,144804,28414,11514,16900,418803
115.108009338378906,35.902671813964844,4109,41,410922,"",Qingfeng,County,3,654160,332684,321476,163721,650429,330173,320256,168021,89882,78139,436796,220558,216238,49343,22244,27099,638709
114.544319152832031,35.668384552001953,4106,41,410621,"",Junxian,County,3,656550,335475,321075,160962,653162,332981,320181,193036,105181,87855,420183,211225,208958,43331,19069,24262,633284
114.197410583496094,35.600353240966797,4106,41,410622,"",Qixian,County,3,249986,127925,122061,64332,247328,126159,121169,70301,38807,31494,165131,82793,82338,14554,6325,8229,231609
114.515884399414062,35.577438354492188,4105,41,410526,"",Huaxian,County,3,1182162,594958,587204,304791,1177549,592806,584743,314982,163708,151274,780918,392159,388759,86262,39091,47171,1161568
113.649040222167969,35.266094207763672,4107,41,410724,"",Huojia,County,3,381227,193344,187883,89890,379189,191879,187310,104314,55741,48573,250208,126003,124205,26705,11600,15105,362550
113.428741455078125,35.229164123535156,4108,41,410821,"",Xiuwu,County,3,274418,142612,131806,65273,268845,137403,131442,76351,41827,34524,179491,92433,87058,18576,8352,10224,254588
114.691871643066406,35.192264556884766,4107,41,410728,"ԫ",Changyuan,County,3,765740,392362,373378,183724,762312,390372,371940,206426,112857,93569,507885,257373,250512,51429,22132,29297,755124
113.062484741210938,35.165843963623047,4108,41,410822,"",Boai,County,3,419228,214606,204622,102247,415478,211392,204086,113614,62208,51406,275818,139492,136326,29796,12906,16890,378933
114.197731018066406,35.141746520996094,4107,41,410726,"ӽ",Yanjin,County,3,457771,232048,225723,112294,455595,230588,225007,119161,62976,56185,305114,153853,151261,33496,15219,18277,448829
113.383316040039062,35.094825744628906,4108,41,410823,"",Wuzhi,County,3,642544,326411,316133,147511,638991,324132,314859,195115,105680,89435,400833,200648,200185,46596,20083,26513,608498
113.958908081054688,35.049919128417969,4107,41,410725,"ԭ",Yuanyang,County,3,642409,329003,313406,147038,641574,328437,313137,185021,100462,84559,409682,207051,202631,47706,21490,26216,631471
114.417976379394531,35.039676666259766,4107,41,410727,"",Fengqiu,County,3,719510,367737,351773,169498,712842,363446,349396,194381,104085,90296,472611,240216,232395,52518,23436,29082,703680
113.073432922363281,34.933036804199219,4108,41,410825,"",Wenxian,County,3,404621,203586,201035,97058,402037,201697,200340,112570,59627,52943,262221,131436,130785,29830,12523,17307,381656
112.7838134765625,34.895050048828125,4108,41,410883,"",Mengzhou,City,3,354302,178658,175644,90324,348936,174276,174660,91912,47335,44577,235182,119835,115347,27208,11488,15720,319844
112.436737060546875,34.823223114013672,4103,41,410322,"Ͻ",Mengjin,County,3,418065,211552,206513,111192,410137,205290,204847,108869,55833,53036,276627,141970,134657,32569,13749,18820,390640
114.81011962890625,34.826515197753906,4102,41,410225,"",Lankao,County,3,718177,367048,351129,173223,715520,365245,350275,214767,115576,99191,455885,230785,225100,47525,20687,26838,704405
113.351463317871094,34.788188934326172,4101,41,410182,"",Xingyang,City,3,619840,316049,303791,162363,602742,304766,297976,155538,80983,74555,414667,212509,202158,49635,22557,27078,576119
111.124870300292969,34.723793029785156,4112,41,411222,"",Shanxian,County,3,343863,181689,162174,91494,329049,169368,159681,81644,42824,38820,239522,128040,111482,22697,10825,11872,319732
112.964889526367188,34.757144927978516,4101,41,410181,"",Gongyi,City,3,777202,395784,381418,192096,758378,381026,377352,217010,110883,106127,501341,258640,242701,58851,26261,32590,711390
111.766311645507812,34.76519775390625,4112,41,411221,"ų",Mianchi,County,3,328947,172870,156077,84877,309568,157817,151751,77314,40272,37042,231740,123306,108434,19893,9292,10601,302334
114.427902221679688,34.756832122802734,4102,41,410224,"",Kaifeng,County,3,705080,359916,345164,173438,701063,357036,344027,199818,105627,94191,452796,231422,221374,52466,22867,29599,692356
112.14227294921875,34.723915100097656,4103,41,410323,"°",Xinan,County,3,481740,249898,231842,123806,469870,240417,229453,135347,70688,64659,315119,164961,150158,31274,14249,17025,460080
114.025238037109375,34.729045867919922,4101,41,410122,"Ĳ",Zhongmu,County,3,673058,347238,325820,164793,659387,338633,320754,185097,99698,85399,438160,225675,212485,49801,21865,27936,648849
112.784004211425781,34.721988677978516,4103,41,410381,"ʦ",Yanshi,City,3,816026,414890,401136,197044,793475,401125,392350,227617,121761,105856,527332,267532,259800,61077,25597,35480,773333
115.139808654785156,34.654659271240234,4114,41,411421,"Ȩ",Minquan,County,3,805063,411311,393752,197258,800941,409171,391770,264732,141463,123269,487214,246724,240490,53117,23124,29993,796374
114.774482727050781,34.553512573242188,4102,41,410221,"",Qixian,County,3,1002592,513437,489155,251596,1002001,513013,488988,287101,156224,130877,640293,324349,315944,75198,32864,42334,992076
110.874526977539062,34.522430419921875,4112,41,411282,"鱦",Lingbao,City,3,722890,377872,345018,181820,701938,361409,340529,185709,98210,87499,493217,259610,233607,43964,20052,23912,673190
113.362654247398439,34.520954856185583,4101,41,410183,"",Xinmi,City,3,779014,406291,372723,192924,759249,389180,370069,213372,113330,100042,509777,266873,242904,55865,26088,29777,725521
112.166236877441406,34.506622314453125,4103,41,410327,"",Yiyang,County,3,650356,335634,314722,157766,645246,331619,313627,189176,99838,89338,421005,217695,203310,40175,18101,22074,627113
114.460090637207031,34.470943450927734,4102,41,410222,"ͨ",Tongxu,County,3,552363,282598,269765,137188,550220,281241,268979,150252,81248,69004,361547,183121,178426,40564,18229,22335,544366
113.030715942382812,34.455818176269531,4101,41,410185,"Ƿ",Dengfeng,City,3,609085,321081,288004,147333,585410,300314,285096,159664,85967,73697,408201,216014,192187,41220,19100,22120,576795
115.320449829101562,34.445976257324219,4114,41,411423,"",Ningling,County,3,562794,289148,273646,143244,562147,288712,273435,163492,89409,74083,359926,182671,177255,39376,17068,22308,554756
115.060897827148438,34.428470611572266,4114,41,411422,"",Suixian,County,3,757080,389365,367715,195531,755286,388393,366893,236637,128961,107676,466201,236901,229300,54242,23503,30739,748102
112.426277160644531,34.421947479248047,4103,41,410329,"",Yichuan,County,3,708387,366568,341819,167825,703693,362549,341144,213585,113097,100488,447345,232063,215282,47457,21408,26049,690015
114.185844421386719,34.409389495849609,4102,41,410223,"ξ",Weishi,County,3,812150,419415,392735,197804,807093,417183,389910,229022,125966,103056,519429,263817,255612,63699,29632,34067,798478
115.852348327636719,34.401199340820312,4114,41,411425,"ݳ",Yucheng,County,3,1025261,532400,492861,277522,1022840,530952,491888,305309,167561,137748,641140,329777,311363,78812,35062,43750,1012451
113.719085693359375,34.401386260986328,4101,41,410184,"֣",Xinzheng,City,3,609173,315462,293711,157060,586604,300451,286153,155181,83020,72161,407868,211417,196451,46124,21025,25099,558777
111.663566589355469,34.38885498046875,4103,41,410328,"",Luoning,County,3,422972,218393,204579,106739,419458,216087,203371,118220,60605,57615,281869,147233,134636,22883,10555,12328,409087
115.610496520996094,34.382003784179688,4114,41,411403,"",Suiyangqu,Qu,3,754481,388631,365850,193363,729222,375412,353810,205164,112235,92929,495917,252860,243057,53400,23536,29864,727768
116.121414184570312,34.248149871826172,4114,41,411426,"",Xiayi,Xiang,3,1033519,532308,501211,290636,1029325,530751,498574,324456,177590,146866,626296,318559,307737,82767,36159,46608,1019755
113.756668090820312,34.216827392578125,4110,41,411082,"",Changge,City,3,646306,332022,314284,166711,639760,327589,312171,163346,89529,73817,430259,219113,211146,52701,23380,29321,624830
112.461898803710938,34.148639678955078,4103,41,410326,"",Ruyang,County,3,397833,207464,190369,103847,395844,205889,189955,116283,62251,54032,250798,131070,119728,30752,14143,16609,386861
112.08856201171875,34.139087677001953,4103,41,410325,"",Songxian,County,3,527768,278333,249435,136750,523735,275260,248475,147560,78750,68810,342946,182772,160174,37262,16811,20451,504974
114.1912841796875,34.09930419921875,4110,41,411024,"۳",Yanling,County,3,564477,293837,270640,148097,558982,290440,268542,146630,82996,63634,370759,188775,181984,47088,22066,25022,557843
115.302558898925781,34.069499969482422,4114,41,411424,"ϳ",Zhecheng,County,3,876537,455391,421146,235210,874820,454414,420406,271693,152658,119035,541186,274927,266259,63658,27806,35852,863307
114.861457824707031,34.055747985839844,4116,41,411627,"̫",Taikang,County,3,1254680,652829,601851,319036,1251176,650522,600654,361045,201385,159660,811127,415240,395887,82508,36204,46304,1247613
114.385330200195312,34.050937652587891,4116,41,411621,"",Fugou,County,3,666779,347246,319533,169275,664219,345636,318583,192859,109936,82923,421829,213728,208101,52091,23582,28509,658325
111.038887023925781,34.056674957275391,4112,41,411224,"¬",Lushi,County,3,356439,187832,168607,96977,354993,186662,168331,86649,44956,41693,246539,131094,115445,23251,11782,11469,344199
113.218643188476562,33.975101470947266,4104,41,410425,"ۣ",Jiaxian,Xiang,3,533168,278423,254745,145150,528249,274789,253460,129655,71054,58601,360165,187479,172686,43348,19890,23458,517262
116.371716591255563,33.933761701238708,4114,41,411481,"",Yongcheng,City,3,1264607,654047,610560,356681,1256603,648059,608544,352160,191356,160804,808469,416241,392228,103978,46450,57528,1233288
113.065231323242188,33.872142791748047,4104,41,410421,"",Baofeng,County,3,473287,245457,227830,124239,464875,238452,226423,118893,62484,56409,319486,166683,152803,34908,16290,18618,441398
115.469169616699219,33.859752655029297,4116,41,411628,"¹",Luyi,Xiang,3,1068984,551059,517925,283064,1067556,550029,517527,335251,184850,150401,658473,333603,324870,75260,32606,42654,1064026
113.48760986328125,33.859786987304688,4110,41,411025,"",Xiangcheng,County,3,679863,351883,327980,198960,674093,348912,325181,171059,94308,76751,450141,230081,220060,58663,27494,31169,655281
114.524444580078125,33.793056488037109,4116,41,411622,"",Xihua,County,3,820319,427069,393250,208233,811834,420770,391064,238137,133752,104385,521042,266092,254950,61140,27225,33915,809192
111.608772277832031,33.782299041748047,4103,41,410324,"ﴨ",Luanchuan,County,3,312838,164457,148381,85543,309078,161253,147825,85329,45593,39736,207784,109510,98274,19725,9354,10371,285868
112.904983520507812,33.741180419921875,4104,41,410423,"³ɽ",Lushan,County,3,822541,434309,388232,209148,811126,425820,385306,201230,108112,93118,560293,296565,263728,61018,29632,31386,792918
114.878387451171875,33.733982086181641,4116,41,411626,"",Huaiyang,County,3,1229357,639304,590053,316068,1224106,636356,587750,342420,193547,148873,794576,405812,388764,92361,39945,52416,1218584
115.189750671386719,33.644603729248047,4116,41,411625,"",Dancheng,County,3,1151994,599665,552329,302241,1150403,598740,551663,340995,191197,149798,728080,372186,355894,82919,36282,46637,1139893
113.359748840332031,33.629398345947266,4104,41,410422,"Ҷ",Yexian,County,3,838691,434010,404681,210264,822280,422896,399384,195071,103770,91301,574994,298115,276879,68626,32125,36501,813006
113.988365173339844,33.589157104492188,4111,41,411123,"۱",Yancheng,County,3,826902,425416,401486,218249,822046,422305,399741,212100,117735,94365,541493,275558,265935,73309,32123,41186,803564
114.595726013183594,33.537883758544922,4116,41,411623,"ˮ",Shangshui,County,3,1093686,572849,520837,276799,1091379,571245,520134,322441,185550,136891,692218,353576,338642,79027,33723,45304,1078251
112.428390502929688,33.494419097900391,4113,41,411321,"",Nanzhao,County,3,561784,299616,262168,159094,558395,297026,261369,122659,65306,57353,401421,213907,187514,37704,20403,17301,544826
114.897659301757812,33.447288513183594,4116,41,411681,"",Xiangcheng,City,3,1052468,546760,505708,259824,1049449,544806,504643,275559,157225,118334,707501,360069,347432,69408,29466,39942,1027291
113.590965270996094,33.425460815429688,4111,41,411121,"",Wuyang,County,3,498970,254517,244453,147136,494160,251612,242548,116264,62478,53786,328566,168203,160363,54140,23836,30304,488150
115.063705444335938,33.397487640380859,4116,41,411624,"",Shenqiu,County,3,1079278,556826,522452,273855,1074916,554128,520788,291414,164886,126528,706871,357372,349499,80993,34568,46425,1068920
114.015533447265625,33.389057159423828,4117,41,411721,"ƽ",Xiping,County,3,767214,390876,376338,212627,761497,387910,373587,188295,101771,86524,502752,255355,247397,76167,33750,42417,741986
111.479598999023438,33.300712585449219,4113,41,411323,"Ͽ",Xixia,County,3,412988,219232,193756,120911,407368,214810,192558,89151,47703,41448,292483,156239,136244,31354,15290,16064,388138
114.259353637695312,33.267238616943359,4117,41,411722,"ϲ",Shangcai,County,3,1198534,619168,579366,308267,1195227,617516,577711,340154,191923,148231,766807,388543,378264,91573,38702,52871,1185597
112.992507934570312,33.260078430175781,4113,41,411322,"",Fangcheng,County,3,886230,466349,419881,259114,873914,457772,416142,199957,105550,94407,614052,323106,290946,72221,37693,34528,871167
113.989112854003906,33.147838592529297,4117,41,411728,"ƽ",Suiping,County,3,547541,282205,265336,153192,544873,280191,264682,124823,66708,58115,370418,191980,178438,52300,23517,28783,533419
111.477073669433594,33.144611358642578,4113,41,411326,"",Xichuan,County,3,641327,335276,306051,182947,636226,331939,304287,163520,91103,72417,437428,226112,211316,40379,18061,22318,606728
112.938201904296875,33.057907104492188,4113,41,411327,"",Sheqi,County,3,580280,302659,277621,160070,569274,295322,273952,127829,68859,58970,410894,213217,197677,41557,20583,20974,570635
111.843673706054688,33.037025451660156,4113,41,411325,"",Neixiang,County,3,583233,305306,277927,169733,576678,300983,275695,130578,71192,59386,407907,214430,193477,44748,19684,25064,575995
112.233802795410156,33.033473968505859,4113,41,411324,"ƽ",Zhenping,County,3,852360,445879,406481,242622,847587,442682,404905,188686,103220,85466,601580,313615,287965,62094,29044,33050,833910
114.353111267089844,33.009571075439453,4117,41,411727,"",Runan,County,3,784005,401923,382082,217637,779177,399890,379287,193085,105952,87133,526648,268128,258520,64272,27843,36429,776208
114.639076232910156,32.953121185302734,4117,41,411723,"ƽ",Pingyu,County,3,842250,433320,408930,224356,841284,432560,408724,235203,131579,103624,548626,277446,271180,58421,24295,34126,832290
114.0260009765625,32.80462646484375,4117,41,411725,"ȷɽ",Queshan,County,3,553157,284356,268801,165200,550620,282499,268121,123166,65154,58012,383072,197193,185879,46919,22009,24910,545215
114.973915100097656,32.751262664794922,4117,41,411729,"²",Xincai,Xiang,3,918237,474111,444126,244330,917156,473409,443747,225559,124535,101024,626054,322582,303472,66624,26994,39630,908688
113.330368041992188,32.723171234130859,4117,41,411726,"",Miyang,County,3,813273,432183,381090,221129,809470,429537,379933,199154,110565,88589,551243,290278,260965,62876,31340,31536,802342
112.837600708007812,32.693645477294922,4113,41,411328,"ƺ",Tanghe,County,3,1151733,602973,548760,326957,1142670,597564,545106,264201,143284,120917,802494,418543,383951,85038,41146,43892,1125902
114.381210327148438,32.609119415283203,4117,41,411724,"",Zhengyang,County,3,690505,358743,331762,199788,685155,353873,331282,174946,96179,78767,465025,239851,225174,50534,22713,27821,680827
112.352333068847656,32.51776123046875,4113,41,411329,"Ұ",Xinye,County,3,629106,325582,303524,194411,625696,323997,301699,147133,79838,67295,433957,223242,210715,48016,22502,25514,613470
115.404380798339844,32.442378997802734,4115,41,411527,"",Huaibin,County,3,569829,293015,276814,154091,569414,292664,276750,178280,98069,80211,355389,180067,175322,36160,14879,21281,558803
113.407241821289062,32.371761322021484,4113,41,411330,"ͩ",Tongbai,County,3,403359,210959,192400,122780,399663,208154,191509,91271,47886,43385,287732,150639,137093,24356,12434,11922,392677
114.729087829589844,32.342430114746094,4115,41,411528,"Ϣ",Xixian,County,3,770280,395595,374685,209751,769119,394725,374394,222841,119759,103082,498087,254926,243161,49352,20910,28442,753935
114.522239685058594,32.202373504638672,4115,41,411521,"ɽ",Luoshan,County,3,574100,298045,276055,176460,568576,293441,275135,162869,88225,74644,368901,189712,179189,42330,20108,22222,542361
115.680252075195312,32.187602996826172,4115,41,411525,"ʼ",Gushi,County,3,1188599,606121,582478,368268,1184066,603353,580713,358659,194939,163720,742233,370328,371905,87707,40854,46853,1156410
115.043563842773438,32.134365081787109,4115,41,411526,"괨",Huangchuan,County,3,679278,345912,333366,189871,672250,342708,329542,208985,113176,95809,431591,216165,215426,38702,16571,22131,646142
114.898773193359375,32.009700775146484,4115,41,411522,"ɽ",Guangshan,County,3,649578,339378,310200,188994,647936,338122,309814,201138,113926,87212,409673,208392,201281,38767,17060,21707,628276
115.404006958007812,31.801486968994141,4115,41,411524,"̳",Shangcheng,County,3,570181,294009,276172,168118,568684,292873,275811,187311,105545,81766,347995,171888,176107,34875,16576,18299,556108
114.863639831542969,31.62127685546875,4115,41,411523,"",Xinxian,County,3,269773,139201,130572,86919,268781,138478,130303,75822,42234,33588,178067,89683,88384,15884,7284,8600,255588
113.907272338867188,35.389888763427734,4107,41,410704,"վ",Beizhanqu,Qu,3,100132,57286,42846,23144,81505,41225,40280,19624,10428,9196,75685,44563,31122,4823,2295,2528,80209
115.045475886084191,35.686850582180895,4109,41,410928,"",Puyang,County,3,1081832,554299,527533,264948,1067281,544719,522562,300101,161171,138930,708775,361853,346922,72956,31275,41681,1065397
113.849979386587052,33.994961506313722,4110,41,411023,"",Xuchang,County,3,737384,379548,357836,197537,731840,376647,355193,178426,98134,80292,494950,252115,242835,64008,29299,34709,721236
113.796173095703125,35.461723327636719,4107,41,410782,"",Huixian,City,3,776326,394763,381563,197132,760670,384365,376305,210799,110108,100691,514124,260842,253282,51403,23813,27590,732907
114.070266723632812,35.410385131835938,4107,41,410781,"",Weihui,City,3,464371,233151,231220,118212,458387,230504,227883,112688,57966,54722,321326,161585,159741,30357,13600,16757,444105
112.582672119140625,35.082279205322266,4108,41,410881,"Դ",Jiyuan,City,3,626478,323554,302924,158328,607588,309080,298508,164163,86967,77196,421482,218661,202821,40833,17926,22907,569154
112.930892944335938,35.089302062988281,4108,41,410882,"",Qinyang,City,3,446404,224725,221679,110000,441294,221773,219521,118893,62276,56617,297011,149145,147866,30500,13304,17196,395193
111.898880004882812,34.736236572265625,4112,41,411281,"",Yima,City,3,136543,73411,63132,38361,128208,66023,62185,32178,17099,15079,98369,53358,45011,5996,2954,3042,115902
113.472129821777344,34.169601440429688,4110,41,411081,"",Yuzhou,City,3,1122669,587728,534941,292694,1107412,575144,532268,297579,164788,132791,734456,380917,353539,90634,42023,48611,1090021
112.837020874023438,34.161762237548828,4104,41,410482,"",Ruzhou,City,3,923245,474090,449155,230354,917500,469638,447862,259511,136832,122679,596293,305819,290474,67441,31439,36002,893298
113.513954162597656,33.296981811523438,4104,41,410481,"",Wugang,City,3,313089,164347,148742,87772,306337,160349,145988,61097,32786,28311,222697,116985,105712,29295,14576,14719,297165
112.082992553710938,32.680763244628906,4113,41,411381,"",Dengzhou,City,3,1290656,677791,612865,367997,1268592,667503,601089,310039,174675,135364,896666,465639,431027,83951,37477,46474,1268046
114.405671457410691,34.797191424389915,4102,41,410211,"",Jiaoqu,Qu,3,268030,137590,130440,66056,250537,125319,125218,58217,30418,27799,193131,99674,93457,16682,7498,9184,237115
112.469303214910624,34.609182033955982,4103,41,410307,"",Luolongqu,Qu,3,323375,162410,160965,82101,309947,155688,154259,76496,39459,37037,225672,113769,111903,21207,9182,12025,287057
114.332900895300511,36.123689736033768,4105,41,410511,"",Jiaoqu,Qu,3,249294,126219,123075,68213,246814,124389,122425,59655,31340,28315,176383,89267,87116,13256,5612,7644,211040
114.224351292873493,36.191780672733564,4105,41,410522,"",Anyang,County,3,1116162,565768,550394,286050,1097578,553086,544492,292504,154553,137951,759131,385016,374115,64527,26199,38328,1075340
114.136415850356698,35.980916252905082,4106,41,410602,"ɽ",Heshanqu,Qu,3,140130,75626,64504,35645,129617,66145,63472,32635,17105,15530,100306,54990,45316,7189,3531,3658,121911
114.173658352267879,35.890926990259253,4106,41,410603,"ɽ",Shanchengqu,Qu,3,239730,124292,115438,65919,227618,115510,112108,51932,27457,24475,176811,91474,85337,10987,5361,5626,195586
114.240712224503085,35.766371796793962,4106,41,410611,"",Jiaoqu,Qu,3,115476,60294,55182,28560,106018,53849,52169,30827,16515,14312,78573,41243,37330,6076,2536,3540,101469
113.872318289072382,35.346302614963058,4107,41,410711,"",Jiaoqu,Qu,3,141856,71198,70658,37274,136976,69030,67946,31995,16799,15196,101858,50783,51075,8003,3616,4387,113093
113.857451087226863,35.23950198046343,4107,41,410721,"",Xin,County,3,424138,213964,210174,97946,417880,210908,206972,114950,60930,54020,280922,140859,140063,28266,12175,16091,403297
115.018727426087864,35.749225924308242,4109,41,410902,"",Districts,Qu,3,448290,229387,218903,121956,417679,210353,207326,103575,55758,47817,323704,163707,159997,21011,9922,11089,358213
113.810212130747885,34.025230262006986,4110,41,411002,"κ",Weiduqu,Qu,3,373387,188476,184911,107400,332284,165092,167192,62510,32956,29554,286396,143759,142637,24481,11761,12720,270427
114.030570300384923,33.573082504061333,4111,41,411102,"Դ",Yuanhuiqu,Qu,3,304105,150273,153832,87328,275011,135614,139397,55073,28678,26395,228694,112476,116218,20338,9119,11219,225703
113.949077225640579,33.814875143412742,4111,41,411122,"ӱ",Linying,County,3,632427,326357,306070,166701,621386,320616,300770,157391,87520,69871,420516,213717,206799,54520,25120,29400,611769
111.202200151762554,34.779993993625361,4112,41,411202,"",Hubinqu,Qu,3,288746,149846,138900,88369,266535,135033,131502,56277,29694,26583,216961,112340,104621,15508,7812,7696,217189
112.539418614274467,32.998980714115028,4113,41,411302,"",Wanchengqu,Qu,3,785943,404314,381629,229136,756217,385854,370363,160690,84932,75758,576369,295603,280766,48884,23779,25105,667635
112.487003208160957,32.980447999934512,4113,41,411303,"",Wolongqu,Qu,3,798772,410508,388264,229228,757071,387877,369194,174957,93329,81628,574346,293042,281304,49469,24137,25332,684768
114.635681766048521,33.627822554496056,4116,41,411602,"",Chuanhuiqu,Qu,3,323738,162443,161295,84174,297757,149316,148441,72662,39320,33342,232758,115159,117599,18318,7964,10354,275567
114.036906265531087,32.97932907313136,4117,41,411702,"",Yichengqu,Qu,3,338036,170485,167551,100090,307290,154437,152853,63104,33740,29364,254650,127331,127319,20282,9414,10868,240180
114.340606459016271,34.815363025961275,4102,41,410202,"ͤ",Longtingqu,Qu,3,87411,44023,43388,22569,68283,33384,34899,11184,5672,5512,68789,34968,33821,7438,3383,4055,71871
114.362867109947047,34.806821864682838,4102,41,410203,"˳ӻ",Shunhehuizuqu,Qu,3,188800,92881,95919,54245,166229,81216,85013,27973,14258,13715,146399,71755,74644,14428,6868,7560,146855
114.337444027705018,34.790851973384143,4102,41,410204,"¥",Gulouqu,Qu,3,132587,65320,67267,41840,127360,61931,65429,21309,10881,10428,99681,49126,50555,11597,5313,6284,98378
114.347934772931424,34.778448844013923,4102,41,410205,"Ϲ",Nanguanqu,Qu,3,119343,58319,61024,35685,115702,56414,59288,19862,10088,9774,88359,43176,45183,11122,5055,6067,93299
112.440597226812457,34.680116527020836,4103,41,410302,"ϳ",Laochengqu,Qu,3,141571,70609,70962,41495,134912,66859,68053,26931,13739,13192,103036,51517,51519,11604,5353,6251,98966
112.398204661944078,34.672673412462991,4103,41,410303,"",Xigongqu,Qu,3,333461,171000,162461,101443,306563,152010,154553,56368,28968,27400,255408,130930,124478,21685,11102,10583,238678
112.503615860817831,34.695941486497809,4103,41,410304,"ܺӻ",Chanhehuizuqu,Qu,3,167069,84585,82484,48065,148057,72711,75346,29769,15238,14531,126368,64163,62205,10932,5184,5748,127255
112.387299097944734,34.655435699080073,4103,41,410305,"",Jianxiqu,Qu,3,455611,234357,221254,137741,414452,207040,207412,74737,38503,36234,351983,181021,170962,28891,14833,14058,351779
113.296822842739843,33.732175777016934,4104,41,410402,"»",Xinhuaqu,Qu,3,337733,177647,160086,93347,307348,156150,151198,62124,32883,29241,258465,136085,122380,17144,8679,8465,252294
113.346398362059034,33.754492934124521,4104,41,410403,"",Weidongqu,Qu,3,274444,141645,132799,79941,257313,130754,126559,50713,27075,23638,211145,108136,103009,12586,6434,6152,200302
112.878435257017074,33.900898392461301,4104,41,410404,"ʯ",Shilongqu,Qu,3,53499,31174,22325,14164,46055,24243,21812,11724,6257,5467,39892,24002,15890,1883,915,968,40783
113.26873638560059,33.717595567892303,4104,41,410411,"տ",Zhanhequ,Qu,3,235227,119896,115331,66773,218122,110574,107548,47472,25125,22347,174862,88430,86432,12893,6341,6552,175288
114.340841919359434,36.09312404687283,4105,41,410502,"ķ",Wenfengqu,Qu,3,150360,74353,76007,42584,135779,66759,69020,26474,13656,12818,114647,56628,58019,9239,4069,5170,94297
114.344778403124465,36.11325955557578,4105,41,410503,"",Beiguanqu,Qu,3,185724,92466,93258,53889,165268,81125,84143,31758,16390,15368,143898,71230,72668,10068,4846,5222,124938
114.284541541484955,36.115003471966517,4105,41,410504,"",Tiexiqu,Qu,3,183614,97082,86532,56153,171550,86967,84583,34056,17996,16060,141539,75160,66379,8019,3926,4093,135430
113.884470276580686,35.312927318226556,4107,41,410703,"»",Xinhuaqu,Qu,3,203783,100692,103091,61587,194772,95914,98858,36695,19001,17694,152438,74624,77814,14650,7067,7583,154596
113.899941425519202,35.324441110408962,4107,41,410702,"",Hongqiqu,Qu,3,330170,165048,165122,90025,280493,138584,141909,52353,27084,25269,257760,128019,129741,20057,9945,10112,241134
113.21491930403225,35.238502158974804,4108,41,410802,"",Jiefangqu,Qu,3,273823,140377,133446,71564,242072,120289,121783,49784,25782,24002,209311,107486,101825,14728,7109,7619,198437
115.643784684279439,34.434024490787337,4114,41,411402,"԰",Liangyuanqu,Qu,3,674502,340688,333814,175594,663348,334894,328454,185522,98797,86725,441481,221031,220450,47499,20860,26639,613610
114.050269321099179,32.138206569219861,4115,41,411502,"",Shihequ,Qu,3,561662,286632,275030,172644,532804,271975,260829,125279,65865,59414,399142,202329,196813,37241,18438,18803,461170
113.243080819417543,35.240381417569175,4108,41,410811,"ɽ",Shanyangqu,Qu,3,233639,117890,115749,63395,223640,111948,111692,51849,27351,24498,169418,84576,84842,12372,5963,6409,169716
113.620739754520343,34.744420094498842,4101,41,410102,"ԭ",Zhongyuanqu,Qu,3,578400,296524,281876,162265,499170,249598,249572,98524,51690,46834,443218,226794,216424,36658,18040,18618,397111
113.647039282700135,34.741784022059363,4101,41,410103,"",Erqiqu,Qu,3,557300,289335,267965,148182,443242,222387,220855,85414,45390,40024,437066,227214,209852,34820,16731,18089,352343
113.688222669090464,34.754821643001968,4101,41,410104,"ܳǻ",Guanchenghuizuqu,Qu,3,348513,179006,169507,104788,324701,163644,161057,66143,35648,30495,256815,131543,125272,25555,11815,13740,220102
113.601067367818885,34.841994123550108,4101,41,410108,"ɽ",Mangshanqu,Qu,3,149852,77632,72220,38292,141594,71829,69765,34547,18415,16132,104869,54497,50372,10436,4720,5716,120735
113.656971190046164,34.768096828389503,4101,41,410105,"ˮ",Jinshuiqu,Qu,3,878308,465170,413138,237864,676855,339152,337703,129746,68247,61499,699719,372870,326849,48843,24053,24790,512117
112.596000671386719,30.703563690185547,4208,42,420822,ɳ,Shayang,County,3,669469,354820,314649,172505,608999,308916,300083,134036,68965,65071,488548,263831,224717,46885,22024,24861,634211
114.127548217773438,30.627374649047852,4201,42,420112,,Dongxihu,Qu,3,298479,156379,142100,85729,269669,136675,132994,57412,30571,26841,224824,118227,106597,16243,7581,8662,175253
114.074958801269531,30.312501907348633,4201,42,420113,,Hannan,Qu,3,98901,50754,48147,31445,98216,50338,47878,21644,11629,10015,71445,36520,34925,5812,2605,3207,78397
110.417633056640625,32.992084503173828,4203,42,420322,,Yunxi,County,3,492015,263007,229008,135909,483252,257133,226119,124875,65407,59468,335261,182249,153012,31879,15351,16528,477961
110.802871704101562,32.829292297363281,4203,42,420321,,Yun,County,3,584315,307869,276446,154935,566099,295872,270227,151667,80353,71314,396476,209961,186515,36172,17555,18617,560470
109.704826354980469,32.305233001708984,4203,42,420324,Ϫ,Zhuxi,County,3,338534,184535,153999,88302,320565,172968,147597,76806,42637,34169,236855,128905,107950,24873,12993,11880,332297
111.645805358886719,32.258800506591797,4206,42,420625,ȳ,Gucheng,County,3,551042,285319,265723,145948,525785,270815,254970,126890,65454,61436,384409,200681,183728,39743,19184,20559,522783
110.230949401855469,32.201492309570312,4203,42,420323,ɽ,Zhushan,County,3,438787,238851,199936,120051,420623,226731,193892,106201,59632,46569,297403,161359,136044,35183,17860,17323,423425
110.727149963378906,32.042549133300781,4203,42,420325,,Fang,County,3,471311,251120,220191,121252,450889,237655,213234,103689,53316,50373,330920,178602,152318,36702,19202,17500,453737
111.261215209960938,31.873956680297852,4206,42,420626,,Baokang,County,3,286729,152650,134079,80793,280012,148495,131517,57719,29165,28554,205145,111512,93633,23865,11973,11892,275381
111.840034484863281,31.768976211547852,4206,42,420624,,Nanzhang,County,3,573303,298533,274770,153665,557138,289708,267430,127150,64449,62701,398753,211175,187578,47400,22909,24491,548958
110.672256469726562,31.730854034423828,4290,42,429021,ũ,Shennongjialin,Qu,3,78242,42386,35856,21848,75371,40366,35005,15462,7872,7590,56990,31568,25422,5790,2946,2844,71797
112.263648986816406,31.693105697631836,4206,42,420684,˳,Yicheng,City,3,522835,266340,256495,140286,506278,255073,251205,121387,62046,59341,363249,185922,177327,38199,18372,19827,491256
114.104194641113281,31.566276550292969,4209,42,420922,,Dawu,County,3,605786,320288,285498,156382,586959,308490,278469,158214,83824,74390,411254,219032,192222,36318,17432,18886,599348
114.600471496582031,31.297031402587891,4211,42,421122,찲,Hongan,County,3,648400,342145,306255,166324,614148,320831,293317,169613,91272,78341,448515,237210,211305,30272,13663,16609,624245
110.752243041992188,31.330272674560547,4205,42,420526,ɽ,Xingshan,County,3,182691,96139,86552,62419,180013,94249,85764,35936,18190,17746,129945,69724,60221,16810,8225,8585,167078
112.602157592773438,31.151056289672852,4208,42,420881,,Zhongxiang,City,3,1021998,516758,505240,263793,966097,487789,478308,227274,116600,110674,724111,368053,356058,70613,32105,38508,963119
111.639411926269531,31.063369750976562,4205,42,420525,Զ,Yuanan,County,3,217389,114693,102696,68403,209907,109223,100684,40572,20815,19757,159990,85683,74307,16827,8195,8632,194248
110.39984130859375,31.019462585449219,4228,42,422823,Ͷ,Badong,County,3,485338,256008,229330,140395,475503,249035,226468,103954,53732,50222,342938,182967,159971,38446,19309,19137,464716
113.7279052734375,31.036491394042969,4209,42,420923,,Yunmeng,County,3,571591,299740,271851,141625,557064,290663,266401,150449,84408,66041,387393,199834,187559,33749,15498,18251,544692
113.106292724609375,31.018949508666992,4208,42,420821,ɽ,Jingshan,County,3,696008,357830,338178,188445,662849,339100,323749,158623,82785,75838,493942,254985,238957,43443,20060,23383,648137
110.992118835449219,30.828344345092773,4205,42,420527,,Zigui,County,3,398043,207908,190135,124169,389703,202513,187190,80025,40843,39182,281753,149259,132494,36265,17806,18459,372010
114.36090087890625,30.881534576416016,4201,42,420116,,Huangpi,Qu,3,1054046,542730,511316,259408,888611,449125,439486,254075,135538,118537,734030,377352,356678,65941,29840,36101,999886
114.782691955566406,30.84583854675293,4201,42,420117,,Xinzhou,Qu,3,902380,470484,431896,230644,863543,448177,415366,243498,136872,106626,606126,309875,296251,52756,23737,29019,858223
115.390396118164062,30.790346145629883,4211,42,421123,,Luotian,County,3,554196,295896,258300,150783,525978,278591,247387,148321,83800,64521,372547,195788,176759,33328,16308,17020,545308
111.325340270996094,30.768522262573242,4205,42,420521,˲,Yichang,County,3,625208,333911,291297,185174,577037,298781,278256,117168,59801,57367,454643,247879,206764,53397,26231,27166,526425
115.669448852539062,30.742137908935547,4211,42,421124,Ӣɽ,Yingshan,County,3,384015,202811,181204,108273,369046,193304,175742,86576,45985,40591,269723,143882,125841,27716,12944,14772,367192
113.824005126953125,30.661413192749023,4209,42,420984,,Hanchuan,City,3,1057396,552093,505303,255772,993425,516993,476432,270271,152438,117833,726361,371448,354913,60764,28207,32557,1015118
109.727439880371094,30.594263076782227,4228,42,422822,ʼ,Jianshi,County,3,510555,266673,243882,139383,499232,259880,239352,105696,54135,51561,365903,192872,173031,38956,19666,19290,500583
114.019767761230469,30.590370178222656,4201,42,420114,̵,Caidian,Qu,3,512444,265824,246620,140448,468217,236707,231510,110748,60136,50612,361984,188646,173338,39712,17042,22670,449323
111.202056884765625,30.468353271484375,4205,42,420528,,Changyangtujiazuzizhixian,County,3,416782,219877,196905,123945,409632,215350,194282,81488,41600,39888,296143,159121,137022,39151,19156,19995,395008
115.259078979492188,30.458690643310547,4211,42,421125,ˮ,Xishui,County,3,1008569,527844,480725,248300,932392,483768,448624,253347,139314,114033,697600,361573,336027,57622,26957,30665,964290
111.757591247558594,30.42399787902832,4205,42,420583,֦,Zhijiang,City,3,508835,257013,251822,147122,486830,245039,241791,95840,49251,46589,366081,186899,179182,46914,20863,26051,470518
114.304832458496094,30.353366851806641,4201,42,420115,,Jiangxia,Qu,3,634149,330662,303487,160303,544801,278970,265831,158827,86016,72811,438767,228328,210439,36555,16318,20237,547872
112.417861938476562,30.026889801025391,4210,42,421024,,Jiangling,County,3,389653,202067,187586,98831,371690,189236,182454,81933,42368,39565,282900,148954,133946,24820,10745,14075,373660
115.414138793945312,30.244338989257812,4211,42,421126,ޭ,Qichun,County,3,949479,500811,448668,225723,884818,461901,422917,262969,143161,119808,628488,329746,298742,58022,27904,30118,925348
110.668296813964844,30.196968078613281,4205,42,420529,,Wufengtujiazuzizhixian,County,3,205897,108292,97605,64601,202412,106127,96285,40356,20658,19698,146757,78331,68426,18784,9303,9481,198292
111.777214050292969,30.169910430908203,4210,42,421087,,Songzi,City,3,859941,437980,421961,229941,797719,405802,391917,160567,81781,78786,625918,322450,303468,73456,33749,39707,825140
114.958267211914062,30.096656799316406,4202,42,420281,ұ,Daye,City,3,873859,460417,413442,220921,833493,435095,398398,240917,135911,105006,583726,302543,281183,49216,21963,27253,794779
115.931419372558594,30.078027725219727,4211,42,421127,÷,Huangmei,County,3,966416,507330,459086,227224,918182,478408,439774,262285,145498,116787,641456,332420,309036,62675,29412,33263,934052
112.235870361328125,30.057533264160156,4210,42,421022,,Gongan,County,3,1009690,512653,497037,268649,975319,493664,481655,217857,111491,106366,723192,370536,352656,68641,30626,38015,998440
109.48492431640625,29.993091583251953,4228,42,422825,,Xuanen,County,3,335984,176585,159399,89212,326861,170870,155991,77405,40668,36737,234483,123881,110602,24096,12036,12060,333288
113.895576477050781,29.981464385986328,4212,42,421221,,Jiayu,County,3,358646,186898,171748,88717,336133,174469,161664,91211,50196,41015,246779,127522,119257,20656,9180,11476,340324
110.017341613769531,29.885509490966797,4228,42,422828,׷,Hefeng,County,3,220187,115495,104692,62148,206397,107971,98426,48019,24555,23464,155737,82666,73071,16431,8274,8157,210833
115.207275390625,29.835994720458984,4202,42,420222,,Yangxin,County,3,949886,505769,444117,198073,909587,480089,429498,287603,157529,130074,620782,328890,291892,41501,19350,22151,910580
112.889694213867188,29.811065673828125,4210,42,421023,,Jianli,County,3,1363132,707483,655649,330300,1319343,682519,636824,364401,198102,166299,918748,474120,444628,79983,35261,44722,1343876
109.144256591796875,29.676366806030273,4228,42,422826,̷,Xianfeng,County,3,363710,192517,171193,103085,355525,187314,168211,85553,44805,40748,254543,135301,119242,23614,12411,11203,352819
114.512031555175781,29.603015899658203,4212,42,421224,ͨɽ,Tongshan,County,3,378849,198728,180121,94298,362442,188842,173600,110677,59417,51260,247414,129398,118016,20758,9913,10845,365373
114.046188354492188,29.54058837890625,4212,42,421223,,Chongyang,County,3,456792,239508,217284,104926,444488,231537,212951,123051,65234,57817,309863,163203,146660,23878,11071,12807,450681
109.404823303222656,29.50520133972168,4228,42,422827,,Laifeng,County,3,316707,164156,152551,77477,263728,135303,128425,85365,44847,40518,212066,109807,102259,19276,9502,9774,304870
113.804084777832031,29.248291015625,4212,42,421222,ͨ,Tongcheng,County,3,427867,223305,204562,108065,416699,217434,199265,115572,61157,54415,286476,149826,136650,25819,12322,13497,402776
113.953956604003906,31.257740020751953,4209,42,420921,Т,Xiaochang,County,3,612166,321407,290759,145517,598905,312380,286525,181215,99182,82033,397386,206804,190582,33565,15421,18144,602774
114.866241455078125,30.626605987548828,4211,42,421121,ŷ,Tuanfeng,County,3,375931,200090,175841,96995,353944,186686,167258,96263,54590,41673,252719,132613,120106,26949,12887,14062,363659
112.206341141495074,32.083565883634932,4206,42,420621,,Xiangyang,County,3,1289584,661264,628320,327111,1220229,619519,600710,324613,169796,154817,894333,460228,434105,70638,31240,39398,1223114
111.503143310546875,32.548080444335938,4203,42,420381,,Danjiangkou,City,3,501126,262922,238204,134863,459637,237986,221651,113273,59156,54117,358019,188673,169346,29834,15093,14741,438191
111.668487548828125,32.381507873535156,4206,42,420682,Ϻӿ,Laohekou,City,3,509468,257204,252264,128554,469853,237403,232450,111853,58070,53783,367112,185412,181700,30503,13722,16781,456928
112.758949279785156,32.136714935302734,4206,42,420683,,Zaoyang,City,3,1054374,538588,515786,286638,996260,508681,487579,252952,131604,121348,735290,375531,359759,66132,31453,34679,968477
113.804267883300781,31.632261276245117,4213,42,421381,ˮ,Guangshui,City,3,885936,458607,427329,224484,864742,446613,418129,227967,119962,108005,605012,313162,291850,52957,25483,27474,842987
113.664810180664062,31.271152496337891,4209,42,420982,½,Anlu,City,3,611990,314089,297901,155659,589443,300910,288533,148045,77878,70167,425804,218968,206836,38141,17243,20898,608223
115.019241333007812,31.182090759277344,4211,42,421181,,Macheng,City,3,1129047,595391,533656,290487,1074578,562260,512318,282924,154603,128321,787717,413414,374303,58406,27374,31032,1105139
113.572029113769531,30.958908081054688,4209,42,420981,Ӧ,Yingcheng,City,3,650485,340907,309578,166928,621510,323276,298234,160556,88782,71774,453055,235052,218003,36874,17073,19801,616845
111.778907775878906,30.820953369140625,4205,42,420582,,Dangyang,City,3,495946,253125,242821,145146,477758,242127,235631,92932,47626,45306,362100,186340,175760,40914,19159,21755,428774
113.16998291015625,30.659770965576172,4290,42,429006,,Tianmen,City,3,1613739,849283,764456,359891,1192001,619071,572930,393876,229497,164379,1122118,576484,545634,97745,43302,54443,1565946
112.894126892089844,30.425643920898438,4290,42,429005,Ǳ,Qianjiang,City,3,992438,506290,486148,253782,938322,477620,460702,224183,117403,106780,708333,361411,346922,59922,27476,32446,916977
111.457916259765625,30.392385482788086,4205,42,420581,˶,Yidu,City,3,385779,196716,189063,112469,373567,189532,184035,70572,36048,34524,275009,142085,132924,40198,18583,21615,357069
113.452827453613281,30.378803253173828,4290,42,429004,,Xiantao,City,3,1474078,774487,699591,362976,1398038,732400,665638,378558,217422,161136,1005132,515262,489870,90388,41803,48585,1392122
108.938232421875,30.293907165527344,4228,42,422802,,Lichuan,City,3,786984,417988,368996,211084,772947,408878,364069,201999,106713,95286,537425,286085,251340,47560,25190,22370,763054
109.471931457519531,30.271001815795898,4228,42,422801,ʩ,Enshi,City,3,755725,397284,358441,209123,727876,380349,347527,156494,80368,76126,544277,288888,255389,54954,28028,26926,723163
115.55950927734375,29.849552154541016,4211,42,421182,Ѩ,Wuxue,City,3,719426,381959,337467,173250,690145,362554,327591,206909,118758,88151,466573,241355,225218,45944,21846,24098,678032
113.46142578125,29.810237884521484,4210,42,421083,,Honghu,City,3,877775,459997,417778,225323,854006,446704,407302,228759,131028,97731,593996,304479,289517,55020,24490,30530,842736
112.417022705078125,29.724309921264648,4210,42,421081,ʯ,Shishou,City,3,602649,310486,292163,163220,583438,299602,283836,133527,69898,63629,433750,224628,209122,35372,15960,19412,563175
113.926020885673481,29.742492668620915,4212,42,421281,,Chibi,City,3,510926,267233,243693,131449,480154,248648,231506,128991,70755,58236,354451,184247,170204,27484,12231,15253,439660
114.301566752615642,30.607626733197161,4201,42,420102,,Jiangan,Qu,3,723118,364928,358190,220145,672803,332451,340352,104067,54669,49398,554149,280162,273987,64902,30097,34805,449730
114.30137721272277,30.558503359094978,4201,42,420106,,Wuchang,Qu,3,976303,499926,476377,279260,825420,409993,415427,126328,65520,60808,773731,397893,375838,76244,36513,39731,681044
114.409483836335525,30.527214106679097,4201,42,420111,ɽ,Hongshan,Qu,3,878379,483886,394493,211469,627475,321197,306278,123215,66930,56285,711984,395883,316101,43180,21073,22107,496684
115.064005731256515,30.245997437756902,4202,42,420202,ʯ,Huangshigang,Qu,3,196569,98985,97584,57157,177285,88724,88561,32583,17592,14991,152283,75658,76625,11703,5735,5968,156931
114.911515002333914,30.178663869141729,4202,42,420205,ɽ,Tieshan,Qu,3,66469,34288,32181,20380,62514,31863,30651,12308,6667,5641,49611,25331,24280,4550,2290,2260,51443
115.037270343718134,30.18361486683402,4202,42,420204,½,Xialu,Qu,3,146649,76580,70069,41671,132662,68396,64266,26026,14179,11847,113202,58582,54620,7421,3819,3602,108301
110.79556768388656,32.611719290165674,4203,42,420302,é,Maojian,Qu,3,267855,140371,127484,78328,230839,118046,112793,44710,23657,21053,212093,110834,101259,11052,5880,5172,191545
110.749504878432901,32.644986871882203,4203,42,420303,,Zhangwan,Qu,3,321969,169181,152788,98582,293811,150290,143521,57403,30242,27161,249427,131090,118337,15139,7849,7290,239166
111.308016148555666,30.720282733487206,4205,42,420502,,Xiling,Qu,3,427299,224425,202874,126433,372330,187445,184885,55298,28778,26520,347051,183212,163839,24950,12435,12515,292526
111.356637998756753,30.65374757005414,4205,42,420503,Ҹ,Wujiagang,Qu,3,184000,94882,89118,58508,169523,85214,84309,27105,14147,12958,145613,75609,70004,11282,5126,6156,106668
111.241480985122607,30.695971808386663,4205,42,420504,,Dianjun,Qu,3,48612,25128,23484,14240,46740,23774,22966,8551,4419,4132,36129,18874,17255,3932,1835,2097,34776
111.435968385926955,30.525795332682861,4205,42,420505,Vͤ,Vͤ,Qu,3,52827,27075,25752,14851,50248,25287,24961,10160,5109,5051,38552,20108,18444,4115,1858,2257,42775
112.13172754147827,32.001998803668215,4206,42,420602,,Xiangcheng,Qu,3,289826,148428,141398,77091,231014,115306,115708,44924,23551,21373,231248,118229,113019,13654,6648,7006,204189
112.134286586225699,32.068533967101281,4206,42,420606,,Fancheng,Qu,3,581562,295471,286091,166228,496409,247594,248815,99770,51729,48041,456969,231829,225140,24823,11913,12910,350089
114.602572017670113,30.125208212009078,4207,42,420702,Ӻ,Liangzihu,Qu,3,173896,91448,82448,41998,171061,89708,81353,52404,29755,22649,111739,57396,54343,9753,4297,5456,169105
114.714229298127478,30.541877625417108,4207,42,420703,,Huarong,Qu,3,246073,127454,118619,64592,235858,121459,114399,65051,36437,28614,163693,83423,80270,17329,7594,9735,233743
114.866748365074045,30.403689209056129,4207,42,420704,,Echeng,Qu,3,603316,315038,288278,155262,557900,289417,268483,146309,83205,63104,426782,218134,208648,30225,13699,16526,504695
112.204527423651541,31.023551418511548,4208,42,420802,,Dongbao,Qu,3,583373,300284,283089,157114,512429,260185,252244,108224,55470,52754,439586,227609,211977,35563,17205,18358,450182
113.885839280003225,30.931654158717482,4209,42,420902,Т,Xiaonan,Qu,3,883123,454917,428206,220479,835063,428052,407011,218129,118638,99491,615047,313179,301868,49947,23100,26847,827975
112.317787301942801,30.309696149022564,4210,42,421002,ɳ,Shashi,Qu,3,591572,299919,291653,178942,547755,274735,273020,101962,52644,49318,454540,231433,223107,35070,15842,19228,408593
112.194549459478054,30.335576095940159,4210,42,421003,,Jingzhou,Qu,3,585578,299032,286546,145573,501227,252053,249174,105256,54066,51190,443474,228083,215391,36848,16883,19965,482216
114.863035251708027,30.447786234792023,4211,42,421102,,Huangzhou,Qu,3,373568,194607,178961,93740,301036,154649,146387,74781,42272,32509,278474,142453,136021,20313,9882,10431,328105
114.269766077708553,29.884814594592811,4212,42,421202,̰,Xianan,Qu,3,567598,295836,271762,132527,477677,248677,229000,142586,79541,63045,398340,203919,194421,26672,12376,14296,489231
113.371412172072795,31.722067662863978,4213,42,421302,,Cengdu,Qu,3,1598752,818936,779816,404198,1375112,701270,673842,372816,191910,180906,1125038,579328,545710,100898,47698,53200,1528424
114.225429573244938,30.583075623072062,4201,42,420104,~,~,Qu,3,686318,342618,343700,195899,584940,290714,294226,94062,48795,45267,540048,269851,270197,52208,23972,28236,378736
114.239791516507225,30.550797372319611,4201,42,420105,,Hanyang,Qu,3,507772,261200,246572,148745,466522,233609,232913,75278,39386,35892,393910,203590,190320,38584,18224,20360,295309
114.270711595562844,30.570592002369239,4201,42,420103,,Jianghan,Qu,3,596768,306569,290199,188311,548341,274360,273981,87485,46587,40898,464221,239435,224786,45062,20547,24515,306713
114.370864994063652,30.620806900214177,4201,42,420107,ɽ,Qingshan,Qu,3,443643,230769,212874,136291,411761,207488,204273,60760,31692,29068,350504,182273,168231,32379,16804,15575,338859
115.053923493441275,30.200942774208226,4202,42,420203,ʯҤ,Shihuiyao,Qu,3,244035,124859,119176,74458,236970,120498,116472,45682,24752,20930,182877,92962,89915,15476,7145,8331,188085
112.721809387207031,27.246335983276367,4304,43,430412,,Nanyue,Qu,3,53423,27350,26073,13110,45328,23178,22150,11067,5883,5184,38865,19758,19107,3491,1709,1782,46436
113.104423522949219,25.8243408203125,4310,43,431003,,Suxian,Qu,3,340537,176658,163879,102114,319823,164300,155523,63179,33598,29581,252864,131302,121562,24494,11758,12736,288748
111.694632672026003,28.964686509537483,4307,43,430703,,Dingcheng,Qu,3,836799,429301,407498,242768,831000,425523,405477,184334,95520,88814,583823,301009,282814,68642,32772,35870,764768
110.564262390136719,29.350456237792969,4308,43,430811,Դ,Wulingyuan,Qu,3,47755,25370,22385,13045,40650,21127,19523,9654,4981,4673,34916,18827,16089,3185,1562,1623,39519
112.359161376953125,28.580879211425781,4309,43,430903,ɽ,Heshan,Qu,3,831114,425799,405315,234526,760633,388895,371738,172322,89259,83063,592080,303979,288101,66712,32561,34151,812410
111.758987426757812,29.639486312866211,4307,43,430723,,Li,County,3,824902,422103,402799,247997,815351,416411,398940,156344,80164,76180,604350,311329,293021,64208,30610,33598,776539
111.365455627441406,29.582172393798828,4307,43,430726,ʯ,Shimen,County,3,673435,351837,321598,202356,664626,345764,318862,119709,61810,57899,498449,262894,235555,55277,27133,28144,646202
112.554328918457031,29.521463394165039,4306,43,430623,,Huarong,County,3,703416,363176,340240,188437,677947,349111,328836,159314,83372,75942,496282,257068,239214,47820,22736,25084,663859
109.440216064453125,29.461141586303711,4331,43,433130,ɽ,Longshan,County,3,490363,251620,238743,126504,482800,247646,235154,151615,78945,72670,306114,157239,148875,32634,15436,17198,473869
111.647544860839844,29.443166732788086,4307,43,430724,,Linli,County,3,411971,212799,199172,118820,395856,202315,193541,74768,38486,36282,305642,159436,146206,31561,14877,16684,386480
111.121498107910156,29.420610427856445,4308,43,430821,,Cili,County,3,636659,329845,306814,196350,633996,328240,305756,128716,66435,62281,453447,237314,216133,54496,26096,28400,617727
112.165702819824219,29.408256530761719,4307,43,430721,,Anxiang,County,3,543602,279718,263884,152524,531210,272563,258647,106866,55498,51368,396184,204692,191492,40552,19528,21024,515058
110.160957336425781,29.399257659912109,4308,43,430822,ɣֲ,Sangzhi,County,3,402733,209770,192963,111660,400503,208136,192367,93025,48018,45007,275265,144968,130297,34443,16784,17659,391259
112.403549194335938,29.36566162109375,4309,43,430921,,Nan,County,3,703823,363182,340641,198792,693621,357326,336295,151178,78248,72930,496267,257561,238706,56378,27373,29005,669223
113.105262756347656,29.141731262207031,4306,43,430621,,Yueyang,County,3,709512,375671,333841,198723,697020,366287,330733,168143,91268,76875,495010,261207,233803,46359,23196,23163,670460
109.849052429199219,29.001796722412109,4331,43,433127,˳,Yongshun,County,3,445224,231192,214032,117140,439894,228203,211691,126915,67402,59513,282969,146781,136188,35340,17009,18331,425595
111.995468139648438,28.901142120361328,4307,43,430722,,Hanshou,County,3,764213,397770,366443,217012,760329,395268,365061,175209,92036,83173,531715,278309,253406,57289,27425,29864,745256
111.480575561523438,28.903560638427734,4307,43,430725,Դ,Taoyuan,County,3,932771,486904,445867,265011,903218,470567,432651,166505,86641,79864,679824,357958,321866,86442,42305,44137,891164
113.571609497070312,28.707729339599609,4306,43,430626,ƽ,Pingjiang,County,3,931996,493998,437998,252858,925698,489430,436268,213560,112397,101163,645505,345251,300254,72931,36350,36581,907370
109.640182495117188,28.707094192504883,4331,43,433125,,Baojing,County,3,260034,136690,123344,66666,255464,133870,121594,68242,35523,32719,170740,91071,79669,21052,10096,10956,244799
112.881294250488281,28.670810699462891,4306,43,430624,,Xiangyin,County,3,646180,336846,309334,180783,640890,332839,308051,157304,83235,74069,442246,230075,212171,46630,23536,23094,618966
109.941925048828125,28.616851806640625,4331,43,433126,,Guzhang,County,3,119202,63120,56082,32328,117527,61769,55758,32718,16939,15779,77565,41888,35677,8919,4293,4626,110692
109.4676513671875,28.595237731933594,4331,43,433124,ԫ,Huayuan,County,3,253750,132071,121679,61794,249645,129353,120292,71104,37309,33795,163820,85926,77894,18826,8836,9990,243891
112.1405029296875,28.520803451538086,4309,43,430922,ҽ,Taojiang,County,3,775444,403905,371539,225907,752097,390363,361734,172720,91802,80918,532991,277031,255960,69733,35072,34661,754809
110.389511108398438,28.460124969482422,4312,43,431222,,Yuanling,County,3,599680,314209,285471,158126,586413,305760,280653,126410,65608,60802,422914,224125,198789,50356,24476,25880,566482
111.212471008300781,28.382406234741211,4309,43,430923,,Anhua,County,3,900759,473408,427351,250611,892986,468712,424274,201697,103696,98001,623693,329940,293753,75369,39772,35597,876859
112.816986083984375,28.377765655517578,4301,43,430122,,Wangcheng,County,3,686349,357495,328854,188531,639874,330423,309451,136934,70944,65990,493794,259378,234416,55621,27173,28448,654929
110.154220581054688,28.280029296875,4331,43,433122,Ϫ,Luxi,County,3,256869,132592,124277,64204,255680,131856,123824,81250,42185,39065,157681,81857,75824,17938,8550,9388,242061
112.592559814453125,28.239740371704102,4301,43,430124,,Ningxiang,County,3,1247218,644213,603005,366324,1180787,605595,575192,260008,134563,125445,878305,456936,421369,108905,52714,56191,1191991
110.187301635742188,28.014862060546875,4312,43,431223,Ϫ,Chenxi,County,3,478708,248476,230232,129460,473045,244695,228350,108509,57165,51344,334322,174026,160296,35877,17285,18592,459784
109.598991394042969,27.944236755371094,4331,43,433123,,Fenghuang,County,3,343878,178684,165194,83066,341694,177409,164285,98948,51748,47200,221163,115537,105626,23767,11399,12368,330613
110.595932006835938,27.915643692016602,4312,43,431224,,Xupu,County,3,798983,415715,383268,217973,786511,406916,379595,178351,93633,84718,559006,292256,266750,61626,29826,31800,769338
109.797515869140625,27.878908157348633,4312,43,431226,,Mayangmiaozuzizhixian,County,3,335027,172974,162053,86811,333271,171798,161473,82555,43555,39000,226964,117153,109811,25508,12266,13242,319151
111.292892456054688,27.746667861938477,4313,43,431322,»,Xinhua,County,3,1207436,631245,576191,317729,1197789,624841,572948,305476,161830,143646,812099,425519,386580,89861,43896,45965,1170623
113.14752197265625,27.710634231567383,4302,43,430221,,Zhuzhou,County,3,429723,223416,206307,116263,419092,217315,201777,90816,47141,43675,302128,157859,144269,36779,18416,18363,415075
112.192276000976562,27.46168327331543,4313,43,431321,˫,Shuangfeng,County,3,840626,434761,405865,236047,829968,426746,403222,196661,105243,91418,575550,297454,278096,68415,32064,36351,809439
109.686927795410156,27.442174911499023,4312,43,431228,ƽ,Zhijiangdongzuzizhixian,County,3,334229,175350,158879,95968,325299,169743,155556,77511,41411,36100,229329,120284,109045,27389,13655,13734,313495
109.17156982421875,27.357137680053711,4312,43,431227,»ζ,Xinhuangdongzuzizhixian,County,3,241690,130740,110950,66852,239044,128775,110269,51220,29583,21637,168394,89923,78471,22076,11234,10842,229588
111.4583740234375,27.331321716308594,4305,43,430522,,Xinshao,County,3,686810,363061,323749,195051,672665,353451,319214,171752,95186,76566,462044,241833,220211,53014,26042,26972,672453
112.869064331054688,27.244678497314453,4304,43,430423,ɽ,Hengshan,County,3,381300,197609,183691,100935,372855,192538,180317,91698,49338,42360,259960,133966,125994,29642,14305,15337,368869
111.684158325195312,27.250560760498047,4305,43,430521,۶,Shaodong,County,3,1139536,596561,542975,323547,1122067,584386,537681,271484,150870,120614,784810,405848,378962,83242,39843,43399,1091312
111.02685546875,27.121444702148438,4305,43,430524,¡,Longhui,County,3,1056727,558702,498025,294810,1051213,554551,496662,251042,139729,111313,730655,382448,348207,75030,36525,38505,1039227
112.950836181640625,27.092411041259766,4304,43,430424,ⶫ,Hengdong,County,3,594131,307687,286444,172890,585669,301750,283919,153040,81457,71583,394221,203745,190476,46870,22485,24385,574980
110.570320129394531,27.067800521850586,4305,43,430525,,Dongkou,County,3,752581,392409,360172,206845,732300,379954,352346,177097,98073,79024,517707,265931,251776,57777,28405,29372,741237
113.337554931640625,27.004034042358398,4302,43,430223,,You,County,3,679839,348901,330938,187824,664801,337854,326947,148420,76222,72198,472497,245325,227172,58922,27354,31568,652332
111.271316528320312,26.999526977539062,4305,43,430523,,Shaoyang,County,3,887378,469719,417659,233948,883712,467076,416636,236028,130252,105776,588689,308517,280172,62661,30950,31711,867248
112.371055603027344,26.968738555908203,4304,43,430421,,Hengyang,County,3,1087777,576995,510782,297252,1060248,560045,500203,270036,150541,119495,737664,385892,351772,80077,40562,39515,1066828
109.715568542480469,26.863803863525391,4312,43,431225,ͬ,Huitong,County,3,331392,172162,159230,91921,327209,169315,157894,71753,38674,33079,237098,122977,114121,22541,10511,12030,318899
113.552169799804688,26.801975250244141,4302,43,430224,,Chaling,County,3,493059,249879,243180,134929,487031,245091,241940,116482,59784,56698,339754,173906,165848,36823,16189,20634,468726
112.1202392578125,26.7880859375,4304,43,430426,,Qidong,County,3,884957,466828,418129,257573,872691,458675,414016,214714,118614,96100,601630,314211,287419,68613,34003,34610,863081
110.622291564941406,26.730705261230469,4305,43,430581,,Wugang,City,3,694847,363904,330943,192911,683818,356262,327556,163539,90681,72858,475912,246174,229738,55396,27049,28347,669560
113.267646789550781,26.706846237182617,4310,43,431028,,Anren,County,3,361098,187678,173420,100636,357154,185146,172008,85635,45772,39863,249189,129542,119647,26274,12364,13910,350743
111.853736877441406,26.591423034667969,4311,43,431121,,Qiyang,County,3,944602,495375,449227,253573,913638,475446,438192,205650,111339,94311,669518,350064,319454,69434,33972,35462,916152
110.157279968261719,26.588134765625,4305,43,430527,,Suining,County,3,339235,176030,163205,89876,336288,173909,162379,80587,42726,37861,235063,121937,113126,23585,11367,12218,325946
109.689460754394531,26.571107864379883,4312,43,431229,嶱,Jingzhoumiaozudongzuzizhixi,County,3,245444,126855,118589,63469,239579,122892,116687,60378,31845,28533,170398,88351,82047,14668,6659,8009,235561
113.766647338867188,26.496860504150391,4302,43,430225,,Yanling,County,3,164807,84535,80272,46311,157940,79955,77985,34925,17944,16981,116204,60172,56032,13678,6419,7259,157490
110.855926513671875,26.439521789550781,4305,43,430528,,Xinning,County,3,557120,290142,266978,153872,552119,286741,265378,132935,70092,62843,380903,198553,182350,43282,21497,21785,544880
112.393409729003906,26.407257080078125,4304,43,430482,,Changning,City,3,795223,428332,366891,209122,766262,408050,358212,186356,106879,79477,554468,295119,259349,54399,26334,28065,765352
111.290817260742188,26.406089782714844,4311,43,431122,,Dongan,County,3,556501,291475,265026,150757,552577,288473,264104,118889,63188,55701,398033,209108,188925,39579,19179,20400,544242
110.31719970703125,26.369916915893555,4305,43,430529,ǲ,Chengbumiaozuzizhixian,County,3,241517,125616,115901,63384,228262,117775,110487,55625,28770,26855,169977,89174,80803,15915,7672,8243,240389
109.770538330078125,26.157476425170898,4312,43,431230,ͨ,Tongdaodongzuzizhixian,County,3,206327,107168,99159,51928,202827,104959,97868,49768,25625,24143,143360,75111,68249,13199,6432,6767,195618
113.109260559082031,26.135557174682617,4310,43,431023,,Yongxing,County,3,576848,302600,274248,162004,572546,299437,273109,131911,70677,61234,402825,211466,191359,42112,20457,21655,554460
113.933128356933594,26.082670211791992,4310,43,431027,,Guidong,County,3,167045,86508,80537,44877,166677,86205,80472,39394,20332,19062,115214,60110,55104,12437,6066,6371,165938
111.652992248535156,25.963418960571289,4311,43,431123,˫,Shuangpai,County,3,161510,85818,75692,43635,158987,83946,75041,35960,19295,16665,114565,61143,53422,10985,5380,5605,156143
112.210151672363281,25.912876129150391,4311,43,431128,,Xintian,County,3,358831,188956,169875,99391,356118,187228,168890,91528,50196,41332,244653,127783,116870,22650,10977,11673,357797
112.726188659667969,25.744569778442383,4310,43,431021,,Guiyang,County,3,725168,381851,343317,204521,717852,375939,341913,178034,95814,82220,499682,264250,235432,47452,21787,25665,685716
111.941520690917969,25.597820281982422,4311,43,431126,Զ,Ningyuan,County,3,738259,396100,342159,195050,735318,393759,341559,172659,97995,74664,518249,275677,242572,47351,22428,24923,721327
112.361763000488281,25.585832595825195,4310,43,431024,κ,Jiahe,County,3,307657,162221,145436,90164,302844,158686,144158,83173,47203,35970,202545,104940,97605,21939,10078,11861,291081
113.679718017578125,25.551719665527344,4310,43,431026,,Rucheng,County,3,342861,180779,162082,97241,338438,177418,161020,78009,42311,35698,238908,125296,113612,25944,13172,12772,331211
111.591583251953125,25.555206298828125,4311,43,431124,,Dao,County,3,624199,345769,278430,166233,616014,341088,274926,141254,84411,56843,443284,241238,202046,39661,20120,19541,611462
112.947250366210938,25.405281066894531,4310,43,431022,,Yizhang,County,3,534250,279400,254850,137117,526683,274136,252547,136170,74050,62120,363514,189051,174463,34566,16299,18267,511000
112.18292236328125,25.369075775146484,4311,43,431127,ɽ,Lanshan,County,3,332937,175188,157749,91207,329687,172911,156776,86378,46734,39644,224369,118183,106186,22190,10271,11919,318700
112.552017211914062,25.287189483642578,4310,43,431025,,Linwu,County,3,303290,160077,143213,86721,298987,156854,142133,69158,37397,31761,213141,112658,100483,20991,10022,10969,294943
111.34228515625,25.275115966796875,4311,43,431125,,Jiangyong,County,3,235893,123293,112600,65113,235024,122762,112262,56448,30243,26205,164207,85891,78316,15238,7159,8079,228057
111.564888000488281,25.187177658081055,4311,43,431129,,Jianghuayaozuzizhixian,County,3,437835,233147,204688,108791,434616,230721,203895,114510,62606,51904,294449,156441,138008,28876,14100,14776,428286
112.933151245117188,27.790773391723633,4303,43,430321,̶,Xiangtan,County,3,1061269,549016,512253,299052,1047277,539847,507430,239355,127360,111995,727434,375471,351963,94480,46185,48295,1019205
109.947776794433594,27.455423355102539,4312,43,431221,з,Zhongfang,County,3,236675,124339,112336,68465,235276,123313,111963,55973,29557,26416,161531,85474,76057,19171,9308,9863,226697
113.224838256835938,28.181415557861328,4301,43,430121,ɳ,Changsha,County,3,774707,403933,370774,215426,717380,370390,346990,144510,74897,69613,563551,296613,266938,66646,32423,34223,719666
112.495948791503906,26.738807678222656,4304,43,430422,,Hengnan,County,3,982217,524034,458183,259987,958613,508371,450242,241805,135805,106000,670799,353094,317705,69613,35135,34478,954273
111.876197814941406,29.63578987121582,4307,43,430781,,Jinshi,City,3,243242,126619,116623,75698,226576,114676,111900,45971,23830,22141,178769,94219,84550,18502,8570,9932,215173
113.410476684570312,29.493867874145508,4306,43,430682,,Linxiang,City,3,448452,235723,212729,122072,431960,225681,206279,109450,59947,49503,311844,162591,149253,27158,13185,13973,409465
112.394302368164062,28.832717895507812,4309,43,430981,佭,Yuanjiang,City,3,700236,363730,336506,205639,691332,357237,334095,160203,83183,77020,485605,253951,231654,54428,26596,27832,646300
113.070587158203125,28.811098098754883,4306,43,430681,,Miluo,City,3,658867,342113,316754,192983,653128,338516,314612,148148,79098,69050,461850,239125,222725,48869,23890,24979,624565
109.734039306640625,28.315654754638672,4331,43,433101,,Jishou,City,3,294297,151422,142875,75331,264916,135016,129900,68121,35079,33042,208363,107727,100636,17813,8616,9197,205512
113.620803833007812,28.147993087768555,4301,43,430181,,Liuyang,City,3,1307572,680610,626962,343031,1224375,637675,586700,250245,129876,120369,943882,495087,448795,113445,55647,57798,1261715
112.529067993164062,27.734865188598633,4303,43,430381,,Xiangxiang,City,3,807718,413489,394229,243766,794876,405414,389462,187997,99618,88379,544077,278259,265818,75644,35612,40032,763039
111.669479370117188,27.698657989501953,4313,43,431382,Դ,Lianyuan,City,3,996893,521941,474952,282004,976431,506698,469733,262852,144422,118430,655542,340022,315520,78499,37497,41002,957691
111.418380737304688,27.696771621704102,4313,43,431381,ˮ,Lengshuijiang,City,3,339701,175071,164630,100634,321790,163384,158406,73378,38992,34386,245134,125903,119231,21189,10176,11013,294763
113.4952392578125,27.66937255859375,4302,43,430281,,Liling,City,3,934396,484127,450269,245781,912685,471322,441363,206665,106660,100005,649305,338077,311228,78426,39390,39036,885189
109.821242071009195,27.192197134776798,4312,43,431281,齭,Hongjiang,City,3,485061,250434,234627,146331,475267,243714,231553,100205,52525,47680,344006,178749,165257,40850,19160,21690,458799
111.584228515625,26.44354248046875,4311,43,431103,ˮ̲,Lengshuitan,Qu,3,423462,220016,203446,125644,411459,213034,198425,95141,52200,42941,298343,152951,145392,29978,14865,15113,365867
112.849723815917969,26.415779113769531,4304,43,430481,,Leiyang,City,3,1180235,631431,548804,305718,1150129,606970,543159,276470,152735,123735,824923,439744,385179,78842,38952,39890,1136328
113.220741271972656,25.947257995605469,4310,43,431081,,Zixing,City,3,351581,181632,169949,109434,344335,177060,167275,68140,35599,32541,257408,133296,124112,26033,12737,13296,324214
112.481765747070312,27.909420013427734,4303,43,430382,ɽ,Shaoshan,City,3,95299,48304,46995,27731,93639,47269,46370,19580,10135,9445,67211,34095,33116,8508,4074,4434,88757
113.010460171873959,28.195552306874923,4301,43,430102,ܽ,Furong,Qu,3,390074,204551,185523,112259,314975,156976,157999,48065,25209,22856,317999,167740,150259,24010,11602,12408,212691
112.94721262226382,28.214507149565851,4301,43,430104,´,Yuelu,Qu,3,409939,218316,191623,96712,279376,140049,139327,46896,24244,22652,341642,183478,158164,21401,10594,10807,274588
113.180527518555422,27.859826140919317,4302,43,430202,,Hetang,Qu,3,260835,133726,127109,77774,226406,115065,111341,39980,20920,19060,207123,105875,101248,13732,6931,6801,183168
113.15267280128549,27.833501889730236,4302,43,430203,«,Lusong,Qu,3,226162,113331,112831,69093,196443,99035,97408,32272,17113,15159,180434,89189,91245,13456,7029,6427,153849
113.167330703274374,27.916572446627789,4302,43,430204,ʯ,Shifeng,Qu,3,272258,144904,127354,82435,240780,122901,117879,41903,21610,20293,215019,115274,99745,15336,8020,7316,218709
113.126426455266952,27.831494880332258,4302,43,430211,Ԫ,Tianyuan,Qu,3,120741,62096,58645,33766,111046,56301,54745,23305,11955,11350,90180,46482,43698,7256,3659,3597,89972
112.905099039136928,27.873859679083889,4303,43,430302,,Yuhu,Qu,3,362871,185206,177665,101142,306745,152352,154393,52901,27795,25106,285490,145513,139977,24480,11898,12582,273431
112.894390979168733,27.83544163820865,4303,43,430304,,Yuetang,Qu,3,344912,178413,166499,103334,314267,158398,155869,55122,28730,26392,267028,138145,128883,22762,11538,11224,265290
111.489598071818975,27.245138431440253,4305,43,430502,˫,Shuangqing,Qu,3,262658,134130,128528,80434,253349,128006,125343,53346,28428,24918,191261,96912,94349,18051,8790,9261,197937
111.437766118602227,27.223301443549385,4305,43,430503,,Daxiang,Qu,3,277672,140607,137065,78565,250134,126756,123378,55485,29427,26058,202773,101787,100986,19414,9393,10021,230299
111.459297755164414,27.282935160751254,4305,43,430511,,Beita,Qu,3,67538,34826,32712,19983,66144,33860,32284,15417,8091,7326,47016,24361,22655,5105,2374,2731,56879
113.092262767006162,29.3646969132149,4306,43,430602,¥,Yueyanglou,Qu,3,542599,276497,266102,167382,497032,252287,244745,102741,55279,47462,414462,208661,205801,25396,12557,12839,334684
113.260166152734001,29.477757484509024,4306,43,430603,Ϫ,Yunxi,Qu,3,163220,84405,78815,49094,158356,80945,77411,34513,18006,16507,120360,62303,58057,8347,4096,4251,138103
113.043326101819162,29.434726968568722,4306,43,430611,ɽ,Junshan,Qu,3,207174,110268,96906,59278,197882,102429,95453,45210,23997,21213,148688,79703,68985,13276,6568,6708,182737
111.697603196316194,29.035633789603828,4307,43,430702,,Wuling,Qu,3,509940,257166,252774,146605,443302,220295,223007,85704,43875,41829,391995,198244,193751,32241,15047,17194,385922
110.491766904566035,29.116757965406375,4308,43,430802,,Yongding,Qu,3,405968,209084,196884,112677,393873,201906,191967,93333,48805,44528,282865,145728,137137,29770,14551,15219,365307
112.316345153995471,28.621063296486245,4309,43,430902,,Ziyang,Qu,3,397767,204043,193724,113986,388792,199880,188912,86102,45091,41011,278485,143279,135206,33180,15673,17507,362722
113.025814691052929,25.794963651445464,4310,43,431002,,Beihu,Qu,3,314477,164141,150336,97695,290290,148775,141515,60341,32018,28323,235617,122954,112663,18519,9169,9350,226640
111.620110300666568,26.214675290972757,4311,43,431102,֥ɽ,Zhishan,Qu,3,553077,288005,265072,151176,533033,277440,255593,118208,62756,55452,393507,205656,187851,41362,19593,21769,530406
109.960524746347545,27.546644865443692,4312,43,431202,׳,Hecheng,Qu,3,346522,178221,168301,102053,308174,156574,151600,66010,34861,31149,263019,134440,128579,17493,8920,8573,245535
111.983014648982831,27.738047319140879,4313,43,431302,¦,Louxing,Qu,3,398577,205172,193405,119617,363505,185184,178321,79832,42797,37035,294938,150545,144393,23807,11830,11977,326109
112.967821851978428,28.173385603179995,4301,43,430103,,Tianxin,Qu,3,396827,203501,193326,111727,312002,154848,157154,46996,24470,22526,321586,166100,155486,28245,12931,15314,266623
112.996516977758091,28.22410503214109,4301,43,430105,,Kaifu,Qu,3,423645,213186,210459,131843,383155,189855,193300,59896,31316,28580,328527,165875,162652,35222,15995,19227,294746
112.989104952648958,28.174338577836885,4301,43,430111,껨,Yuhua,Qu,3,502388,259750,242638,140042,411341,207275,204066,64898,33954,30944,410176,211938,198238,27314,13858,13456,339806
112.623384983791794,26.909207986242091,4304,43,430402,,Jiangdong,Qu,3,177909,90232,87677,59066,164724,81941,82783,29118,15350,13768,135270,68548,66722,13521,6334,7187,127341
112.593479255300466,26.936108832923289,4304,43,430404,Ǳ,Chengbei,Qu,3,233674,118593,115081,69599,202929,100982,101947,36824,19782,17042,181591,91474,90117,15259,7337,7922,163837
112.593049986470447,26.89675919017154,4304,43,430403,,Chengnan,Qu,3,195001,99827,95174,57599,161183,79967,81216,28635,14961,13674,154010,79019,74991,12356,5847,6509,135635
112.606071140981015,26.871861598030431,4304,43,430411,,Jiaoqu,Qu,3,219044,114220,104824,61796,211469,108502,102967,49060,26509,22551,155753,80961,74792,14231,6750,7481,159174
106.834243883481818,39.715802211934609,1503,15,150302,,Haibowan,Qu,3,199557,104318,95239,62740,190743,97270,93473,40722,21011,19711,151183,79118,72065,7652,4189,3463,138163
106.816817301360047,39.545502431372867,1503,15,150303,,Hainan,Qu,3,100819,53671,47148,32763,96876,50167,46709,21659,11239,10420,74574,39799,34775,4586,2633,1953,77397
106.935243732239655,39.527075398802545,1503,15,150304,ڴ,Wuda,Qu,3,127177,65958,61219,40965,124746,63858,60888,24856,12649,12207,96145,49785,46360,6176,3524,2652,107120
122.268217757051218,43.608985514232081,1505,15,150502,ƶ,Keerqin,Qu,3,793913,400930,392983,221838,767979,387139,380840,167183,85999,81184,584509,293880,290629,42221,21051,21170,681538
111.688102722167969,40.831863403320312,1501,15,150102,³,Xincheng,Qu,3,409629,209245,200384,127619,357716,179800,177916,68829,35480,33349,318205,161613,156592,22595,12152,10443,232885
111.624649047851562,40.809234619140625,1501,15,150103,,Huimin,Qu,3,284676,146539,138137,93629,264642,134274,130368,49063,25423,23640,218407,111904,106503,17206,9212,7994,157632
111.627578735351562,40.789283752441406,1501,15,150104,Ȫ,Yuquan,Qu,3,266888,139986,126902,88679,245675,125408,120267,48894,25573,23321,202939,106715,96224,15055,7698,7357,122523
111.693901062011719,40.808002471923828,1501,15,150105,,Saihan,Qu,3,445762,228558,217204,133740,383346,196337,187009,74478,39350,35128,348082,176569,171513,23202,12639,10563,279227
118.966423338389063,42.271417030614757,1504,15,150402,ɽ,Hongshan,Qu,3,318512,158698,159814,96878,298137,148353,149784,59906,31324,28582,242004,119136,122868,16602,8238,8364,204893
119.017988018002896,42.263879264333944,1504,15,150403,Ԫɽ,Yuanbaoshan,Qu,3,297035,152087,144948,88349,290259,147746,142513,65980,35617,30363,217576,109508,108068,13479,6962,6517,254850
121.528892517089844,50.778202056884766,1521,15,152105,,Genhe,City,3,157337,80485,76852,49651,156374,79767,76607,30038,15292,14746,119059,60613,58446,8240,4580,3660,141343
119.941017150878906,47.161617279052734,1522,15,152202,ɽ,Aershan,City,3,45189,23568,21621,14879,44320,22801,21519,8754,4544,4210,34167,17747,16420,2268,1277,991,37236
109.970550537109375,41.767955780029297,1502,15,150206,ƿ,Baiyunkuangqu,Qu,3,25286,13029,12257,8388,24907,12729,12178,4948,2524,2424,19099,9759,9340,1239,746,493,19070
123.712104797363281,50.584728240966797,1521,15,152127,״,Elunchunzizhiqi,Qi,3,292097,150635,141462,85025,288647,148496,140151,62828,32133,30695,216787,111619,105168,12482,6883,5599,220569
120.223175048828125,50.275138854980469,1521,15,152106,,Eerguna,City,3,87829,45425,42404,27937,86257,44156,42101,17918,9201,8717,66139,34210,31929,3772,2014,1758,67472
119.431350708007812,49.326984405517578,1521,15,152131,°Ͷ,Chenbaerhu,Qi,3,67882,35385,32497,20560,66992,34590,32402,14770,7570,7200,50423,26455,23968,2689,1360,1329,45131
119.732831305911304,49.149080766391499,1521,15,152128,¿,Ewenkezuzizhiqi,Qi,3,146808,75381,71427,44460,145108,74106,71002,30893,15736,15157,110082,56720,53362,5833,2925,2908,116375
124.500877380371094,48.472194671630859,1521,15,152123,ĪߴӶ,Molidawadawoerzuzizhiqi,Qi,3,294501,153703,140798,78015,290927,151209,139718,73599,37620,35979,210638,110465,100173,10264,5618,4646,249903
118.267135620117188,48.216030120849609,1521,15,152130,°Ͷ,Xinbaerhuzuo,Qi,3,41647,21618,20029,11958,40613,20705,19908,9318,4765,4553,30684,16076,14608,1645,777,868,33581
123.466609576667238,48.121935252398956,1521,15,152122,,Arong,Qi,3,304210,157262,146948,79734,302251,155887,146364,71925,36618,35307,219262,113636,105626,13023,7008,6015,275013
120.736506384505844,46.293833815753743,1522,15,152221,ƶǰ,Keerqinyouyiqian,Qi,3,341574,177261,164313,88050,340445,176336,164109,79268,40686,38582,247532,128960,118572,14774,7615,7159,317820
121.553688049316406,45.377368927001953,1522,15,152224,ͻȪ,Tuquan,County,3,292852,150461,142391,81677,291088,149306,141782,63905,32885,31020,213357,109560,103797,15590,8016,7574,276447
117.609390258789062,44.587070465087891,1525,15,152526,,Xiwuzhumuqin,Qi,3,72163,36831,35332,19488,71618,36442,35176,17388,8924,8464,52509,26811,25698,2266,1096,1170,59804
120.903060913085938,44.549728393554688,1505,15,150526,³,Zhalute,Qi,3,292484,149139,143345,74486,289479,147121,142358,71065,36260,34805,209784,106940,102844,11635,5939,5696,271799
123.311134338378906,44.120445251464844,1505,15,150521,ƶ,Keerqinzuoyizhong,Qi,3,511196,261995,249201,125183,508446,260282,248164,128433,65869,62564,361453,185030,176423,21310,11096,10214,495043
119.380378723144531,43.978538513183594,1504,15,150422,,Balinzuo,Qi,3,332550,169666,162884,91772,327708,166814,160894,70736,36332,34404,245572,125180,120392,16242,8154,8088,305593
120.08837890625,43.880847930908203,1504,15,150421,³ƶ,Alukeerqin,Qi,3,297090,151579,145511,81841,294552,150118,144434,66516,34179,32337,216530,110486,106044,14044,6914,7130,281882
118.051010131835938,43.600822448730469,1504,15,150424,,Linxi,County,3,235947,120249,115698,70991,234166,119168,114998,47634,24399,23235,175049,89149,85900,13264,6701,6563,221251
121.307395935058594,43.599082946777344,1505,15,150523,³,Kailu,County,3,382836,195491,187345,103189,380722,194111,186611,87694,45756,41938,277291,141130,136161,17851,8605,9246,367561
118.666984558105469,43.522350311279297,1504,15,150423,,Balinyou,Qi,3,174275,88776,85499,50226,172577,87662,84915,40163,20860,19303,127042,64482,62560,7070,3434,3636,156969
117.510604858398438,43.248016357421875,1504,15,150425,ʲ,Keshenketeng,Qi,3,242957,125188,117769,71373,240057,123016,117041,55983,28917,27066,174795,89766,85029,12179,6505,5674,222062
122.363784790039062,42.962894439697266,1505,15,150522,ƶ,Keerqinzuoyihou,Qi,3,387577,199366,188211,99486,384685,197536,187149,86119,44577,41542,283588,145674,137914,17870,9115,8755,371912
119.018783569335938,42.934436798095703,1504,15,150426,ţ,Wengniute,Qi,3,464211,238804,225407,121499,458877,235758,223119,105114,56547,48567,335417,170431,164986,23680,11826,11854,447406
120.645652770996094,42.843887329101562,1505,15,150525,,Naiman,Qi,3,421049,215743,205306,105858,416109,212859,203250,99443,51673,47770,300335,153620,146715,21271,10450,10821,401349
121.76318359375,42.72796630859375,1505,15,150524,,Kulun,Qi,3,172419,89116,83303,43837,170519,87746,82773,39932,20738,19194,123427,63786,59641,9060,4592,4468,165803
119.896110534667969,42.284286499023438,1504,15,150430,,Aohan,Qi,3,580842,300020,280822,152723,573632,295803,277829,134440,70509,63931,413879,212970,200909,32523,16541,15982,557756
113.842277526855469,42.242733001708984,1525,15,152528,,Xianghuang,Qi,3,26843,13528,13315,8077,26603,13392,13211,5628,2812,2816,20075,10185,9890,1140,531,609,21164
116.470954895019531,42.184219360351562,1525,15,152531,,Duolun,County,3,102879,54821,48058,27731,99131,51943,47188,20804,10566,10238,76658,41301,35357,5417,2954,2463,91237
101.071769714355469,41.971431732177734,1529,15,152923,,Ejina,Qi,3,22326,11203,11123,7379,20210,9566,10644,5111,2624,2487,16350,8179,8171,865,400,465,16769
118.686943054199219,41.929714202880859,1504,15,150428,,Kalaqin,Qi,3,362458,188826,173632,92886,358256,186169,172087,81660,43407,38253,260877,135133,125744,19921,10286,9635,344585
113.985794067382812,41.889934539794922,1526,15,152625,,Huade,County,3,129161,65864,63297,42970,126522,64164,62358,28036,14014,14022,92602,47217,45385,8523,4633,3890,111282
110.428916931152344,41.694759368896484,1502,15,150223,ï,Daerhanmaominganlianhe,Qi,3,98325,51984,46341,30167,96988,50947,46041,19741,10075,9666,71685,38030,33655,6899,3879,3020,80630
119.335052490234375,41.593379974365234,1504,15,150429,,Ningcheng,County,3,591684,307581,284103,153004,582437,301880,280557,140144,74416,65728,417349,215936,201413,34191,17229,16962,565865
113.535728454589844,41.553157806396484,1526,15,152626,̶,Shangdu,County,3,276156,143340,132816,87784,273246,141672,131574,50920,25081,25839,205947,107931,98016,19289,10328,8961,254001
111.442794799804688,41.095355987548828,1501,15,150125,䴨,Wuchuan,County,3,157530,83775,73755,47714,154965,82030,72935,33566,17770,15796,111504,58763,52741,12460,7242,5218,142745
108.268562316894531,41.093097686767578,1528,15,152822,ԭ,Wuyuan,County,3,269082,140204,128878,76122,259720,133287,126433,60325,30890,29435,193572,101087,92485,15185,8227,6958,225233
110.053459167480469,41.027854919433594,1502,15,150222,,Guyang,County,3,170643,90651,79992,51497,167818,88802,79016,34552,18192,16360,122746,64977,57769,13345,7482,5863,150273
113.888153076171875,40.876689910888672,1526,15,152627,˺,Xinghe,County,3,250261,129501,120760,74120,248713,128344,120369,55624,27887,27737,176713,92219,84494,17924,9395,8529,236230
111.124908447265625,40.712486267089844,1501,15,150121,Ĭ,Tumotezuo,Qi,3,340606,179464,161142,96875,332862,174659,158203,76342,40982,35360,238040,123905,114135,26224,14577,11647,299922
110.513114929199219,40.548046112060547,1502,15,150221,Ĭ,Tumoteyou,Qi,3,314290,164479,149811,98654,308756,160960,147796,69455,36820,32635,221552,114666,106886,23283,12993,10290,288628
112.49566650390625,40.524707794189453,1526,15,152629,,Liangcheng,County,3,197098,103270,93828,63581,194332,101395,92937,41787,21896,19891,137869,71820,66049,17442,9554,7888,173815
111.821571350097656,40.372364044189453,1501,15,150123,ָ,Helingeer,County,3,176474,93611,82863,47059,172418,90847,81571,36728,19458,17270,126070,66604,59466,13676,7549,6127,159610
111.155303955078125,40.271236419677734,1501,15,150122,п,Tuoketuo,County,3,185582,98353,87229,50819,179112,93048,86064,41141,21688,19453,130734,69320,61414,13707,7345,6362,160474
111.677094175837567,39.907029674866195,1501,15,150124,ˮ,Qingshuihe,County,3,125748,65205,60543,36243,123460,63571,59889,35025,17938,17087,81429,42084,39345,9294,5183,4111,109374
111.259789407227856,39.865477657441353,1527,15,152723,׼,Zhungeer,Qi,3,271298,146399,124899,84430,260536,137396,123140,59704,31872,27832,190913,102534,88379,20681,11993,8688,216879
109.733787536621094,39.566646575927734,1527,15,152728,,Yijinhuoluo,Qi,3,147739,80820,66919,46488,140362,74450,65912,29076,15898,13178,108831,59721,49110,9832,5201,4631,118739
117.443641662597656,49.578433990478516,1521,15,152102,,Manzhouli,City,3,181112,92853,88259,59492,175790,88863,86927,34664,17623,17041,137122,70480,66642,9326,4750,4576,126507
120.728073120117188,49.282691955566406,1521,15,152104,ʯ,Yakeshi,City,3,405806,207451,198355,130490,398047,202146,195901,76322,38771,37551,304314,155374,148940,25170,13306,11864,335209
119.730560302734375,49.211528778076172,1521,15,152101,,Hailaer,City,3,262184,132849,129335,80683,247274,123632,123642,46454,23732,22722,200259,101458,98801,15471,7659,7812,199135
122.733367919921875,48.010650634765625,1521,15,152103,,Zhalantun,City,3,409051,211922,197129,111419,402972,208227,194745,87149,44173,42976,301623,156980,144643,20279,10769,9510,356033
122.10075569778536,46.132820141908596,1522,15,152201,,Wulanhaote,City,3,269162,135406,133756,79688,258230,129298,128932,52745,27133,25612,204057,102184,101873,12360,6089,6271,222763
119.641426086425781,45.539466857910156,1505,15,150581,ֹ,Huolinguole,City,3,66945,33948,32997,19572,66482,33582,32900,14193,7276,6917,50706,25608,25098,2046,1064,982,51516
116.066268920898438,43.944290161132812,1525,15,152502,ֺ,Xilinhaote,City,3,173796,89527,84269,53477,163198,82778,80420,33524,17004,16520,133106,68613,64493,7166,3910,3256,101342
111.970115661621094,43.649314880371094,1525,15,152501,,Erlianhaote,City,3,47025,24625,22400,16629,45275,23299,21976,10574,5396,5178,35557,18725,16832,894,504,390,15868
113.098518371582031,41.031166076660156,1526,15,152601,,Jining,City,3,272448,136913,135535,85286,252657,126817,125840,49648,25397,24251,206659,103017,103642,16141,8499,7642,187315
107.394569396972656,40.762340545654297,1528,15,152801,ٺ,Linhe,City,3,510965,260835,250130,148810,489091,249072,240019,108413,56069,52344,378070,191480,186590,24482,13286,11196,375592
113.153831481933594,40.436588287353516,1526,15,152602,,Fengzhen,City,3,264204,137562,126642,80049,261528,135558,125970,57768,29355,28413,184825,97066,87759,21611,11141,10470,223320
109.997581481933594,39.818428039550781,1527,15,152701,ʤ,Dongsheng,City,3,252566,129512,123054,83793,231937,118188,113749,49882,26456,23426,192107,97205,94902,10577,5851,4726,135223
110.058526367388524,40.568293856092801,1502,15,150202,,Donghe,Qu,3,429355,218654,210701,144094,412611,207585,205026,76289,38784,37505,323378,164490,158888,29688,15380,14308,264207
109.844515958191067,40.670203574758254,1502,15,150203,,Kundulun,Qu,3,505951,261196,244755,166567,481321,244159,237162,90185,46313,43872,387713,199251,188462,28053,15632,12421,268871
109.854994469006598,40.6749842178656,1502,15,150204,ɽ,Qingshan,Qu,3,382659,195081,187578,125661,355921,180192,175729,64459,33164,31295,299500,151566,147934,18700,10351,8349,236328
110.292918720319065,40.700776490357896,1502,15,150205,ʯ,Shiguai,Qu,3,50337,26533,23804,18402,49388,25652,23736,9092,4716,4376,36988,19338,17650,4257,2479,1778,40428
109.929259808997713,40.579767507308929,1502,15,150207,ԭ,Jiuyuan,Qu,3,277593,148002,129591,89972,266846,139474,127372,60624,31887,28737,202326,108198,94128,14643,7917,6726,163634
118.956872926523459,42.21126659240138,1504,15,150404,ɽ,Songshan,Qu,3,538176,278665,259511,141463,510534,261897,248637,129558,70481,59077,381220,194061,187159,27398,14123,13275,475115
116.820363875606432,48.66044325098661,1521,15,152129,°Ͷ,Xinbaerhuyou,Qi,3,36764,19078,17686,10546,35855,18309,17546,8071,4110,3961,27306,14355,12951,1387,613,774,26420
121.466846689390792,45.06113100739622,1522,15,152222,ƶ,Keerqinyouyizhong,Qi,3,247031,125842,121189,60260,244934,124470,120464,60872,30994,29878,178037,90740,87297,8122,4108,4014,225460
122.909887002435639,46.723372956146001,1522,15,152223,,Zhalaite,Qi,3,392979,207957,185022,100869,381341,197490,183851,90607,46243,44364,285863,152651,133212,16509,9063,7446,362758
114.964796367673827,44.021855615669089,1525,15,152522,͸,Abaga,Qi,3,46975,24407,22568,14475,46402,23951,22451,9825,4956,4869,35181,18506,16675,1969,945,1024,34109
113.725402242849455,43.844138660213744,1525,15,152523,,Sunitezuo,Qi,3,37612,19582,18030,11100,36737,18928,17809,8514,4341,4173,27676,14564,13112,1422,677,745,27384
112.644334645547062,42.740759568036964,1525,15,152524,,Suniteyou,Qi,3,76880,39650,37230,24515,75297,38323,36974,16483,8313,8170,56740,29434,27306,3657,1903,1754,50238
116.969814729523719,45.517568097795888,1525,15,152525,,Dongwuzhumuqin,Qi,3,85909,45316,40593,24827,83486,43332,40154,19269,9937,9332,64106,34108,29998,2534,1271,1263,54803
115.277959141624137,41.894489057284758,1525,15,152527,̫,Taipusi,Qi,3,170261,87860,82401,53333,168973,87103,81870,33092,16723,16369,125986,65113,60873,11183,6024,5159,158137
114.996458059087146,42.308853098410495,1525,15,152529,,Zhengxiangbai,Qi,3,63639,33044,30595,19373,63051,32501,30550,12932,6577,6355,47321,24745,22576,3386,1722,1664,53261
115.996119167343721,42.248080649446628,1525,15,152530,,Zhenglan,Qi,3,71186,36684,34502,21277,70165,36048,34117,15327,7791,7536,52225,26970,25255,3634,1923,1711,60553
112.564212251814041,40.896157967465442,1526,15,152624,׿,Zhuozi,County,3,172867,91964,80903,52773,171119,90836,80283,34620,17691,16929,123212,65868,57344,15035,8405,6630,159057
113.202982111524392,40.780886212599313,1526,15,152630,ǰ,Chahaeryouyiqian,Qi,3,209468,107923,101545,66829,206523,106034,100489,40460,20252,20208,151222,78388,72834,17786,9283,8503,190803
112.627325374297655,41.265311293419778,1526,15,152631,,Chahaeryouyizhong,Qi,3,167203,87974,79229,52501,164836,86413,78423,32883,16892,15991,121282,63690,57592,13038,7392,5646,153900
113.176384586561724,41.451330515119274,1526,15,152632,,Chahaeryouyihou,Qi,3,164980,85377,79603,49281,163734,84515,79219,30429,15110,15319,123221,64130,59091,11330,6137,5193,147875
111.690455043341984,41.515940552390056,1526,15,152634,,Siziwang,Qi,3,180568,94556,86012,54408,178288,93074,85214,38078,19749,18329,129636,67296,62340,12854,7511,5343,156071
110.028948384250384,40.399602176162276,1527,15,152722,,Dalate,Qi,3,311608,167031,144577,91635,294522,154672,139850,65436,34724,30712,224041,120043,103998,22131,12264,9867,248843
107.434308256208979,38.226940852882727,1527,15,152724,пǰ,Etuokeqian,Qi,3,66866,34793,32073,19921,65169,33679,31490,15409,8129,7280,48189,25047,23142,3268,1617,1651,56181
107.981879941310538,39.096833143532685,1527,15,152725,п,Etuoke,Qi,3,100072,53619,46453,31233,95421,49614,45807,21333,11322,10011,73629,39670,33959,5110,2627,2483,71755
108.723456781841065,39.841812209560509,1527,15,152726,,Hangjin,Qi,3,122744,65285,57459,37981,120014,63220,56794,25403,13451,11952,89310,47629,41681,8031,4205,3826,98085
108.848218100422585,38.600437089674394,1527,15,152727,,Wushen,Qi,3,96873,51146,45727,28581,94832,49676,45156,21410,11722,9688,70481,36939,33542,4982,2485,2497,79812
107.001038870001494,40.326383468265625,1528,15,152823,,Dengkou,County,3,117561,60832,56729,35317,115719,59600,56119,26077,13381,12696,85380,44212,41168,6104,3239,2865,93694
108.651067524321235,40.719330312601244,1528,15,152824,ǰ,Wulateqian,Qi,3,319376,166820,152556,93937,311807,161685,150122,69506,36019,33487,230364,120064,110300,19506,10737,8769,263128
108.520825108752348,41.56429385768201,1528,15,152825,,Wulatezhong,Qi,3,133309,70328,62981,39379,130208,67852,62356,29445,15385,14060,96998,51225,45773,6866,3718,3148,103320
107.053904917615057,41.447736245595529,1528,15,152826,غ,Wulatehou,Qi,3,48090,25212,22878,14314,46829,24169,22660,10693,5542,5151,35599,18718,16881,1798,952,846,39063
107.144665705482311,40.885123882857094,1528,15,152827,,Hangjinhou,Qi,3,284279,145622,138657,76153,277164,141598,135566,63873,32694,31179,204390,104505,99885,16016,8423,7593,254560
105.664613604254441,38.839215391775674,1529,15,152921,,Alashanzuo,Qi,3,148672,79963,68709,43226,135244,68753,66491,29820,15401,14419,111639,60896,50743,7213,3666,3547,106253
101.667349199542727,39.205333488148696,1529,15,152922,,Alashanyou,Qi,3,25281,13171,12110,7793,24327,12314,12013,5202,2655,2547,18721,9833,8888,1358,683,675,21353
118.751559895807219,32.212930882489815,3201,32,320112,,Dachang,Qu,3,219139,115909,103230,74742,204918,105063,99855,33501,17337,16164,170116,91156,78960,15522,7416,8106,162047
118.810814030953068,32.0455180000423,3201,32,320102,,Xuanwu,Qu,3,491364,264630,226734,139155,389761,194780,194981,56388,29600,26788,396439,216347,180092,38537,18683,19854,335029
118.771935465162727,32.062941236731362,3201,32,320106,¥,Gulou,Qu,3,633188,343670,289518,173976,493201,246452,246749,71464,37051,34413,512676,283042,229634,49048,23577,25471,432209
118.714082704608813,32.103377673827843,3201,32,320111,ֿ,Pukou,Qu,3,224112,123613,100499,60772,176494,90200,86294,29242,15426,13816,177511,100113,77398,17359,8074,9285,150604
118.869757546679736,32.126022220952642,3201,32,320113,ϼ,Xixia,Qu,3,395388,210195,185193,119338,340996,172988,168008,56399,29361,27038,310247,167188,143059,28742,13646,15096,287532
118.739636382938272,31.975364259303319,3201,32,320114,껨̨,Yuhuatai,Qu,3,274936,148598,126338,87634,240100,123130,116970,38242,19729,18513,218809,120165,98644,17885,8704,9181,170659
120.299905040500562,31.583995872551515,3202,32,320202,簲,Chongan,Qu,3,176580,93835,82745,56214,155062,76969,78093,22741,11844,10897,136126,73945,62181,17713,8046,9667,121535
117.190785766950825,34.262624497995915,3203,32,320302,¥,Gulou,Qu,3,298638,152666,145972,94384,281417,140601,140816,48394,25317,23077,227682,117078,110604,22562,10271,12291,205309
117.184560975837158,34.256733576049207,3203,32,320303,,Yunlong,Qu,3,220217,110556,109661,69268,202141,99740,102401,35245,18438,16807,166368,83865,82503,18604,8253,10351,142885
119.959278185670499,31.785965680097625,3204,32,320402,,Tianning,Qu,3,281302,139109,142193,88354,251541,124752,126789,37204,18984,18220,219194,108502,110692,24904,11623,13281,171066
120.050285209762421,31.731441266921696,3204,32,320405,,Qishuyan,Qu,3,89438,46704,42734,27972,81877,41442,40435,12543,6553,5990,68349,36280,32069,8546,3871,4675,59931
120.604771509136924,31.308461602043227,3205,32,320504,,Jinchang,Qu,3,387882,197908,189974,117968,334338,167099,167239,48211,24709,23502,303606,156998,146608,36065,16201,19864,257027
120.591993863350609,31.335683718843825,3205,32,320505,,Huqiu,Qu,3,226242,116360,109882,65812,189936,97354,92582,30558,16077,14481,181343,94049,87294,14341,6234,8107,118874
120.865353027658301,32.008783402566152,3206,32,320602,紨,Chongchuan,Qu,3,546938,273210,273728,165249,467349,231885,235464,74870,38416,36454,428801,214889,213912,43267,19905,23362,336771
120.827459072173838,32.00732849791477,3206,32,320611,բ,Gangzha,Qu,3,224448,112996,111452,67341,206281,102299,103982,31917,16375,15542,165713,84754,80959,26818,11867,14951,155063
119.358205762941338,34.747268604920286,3207,32,320703,,Lianyun,Qu,3,131429,69606,61823,39472,121721,61631,60090,24573,13389,11184,99454,52793,46661,7402,3424,3978,99600
119.246804326180026,34.642733781914259,3207,32,320704,̨,Yuntai,Qu,3,150426,77808,72618,41775,147041,75242,71799,36167,19869,16298,102104,52254,49850,12155,5685,6470,126597
119.161374558063159,34.620754438702299,3207,32,320705,,Xinpu,Qu,3,260628,133142,127486,76405,231023,115515,115508,43268,22934,20334,201998,102650,99348,15362,7558,7804,184233
119.131211508075523,34.578423149299766,3207,32,320706,,Haizhou,Qu,3,144759,73794,70965,39990,139606,70804,68802,34675,18602,16073,100203,50422,49781,9881,4770,5111,115991
119.00828365848507,33.596137403921311,3208,32,320802,,Qinghe,Qu,3,248794,125968,122826,66174,215611,108381,107230,43286,23183,20103,192444,96701,95743,13064,6084,6980,169560
120.129257671982984,33.380025985517292,3209,32,320902,,Cheng,Qu,3,683663,347576,336087,201330,631458,321263,310195,126019,69269,56750,519456,260695,258761,38188,17612,20576,498908
119.434664883175074,32.391402538083902,3210,32,321002,,Guangling,Qu,3,527038,268331,258707,135424,395254,196378,198876,74173,38631,35542,415719,211708,204011,37146,17992,19154,373218
119.419250817121963,32.385204614186286,3210,32,321011,,Jiaoqu,Qu,3,184955,94094,90861,50036,162753,82314,80439,27924,14712,13212,144567,73646,70921,12464,5736,6728,110213
119.454107970531922,32.210436795472425,3211,32,321102,,Jingkou,Qu,3,427272,227256,200016,122143,355143,177702,177441,59635,30716,28919,337785,182615,155170,29852,13925,15927,301080
119.909678592316851,32.489965910296888,3212,32,321202,,Hailing,Qu,3,402355,201180,201175,124078,384711,191355,193356,63291,33916,29375,300204,149405,150799,38860,17859,21001,315485
119.855504307173732,32.318608817631883,3212,32,321203,߸,Gaogang,Qu,3,205305,101898,103407,60848,198422,97046,101376,36868,20425,16443,145310,71556,73754,23127,9917,13210,185689
118.297967687150958,33.95236579738863,3213,32,321302,޳,Sucheng,Qu,3,244651,124719,119932,63223,232329,117222,115107,57772,31107,26665,171252,86768,84484,15627,6844,8783,200250
119.947958289391494,31.785327938189642,3204,32,320404,¥,Zhonglou,Qu,3,243064,125612,117452,78737,223656,111461,112195,32477,16714,15763,187598,98273,89325,22989,10625,12364,162958
119.943183780992797,31.777515829645651,3204,32,320411,,Jiaoqu,Qu,3,468041,241425,226616,129394,384341,196615,187726,63929,33762,30167,376738,195495,181243,27374,12168,15206,250930
120.294835777905419,31.569260462091762,3202,32,320203,ϳ,Nanchang,Qu,3,214407,107498,106909,71021,201180,99365,101815,28735,14871,13864,161249,81427,79822,24423,11200,13223,158294
120.284101122159683,31.584269980745063,3202,32,320204,,Beitang,Qu,3,190124,94678,95446,64533,178322,88575,89747,26084,13552,12532,143683,71901,71782,20357,9225,11132,134659
120.280966222694119,31.572775349371334,3202,32,320211,,Jiaoqu,Qu,3,812270,419730,392540,243570,718300,363347,354953,110355,58096,52259,642654,335104,307550,59261,26530,32731,491009
120.102593625130481,31.437602848338823,3202,32,320212,ɽ,Mashan,Qu,3,32385,16490,15895,9657,28538,14527,14011,5092,2662,2430,25655,13023,12632,1638,805,833,21211
119.434936441092177,32.213928814556681,3211,32,321111,,Runzhou,Qu,3,268391,137173,131218,86618,254032,128340,125692,40989,20994,19995,205108,105661,99447,22294,10518,11776,173752
120.625295837471441,31.290890712872908,3205,32,320502,,Canglang,Qu,3,313521,159111,154410,99713,273516,137099,136417,37660,19555,18105,244036,124595,119441,31825,14961,16864,202196
120.633555415968615,31.322602987085251,3205,32,320503,ƽ,Pingjiang,Qu,3,417064,213540,203524,130255,377253,188406,188847,55783,28485,27298,320416,166923,153493,40865,18132,22733,301001
119.025716951113509,33.574546934463022,3208,32,320811,,Qingpu,Qu,3,306258,156218,150040,82465,297741,149663,148078,68899,36783,32116,217166,110397,106769,20193,9038,11155,257567
117.148456068526855,34.303104598750267,3203,32,320304,,Jiuli,Qu,3,198123,109685,88438,54938,173699,88485,85214,40889,21747,19142,146853,83030,63823,10381,4908,5473,158207
117.123878705664438,34.26141083164795,3203,32,320311,Ȫɽ,Quanshan,Qu,3,468482,238318,230164,142204,423939,210734,213205,75547,39493,36054,358338,182406,175932,34597,16419,18178,336457
118.340362548828125,34.373092651367188,3203,32,320381,,Xinyi,City,3,962656,491509,471147,266795,952221,483943,468278,239974,128587,111387,646495,330587,315908,76187,32335,43852,927654
119.136322021484375,33.506614685058594,3208,32,320882,,Huaian,City,3,1200679,619541,581138,305571,1188717,612061,576656,277190,155030,122160,835461,425788,409673,88028,38723,49305,1152127
119.839149411341978,32.924682935965897,3212,32,321281,˻,Xinghua,City,3,1441659,745856,695803,465347,1427103,736640,690463,292818,169375,123443,1014569,515502,499067,134272,60979,73293,1372472
120.30572509765625,32.845481872558594,3209,32,320981,̨,Dongtai,City,3,1164653,583122,581531,387242,1142127,570468,571659,205854,110509,95345,834342,415687,418655,124457,56926,67531,1104428
119.178581237792969,32.266586303710938,3210,32,321081,,Yizheng,City,3,610356,311144,299212,176111,552685,274264,278421,109340,57531,51809,449143,230357,218786,51873,23256,28617,550916
119.570808410644531,31.991975784301758,3211,32,321181,,Danyang,City,3,877232,442296,434936,275248,839324,420045,419279,152159,79782,72377,647124,328694,318430,77949,33820,44129,717385
120.255569458007812,31.902072906494141,3202,32,320281,,Jiangyin,City,3,1315472,665719,649753,369554,1226446,620777,605669,243281,132286,110995,965987,486148,479839,106204,47285,58919,1068123
120.533058166503906,31.861804962158203,3205,32,320582,żҸ,Zhangjiagang,City,3,957223,466771,490452,276048,860688,425658,435030,157744,81959,75785,710716,345287,365429,88763,39525,49238,784651
121.664665222167969,31.806524276733398,3206,32,320681,,Qidong,City,3,1057073,495819,561254,424440,1016243,474042,542201,180708,91301,89407,741505,346343,395162,134860,58175,76685,973338
120.736656188964844,31.640842437744141,3205,32,320581,,Changshu,City,3,1239637,598034,641603,346380,1121983,551726,570257,171692,87273,84419,944524,457933,486591,123421,52828,70593,964910
120.950149536132812,31.382282257080078,3205,32,320583,ɽ,Kunshan,City,3,750074,377433,372641,207003,669203,334124,335079,104462,53582,50880,582178,295854,286324,63434,27997,35437,555157
119.822036743164062,31.367464065551758,3202,32,320282,,Yixing,City,3,1164275,592095,572180,378052,1107394,552920,554474,200767,103662,97105,849521,434380,415141,113987,54053,59934,959259
120.139641095006027,32.510432973876604,3212,32,321284,,Jiangyan,City,3,861321,419333,441988,278894,850317,412526,437791,151369,80449,70920,608562,292959,315603,101390,45925,55465,801108
121.074501037597656,32.080829620361328,3206,32,320683,ͨ,Tongzhou,City,3,1371498,652777,718721,458672,1337162,632420,704742,240392,121089,119303,953293,453387,499906,177813,78301,99512,1285740
119.930381774902344,31.730634689331055,3204,32,320483,,Wujin,City,3,1420204,719200,701004,409955,1307436,656788,650648,234024,121862,112162,1064372,544010,520362,121808,53328,68480,1087133
120.362754821777344,31.580450057983398,3202,32,320283,ɽ,Xishan,City,3,1181073,599540,581533,342010,1100179,552529,547650,187142,97421,89721,891355,457971,433384,102576,44148,58428,902266
120.626535272421449,31.237061876804436,3205,32,320586,,Wuxian,City,3,1128429,557717,570712,323160,1039744,515374,524370,174337,89003,85334,853769,425505,428264,100323,43209,57114,891106
119.12139892578125,34.844608306884766,3207,32,320721,,Ganyu,County,3,1043940,543238,500702,280911,1030009,533784,496225,303510,172888,130622,661038,333868,327170,79392,36482,42910,999100
116.935554504394531,34.727474212646484,3203,32,320322,,Peixian,County,3,1183048,606940,576108,305620,1140789,580264,560525,315853,174333,141520,777607,393203,384404,89588,39404,50184,1128199
116.5880126953125,34.6978759765625,3203,32,320321,,Fengxian,County,3,1068404,546636,521768,288581,1047359,534416,512943,286828,161997,124831,691965,346135,345830,89611,38504,51107,1027165
118.753181457519531,34.5294189453125,3207,32,320722,,Donghai,County,3,1110952,571891,539061,291073,1097902,563237,534665,316050,171982,144068,709666,360652,349014,85236,39257,45979,1057223
117.448249816894531,34.436172485351562,3203,32,320305,,Jiawang,Qu,3,494166,255461,238705,138364,471080,238446,232634,120547,65538,55009,336627,173257,163370,36992,16666,20326,451185
117.957786560058594,34.314041137695312,3203,32,320382,,Pizhou,City,3,1539922,791332,748590,414737,1515726,775779,739947,393393,217395,175998,1023935,518884,505051,122594,55053,67541,1499116
119.255790710449219,34.298286437988281,3207,32,320723,,Guanyun,County,3,1030069,538121,491948,247294,962658,499358,463300,287682,159819,127863,673987,346600,327387,68400,31702,36698,995102
117.16728377784041,34.176563540922395,3203,32,320323,ͭɽ,Tongshan,County,3,1262489,642404,620085,357799,1223532,620089,603443,313998,168827,145171,845604,427732,417872,102887,45845,57042,1168229
119.570999145507812,34.200260162353516,3209,32,320921,ˮ,Xiangshui,County,3,562411,291030,271381,152468,557195,287732,269463,138587,76012,62575,385310,197991,187319,38514,17027,21487,517031
118.766792297363281,34.137016296386719,3213,32,321322,,Shuyang,County,3,1705303,874577,830726,409105,1689008,864230,824778,466946,249445,217501,1119726,573779,545947,118631,51353,67278,1651192
119.346328735351562,34.090415954589844,3207,32,320724,,Guannan,County,3,697710,364343,333367,174514,690401,359357,331044,177902,99623,78279,475542,245672,229870,44266,19048,25218,669018
119.837776184082031,34.003391265869141,3209,32,320922,,Binhai,County,3,1050251,545055,505196,292051,1034331,535169,499162,242180,132333,109847,734262,380133,354129,73809,32589,41220,1005487
117.945381164550781,33.904792785644531,3203,32,320324,,Suining,County,3,1217820,623037,594783,326763,1208293,616652,591641,351172,192645,158527,759149,383071,376078,107499,47321,60178,1175620
119.793701171875,33.780426025390625,3209,32,320923,,Funing,County,3,1035035,532122,502913,278530,1013144,518878,494266,203845,111345,92500,754499,387307,367192,76691,33470,43221,987682
120.251274108886719,33.775848388671875,3209,32,320924,,Sheyang,County,3,1053680,535543,518137,335124,1036811,526050,510761,201987,107780,94207,772746,393099,379647,78947,34664,44283,970057
119.2669677734375,33.773067474365234,3208,32,320826,ˮ,Lianshui,County,3,1003294,515134,488160,247410,993889,508848,485041,252211,136327,115884,680152,349876,330276,70931,28931,42000,961373
118.674140930175781,33.707080841064453,3213,32,321323,,Siyang,County,3,1162470,603223,559247,279214,1141978,590747,551231,293068,162281,130787,782612,404045,378567,86790,36897,49893,1124027
119.011856079101562,33.637798309326172,3208,32,320821,,Huaiyin,County,3,838184,430244,407940,208281,822766,421657,401109,207725,112134,95591,564563,290222,274341,65896,27888,38008,782964
119.799491882324219,33.474441528320312,3209,32,320925,,Jianhu,County,3,789566,402159,387407,235595,769410,391115,378295,161995,89705,72290,566599,285336,281263,60972,27118,33854,721142
118.215545654296875,33.456211090087891,3213,32,321324,,Sihong,County,3,1022670,527944,494726,263554,1005981,514169,491812,253164,134095,119069,692027,358541,333486,77479,35308,42171,983758
118.837310791015625,33.29425048828125,3208,32,320829,,Hongze,County,3,365146,183602,181544,104409,360523,180905,179618,68940,36190,32750,267855,135068,132787,28351,12344,16007,345909
119.310043334960938,33.235946655273438,3210,32,321023,Ӧ,Baoying,County,3,869972,434842,435130,256452,810311,394838,415473,166001,89451,76550,627672,312696,314976,76299,32695,43604,809064
120.459114074707031,33.196273803710938,3209,32,320982,,Dafeng,City,3,756766,383391,373375,263397,736859,368350,368509,126749,64685,62064,561805,287401,274404,68212,31305,36907,694073
119.015365600585938,33.031723022460938,3208,32,320831,,Jinhu,County,3,363377,182905,180472,111401,354243,177192,177051,65979,33916,32063,265288,134770,130518,32110,14219,17891,327839
118.494377136230469,33.019519805908203,3208,32,320830,,Xuyi,County,3,712499,362913,349586,189862,706005,358447,347558,162208,85427,76781,494971,252788,242183,55320,24698,30622,679708
119.430633544921875,32.786884307861328,3210,32,321084,,Gaoyou,City,3,797752,392863,404889,241884,771368,376344,395024,140466,71566,68900,579861,286992,292869,77425,34305,43120,738169
120.448776245117188,32.54974365234375,3206,32,320621,,Haian,County,3,921999,436442,485557,298607,895486,419233,476253,160466,82567,77899,647225,301955,345270,114308,51920,62388,858772
119.555686950683594,32.431529998779297,3210,32,321088,,Jiangdu,City,3,1053023,512151,540872,324063,971364,455249,516115,181153,96264,84889,762549,368239,394310,109321,47648,61673,941888
120.556747436523438,32.391674041748047,3206,32,320682,,Rugao,City,3,1362533,659720,702813,394742,1327176,640047,687129,263829,139618,124211,930960,447018,483942,167744,73084,94660,1288471
118.832160949707031,32.337898254394531,3201,32,320123,,Liuhe,County,3,647537,325324,322213,186985,635602,318164,317438,131085,69170,61915,455604,229449,226155,60848,26705,34143,604468
121.179771423339844,32.310176849365234,3206,32,320623,綫,Rudong,County,3,1085478,532069,553409,354089,1069950,522513,547437,176719,89187,87532,762515,374591,387924,146244,68291,77953,1022835
119.807273864746094,32.240165710449219,3211,32,321182,,Yangzhong,City,3,301672,150538,151134,91780,290598,144019,146579,51364,26662,24702,223131,112204,110927,27177,11672,15505,248407
120.003730773925781,32.168991088867188,3212,32,321283,̩,Taixing,City,3,1235454,618158,617296,374005,1214571,605433,609138,241006,136121,104885,862179,425964,436215,132269,56073,76196,1146404
118.620468139648438,32.062957763671875,3201,32,320122,,Jiangpu,County,3,292641,148839,143802,91532,279724,139940,139784,60759,32059,28700,205652,105262,100390,26230,11518,14712,261584
120.253616333007812,32.015361785888672,3212,32,321282,,Jingjiang,City,3,639665,316885,322780,192580,626934,309183,317751,117903,62724,55179,458957,227897,231060,62805,26264,36541,556448
118.838760375976562,31.956821441650391,3201,32,320121,,Jiangning,County,3,781344,402569,378775,235600,730327,366885,363442,138957,72420,66537,577883,300629,277254,64504,29520,34984,662708
119.163688659667969,31.941751480102539,3211,32,321183,,Jurong,City,3,594316,302713,291603,182337,562276,281093,281183,108587,55766,52821,433333,222602,210731,52396,24345,28051,523451
121.16436767578125,31.890861511230469,3206,32,320684,,Haimen,City,3,942952,431066,511886,349954,904261,408991,495270,171349,86656,84693,647940,291480,356460,123663,52930,70733,848704
119.573486328125,31.74028205871582,3204,32,320482,̳,Jintan,City,3,533350,256798,276552,190983,519447,250132,269315,99326,51172,48154,380921,179957,200964,53103,25669,27434,435167
119.022865295410156,31.656557083129883,3201,32,320124,ˮ,Lishui,County,3,380288,193925,186363,125011,372844,189463,183381,79024,41894,37130,267015,135435,131580,34249,16596,17653,352432
121.102462768554688,31.448129653930664,3205,32,320585,̫,Taicang,City,3,515063,250788,264275,134562,475002,233007,241995,67448,34260,33188,385037,189482,195555,62578,27046,35532,427640
119.4879150390625,31.427835464477539,3204,32,320481,,Liyang,City,3,740871,375694,365177,240676,712646,354043,358603,146550,78940,67610,522470,261316,261154,71851,35438,36413,669076
118.86151123046875,31.321630477905273,3201,32,320125,ߴ,Gaochun,County,3,400121,203954,196167,138921,393747,198957,194790,78706,42379,36327,278495,140327,138168,42920,21248,21672,381895
120.637786865234375,31.167064666748047,3205,32,320584,⽭,Wujiang,City,3,857104,426423,430681,248348,806519,402407,404112,130862,66761,64101,636965,319273,317692,89277,40389,48888,735180
118.346957688498136,33.94835824867733,3213,32,321321,ԥ,Suyu,County,3,926482,476712,449770,238175,914157,468540,445617,256081,139309,116772,591250,303520,287730,79151,33883,45268,894171
120.14288140018914,33.343895330224981,3209,32,320928,ζ,Yandu,County,3,850519,439915,410604,250134,839621,432966,406655,171302,98700,72602,608909,309755,299154,70308,31460,38848,808477
119.447005824108743,32.214249661204086,3211,32,321121,ͽ,Dantu,County,3,375973,188144,187829,115896,366240,182134,184106,61784,31841,29943,275124,139649,135475,39065,16654,22411,329848
119.382064819335938,32.376567840576172,3210,32,321027,,Hanjiang,County,3,545458,270230,275228,158133,527774,259737,268037,92757,49807,42950,397874,196520,201354,54827,23903,30924,462069
118.789879466760524,32.032727726080601,3201,32,320103,,Baixia,Qu,3,369448,192896,176552,114874,322332,159668,162664,45675,23818,21857,290572,153496,137076,33201,15582,17619,253354
118.77208873933462,32.022021296705276,3201,32,320104,ػ,Qinhuai,Qu,3,292260,151404,140856,100046,271170,136334,134836,36711,19134,17577,227135,119284,107851,28414,12986,15428,192575
118.774220116500771,32.031091534988867,3201,32,320105,,Jianye,Qu,3,358966,188693,170273,119334,319818,162767,157051,43960,23104,20856,284735,151662,133073,30271,13927,16344,202061
118.73164005199699,32.09548631422691,3201,32,320107,¹,Xiaguan,Qu,3,365433,196323,169110,117301,327799,166431,161368,45377,23979,21398,287817,157083,130734,32239,15261,16978,227107
115.7305908203125,28.716936111450195,3601,36,360105,,Wanli,Qu,3,65130,33950,31180,16970,60087,31077,29010,17682,9720,7962,42894,21972,20922,4554,2258,2296,48925
114.973094264295398,27.797548571472333,3605,36,360502,ˮ,Yushui,Qu,3,778391,408940,369451,224206,702340,363064,339276,161131,89350,71781,571909,298001,273908,45351,21589,23762,685348
114.938251824874513,25.853521624450849,3607,36,360702,¹,Zhanggong,Qu,3,494600,254272,240328,127620,436120,217832,218288,89397,46219,43178,373582,193749,179833,31621,14304,17317,377342
114.978851940177506,27.117055671706879,3608,36,360802,,Jizhou,Qu,3,294085,150161,143924,80207,263003,133211,129792,60291,32414,27877,214252,109002,105250,19542,8745,10797,231335
115.015603023923603,27.062641204297119,3608,36,360803,ԭ,Qingyuan,Qu,3,179028,94315,84713,41950,163300,83905,79395,46680,25733,20947,122241,64132,58109,10107,4450,5657,163174
114.382703288942253,27.795028386581649,3609,36,360902,Ԭ,Yuanzhou,Qu,3,920357,480945,439412,231325,809571,422150,387421,234594,125526,109068,625974,325442,300532,59789,29977,29812,814604
116.352488458095493,27.991018708986424,3610,36,361002,ٴ,Linchuan,Qu,3,1007391,533936,473455,248012,956843,505655,451188,265450,153298,112152,681877,352771,329106,60064,27867,32197,896741
117.961068812208637,28.448783258599825,3611,36,361102,,Xinzhou,Qu,3,327703,164698,163005,90900,311809,156947,154862,74871,39539,35332,231413,114647,116766,21419,10512,10907,288164
115.941800752715409,28.699500729635531,3601,36,360111,,Jiaoqu,Qu,3,554202,299121,255081,131015,464704,244535,220169,125065,71499,53566,405256,216202,189054,23881,11420,12461,326784
117.20248183037701,29.289970302288154,3602,36,360203,ɽ,Zhushan,Qu,3,305499,156339,149160,90134,281571,141878,139693,55001,28739,26262,230112,117736,112376,20386,9864,10522,216949
113.842582166011397,27.635649264042318,3603,36,360302,Դ,Anyuan,Qu,3,414879,210849,204030,107878,386797,194978,191819,77009,39765,37244,311993,158059,153934,25877,13025,12852,339300
113.742775313298878,27.651472301667471,3603,36,360313,涫,Xiangdong,Qu,3,368566,191349,177217,92821,351017,181954,169063,86453,44787,41666,255282,132987,122295,26831,13575,13256,352670
115.987508907960049,29.680497732343614,3604,36,360402,®ɽ,Lushan,Qu,3,253625,130797,122828,68310,236055,119585,116470,56238,29246,26992,181501,93897,87604,15886,7654,8232,191849
115.989943221440839,29.726749688478677,3604,36,360403,,Xunyang,Qu,3,297704,149329,148375,90927,270645,134943,135702,51327,26592,24735,226795,113051,113744,19582,9686,9896,204537
117.048097149684651,28.246403784569164,3606,36,360602,º,Yuehu,Qu,3,178406,92050,86356,53681,168145,85340,82805,37587,20593,16994,131000,66536,64464,9819,4921,4898,135732
115.903256507045626,28.6347063460002,3601,36,360104,,Qingyunpu,Qu,3,229141,118250,110891,65207,206247,104650,101597,40217,21605,18612,175575,89744,85831,13349,6901,6448,140914
115.872966567180953,28.671936849189365,3601,36,360103,,Xihu,Qu,3,503764,253122,250642,151504,471693,233696,237997,85052,44542,40510,378083,189716,188367,40629,18864,21765,328111
115.902407123293187,28.686781287262782,3601,36,360102,,Donghu,Qu,3,492016,248061,243955,129999,410475,202234,208241,77397,40420,36977,379234,190557,188677,35385,17084,18301,331065
116.547836303710938,29.904428482055664,3604,36,360430,,Pengze,County,3,331085,169247,161838,87006,323569,164086,159483,81315,42475,38840,229881,117736,112145,19889,9036,10853,299967
116.223419189453125,29.752080917358398,3604,36,360429,,Hukou,County,3,261031,134962,126069,66482,256604,131654,124950,70787,38061,32726,175025,90335,84690,15219,6566,8653,240756
115.893478393554688,29.611911773681641,3604,36,360421,Ž,Jiujiang,County,3,326572,169396,157176,78227,316453,162701,153752,90871,49127,41744,216005,110991,105014,19696,9278,10418,306360
116.044342041015625,29.454160690307617,3604,36,360427,,Xingzi,County,3,221109,114846,106263,54189,218702,113287,105415,65388,35633,29755,143048,73248,69800,12673,5965,6708,211728
117.239303588867188,29.37773323059082,3602,36,360222,,Fuliang,County,3,279008,143890,135118,72448,269294,136637,132657,70619,35587,35032,190959,99880,91079,17430,8423,9007,255825
115.758796691894531,29.324192047119141,3604,36,360426,°,Dean,County,3,196647,101547,95100,53389,189944,97618,92326,44757,23486,21271,140024,72183,67841,11866,5878,5988,168181
116.189186096191406,29.272563934326172,3604,36,360428,,Duchang,County,3,671906,349379,322527,156262,655346,337204,318142,203105,109460,93645,431786,223562,208224,37015,16357,20658,641183
115.092422485351562,29.26215934753418,3604,36,360423,,Wuning,County,3,345292,179468,165824,87632,341771,177057,164714,83612,43061,40551,236819,124372,112447,24861,12035,12826,319801
117.853523254394531,29.253660202026367,3611,36,361130,Դ,Wuyuan,County,3,318658,163631,155027,82949,310900,158676,152224,77256,39643,37613,218311,112862,105449,23091,11126,11965,304267
115.816307067871094,29.037380218505859,3604,36,360425,,Yongxiu,County,3,351457,183000,168457,94320,345062,178649,166413,89301,47826,41475,236891,122847,114044,25265,12327,12938,322022
114.562545776367188,29.024404525756836,3604,36,360424,ˮ,Xiushui,County,3,745976,391282,354694,168201,739126,386372,352754,180331,93373,86958,520543,274796,245747,45102,23113,21989,708798
116.686187744140625,28.990251541137695,3611,36,361128,,Boyang,County,3,1191526,622350,569176,283401,1183322,614968,568354,362115,198384,163731,757462,389659,367803,71949,34307,37642,1169915
115.359596252441406,28.857261657714844,3609,36,360925,,Jingan,County,3,139630,73018,66612,38264,137714,71634,66080,31761,16600,15161,95960,50479,45481,11909,5939,5970,126989
115.549903869628906,28.847938537597656,3601,36,360123,,Anyi,County,3,220358,113069,107289,53700,207343,105355,101988,67128,36771,30357,137594,68864,68730,15636,7434,8202,203314
115.373336791992188,28.705957412719727,3609,36,360921,,Fengxin,County,3,293065,152753,140312,77111,272007,140523,131484,73195,39043,34152,198324,103088,95236,21546,10622,10924,270439
117.062049865722656,28.692913055419922,3611,36,361129,,Wannian,County,3,324922,168495,156427,85091,321584,166766,154818,85950,47255,38695,221545,113085,108460,17427,8155,9272,310593
116.682914733886719,28.693145751953125,3611,36,361127,,Yugan,County,3,804597,419365,385232,189525,801340,417224,384116,254052,140365,113687,502866,256986,245880,47679,22014,25665,788816
115.810794887481194,28.693810463672758,3601,36,360122,½,Xinjian,County,3,641493,343618,297875,145664,590095,308101,281994,191569,105323,86246,414023,220919,193104,35901,17376,18525,576831
118.240821838378906,28.682945251464844,3611,36,361123,ɽ,Yushan,County,3,515934,271761,244173,133100,509509,267568,241941,126905,68674,58231,353697,185638,168059,35332,17449,17883,491681
115.934379577636719,28.54517936706543,3601,36,360121,ϲ,Nanchang,County,3,938361,492473,445888,235121,918509,480001,438508,262548,149767,112781,610055,313231,296824,65758,29475,36283,833179
114.356109619140625,28.531940460205078,3609,36,360926,ͭ,Tonggu,County,3,131616,68990,62626,34843,130161,67995,62166,30533,15697,14836,92215,48643,43572,8868,4650,4218,118815
118.18499755859375,28.445148468017578,3611,36,361122,,Guangfeng,County,3,679271,352517,326754,163716,676962,350912,326050,216507,116518,99989,418108,213732,204376,44656,22267,22389,650349
117.920066833496094,28.440359115600586,3611,36,361121,,Shangrao,County,3,636086,330840,305246,152768,631185,327764,303421,184140,98435,85705,418434,215992,202442,33512,16413,17099,603430
115.373092651367188,28.434221267700195,3609,36,360983,߰,Gaoan,City,3,788329,416678,371651,198802,724177,377216,346961,193670,109166,84504,544097,284134,259963,50562,23378,27184,731102
117.601051330566406,28.423187255859375,3611,36,361125,,Hengfeng,County,3,166738,86873,79865,46078,165849,86245,79604,43694,23826,19868,113932,58336,55596,9112,4711,4401,157064
117.425155639648438,28.402944564819336,3611,36,361126,߮,Yiyang,County,3,330523,174303,156220,90482,328410,172952,155458,82371,45494,36877,229824,119553,110271,18328,9256,9072,312923
114.779762268066406,28.390432357788086,3609,36,360924,˷,Yifeng,County,3,265836,138706,127130,76713,255785,132915,122870,58426,30501,27925,187721,98127,89594,19689,10078,9611,241049
116.263160705566406,28.3668212890625,3601,36,360124,,Jinxian,County,3,687203,360125,327078,159484,672615,351064,321551,184937,102939,81998,458225,237493,220732,44041,19693,24348,634858
117.704078674316406,28.318265914916992,3611,36,361124,Ǧɽ,Qianshan,County,3,383936,199674,184262,102772,380933,197612,183321,97226,51832,45394,265901,137355,128546,20809,10487,10322,370370
114.921165466308594,28.240924835205078,3609,36,360923,ϸ,Shanggao,County,3,334535,174858,159677,94638,323160,168333,154827,82936,45202,37734,227013,117567,109446,24586,12089,12497,303620
116.610748291015625,28.22764778137207,3610,36,361029,,Dongxiang,County,3,383069,201186,181883,96158,373427,195890,177537,100421,56861,43560,261227,134373,126854,21421,9952,11469,367869
116.814125061035156,28.211786270141602,3606,36,360622,཭,Yujiang,County,3,313152,163494,149658,83899,308513,160531,147982,88779,50169,38610,204451,103900,100551,19922,9425,10497,296425
114.447547912597656,28.112749099731445,3609,36,360922,,Wanzai,County,3,462189,242857,219332,117516,451701,236240,215461,113605,60651,52954,319784,168004,151780,28800,14202,14598,442268
116.777519226074219,27.909030914306641,3610,36,361027,Ϫ,Jinxi,County,3,261049,135631,125418,64089,255546,132206,123340,68404,37109,31295,178250,92139,86111,14395,6383,8012,242227
114.672126770019531,27.811786651611328,3605,36,360521,,Fenyi,County,3,293429,154326,139103,84886,283255,147561,135694,65408,34985,30423,207643,109165,98478,20378,10176,10202,268741
115.386711120605469,27.761566162109375,3608,36,360824,¸,Xingan,County,3,286348,149905,136443,75388,247286,127322,119964,71908,40587,31321,196570,101116,95454,17870,8202,9668,236233
116.05633544921875,27.758899688720703,3610,36,361024,,Chongren,County,3,298734,159072,139662,70747,287837,152920,134917,92394,52894,39500,189632,98269,91363,16708,7909,8799,279765
117.059410095214844,27.710256576538086,3610,36,361028,Ϫ,Zixi,County,3,104939,54405,50534,27581,102155,52409,49746,24211,12587,11624,74304,38688,35616,6424,3130,3294,96113
116.629280090332031,27.564285278320312,3610,36,361021,ϳ,Nancheng,County,3,294307,149926,144381,73650,286781,145459,141322,71376,37823,33553,207692,105340,102352,15239,6763,8476,269976
116.214630126953125,27.547176361083984,3610,36,361026,˻,Yihuang,County,3,205961,106893,99068,52820,203349,104878,98471,54290,28352,25938,142120,74045,68075,9551,4496,5055,193739
115.824462890625,27.429338455200195,3610,36,361025,ְ,Lean,County,3,329045,172670,156375,82927,325461,169922,155539,91644,49978,41666,219140,113420,105720,18261,9272,8989,310953
114.604545593261719,27.376470565795898,3608,36,360829,,Anfu,County,3,372202,192041,180161,92881,358841,183281,175560,86875,45022,41853,259970,134912,125058,25357,12107,13250,345032
115.423423767089844,27.321672439575195,3608,36,360825,,Yongfeng,County,3,379279,199574,179705,93215,370518,192947,177571,108268,60244,48024,250667,129491,121176,20344,9839,10505,350900
116.91314697265625,27.295316696166992,3610,36,361022,质,Lichuan,County,3,217914,113628,104286,56541,214105,110952,103153,57617,31490,26127,147441,75813,71628,12856,6325,6531,201067
115.123222351074219,27.216533660888672,3608,36,360822,ˮ,Jishui,County,3,437081,229909,207172,110458,414746,215376,199370,113131,64952,48179,297229,152904,144325,26721,12053,14668,399999
116.527267456054688,27.209867477416992,3610,36,361023,Ϸ,Nanfeng,County,3,260738,135184,125554,65448,255455,131720,123735,64543,34874,29669,183964,94775,89189,12231,5535,6696,236565
113.948196411132812,27.129657745361328,3603,36,360321,,Lianhua,County,3,224668,115342,109326,54089,217294,110089,107205,57548,29829,27719,152111,78355,73756,15009,7158,7851,208702
114.904335021972656,27.041667938232422,3608,36,360821,,Jian,County,3,409606,213205,196401,100499,387473,199061,188412,106690,58435,48255,277347,143546,133801,25569,11224,14345,388488
114.242340087890625,26.93931770324707,3608,36,360830,,Yongxin,County,3,430046,221975,208071,100674,419866,214466,205400,105083,55792,49291,294923,152551,142372,30040,13632,16408,404674
116.322914123535156,26.833126068115234,3610,36,361030,,Guangchang,County,3,209274,108111,101163,49606,204333,104944,99389,62100,32905,29195,136636,70187,66449,10538,5019,5519,201048
114.8917236328125,26.790647506713867,3608,36,360826,̩,Taihe,County,3,496567,256778,239789,114895,459043,233434,225609,121806,64546,57260,343904,178549,165355,30857,13683,17174,463490
116.016120910644531,26.467782974243164,3607,36,360730,,Ningdu,County,3,657241,342690,314551,164153,626581,324594,301987,179185,98546,80639,438457,224796,213661,39599,19348,20251,612018
114.770973205566406,26.471063613891602,3608,36,360828,,Wanan,County,3,268196,137552,130644,64466,256596,129780,126816,69232,36438,32794,181215,93068,88147,17749,8046,9703,250483
116.339179992675781,26.331743240356445,3607,36,360735,ʯ,Shicheng,County,3,265286,137932,127354,62947,256448,132424,124024,82232,44875,37357,167217,85707,81510,15837,7350,8487,247758
114.501045227050781,26.323022842407227,3608,36,360827,촨,Suichuan,County,3,506955,263988,242967,120895,492211,252977,239234,127729,67823,59906,345878,179995,165883,33348,16170,17178,483305
115.344108581542969,26.320804595947266,3607,36,360732,˹,Xingguo,County,3,611163,316203,294960,150410,595114,305082,290032,170055,94319,75736,398926,201979,196947,42182,19905,22277,580870
115.408981323242188,25.946025848388672,3607,36,360731,ڶ,Yudu,County,3,746608,385656,360952,170462,729983,372660,357323,239344,133794,105550,458006,229763,228243,49258,22099,27159,704249
116.024154663085938,25.870292663574219,3607,36,360781,,Ruijin,City,3,535499,280328,255171,125566,516846,268091,248755,158021,87245,70776,342869,176735,166134,34609,16348,18261,506280
115.003273010253906,25.861648559570312,3607,36,360721,,Ganxian,County,3,492065,244823,247242,119567,476747,236674,240073,133577,72494,61083,327566,158433,169133,30922,13896,17026,453721
114.529090881347656,25.802507400512695,3607,36,360724,,Shangyou,County,3,256238,130644,125594,65728,213745,104025,109720,59937,32275,27662,177192,89433,87759,19109,8936,10173,240964
114.296562194824219,25.705259323120117,3607,36,360725,,Chongyi,County,3,187919,97189,90730,50533,181359,91934,89425,44070,22939,21131,130887,67940,62947,12962,6310,6652,167725
115.7725830078125,25.584566116333008,3607,36,360733,,Huichang,County,3,388115,200213,187902,90222,380156,194059,186097,120509,65757,54752,243730,124157,119573,23876,10299,13577,356630
114.346672058105469,25.401626586914062,3607,36,360723,,Dayu,County,3,261611,135147,126464,67639,230115,114239,115876,62047,32755,29292,181595,94606,86989,17969,7786,10183,233479
114.928932189941406,25.381122589111328,3607,36,360722,ŷ,Xinfeng,County,3,590662,296928,293734,148674,567597,281629,285968,166458,88749,77709,387847,193291,194556,36357,14888,21469,551271
115.39276123046875,25.131118774414062,3607,36,360726,Զ,Anyuan,County,3,309541,158090,151451,71488,302824,153313,149511,93095,50096,42999,198314,100366,97948,18132,7628,10504,287586
115.64434814453125,24.939668655395508,3607,36,360734,Ѱ,Xunwu,County,3,271854,142001,129853,64226,267972,139230,128742,79023,42340,36683,174861,91844,83017,17970,7817,10153,255250
114.780807495117188,24.905876159667969,3607,36,360727,,Longnan,County,3,283514,143806,139708,71294,268048,134384,133664,75072,39499,35573,189644,97426,92218,18798,6881,11917,254262
115.019775390625,24.767629623413086,3607,36,360728,,Dingnan,County,3,179123,92880,86243,44196,171470,86971,84499,47115,24702,22413,119505,63140,56365,12503,5038,7465,163398
114.518020629882812,24.74934196472168,3607,36,360729,ȫ,Quannan,County,3,170847,87818,83029,45009,158058,79524,78534,39522,20770,18752,117887,61342,56545,13438,5706,7732,155837
114.048507690429688,27.636192321777344,3603,36,360323,«Ϫ,Luxi,County,3,263182,138081,125101,67156,261171,136547,124624,59886,31035,28851,184366,97822,86544,18930,9224,9706,251147
113.786407470703125,27.887365341186523,3603,36,360322,,Shangli,County,3,453437,236166,217271,103748,448013,232435,215578,126030,65834,60196,298734,155943,142791,28673,14389,14284,435892
115.318672180175781,27.610261917114258,3608,36,360823,Ͽ,Xiajiang,County,3,155762,81177,74585,41820,151032,77806,73226,40982,22194,18788,105216,54415,50801,9564,4568,4996,140424
117.107689795173101,29.258591108559067,3602,36,360202,,Changjiang,Qu,3,139221,72408,66813,37793,134359,69522,64837,35326,18821,16505,96188,49950,46238,7707,3637,4070,100812
115.660301208496094,29.67479133605957,3604,36,360481,,Ruichang,City,3,398844,209755,189089,100597,386747,200764,185983,97821,52617,45204,276984,145333,131651,24039,11805,12234,359282
117.123291015625,28.963794708251953,3602,36,360281,ƽ,Leping,City,3,729639,381937,347702,178352,659185,341168,318017,196855,107586,89269,496354,256858,239496,36430,17493,18937,692850
117.571426391601562,28.950616836547852,3611,36,361181,,Dexing,City,3,297784,155178,142606,84185,284582,147033,137549,66735,34812,31923,213337,111164,102173,17712,9202,8510,274120
117.198348999023438,28.281887054443359,3606,36,360681,Ϫ,Guixi,City,3,535517,282662,252855,140269,525711,275927,249784,129760,72227,57533,374931,195618,179313,30826,14817,16009,499023
115.775108337402344,28.200101852416992,3609,36,360981,,Fengcheng,City,3,1216412,644029,572383,289928,1197620,630454,567166,350041,201070,148971,791223,408351,382872,75148,34608,40540,1155858
115.531578063964844,28.068796157836914,3609,36,360982,,Zhangshu,City,3,527823,273691,254132,133748,504652,260365,244287,125740,68584,57156,365574,188896,176678,36509,16211,20298,495956
114.261813251581927,26.72627758751522,3608,36,360881,ɽ,Jinggangshan,City,3,145769,74722,71047,36393,141921,72227,69694,34947,18035,16912,102166,52540,49626,8656,4147,4509,129394
114.745162963867188,25.661659240722656,3607,36,360782,Ͽ,Nankang,City,3,694987,338836,356151,184163,673338,325984,347354,199032,109532,89500,444409,208058,236351,51546,21246,30300,633924
126.556195689125857,43.856370319475523,2202,22,220202,,Changyi,Qu,3,666927,335088,331839,201184,636190,318151,318039,100630,51962,48668,518866,259562,259304,47431,23564,23867,580197
126.565148749945763,43.873864555635123,2202,22,220203,̶,Longtan,Qu,3,528724,267430,261294,160530,516447,260267,256180,87417,45154,42263,406471,204323,202148,34836,17953,16883,472174
126.525064452755814,43.837417673759269,2202,22,220204,Ӫ,Chuanying,Qu,3,479371,241585,237786,145762,462727,229888,232839,75622,39132,36490,369269,185568,183701,34480,16885,17595,378739
126.562165527683689,43.82036402270937,2202,22,220211,,Fengman,Qu,3,278112,140659,137453,78673,255481,128410,127071,44195,22926,21269,217159,109295,107864,16758,8438,8320,222841
124.394122275448595,43.142659961267746,2203,22,220303,,Tiedong,Qu,3,264157,136344,127813,84242,252011,126363,125648,44382,23187,21195,202591,104451,98140,17184,8706,8478,239445
124.331748857302003,43.15755261229242,2203,22,220302,,Tiexi,Qu,3,228684,111072,117612,70621,212563,105174,107389,38747,20172,18575,175679,83819,91860,14258,7081,7177,195587
125.126132665959105,42.925338728458129,2204,22,220403,,Xian,Qu,3,179188,91045,88143,56624,177716,90319,87397,30648,16235,14413,135345,68018,67327,13195,6792,6403,151990
125.109563617872837,42.895867492584067,2204,22,220402,ɽ,Longshan,Qu,3,283045,143656,139389,84506,274206,137541,136665,48791,25368,23423,217888,109987,107901,16366,8301,8065,232639
125.304456642653705,43.89199561541384,2201,22,220103,,Kuancheng,Qu,3,479349,249603,229746,141682,446706,224233,222473,72712,37706,35006,375093,196236,178857,31544,15661,15883,327748
125.279860064124861,43.850536622743633,2201,22,220104,,Chaoyang,Qu,3,714437,364031,350406,185456,588809,290735,298074,91852,47305,44547,572877,291600,281277,49708,25126,24582,545600
124.284782409667969,45.498954772949219,2208,22,220882,,Daan,City,3,430512,219682,210830,132195,426148,217049,209099,77908,40275,37633,328386,167202,161184,24218,12205,12013,395880
122.771736145019531,45.339099884033203,2208,22,220881,,Taonan,City,3,441096,224878,216218,136255,438910,223395,215515,86487,44205,42282,330529,168220,162309,24080,12453,11627,402472
125.813179016113281,44.155319213867188,2201,22,220181,̨,Jiutai,City,3,799729,411067,388662,217489,790643,405301,385342,166821,87135,79686,581485,298330,283155,51423,25602,25821,733101
127.336334228515625,43.720302581787109,2202,22,220281,Ժ,Jiaohe,City,3,474109,243510,230599,143380,470304,240630,229674,85134,43402,41732,357594,183889,173705,31381,16219,15162,435421
124.795082092285156,43.507781982421875,2203,22,220381,,Gongzhuling,City,3,1041735,532134,509601,288063,1028350,523792,504558,222069,115322,106747,754046,383129,370917,65620,33683,31937,990976
128.23260498046875,43.369815826416016,2224,22,222403,ػ,Dunhua,City,3,480834,247966,232868,152336,468477,238673,229804,89263,45668,43595,360697,186241,174456,30874,16057,14817,418372
126.739410400390625,42.967079162597656,2202,22,220282,,Huadian,City,3,444415,228624,215791,130079,439688,225144,214544,90255,46695,43560,330405,169310,161095,23755,12619,11136,396976
129.847871721423928,42.959121357185204,2224,22,222402,ͼ,Tumen,City,3,132368,67067,65301,43516,129134,64629,64505,21428,10925,10503,100651,51799,48852,10289,4343,5946,107059
129.502953612775741,42.901135018265606,2224,22,222401,Ӽ,Yanji,City,3,432339,223342,208997,129729,388261,192509,195752,66269,34271,31998,342673,179062,163611,23397,10009,13388,262988
130.364517211914062,42.871646881103516,2224,22,222404,,Huichun,City,3,211091,108873,102218,68052,206688,105511,101177,38679,19770,18909,160994,84155,76839,11418,4948,6470,160596
129.420669555664062,42.773643493652344,2224,22,222405,,Longjing,City,3,261551,132150,129401,88204,256512,128885,127627,39581,20206,19375,201076,103531,97545,20894,8413,12481,229842
125.682449340820312,42.52978515625,2205,22,220581,÷ӿ,Meihekou,City,3,617674,317226,300448,185016,609852,312214,297638,119709,62218,57491,462445,236480,225965,35520,18528,16992,560339
126.926750183105469,41.820209503173828,2206,22,220681,ٽ,Linjiang,City,3,184901,94904,89997,59868,182461,92899,89562,34605,17561,17044,137499,70714,66785,12797,6629,6168,163457
126.2012228093689,41.129430392502577,2205,22,220582,,Jian,City,3,239849,124475,115374,70759,236841,122276,114565,42957,22492,20465,181287,94185,87102,15605,7798,7807,192189
123.200248718261719,45.841964721679688,2208,22,220821,,Zhenlai,County,3,320960,170762,150198,97352,305844,156724,149120,55409,28464,26945,247446,132574,114872,18105,9724,8381,302883
124.837905883789062,45.118038177490234,2207,22,220721,ǰ˹ɹ,Qianguoerluosimengguzuzizhi,County,3,567246,290563,276683,153263,550285,280212,270073,120873,62323,58550,420921,215409,205512,25452,12831,12621,518041
124.020599365234375,44.993614196777344,2207,22,220723,Ǭ,Qianan,County,3,300745,152783,147962,88559,297194,150555,146639,62533,32303,30230,223693,112964,110729,14519,7516,7003,283822
126.538398742675781,44.820018768310547,2201,22,220182,,Yushu,City,3,1155670,592213,563457,322866,1147660,587671,559989,250475,131790,118685,836243,426352,409891,68952,34071,34881,1065605
123.081840515136719,44.794498443603516,2208,22,220822,ͨ,Tongyu,County,3,348344,178106,170238,102406,346669,177028,169641,71271,36550,34721,260151,132869,127282,16922,8687,8235,327339
125.688140869140625,44.528881072998047,2201,22,220183,»,Dehui,City,3,878349,448146,430203,237531,871751,444988,426763,204883,106720,98163,621281,315377,305904,52185,26049,26136,816892
125.174789428710938,44.423831939697266,2201,22,220122,ũ,Nongan,County,3,1076134,551332,524802,288958,1066556,545700,520856,246001,127719,118282,766584,391079,375505,63549,32534,31015,1035716
126.925086975097656,44.405902862548828,2202,22,220283,,Shulan,City,3,660065,340293,319772,193009,654189,335918,318271,123148,64091,59057,497543,255881,241662,39374,20321,19053,609694
123.974922180175781,44.275348663330078,2207,22,220722,,Changling,County,3,625830,319683,306147,164293,620097,316265,303832,155679,79969,75710,439904,224113,215791,30247,15601,14646,602707
126.495841979980469,43.653522491455078,2202,22,220221,,Yongji,County,3,423301,216951,206350,121084,404031,206858,197173,80451,41528,38923,317485,162211,155274,25365,13212,12153,394048
125.661827087402344,43.522312164306641,2201,22,220112,˫,Shuangyang,Qu,3,359958,185178,174780,102393,355288,181912,173376,70768,36763,34005,267481,137306,130175,21709,11109,10600,320841
123.493095397949219,43.526782989501953,2203,22,220382,˫,Shuangliao,City,3,404499,206071,198428,120660,399493,203575,195918,77972,40487,37485,304169,154560,149609,22358,11024,11334,388420
125.302176165427724,43.337730660469141,2203,22,220323,ͨ,Yitongmanzuzizhixian,County,3,482134,250130,232004,137504,473055,243698,229357,90624,47536,43088,361579,186992,174587,29931,15602,14329,465555
124.320610046386719,43.310909271240234,2203,22,220322,,Lishu,County,3,871117,448388,422729,253369,863458,442879,420579,180269,95653,84616,637268,325196,312072,53580,27539,26041,831502
129.758041381835938,43.317031860351562,2224,22,222424,,Wangqing,County,3,255882,131304,124578,86552,253371,129676,123695,44873,23024,21849,193338,99911,93427,17671,8369,9302,232885
128.931045532226562,43.118465423583984,2224,22,222426,ͼ,Antu,County,3,220315,113586,106729,70643,217618,111480,106138,43734,22453,21281,162871,84510,78361,13710,6623,7087,197762
126.052177429199219,42.935699462890625,2202,22,220284,ʯ,Panshi,City,3,530470,273219,257251,151541,526192,270161,256031,106224,54510,51714,392875,202303,190572,31371,16406,14965,488355
124.975898742675781,42.910285949707031,2204,22,220422,,Dongliao,County,3,396121,205589,190532,115562,393691,203757,189934,77551,40053,37498,294033,152652,141381,24537,12884,11653,365499
126.036727905273438,42.680046081542969,2205,22,220523,,Huinan,County,3,360103,185020,175083,109268,356862,182922,173940,65984,34210,31774,273719,140337,133382,20400,10473,9927,333448
125.521255493164062,42.673469543457031,2204,22,220421,,Dongfeng,County,3,408679,211619,197060,119582,405270,209199,196071,78158,40458,37700,306223,158242,147981,24298,12919,11379,385973
129.003402709960938,42.535285949707031,2224,22,222406,,Helong,City,3,215266,110051,105215,72685,213021,108306,104715,37024,19063,17961,162240,84209,78031,16002,6779,9223,190480
126.7843017578125,42.385612487792969,2206,22,220622,,Jingyu,County,3,141120,73465,67655,44315,139288,71984,67304,29547,15119,14428,103510,54058,49452,8063,4288,3775,123443
127.26800124069625,42.327575780933259,2206,22,220621,,Fusong,County,3,306736,158677,148059,94239,300966,154282,146684,58552,30266,28286,230477,118692,111785,17707,9719,7988,279027
125.727531433105469,42.269699096679688,2205,22,220524,,Liuhe,County,3,375027,194950,180077,103806,370704,192096,178608,80733,41816,38917,274215,142584,131631,20079,10550,9529,342303
126.5548095703125,42.044506072998047,2206,22,220625,Դ,Jiangyuan,County,3,259538,134064,125474,84197,257283,132480,124803,47814,24785,23029,194470,100064,94406,17254,9215,8039,235280
125.754325866699219,41.679267883300781,2205,22,220521,ͨ,Tonghua,County,3,255163,132586,122577,74659,252297,130416,121881,50060,25685,24375,189319,98893,90426,15784,8008,7776,231458
128.194244384765625,41.421756744384766,2206,22,220623,׳,Changbaichaoxianzuzizhixian,County,3,84667,44105,40562,27072,81474,41545,39929,15410,7871,7539,64243,33767,30476,5014,2467,2547,74584
126.025550842285156,44.978050231933594,2207,22,220724,,Fuyu,County,3,733746,375475,358271,199744,730608,373579,357029,159239,85765,73474,534319,269868,264451,40188,19842,20346,701838
122.83539763300044,45.615004067279969,2208,22,220802,䬱,Taobei,Qu,3,484979,244453,240526,148991,469245,236796,232449,86256,44635,41621,371487,186008,185479,27236,13810,13426,401821
126.435456441256591,41.939770955234522,2206,22,220602,˵,Badaojiang,Qu,3,335400,172109,163291,107306,329360,168222,161138,58961,31014,27947,258631,131914,126717,17808,9181,8627,285498
124.816623897777774,45.171104577627531,2207,22,220702,,Ningjiang,Qu,3,538469,273101,265368,158248,533110,269814,263296,102642,54310,48332,412076,207323,204753,23751,11468,12283,416659
125.917503464834425,41.725879360377064,2205,22,220502,,Dongchang,Qu,3,312558,156401,156157,95925,301787,151056,150731,50459,26157,24302,242162,120327,121835,19937,9917,10020,259994
126.036231376199098,41.783287589544607,2205,22,220503,,Erdaojiang,Qu,3,147590,75559,72031,46107,145607,74160,71447,24456,12689,11767,113697,58142,55555,9437,4728,4709,124693
125.328718157197187,43.867582277451731,2201,22,220102,Ϲ,Nanguan,Qu,3,576658,293082,283576,168978,515136,256589,258547,78231,40662,37569,455002,231093,223909,43425,21327,22098,442767
125.257368800726894,43.890680709471759,2201,22,220106,԰,Lvyuan,Qu,3,617153,312359,304794,188257,581073,291001,290072,93312,48570,44742,485387,243990,241397,38454,19799,18655,451928
125.359211172133882,43.87471485425398,2201,22,220105,,Erdao,Qu,3,478002,242963,235039,143293,452290,227641,224649,76101,39582,36519,373547,189150,184397,28354,14231,14123,316776
123.460658453628852,41.756120893218906,2101,21,210112,,Dongling,Qu,3,601489,312646,288843,182149,550772,279489,271283,90378,47194,43184,469497,245176,224321,41614,20276,21338,356242
122.577321941706899,39.274451002944851,2102,21,210224,,Changhai,County,3,99532,51681,47851,29384,95111,48058,47053,21996,11257,10739,70333,37196,33137,7203,3228,3975,79024
123.947925072171373,41.886817851519865,2104,21,210411,˳,Shuncheng,Qu,3,397617,199795,197822,126371,388180,193361,194819,60274,31119,29155,302114,151497,150617,35229,17179,18050,320841
123.741756010966668,41.248629320415965,2105,21,210502,ƽɽ,Pingshan,Qu,3,356430,179286,177144,111863,348515,173651,174864,53564,27659,25905,271596,135919,135677,31270,15708,15562,288804
123.743431815691054,41.296798604918997,2105,21,210503,Ϫ,Xihu,Qu,3,223735,114294,109441,73666,220574,111713,108861,34624,17751,16873,167979,85991,81988,21132,10552,10580,186619
123.769027780946828,41.274819245928306,2105,21,210504,ɽ,Mingshan,Qu,3,311615,155870,155745,98408,300072,150173,149899,46897,24176,22721,239834,119210,120624,24884,12484,12400,239567
124.364349101135488,40.136643901513416,2106,21,210602,Ԫ,Yuanbao,Qu,3,195890,96390,99500,62504,185308,91265,94043,27145,14016,13129,151247,74337,76910,17498,8037,9461,145857
121.143305990995515,41.14149259491797,2107,21,210702,,Guta,Qu,3,251648,125510,126138,83016,232818,114198,118620,33506,17270,16236,196684,97938,98746,21458,10302,11156,189459
121.17820339814844,41.121991102685463,2107,21,210703,,Linghe,Qu,3,371644,182461,189183,125122,346350,170201,176149,48934,25129,23805,287659,140297,147362,35051,17035,18016,278735
122.272696849465447,40.664250209678634,2108,21,210802,վǰ,Zhanqian,Qu,3,262376,133562,128814,82893,244075,120962,123113,37474,19569,17905,204211,103412,100799,20691,10581,10110,197190
121.588903447841219,41.943546556778038,2109,21,210902,,Haizhou,Qu,3,341454,168719,172735,107904,320200,157601,162599,51245,26010,25235,264812,130157,134655,25397,12552,12845,275625
123.163469323112025,41.268314993783697,2110,21,211002,,Baita,Qu,3,212493,105098,107395,67774,199121,98393,100728,31693,16244,15449,164426,80725,83701,16374,8129,8245,158220
123.181844335119976,41.23016712012155,2110,21,211011,̫Ӻ,Taizihe,Qu,3,133359,68033,65326,40962,127656,64329,63327,22695,11899,10796,102685,52242,50443,7979,3892,4087,93196
122.075868748620522,41.179823501111926,2111,21,211102,˫̨,Shuangtaizi,Qu,3,193855,97687,96168,63671,188831,94681,94150,34327,17824,16503,149044,74547,74497,10484,5316,5168,114497
120.472545267344358,41.582079866826582,2113,21,211302,˫,Shuangta,Qu,3,321413,159114,162299,98894,308567,153179,155388,57729,29837,27892,245075,120269,124806,18609,9008,9601,230769
120.431224905252279,41.618235183657156,2113,21,211303,,Longcheng,Qu,3,153625,79014,74611,45648,149511,76040,73471,31374,16421,14953,113306,58329,54977,8945,4264,4681,119516
120.834951185936617,40.797465975756367,2114,21,211402,ɽ,Lianshan,Qu,3,596009,300930,295079,194689,589798,296367,293431,106793,55804,50989,439861,220993,218868,49355,24133,25222,512809
120.889843376494497,40.783941812865294,2114,21,211403,,Longgang,Qu,3,168673,85781,82892,56028,160445,80024,80421,28030,14442,13588,131493,66822,64671,9150,4517,4633,120109
120.720393570859301,41.125228041116465,2114,21,211404,Ʊ,Nanpiao,Qu,3,136254,69500,66754,43483,135809,69103,66706,26468,13712,12756,99215,50591,48624,10571,5197,5374,118280
121.526643707547208,38.946321383261086,2102,21,210211,ʾ,Ganjingzi,Qu,3,785131,410705,374426,234204,679499,342507,336992,106402,55193,51209,623252,328430,294822,55477,27082,28395,458901
121.558952631499992,38.895290220351583,2102,21,210204,ɳӿ,Shahekou,Qu,3,638366,321529,316837,197745,569650,282082,287568,77821,40118,37703,498331,251551,246780,62214,29860,32354,465428
121.588924924935796,38.88653180071681,2102,21,210203,,Xigang,Qu,3,345098,175249,169849,110515,319983,157155,162828,42943,22098,20845,263672,135287,128385,38483,17864,20619,243021
121.59622205609115,38.976937596830744,2102,21,210202,ɽ,Zhongshan,Qu,3,378004,189910,188094,118097,345522,168662,176860,46662,23954,22708,289716,146869,142847,41626,19087,22539,263845
124.025566101074219,42.539760589599609,2112,21,211282,ԭ,Kaiyuan,City,3,529736,271422,258314,163399,528575,270455,258120,106547,56018,50529,385811,196490,189321,37378,18914,18464,497031
123.535171508789062,42.468299865722656,2112,21,211281,,Tiefa,City,3,239636,121471,118165,76589,238895,120903,117992,44793,23335,21458,181961,91587,90374,12882,6549,6333,220133
120.761634826660156,41.806262969970703,2113,21,211381,Ʊ,Beipiao,City,3,573836,291584,282252,176141,572878,290816,282062,113733,58923,54810,414822,210386,204436,45281,22275,23006,521450
122.750343322753906,40.849636077880859,2103,21,210381,,Haicheng,City,3,1181130,606805,574325,350213,1162131,596614,565517,227551,123985,103566,874296,443221,431075,79283,39599,39684,1000815
120.703437805175781,40.619228363037109,2114,21,211481,˳,Xingcheng,City,3,524527,269567,254960,158589,518195,263877,254318,107689,56881,50808,373680,191346,182334,43158,21340,21818,476792
121.994132995605469,39.621074676513672,2102,21,210281,߷,Wafangdian,City,3,956063,489377,466686,310289,942440,481816,460624,177732,92488,85244,695669,357310,338359,82662,39579,43083,844358
124.113059997558594,42.771743774414062,2112,21,211224,ͼ,Changtu,County,3,959439,489746,469693,285601,957536,488003,469533,189531,98473,91058,707101,359886,347215,62807,31387,31420,892516
123.340576171875,42.749698638916016,2101,21,210123,ƽ,Kangping,County,3,324956,166759,158197,93921,320440,162401,158039,69599,35792,33807,232268,119786,112482,23089,11181,11908,296371
124.729743957519531,42.729957580566406,2112,21,211223,,Xifeng,County,3,309416,159183,150233,91002,308484,158476,150008,64841,33622,31219,221417,113495,107922,23158,12066,11092,293272
124.142677307128906,42.538291931152344,2112,21,211204,,Qinghe,Qu,3,92620,47369,45251,29288,92034,46959,45075,17998,9364,8634,68250,34693,33557,6372,3312,3060,80760
123.406791687011719,42.506694793701172,2101,21,210124,,Faku,County,3,420362,216062,204300,127144,419090,215038,204052,83677,44476,39201,305023,155962,149061,31662,15624,16038,390996
122.534248352050781,42.38372802734375,2109,21,210922,,Zhangwu,County,3,389969,198254,191715,116189,389352,197692,191660,75173,38562,36611,286816,146004,140812,27980,13688,14292,374085
124.062667846679688,42.162479400634766,2112,21,211221,,Tieling,County,3,351194,181726,169468,109157,350650,181230,169420,66908,35050,31858,257956,133443,124513,26330,13233,13097,334871
124.911659240722656,42.09783935546875,2104,21,210423,ԭ,Qingyuanmanzuzizhixian,County,3,317842,163232,154610,98222,316941,162559,154382,63386,32666,30720,233541,119931,113610,20915,10635,10280,298655
121.789535522460938,42.085590362548828,2109,21,210903,,Xinqiu,Qu,3,65293,32656,32637,23440,65172,32577,32595,10643,5427,5216,47953,23891,24062,6697,3338,3359,56806
121.727249145507812,42.050045013427734,2109,21,210921,ɹ,Fuxinmengguzuzizhixian,County,3,714244,363667,350577,203324,712202,362419,349783,147785,76623,71162,518924,264003,254921,47535,23041,24494,687203
123.50457763671875,42.052925109863281,2101,21,210113,³,Xinchengzi,Qu,3,304230,155932,148298,94780,289539,147044,142495,50956,26324,24632,230903,118341,112562,22371,11267,11104,253006
122.797088623046875,41.989398956298828,2101,21,210181,,Xinmin,City,3,653719,333683,320036,200360,649247,331126,318121,123036,64087,58949,483002,245970,237032,47681,23626,24055,593254
124.175506591796875,41.692893981933594,2104,21,210421,˳,Fushun,County,3,223297,115593,107704,69943,222410,114915,107495,38945,20226,18719,167219,86986,80233,17133,8381,8752,205461
123.162418365697633,41.841193364224061,2101,21,210114,ں,Yuhong,Qu,3,606008,314168,291840,191473,564999,286160,278839,93364,48571,44793,472420,245482,226938,40224,20115,20109,327685
121.411216735839844,41.756427764892578,2109,21,210905,,Qinghemen,Qu,3,72323,36461,35862,23464,72166,36311,35855,14086,7281,6805,53555,26895,26660,4682,2285,2397,59630
125.033706665039062,41.726318359375,2104,21,210422,±,Xinbinmanzuzizhixian,County,3,284704,146487,138217,81962,284052,145999,138053,58161,30124,28037,208546,107641,100905,17997,8722,9275,268698
122.110404968261719,41.686862945556641,2107,21,210726,ɽ,Heishan,County,3,617664,313996,303668,189201,615129,312027,303102,115785,59942,55843,447892,227753,220139,53987,26301,27686,582769
123.321121215820312,41.655750274658203,2101,21,210111,ռ,Sujiatun,Qu,3,435342,221878,213464,144610,427789,216090,211699,72936,37680,35256,329086,167672,161414,33320,16526,16794,339844
121.786598205566406,41.595165252685547,2107,21,210782,,Beining,City,3,527217,270153,257064,157521,520177,264097,256080,98939,51144,47795,385380,198605,186775,42898,20404,22494,495648
120.201507568359375,41.370429992675781,2113,21,211321,,Chaoyang,County,3,584959,300740,284219,169442,583877,299986,283891,133890,70735,63155,404786,207459,197327,46283,22546,23737,566295
121.254875183105469,41.538364410400391,2107,21,210727,,Yixian,County,3,422553,216093,206460,126353,419378,213971,205407,82426,43117,39309,305971,156764,149207,34156,16212,17944,387240
122.7154541015625,41.507408142089844,2101,21,210122,,Liaozhong,County,3,501627,256688,244939,160640,497722,253723,243999,94516,50208,44308,370863,188773,182090,36248,17707,18541,437964
123.330291748046875,41.425216674804688,2110,21,211081,,Dengta,City,3,502149,259895,242254,156225,494772,254315,240457,95543,50521,45022,373318,193022,180296,33288,16352,16936,435196
119.63226318359375,41.400791168212891,2113,21,211322,ƽ,Jianping,County,3,543405,276564,266841,157607,540250,274725,265525,124941,67904,57037,383562,191556,192006,34902,17104,17798,523071
122.423027038574219,41.384235382080078,2103,21,210321,̨,Taian,County,3,354706,181759,172947,101954,351934,179530,172404,72981,38758,34223,253598,129190,124408,28127,13811,14316,327902
124.112640380859375,41.295799255371094,2105,21,210521,Ϫ,Benximanzuzizhixian,County,3,293834,151474,142360,87094,290596,148874,141722,64129,33868,30261,209087,107498,101589,20618,10108,10510,265389
125.35614013671875,41.267871856689453,2105,21,210522,,Huanrenmanzuzizhixian,County,3,293505,151215,142290,81696,291616,150020,141596,58816,30550,28266,215976,111404,104572,18713,9261,9452,278887
119.389060974121094,41.242252349853516,2113,21,211382,Դ,Lingyuan,City,3,620121,324554,295567,176034,608044,313573,294471,133378,72347,61031,445563,231460,214103,41180,20747,20433,602800
123.057701110839844,41.225643157958984,2110,21,211021,,Liaoyang,County,3,570566,295840,274726,176871,568492,294042,274450,106860,57010,49850,422176,218428,203748,41530,20402,21128,519028
123.230323791503906,41.193706512451172,2110,21,211004,ΰ,Hongwei,Qu,3,117784,59377,58407,39965,114375,57396,56979,18375,9485,8890,93007,46642,46365,6402,3250,3152,95587
121.934414729245333,41.238962778979491,2111,21,211122,ɽ,Panshan,County,3,281562,144757,136805,84864,277890,141547,136343,58179,30217,27962,201748,103540,98208,21635,11000,10635,251093
121.366806030273438,41.174568176269531,2107,21,210781,躣,Linghai,City,3,647310,332906,314404,197031,635546,322365,313181,118846,61391,57455,476643,246218,230425,51821,25297,26524,595104
119.731147766113281,41.124919891357422,2113,21,211324,ɹ,Kalaqinzuoyimengguzuzizhixi,County,3,397469,203380,194089,115472,396539,202771,193768,93016,49722,43294,276292,140080,136212,28161,13578,14583,384344
123.439239501953125,41.138500213623047,2110,21,211005,,Gongchangling,Qu,3,93210,48123,45087,30834,91520,46525,44995,14797,7784,7013,71275,36837,34438,7138,3502,3636,77799
121.092041015625,41.100776672363281,2107,21,210711,̫,Taihe,Qu,3,238699,122806,115893,74775,221049,111465,109584,39478,20326,19152,183890,95057,88833,15331,7423,7908,176794
123.745956420898438,41.092662811279297,2105,21,210505,Ϸ,Nanfen,Qu,3,88289,45652,42637,29041,86127,43751,42376,15004,7792,7212,65786,34167,31619,7499,3693,3806,79486
122.078109741210938,40.996677398681641,2111,21,211121,,Dawa,County,3,377650,193590,184060,113140,373315,189811,183504,78892,41017,37875,275565,140704,134861,23193,11869,11324,325230
119.779937744140625,40.813003540039062,2114,21,211422,,Jianchang,County,3,555121,288435,266686,151329,554345,287973,266372,144290,79192,65098,368174,188065,180109,42657,21178,21479,534244
124.777725219726562,40.730361938476562,2106,21,210624,,Kuandianmanzuzizhixian,County,3,409386,211195,198191,118595,406792,209091,197701,78493,40627,37866,299723,154673,145050,31170,15895,15275,381334
122.389442443847656,40.675678253173828,2108,21,210811,ϱ,Laobian,Qu,3,137226,70054,67172,41389,135836,69238,66598,27420,14320,13100,101747,51564,50183,8059,4170,3889,93009
122.495719909667969,40.631927490234375,2108,21,210882,ʯ,Dashiqiao,City,3,714670,370713,343957,206768,705245,363631,341614,152184,82712,69472,514289,263681,250608,48197,24320,23877,620015
124.06329345703125,40.457183837890625,2106,21,210682,,Fengcheng,City,3,560384,288402,271982,168760,555166,284215,270951,100424,51713,48711,415049,214588,200461,44911,22101,22810,510483
122.355331420898438,40.393135070800781,2108,21,210881,,Gaizhou,City,3,883811,455641,428170,244919,869141,445960,423181,182731,98829,83902,634205,324652,309553,66875,32160,34715,752719
120.337936401367188,40.328262329101562,2114,21,211421,,Suizhong,County,3,600101,311271,288830,178261,597722,309193,288529,130787,71863,58924,421025,215911,205114,48289,23497,24792,572864
122.104699057790498,40.295333102111194,2108,21,210804,Ȧ,Bayuquan,Qu,3,134576,68120,66456,40963,129450,66129,63321,27385,14689,12696,102306,51069,51237,4885,2362,2523,87576
123.269737243652344,40.283283233642578,2103,21,210323,,Xiuyanmanzuzizhixian,County,3,491918,254281,237637,133765,489952,252818,237134,106158,55415,50743,346517,179170,167347,39243,19696,19547,462357
124.145942687988281,39.885051727294922,2106,21,210681,,Donggang,City,3,640340,324344,315996,191358,634355,320631,313724,123496,63779,59717,467910,236424,231486,48934,24141,24793,572495
122.963920593261719,39.700771331787109,2102,21,210283,ׯ,Zhuanghe,City,3,835062,422677,412385,257770,830133,419772,410361,157136,80561,76575,598603,303186,295417,79323,38930,40393,764691
121.958412170410156,39.397819519042969,2102,21,210282,,Pulandian,City,3,757844,385636,372208,244245,750375,381293,369082,142927,72880,70047,547957,279713,268244,66960,33043,33917,701325
121.713996887207031,39.104301452636719,2102,21,210213,,Jinzhou,Qu,3,833594,409493,424101,255361,728040,366855,361185,128759,66230,62529,645961,315059,330902,58874,28204,30670,549085
121.263343811035156,38.8096923828125,2102,21,210212,˳,Lvshunkou,Qu,3,264998,134599,130399,86645,247369,123830,123539,41744,21475,20269,202049,103259,98790,21205,9865,11340,180569
123.924410159969753,41.826281628036391,2104,21,210403,,Dongzhou,Qu,3,345778,174901,170877,116311,341970,171937,170033,48591,25193,23398,261780,132667,129113,35407,17041,18366,290802
123.84166440655639,41.902216545011861,2104,21,210404,,Wanghua,Qu,3,387473,197152,190321,124440,376763,189639,187124,56135,29024,27111,298954,152285,146669,32384,15843,16541,320530
124.437009942673257,40.172835374376355,2106,21,210604,,Zhenan,Qu,3,198154,101589,96565,59779,188027,94787,93240,32511,16884,15627,150344,77173,73171,15299,7532,7767,163134
123.790744386124217,42.328161083663225,2112,21,211202,,Yinzhou,Qu,3,341179,170426,170753,111156,327695,163446,164249,52156,27098,25058,266279,132132,134147,22744,11196,11548,243167
124.377022866817171,40.129805459404103,2106,21,210603,,Zhenxing,Qu,3,386370,191298,195072,122147,368547,181419,187128,55570,28734,26836,296278,145662,150616,34522,16902,17620,302986
123.893453203660272,41.879428072529841,2104,21,210402,¸,Xinfu,Qu,3,303579,150701,152878,96807,294302,144941,149361,41920,21493,20427,233366,115949,117417,28293,13259,15034,238594
123.44575659659904,41.81507992948238,2101,21,210104,,Dadong,Qu,3,645838,329451,316387,208547,606285,300157,306128,79902,41337,38565,501372,256355,245017,64564,31759,32805,499042
123.389047322221828,41.829421471035609,2101,21,210105,ʹ,Huanggu,Qu,3,707994,357987,350007,215201,641998,316201,325797,86878,44593,42285,551339,279245,272094,69777,34149,35628,541623
123.386653640861255,41.796038068561089,2101,21,210102,ƽ,Heping,Qu,3,651874,329242,322632,202303,596325,292888,303437,79889,41042,38847,503565,255558,248007,68420,32642,35778,499809
123.417744759339541,41.798901170757091,2101,21,210103,,Shenhe,Qu,3,601444,300835,300609,194003,568465,278570,289895,75172,38586,36586,466555,234325,232230,59717,27924,31793,450998
123.327525707530953,41.803645032989913,2101,21,210106,,Tiexi,Qu,3,748834,378241,370593,243575,722970,359582,363388,95017,49057,45960,569488,286857,282631,84329,42327,42002,565063
122.079367223237398,41.122367353805927,2111,21,211103,¡̨,Xinglongtai,Qu,3,408686,211690,196996,134243,386000,193574,192426,67673,35079,32594,326093,168852,157241,14920,7759,7161,320961
122.210941063266347,40.664852961929242,2108,21,210803,,Xishi,Qu,3,163881,82015,81866,54663,158232,78404,79828,24199,12622,11577,126637,63079,63558,13045,6314,6731,115704
123.202921607603855,41.266930117579811,2110,21,211003,ʥ,Wensheng,Qu,3,171646,85202,86444,59615,169970,84358,85612,25866,13265,12601,130161,64125,66036,15619,7812,7807,123593
122.992029752460525,41.09109020892118,2103,21,210302,,Tiedong,Qu,3,452872,224613,228259,141621,440623,218717,221906,61922,32173,29749,346067,170074,175993,44883,22366,22517,356714
122.98428868329465,41.074418201246054,2103,21,210311,ǧɽ,Qianshan,Qu,3,366221,189270,176951,118089,352561,180465,172096,58435,30653,27782,280762,145472,135290,27024,13145,13879,254646
122.965107448369054,41.097680254060407,2103,21,210303,,Tiexi,Qu,3,311630,157265,154365,104586,308288,155665,152623,41746,21672,20074,241446,121580,119866,28438,14013,14425,241562
123.010745331550353,41.113571396718172,2103,21,210304,ɽ,Lishan,Qu,3,425562,216690,208872,140130,421539,213158,208381,56971,29449,27522,327398,166290,161108,41193,20951,20242,349397
121.676955202716826,41.962915264421838,2109,21,210904,̫ƽ,Taiping,Qu,3,148785,74076,74709,51219,147859,73442,74417,23836,12181,11655,111802,55384,56418,13147,6511,6636,124790
121.665809724806024,42.017985307899615,2109,21,210911,ϸ,Xihe,Qu,3,157706,80470,77236,47848,155478,78601,76877,27877,14424,13453,120331,61446,58885,9498,4600,4898,107248
106.686698913574219,39.111831665039062,6402,64,640223,ũ,Huinong,County,3,74499,39456,35043,20704,70346,36019,34327,16237,8345,7892,54212,28976,25236,4050,2135,1915,59135
106.542938232421875,38.906406402587891,6402,64,640221,ƽ,Pingluo,County,3,257445,132886,124559,72103,252954,128907,124047,61806,31733,30073,181750,93800,87950,13889,7353,6536,226763
106.694038391113281,38.810596466064453,6402,64,640222,,Taole,County,3,29138,14994,14144,7770,28844,14747,14097,8402,4339,4063,19472,9973,9499,1264,682,582,24775
106.345787048339844,38.557640075683594,6401,64,640122,,Helan,County,3,178458,91489,86969,49295,176439,89861,86578,44224,22687,21537,124313,63720,60593,9921,5082,4839,156091
106.248611450195312,38.280353546142578,6401,64,640121,,Yongning,County,3,191668,98685,92983,50388,187226,95621,91605,50919,26917,24002,131284,66867,64417,9465,4901,4564,171896
106.330825805664062,38.091331481933594,6403,64,640382,,Lingwu,City,3,249890,128364,121526,62772,243902,123300,120602,69544,36204,33340,169051,86292,82759,11295,5868,5427,214701
107.403884887695312,37.783184051513672,6403,64,640323,γ,Yanchi,County,3,153584,79182,74402,39339,151174,77467,73707,41489,21744,19745,105967,54129,51838,6128,3309,2819,125647
105.1866455078125,37.512992858886719,6403,64,640321,,Zhongwei,County,3,320474,163555,156919,83744,318850,162376,156474,90843,47791,43052,216334,108784,107550,13297,6980,6317,289820
105.673553466796875,37.490055084228516,6403,64,640322,,Zhongning,County,3,249270,127140,122130,61895,247454,125698,121756,74660,38925,35735,163528,82464,81064,11082,5751,5331,220182
105.906280517578125,36.982105255126953,6403,64,640324,ͬ,Tongxin,County,3,328741,166687,162054,67733,327011,165606,161405,123200,63194,60006,194487,97684,96803,11054,5809,5245,312150
105.63916015625,36.560127258300781,6422,64,642222,ԭ,Haiyuan,County,3,343960,175123,168837,68566,343464,174714,168750,130588,66988,63600,201470,101928,99542,11902,6207,5695,334553
106.28009033203125,36.012859344482422,6422,64,642221,ԭ,Guyuan,County,3,470741,239739,231002,106936,462325,234628,227697,151310,77852,73458,299764,151724,148040,19667,10163,9504,427804
105.722099304199219,35.972354888916016,6422,64,642223,,Xiji,County,3,403209,206083,197126,78470,400850,204093,196757,151539,77764,73775,235690,120123,115567,15980,8196,7784,393944
106.64617919921875,35.851772308349609,6422,64,642226,,Pengyang,County,3,230981,118268,112713,51789,229833,117371,112462,75541,39013,36528,146070,74260,71810,9370,4995,4375,221006
106.117965698242188,35.619373321533203,6422,64,642224,¡,Longde,County,3,197160,101226,95934,47511,195812,100161,95651,64009,33091,30918,123785,63494,60291,9366,4641,4725,180806
106.337913513183594,35.491291046142578,6422,64,642225,Դ,Jingyuan,County,3,81310,41146,40164,19606,80880,40781,40099,26859,13449,13410,50487,25565,24922,3964,2132,1832,74341
106.765693664550781,39.23748779296875,6402,64,640203,ʯɽ,Shizuishan,Qu,3,120739,62891,57848,39265,117363,59987,57376,24013,12397,11616,89442,46438,43004,7284,4056,3228,100641
106.072845458984375,38.019466400146484,6403,64,640381,ͭϿ,Qingtongxia,City,3,248640,129121,119519,67545,241939,123464,118475,60831,31948,28883,176393,91216,85177,11416,5957,5459,212080
106.140457499128047,38.560225787134314,6401,64,640111,,Jiaoqu,Qu,3,273031,144056,128975,81633,258164,132626,125538,67287,34740,32547,196223,104368,91855,9521,4948,4573,133130
106.382402870015099,39.026330038253462,6402,64,640202,,Dawukou,Qu,3,133168,68511,64657,41775,124889,62795,62094,24974,12939,12035,101793,52007,49786,6401,3565,2836,104549
106.196416254223394,37.981872279928901,6403,64,640302,ͨ,Litong,Qu,3,303567,154551,149016,77906,296090,148771,147319,79468,41480,37988,208480,105110,103370,15619,7961,7658,270203
106.103874206542969,38.51806640625,6401,64,640103,³,Xincheng,Qu,3,250627,127376,123251,75790,211787,106732,105055,41158,21203,19955,197601,99543,98058,11868,6630,5238,171507
106.315261840820312,38.48004150390625,6401,64,640102,,Cheng,Qu,3,283829,143771,140058,94267,261145,128189,132956,45376,23156,22220,219863,110902,108961,18590,9713,8877,201079
106.366296227566465,39.185789940036294,6402,64,640204,ʯ̿,Shitanjing,Qu,3,60389,31859,28530,19059,58928,30476,28452,12580,6494,6086,45847,24214,21633,1962,1151,811,49999
106.202490837140488,37.605970188021161,6403,64,640303,±,Hongsibao,Qu,3,51875,27358,24517,11009,50372,25938,24434,19812,10504,9308,30917,16278,14639,1146,576,570,49754
101.830436706542969,36.601734161376953,6301,63,630102,Ƕ,Chengdong,Qu,3,270268,139989,130279,80005,250120,124867,125253,52376,27153,25223,202801,104347,98454,15091,8489,6602,172594
101.775550842285156,36.616226196289062,6301,63,630103,,Chengzhong,Qu,3,148521,75418,73103,46737,136877,67927,68950,24407,12634,11773,113388,56858,56530,10726,5926,4800,107274
101.749168395996094,36.622154235839844,6301,63,630104,,Chengxi,Qu,3,225412,114691,110721,69268,206264,102813,103451,39463,20418,19045,172614,86648,85966,13335,7625,5710,163535
101.738227844238281,36.656780242919922,6301,63,630105,Ǳ,Chengbei,Qu,3,210265,110261,100004,63325,195747,99574,96173,37498,19476,18022,161636,84559,77077,11131,6226,4905,158974
100.24029541015625,38.174961090087891,6322,63,632222,,Qilian,County,3,45394,23076,22318,10488,44533,22337,22196,13820,6975,6845,30001,15401,14600,1573,700,873,39775
101.616798400878906,37.374786376953125,6322,63,632221,Դ,Menyuanhuizuzizhixian,County,3,141426,73292,68134,31414,139283,71386,67897,42808,21902,20906,93757,48760,44997,4861,2630,2231,135762
100.132164001464844,37.326725006103516,6322,63,632224,ղ,Gangcha,County,3,39223,20883,18340,9348,36767,18631,18136,10815,5426,5389,26954,14833,12121,1454,624,830,33839
99.0203857421875,37.303333282470703,6328,63,632823,,Tianjun,County,3,18927,9845,9082,4174,17945,8979,8966,5717,2925,2792,12400,6579,5821,810,341,469,16123
98.4779052734375,36.930156707763672,6328,63,632821,,Wulan,County,3,36015,18866,17149,9883,34868,17843,17025,9988,4994,4994,25063,13419,11644,964,453,511,29640
101.686065673828125,36.923164367675781,6301,63,630121,ͨ,Datonghuizutuzuzhzhixian,County,3,416968,215227,201741,97189,410785,210576,200209,116030,59681,56349,284953,147345,137608,15985,8201,7784,394352
100.986061096191406,36.899391174316406,6322,63,632223,,Haiyan,County,3,32879,17550,15329,8531,30331,15502,14829,8149,4216,3933,23660,12815,10845,1070,519,551,26705
101.95526123046875,36.837501525878906,6321,63,632126,,Huzhutuzuzhzhixian,County,3,357089,184722,172367,82515,353163,181568,171595,98539,51287,47252,243294,125943,117351,15256,7492,7764,348522
101.268562316894531,36.688724517822266,6301,63,630123,Դ,Huangyuan,County,3,129814,66771,63043,32113,127482,65444,62038,32218,16292,15926,91531,47398,44133,6065,3081,2984,127757
102.117691040039062,36.495349884033203,6321,63,632121,ƽ,Pingan,County,3,106866,54374,52492,29307,103908,52637,51271,27432,14173,13259,74338,37659,36679,5096,2542,2554,95094
101.57501220703125,36.495552062988281,6301,63,630122,,Huangzhong,County,3,448465,234714,213751,104543,434561,225483,209078,118566,62091,56475,309163,162343,146820,20736,10280,10456,428125
102.3944091796875,36.48724365234375,6321,63,632123,ֶ,Ledu,County,3,262704,134513,128191,65702,254399,129405,124994,68686,35443,33243,180026,91955,88071,13992,7115,6877,245636
102.806404113769531,36.330341339111328,6321,63,632122,ͻ,Minhehuizutuzuzhzhixian,County,3,346748,180210,166538,75126,343877,178308,165569,107434,56170,51264,223639,116125,107514,15675,7915,7760,333804
98.093856811523438,36.306083679199219,6328,63,632822,,Dulan,County,3,57670,31462,26208,14011,53164,27121,26043,16130,8140,7990,39751,22472,17279,1789,850,939,49036
100.629501342773438,36.296413421630859,6325,63,632521,,Gonghe,County,3,111974,57666,54308,26257,104727,52023,52704,32167,16235,15932,75565,39456,36109,4242,1975,2267,98900
102.280990600585938,36.097591400146484,6321,63,632127,¡,Hualonghuizuzhzhixian,County,3,213706,109772,103934,43807,209779,106325,103454,65913,33916,31997,139056,71611,67445,8737,4245,4492,200562
101.448204040527344,36.053295135498047,6325,63,632523,,Guide,County,3,91552,46388,45164,22008,89342,44617,44725,24781,12589,12192,61984,31651,30333,4787,2148,2639,85513
102.036590576171875,35.936252593994141,6323,63,632322,,Jianzha,County,3,51064,26000,25064,12120,48189,23957,24232,15212,7648,7564,33517,17299,16218,2335,1053,1282,44530
102.494880676269531,35.845653533935547,6321,63,632128,ѭ,Xunhuasalazuzhzhixian,County,3,104452,52407,52045,20610,101822,50520,51302,32214,16613,15601,66442,33102,33340,5796,2692,3104,99588
99.990074157714844,35.555622100830078,6325,63,632524,˺,Xinghai,County,3,59580,30248,29332,12480,58271,28978,29293,20560,10505,10055,36465,18599,17866,2555,1144,1411,53964
100.743621826171875,35.584300994873047,6325,63,632525,,Guinan,County,3,63579,31950,31629,12913,62382,30863,31519,20483,10228,10255,40402,20576,19826,2694,1146,1548,60334
102.008888244628906,35.511459350585938,6323,63,632321,ͬ,Tongren,County,3,77040,38703,38337,17031,73528,35856,37672,23223,11775,11448,49235,25086,24149,4582,1842,2740,72377
100.575057983398438,35.254711151123047,6325,63,632522,ͬ,Tongde,County,3,48741,24798,23943,8801,47200,23352,23848,16300,8331,7969,30297,15585,14712,2144,882,1262,44572
101.470863342285156,35.03656005859375,6323,63,632323,,Zeku,County,3,54288,27401,26887,10987,53710,26851,26859,20402,10347,10055,31393,16038,15355,2493,1016,1477,51651
98.208473205566406,34.921768188476562,6326,63,632626,,Maduo,County,3,10890,5673,5217,2639,10561,5353,5208,3610,1767,1843,6928,3768,3160,352,138,214,8388
101.613090515136719,34.737598419189453,6323,63,632324,ɹ,Henanmengguzuzizhixian,County,3,32250,16289,15961,6414,31660,15710,15950,11099,5625,5474,19729,10120,9609,1422,544,878,29533
95.780418395996094,34.128452301025391,6327,63,632726,,Qumalai,County,3,24181,12295,11886,5211,23767,11938,11829,8777,4428,4349,14538,7579,6959,866,288,578,19983
99.899169921875,33.959480285644531,6326,63,632623,ʵ,Gande,County,3,25494,13020,12474,5284,24574,12147,12427,8515,4383,4132,15685,8134,7551,1294,503,791,23361
95.613853454589844,33.857200622558594,6327,63,632724,ζ,Zhiduo,County,3,24194,12060,12134,5568,23819,11700,12119,8457,4236,4221,14810,7494,7316,927,330,597,21649
99.65203857421875,33.749839782714844,6326,63,632624,,Dari,County,3,24354,12560,11794,5594,23467,11727,11740,7253,3687,3566,16044,8441,7603,1057,432,625,22487
101.482696533203125,33.425849914550781,6326,63,632625,,Jiuzhi,County,3,19336,9846,9490,4067,18510,9025,9485,5665,2799,2866,12626,6658,5968,1045,389,656,17734
97.104103088378906,33.360183715820312,6327,63,632723,ƶ,Chengduo,County,3,40391,20031,20360,8247,38681,18403,20278,12432,6216,6216,26071,13149,12922,1888,666,1222,38312
97.017341613769531,33.012714385986328,6327,63,632721,,Yushu,County,3,77854,38891,38963,16207,74601,36404,38197,23830,12183,11647,50152,25406,24746,3872,1302,2570,68194
100.735801696777344,32.916709899902344,6326,63,632622,,Banma,County,3,22088,11270,10818,5024,21782,10993,10789,6959,3549,3410,13950,7277,6673,1179,444,735,20578
95.3009033203125,32.901931762695312,6327,63,632722,Ӷ,Zaduo,County,3,38654,19433,19221,6898,38319,19208,19111,14594,7358,7236,22224,11351,10873,1836,724,1112,33250
96.476951599121094,32.208442687988281,6327,63,632725,ǫ,Nangqian,County,3,57387,28991,28396,9603,56175,28025,28150,17744,9137,8607,36553,18628,17925,3090,1226,1864,54728
97.371711730957031,37.375202178955078,6328,63,632802,,Delingha,City,3,83585,45968,37617,24249,74789,38681,36108,18902,9648,9254,62682,35218,27464,2001,1102,899,58459
94.443419572348915,36.317399479518429,6328,63,632801,ľ,Geermu,City,3,135897,73572,62325,39448,126033,65379,60654,35052,18369,16683,98945,54147,44798,1900,1056,844,74107
100.24217274997487,34.481485862933944,6326,63,632621,,Maqin,County,3,35778,18494,17284,8830,33764,16980,16784,10853,5500,5353,23589,12471,11118,1336,523,813,30482
109.227836608886719,34.646434783935547,6101,61,610114,,Yanliang,Qu,3,235672,120500,115172,66165,227768,115236,112532,53426,28103,25323,168250,85514,82736,13996,6883,7113,216429
108.079132080078125,34.272666931152344,6104,61,610403,,Yangling,Qu,3,137941,73193,64748,30354,111734,57813,53921,30266,17212,13054,100375,52227,48148,7300,3754,3546,116481
109.157058715820312,33.407962799072266,6125,61,612526,,Zhenan,County,3,276488,149909,126579,76320,271388,146640,124748,72691,38784,33907,182461,99943,82518,21336,11182,10154,265098
107.761627197265625,32.985244750976562,6107,61,610724,,Xixiang,County,3,345074,180970,164104,108474,343219,179571,163648,77866,41909,35957,240589,124899,115690,26619,14162,12457,336143
107.908546447753906,32.534290313720703,6107,61,610728,,Zhenba,County,3,251522,135033,116489,71689,250154,133947,116207,60780,32740,28040,173314,93002,80312,17428,9291,8137,248932
109.516273498535156,31.891204833984375,6109,61,610927,ƺ,Zhenping,County,3,53719,28791,24928,14994,52924,28149,24775,12342,6312,6030,36810,19965,16845,4567,2514,2053,51241
111.074569702148438,39.032142639160156,6108,61,610822,,Fugu,County,3,224957,121494,103463,56927,210531,110525,100006,58344,31469,26875,151993,82131,69862,14620,7894,6726,185086
110.504692077636719,38.823215484619141,6108,61,610821,ľ,Shenmu,County,3,360774,193218,167556,94840,344802,180082,164720,103192,56284,46908,238218,126842,111376,19364,10092,9272,295708
110.489770030680802,38.01971479197357,6108,61,610828,,Jia,County,3,238496,124125,114371,65141,236769,123212,113557,72025,38569,33456,151801,77990,73811,14670,7566,7104,232887
109.306686401367188,37.958030700683594,6108,61,610823,ɽ,Hengshan,County,3,294674,153008,141666,68023,291697,151218,140479,94133,50836,43297,185687,94505,91182,14854,7667,7187,279961
110.193313598632812,37.753974914550781,6108,61,610827,֬,Mizhi,County,3,200626,103213,97413,51430,197239,101441,95798,56982,30841,26141,130415,65706,64709,13229,6666,6563,185689
110.036468505859375,37.616783142089844,6108,61,610831,,Zizhou,County,3,248619,127858,120761,63093,244582,125751,118831,77944,41720,36224,155450,78543,76907,15225,7595,7630,236567
108.810783386230469,37.597328186035156,6108,61,610824,,Jingbian,County,3,272836,141951,130885,64696,264712,136579,128133,78672,41832,36840,181941,93645,88296,12223,6474,5749,231307
107.598114013671875,37.581348419189453,6108,61,610825,,Dingbian,County,3,285416,148387,137029,68179,281679,145807,135872,85994,45887,40107,187247,95836,91411,12175,6664,5511,256922
110.261611938476562,37.499725341796875,6108,61,610826,,Suide,County,3,310880,159107,151773,86554,303006,155507,147499,92794,49266,43528,197712,99653,98059,20374,10188,10186,286157
110.735671997070312,37.453117370605469,6108,61,610829,Ɽ,Wubao,County,3,72781,37642,35139,20761,72155,37235,34920,22474,11883,10591,45535,23461,22074,4772,2298,2474,68709
109.666244506835938,37.135143280029297,6106,61,610623,ӳ,Zichang,County,3,207972,107049,100923,51543,203776,104459,99317,69895,36467,33428,128080,65528,62552,9997,5054,4943,185557
110.128211975097656,37.087821960449219,6108,61,610830,彧,Qingjian,County,3,176644,92196,84448,48591,174331,90889,83442,53312,28489,24823,112349,58217,54132,10983,5490,5493,169395
108.188392639160156,36.922828674316406,6106,61,610626,,Wuqi,County,3,112524,58720,53804,27960,108136,55614,52522,33255,17452,15803,73705,38231,35474,5564,3037,2527,100441
110.18707275390625,36.869590759277344,6106,61,610622,Ӵ,Yanchuan,County,3,164902,86066,78836,43508,160358,83230,77128,50105,26580,23525,106415,55161,51254,8382,4325,4057,148036
109.342025756835938,36.863502502441406,6106,61,610624,,Ansai,County,3,160771,85159,75612,40680,153332,79319,74013,48447,25490,22957,105510,56086,49424,6814,3583,3231,140041
108.784378051757812,36.815666198730469,6106,61,610625,־,Zhidan,County,3,124449,66000,58449,29830,119234,61851,57383,38609,20381,18228,80991,42852,38139,4849,2767,2082,110376
110.021308898925781,36.57867431640625,6106,61,610621,ӳ,Yanchang,County,3,128551,67024,61527,35582,126290,65208,61082,37979,19903,18076,83251,43267,39984,7321,3854,3467,114676
109.365936279296875,36.273597717285156,6106,61,610627,Ȫ,Ganquan,County,3,76705,40715,35990,20105,73705,38300,35405,22219,11625,10594,50971,27100,23871,3515,1990,1525,66475
110.177444458007812,36.040145874023438,6106,61,610630,˴,Yichuan,County,3,111685,57844,53841,29576,110198,56956,53242,31272,16183,15089,73997,38279,35718,6416,3382,3034,103313
109.397331237792969,35.985572814941406,6106,61,610628,,Fu,County,3,141760,75708,66052,36784,136913,71785,65128,38554,20522,18032,96255,51469,44786,6951,3717,3234,128508
109.434959411621094,35.749034881591797,6106,61,610629,崨,Luochuan,County,3,200573,104581,95992,51998,192683,100074,92609,55218,29219,25999,134556,69637,64919,10799,5725,5074,187089
109.83929443359375,35.578807830810547,6106,61,610631,,Huanglong,County,3,49039,26312,22727,14877,47658,25333,22325,12323,6273,6050,33828,18436,15392,2888,1603,1285,44712
109.271354675292969,35.576904296875,6106,61,610632,,Huangling,County,3,133988,72811,61177,35390,123096,63458,59638,36400,18860,17540,91326,50656,40670,6262,3295,2967,110122
109.115615844726562,35.387222290039062,6102,61,610222,˾,Yijun,County,3,93141,51151,41990,25544,88445,46946,41499,24141,12486,11655,63669,35828,27841,5331,2837,2494,82701
110.166099548339844,35.228759765625,6105,61,610524,,Heyang,County,3,432313,219025,213288,110216,427693,216202,211491,112461,58997,53464,291953,147343,144610,27899,12685,15214,416332
107.7930908203125,35.196643829345703,6104,61,610428,,Changwu,County,3,167274,88660,78614,43896,161424,84984,76440,44902,25406,19496,113019,58110,54909,9353,5144,4209,162470
109.949295043945312,35.179603576660156,6105,61,610525,γ,Chengcheng,County,3,372150,190529,181621,94786,352996,178249,174747,96385,51117,45268,252372,128651,123721,23393,10761,12632,345144
109.599624633789062,35.169052124023438,6105,61,610527,ˮ,Baishui,County,3,277716,144011,133705,69132,269724,138269,131455,78654,41601,37053,183097,94528,88569,15965,7882,8083,259002
108.316238403320312,35.113700866699219,6104,61,610429,Ѯ,Xunyi,County,3,261666,138089,123577,67095,257606,135056,122550,74896,41176,33720,173532,89468,84064,13238,7445,5793,255129
108.069190979003906,35.035888671875,6104,61,610427,,Bin,County,3,313216,165718,147498,80084,307981,161661,146320,92888,50635,42253,206129,106958,99171,14199,8125,6074,301119
109.580093383789062,34.943367004394531,6105,61,610526,ѳ,Pucheng,County,3,738675,377385,361290,187552,713067,360123,352944,191565,100885,90680,502157,255734,246423,44953,20766,24187,696532
108.976493835449219,34.901958465576172,6102,61,610221,ҫ,Yao,County,3,295202,154384,140818,76786,285390,146813,138577,76575,40702,35873,203271,105848,97423,15356,7834,7522,270386
106.875579833984375,34.897689819335938,6103,61,610327,¤,Long,County,3,241751,125245,116506,61618,236362,120992,115370,69021,37774,31247,162161,81738,80423,10569,5733,4836,228348
108.570091247558594,34.808723449707031,6104,61,610430,,Chunhua,County,3,186867,96105,90762,46633,181220,92343,88877,56829,29356,27473,120777,61806,58971,9261,4943,4318,183069
109.931510925292969,34.782161712646484,6105,61,610523,,Dali,County,3,706948,358168,348780,174883,688513,347375,341138,179335,95316,84019,481824,242342,239482,45789,20510,25279,681668
109.162826538085938,34.74688720703125,6105,61,610528,ƽ,Fuping,County,3,747942,384129,363813,180746,700630,354858,345772,198295,105372,92923,506276,257889,248387,43371,20868,22503,721730
108.134628295898438,34.691444396972656,6104,61,610426,,Yongshou,County,3,187446,98597,88849,44856,180393,93708,86685,54129,29422,24707,125722,65195,60527,7595,3980,3615,184220
107.784233093261719,34.685199737548828,6103,61,610329,,Linyou,County,3,85782,44525,41257,23122,84129,43161,40968,24611,12167,12444,57183,30108,27075,3988,2250,1738,79090
107.133857727050781,34.639846801757812,6103,61,610328,ǧ,Qianyang,County,3,121532,63285,58247,32773,117274,60305,56969,32054,17247,14807,82861,42495,40366,6617,3543,3074,112697
108.931320190429688,34.604663848876953,6104,61,610422,ԭ,Sanyuan,County,3,388842,196422,192420,100757,383261,192732,190529,95239,49947,45292,269885,135594,134291,23718,10881,12837,376690
110.085594177246094,34.554485321044922,6105,61,610582,,Huayin,City,3,242488,125006,117482,61803,223646,112373,111273,62952,32369,30583,165559,86314,79245,13977,6323,7654,223358
110.237930297851562,34.529384613037109,6105,61,610522,,Tongguan,County,3,147833,75079,72754,36001,144174,72262,71912,44660,22469,22191,95941,49266,46675,7232,3344,3888,133887
108.826248168945312,34.520767211914062,6104,61,610423,,Jingyang,County,3,485791,247121,238670,117612,477640,242424,235216,122926,65367,57559,335053,169154,165899,27812,12600,15212,474563
109.084243774414062,34.525783538818359,6101,61,610126,,Gaoling,County,3,222367,112605,109762,55873,220299,111089,109210,57918,30868,27050,150997,75874,75123,13452,5863,7589,214615
108.230575561523438,34.530300140380859,6104,61,610424,Ǭ,Qian,County,3,544846,283010,261836,128010,530821,275949,254872,156209,87228,68981,360690,182174,178516,27947,13608,14339,525423
107.39471435546875,34.517490386962891,6103,61,610322,,Fengxiang,County,3,484464,247587,236877,128096,474467,240424,234043,130226,70941,59285,326270,162678,163592,27968,13968,14000,457834
109.757377624511719,34.502033233642578,6105,61,610521,,Hua,County,3,350228,177867,172361,94187,340833,170744,170089,85145,42968,42177,240819,123903,116916,24264,10996,13268,334378
108.41656494140625,34.489967346191406,6104,61,610425,Ȫ,Liquan,County,3,455278,234210,221068,110774,440675,225888,214787,123457,68390,55067,307401,154426,152975,24420,11394,13026,449705
107.623321533203125,34.438381195068359,6103,61,610323,ɽ,Qishan,County,3,446579,229124,217455,121074,431160,219100,212060,114428,63438,50990,305076,152621,152455,27075,13065,14010,426430
107.868492126464844,34.361824035644531,6103,61,610324,,Fufeng,County,3,438324,228015,210309,111335,429781,221882,207899,122081,69252,52829,293438,147647,145791,22805,11116,11689,416522
107.395401000976562,34.366176605224609,6103,61,610321,,Baoji,County,3,729126,379438,349688,174734,695368,355368,340000,188931,101904,87027,502168,257988,244180,38027,19546,18481,703353
108.48260498046875,34.298721313476562,6104,61,610481,ƽ,Xingping,City,3,551523,284879,266644,135296,538154,276473,261681,147351,81613,65738,372288,187740,184548,31884,15526,16358,530221
107.754791259765625,34.273563385009766,6103,61,610326,ü,Mei,County,3,290315,151106,139209,77012,278275,143458,134817,74648,40753,33895,199643,102300,97343,16024,8053,7971,275140
108.202484130859375,34.260116577148438,6104,61,610431,书,Wugong,County,3,389394,201177,188217,91833,377675,194392,183283,115015,64255,50760,254369,127222,127147,20010,9700,10310,380851
108.944999694824219,34.147609710693359,6101,61,610121,,Changan,County,3,864269,442284,421985,221053,839376,428133,411243,215108,117117,97991,594410,299796,294614,54751,25371,29380,812473
109.321128845214844,34.138694763183594,6101,61,610122,,Lantian,County,3,560283,285984,274299,144396,552347,280044,272303,161278,86585,74693,360232,180922,179310,38773,18477,20296,539577
108.618980407714844,34.128158569335938,6101,61,610125,,Hu,County,3,549252,285227,264025,139416,538825,279018,259807,133381,77004,56377,380718,190835,189883,35153,17388,17765,521140
110.142501831054688,34.073135375976562,6125,61,612522,,Luonan,County,3,455183,239735,215448,119381,425786,219385,206401,121476,63645,57831,306623,163091,143532,27084,12999,14085,438129
107.317626953125,34.056732177734375,6103,61,610331,̫,Taibai,County,3,51332,28046,23286,13452,47936,25100,22836,12711,6377,6334,36113,20252,15861,2508,1417,1091,45651
106.537925720214844,33.904487609863281,6103,61,610330,,Feng,County,3,104633,56186,48447,28169,98924,51285,47639,23464,11721,11743,74589,40897,33692,6580,3568,3012,91347
110.342460632324219,33.671623229980469,6125,61,612523,,Danfeng,County,3,295833,157257,138576,74345,286072,150602,135470,81471,43700,37771,198925,105770,93155,15437,7787,7650,288078
109.116973876953125,33.670768737792969,6125,61,612527,ˮ,Zhashui,County,3,158421,86433,71988,43980,154397,83316,71081,42115,21952,20163,106350,59165,47185,9956,5316,4640,150336
106.93865966796875,33.616722106933594,6107,61,610729,,Liuba,County,3,46294,25723,20571,12520,43003,23024,19979,10144,5160,4984,32102,18356,13746,4048,2207,1841,42999
109.88275146484375,33.513820648193359,6125,61,612525,ɽ,Shanyang,County,3,400993,213771,187222,107829,399440,212772,186668,119391,64739,54652,259815,137719,122096,21787,11313,10474,394728
110.888259887695312,33.513347625732422,6125,61,612524,,Shangnan,County,3,227636,120717,106919,62495,222831,116436,106395,61612,32041,29571,153770,82260,71510,12254,6416,5838,220980
107.992080688476562,33.52587890625,6107,61,610730,ƺ,Foping,County,3,33695,18731,14964,9513,32874,18162,14712,7063,3764,3299,23868,13429,10439,2764,1538,1226,31562
106.155021667480469,33.323604583740234,6107,61,610727,,Lveyang,County,3,201498,107981,93517,55925,197151,104551,92600,42305,21337,20968,141907,77353,64554,17286,9291,7995,194522
108.324592590332031,33.313087463378906,6109,61,610923,,Ningshan,County,3,75778,41874,33904,21071,74038,40570,33468,16962,8586,8376,52691,29791,22900,6125,3497,2628,70899
107.5467529296875,33.218574523925781,6107,61,610723,,Yang,County,3,384374,203120,181254,120734,380650,200208,180442,89503,50505,38998,263719,136798,126921,31152,15817,15335,373143
107.330825805664062,33.144412994384766,6107,61,610722,ǹ,Chenggu,County,3,455408,234667,220741,145230,445831,228086,217745,102035,54097,47938,316945,162476,154469,36428,18094,18334,430003
106.673980712890625,33.148887634277344,6107,61,610725,,Mian,County,3,397131,204543,192588,116279,378628,192254,186374,83148,43331,39817,283258,145873,137385,30725,15339,15386,388659
108.253456115722656,33.043373107910156,6109,61,610922,ʯȪ,Shiquan,County,3,159503,86419,73084,48134,157758,85154,72604,38579,20455,18124,108598,59359,49239,12326,6605,5721,154171
106.931159973144531,32.991069793701172,6107,61,610721,֣,Nanzheng,County,3,478782,244735,234047,149610,473013,240478,232535,107364,55096,52268,335673,171164,164509,35745,18475,17270,470837
108.505386352539062,32.905281066894531,6109,61,610921,,Hanyin,County,3,240359,128517,111842,73642,239280,127766,111514,69165,37334,31831,153929,81995,71934,17265,9188,8077,235996
109.378646850585938,32.827323913574219,6109,61,610928,Ѯ,Xunyang,County,3,426173,226934,199239,121339,421840,224027,197813,110912,59536,51376,284329,152378,131951,30932,15020,15912,417634
106.246780395507812,32.819629669189453,6107,61,610726,ǿ,Ningqiang,County,3,313395,162701,150694,85473,311551,161197,150354,73149,37430,35719,214963,112598,102365,25283,12673,12610,305488
110.101699829101562,32.795772552490234,6109,61,610929,׺,Baihe,County,3,180235,95724,84511,51069,179842,95442,84400,50113,26185,23928,115833,62404,53429,14289,7135,7154,177331
108.539474487304688,32.532299041748047,6109,61,610924,,Ziyang,County,3,285018,152830,132188,83645,284234,152269,131965,77942,40930,37012,185018,99966,85052,22058,11934,10124,278918
109.351043701171875,32.369083404541016,6109,61,610926,ƽ,Pingli,County,3,201392,107446,93946,60320,198969,106022,92947,50422,26624,23798,132851,71165,61686,18119,9657,8462,195767
108.891670227050781,32.303905487060547,6109,61,610925,᰸,Langao,County,3,148311,81078,67233,43501,145405,79170,66235,35013,18593,16420,100035,55239,44796,13263,7246,6017,142701
110.457748413085938,35.453369140625,6105,61,610581,,Hancheng,City,3,387041,201881,185160,100452,362560,184298,178262,96273,51569,44704,268348,139927,128421,22420,10385,12035,348132
109.939033508300781,33.845535278320312,6125,61,612501,,Shangzhou,City,3,530883,279160,251723,141893,500148,259847,240301,143524,76877,66647,355429,186213,169216,31930,16070,15860,514167
109.763922531645562,38.193173291139239,6108,61,610802,,Yuyang,Qu,3,451337,232951,218386,117303,427257,219735,207522,118833,64247,54586,309781,157204,152577,22723,11500,11223,381579
109.548673890306119,36.493139951105434,6106,61,610602,,Baota,Qu,3,403868,209240,194628,109464,377018,193655,183363,104961,55228,49733,281411,144631,136780,17496,9381,8115,313054
108.68965476652977,34.313483742827138,6104,61,610402,ض,Qindu,Qu,3,449820,232478,217342,121279,396003,200345,195658,88298,47232,41066,339404,174177,165227,22118,11069,11049,396435
108.735595886075942,34.299298924050632,6104,61,610404,μ,Weicheng,Qu,3,366099,187482,178617,96946,322575,161210,161365,73282,38510,34772,270910,138182,132728,21907,10790,11117,320437
108.934347123130024,34.280224792865354,6101,61,610102,³,Xincheng,Qu,3,526718,270443,256275,169711,485058,242275,242783,80314,41784,38530,398585,204950,193635,47819,23709,24110,436703
108.945518600079851,34.262611652732431,6101,61,610103,,Beilin,Qu,3,698755,371580,327175,195376,552440,274116,278324,89563,46337,43226,551755,296202,255553,57437,29041,28396,565341
108.96925294074822,34.269348474319521,6101,61,610104,,Lianhu,Qu,3,631224,322791,308433,199449,578500,288568,289932,97577,50300,47277,481876,246547,235329,51771,25944,25827,540970
108.961497526797956,34.282828890457196,6101,61,610112,δ,Weiyang,Qu,3,460416,239443,220973,126343,415550,209613,205937,82794,43324,39470,350578,183045,167533,27044,13074,13970,359483
108.953494128290501,34.243193202788049,6101,61,610113,,Yanta,Qu,3,795058,419559,375499,199340,558521,283029,275492,102226,53438,48788,659402,348825,310577,33430,17296,16134,550934
109.506535253164557,34.48933727848101,6105,61,610502,μ,Linwei,Qu,3,888866,451028,437838,228650,843458,422731,420727,217983,114729,103254,615451,311344,304107,55432,24955,30477,829700
107.165762341772151,34.366539683544303,6103,61,610302,μ,Weibin,Qu,3,328184,168170,160014,99585,296619,149644,146975,56277,30065,26212,252815,128003,124812,19092,10102,8990,284429
107.179963456735763,34.374289292308745,6103,61,610303,̨,Jintai,Qu,3,272193,140323,131870,87485,244845,122294,122551,44333,23211,21122,209046,107722,101324,18814,9390,9424,234492
109.030653524149656,34.290020036095797,6101,61,610111,,Baqiao,Qu,3,494084,254387,239697,135409,452810,229718,223092,99117,53325,45792,362402,185103,177299,32565,15959,16606,419339
109.221355402908884,34.395422172876103,6101,61,610115,,Lintong,Qu,3,639581,321939,317642,162854,627638,315671,311967,170192,89938,80254,428084,213058,215026,41305,18943,22362,616120
108.177178793155804,34.168098174725273,6101,61,610124,,Zhouzhi,County,3,597153,314299,282854,143585,589273,308972,280301,170822,96419,74403,394107,201928,192179,32224,15952,16272,581282
109.096206528285691,35.069269279100432,6102,61,610202,,Wangyi,Qu,3,190630,97702,92928,57727,183032,92145,90887,38748,19980,18768,137862,70396,67466,14020,7326,6694,175329
109.036612658885019,32.682583326336513,6109,61,610902,,Hanbin,Qu,3,843426,443270,400156,232411,812357,425928,386429,239049,130043,109006,553191,287415,265776,51186,25812,25374,792111
109.09395251331361,35.094965049782125,6102,61,610203,ӡ̨,Yintai,Qu,3,213627,113592,100035,60344,202142,103660,98482,51960,26722,25238,149964,80633,69331,11703,6237,5466,184774
107.02944454720047,33.070702233172256,6107,61,610702,̨,Hantai,Qu,3,503871,258142,245729,153172,456143,229634,226509,92737,48514,44223,376684,192472,184212,34450,17156,17294,450774
121.443406842321053,37.400459196429992,3706,37,370613,ɽ,Laishan,Qu,3,181963,93936,88027,54579,149135,74169,74966,27496,14073,13423,141140,74021,67119,13327,5842,7485,141558
121.252578735351562,37.498157501220703,3706,37,370611,ɽ,Fushan,Qu,3,355803,178882,176921,117182,330664,165279,165385,56941,29312,27629,271907,137683,134224,26955,11887,15068,294191
119.218246459960938,36.7781982421875,3707,37,370703,ͤ,Hanting,Qu,3,355945,180398,175547,106580,344018,172797,171221,67508,34965,32543,252475,129300,123175,35962,16133,19829,330629
117.840133666992188,36.795513153076172,3703,37,370306,ܴ,Zhoucun,Qu,3,327169,163373,163796,99214,303979,150017,153962,57938,29704,28234,243059,121996,121063,26172,11673,14499,281930
117.959457397460938,36.643424987792969,3703,37,370302,ʹ,Zichuan,Qu,3,697178,353626,343552,218039,649748,322180,327568,127378,66047,61331,511414,261220,250194,58386,26359,32027,583132
117.8551025390625,36.498359680175781,3703,37,370304,ɽ,Boshan,Qu,3,473653,236903,236750,156757,454739,225642,229097,82349,42656,39693,347718,174804,172914,43586,19443,24143,414774
120.431365966796875,36.128616333007812,3702,37,370212,ɽ,Laoshan,Qu,3,254625,128799,125826,69953,203307,100859,102448,38340,19672,18668,198965,101355,97610,17320,7772,9548,195644
117.437721252441406,35.076469421386719,3704,37,370406,ɽͤ,Shanting,Qu,3,443983,231971,212012,124277,441836,230457,211379,121597,67230,54367,287425,148001,139424,34961,16740,18221,433800
117.226028442382812,34.803730010986328,3704,37,370403,Ѧ,Xuecheng,Qu,3,454051,232828,221223,128882,433896,220849,213047,114315,62912,51403,306369,154563,151806,33367,15353,18014,403520
117.56744384765625,34.767459869384766,3704,37,370404,ỳ,Yicheng,Qu,3,339980,173519,166461,97046,334931,170788,164143,79972,43514,36458,233590,117763,115827,26418,12242,14176,322179
118.294143676757812,36.800827026367188,3703,37,370305,,Linzi,Qu,3,607189,307603,299586,189480,584354,292803,291551,113063,58870,54193,447077,227741,219336,47049,20992,26057,549111
121.38370843669037,37.535089795585684,3706,37,370602,֥,Zhifu,Qu,3,687639,346291,341348,214638,582288,287078,295210,96188,49449,46739,550516,278444,272072,40935,18398,22537,495357
120.735929655574637,37.929316991277489,3706,37,370634,,Changdao,County,3,52890,27601,25289,16686,47227,23498,23729,10611,5512,5099,38742,20550,18192,3537,1539,1998,41753
119.07328244526073,36.686937108974504,3707,37,370702,Ϋ,Weicheng,Qu,3,383189,192900,190289,112887,354323,177096,177227,67849,35543,32306,286584,144885,141699,28756,12472,16284,310345
119.130895749434302,36.700546092146801,3707,37,370705,,Kuiwen,Qu,3,384576,192580,191996,108766,324166,160528,163638,62445,32273,30172,301768,150969,150799,20363,9338,11025,291225
116.58278102368611,35.406122367365754,3708,37,370802,,Shizhong,Qu,3,400978,198804,202174,120835,361872,179425,182447,67378,35752,31626,309944,151932,158012,23656,11120,12536,322443
116.582830135204475,35.37442410270414,3708,37,370811,γ,Rencheng,Qu,3,649544,331518,318026,176027,618157,311694,306463,141803,76470,65333,458951,233542,225409,48790,21506,27284,597531
117.160746697719574,36.197474949885191,3709,37,370902,̩ɽ,Taishan,Qu,3,615720,308388,307332,173649,525467,261456,264011,97131,51144,45987,481291,240856,240435,37298,16388,20910,514262
117.108362569395652,36.190771834182904,3709,37,370903,,Daiyue,Qu,3,922491,466958,455533,282299,901043,453867,447176,172389,90016,82373,665956,340233,325723,84146,36709,47437,883364
122.108156128284435,37.506062873108583,3710,37,371002,,Huancui,Qu,3,609219,307867,301352,190579,517594,258007,259587,95637,48930,46707,475219,241389,233830,38363,17548,20815,410235
119.470561356700472,35.431551263610594,3711,37,371102,,Donggang,Qu,3,1148190,576050,572140,363485,1094888,549103,545785,226099,116875,109224,823139,412003,411136,98952,47172,51780,1016411
117.653587736397327,36.196015330664544,3712,37,371202,,Laicheng,Qu,3,998634,505150,493484,322299,957365,481275,476090,191096,100056,91040,723638,366806,356832,83900,38288,45612,931417
117.780320098157532,36.104876243991974,3712,37,371203,ֳ,Gangcheng,Qu,3,234891,121399,113492,75456,220663,111987,108676,43990,22902,21088,175760,91468,84292,15141,7029,8112,202277
118.341511521623019,35.072948394410112,3713,37,371302,ɽ,Lanshan,Qu,3,938159,479432,458727,262409,832993,422008,410985,206957,109944,97013,672463,341325,331138,58739,28163,30576,739858
118.327900416452721,34.990955096864162,3713,37,371311,ׯ,Luozhuang,Qu,3,412454,210897,201557,115176,383888,196917,186971,104510,57009,47501,279658,140643,139015,28286,13245,15041,352288
116.293944957806289,37.435961530731312,3714,37,371402,³,Decheng,Qu,3,552445,277994,274451,155651,496522,247918,248604,101884,52754,49130,421017,211017,210000,29544,14223,15321,460326
115.99367519291863,36.439667774142606,3715,37,371502,,Dongchangfu,Qu,3,950319,474976,475343,261746,892285,444544,447741,203346,107442,95904,682818,338763,344055,64155,28771,35384,850810
118.019623515718251,37.356847674461662,3716,37,371602,,Bincheng,Qu,3,600883,299952,300931,183160,567586,283331,284255,114509,59037,55472,442093,221269,220824,44281,19646,24635,496796
115.450199670839609,35.245253590014862,3717,37,371702,ĵ,Mudan,Qu,3,1280031,656790,623241,330488,1232160,628907,603253,303914,166458,137456,890105,452136,437969,86012,38196,47816,1183345
120.177714989868662,35.962184067506421,3702,37,370211,Ƶ,Huangdao,Qu,3,238405,122173,116232,66680,192716,96511,96205,37796,19447,18349,187093,96247,90846,13516,6479,7037,162361
120.38037633558649,36.30592929191139,3702,37,370214,,Chengyang,Qu,3,494007,231813,262194,141916,425070,210890,214180,81682,41791,39891,373127,172307,200820,39198,17715,21483,388589
118.055240249260692,36.787064180614529,3703,37,370303,ŵ,Zhangdian,Qu,3,712290,368333,343957,214262,628024,313864,314160,113841,58689,55152,552866,288777,264089,45583,20867,24716,560050
117.548746055330426,34.872646331787109,3704,37,370402,,Shizhong,Qu,3,482444,245117,237327,139109,462419,232935,229484,105716,56248,49468,347516,174856,172660,29212,14013,15199,389377
118.48552420255966,37.459727574667362,3705,37,370502,Ӫ,Dongying,Qu,3,568510,294582,273928,177060,504739,253246,251493,98880,51638,47242,442324,230042,212282,27306,12902,14404,406303
120.743690490722656,37.816036224365234,3706,37,370684,,Penglai,City,3,500408,252726,247682,174822,476881,238409,238472,83391,42724,40667,372040,190417,181623,44977,19585,25392,451216
117.386756896972656,37.775127410888672,3714,37,371423,,Qingyun,County,3,286427,146922,139505,80911,279428,142513,136915,64819,33782,31037,201778,103673,98105,19830,9467,10363,279531
117.601211547851562,37.740623474121094,3716,37,371623,,Wudi,County,3,423113,216110,207003,134265,413851,209935,203916,93978,49427,44551,292992,149112,143880,36143,17571,18572,399134
118.126358032226562,37.692401885986328,3716,37,371624,մ,Zhanhua,County,3,366178,184371,181807,115322,362864,182428,180436,84735,44250,40485,250101,126009,124092,31342,14112,17230,355117
116.78961181640625,37.638683319091797,3714,37,371422,,Ningjin,County,3,432880,218172,214708,125158,426207,214105,212102,92275,47926,44349,309664,156437,153227,30941,13809,17132,426089
117.576309204101562,37.640834808349609,3716,37,371622,,Yangxin,County,3,419591,211766,207825,118972,415312,209632,205680,89550,46016,43534,295522,150535,144987,34519,15215,19304,405921
118.539718627929688,37.590141296386719,3705,37,370521,,Kenli,County,3,242654,123651,119003,74610,232763,116598,116165,51549,26910,24639,174269,89217,85052,16836,7524,9312,189543
118.265174865722656,37.490512847900391,3705,37,370522,,Lijin,County,3,288832,145324,143508,86276,281069,140013,141056,64082,33251,30831,201370,101750,99620,23380,10323,13057,267148
117.503097534179688,37.479530334472656,3716,37,371621,,Huimin,County,3,604751,302532,302219,166987,597520,298790,298730,126361,65290,61071,425711,214090,211621,52679,23152,29527,588964
121.589332580566406,37.386127471923828,3706,37,370612,Ĳƽ,Muping,Qu,3,498999,252343,246656,179049,475932,238761,237171,83688,42636,41052,368509,188219,180290,46802,21488,25314,429603
120.388381958007812,37.352149963378906,3706,37,370685,Զ,Zhaoyuan,City,3,593705,297504,296201,201908,566883,281963,284920,110091,56602,53489,426883,216814,210069,56731,24088,32643,504930
116.572021484375,37.323318481445312,3714,37,371421,,Ling,County,3,529537,265576,263961,158753,506256,251572,254684,113196,57801,55395,378012,190476,187536,38329,17299,21030,516284
117.157546997070312,37.308677673339844,3701,37,370126,̺,Shanghe,County,3,574789,290620,284169,149108,560455,282459,277996,120979,62787,58192,407590,207314,200276,46220,20519,25701,562446
116.072929382324219,37.213150024414062,3714,37,371428,,Wucheng,County,3,361179,180833,180346,103215,347817,173201,174616,76603,39895,36708,257857,129312,128545,26719,11626,15093,348628
116.86323995152523,37.178615018289172,3714,37,371424,,Linyi,County,3,508213,256524,251689,136536,494509,247935,246574,104508,53536,50972,368495,187521,180974,35210,15467,19743,493127
117.81903076171875,37.164932250976562,3703,37,370322,,Gaoqing,County,3,351348,176381,174967,107836,346486,173364,173122,67914,34744,33170,252231,128418,123813,31203,13219,17984,336728
116.429069519042969,37.157733917236328,3714,37,371426,ƽԭ,Pingyuan,County,3,439701,219579,220122,128765,429489,213540,215949,89949,46114,43835,315207,158062,157145,34545,15403,19142,427323
118.121315002441406,37.126617431640625,3716,37,371625,,Boxing,County,3,462815,231577,231238,142001,454150,227367,226783,93365,48835,44530,330616,165650,164966,38834,17092,21742,438101
118.401100158691406,37.049800872802734,3705,37,370523,,Guangrao,County,3,472841,238753,234088,141803,462259,232247,230012,97105,51059,46046,336465,170655,165810,39271,17039,22232,448678
117.2130126953125,36.975330352783203,3701,37,370125,,Jiyang,County,3,518879,260865,258014,137761,505070,253047,252023,112295,58290,54005,361075,183389,177686,45509,19186,26323,505383
118.109817504882812,36.953292846679688,3703,37,370321,̨,Huantai,County,3,474908,233098,241810,142545,465710,227523,238187,93983,49269,44714,335583,164265,171318,45342,19564,25778,442559
116.007545471191406,36.95318603515625,3714,37,371427,Ľ,Xiajin,County,3,479817,239184,240633,142248,466999,231851,235148,94696,48412,46284,347423,173644,173779,37698,17128,20570,468163
117.726516723632812,36.885692596435547,3716,37,371626,ƽ,Zouping,County,3,686590,342701,343889,200939,667298,333820,333478,137241,71014,66227,491006,247220,243786,58343,24467,33876,649542
116.231582641601562,36.861186981201172,3715,37,371526,,Gaotang,County,3,456464,228062,228402,134198,443638,219781,223857,92609,47777,44832,325529,163029,162500,38326,17256,21070,426264
116.738014221191406,36.800457000732422,3714,37,371425,,Qihe,County,3,593341,299626,293715,163339,582510,292193,290317,124505,64002,60503,417508,212602,204906,51328,23022,28306,581849
118.831451416015625,36.709579467773438,3707,37,370725,,Changle,County,3,593009,299679,293330,167268,577650,290943,286707,129204,67774,61430,414794,210500,204294,49011,21405,27606,560678
116.252410888671875,36.585163116455078,3715,37,371523,ƽ,Chiping,County,3,546125,271591,274534,162216,533208,264453,268755,125287,64706,60581,374360,185629,188731,46478,21256,25222,525956
116.718452453613281,36.554424285888672,3701,37,370123,,Changqing,County,3,506579,254075,252504,150387,497107,249573,247534,101536,53048,48488,360749,181368,179381,44294,19659,24635,485003
118.542770385742188,36.511245727539062,3707,37,370724,,Linqu,County,3,869470,444727,424743,232677,847744,431267,416477,205399,110962,94437,598658,303118,295540,65413,30647,34766,829897
115.451339721679688,36.487083435058594,3715,37,371525,,Guan,County,3,707137,354200,352937,198965,691894,345756,346138,161601,85384,76217,494137,245410,248727,51399,23406,27993,694930
116.241607666015625,36.331764221191406,3715,37,371524,,Donga,County,3,413735,206997,206738,117436,406777,202788,203989,90815,47635,43180,285571,142923,142648,37349,16439,20910,397657
116.450851440429688,36.286933898925781,3701,37,370124,ƽ,Pingyin,County,3,344386,171590,172796,102734,337580,167604,169976,75225,39121,36104,237756,118597,119159,31405,13872,17533,324386
115.67559814453125,36.237743377685547,3715,37,371522,ݷ,Shen,County,3,921225,464317,456908,250751,897217,449935,447282,219817,117342,102475,632833,315723,317110,68575,31252,37323,900117
118.162460327148438,36.185054779052734,3703,37,370323,Դ,Yiyuan,County,3,540695,273176,267519,182143,524136,264548,259588,116132,60627,55505,383835,193137,190698,40728,19412,21316,514170
115.783058166503906,36.117542266845703,3715,37,371521,,Yanggu,County,3,722863,362473,360390,200474,702386,350914,351472,164124,87920,76204,499743,248378,251365,58996,26175,32821,699722
116.518379211425781,35.937091827392578,3709,37,370923,ƽ,Dongping,County,3,725877,363736,362141,197997,705507,351023,354484,157067,82328,74739,501099,251758,249341,67711,29650,38061,702089
116.093185424804688,35.803310394287109,3708,37,370832,ɽ,Liangshan,County,3,675392,339852,335540,184648,670078,336468,333610,159528,84155,75373,460908,230315,230593,54956,25382,29574,661827
118.631134033203125,35.787837982177734,3713,37,371323,ˮ,Yishui,County,3,1057758,534088,523670,343112,1036824,523822,513002,241919,124830,117089,728934,368880,360054,86905,40378,46527,1022969
116.789291381835938,35.761489868164062,3709,37,370921,,Ningyang,County,3,777546,395681,381865,220090,771078,391389,379689,172287,90787,81500,548446,280050,268396,56813,24844,31969,745459
119.21929931640625,35.753635406494141,3711,37,371121,,Wulian,County,3,503219,256231,246988,169679,487633,247432,240201,98189,50866,47323,356752,182064,174688,48278,23301,24977,466104
116.489913940429688,35.726947784423828,3708,37,370830,,Wenshang,County,3,702095,357251,344844,183319,692450,351173,341277,174413,95567,78846,477084,239583,237501,50598,22101,28497,686424
117.929108934779137,35.713501928135138,3713,37,371328,,Mengyin,County,3,535070,272403,262667,163287,503453,255186,248267,123885,65680,58205,373822,189532,184290,37363,17191,20172,515935
117.271324157714844,35.660743713378906,3708,37,370831,ˮ,Sishui,County,3,552028,283678,268350,170439,543324,277999,265325,117267,62091,55176,389492,200377,189115,45269,21210,24059,537243
115.940826416015625,35.604480743408203,3717,37,371725,۩,Yuncheng,County,3,1025800,519545,506255,302623,1006488,508341,498147,242942,133584,109358,690571,344550,346021,92287,41411,50876,992700
118.840003967285156,35.582687377929688,3711,37,371122,,Juxian,County,3,1034519,518238,516281,343629,1015464,507237,508227,243386,127123,116263,701552,349709,351843,89581,41406,48175,995670
115.508689880371094,35.577007293701172,3717,37,371726,۲,Juancheng,County,3,715684,365585,350099,203872,709732,362024,347708,167021,91191,75830,497398,251595,245803,51265,22799,28466,699243
118.461380004882812,35.553859710693359,3713,37,371321,,Yinan,County,3,869535,440298,429237,286570,846348,427179,419169,199191,102947,96244,596111,302613,293498,74233,34738,39495,841839
117.6158447265625,35.506690979003906,3713,37,371326,ƽ,Pingyi,County,3,974213,507510,466703,286468,922147,475372,446775,234162,126930,107232,670300,347999,322301,69751,32581,37170,940374
116.342979431152344,35.400688171386719,3708,37,370829,,Jiaxiang,County,3,761086,389751,371335,206183,740390,376382,364008,194200,105385,88815,506394,256533,249861,60492,27833,32659,740601
116.088706970214844,35.396209716796875,3717,37,371724,Ұ,Juye,County,3,839438,423590,415848,247221,832504,419276,413228,211930,113910,98020,559223,278989,280234,68285,30691,37594,819413
115.095046997070312,35.306758880615234,3717,37,371728,,Dongming,County,3,691206,354755,336451,172305,669549,342117,327432,165784,89896,75888,481024,244950,236074,44398,19909,24489,670329
117.966224670410156,35.265209197998047,3713,37,371325,,Fei,County,3,904696,464868,439828,270810,890870,457728,433142,222949,118297,104652,607379,311055,296324,74368,35516,38852,882634
118.837051391601562,35.181484222412109,3713,37,371327,,Junan,County,3,964591,488018,476573,321899,950841,481410,469431,224221,117854,106367,657501,330492,327009,82869,39672,43197,936402
115.570976257324219,35.076896667480469,3717,37,371727,,Dingtao,County,3,563352,285086,278266,159501,557450,281900,275550,137891,74174,63717,378777,190594,188183,46684,20318,26366,551408
116.308517456054688,35.064971923828125,3708,37,370828,,Jinxiang,County,3,602555,302999,299556,163930,583247,293034,290213,144620,76644,67976,406269,203590,202679,51666,22765,28901,572886
116.653327941894531,35.00213623046875,3708,37,370827,̨,Yutai,County,3,426172,215996,210176,106996,416719,210472,206247,110001,59927,50074,281436,140968,140468,34735,15101,19634,411525
115.875175476074219,34.962230682373047,3717,37,371723,,Chengwu,County,3,596339,298944,297395,169581,582542,291028,291514,140062,73855,66207,406997,203379,203618,49280,21710,27570,582756
118.651710510253906,34.925678253173828,3713,37,371329,,Linshu,County,3,597850,303897,293953,196609,590756,300002,290754,139063,73599,65464,409278,207411,201867,49509,22887,26622,572843
118.042564392089844,34.852649688720703,3713,37,371324,ɽ,Cangshan,County,3,1128161,579579,548582,322452,1110832,568853,541979,277780,147835,129945,759211,389261,369950,91170,42483,48687,1101514
115.537269592285156,34.831222534179688,3717,37,371721,,Cao,County,3,1335422,677163,658259,350797,1321303,668998,652305,331083,177375,153708,898948,453008,445940,105391,46780,58611,1310105
117.113312555400015,34.813427382887113,3708,37,370826,΢ɽ,Weishan,County,3,645728,339356,306372,169217,624468,320119,304349,165450,91407,74043,432832,226055,206777,47446,21894,25552,615279
116.086524963378906,34.798629760742188,3717,37,371722,,Dan,County,3,1050701,527641,523060,291034,1038027,521160,516867,253325,136238,117087,708779,353102,355677,88597,38301,50296,1028177
118.342437744140625,34.618934631347656,3713,37,371322,۰,Tancheng,County,3,972268,495528,476740,268265,934578,472990,461588,247322,131330,115992,650232,331521,318711,74714,32677,42037,946734
118.540657043457031,37.892524719238281,3705,37,370503,ӿ,Hekou,Qu,3,220334,112659,107675,71747,208805,104874,103931,43587,22562,21025,167105,85314,81791,9642,4783,4859,174206
117.215094399070054,37.728627824019014,3714,37,371481,,Leling,City,3,615833,313642,302191,162327,579820,291884,287936,131813,68495,63318,440021,224014,216007,43999,21133,22866,605972
120.32501220703125,37.655281066894531,3706,37,370681,,Longkou,City,3,671335,337507,333828,214274,628645,312351,316294,120707,61677,59030,496443,252527,243916,54185,23303,30882,559799
120.822113037109375,37.296070098876953,3706,37,370686,ϼ,Xixia,City,3,651357,331148,320209,228191,635853,321987,313866,121193,62509,58684,468707,240630,228077,61457,28009,33448,607776
122.056686401367188,37.197853088378906,3710,37,371081,ĵ,Wendeng,City,3,675061,335330,339731,248537,639128,320801,318327,110710,56301,54409,487650,242387,245263,76701,36642,40059,579148
119.947158813476562,37.173500061035156,3706,37,370683,,Laizhou,City,3,889361,450192,439169,297214,860018,430533,429485,156098,79867,76231,635485,326828,308657,97778,43497,54281,787003
122.408943176269531,37.171340942382812,3710,37,371082,ٳ,Rongcheng,City,3,732147,368156,363991,264747,681634,341233,340401,123004,62752,60252,533745,271106,262639,75398,34298,41100,617378
120.704338073730469,36.974910736083984,3706,37,370682,,Laiyang,City,3,897681,453293,444388,278934,855542,433753,421789,166506,88475,78031,651524,328564,322960,79651,36254,43397,830393
116.622154235839844,36.930240631103516,3714,37,371482,,Yucheng,City,3,494301,248103,246198,135226,467910,232243,235667,101272,51483,49789,353714,178675,175039,39315,17945,21370,476778
121.514778137207031,36.912570953369141,3710,37,371083,ɽ,Rushan,City,3,580326,291047,289279,219009,563304,283821,279483,95061,48305,46756,420645,212392,208253,64620,30350,34270,526103
118.734519958496094,36.878204345703125,3707,37,370783,ٹ,Shouguang,City,3,1081991,548020,533971,314134,1040638,522578,518060,223221,118515,104706,764968,388875,376093,93802,40630,53172,994794
120.5164794921875,36.858051300048828,3702,37,370285,,Laixi,City,3,728796,366400,362396,234354,691874,349164,342710,135264,70762,64502,523301,263735,259566,70231,31903,38328,659506
119.391998291015625,36.860458374023438,3707,37,370786,,Changyi,City,3,683182,340763,342419,208639,672982,335742,337240,135898,70685,65213,476118,239339,236779,71166,30739,40427,638602
115.716636657714844,36.854354858398438,3715,37,371581,,Linqing,City,3,694247,348411,345836,191706,665227,332900,332327,155891,81932,73959,491414,245559,245855,46942,20920,26022,661105
119.950584411621094,36.778434753417969,3702,37,370283,ƽ,Pingdu,City,3,1321975,670685,651290,420372,1290219,652578,637641,265527,138769,126758,920936,470947,449989,135512,60969,74543,1235772
121.159934997558594,36.776786804199219,3706,37,370687,,Haiyang,City,3,654594,329202,325392,242802,642369,323003,319366,114539,58538,56001,471752,238798,232954,68303,31866,36437,610528
117.525978088378906,36.712390899658203,3701,37,370181,,Zhangqiu,City,3,977324,485925,491399,288388,960028,474174,485854,197819,103149,94670,693925,347411,346514,85580,35365,50215,931073
118.478958129882812,36.696533203125,3707,37,370781,,Qingzhou,City,3,894468,450090,444378,253894,874876,440462,434414,195798,103623,92175,624335,313572,310763,74335,32895,41440,835104
119.195777893066406,36.429946899414062,3707,37,370784,,Anqiu,City,3,1096782,554403,542379,306278,1079927,545317,534610,249525,134127,115398,755797,379455,376342,91460,40821,50639,1040758
119.756019592285156,36.384830474853516,3707,37,370785,,Gaomi,City,3,842403,420956,421447,249021,827344,414320,413024,165154,85834,79320,594416,298198,296218,82833,36924,45909,786312
120.462379455566406,36.3876953125,3702,37,370282,ī,Jimo,City,3,1111202,553261,557941,345109,1042347,523421,518926,199059,102549,96510,812264,404722,407542,99879,45990,53889,980593
120.006507873535156,36.282470703125,3702,37,370281,,Jiaozhou,City,3,783478,388207,395271,238420,746327,373316,373011,149061,77716,71345,562397,277470,284927,72020,33021,38999,690996
116.760421752929688,36.188934326171875,3709,37,370983,ʳ,Feicheng,City,3,948602,476032,472570,273524,923805,460350,463455,199639,103593,96046,680235,344012,336223,68728,28427,40301,894383
119.419914245605469,36.000850677490234,3707,37,370782,,Zhucheng,City,3,1053695,531390,522305,301403,1022693,515489,507204,221546,117030,104516,737664,370646,367018,94485,43714,50771,981963
117.752899169921875,35.905452728271484,3709,37,370982,̩,Xintai,City,3,1344395,687569,656826,398103,1291651,652581,639070,278908,146969,131939,975900,499034,476866,89587,41566,48021,1272796
119.972915649414062,35.878448486328125,3702,37,370284,,Jiaonan,City,3,827771,419331,408440,257608,792505,401015,391490,156483,81243,75240,587049,298125,288924,84239,39963,44276,735080
116.972404479980469,35.598854064941406,3708,37,370881,,Qufu,City,3,625313,317685,307628,167869,585368,296286,289082,128903,68452,60451,449420,228671,220749,46990,20562,26428,592442
116.82733154296875,35.553787231445312,3708,37,370882,,Yanzhou,City,3,598387,303581,294806,172435,575450,288392,287058,124350,66042,58308,428491,217732,210759,45546,19807,25739,535427
116.942100524902344,35.403820037841797,3708,37,370883,޳,Zoucheng,City,3,1101003,571761,529242,312183,1045952,534187,511765,259035,139002,120033,762473,395632,366841,79495,37127,42368,1031400
117.139808654785156,35.087684631347656,3704,37,370481,,Tengzhou,City,3,1548817,811999,736818,419242,1505564,780634,724930,393684,226509,167175,1044732,534953,509779,110401,50537,59864,1439510
117.024906009180597,36.659781201687352,3701,37,370102,,Lixia,Qu,3,582520,302819,279701,145867,418621,205858,212763,70464,36155,34309,473266,248391,224875,38790,18273,20517,447281
116.992966113038719,36.647551433351985,3701,37,370103,,Shizhong,Qu,3,572141,289628,282513,170555,496239,243389,252850,87723,45538,42185,439208,223889,215319,45210,20201,25009,423778
116.956677307998291,36.647911999382039,3701,37,370104,,Huaiyin,Qu,3,396846,203421,193425,115881,347778,171709,176069,60470,31309,29161,304406,157773,146633,31970,14339,17631,289195
116.978541851399285,36.674173898908876,3701,37,370105,,Tianqiao,Qu,3,570296,291448,278848,172466,511180,253902,257278,86305,44420,41885,438157,226478,211679,45834,20550,25284,402158
117.084924465335817,36.706451676404548,3701,37,370112,,Licheng,Qu,3,878131,451751,426380,251639,803286,403578,399708,149053,78336,70717,661692,343570,318122,67386,29845,37541,759040
120.350985016326206,36.098582014615317,3702,37,370205,ķ,Sifang,Qu,3,429389,219784,209605,133531,372869,186044,186825,53412,27546,25866,333969,173187,160782,42008,19051,22957,291670
120.349455399289099,36.082425425503423,3702,37,370203,б,Shibei,Qu,3,504213,254296,249917,166890,461495,226541,234954,63815,32705,31110,385804,197573,188231,54594,24018,30576,331251
120.387424639745561,36.126918637768227,3702,37,370213,,Licang,Qu,3,352801,177339,175462,108641,308421,152923,155498,50140,25879,24261,273764,138479,135285,28897,12981,15916,235075
120.359385708690795,36.072833759909855,3702,37,370202,,Shinan,Qu,3,447532,225323,222209,143524,394000,190801,203199,56883,28970,27913,346752,176785,169967,43897,19568,24329,299387
117.735683632733711,34.567184392698579,3704,37,370405,̨ׯ,Taierzhuang,Qu,3,276340,141755,134585,79940,273786,140147,133639,69146,37803,31343,185357,93801,91556,21837,10151,11686,258973
119.156832361041381,36.600912266281412,3707,37,370704,,Fangzi,Qu,3,256590,130842,125748,75492,249037,125519,123518,50656,26756,23900,183636,94303,89333,22298,9783,12515,225266
118.386026616742015,35.074397243020663,3713,37,371312,Ӷ,Hedong,Qu,3,587897,298611,289286,177043,575701,291758,283943,143322,76245,67077,395594,198977,196617,48981,23389,25592,563616
121.389892578125,31.627645492553711,3102,31,310230,,Chongming,County,3,649812,314215,335597,248003,632628,304828,327800,97690,49888,47802,462311,224938,237373,89811,39389,50422,542186
121.487335205078125,31.407932281494141,3101,31,310113,ɽ,Baoshan,Qu,3,1227978,655955,572023,401849,1090021,555975,534046,157295,82528,74767,958184,522085,436099,112499,51342,61157,692771
121.2490234375,31.385845184326172,3101,31,310114,ζ,Jiading,Qu,3,753070,388178,364892,241343,676486,341169,335317,90224,47342,42882,587935,307869,280066,74911,32967,41944,418067
121.107757568359375,31.144771575927734,3101,31,310118,,Qingpu,Qu,3,595863,304023,291840,175840,526445,261985,264460,78973,40676,38297,462880,239583,223297,54010,23764,30246,413812
121.366569519042969,31.115299224853516,3101,31,310112,,Minxing,Qu,3,1217309,643371,573938,378325,1023181,519309,503872,140852,74367,66485,972089,521122,450967,104368,47882,56486,585352
121.751899719238281,31.055320739746094,3102,31,310225,ϻ,Nanhui,County,3,785102,392536,392566,272708,733460,362271,371189,115475,59060,56415,589729,299658,290071,79898,33818,46080,615751
121.227638244628906,31.016811370849609,3101,31,310117,ɽ,Songjiang,Qu,3,641156,327695,313461,196439,580842,291195,289647,88519,46254,42265,490628,253816,236812,62009,27625,34384,437064
121.447952270507812,30.924777984619141,3102,31,310226,,Fengxian,County,3,624285,309237,315048,206435,569940,281528,288412,84764,43703,41061,480103,240061,240042,59418,25473,33945,434367
121.328605651855469,30.727006912231445,3101,31,310116,ɽ,Jinshan,Qu,3,580377,291568,288809,174640,549866,272506,277360,82730,42195,40535,439658,223915,215743,57989,25458,32531,478898
121.504974192622214,31.240482223202115,3101,31,310115,ֶ,Pudongxin,Qu,3,2402343,1244664,1157679,760757,2125311,1066801,1058510,295549,153591,141958,1862176,982409,879767,244618,108664,135954,1418319
121.473971546461115,31.237751188269971,3101,31,310101,,Huangpu,Qu,3,188743,96048,92695,61870,176114,85870,90244,20910,10790,10120,133569,70731,62838,34264,14527,19737,153496
121.449499195326638,31.229285077607233,3101,31,310106,,Jingan,Qu,3,305329,152550,152779,99827,283952,137605,146347,32488,16635,15853,218794,112588,106206,54047,23327,30720,236109
121.423307165463797,31.21433710096834,3101,31,310105,,Changning,Qu,3,702239,360757,341482,228413,627060,310963,316097,78575,40500,38075,534227,279274,254953,89437,40983,48454,472962
121.390004925474059,31.24291022445508,3101,31,310107,,Putuo,Qu,3,1051672,546532,505140,342421,950658,479566,471092,117211,60841,56370,807384,428324,379060,127077,57367,69710,685775
121.441055304070559,31.192457315368699,3101,31,310104,,Xuhui,Qu,3,1064645,546034,518611,337519,929519,462176,467343,114303,59349,54954,819894,426648,393246,130448,60037,70411,691750
121.454891618546981,31.270108209249425,3101,31,310108,բ,Zhabei,Qu,3,798620,409056,389564,263145,745462,373865,371597,96563,49832,46731,596134,311694,284440,105923,47530,58393,557514
121.486941071739864,31.2673959052015,3101,31,310109,,Hongkou,Qu,3,860726,440023,420703,281206,796688,394106,402582,98620,50821,47799,638551,334517,304034,123555,54685,68870,620395
121.525030209195691,31.273836176471136,3101,31,310110,,Yangpu,Qu,3,1243757,647301,596456,391272,1096294,548009,548285,138184,71097,67087,950441,506006,444435,155132,70198,84934,885859
121.488792310537818,31.216578128361679,3101,31,310102,,Nanshi,Qu,3,385790,195241,190549,129845,366482,181227,185255,45740,23350,22390,276077,144929,131148,63973,26962,37011,291645
121.470121388346612,31.212541172212227,3101,31,310103,¬,Luwan,Qu,3,328918,165278,163640,107211,306816,150281,156535,36264,18910,17354,235725,121752,113973,56929,24616,32313,248742
112.566883453231299,37.809674726190472,1401,14,140105,С,Xiaodian,Qu,3,491250,249805,241445,124206,400126,201174,198952,88410,45019,43391,376073,190789,185284,26767,13997,12770,355281
112.557590642006815,37.853994287414963,1401,14,140106,ӭ,Yingze,Qu,3,470917,237218,233699,139828,424152,210609,213543,75042,38377,36665,357119,179202,177917,38756,19639,19117,313048
112.575461432823133,37.883778938775507,1401,14,140107,ӻ,Xinghualing,Qu,3,520702,265509,255193,161153,494846,248612,246234,87782,44997,42785,386238,196847,189391,46682,23665,23017,357132
112.535669138605442,37.909512877551016,1401,14,140108,ƺ,Jiancaoping,Qu,3,338417,177399,161018,94342,302496,155077,147419,60550,31314,29236,255255,134071,121184,22612,12014,10598,260387
112.510650031462589,37.864955039115642,1401,14,140109,,Wanbailin,Qu,3,556931,299508,257423,156802,485851,248870,236981,97021,50334,46687,427462,231372,196090,32448,17802,14646,378256
112.484916092687087,37.802288132653061,1401,14,140110,Դ,Jinyuan,Qu,3,180165,91777,88388,46859,168923,85384,83539,41273,20680,20593,126915,65066,61849,11977,6031,5946,159921
113.28463399234694,40.050615510204082,1402,14,140202,,Chengqu,Qu,3,537598,268243,269355,177291,515799,257142,258657,101545,52870,48675,403250,198330,204920,32803,17043,15760,350628
113.210219834183675,40.057489107142857,1402,14,140203,,Kuangqu,Qu,3,460714,237585,223129,143100,453638,233031,220607,88757,47351,41406,349180,177549,171631,22777,12685,10092,326180
113.132937654761903,36.174076095238092,1404,14,140402,,Cheng,Qu,3,361508,182062,179446,97384,323451,161587,161864,66548,33920,32628,278237,139794,138443,16723,8348,8375,271736
114.073677062988281,40.413215637207031,1402,14,140222,,Tianzhen,County,3,187832,95545,92287,53125,187708,95430,92278,55274,28123,27151,119320,60646,58674,13238,6776,6462,168778
113.751449584960938,40.360786437988281,1402,14,140221,,Yanggao,County,3,262565,134091,128474,75276,262052,133709,128343,75177,38244,36933,165663,84968,80695,21725,10879,10846,237545
113.152687072753906,40.262310028076172,1402,14,140212,,Xinrong,Qu,3,105915,56343,49572,31692,103275,53756,49519,27932,14416,13516,71228,38263,32965,6755,3664,3091,71523
113.597671508789062,40.042335510253906,1402,14,140227,ͬ,Datong,County,3,162977,85767,77210,47983,160727,83753,76974,43746,23266,20480,106668,55848,50820,12563,6653,5910,120319
112.692283630371094,40.001655578613281,1402,14,140226,,Zuoyun,County,3,163366,88233,75133,45664,157651,82808,74843,45742,23552,22190,109351,60289,49062,8273,4392,3881,106758
112.457382202148438,39.984413146972656,1406,14,140623,,Youyu,County,3,105143,54515,50628,28212,104134,53670,50464,28728,14671,14057,68600,35731,32869,7815,4113,3702,81890
113.103851318359375,39.8304443359375,1406,14,140624,,Huairen,County,3,286054,150457,135597,77693,278392,144567,133825,80231,43569,36662,188860,98063,90797,16963,8825,8138,219002
114.272193908691406,39.76226806640625,1402,14,140223,,Guangling,County,3,162548,85683,76865,45933,161900,85130,76770,46307,24135,22172,104775,55387,49388,11466,6161,5305,146178
113.683609008789062,39.692470550537109,1402,14,140225,Դ,Hunyuan,County,3,325763,165826,159937,87897,322939,164357,158582,93133,47001,46132,209146,107046,102100,23484,11779,11705,306821
113.187538146972656,39.563392639160156,1406,14,140622,Ӧ,Yingxian,County,3,279483,145102,134381,73861,276913,143286,133627,77480,41620,35860,180335,92024,88311,21668,11458,10210,242304
112.822669982910156,39.515499114990234,1406,14,140621,ɽ,Shanyin,County,3,217299,112351,104948,58268,215829,111206,104623,62286,32798,29488,138916,71254,67662,16097,8299,7798,188230
111.497276306152344,39.442062377929688,1409,14,140932,ƫ,Pianguan,County,3,112324,59690,52634,31246,109289,56920,52369,32608,16925,15683,71277,38361,32916,8439,4404,4035,97405
114.224067687988281,39.442253112792969,1402,14,140224,,Lingqiu,County,3,209713,109842,99871,60219,208020,108356,99664,60655,31369,29286,134092,70698,63394,14966,7775,7191,194511
111.142082214355469,39.387954711914062,1409,14,140930,,Hequ,County,3,138811,73031,65780,39165,137806,72254,65552,36868,19605,17263,89789,47192,42597,12154,6234,5920,124521
113.260215759277344,39.185554504394531,1409,14,140924,,Fanzhi,County,3,241938,128376,113562,63960,238858,125684,113174,65655,34480,31175,158726,84706,74020,17557,9190,8367,214452
112.196022033691406,39.084381103515625,1409,14,140927,,Shenchi,County,3,103990,55692,48298,29561,101996,54008,47988,25341,13140,12201,71058,38602,32456,7591,3950,3641,91259
112.948402404785156,39.058456420898438,1409,14,140923,,Daixian,County,3,203311,105917,97394,58288,202093,104818,97275,48590,24708,23882,136496,72322,64174,18225,8887,9338,188771
111.089332580566406,39.019077301025391,1409,14,140931,,Baode,County,3,146995,76873,70122,38252,145494,75472,70022,48583,24886,23697,89297,47260,42037,9115,4727,4388,132475
112.303497314453125,38.998031616210938,1409,14,140925,,Ningwu,County,3,152938,83005,69933,41318,150538,80890,69648,40592,21323,19269,102284,56457,45827,10062,5225,4837,130372
111.838386535644531,38.905719757080078,1409,14,140928,կ,Wuzhai,County,3,108651,56888,51763,32150,105755,55682,50073,28090,14753,13337,72676,38141,34535,7885,3994,3891,93257
112.705787658691406,38.726245880126953,1409,14,140981,ԭƽ,Yuanping,City,3,471853,244751,227102,137089,463264,238260,225004,112864,57646,55218,317247,167223,150024,41742,19882,21860,417436
113.255989074707031,38.720466613769531,1409,14,140922,̨,Wutai,County,3,313321,162640,150681,83467,309500,160016,149484,78131,40223,37908,207080,108919,98161,28110,13498,14612,291454
111.567626953125,38.700580596923828,1409,14,140929,,Kelan,County,3,80760,43253,37507,22015,80412,42951,37461,22547,11475,11072,52866,28870,23996,5347,2908,2439,74606
112.957420349121094,38.497238159179688,1409,14,140921,,Dingxiang,County,3,211104,108447,102657,59830,210137,107861,102276,49942,25594,24348,141487,73736,67751,19675,9117,10558,193175
111.130226135253906,38.470073699951172,1423,14,142325,,Xingxian,County,3,259451,134791,124660,65877,259218,134598,124620,83462,43191,40271,161157,83842,77315,14832,7758,7074,245651
111.935577392578125,38.352474212646484,1409,14,140926,,Jingle,County,3,155740,84355,71385,39065,155305,83998,71307,42212,22114,20098,102622,56534,46088,10906,5707,5199,148433
111.678192138671875,38.280082702636719,1423,14,142329,,Lanxian,County,3,163897,86592,77305,39583,163655,86375,77280,50176,26022,24154,104519,55633,48886,9202,4937,4265,155078
113.408424377441406,38.088356018066406,1403,14,140322,,Yuxian,County,3,294176,153689,140487,80808,288733,148796,139937,79411,41397,38014,192132,100733,91399,22633,11559,11074,269828
111.785003662109375,38.066902160644531,1401,14,140123,¦,Loufan,County,3,109412,58302,51110,27799,107777,56833,50944,33014,17136,15878,69226,37441,31785,7172,3725,3447,92715
112.660690307617188,38.070461273193359,1401,14,140122,,Yangqu,County,3,142109,74361,67748,40026,140922,73371,67551,35858,18277,17581,94156,49571,44585,12095,6513,5582,127384
110.987007141113281,37.960670471191406,1423,14,142326,,Linxian,County,3,553440,289772,263668,142979,552723,289245,263478,182012,95618,86394,341019,178518,162501,30409,15636,14773,545652
113.168708801269531,37.891983032226562,1407,14,140725,,Shouyang,County,3,210184,112683,97501,64073,204131,107703,96428,43790,22652,21138,146512,79102,67410,19882,10929,8953,183190
111.238090515136719,37.887744903564453,1423,14,142330,ɽ,Fangshan,County,3,135598,71647,63951,34092,135133,71281,63852,43898,22980,20918,84509,44866,39643,7191,3801,3390,131485
113.620964050292969,37.7994384765625,1403,14,140321,ƽ,Pingding,County,3,323633,168106,155527,93036,318084,164518,153566,76160,41060,35100,226444,117199,109245,21029,9847,11182,288972
112.337066650390625,37.6092529296875,1401,14,140121,,Qingxu,County,3,328787,177429,151358,77800,297786,150864,146922,85176,43575,41601,223242,124163,99079,20369,9691,10678,279556
113.696800231933594,37.608364105224609,1407,14,140724,,Xiyang,County,3,221361,116268,105093,73008,218907,114351,104556,46597,24956,21641,156412,82352,74060,18352,8960,9392,205272
112.160064697265625,37.551998138427734,1423,14,142323,,Jiaocheng,County,3,207404,107523,99881,53259,204397,104961,99436,60191,31314,28877,133948,69767,64181,13265,6442,6823,194788
111.139724731445312,37.507831573486328,1423,14,142302,ʯ,Lishi,City,3,235678,121253,114425,59679,217488,112212,105276,68547,35934,32613,156846,79938,76908,10285,5381,4904,208329
112.030258178710938,37.438499450683594,1423,14,142322,ˮ,Wenshui,County,3,401641,203482,198159,101758,399559,202109,197450,121180,61934,59246,252897,128613,124284,27564,12935,14629,388184
110.885116577148438,37.430179595947266,1423,14,142327,,Liulin,County,3,282840,147811,135029,69713,280264,145509,134755,96638,50689,45949,171230,89469,81761,14972,7653,7319,264807
112.552764892578125,37.425506591796875,1407,14,140726,̫,Taigu,County,3,285807,146764,139043,79301,266444,135389,131055,60470,31370,29100,205442,105364,100078,19895,10030,9865,255459
112.312049865722656,37.353168487548828,1407,14,140727,,Qixian,County,3,253829,132415,121414,71221,246193,126119,120074,60472,31635,28837,174742,91630,83112,18615,9150,9465,225818
111.188125610351562,37.339595794677734,1423,14,142332,,Zhongyang,County,3,131812,69662,62150,33261,130812,68729,62083,44313,23714,20599,80637,42267,38370,6862,3681,3181,127007
113.566879272460938,37.3314208984375,1407,14,140723,˳,Heshun,County,3,134522,71268,63254,38925,131221,68729,62492,30498,15771,14727,95000,50571,44429,9024,4926,4098,120059
111.785102844238281,37.269474029541016,1423,14,142303,,Fenyang,City,3,387046,199129,187917,102129,376274,192180,184094,110765,57861,52904,251014,129041,121973,25267,12227,13040,365967
112.185935974121094,37.208778381347656,1407,14,140728,ƽң,Pingyao,County,3,477373,245428,231945,128371,472990,242441,230549,132951,70771,62180,309171,158212,150959,35251,16445,18806,453223
111.782768249511719,37.143234252929688,1423,14,142301,"Т
",Xiaoyi,City,3,414154,215941,198213,106964,402904,206762,196142,121941,64006,57935,267006,139567,127439,25207,12368,12839,377029
113.365509033203125,37.079479217529297,1407,14,140722,Ȩ,Zuoquan,County,3,156203,83163,73040,44252,148512,77712,70800,35660,18634,17026,111731,59927,51804,8812,4602,4210,140993
112.964309692382812,37.076789855957031,1407,14,140721,,Yushe,County,3,126173,66701,59472,37547,124473,65583,58890,35455,18531,16924,82696,44050,38646,8022,4120,3902,110356
111.925819396972656,37.033302307128906,1407,14,140781,,Jiexiu,City,3,372993,190675,182318,108628,368531,187469,181062,97352,50948,46404,252371,128736,123635,23270,10991,12279,340502
110.819839477539062,36.998741149902344,1423,14,142328,ʯ¥,Shilou,County,3,101858,53175,48683,24438,101733,53065,48668,35427,18504,16923,61791,32076,29715,4640,2595,2045,100405
111.199752807617188,36.959716796875,1423,14,142333,,Jiaokou,County,3,107461,57360,50101,26722,104486,54676,49810,32057,16801,15256,68707,37082,31625,6697,3477,3220,99837
111.77166748046875,36.848979949951172,1407,14,140729,ʯ,Lingshi,County,3,243734,130805,112929,67776,231168,119427,111741,61926,32711,29215,166908,90804,76104,14900,7290,7610,200018
112.863258361816406,36.836799621582031,1404,14,140429,,Wuxiang,County,3,196097,104791,91306,52487,191855,101500,90355,50406,26066,24340,131598,71724,59874,14093,7001,7092,186303
110.625137329101562,36.764492034912109,1410,14,141032,,Yonghe,County,3,61001,31839,29162,15691,60914,31755,29159,19946,10459,9487,38219,19893,18326,2836,1487,1349,57818
112.695732116699219,36.752883911132812,1404,14,140430,,Qinxian,County,3,169959,89473,80486,44716,161802,85161,76641,44241,23003,21238,113951,61082,52869,11767,5388,6379,157210
110.926094055175781,36.694454193115234,1410,14,141031,,Xixian,County,3,95895,49273,46622,23140,93433,48592,44841,27185,14174,13011,63690,32485,31205,5020,2614,2406,91386
111.5703125,36.658123016357422,1410,14,141034,,Fenxi,County,3,133836,70045,63791,30247,132618,68938,63680,43849,22728,21121,83330,44050,39280,6657,3267,3390,128540
113.040763854980469,36.534587860107422,1404,14,140423,ԫ,Xiangyuan,County,3,248383,129172,119211,64081,245037,126409,118628,61774,32334,29440,171001,89374,81627,15608,7464,8144,230304
113.371589660644531,36.503570556640625,1404,14,140426,,Licheng,County,3,155075,82119,72956,44409,151388,79011,72377,38248,20058,18190,107842,57469,50373,8985,4592,4393,141726
112.329559326171875,36.497116088867188,1404,14,140431,Դ,Qinyuan,County,3,154305,82437,71868,39881,147675,77940,69735,40205,20496,19709,104292,57083,47209,9808,4858,4950,142219
110.750473022460938,36.46917724609375,1410,14,141030,,Daning,County,3,56037,28814,27223,14642,55963,28752,27211,18982,9717,9265,34080,17557,16523,2975,1540,1435,51318
111.0968017578125,36.415763854980469,1410,14,141033,,Puxian,County,3,98860,53428,45432,22413,93641,48372,45269,30081,15373,14708,64189,35706,28483,4590,2349,2241,85925
113.222679138183594,36.328193664550781,1404,14,140481,º,Lucheng,City,3,213944,111293,102651,54311,209989,107621,102368,53693,27834,25859,149164,78052,71112,11087,5407,5680,193177
112.8824462890625,36.321949005126953,1404,14,140424,,Tunliu,County,3,248225,128283,119942,61804,245929,126577,119352,65761,34299,31462,168808,87632,81176,13656,6352,7304,236943
111.919990539550781,36.286735534667969,1410,14,141025,,Guxian,County,3,84696,44469,40227,21044,83313,43189,40124,24561,12572,11989,55969,29898,26071,4166,1999,2167,81244
111.673927307128906,36.261592864990234,1410,14,141024,鶴,Hongdong,County,3,693261,353984,339277,158733,685226,348010,337216,205250,107407,97843,452533,231115,221418,35478,15462,20016,674407
113.42694091796875,36.200164794921875,1404,14,140425,ƽ˳,Pingshun,County,3,160868,83379,77489,44495,158547,81597,76950,44016,22498,21518,107082,56156,50926,9770,4725,5045,154054
112.244903564453125,36.144832611083984,1410,14,141026,,Anze,County,3,76139,39969,36170,21432,74874,38845,36029,20180,10264,9916,52030,27737,24293,3929,1968,1961,71944
112.873794555664062,36.11993408203125,1404,14,140428,,Changzi,County,3,337354,172225,165129,84529,336690,171717,164973,88279,45538,42741,228617,117284,111333,20458,9403,11055,324673
113.199623107910156,36.113498687744141,1404,14,140427,,Huguan,County,3,282564,143171,139393,72759,281356,142170,139186,81721,41725,39996,184028,93905,90123,16815,7541,9274,275226
110.6751708984375,36.095630645751953,1410,14,141028,,Jixian,County,3,97096,49952,47144,26270,96987,49847,47140,30755,15672,15083,61444,31755,29689,4897,2525,2372,90201
113.044830322265625,36.045421600341797,1404,14,140421,,Changzhi,County,3,323236,162923,160313,82149,320657,161128,159529,77282,39549,37733,227284,115391,111893,18670,7983,10687,305669
110.833747863769531,35.970108032226562,1410,14,141029,,Xiangning,County,3,216408,112753,103655,48629,212691,109308,103383,72165,37286,34879,134026,70503,63523,10217,4964,5253,203568
111.842437744140625,35.967441558837891,1410,14,141027,ɽ,Fushan,County,3,121323,62857,58466,32208,119156,60723,58433,31376,15899,15477,82196,43412,38784,7751,3546,4205,109186
111.437271118164062,35.873077392578125,1410,14,141023,,Xiangfen,County,3,466163,236842,229321,112522,459848,231750,228098,128833,66779,62054,307888,157046,150842,29442,13017,16425,453442
112.921890258789062,35.786689758300781,1405,14,140581,ƽ,Gaoping,City,3,471671,236439,235232,123489,464013,229963,234050,123759,61149,62610,319179,162840,156339,28733,12450,16283,436797
113.278541564941406,35.769687652587891,1405,14,140524,괨,Lingchuan,County,3,249782,129512,120270,67725,248793,128747,120046,63077,32069,31008,170557,89842,80715,16148,7601,8547,237251
111.709976196289062,35.736461639404297,1410,14,141022,,Yicheng,County,3,303258,154157,149101,76768,301470,152483,148987,76669,38973,37696,208847,107428,101419,17742,7756,9986,284948
112.173965454101562,35.687332153320312,1405,14,140521,ˮ,Qinshui,County,3,211440,110365,101075,61241,205759,105329,100430,50386,25410,24976,147198,78504,68694,13856,6451,7405,190756
111.464653015136719,35.638217926025391,1410,14,141021,,Quwo,County,3,222391,113641,108750,52793,218191,110029,108162,58798,30068,28730,150202,77597,72605,13391,5976,7415,204256
111.219215393066406,35.615642547607422,1408,14,140825,,Xinjiang,County,3,312063,159153,152910,73111,308008,156330,151678,85947,46240,39707,206733,104333,102400,19383,8580,10803,300111
110.984962463378906,35.596023559570312,1408,14,140824,ɽ,Jishan,County,3,324812,166055,158757,73570,315098,161250,153848,94170,51469,42701,211094,105976,105118,19548,8610,10938,315447
110.697807312011719,35.58740234375,1408,14,140882,"ӽ
",Hejin,City,3,368572,195677,172895,87465,356362,185672,170690,107720,59857,47863,240781,126474,114307,20071,9346,10725,344399
112.42413330078125,35.479087829589844,1405,14,140522,,Yangcheng,County,3,406708,209124,197584,115181,393688,198926,194762,102886,51710,51176,281180,147200,133980,22642,10214,12428,371726
111.561325073242188,35.489242553710938,1408,14,140826,,Jiangxian,County,3,264708,133777,130931,65823,263792,133099,130693,66576,33829,32747,182200,92678,89522,15932,7270,8662,255811
110.833221435546875,35.420173645019531,1408,14,140822,,Wanrong,County,3,425598,217147,208451,97625,420343,213641,206702,117763,62204,55559,279168,142122,137046,28667,12821,15846,417153
111.217208862304688,35.357723236083984,1408,14,140823,ϲ,Wenxi,County,3,377572,194011,183561,90387,372532,189744,182788,101511,54053,47458,252595,129120,123475,23466,10838,12628,359625
111.661994934082031,35.303138732910156,1408,14,140827,ԫ,Yuanqu,County,3,219371,113672,105699,59810,216824,111568,105256,60586,31529,29057,145853,76027,69826,12932,6116,6816,207863
110.771736145019531,35.150245666503906,1408,14,140821,,Linyi,County,3,536518,273837,262681,129546,522437,263660,258777,141779,74828,66951,360443,183766,176677,34296,15243,19053,520344
111.220054626464844,35.137451171875,1408,14,140828,,Xiaxian,County,3,342870,177978,164892,77572,336955,173351,163604,93170,50584,42586,225641,116282,109359,24059,11112,12947,335040
110.446014404296875,34.883457183837891,1408,14,140881,,Yongji,City,3,421244,214446,206798,105903,408047,205272,202775,110833,57639,53194,282390,144243,138147,28021,12564,15457,398824
111.210960388183594,34.841091156005859,1408,14,140829,ƽ½,Pinglu,County,3,241879,124349,117530,59992,239581,122536,117045,65186,34138,31048,158839,81746,77093,17854,8465,9389,236918
110.681388854980469,34.706512451171875,1408,14,140830,ǳ,Ruicheng,County,3,372773,189709,183064,95478,367696,186498,181198,104423,55237,49186,242382,122672,119710,25968,11800,14168,354673
112.799186706542969,35.460391998291016,1405,14,140525,,Zezhou,County,3,517162,269035,248127,136594,494086,248027,246059,131769,66129,65640,354831,189069,165762,30562,13837,16725,469452
112.152557373046875,37.907569885253906,1401,14,140181,Ž,Gujiao,City,3,205702,110105,95597,56521,200108,104870,95238,56992,30388,26604,139781,74967,64814,8929,4750,4179,154222
111.728004455566406,36.575939178466797,1410,14,141082,,Huozhou,City,3,274955,142316,132639,68263,269387,137414,131973,79827,41688,38139,182646,94452,88194,12482,6176,6306,254976
111.343437194824219,35.607330322265625,1410,14,141081,,Houma,City,3,225123,113997,111126,61240,218354,109615,108739,54291,27764,26527,157636,79748,77888,13196,6485,6711,183365
112.291107177734375,39.521007537841797,1406,14,140603,ƽ³,Pinglu,Qu,3,175258,90926,84332,43982,174043,89794,84249,59795,31129,28666,103792,53763,50029,11671,6034,5637,148319
113.124267578125,40.005626678466797,1402,14,140211,Ͻ,Nanjiaoqu,Qu,3,422517,223583,198934,120181,410058,214326,195732,113081,60095,52986,293668,155525,138143,15768,7963,7805,209187
112.417904896380463,39.312551540535203,1406,14,140602,˷,Shuocheng,Qu,3,388638,199695,188943,103105,380923,194975,185948,116019,60988,55031,250358,127283,123075,22261,11424,10837,318106
110.99435186182383,35.030060552439387,1408,14,140802,κ,Yanhu,Qu,3,604381,304489,299892,146408,557384,281259,276125,148601,77983,70618,420874,210464,210410,34906,16042,18864,535399
112.735989620538604,38.418056488037109,1409,14,140902,ø,Xinfu,Qu,3,496608,251708,244900,142510,477175,242767,234408,119159,61717,57442,339773,172177,167596,37676,17814,19862,416028
111.517434029219345,36.088611430240114,1410,14,141002,Ң,Yaodu,Qu,3,724403,367377,357026,179968,682008,343219,338789,180919,93879,87040,504340,255779,248561,39144,17719,21425,646423
113.558902349730261,37.857917612504025,1403,14,140302,,Cheng,Qu,3,164288,84865,79423,49744,152220,76227,75993,27799,14295,13504,127581,65963,61618,8908,4607,4301,119270
113.499506896308546,37.865211790994415,1403,14,140303,,Kuangqu,Qu,3,217592,114455,103137,66073,212125,109537,102588,39775,20720,19055,167735,88060,79675,10082,5675,4407,170620
112.757174390654171,37.708949499418203,1407,14,140702,ܴ,Yuci,Qu,3,534357,274957,259400,155808,507094,257437,249657,109138,56462,52676,387249,198697,188552,37970,19798,18172,418034
113.058605279849402,36.324737212890078,1404,14,140411,,Jiaoqu,Qu,3,287473,150184,137289,74892,274330,139704,134626,65175,34302,30873,209395,109787,99608,12903,6095,6808,242141
112.86563681687332,35.507538545850558,1405,14,140502,,Cheng,Qu,3,304221,157663,146558,87053,286722,145363,141359,70078,36036,34042,223464,116491,106973,10679,5136,5543,190402
113.529411298749395,37.934235275149568,1403,14,140311,,Jiaoqu,Qu,3,273437,146889,126548,76628,259854,134583,125271,57782,30906,26876,198208,107371,90837,17447,8612,8835,216037
104.618888854980469,28.756488800048828,5115,51,511502,,Cuiping,Qu,3,809099,419397,389702,235688,746779,379931,366848,161675,86523,75152,588957,305021,283936,58467,27853,30614,623918
104.091575622558594,30.631219863891602,5101,51,510104,,Jinjiang,Qu,3,440280,224072,216208,143264,388966,194837,194129,52829,27322,25507,345522,176272,169250,41929,20478,21451,287210
104.109511284428933,30.683003907339423,5101,51,510108,ɻ,Chenghua,Qu,3,733274,388348,344926,222509,641201,326503,314698,92281,47989,44292,589620,313338,276282,51373,27021,24352,455726
104.065788269042969,30.664285659790039,5101,51,510105,,Qingyang,Qu,3,551261,285738,265523,169082,462896,229882,233014,66313,34208,32105,435354,226911,208443,49594,24619,24975,335596
104.035470448072616,30.636755431521514,5101,51,510107,,Wuhou,Qu,3,822859,435187,387672,234004,653116,327885,325231,98941,50950,47991,674122,359078,315044,49796,25159,24637,447632
104.030525232974625,30.718790490624496,5101,51,510106,ţ,Jinniu,Qu,3,922804,482619,440185,283856,781867,394574,387293,110779,57906,52873,746195,391493,354702,65830,33220,32610,432701
104.718841552734375,29.334659576416016,5103,51,510303,,Gongjing,Qu,3,134697,66831,67866,39351,133213,65897,67316,21212,10787,10425,100450,50482,49968,13035,5562,7473,118230
104.772276901388793,29.35286277298577,5103,51,510302,,Ziliujing,Qu,3,206060,103606,102454,60284,187259,91718,95541,28028,14377,13651,159490,80830,78660,18542,8399,10143,183530
104.799688440090833,29.347084846378767,5103,51,510304,,Daan,Qu,3,358977,181553,177424,106347,351075,176795,174280,66214,34074,32140,262664,133964,128700,30099,13515,16584,295817
101.703498840332031,26.53173828125,5104,51,510402,,Dong,Qu,3,315707,166358,149349,101179,287933,146000,141933,47303,24621,22682,255119,134469,120650,13285,7268,6017,248950
101.662163245810987,26.606564978763636,5104,51,510403,,Xi,Qu,3,170862,90755,80107,53302,157204,80529,76675,26634,13731,12903,137762,73409,64353,6466,3615,2851,139280
105.080406188964844,29.590896606445312,5110,51,511002,,Shizhong,Qu,3,544660,275056,269604,161438,530661,265772,264889,111616,57811,53805,387517,195799,191718,45527,21446,24081,481072
105.103805541992188,29.581142425537109,5110,51,511011,,Dongxing,Qu,3,847271,433997,413274,233321,824898,423271,401627,183258,95989,87269,600551,307676,292875,63462,30332,33130,804559
104.729265061484995,31.474228875498397,5107,51,510703,,Fucheng,Qu,3,671401,348408,322993,210062,585002,296218,288784,104145,53778,50367,527362,274322,253040,39894,20308,19586,470825
104.3988037109375,31.151481628417969,5106,51,510603,,Jingyang,Qu,3,628876,324823,304053,204102,587960,296810,291150,102143,52566,49577,479029,247798,231231,47704,24459,23245,507339
102.96044921875,33.579566955566406,5132,51,513232,,Ruoergai,County,3,65413,33185,32228,13503,62897,31082,31815,20893,10781,10112,40414,20830,19584,4106,1574,2532,61818
98.07989501953125,32.973430633544922,5133,51,513332,ʯ,Shiqu,County,3,63489,32050,31439,14902,61653,30461,31192,15326,7898,7428,44247,22517,21730,3916,1635,2281,61624
101.71295166015625,32.891040802001953,5132,51,513231,,Aba,County,3,62312,31694,30618,11683,60624,30433,30191,19849,10207,9642,38479,19872,18607,3984,1615,2369,58550
102.549041748046875,32.793327331542969,5132,51,513233,ԭ,Hongyuan,County,3,37931,19439,18492,8877,36055,17995,18060,11827,5986,5841,24259,12673,11586,1845,780,1065,34381
103.592697143554688,32.640609741210938,5132,51,513224,,Songpan,County,3,69079,35815,33264,15303,65438,33534,31904,19470,9942,9528,45798,24231,21567,3811,1642,2169,64957
105.234489440917969,32.623294830322266,5108,51,510822,ന,Qingchuan,County,3,253416,132830,120586,69146,248872,130078,118794,61318,31209,30109,175490,93422,82068,16608,8199,8409,239410
104.52972412109375,32.413154602050781,5107,51,510727,ƽ,Pingwu,County,3,187799,99147,88652,52250,179878,94524,85354,44841,23043,21798,129905,69507,60398,13053,6597,6456,179053
106.832756042480469,32.36175537109375,5119,51,511922,Ͻ,Nanjiang,County,3,593720,309645,284075,160498,583803,303768,280035,167533,91639,75894,393302,201008,192294,32885,16998,15887,560705
100.334739685058594,32.269882202148438,5133,51,513333,ɫ,Seda,County,3,41450,19904,21546,8796,35839,18133,17706,9043,4616,4427,30078,14378,15700,2329,910,1419,33894
100.974647521972656,32.268356323242188,5132,51,513230,,Rangtang,County,3,33550,17118,16432,7477,32030,16114,15916,9597,4873,4724,21700,11312,10388,2253,933,1320,32043
106.285224914550781,32.211200714111328,5108,51,510821,,Wangcang,County,3,459119,241189,217930,127240,437873,227054,210819,103197,53567,49630,330535,174653,155882,25387,12969,12418,438122
108.045974731445312,32.069965362548828,5117,51,511781,Դ,Wanyuan,City,3,536685,278918,257767,149176,526848,273155,253693,154849,80592,74257,353946,183538,170408,27890,14788,13102,502717
102.986137390136719,32.065624237060547,5132,51,513228,ˮ,Heishui,County,3,57000,28688,28312,14193,55722,27792,27930,14250,7294,6956,40214,20446,19768,2536,948,1588,54526
105.578032958351685,32.218714027276555,5108,51,510823,,Jiange,County,3,667978,348177,319801,179455,654542,340211,314331,164110,85094,79016,460665,242864,217801,43203,20219,22984,633376
107.235183715820312,31.914350509643555,5119,51,511921,ͨ,Tongjiang,County,3,676370,349467,326903,175219,669837,344818,325019,190763,100974,89789,444971,228321,216650,40636,20172,20464,653827
102.210617065429688,31.909631729125977,5132,51,513229,,Maerkang,County,3,55046,28308,26738,14990,50431,25801,24630,11387,5789,5598,40457,21194,19263,3202,1325,1877,49009
104.467124938964844,31.830085754394531,5107,51,510726,,Beichuan,County,3,160301,84555,75746,43165,152792,79717,73075,39416,20131,19285,110287,59046,51241,10598,5378,5220,156943
98.565254211425781,31.829385757446289,5133,51,513330,¸,Dege,County,3,63989,32355,31634,13011,62786,31350,31436,16441,8345,8096,43892,22538,21354,3656,1472,2184,62131
105.933036804199219,31.743104934692383,5108,51,510824,Ϫ,Cangxi,County,3,777721,399558,378163,209015,750315,383034,367281,158617,82606,76011,572291,294973,277318,46813,21979,24834,745108
103.853492736816406,31.674938201904297,5132,51,513223,ï,Mao,County,3,103570,54158,49412,22532,96438,49028,47410,29397,14962,14435,69453,37009,32444,4720,2187,2533,98698
105.147018432617188,31.644220352172852,5107,51,510725,,Zitong,County,3,362712,187202,175510,110976,358934,184668,174266,72960,37432,35528,261186,136419,124767,28566,13351,15215,348109
99.981407165527344,31.637514114379883,5133,51,513328,,Ganzi,County,3,55703,27911,27792,11960,52984,26150,26834,12274,6082,6192,40747,20804,19943,2682,1025,1657,51793
105.967033386230469,31.583160400390625,5113,51,511381,,Langzhong,City,3,787809,400390,387419,235178,770636,388911,381725,155837,81384,74453,568447,289445,279002,63525,29561,33964,751322
107.094978332519531,31.562837600708008,5119,51,511923,ƽ,Pingchang,County,3,833294,422624,410670,239059,824699,416336,408363,243766,132414,111352,536625,264849,271776,52903,25361,27542,795047
106.403678894042969,31.526845932006836,5113,51,511324,¤,Yilong,County,3,916807,476547,440260,247055,908689,470420,438269,252394,142952,109442,600182,301246,298936,64231,32349,31882,893166
102.06292724609375,31.496160507202148,5132,51,513226,,Jinchuan,County,3,69098,35572,33526,16917,67863,34617,33246,18881,9596,9285,46304,24190,22114,3913,1786,2127,64880
103.581535339355469,31.466510772705078,5132,51,513221,봨,Wenchuan,County,3,111935,59286,52649,27659,97934,50331,47603,27420,13923,13497,78542,42363,36179,5973,3000,2973,102322
103.186798095703125,31.44483757019043,5132,51,513222,,Li,County,3,43668,22380,21288,11511,42897,21932,20965,11075,5659,5416,30180,15637,14543,2413,1084,1329,40747
100.677803039550781,31.412508010864258,5133,51,513327,¯,Luhuo,County,3,39603,20057,19546,8818,38427,19250,19177,9898,5050,4848,27744,14233,13511,1961,774,1187,37712
106.028221864413197,31.344803493638818,5113,51,511321,ϲ,Nanbu,County,3,1186897,615770,571127,329072,1165029,602017,563012,295730,162476,133254,805157,413626,391531,86010,39668,46342,1157559
107.721786499023438,31.359371185302734,5117,51,511722,,Xuanhan,County,3,1047230,551218,496012,287603,1038440,545182,493258,291478,157999,133479,690789,360799,329990,64963,32420,32543,1012412
104.194244384765625,31.35090446472168,5106,51,510683,,Mianzhu,City,3,515830,263098,252732,175171,504055,254848,249207,87057,44387,42670,382554,195520,187034,46219,23191,23028,469068
105.376113891601562,31.229305267333984,5107,51,510723,ͤ,Yanting,County,3,566541,292701,273840,162150,550715,284316,266399,110948,57094,53854,409168,215038,194130,46425,20569,25856,543172
98.821182250976562,31.248083114624023,5133,51,513331,,Baiyu,County,3,42013,21120,20893,8253,40612,20063,20549,9098,4682,4416,30338,15478,14860,2577,960,1617,39664
104.16632080078125,31.137165069580078,5106,51,510682,ʲ,Shenfang,City,3,432579,218447,214132,147270,425709,213767,211942,79022,40370,38652,315540,159017,156523,38017,19060,18957,408114
105.084877014160156,31.096418380737305,5107,51,510722,̨,Santai,County,3,1395841,728045,667796,416754,1362505,706364,656141,326486,171842,154644,956372,503003,453369,112983,53200,59783,1342073
107.867454528808594,31.078832626342773,5117,51,511723,,Kaijiang,County,3,509469,270420,239049,141803,497099,263621,233478,134060,74040,60020,341058,179119,161939,34351,17261,17090,477593
106.565032958984375,31.075796127319336,5113,51,511322,Ӫɽ,Yingshan,County,3,804083,418574,385509,213606,791631,410004,381627,203418,110991,92427,532224,275283,256941,68441,32300,36141,796562
104.679046630859375,31.044277191162109,5106,51,510623,н,Zhongjiang,County,3,1395789,735471,660318,404040,1369651,718408,651243,298655,158699,139956,983394,521593,461801,113740,55179,58561,1348873
106.408889770507812,31.036739349365234,5113,51,511323,,Pengan,County,3,639314,335715,303599,180852,628991,328152,300839,157446,85957,71489,432533,225677,206856,49335,24081,25254,631520
105.880943298339844,31.010457992553711,5113,51,511325,,Xichong,County,3,576576,299379,277197,173728,562983,291807,271176,139030,75070,63960,388535,201572,186963,49011,22737,26274,569046
102.356948852539062,31.006866455078125,5132,51,513227,С,Xiaojin,County,3,76709,39849,36860,18082,75121,38888,36233,21110,10857,10253,51977,27358,24619,3622,1634,1988,73289
103.939277648925781,30.991878509521484,5101,51,510182,,Pengzhou,City,3,770749,389697,381052,228088,756630,381485,375145,143783,74165,69618,563080,284038,279042,63886,31494,32392,707220
101.110122680664062,30.973852157592773,5133,51,513326,,Daofu,County,3,44848,22625,22223,9582,44039,22023,22016,11431,5880,5551,31098,15828,15270,2319,917,1402,41479
100.303657531738281,30.94495964050293,5133,51,513329,,Xinlong,County,3,40505,20272,20233,8233,40396,20167,20229,11425,5803,5622,26353,13464,12889,2727,1005,1722,39868
104.243301391601562,30.88380241394043,5101,51,510113,׽,Qingbaijiang,Qu,3,384674,197522,187152,117052,364166,184417,179749,69339,35745,33594,284290,146062,138228,31045,15715,15330,349557
105.382369995117188,30.876119613647461,5109,51,510922,,Shehong,County,3,963237,492727,470510,274681,871364,434118,437246,223370,117436,105934,658812,338642,320170,81055,36649,44406,850003
101.876510620117188,30.866321563720703,5133,51,513323,,Danba,County,3,55753,28434,27319,13381,54817,27684,27133,14158,7268,6890,37931,19578,18353,3664,1588,2076,52641
104.434562683105469,30.857915878295898,5101,51,510121,,Jintang,County,3,772273,401493,370780,240697,761190,394426,366764,169540,89048,80492,536179,279139,257040,66554,33306,33248,736768
106.962242126464844,30.844326019287109,5117,51,511725,,Qu,County,3,1236602,643081,593521,322520,1102234,567516,534718,342440,182566,159874,804618,419217,385401,89544,41298,48246,1189186
104.160545349121094,30.831390380859375,5101,51,510125,¶,Xindu,County,3,611986,308717,303269,180392,575421,288011,287410,104930,54009,50921,458343,230184,228159,48713,24524,24189,560566
103.882980346679688,30.81672477722168,5101,51,510124,ۯ,Pi,County,3,490314,245576,244738,149878,470429,233927,236502,84308,43494,40814,365718,182401,183317,40288,19681,20607,451610
105.708625793457031,30.776372909545898,5109,51,510921,Ϫ,Pengxi,County,3,672546,345744,326802,185671,585156,298062,287094,181562,97793,83769,433120,220489,212631,57864,27462,30402,636965
106.095509212632962,30.782637118235243,5113,51,511303,ƺ,Gaoping,Qu,3,543574,284954,258620,157915,520679,270282,250397,120925,66107,54818,383251,199518,183733,39398,19329,20069,525865
107.204841613769531,30.738197326660156,5117,51,511724,,Dazhu,County,3,952734,504214,448520,272492,934356,491735,442621,237723,131602,106121,643305,338671,304634,71706,33941,37765,899299
103.830604553222656,30.702268600463867,5101,51,510123,½,Wenjiang,County,3,322290,163173,159117,97189,302691,151022,151669,52800,27090,25710,243683,123329,120354,25807,12754,13053,283039
103.670806884765625,30.634767532348633,5101,51,510184,,Chongzhou,City,3,650698,330345,320353,183903,619787,311706,308081,117315,60371,56944,472320,239714,232606,61063,30260,30803,607006
103.518211364746094,30.594430923461914,5101,51,510129,,Dayi,County,3,490373,253272,237101,144197,476527,242022,234505,91090,46351,44739,354822,185035,169787,44461,21886,22575,448424
103.91558837890625,30.58375358581543,5101,51,510122,˫,Shuangliu,County,3,874184,447869,426315,256622,833167,421358,411809,158052,81250,76802,648329,332607,315722,67803,34012,33791,795560
104.2705078125,30.568614959716797,5101,51,510112,Ȫ,Longquanyi,Qu,3,478389,245510,232879,140470,446432,226230,220202,83523,42740,40783,359267,184251,175016,35599,18519,17080,423126
106.440574645996094,30.545619964599609,5116,51,511621,,Yuechi,County,3,1062585,552439,510146,296440,1052668,546379,506289,277301,153095,124206,710311,364161,346150,74973,35183,39790,1030967
103.810935974121094,30.42353630065918,5101,51,510132,½,Xinjin,County,3,291021,146115,144906,86914,285934,143121,142813,51661,26294,25367,214202,107573,106629,25158,12248,12910,257919
103.457756042480469,30.421257019042969,5101,51,510183,,Qionglai,City,3,631577,321382,310195,181167,611672,309357,302315,116969,59601,57368,457816,234792,223024,56792,26989,29803,601338
104.551536560058594,30.397039413452148,5120,51,512081,,Jianyang,City,3,1412523,728353,684170,408853,1357632,698612,659020,306554,159334,147220,978775,505464,473311,127194,63555,63639,1361091
102.821022033691406,30.372356414794922,5118,51,511827,,Baoxing,County,3,56137,29653,26484,15156,54521,28354,26167,13753,7071,6682,38426,20691,17735,3958,1891,2067,50191
106.290924072265625,30.361160278320312,5116,51,511622,ʤ,Wusheng,County,3,758957,388665,370292,213399,747282,381934,365348,210762,113579,97183,492541,249082,243459,55654,26004,29650,729424
106.919631958007812,30.335321426391602,5116,51,511623,ˮ,Linshui,County,3,857198,448807,408391,240188,847914,442782,405132,267253,144843,122410,536981,278210,258771,52964,25754,27210,826336
105.018692016601562,30.285236358642578,5120,51,512022,,Lezhi,County,3,844599,437590,407009,267378,836611,432901,403710,171203,89357,81846,596156,311733,284423,77240,36500,40740,822187
103.4737548828125,30.221641540527344,5101,51,510131,ѽ,Pujiang,County,3,247548,125448,122100,75818,243741,123363,120378,46106,23632,22474,181275,92285,88990,20167,9531,10636,228858
103.8746337890625,30.199213027954102,5114,51,511422,ɽ,Pengshan,County,3,315252,159471,155781,91332,286421,144162,142259,57668,29538,28130,228416,115975,112441,29168,13958,15210,293411
102.919265747070312,30.176385879516602,5118,51,511826,«ɽ,Lushan,County,3,121520,65035,56485,31952,113192,58524,54668,27067,13957,13110,85784,46941,38843,8669,4137,4532,112889
105.324516296386719,30.112699508666992,5120,51,512021,,Anyue,County,3,1424518,737046,687472,412383,1411058,728509,682549,341120,184012,157108,963213,494973,468240,120185,58061,62124,1408040
103.104469299316406,30.096099853515625,5118,51,511821,ɽ,Mingshan,County,3,256214,132771,123443,75121,252183,130025,122158,47956,24528,23428,186721,97768,88953,21537,10475,11062,243546
102.736610412597656,30.081218719482422,5118,51,511825,ȫ,Tianquan,County,3,141084,73365,67719,40749,139111,71700,67411,32672,16697,15975,98542,52189,46353,9870,4479,5391,130947
101.951080322265625,30.057140350341797,5133,51,513321,,Kangding,County,3,109349,56835,52514,27263,98833,50422,48411,25528,13067,12461,78662,41433,37229,5159,2335,2824,99188
100.9996337890625,30.035999298095703,5133,51,513325,Ž,Yajiang,County,3,39701,20363,19338,7873,39444,20112,19332,10987,5644,5343,26849,13932,12917,1865,787,1078,38864
103.483016967773438,30.036964416503906,5114,51,511424,,Danleng,County,3,162096,82419,79677,45114,155843,78883,76960,32266,16433,15833,115855,59501,56354,13975,6485,7490,152210
99.132377624511719,30.020177841186523,5133,51,513335,,Batang,County,3,43814,22203,21611,9193,42961,21573,21388,11817,6002,5815,30065,15453,14612,1932,748,1184,42994
104.136711120605469,29.997390747070312,5114,51,511421,,Renshou,County,3,1398462,722650,675812,388687,1257942,638332,619610,337688,174845,162843,940436,489319,451117,120338,58486,61852,1237438
100.274406433105469,29.996824264526367,5133,51,513334,,Litang,County,3,49453,24808,24645,10432,49142,24564,24578,12438,6391,6047,34759,17579,17180,2256,838,1418,46231
102.229522705078125,29.908485412597656,5133,51,513322,,Luding,County,3,77855,40631,37224,20749,74922,38493,36429,21032,10702,10330,51336,27287,24049,5487,2642,2845,72437
103.352005004882812,29.925897598266602,5114,51,511423,,Hongya,County,3,331055,169364,161691,95012,313657,158714,154943,65151,33095,32056,237030,122909,114121,28874,13360,15514,313592
103.871917724609375,29.840097427368164,5114,51,511425,,Qingshen,County,3,198997,100800,98197,60393,184859,92979,91880,35389,17925,17464,144376,73805,70571,19232,9070,10162,181126
102.837318420410156,29.795326232910156,5118,51,511822,,Xingjing,County,3,142683,73958,68725,44492,139053,70917,68136,30893,15716,15177,100815,53073,47742,10975,5169,5806,132769
104.848358154296875,29.784748077392578,5110,51,511025,,Zizhong,County,3,1278563,662839,615724,358192,1219492,629134,590358,306558,159477,147081,867542,453552,413990,104463,49810,54653,1181476
103.544708251953125,29.755212783813477,5111,51,511126,н,Jiajiang,County,3,348481,177116,171365,104533,340175,171857,168318,62707,32007,30700,255069,130770,124299,30705,14339,16366,329038
104.067558288574219,29.652866363525391,5111,51,511124,,Jingyan,County,3,384060,196640,187420,121565,349076,177272,171804,73438,37637,35801,274233,141612,132621,36389,17391,18998,358412
104.664840698242188,29.528804779052734,5110,51,511024,Զ,Weiyuan,County,3,744778,383443,361335,210935,704485,360884,343601,161774,83091,78683,522186,271645,250541,60818,28707,32111,668489
104.420372009277344,29.461076736450195,5103,51,510321,,Rong,County,3,862003,443273,418730,252570,849515,435347,414168,154138,78705,75433,635388,330341,305047,72477,34227,38250,820912
103.797158572732158,29.423014521880098,5111,51,511112,ͨ,Wutongqiao,Qu,3,310229,156971,153258,101473,306925,154931,151994,51138,26011,25127,228970,116606,112364,30121,14354,15767,290307
102.668853759765625,29.351730346679688,5118,51,511823,Դ,Hanyuan,County,3,347471,178510,168961,99018,341588,174921,166667,85323,43775,41548,235808,122240,113568,26340,12495,13845,319142
105.273345947265625,29.34686279296875,5110,51,511028,¡,Longchang,County,3,745033,378493,366540,228660,718938,363516,355422,157258,81582,75676,527526,269394,258132,60249,27517,32732,700426
102.355186462402344,29.250091552734375,5118,51,511824,ʯ,Shimian,County,3,123261,65055,58206,37578,119011,61232,57779,26667,13876,12791,87765,46514,41251,8829,4665,4164,110247
103.245620727539062,29.242626190185547,5111,51,511132,,Ebianyizuzhzhixian,County,3,141166,75949,65217,37302,132114,68382,63732,39088,20287,18801,93739,51545,42194,8339,4117,4222,131703
103.94427490234375,29.211551666259766,5111,51,511123,Ϊ,Jianwei,County,3,506834,262011,244823,159158,499468,257447,242021,108821,56724,52097,354424,184023,170401,43589,21264,22325,478656
104.988311767578125,29.188720703125,5103,51,510322,˳,Fushun,County,3,1120376,578458,541918,306496,1107320,570187,537133,272055,145898,126157,757020,389004,368016,91301,43556,47745,1077434
100.284805297851562,29.035341262817383,5133,51,513337,,Daocheng,County,3,28228,14292,13936,5535,27610,13745,13865,7208,3575,3633,19630,10238,9392,1390,479,911,26830
101.513626098632812,29.004007339477539,5133,51,513324,,Jiulong,County,3,50816,26435,24381,12046,50430,26111,24319,16706,8879,7827,31634,16437,15197,2476,1119,1357,47703
102.761741638183594,28.974451065063477,5134,51,513435,,Ganluo,County,3,175426,92814,82612,43077,172810,90705,82105,57105,30841,26264,111818,58984,52834,6503,2989,3514,163023
103.895454406738281,28.964479446411133,5111,51,511129,崨,Muchuan,County,3,229945,123318,106627,66906,225378,119250,106128,52691,27166,25525,159253,87156,72097,18001,8996,9005,217501
99.793937683105469,28.939277648925781,5133,51,513336,,Xiangcheng,County,3,26879,13762,13117,4760,26040,13131,12909,7418,3773,3645,18206,9540,8666,1255,449,806,25513
104.972015380859375,28.847984313964844,5115,51,511522,Ϫ,Nanxi,County,3,377289,196411,180878,106051,348629,180164,168465,87475,47649,39826,262188,135546,126642,27626,13216,14410,336907
103.534294128417969,28.855634689331055,5111,51,511133,,Mabianyizuzhzhixian,County,3,170425,89091,81334,42280,167017,86825,80192,49034,25517,23517,112127,59138,52989,9264,4436,4828,162467
105.839431762695312,28.812002182006836,5105,51,510522,Ͻ,Hejiang,County,3,720198,373803,346395,242789,706115,364698,341417,154599,81366,73233,496301,258950,237351,69298,33487,35811,674355
105.368057250976562,28.766332626342773,5105,51,510503,Ϫ,Naxi,Qu,3,425333,221123,204210,132148,389094,200011,189083,88329,46692,41637,300359,156457,143902,36645,17974,18671,371652
105.066436767578125,28.733867645263672,5115,51,511523,,Jiangan,County,3,488174,254353,233821,134117,454831,236480,218351,130698,70811,59887,320968,166021,154947,36508,17521,18987,432735
99.269081115722656,28.710622787475586,5133,51,513338,,Derong,County,3,23791,12104,11687,4203,23216,11656,11560,6303,3216,3087,15968,8261,7707,1520,627,893,22872
104.52423095703125,28.701313018798828,5115,51,511521,˱,Yibin,County,3,928584,483851,444733,260194,879191,456235,422956,219593,117034,102559,639439,333071,306368,69552,33746,35806,852416
104.150917053222656,28.662605285644531,5115,51,511529,ɽ,Pingshan,County,3,250620,130564,120056,65507,241368,125339,116029,66006,34524,31482,167273,87659,79614,17341,8381,8960,231958
102.503776550292969,28.643764495849609,5134,51,513434,Խ,Yuexi,County,3,237800,122772,115028,57746,236691,121950,114741,84622,45417,39205,144115,73255,70860,9063,4100,4963,229033
104.923332214355469,28.581974029541016,5115,51,511524,,Changning,County,3,391832,206493,185339,108761,364135,193175,170960,89340,50755,38585,270750,139993,130757,31742,15745,15997,351175
102.15301513671875,28.542879104614258,5134,51,513433,,Mianning,County,3,324332,166871,157461,80321,320617,164281,156336,102927,54157,48770,202846,104002,98844,18559,8712,9847,299282
104.563461303710938,28.394594192504883,5115,51,511525,,Gao,County,3,472335,246734,225601,125690,447353,232392,214961,110269,59241,51028,326350,170294,156056,35716,17199,18517,440044
104.788566589355469,28.381191253662109,5115,51,511526,,Gong,County,3,401312,213586,187726,108254,379622,198879,180743,98336,53712,44624,274943,145788,129155,28033,14086,13947,365102
105.237388610839844,28.30833625793457,5115,51,511528,,Xingwen,County,3,401510,213499,188011,107204,371844,196443,175401,92988,51972,41016,276242,145317,130925,32280,16210,16070,357047
103.107681274414062,28.33247184753418,5134,51,513436,,Meigu,County,3,176214,90368,85846,43644,175737,90010,85727,58733,30864,27869,111496,56567,54929,5985,2937,3048,172210
102.407211303710938,28.310705184936523,5134,51,513432,ϲ,Xide,County,3,137676,71151,66525,35163,136343,70035,66308,46692,24863,21829,86216,43941,42275,4768,2347,2421,133238
103.542930603027344,28.279323577880859,5134,51,513437,ײ,Leibo,County,3,207873,109044,98829,51869,203565,105107,98458,67847,35652,32195,130558,68633,61925,9468,4759,4709,203531
105.442550659179688,28.172506332397461,5105,51,510524,,Xuyong,County,3,610652,323176,287476,169210,568125,300033,268092,151146,82584,68562,412182,217275,194907,47324,23317,24007,559975
104.503036499023438,28.167531967163086,5115,51,511527,,Junlian,County,3,366487,190984,175503,91746,349286,181526,167760,109514,60241,49273,232503,118873,113630,24470,11870,12600,332917
105.827804565429688,28.046186447143555,5105,51,510525,,Gulin,County,3,693792,364703,329089,175364,689981,362223,327758,210638,112111,98527,433069,227739,205330,50085,24853,25232,678545
102.829612731933594,28.024440765380859,5134,51,513431,Ѿ,Zhaojue,County,3,207712,107598,100114,52115,206764,106914,99850,69825,37167,32658,131401,67154,64247,6486,3277,3209,202623
101.268829345703125,27.924552917480469,5134,51,513422,ľ,Mulicangzuzhzhixian,County,3,124462,63862,60600,26255,122976,62566,60410,40018,20763,19255,78678,40508,38170,5766,2591,3175,121279
102.804244995117188,27.712940216064453,5134,51,513429,,Butuo,County,3,138604,71716,66888,35706,137922,71152,66770,45060,24781,20279,88414,44474,43940,5130,2461,2669,134194
103.246429443359375,27.700712203979492,5134,51,513430,,Jinyang,County,3,140028,73003,67025,33108,139494,72558,66936,50666,26982,23684,84656,43655,41001,4706,2366,2340,136855
101.51165771484375,27.42167854309082,5134,51,513423,Դ,Yanyuan,County,3,313765,164482,149283,74453,310489,161506,148983,103017,55053,47964,196981,102782,94199,13767,6647,7120,302146
102.172828674316406,27.405424118041992,5134,51,513424,²,Dechang,County,3,188980,97677,91303,49599,186683,96248,90435,51956,27269,24687,126400,65049,61351,10624,5359,5265,173790
102.536018371582031,27.386348724365234,5134,51,513428,ո,Puge,County,3,139156,74180,64976,35619,134745,70037,64708,44549,24095,20454,89317,47448,41869,5290,2637,2653,131170
102.759292602539062,27.076370239257812,5134,51,513427,,Ningnan,County,3,169962,88260,81702,45097,168905,87659,81246,47923,25777,22146,112057,57647,54410,9982,4836,5146,159348
101.915985107421875,26.63752555847168,5104,51,510422,α,Yanbian,County,3,193618,101083,92535,52933,190147,98353,91794,51016,26570,24446,131036,68966,62070,11566,5547,6019,172689
102.099029541015625,26.873472213745117,5104,51,510421,,Miyi,County,3,207300,106501,100799,55782,202815,103480,99335,50105,25775,24330,143628,74111,69517,13567,6615,6952,183403
102.25079345703125,26.657634735107422,5134,51,513425,,Huili,County,3,433185,224284,208901,109653,429265,221779,207486,120246,62499,57747,282486,147234,135252,30453,14551,15902,418356
102.567214965820312,26.643356323242188,5134,51,513426,ᶫ,Huidong,County,3,351310,189263,162047,92525,347733,186179,161554,93091,51733,41358,236048,126515,109533,22171,11015,11156,337281
104.514782991554185,31.306327114211204,5106,51,510626,޽,Luojiang,County,3,237684,122571,115113,79323,233107,119625,113482,43031,22018,21013,174651,90369,84282,20002,10184,9818,218713
105.254035949707031,30.594028472900391,5109,51,510923,Ӣ,Daying,County,3,485842,250487,235355,130251,442963,224726,218237,132088,70562,61526,314535,161931,152604,39219,17994,21225,435221
103.85357666015625,33.305702209472656,5132,51,513225,կ,Jiuzhaigou,County,3,62157,32457,29700,14679,56501,29198,27303,17393,8870,8523,41719,22022,19697,3045,1565,1480,53503
105.376960754394531,29.15550422668457,5105,51,510521,,Lu,County,3,824639,418805,405834,268612,779744,392945,386799,183272,97457,85815,558009,281862,276147,83358,39486,43872,787637
105.913730867063109,32.617582198304383,5108,51,510812,,Chaotian,Qu,3,202984,105276,97708,53652,200150,103557,96593,54238,27736,26502,134933,70887,64046,13813,6653,7160,197291
105.962471008300781,32.319412231445312,5108,51,510811,Ԫ,Yuanba,Qu,3,234541,120898,113643,64305,230108,118194,111914,54665,28104,26561,165972,86046,79926,13904,6748,7156,220976
104.871818542480469,29.273281097412109,5103,51,510311,̲,Yantan,Qu,3,351650,180489,171161,95477,341096,173727,167369,76679,39360,37319,247424,127868,119556,27547,13261,14286,336177
103.534492492675781,29.420730590820312,5111,51,511111,ɳ,Shawan,Qu,3,192156,99924,92232,57774,181757,92749,89008,35147,17886,17261,140041,73446,66595,16968,8592,8376,175634
104.757039184812513,31.494739155335534,5107,51,510704,,Youxian,Qu,3,491561,256006,235555,153683,462181,236666,225515,85274,43580,41694,369446,193905,175541,36841,18521,18320,452431
104.558056170321294,31.545986289852358,5107,51,510724,,An,County,3,484224,248774,235450,159495,478390,245294,233096,99221,51008,48213,347421,179140,168281,37582,18626,18956,463700
105.828824959043587,32.440408934466582,5108,51,510802,,Shizhong,Qu,3,467532,241248,226284,136150,427707,216480,211227,95596,49435,46161,345784,178382,167402,26152,13431,12721,389938
103.71359261419839,29.588070429750161,5111,51,511102,,Shizhong,Qu,3,564857,282612,282245,177111,528531,264341,264190,90337,46216,44121,424564,212419,212145,49956,23977,25979,484064
103.098010177057631,29.32500667566525,5111,51,511113,ں,Jinkouhe,Qu,3,52916,27521,25395,14984,51840,26699,25141,13567,6856,6711,35755,19013,16742,3594,1652,1942,44812
106.084409084907278,30.798094604839299,5113,51,511302,˳,Shunqing,Qu,3,603161,307114,296047,183743,557272,282314,274958,117257,62284,54973,439965,222632,217333,45939,22198,23741,511486
106.072559619076188,30.765508573803686,5113,51,511304,,Jialing,Qu,3,625185,330384,294801,176264,617651,324622,293029,150567,82302,68265,423930,223576,200354,50688,24506,26182,600569
104.757881164550781,31.787351608276367,5107,51,510781,,Jiangyou,City,3,849761,436112,413649,269845,825126,420486,404640,155240,79799,75441,632640,324969,307671,61881,31344,30537,802659
103.619491577148438,31.008604049682617,5101,51,510181,,Dujiangyan,City,3,621980,314845,307135,182424,581105,290835,290270,113579,58068,55511,453669,229162,224507,54732,27615,27117,511467
104.281265258789062,30.985805511474609,5106,51,510681,㺺,Guanghan,City,3,577298,289596,287702,182609,566209,282141,284068,100974,51636,49338,427605,214004,213601,48719,23956,24763,530465
106.76959228515625,30.383262634277344,5116,51,511681,,Huaying,City,3,352257,183962,168295,98430,338672,174770,163902,89409,48033,41376,240938,125425,115513,21910,10504,11406,324863
103.462982177734375,29.618663787841797,5111,51,511181,üɽ,Emeishan,City,3,423070,217201,205869,125852,402179,203869,198310,74965,38358,36607,314197,162212,151985,33908,16631,17277,383712
102.249748229980469,27.88878059387207,5134,51,513401,,Xichang,City,3,615212,318658,296554,174395,579189,295030,284159,152092,79198,72894,422918,219077,203841,40202,20383,19819,540757
101.7440185546875,26.501562118530273,5104,51,510411,ʺ,Renhe,Qu,3,204170,106472,97698,55731,194520,99265,95255,45307,23009,22298,146383,77362,69021,12480,6101,6379,175701
105.470260755917153,28.909885608735223,5105,51,510504,̶,Longmatan,Qu,3,291301,145683,145618,98331,280278,139319,140959,54052,27673,26379,209920,104974,104946,27329,13036,14293,249578
105.567971079313409,30.505492548198433,5109,51,510902,,Shizhong,Qu,3,1355388,696590,658798,369606,1287533,656290,631243,339805,183437,156368,915705,466367,449338,99878,46786,53092,1252098
107.49614143515187,31.219750022744577,5117,51,511702,ͨ,Tongchuan,Qu,3,384525,192819,191706,120309,357517,177954,179563,78983,41048,37935,283199,141300,141899,22343,10471,11872,287358
106.631615829180561,30.473951529451305,5116,51,511602,㰲,Guangan,Qu,3,1093103,561454,531649,324298,1071611,548859,522752,302812,162000,140812,708082,361845,346237,82209,37609,44600,1030861
102.980664826013864,30.00026721853822,5118,51,511802,,Yucheng,Qu,3,334475,171237,163238,99973,311501,158109,153392,62862,32416,30446,243245,124811,118434,28368,14010,14358,287456
106.755033112146677,31.848537634797985,5119,51,511902,,Bazhou,Qu,3,1185862,616323,569539,312339,1173105,607376,565729,327373,181696,145677,778341,395300,383041,80148,39327,40821,1120682
104.647090150074618,30.120548438020641,5120,51,512002,㽭,Yanjiang,Qu,3,1016034,527326,488708,304565,989277,510908,478369,235620,122897,112723,695858,363768,332090,84556,40661,43895,972106
105.458741378496967,28.892785456812099,5105,51,510502,,Jiangyang,Qu,3,536250,269846,266404,170019,502614,251498,251116,103267,53828,49439,384724,193204,191520,48259,22814,25445,469473
103.831459045410156,30.051382257421068,5114,51,511402,,Dongpo,Qu,3,799309,402889,396420,239007,761234,380632,380602,153502,78263,75239,579881,293683,286198,65926,30943,34983,730170
107.495222956925943,31.211933312305575,5117,51,511721,,Da,County,3,1125899,583952,541947,325520,1052551,541968,510583,267072,143501,123571,776263,401777,374486,82564,38674,43890,1045740
117.401817321777344,40.043865203857422,1202,12,120225,,Jixian,County,3,800763,407730,393033,213705,778896,395166,383730,203127,108231,94896,531455,268086,263369,66181,31413,34768,749005
117.302421569824219,39.725894927978516,1202,12,120224,,Baodi,County,3,646947,325063,321884,178523,629930,318132,311798,157020,83285,73735,438145,217378,220767,51782,24400,27382,614420
117.063125610351562,39.378593444824219,1201,12,120114,,Wuqing,Qu,3,814752,409443,405309,227289,790799,397487,393312,165141,85525,79616,588578,294827,293751,61033,29091,31942,763575
117.831497192382812,39.331890106201172,1202,12,120221,,Ninghe,County,3,359247,182410,176837,96343,352497,178918,173579,88469,47581,40888,247411,122896,124515,23367,11933,11434,333201
117.813369750976562,39.248283386230469,1201,12,120108,,Hangu,Qu,3,173723,87064,86659,56134,171211,85729,85482,28890,15174,13716,131054,64984,66070,13779,6906,6873,143199
117.002693176269531,39.145767211914062,1201,12,120111,,Xiqing,Qu,3,433697,229805,203892,122798,368780,185319,183461,67970,34947,33023,339054,181180,157874,26673,13678,12995,305182
117.316734313964844,39.108837127685547,1201,12,120110,,Dongli,Qu,3,442224,228229,213995,132807,400890,201767,199123,72114,37256,34858,344222,178027,166195,25888,12946,12942,281094
117.650848388671875,39.026615142822266,1201,12,120107,,Tanggu,Qu,3,552610,289378,263232,173474,506279,253778,252501,80727,41398,39329,435609,229663,205946,36274,18317,17957,397470
117.365753173828125,38.985111236572266,1201,12,120112,,Jinnan,Qu,3,417254,213173,204081,119821,384625,192170,192455,77125,39583,37542,316127,161701,154426,24002,11889,12113,347230
116.919082641601562,38.934356689453125,1202,12,120223,,Jinghai,County,3,542593,276103,266490,165351,528422,268258,260164,116627,62812,53815,388486,194013,194473,37480,19278,18202,464007
117.45684814453125,38.838939666748047,1201,12,120109,,Dagang,Qu,3,389664,200426,189238,125407,364489,184266,180223,68253,36262,31991,301390,153285,148105,20021,10879,9142,286183
117.12945556640625,39.223850250244141,1201,12,120113,,Beichen,Qu,3,444791,229123,215668,129985,401374,201910,199464,67899,35046,32853,347740,179581,168159,29152,14496,14656,291226
117.184877297803823,39.113744352575814,1201,12,120101,ƽ,Heping,Qu,3,310368,152798,157570,102265,291210,139893,151317,36948,18736,18212,229151,114388,114763,44269,19674,24595,246341
117.244454786442773,39.12344301351704,1201,12,120102,Ӷ,Hedong,Qu,3,720247,363922,356325,239825,684498,338864,345634,90018,45928,44090,558812,283945,274867,71417,34049,37368,502085
117.213973280627499,39.096771695928666,1201,12,120103,,Hexi,Qu,3,779131,397913,381218,248410,706341,347673,358668,89639,45861,43778,608518,313507,295011,80974,38545,42429,537239
117.148853700022116,39.119979206038032,1201,12,120104,Ͽ,Nankai,Qu,3,860104,436525,423579,262363,760485,374566,385919,97988,49963,48025,674865,345032,329833,87251,41530,45721,572269
117.194922339492948,39.171243556727369,1201,12,120105,ӱ,Hebei,Qu,3,633603,320129,313474,206978,599846,296291,303555,77130,39411,37719,486050,247733,238317,70423,32985,37438,411708
117.142618846559898,39.168818891492059,1201,12,120106,,Hongqiao,Qu,3,527013,267141,259872,175262,497648,245533,252115,65990,33555,32435,402576,206313,196263,58447,27273,31174,357330
86.419479370117188,48.059562683105469,6543,65,654324,ͺ,Habahe,County,3,73403,37518,35885,16400,72913,37100,35813,20592,10421,10171,50349,25845,24504,2462,1252,1210,71459
86.861976623535156,47.705654144287109,6543,65,654321,,Buerjin,County,3,61633,31446,30187,14233,61255,31150,30105,17097,8714,8383,42241,21583,20658,2295,1149,1146,60096
85.878387451171875,47.440143585205078,6543,65,654326,ľ,Jimunai,County,3,35462,18313,17149,8655,34664,17628,17036,9843,4994,4849,24564,12789,11775,1055,530,525,33209
87.498252868652344,47.113372802734375,6543,65,654323,,Fuhai,County,3,77830,40936,36894,20137,75766,39006,36760,20049,10289,9760,54821,29021,25800,2960,1626,1334,68945
89.523582458496094,46.99725341796875,6543,65,654322,,Fuyun,County,3,80986,41407,39579,18216,79981,40544,39437,24217,12226,11991,54071,27790,26281,2698,1391,1307,77446
85.729179382324219,46.7939453125,6542,65,654226,Ͳɹ,Hebukesaiermengguzizhixian,County,3,57775,30076,27699,15445,56332,28810,27522,14842,7626,7216,41083,21500,19583,1850,950,900,46149
90.380790710449219,46.673095703125,6543,65,654325,,Qinghe,County,3,53843,27454,26389,11084,53507,27132,26375,17364,8774,8590,34715,17799,16916,1764,881,883,51873
83.6231689453125,46.522922515869141,6542,65,654221,,Emin,County,3,178309,91780,86529,46446,176677,90460,86217,47128,24316,22812,124174,63677,60497,7007,3787,3220,153162
82.973236083984375,46.209987640380859,6542,65,654225,ԣ,Yumin,County,3,48147,25009,23138,12377,47716,24620,23096,12707,6615,6092,33839,17531,16308,1601,863,738,42967
83.602912902832031,45.932159423828125,6542,65,654224,,Tuoli,County,3,79882,40692,39190,18395,79345,40196,39149,25261,12770,12491,52411,26787,25624,2210,1135,1075,70079
81.029632568359375,44.970645904541016,6527,65,652723,Ȫ,Wenquan,County,3,65641,33980,31661,17109,64977,33452,31525,16395,8429,7966,46499,24130,22369,2747,1421,1326,57248
82.074424743652344,44.903530120849609,6527,65,652701,,Bole,City,3,224869,116506,108363,62959,217676,111297,106379,55869,28852,27017,160871,83251,77620,8129,4403,3726,165009
82.883010864257812,44.608646392822266,6527,65,652722,,Jinghe,County,3,133530,69259,64271,35478,131851,67952,63899,35801,18744,17057,92617,47787,44830,5112,2728,2384,99620
84.682952880859375,44.425018310546875,6542,65,654202,,Wusu,City,3,190359,100288,90071,49077,182763,93804,88959,46370,24054,22316,136217,72175,64042,7772,4059,3713,153652
85.615859985351562,44.324142456054688,6542,65,654223,ɳ,Shawan,County,3,188715,99274,89441,49457,179888,92574,87314,44523,22934,21589,136172,72097,64075,8020,4243,3777,154388
86.213584899902344,44.296005249023438,6523,65,652324,˹,Manasi,County,3,170533,89953,80580,48206,164471,84817,79654,37004,19048,17956,125609,66751,58858,7920,4154,3766,134653
86.89825439453125,44.191417694091797,6523,65,652323,ͼ,Hutubi,County,3,210643,110686,99957,58188,199646,103058,96588,48697,25133,23564,152040,80249,71791,9906,5304,4602,155788
87.969818115234375,44.160518646240234,6523,65,652302,,Fukang,City,3,152965,80372,72593,45402,147305,75730,71575,33554,17355,16199,111854,58694,53160,7557,4323,3234,122681
80.867546081542969,44.051719665527344,6541,65,654123,,Huocheng,County,3,333013,171564,161449,84333,329674,168950,160724,88166,45213,42953,229422,117865,111557,15425,8486,6939,285460
89.58203125,44.019130706787109,6523,65,652325,̨,Jitai,County,3,204796,106346,98450,56067,202635,104845,97790,48206,24980,23226,145806,75569,70237,10784,5797,4987,181798
89.176849365234375,43.996189117431641,6523,65,652327,ľ,Jimusaer,County,3,117867,61420,56447,32178,116493,60295,56198,26598,13582,13016,84640,44226,40414,6629,3612,3017,107196
81.521751403808594,43.972324371337891,6541,65,654121,,Yining,County,3,385829,198905,186924,83816,382974,196248,186726,115677,59297,56380,255018,131175,123843,15134,8433,6701,362224
87.649017333984375,43.959144592285156,6523,65,652303,Ȫ,Miquan,City,3,180952,95368,85584,51505,173532,89431,84101,40381,20902,19479,131848,69685,62163,8723,4781,3942,126751
81.318656921386719,43.910881042480469,6541,65,654101,,Yining,City,3,357519,179862,177657,92720,336547,168520,168027,86580,44494,42086,255222,126811,128411,15717,8557,7160,273407
81.149147033691406,43.835987091064453,6541,65,654122,첼,Chabuchaerxibozizhixian,County,3,161834,83552,78282,38579,160590,82482,78108,47475,24350,23125,107632,55592,52040,6727,3610,3117,141669
90.289840698242188,43.8214111328125,6523,65,652328,ľݹ,Muleihasakezizhixian,County,3,78172,40512,37660,19890,77670,40127,37543,20187,10420,9767,54174,28055,26119,3811,2037,1774,70880
87.530217234162606,43.644784757567166,6501,65,650121,³ľ,Wulumuqi,County,3,328536,179059,149477,101237,298973,155719,143254,65343,34446,30897,253607,139654,113953,9586,4959,4627,120261
82.499557495117188,43.784065246582031,6541,65,654128,տ,Nileke,County,3,142513,73584,68929,31111,142225,73329,68896,42984,22307,20677,94786,48657,46129,4743,2620,2123,135251
93.013557434082031,43.592571258544922,6522,65,652222,,Balikunhasakezizhixian,County,3,85964,44068,41896,22049,85232,43447,41785,21481,11005,10476,60380,30972,29408,4103,2091,2012,81417
82.228157043457031,43.479759216308594,6541,65,654124,,Gongliu,County,3,153100,78643,74457,34221,152674,78283,74391,46312,23781,22531,101145,51775,49370,5643,3087,2556,141313
83.256988525390625,43.436592102050781,6541,65,654125,Դ,Xinyuan,County,3,269842,141164,128678,62427,262742,134870,127872,75878,39213,36665,183999,96392,87607,9965,5559,4406,248932
94.681320190429688,43.252964019775391,6522,65,652223,,Yiwu,County,3,17418,9056,8362,4514,16982,8709,8273,4164,2075,2089,12610,6635,5975,644,346,298,16375
81.841316223144531,43.212692260742188,6541,65,654127,ؿ˹,Tekesi,County,3,133900,68451,65449,27603,133521,68142,65379,43740,22459,21281,85878,43633,42245,4282,2359,1923,126449
81.127487182617188,43.157981872558594,6541,65,654126,,Zhaosu,County,3,145027,73946,71081,32605,144270,73286,70984,45509,23180,22329,95627,48684,46943,3891,2082,1809,129411
90.214363098144531,42.860790252685547,6521,65,652122,۷,Shanshan,County,3,196929,102359,94570,45741,188883,95581,93302,53624,26961,26663,135145,71004,64141,8160,4394,3766,168685
88.657135009765625,42.788230895996094,6521,65,652123,пѷ,Tuokexun,County,3,102150,52346,49804,23792,101237,51617,49620,25787,13161,12626,71317,36439,34878,5046,2746,2300,97400
86.386161804199219,42.315994262695312,6528,65,652827,;,Hejing,County,3,161157,83836,77321,45494,157598,80856,76742,39784,20413,19371,113342,58901,54441,8031,4522,3509,140827
86.862968444824219,42.256553649902344,6528,65,652828,˶,Heshuo,County,3,62970,32267,30703,17937,60072,30361,29711,16099,8291,7808,44006,22398,21608,2865,1578,1287,47142
86.560768127441406,42.058574676513672,6528,65,652826,Ȼ,Yanqihuizuzizhixian,County,3,117529,61959,55570,31272,111708,57448,54260,27938,14295,13643,83091,44045,39046,6500,3619,2881,101160
86.638427734375,41.971031188964844,6528,65,652829,,Bohu,County,3,53528,27794,25734,14474,52790,27166,25624,13828,7166,6662,37147,19270,17877,2553,1358,1195,45852
81.86669921875,41.793251037597656,6529,65,652926,ݳ,Baicheng,County,3,203665,105351,98314,47581,201417,103244,98173,64264,32387,31877,129663,67651,62012,9738,5313,4425,182533
84.251190185546875,41.773773193359375,6528,65,652822,̨,Luntai,County,3,91986,47599,44387,24120,90844,46785,44059,23998,12236,11762,63685,32982,30703,4303,2381,1922,80564
82.95074462890625,41.7052001953125,6529,65,652923,⳵,Kuche,County,3,388593,201066,187527,90422,381145,194823,186322,116662,59068,57594,250282,129841,120441,21649,12157,9492,362720
82.600357055664062,41.545688629150391,6529,65,652925,º,Xinhe,County,3,139806,71548,68258,33460,139370,71199,68171,42454,21508,20946,89205,45604,43601,8147,4436,3711,133610
86.263771057128906,41.331844329833984,6528,65,652823,ξ,Weili,County,3,103681,54960,48721,29904,96845,49870,46975,25794,13185,12609,72789,38826,33963,5098,2949,2149,76067
80.244056701660156,41.272869110107422,6529,65,652922,,Wensu,County,3,219219,115111,104108,54633,210979,108655,102324,66048,33757,32291,143110,75653,67457,10061,5701,4360,180053
82.776695251464844,41.218521118164062,6529,65,652924,ɳ,Shaya,County,3,202992,105620,97372,47296,200185,103170,97015,64004,32760,31244,127956,66471,61485,11032,6389,4643,190922
79.229652404785156,41.213226318359375,6529,65,652927,ʲ,Wushen,County,3,177410,91203,86207,40899,176803,90655,86148,62394,31759,30635,107945,55382,52563,7071,4062,3009,172577
78.454994201660156,40.928485870361328,6530,65,653023,,Aheji,County,3,34317,17638,16679,6787,33307,16783,16524,11049,5570,5479,21605,11183,10422,1663,885,778,32137
80.375762939453125,40.631172180175781,6529,65,652928,,Awati,County,3,209654,108585,101069,49347,206834,106397,100437,71164,36744,34420,129570,66671,62899,8920,5170,3750,182704
79.044776916503906,40.503177642822266,6529,65,652929,ƺ,Keping,County,3,38584,20127,18457,7915,37696,19346,18350,13699,7080,6619,23095,12118,10977,1790,929,861,32649
78.562965393066406,39.786777496337891,6531,65,653130,ͳ,Bachu,County,3,375883,198466,177417,86064,362533,185349,177184,124309,63269,61040,233611,124928,108683,17963,10269,7694,349587
75.187202453613281,39.705402374267578,6530,65,653024,ǡ,Wuqia,County,3,42002,21640,20362,9353,41297,21051,20246,13006,6625,6381,27325,14156,13169,1671,859,812,38176
76.740280151367188,39.493869781494141,6531,65,653129,٤ʦ,Jiashi,County,3,311733,159307,152426,71046,310904,158557,152347,115199,58078,57121,178667,91412,87255,17867,9817,8050,309017
76.047561645507812,39.408546447753906,6531,65,653122,,Shule,County,3,284853,145252,139601,65413,282570,143740,138830,102287,52112,50175,166706,84370,82336,15860,8770,7090,271975
75.857650756835938,39.375598907470703,6531,65,653121,踽,Shufu,County,3,345282,177099,168183,73849,344918,176815,168103,125609,63766,61843,203791,104338,99453,15882,8995,6887,341176
76.769645690917969,39.234462738037109,6531,65,653128,պ,Yuepuhu,County,3,129441,66139,63302,29614,128465,65321,63144,44070,22352,21718,77294,39328,37966,8077,4459,3618,124622
75.939811706542969,39.149387359619141,6530,65,653022,,Aketao,County,3,163024,83922,79102,36056,162507,83444,79063,59151,30129,29022,95960,49295,46665,7913,4498,3415,151507
88.17041015625,39.020637512207031,6528,65,652824,Ǽ,Ruoqiang,County,3,28636,15643,12993,8133,26910,14010,12900,6789,3483,3306,20811,11555,9256,1036,605,431,21747
76.173309326171875,38.927455902099609,6531,65,653123,Ӣɳ,Yingjisha,County,3,213338,109205,104133,48012,212951,108853,104098,79661,40261,39400,122605,62397,60208,11072,6547,4525,206313
77.647911071777344,38.900035858154297,6531,65,653127,,Maigaiti,County,3,201810,102731,99079,48911,201334,102343,98991,67030,34077,32953,125155,63198,61957,9625,5456,4169,178841
77.251777648925781,38.413990020751953,6531,65,653125,ɯ,Shache,County,3,620329,316912,303417,140732,614088,312235,301853,218220,111270,106950,371080,187816,183264,31029,17826,13203,591893
77.265876770019531,38.188941955566406,6531,65,653124,,Zepu,County,3,181721,92193,89528,45909,180086,90919,89167,58938,29615,29323,114362,57612,56750,8421,4966,3455,158099
85.527114868164062,38.138301849365234,6528,65,652825,ĩ,Qiemo,County,3,55540,29122,26418,14077,54130,27789,26341,16274,8159,8115,37418,19870,17548,1848,1093,755,45998
77.416984558105469,37.885112762451172,6531,65,653126,Ҷ,Yecheng,County,3,370229,188577,181652,80639,368813,187371,181442,134913,68421,66492,218670,110456,108214,16646,9700,6946,348243
75.225723266601562,37.775669097900391,6531,65,653131,ʲ,Tashenkuergantajikezizhixia,County,3,30454,15657,14797,5060,30044,15279,14765,10723,5436,5287,18396,9470,8926,1335,751,584,29649
78.278999328613281,37.612972259521484,6532,65,653223,Ƥɽ,Pishan,County,3,216024,110663,105361,52824,215470,110223,105247,72468,36809,35659,133226,67977,65249,10330,5877,4453,213434
79.740196228027344,37.266460418701172,6532,65,653222,ī,Moyu,County,3,405634,209070,196564,97846,405110,208614,196496,150791,77583,73208,236159,120575,115584,18684,10912,7772,400456
79.803695678710938,36.876335144042969,6532,65,653221,,Hetian,County,3,261498,134799,126699,61799,260813,134182,126631,96712,49392,47320,152263,77892,74371,12523,7515,5008,259118
80.185897827148438,37.066028594970703,6532,65,653224,,Luopu,County,3,235716,121200,114516,57015,234264,120317,113947,77941,39895,38046,145164,73971,71193,12611,7334,5277,225570
82.689605712890625,37.061183929443359,6532,65,653227,,Minfeng,County,3,32111,16666,15445,8386,31885,16471,15414,9445,4791,4654,21435,11110,10325,1231,765,466,31023
80.802406311035156,37.000598907470703,6532,65,653225,,Cele,County,3,132139,67592,64547,33911,131293,66840,64453,41354,20853,20501,83789,42783,41006,6996,3956,3040,129933
81.666885375976562,36.848957061767578,6532,65,653226,,Yutian,County,3,212061,108769,103292,49517,210234,106992,103242,72226,36416,35810,130089,66438,63651,9746,5915,3831,204685
86.022407531738281,44.308017730712891,6590,65,659001,ʯ,Shihezi,City,3,590115,305253,284862,192056,547097,279590,267507,109501,56140,53361,443151,227954,215197,37463,21159,16304,440331
87.677271615129683,42.856694294375686,6501,65,650107,Ȫ,Nanquan,Qu,3,8815,4952,3863,3339,8269,4438,3831,1600,833,767,6997,3987,3010,218,132,86,5541
84.862907946861327,45.597125026682697,6502,65,650203,,Kelamayi,Qu,3,145452,76605,68847,49954,136505,69261,67244,26117,13496,12621,112911,59070,53841,6424,4039,2385,113593
85.114379378392627,45.681599040862082,6502,65,650204,׼̲,Baijiantan,Qu,3,64297,34513,29784,21296,59470,30267,29203,11876,6150,5726,50862,27333,23529,1559,1030,529,52500
85.679535953983773,46.114835605694367,6502,65,650205,ڶ,Wuerhe,Qu,3,9751,5351,4400,3032,8706,4431,4275,2217,1168,1049,7390,4109,3281,144,74,70,6326
88.142077081090093,47.853038787841797,6543,65,654301,̩,Aletai,City,3,178510,91207,87303,47446,173080,87749,85331,42383,21658,20725,127959,65120,62839,8168,4429,3739,171378
82.982770973705058,46.749890609408212,6542,65,654201,,Tacheng,City,3,149210,76056,73154,41502,143849,73123,70726,34094,17493,16601,108293,54876,53417,6823,3687,3136,116922
84.895604578107566,44.42471415311104,6540,65,654001,,Kuitun,City,3,285299,148740,136559,91443,269036,137122,131914,60005,31090,28915,209005,108299,100706,16289,9351,6938,201667
87.30572620745366,44.015983581542976,6523,65,652301,,Changji,City,3,387169,202275,184894,116144,355972,181884,174088,76510,39469,37041,292217,152595,139622,18442,10211,8231,264626
89.181363154310844,42.94233503171035,6521,65,652101,³,Tulufan,City,3,251652,129183,122469,58361,243707,123220,120487,67736,34347,33389,172791,88997,83794,11125,5839,5286,211013
93.518929482885412,42.818912506103523,6522,65,652201,,Hami,City,3,388714,201005,187709,118694,375321,191282,184039,80066,41316,38750,287051,147659,139392,21597,12030,9567,324498
86.134781407567544,41.76003751606283,6528,65,652801,,Kuerle,City,3,381943,199344,182599,117437,356032,181399,174633,81450,42308,39142,282793,146935,135858,17700,10101,7599,262574
80.260021120620792,41.169302403802462,6529,65,652901,,Akesu,City,3,561822,295811,266011,157845,529262,270753,258509,148198,76451,71747,388956,205404,183552,24668,13956,10712,405757
76.168856603948427,39.717839581372793,6530,65,653001,ͼʲ,Atushen,City,3,200345,101867,98478,41910,197394,100209,97185,66467,33568,32899,125050,63719,61331,8828,4580,4248,183305
75.985995200849402,39.466159820556641,6531,65,653101,ʲ,Kashen,City,3,340640,172136,168504,81262,318700,160462,158238,97844,49920,47924,229347,114546,114801,13449,7670,5779,272244
79.926364627381844,37.110782623291016,6532,65,653201,,Hetian,City,3,186127,94034,92093,46377,175560,87957,87603,57253,28837,28416,122422,61408,61014,6452,3789,2663,121557
87.596525065683736,43.78393441724419,6501,65,650103,ɳͿ,Shayibake,Qu,3,482235,253578,228657,146262,421501,212841,208660,77387,40425,36962,377993,197796,180197,26855,15357,11498,300595
87.619462782567751,43.786990457981624,6501,65,650102,ɽ,Tianshan,Qu,3,471432,238520,232912,139191,410936,203156,207780,78016,40037,37979,368518,185219,183299,24898,13264,11634,322648
87.632210878304207,43.813175135173211,6501,65,650105,ˮĥ,Shuimogou,Qu,3,180654,92723,87931,59310,164727,82286,82441,30237,15557,14680,141862,72257,69605,8555,4909,3646,108161
87.579594817480555,43.841811223575938,6501,65,650104,,XinShi,Qu,3,379220,200310,178910,111173,309327,157089,152238,53126,27534,25592,307555,162011,145544,18539,10765,7774,259072
87.605809750327126,43.900049329897882,6501,65,650108,ɽ,Dongshan,Qu,3,100796,52530,48266,32296,90538,46348,44190,16587,8531,8056,79197,41094,38103,5012,2905,2107,75044
87.341751268112688,43.992887376637228,6501,65,650106,ͷͺ,Toutunhe,Qu,3,130146,68715,61431,43066,122059,62728,59331,23782,12255,11527,99117,52248,46869,7247,4212,3035,95725
84.847309225627654,44.319911046798566,6502,65,650202,ɽ,Dushanzi,Qu,3,50732,27031,23701,17071,45265,22994,22271,8910,4616,4294,39662,21144,18518,2160,1271,889,36878
79.7301025390625,33.404933929443359,5425,54,542524,,Ritu,County,3,7175,3616,3559,1655,7102,3552,3550,2554,1306,1248,4281,2169,2112,340,141,199,6833
80.090217590332031,32.504165649414062,5425,54,542523,,Gaer,County,3,13364,7167,6197,3832,12351,6316,6035,3376,1666,1710,9537,5298,4239,451,203,248,10506
81.119636535644531,32.392265319824219,5425,54,542525,Ｊ,Geji,County,3,12826,6630,6196,2691,12714,6534,6180,4849,2563,2286,7381,3799,3582,596,268,328,12642
84.058486938476562,32.299079895019531,5425,54,542526,,Gaize,County,3,17502,8883,8619,3744,17313,8696,8617,6764,3382,3382,9918,5114,4804,820,387,433,17029
91.670646667480469,32.259513854980469,5424,54,542425,,Anduo,County,3,32843,16575,16268,6489,32666,16416,16250,11948,6000,5948,19472,9989,9483,1423,586,837,31020
92.290390014648438,32.114055633544922,5424,54,542424,,Nierong,County,3,28192,13830,14362,5242,28143,13781,14362,10481,5112,5369,16367,8213,8154,1344,505,839,27935
94.059890747070312,31.92302131652832,5424,54,542429,,Baqing,County,3,35895,17926,17969,5634,35793,17834,17959,13947,6924,7023,20112,10155,9957,1836,847,989,35623
93.779014587402344,31.886972427368164,5424,54,542427,,Suo,County,3,34736,17325,17411,5736,33855,16457,17398,12828,6453,6375,19610,9914,9696,2298,958,1340,34421
86.768218335284416,31.343829748023261,5424,54,542430,,Nima,County,3,34309,17159,17150,6898,33973,16834,17139,12430,6102,6328,20020,10266,9754,1859,791,1068,33513
98.208023071289062,31.506340026855469,5421,54,542122,,Jiangda,County,3,68993,35021,33972,10573,67273,33390,33883,22274,11341,10933,42994,22085,20909,3725,1595,2130,68020
79.802841186523438,31.483720779418945,5425,54,542522,,Zhada,County,3,6384,3265,3119,1379,5897,2834,3063,1930,919,1011,4138,2217,1921,316,129,187,5642
93.681190490722656,31.481416702270508,5424,54,542423,,Biru,County,3,45222,22400,22822,7700,44747,21972,22775,16767,8427,8340,25799,12953,12846,2656,1020,1636,44740
92.056243896484375,31.480192184448242,5424,54,542421,,Naqu,County,3,81786,41525,40261,17195,79202,39594,39608,27528,13729,13799,51102,26516,24586,3156,1280,1876,71875
95.630638122558594,31.41126823425293,5421,54,542125,,Dingqing,County,3,60586,30606,29980,8540,59937,29988,29949,22717,11572,11145,34970,17853,17117,2899,1181,1718,59881
90.020286560058594,31.366695404052734,5424,54,542428,,Bange,County,3,32287,15685,16602,6681,32205,15613,16592,12268,5944,6324,18331,9030,9301,1688,711,977,32124
96.58807373046875,31.216978073120117,5421,54,542124,,Leiwuqi,County,3,40895,20836,20059,6518,39703,19893,19810,14650,7538,7112,23885,12279,11606,2360,1019,1341,39491
97.163444519042969,31.160486221313477,5421,54,542121,,Changdu,County,3,94419,49318,45101,17918,86023,42801,43222,25567,13166,12401,63936,34069,29867,4916,2083,2833,76993
85.155975341796875,31.022945404052734,5425,54,542527,,Cuoqin,County,3,12083,6135,5948,2717,11977,6045,5932,4496,2324,2172,6924,3539,3385,663,272,391,11726
94.698188781738281,30.940202713012695,5421,54,542133,߰,Bianba,County,3,30818,15464,15354,5066,30306,14984,15322,10871,5477,5394,18268,9281,8987,1679,706,973,30231
88.704734802246094,30.931903839111328,5424,54,542426,,Shenzha,County,3,16487,8298,8189,3153,16292,8151,8141,6351,3240,3111,9306,4728,4578,830,330,500,16237
98.270248413085938,30.868379592895508,5421,54,542123,,Gongjue,County,3,43160,21932,21228,7272,41271,20325,20946,12450,6319,6131,28150,14532,13618,2560,1081,1479,41518
95.829330444335938,30.748140335083008,5421,54,542132,¡,Luolong,County,3,41144,20599,20545,6948,40889,20351,20538,15403,7739,7664,23766,12091,11675,1975,769,1206,40328
97.558944702148438,30.660684585571289,5421,54,542126,,Chaya,County,3,53009,26354,26655,8828,52098,25567,26531,18001,9129,8872,31585,15865,15720,3423,1360,2063,51996
93.505119323730469,30.604831695556641,5424,54,542422,,Jiali,County,3,24953,12657,12296,4539,24683,12404,12279,9532,4787,4745,14112,7310,6802,1309,560,749,24670
91.099769592285156,30.486753463745117,5401,54,540122,,Dangxiong,County,3,39169,19429,19740,7116,38740,19191,19549,13866,6932,6934,23137,11646,11491,2166,851,1315,37774
81.181648254394531,30.312555313110352,5425,54,542521,,Pulan,County,3,7919,3945,3974,1817,7815,3846,3969,2408,1217,1191,5056,2540,2516,455,188,267,7760
96.916290283203125,30.053537368774414,5421,54,542127,,Basu,County,3,38170,19298,18872,6435,37455,18631,18824,13344,6704,6640,22949,11845,11104,1877,749,1128,36534
91.2606201171875,29.895347595214844,5401,54,540121,,Linzhou,County,3,50895,25124,25771,9132,49308,24144,25164,15909,8193,7716,31955,15713,16242,3031,1218,1813,49538
93.242683410644531,29.887054443359375,5426,54,542622,,Gongbujiangda,County,3,24971,12597,12374,5422,24796,12453,12343,7673,3868,3805,16081,8189,7892,1217,540,677,24027
95.745040893554688,29.864789962768555,5426,54,542625,,Bomi,County,3,26748,14123,12625,5489,25157,12621,12536,8176,4137,4039,17371,9452,7919,1201,534,667,23143
91.7255859375,29.833454132080078,5401,54,540127,ī񹤿,Mozhugongka,County,3,38920,19688,19232,7634,38525,19394,19131,13674,6981,6693,23320,11888,11432,1926,819,1107,38690
89.093818664550781,29.687108993530273,5423,54,542322,ľ,Nanmulin,County,3,69214,35094,34120,11368,68883,34831,34052,25532,13054,12478,40699,20831,19868,2983,1209,1774,68870
98.586585998535156,29.680418014526367,5421,54,542129,â,Mangkang,County,3,73155,36737,36418,11779,72128,35812,36316,22060,11271,10789,47114,23878,23236,3981,1588,2393,71470
97.843048095703125,29.677556991577148,5421,54,542128,,Zuogong,County,3,41803,21016,20787,7153,40650,20058,20592,13491,6902,6589,26083,13168,12915,2229,946,1283,40809
91.35333251953125,29.671459197998047,5401,54,540126,,Dazi,County,3,24906,12559,12347,5422,24324,12046,12278,7553,3859,3694,16192,8201,7991,1161,499,662,24229
91.019462585449219,29.653041839599609,5401,54,540125,,Duilongdeqing,County,3,40543,20394,20149,9340,38925,18951,19974,11331,5658,5673,27298,13922,13376,1914,814,1100,37677
94.484260559082031,29.584074020385742,5426,54,542621,֥,Linzhi,County,3,38960,20389,18571,11187,35857,18194,17663,9126,4668,4458,28464,15087,13377,1370,634,736,26178
90.162506103515625,29.432380676269531,5401,54,540123,ľ,Nimu,County,3,27375,13464,13911,5069,27193,13335,13858,8006,4046,3960,17974,8829,9145,1395,589,806,26780
88.259162902832031,29.427793502807617,5423,54,542328,лͨ,Xietongmen,County,3,39955,20407,19548,7501,39680,20148,19532,14235,7296,6939,23820,12261,11559,1900,850,1050,39403
90.730941772460938,29.351247787475586,5401,54,540124,ˮ,Qushui,County,3,29690,14780,14910,6676,28973,14255,14718,8101,4110,3991,20158,10040,10118,1431,630,801,28517
85.236701073346978,29.323047737745547,5423,54,542337,,Saga,County,3,11947,6159,5788,2557,11808,6025,5783,4498,2265,2233,6964,3679,3285,485,215,270,11501
87.233894348144531,29.291576385498047,5423,54,542327,,Angren,County,3,45172,22732,22440,8721,45002,22576,22426,16355,8236,8119,26299,13394,12905,2518,1102,1416,44962
90.982276916503906,29.289983749389648,5422,54,542223,,Gongga,County,3,44624,22460,22164,9411,43741,21941,21800,13818,7142,6676,28615,14307,14308,2191,1011,1180,43034
92.023193359375,29.259780883789062,5422,54,542224,ɣ,Sangri,County,3,16033,8093,7940,3861,15858,7932,7926,4843,2523,2320,10397,5252,5145,793,318,475,15275
89.840156555175781,29.231952667236328,5423,54,542330,ʲ,Renbu,County,3,28255,14489,13766,4610,27888,14244,13644,8117,4118,3999,18305,9568,8737,1833,803,1030,28181
91.776870727539062,29.223823547363281,5422,54,542221,˶,Naidong,County,3,58808,29877,28931,15783,55821,27646,28175,14481,7356,7125,41808,21413,20395,2519,1108,1411,50860
91.302619934082031,29.260940551757812,5422,54,542222,,Zhanang,County,3,35278,17512,17766,7107,34502,17048,17454,10474,5246,5228,22851,11353,11498,1953,913,1040,30789
94.199600219726562,29.214300155639648,5426,54,542623,,Milin,County,3,18047,9263,8784,4345,17318,8632,8686,5039,2469,2570,12074,6376,5698,934,418,516,14887
92.582595825195312,29.137483596801758,5422,54,542229,Ӳ,Jiacha,County,3,18263,9078,9185,4490,18118,8963,9155,5251,2647,2604,12023,6009,6014,989,422,567,17612
89.253646850585938,29.10087776184082,5423,54,542329,,Bailang,County,3,40111,20450,19661,6155,39840,20274,19566,13391,6761,6630,24929,12891,12038,1791,798,993,39754
87.635917663574219,29.085145950317383,5423,54,542326,,Lazi,County,3,45895,23175,22720,8238,45583,22923,22660,17061,8749,8312,26781,13528,13253,2053,898,1155,45408
92.205307006835938,29.056972503662109,5422,54,542226,,Qusong,County,3,16037,8227,7810,3750,15382,7651,7731,4988,2467,2521,10385,5475,4910,664,285,379,15038
93.095939636230469,29.045539855957031,5426,54,542627,,Lang,County,3,14283,7228,7055,3537,14079,7051,7028,4277,2196,2081,9283,4731,4552,723,301,422,13725
91.679168701171875,29.028171539306641,5422,54,542225,,Qiongjie,County,3,17031,8253,8778,4057,16872,8139,8733,4608,2281,2327,11488,5580,5908,935,392,543,16650
90.399757385253906,28.968317031860352,5422,54,542233,˿,Langkazi,County,3,32635,16282,16353,6583,32143,15878,16265,10274,5221,5053,20768,10371,10397,1593,690,903,32463
89.598823547363281,28.919807434082031,5423,54,542323,,Jiangzi,County,3,61431,30474,30957,11465,61018,30193,30825,18396,9329,9067,40337,19968,20369,2698,1177,1521,60016
88.008987426757812,28.899250030517578,5423,54,542325,,Sajia,County,3,42590,21613,20977,7298,42304,21382,20922,14367,7296,7071,26375,13490,12885,1848,827,1021,41975
85.315940856933594,28.856679916381836,5423,54,542335,¡,Jilong,County,3,12174,6181,5993,2525,12071,6088,5983,4327,2149,2178,7277,3781,3496,570,251,319,11894
97.47601318359375,28.674919128417969,5426,54,542626,,Chayu,County,3,25939,13177,12762,4951,25356,12642,12714,8059,4083,3976,16581,8538,8043,1299,556,743,23974
87.111053466796875,28.659051895141602,5423,54,542324,,Dingri,County,3,46585,23418,23167,8704,46166,23129,23037,16566,8458,8108,27942,14084,13858,2077,876,1201,45725
89.684577941894531,28.563877105712891,5423,54,542331,,Kangma,County,3,19501,9704,9797,3859,19395,9600,9795,6160,3128,3032,12481,6233,6248,860,343,517,19299
91.43634033203125,28.437246322631836,5422,54,542227,,Cuomei,County,3,13529,6667,6862,3222,13481,6631,6850,3765,1901,1864,9061,4472,4589,703,294,409,13422
92.462959289550781,28.4095458984375,5422,54,542231,¡,Longzi,County,3,32184,15812,16372,7895,31855,15526,16329,9543,4752,4791,21150,10435,10715,1491,625,866,31791
90.860610961914062,28.381462097167969,5422,54,542228,,Luozha,County,3,18407,9061,9346,4439,18267,8924,9343,5366,2712,2654,12153,5993,6160,888,356,532,18179
87.771530151367188,28.36265754699707,5423,54,542332,,Dingjie,County,3,17691,8924,8767,3403,17658,8893,8765,6043,3094,2949,11025,5571,5454,623,259,364,17552
88.525291442871094,28.267610549926758,5423,54,542338,ڰ,Gangba,County,3,9201,4611,4590,1935,9138,4552,4586,2801,1435,1366,6139,3076,3063,261,100,161,8878
85.963279724121094,28.157806396484375,5423,54,542336,ľ,Nielamu,County,3,15479,7982,7497,3414,15102,7677,7425,5176,2646,2530,9684,5074,4610,619,262,357,13614
91.95257568359375,27.993497848510742,5422,54,542232,,Cuona,County,3,15277,7461,7816,4148,15074,7272,7802,3809,1834,1975,10543,5221,5322,925,406,519,14575
88.902076721191406,27.475984573364258,5423,54,542334,Ƕ,Yadong,County,3,12038,5835,6203,3116,11841,5678,6163,3113,1565,1548,8342,4041,4301,583,229,354,10386
95.314231872558594,29.302228927612305,5426,54,542624,ī,Motuo,County,3,9699,5044,4655,1789,9651,5006,4645,3763,1902,1861,5540,2950,2590,396,192,204,9453
84.228729248046875,29.647617340087891,5423,54,542333,ٰ,Zhongba,County,3,17860,8960,8900,3683,17711,8836,8875,6919,3492,3427,10015,5066,4949,926,402,524,17498
88.879226684570312,29.274421691894531,5423,54,542301,տ,Rikaze,City,3,99863,51915,47948,20716,94790,47625,47165,27309,13918,13391,68462,36123,32339,4092,1874,2218,89912
91.132688472934518,29.66037357006789,5401,54,540102,ǹ,Chengguan,Qu,3,223001,117004,105997,66316,187326,92552,94774,38548,19461,19087,178363,94812,83551,6090,2731,3359,114146
103.184791564941406,26.093006134033203,5301,53,530113,,Dongchuan,Qu,3,275564,146168,129396,81122,270864,142712,128152,67988,37014,30974,187171,98601,88570,20405,10553,9852,254168
104.380630493164062,28.625595092773438,5321,53,532131,ˮ,Shuifu,County,3,89973,46970,43003,24814,88306,45639,42667,25102,12959,12143,59262,31433,27829,5609,2578,3031,82034
103.971351623535156,28.582004547119141,5321,53,532127,罭,Suijiang,County,3,141989,73155,68834,36103,141740,72970,68770,47074,24267,22807,85970,44776,41194,8945,4112,4833,136686
98.90313720703125,28.486841201782227,5334,53,533422,,Deqin,County,3,60085,30734,29351,11979,57195,28620,28575,14828,7544,7284,41571,21709,19862,3686,1481,2205,57097
103.658058166503906,28.241361618041992,5321,53,532126,,Yongshan,County,3,362943,191554,171389,98153,362519,191179,171340,117551,64635,52916,223811,116558,107253,21581,10361,11220,346153
104.254501342773438,28.07682991027832,5321,53,532124,ν,Yanjin,County,3,323860,168620,155240,77025,321022,166346,154676,118132,60716,57416,186438,98552,87886,19290,9352,9938,313137
105.029869079589844,27.845390319824219,5321,53,532130,,Weixin,County,3,328184,168006,160178,82449,327676,167608,160068,127870,66791,61079,180394,91609,88785,19920,9606,10314,321019
99.701103210449219,27.807092666625977,5334,53,533421,е,Zhongdian,County,3,147416,77254,70162,31443,131521,66858,64663,36073,18487,17586,104135,55653,48482,7208,3114,4094,128928
103.902450561523438,27.754676818847656,5321,53,532125,,Daguan,County,3,235802,125988,109814,57743,232960,123502,109458,82324,44244,38080,141093,75724,65369,12385,6020,6365,222973
98.657371520996094,27.729759216308594,5333,53,533324,ɽŭ,Gongshandulongzunuzuzhzhixi,County,3,34746,18943,15803,8995,33396,17831,15565,9345,4777,4568,23647,13294,10353,1754,872,882,31845
104.040939331054688,27.6187744140625,5321,53,532129,,Yiliang,County,3,477811,252272,225539,117352,475302,250077,225225,170368,90947,79421,284049,150178,133871,23394,11147,12247,458161
104.856353759765625,27.436487197875977,5321,53,532128,,Zhenxiong,County,3,1097093,569255,527838,270750,1093509,566465,527044,412834,218278,194556,625160,322862,302298,59099,28115,30984,1075606
100.849609375,27.288137435913086,5332,53,533224,,Ninglangyizuzhzhixian,County,3,229204,116738,112466,55999,226288,114534,111754,76527,39724,36803,143491,73068,70423,9186,3946,5240,223336
103.557151794433594,27.19371223449707,5321,53,532122,³,Ludian,County,3,345740,180275,165465,81578,344906,179684,165222,136644,72205,64439,193500,100512,92988,15596,7558,8038,333928
99.280921936035156,27.177358627319336,5334,53,533423,ά,Weixilisuzuzhzhixian,County,3,146017,76463,69554,34430,140718,73570,67148,41587,20994,20593,96648,51836,44812,7782,3633,4149,140274
102.936195373535156,26.919225692749023,5321,53,532123,ɼ,Qiaojia,County,3,461034,250711,210323,120003,460266,250131,210135,129493,74180,55313,302359,162536,139823,29182,13995,15187,441077
98.876670837402344,26.90275764465332,5333,53,533323,,Fugong,County,3,88127,46095,42032,21244,86920,45017,41903,27992,14076,13916,55400,29692,25708,4735,2327,2408,85634
100.232803344726562,26.872318267822266,5332,53,533221,,Lijiangnaxizuzhzhixianxian,County,3,366705,189771,176934,86869,337598,172103,165495,84800,43237,41563,257373,135494,121879,24532,11040,13492,327362
100.737899780273438,26.689332962036133,5332,53,533222,ʤ,Yongsheng,County,3,375769,190537,185232,92248,365112,183935,181177,97296,49199,48097,255943,131617,124326,22530,9721,12809,368886
101.245979309082031,26.63170051574707,5332,53,533223,ƺ,Huaping,County,3,154968,81366,73602,40611,150395,77869,72526,36769,18873,17896,108100,57803,50297,10099,4690,5409,142027
100.169136047363281,26.555070877075195,5329,53,532932,,Heqing,County,3,249030,125069,123961,64258,246755,123392,123363,62947,31821,31126,169342,85726,83616,16741,7522,9219,240333
99.892951965332031,26.532405853271484,5329,53,532931,,Jianchuan,County,3,165900,83654,82246,39240,163836,82076,81760,46753,23721,23032,108142,54955,53187,11005,4978,6027,158987
99.435050964355469,26.469354629516602,5333,53,533325,ƺ,Lanpingbaizupumizuzhzhixian,County,3,196977,103651,93326,47066,191013,98793,92220,56513,29099,27414,129605,69404,60201,10859,5148,5711,183582
103.294639587402344,26.40892219543457,5303,53,530326,,Huize,County,3,844485,457712,386773,234626,836737,451190,385547,225525,131481,94044,561598,297274,264324,57362,28957,28405,824108
104.08514404296875,26.206882476806641,5303,53,530381,,Xuanwei,City,3,1292825,691846,600979,352932,1273116,679190,593926,361431,203427,158004,859714,449847,409867,71680,38572,33108,1233180
99.940544128417969,26.1156005859375,5329,53,532930,Դ,Eryuan,County,3,315003,158600,156403,77093,313834,157850,155984,86243,43254,42989,208248,106134,102114,20512,9212,11300,306665
101.662612915039062,26.066904067993164,5323,53,532327,,Yongren,County,3,103606,54046,49560,27855,102224,53132,49092,23542,11821,11721,72759,38860,33899,7305,3365,3940,97861
98.82952880859375,25.979354858398438,5333,53,533321,ˮ,Lushui,County,3,171974,98342,73632,39313,145005,75513,69492,39489,20178,19311,124012,73963,50049,8473,4201,4272,142457
99.377784729003906,25.890275955200195,5329,53,532929,,Yunlong,County,3,196978,102090,94888,47788,196013,101301,94712,50392,25414,24978,132171,70241,61930,14415,6435,7980,192268
100.570587158203125,25.830270767211914,5329,53,532924,,Binchuan,County,3,324412,166740,157672,82551,320350,163654,156696,82103,41838,40265,220878,115160,105718,21431,9742,11689,307873
101.316612243652344,25.724281311035156,5323,53,532326,Ҧ,Dayao,County,3,279838,143586,136252,75428,277969,142551,135418,62938,31764,31174,195389,101816,93573,21511,10006,11505,271488
101.877952575683594,25.721275329589844,5323,53,532328,Ԫı,Yuanmou,County,3,202779,104326,98453,53276,200263,102477,97786,48605,24788,23817,140621,73818,66803,13553,5720,7833,187681
104.234062194824219,25.688631057739258,5303,53,530325,Դ,Fuyuan,County,3,657474,349788,307686,159310,649493,343170,306323,220506,120122,100384,406267,213625,192642,30701,16041,14660,615764
99.946792602539062,25.668378829956055,5329,53,532922,,Yangbiyizuzhzhixian,County,3,105380,56426,48954,24377,97583,49862,47721,25873,13063,12810,73388,40509,32879,6119,2854,3265,94139
102.467025756835938,25.570623397827148,5301,53,530128,»Ȱ,Luquanyizumiaozuzhzhixian,County,3,429355,223163,206192,111858,423014,218647,204367,110279,58489,51790,288366,150227,138139,30710,14447,16263,419977
103.251052856445312,25.57017707824707,5301,53,530129,Ѱ,Xundianhuizuyizuzhzhixian,County,3,481721,249430,232291,124216,478101,246967,231134,138612,73161,65451,310885,160148,150737,32224,16121,16103,470840
102.416923522949219,25.522560119628906,5323,53,532329,䶨,Wuding,County,3,262601,134598,128003,67734,259533,132389,127144,67378,34330,33048,177800,92232,85568,17423,8036,9387,252849
101.235221862792969,25.512289047241211,5323,53,532325,Ҧ,Yaoan,County,3,199071,102366,96705,53727,196379,100202,96177,48741,24685,24056,135370,70607,64763,14960,7074,7886,191510
100.541595458984375,25.484888076782227,5329,53,532923,,Xiangyun,County,3,437371,223916,213455,119012,433291,220694,212597,107247,54465,52782,298680,154051,144629,31444,15400,16044,422903
99.519340515136719,25.467517852783203,5329,53,532928,ƽ,Yongping,County,3,178438,94735,83703,43736,169984,87245,82739,42454,21544,20910,124345,67782,56563,11639,5409,6230,164100
103.570907592773438,25.436407089233398,5303,53,530321,,Malong,County,3,185766,96343,89423,50328,184127,95082,89045,50713,26438,24275,124496,64410,60086,10557,5495,5062,177091
100.479690551757812,25.348028182983398,5329,53,532925,ֶ,Midu,County,3,296860,151607,145253,78921,295923,150915,145008,71410,36496,34914,203893,104971,98922,21557,10140,11417,288655
103.034645080566406,25.346652984619141,5301,53,530127,,Songming,County,3,330514,169212,161302,86854,319621,160235,159386,85151,43636,41515,218248,112318,105930,27115,13258,13857,308688
101.539955139160156,25.320423126220703,5323,53,532323,Ĳ,Muding,County,3,195322,100146,95176,50294,192864,98315,94549,44492,22764,21728,135929,70472,65457,14901,6910,7991,187413
102.499305725097656,25.233623504638672,5301,53,530124,,Fumin,County,3,140046,71808,68238,39926,135427,68524,66903,30405,15425,14980,98173,50791,47382,11468,5592,5876,128135
100.300193786621094,25.228584289550781,5329,53,532927,Ρɽ,Weishanyizuhuizuzhzhixian,County,3,296124,149231,146893,73228,295040,148485,146555,76898,38427,38471,200344,101854,98490,18882,8950,9932,290080
101.26959228515625,25.197601318359375,5323,53,532324,ϻ,Nanhua,County,3,227970,116760,111210,59977,225909,115293,110616,55613,28358,27255,157286,81353,75933,15071,7049,8022,220776
102.081428527832031,25.160686492919922,5323,53,532331,»,Lufeng,County,3,414258,215319,198939,115313,401646,205149,196497,92458,46730,45728,291980,154486,137494,29820,14103,15717,380982
100.519790649414062,25.0498046875,5329,53,532926,Ͻ,Nanjianyizuzhzhixian,County,3,209887,108294,101593,54582,205805,104973,100832,48646,24692,23954,146603,76954,69649,14638,6648,7990,202716
103.658546447753906,25.034923553466797,5303,53,530322,½,Luliang,County,3,581764,304888,276876,160235,574904,300476,274428,174561,97790,76771,372878,189727,183151,34325,17371,16954,551552
98.501716613769531,25.027719497680664,5330,53,533023,ڳ,Tengchong,County,3,593925,309411,284514,135590,577012,297275,279737,160200,86105,74095,394169,205017,189152,39556,18289,21267,571826
102.467361450195312,24.933307647705078,5301,53,530181,,Anning,City,3,295173,161481,133692,93120,259168,133073,126095,52905,26843,26062,224384,125445,98939,17884,9193,8691,210628
103.151275634765625,24.91771125793457,5301,53,530125,,Yiliang,County,3,396677,202714,193963,114053,381594,191616,189978,86550,43682,42868,277723,143527,134196,32404,15505,16899,358433
102.798957824707031,24.900012969970703,5301,53,530121,ʹ,Chenggong,County,3,180685,96129,84556,49234,152784,76598,76186,34033,17252,16781,133816,73010,60806,12836,5867,6969,133837
104.299453735351562,24.891057968139648,5303,53,530324,ƽ,Luoping,County,3,515211,273990,241221,131759,510751,271030,239721,152561,87228,65333,331882,171799,160083,30768,14963,15805,487315
103.991287231445312,24.83717155456543,5303,53,530323,ʦ,Shizong,County,3,349770,184473,165297,88310,347549,182818,164731,105899,58464,47435,224838,116545,108293,19033,9464,9569,332637
99.5965576171875,24.828166961669922,5330,53,533025,,Changning,County,3,333241,172902,160339,80988,324692,165961,158731,80638,41117,39521,229007,121133,107874,23596,10652,12944,324194
98.302406311035156,24.811023712158203,5331,53,533122,,Lianghe,County,3,150985,77583,73402,35973,149427,76456,72971,44568,22994,21574,97346,50528,46818,9071,4061,5010,145384
103.262588500976562,24.761480331420898,5301,53,530126,ʯ,Shilinyizuzhzhixian,County,3,223978,115442,108536,62976,217317,110612,106705,55935,28734,27201,152103,79067,73036,15940,7641,8299,204094
99.182968139648438,24.728199005126953,5330,53,533022,ʩ,Shidian,County,3,314187,159840,154347,73414,309222,156399,152823,82185,42143,40042,207124,106873,100251,24878,10824,14054,303298
97.944038391113281,24.713312149047852,5331,53,533123,ӯ,Yingjiang,County,3,268992,137680,131312,60335,265276,135211,130065,80981,41868,39113,175986,90786,85200,12025,5026,6999,244011
101.642768859863281,24.69427490234375,5323,53,532322,˫,Shuangbai,County,3,153403,81085,72318,41062,151726,79701,72025,34571,17738,16833,108508,58391,50117,10324,4956,5368,147985
102.595748901367188,24.674612045288086,5301,53,530122,,Jinning,County,3,267739,135387,132352,85069,254582,127963,126619,57117,29064,28053,188910,96134,92776,21712,10189,11523,228841
102.919189453125,24.674526214599609,5304,53,530422,ν,Chengjiang,County,3,149748,75493,74255,42989,145856,72967,72889,38004,19259,18745,100343,50995,49348,11401,5239,6162,136676
102.159065246582031,24.679264068603516,5304,53,530425,,Yimen,County,3,169581,88426,81155,49154,163727,83963,79764,40308,20400,19908,116729,62175,54554,12544,5851,6693,158542
99.900840759277344,24.596160888671875,5335,53,533522,,Fengqing,County,3,426943,222116,204827,97060,418673,215553,203120,107878,55344,52534,292066,154620,137446,26999,12152,14847,416504
98.69183349609375,24.591640472412109,5330,53,533024,,Longling,County,3,260097,137445,122652,62016,255970,134456,121514,65794,36177,29617,175697,92845,82852,18606,8423,10183,249358
103.762725830078125,24.531932830810547,5325,53,532527,,Luxi,County,3,365585,194496,171089,93449,361524,191548,169976,109391,62994,46397,232272,119941,112331,23922,11561,12361,351891
100.829048156738281,24.449228286743164,5327,53,532724,,Jingdongyizuzhzhixian,County,3,352089,185832,166257,88286,326329,171439,154890,73756,38132,35624,255409,136924,118485,22924,10776,12148,338539
100.107383728027344,24.452949523925781,5335,53,533523,,Yun,County,3,416507,222244,194263,98600,405938,213746,192192,102075,53418,48657,289194,157169,132025,25238,11657,13581,395497
98.591438293457031,24.446767807006836,5331,53,533103,º,Luxi,City,3,337406,172038,165368,77924,327107,166256,160851,86857,45169,41688,232257,118536,113721,18292,8333,9959,308352
103.445159912109375,24.405372619628906,5325,53,532526,,Mile,County,3,495642,255795,239847,127433,477141,245078,232063,128772,67665,61107,335220,173954,161266,31650,14176,17474,464376
97.795646667480469,24.201229095458984,5331,53,533124,¤,Longchuan,County,3,170006,87233,82773,41282,167895,85714,82181,49215,25465,23750,112830,58254,54576,7961,3514,4447,156968
102.753944396972656,24.294866561889648,5304,53,530421,,Jiangchuan,County,3,257078,129211,127867,76704,251960,126186,125774,70480,36162,34318,166721,84038,82683,19877,9011,10866,238341
102.930335998535156,24.196023941040039,5304,53,530424,,Huaning,County,3,196519,100776,95743,54799,195513,100087,95426,49366,25265,24101,133597,69181,64416,13556,6330,7226,189488
102.402412414550781,24.182159423828125,5304,53,530426,ɽ,Eshanyizuzhzhixian,County,3,151426,78140,73286,40781,143278,72044,71234,35987,18300,17687,104162,54985,49177,11277,4855,6422,137372
102.759590148925781,24.112714767456055,5304,53,530423,ͨ,Tonghai,County,3,275063,138300,136763,77021,267906,132577,135329,70548,36091,34457,183106,92909,90197,21409,9300,12109,246789
101.986083984375,24.079853057861328,5304,53,530427,ƽ,Xinpingyizudaizuzhzhixian,County,3,264615,138725,125890,69387,257418,132444,124974,61621,31855,29766,187663,100095,87568,15331,6775,8556,237551
105.052696228027344,24.055479049682617,5326,53,532627,,Guangnan,County,3,730376,387000,343376,158351,726826,384177,342649,225982,124085,101897,464567,244622,219945,39827,18293,21534,719601
104.201736450195312,24.046245574951172,5326,53,532626,,Qiubei,County,3,434009,230955,203054,95736,429120,227270,201850,148519,81482,67037,263531,139153,124378,21959,10320,11639,421205
99.255142211914062,24.033695220947266,5335,53,533524,,Yongde,County,3,339918,180820,159098,77371,331201,174372,156829,85743,44535,41208,233479,126968,106511,20696,9317,11379,317971
97.847038269042969,24.020429611206055,5331,53,533102,,Ruili,City,3,155210,80532,74678,41677,137000,68601,68399,34007,17438,16569,115700,60596,55104,5503,2498,3005,101930
99.026527404785156,23.882551193237305,5335,53,533525,,Zhenkang,County,3,182258,99857,82401,36042,163038,85590,77448,49279,25521,23758,124692,70566,54126,8287,3770,4517,155441
100.078086853027344,23.880025863647461,5335,53,533521,ٲ,Lincang,County,3,285163,149469,135694,70456,269964,140089,129875,67356,34723,32633,199396,106317,93079,18411,8429,9982,261128
101.111564636230469,24.007627487182617,5327,53,532726,,Zhenyuanyizuhanizulahuzuzhz,County,3,205709,110388,95321,52491,203633,108940,94693,42308,22638,19670,149250,81054,68196,14151,6696,7455,193836
102.493576049804688,23.719015121459961,5325,53,532525,ʯ,Shiping,County,3,277580,141451,136129,75350,274994,139547,135447,68693,35902,32791,188066,96674,91392,20821,8875,11946,259042
105.611785888671875,23.631229400634766,5326,53,532628,,Funing,County,3,382913,201013,181900,86454,378663,197806,180857,97430,51620,45810,264096,139846,124250,21387,9547,11840,375219
102.827621459960938,23.612592697143555,5325,53,532524,ˮ,Jianshui,County,3,513712,265109,248603,129239,475737,241588,234149,123175,63876,59299,356996,186099,170897,33541,15134,18407,472683
104.345497131347656,23.606428146362305,5326,53,532622,ɽ,Yanshan,County,3,437508,228817,208691,100603,427576,221627,205949,136428,72375,64053,279244,146670,132574,21836,9772,12064,410383
101.995552062988281,23.59857177734375,5304,53,530428,Ԫ,Yuanjianghanizuyizudaizuzhz,County,3,199931,104413,95518,52274,193937,99805,94132,53417,28255,25162,134987,71099,63888,11527,5059,6468,177570
99.39349365234375,23.533235549926758,5335,53,533527,,Gengmadaizuwazuzhzhixian,County,3,313220,173859,139361,63636,264676,136312,128364,83431,42188,41243,217463,125812,91651,12326,5859,6467,241572
100.706825256347656,23.499076843261719,5327,53,532725,ȴ,Jinggudaizuyizuzhzhixian,County,3,288794,155007,133787,72021,271589,145077,126512,64410,34696,29714,205452,111680,93772,18932,8631,10301,269673
99.818931579589844,23.467884063720703,5335,53,533526,˫岼,Shuangjianglahuzuwazubulang,County,3,165982,86307,79675,39422,164356,85119,79237,47534,24442,23092,109460,57828,51632,8988,4037,4951,155513
104.651229858398438,23.449283599853516,5326,53,532623,,Xichou,County,3,236120,125885,110235,59818,234969,125021,109948,58289,30724,27565,159562,87162,72400,18269,7999,10270,231945
101.678672790527344,23.446647644042969,5327,53,532723,ī,Mojianghanizuzhzhixian,County,3,355364,194898,160466,74337,322331,174147,148184,81268,44437,36831,253423,140740,112683,20673,9721,10952,335774
102.414901733398438,23.37226676940918,5325,53,532529,,Honghe,County,3,267627,138983,128644,60573,259381,134279,125102,82096,43933,38163,172254,89063,83191,13277,5987,7290,261351
104.264366149902344,23.372261047363281,5326,53,532621,ɽ,Wenshan,County,3,429639,224563,205076,103911,409273,212762,196511,118570,62133,56437,286100,151141,134959,24969,11289,13680,397535
103.396560668945312,23.356660842895508,5325,53,532522,,Mengzi,County,3,340051,175910,164141,83452,314180,159527,154653,84147,43098,41049,235576,123777,111799,20328,9035,11293,298401
102.835739135742188,23.227825164794922,5325,53,532528,Ԫ,Yuanyang,County,3,362950,195047,167903,81962,348410,185362,163048,99329,57885,41444,244603,128414,116189,19018,8748,10270,351024
99.233619689941406,23.144426345825195,5335,53,533528,Դ,Cangyuanwazuzhzhixian,County,3,202579,114546,88033,39669,162004,84505,77499,50165,25358,24807,145391,85515,59876,7023,3673,3350,151643
104.67822265625,23.132848739624023,5326,53,532624,,Malipo,County,3,267986,143422,124564,66306,264561,140710,123851,69237,36919,32318,180304,98374,81930,18445,8129,10316,260553
101.045997619628906,23.072647094726562,5327,53,532722,ն,Puerhanizuyizuzhzhixian,County,3,188106,99638,88468,50773,178083,93756,84327,40791,21541,19250,133889,71804,62085,13426,6293,7133,169011
104.418411254882812,23.014211654663086,5326,53,532625,,Maguan,County,3,350002,186272,163730,84257,345797,183053,162744,86572,45263,41309,238488,129655,108833,24942,11354,13588,337554
102.391181945800781,22.993640899658203,5325,53,532531,̴,Lvchun,County,3,201256,105428,95828,42696,192862,100260,92602,63824,34695,29129,129279,67078,62201,8153,3655,4498,197709
103.707115173339844,22.97681999206543,5325,53,532523,,Pingbianmiaozuzhzhixian,County,3,149088,78255,70833,34223,135723,71905,63818,38299,19689,18610,102109,54501,47608,8680,4065,4615,139978
100.969413757324219,22.778093338012695,5327,53,532701,˼é,Simao,City,3,230834,120071,110763,64091,209853,108316,101537,48717,25463,23254,170297,88716,81581,11820,5892,5928,161376
103.236785888671875,22.775373458862305,5325,53,532530,ƽ,Jinpingmiaozuyaozudaizuzhzh,County,3,316171,167090,149081,71235,311591,164121,147470,89965,49593,40372,210641,110880,99761,15565,6617,8948,304752
99.615974426269531,22.632383346557617,5327,53,532730,,Ximengwazuzhzhixian,County,3,86598,46165,40433,22282,84252,44254,39998,26519,13669,12850,57685,31341,26344,2394,1155,1239,78848
101.841140747070312,22.594223022460938,5327,53,532727,ǹ,Jiangchenghanizuyizuzhzhixi,County,3,100243,53333,46910,25889,99250,52583,46667,26136,13675,12461,69174,37302,31872,4933,2356,2577,79259
99.934036254882812,22.552013397216797,5327,53,532729,,Lancanglahuzuzhzhixian,County,3,464016,247007,217009,112359,449305,237707,211598,120635,62314,58321,319490,173422,146068,23891,11271,12620,437871
103.981819152832031,22.521381378173828,5325,53,532532,ӿ,Hekouyaozuzhzhixian,County,3,95451,50666,44785,25944,88045,46051,41994,23580,12252,11328,67672,36441,31231,4199,1973,2226,72376
99.584709167480469,22.334203720092773,5327,53,532728,,Mengliandaizulahuzuwazuzhzh,County,3,208593,131152,77441,32423,120757,62693,58064,31828,16233,15595,171910,112365,59545,4855,2554,2301,105605
100.802665710449219,21.956890106201172,5328,53,532801,,Jinghong,City,3,443672,229846,213826,123150,426377,218537,207840,101766,52377,49389,319816,166642,153174,22090,10827,11263,340588
100.458808898925781,21.966365814208984,5328,53,532822,º,Menghai,County,3,314068,162562,151506,74254,309671,159267,150404,83816,42745,41071,212370,111490,100880,17882,8327,9555,286544
101.579872131347656,21.4949951171875,5328,53,532823,,Mengla,County,3,235657,123574,112083,63060,232074,120810,111264,63090,32626,30464,162760,86230,76530,9807,4718,5089,182126
103.809478759765625,25.62455940246582,5303,53,530328,մ,Zhanyi,County,3,389838,205222,184616,104553,376730,193742,182988,99860,52276,47584,265871,140607,125264,24107,12339,11768,358878
102.6370849609375,25.03959846496582,5301,53,530112,ɽ,Xishan,Qu,3,603363,321544,281819,188141,502628,255976,246652,92031,47442,44589,476219,256871,219348,35113,17231,17882,274529
102.747775715828794,25.014194029417002,5301,53,530111,ٶ,Guandu,Qu,3,1398305,757580,640725,406812,1090109,556592,533517,203257,105363,97894,1136560,623722,512838,58488,28495,29993,501819
102.540823937295912,24.361045046437219,5304,53,530402,,Hongta,Qu,3,409044,206139,202905,116173,381384,189846,191538,90040,45638,44402,289915,146756,143159,29089,13745,15344,349734
103.722900390625,27.339622497558594,5321,53,532101,ͨ,Zhaotong,City,3,727959,377931,350028,186477,712882,368606,344276,243015,131400,111615,445740,227696,218044,39204,18835,20369,673455
100.208969116210938,25.589534759521484,5329,53,532901,,Dali,City,3,521169,262564,258605,140260,490009,243634,246375,113947,57955,55992,372326,187776,184550,34896,16833,18063,452639
99.174522399902344,25.11390495300293,5330,53,533001,ɽ,Baoshan,City,3,846865,430076,416789,207563,816167,410879,405288,215444,110516,104928,568664,290862,277802,62757,28698,34059,800415
101.546669006347656,25.037399291992188,5323,53,532301,,Chuxiong,City,3,503682,261315,242367,132171,465517,237452,228065,109449,55840,53609,363039,190205,172834,31194,15270,15924,435535
103.244438171386719,23.706932067871094,5325,53,532502,Զ,Kaiyuan,City,3,292039,152771,139268,80167,266811,134497,132314,65003,33238,31765,211121,112125,98996,15915,7408,8507,241688
103.1614990234375,23.354412078857422,5325,53,532501,,Gejiu,City,3,453311,243377,209934,134553,409623,207012,202611,90808,45671,45137,333202,184053,149149,29301,13653,15648,345744
102.712765323779649,25.051429706457135,5301,53,530103,,Panlong,Qu,3,344754,177622,167132,108442,299314,148258,151056,41708,21247,20461,272055,140444,131611,30991,15931,15060,200019
102.707038688599795,25.048257872299715,5301,53,530102,廪,Wuhua,Qu,3,413420,212182,201238,120528,324168,159599,164569,46710,23851,22859,334464,172289,162175,32246,16042,16204,226748
103.785400256003186,25.501482009887706,5303,53,530302,,Qilin,Qu,3,648956,333756,315200,184813,606381,307155,299226,152368,81124,71244,458760,232828,225932,37828,19804,18024,555110
120.916664123535156,30.84111213684082,3304,33,330421,,Jiashan,County,3,425972,214896,211076,129109,408332,203870,204462,74259,37800,36459,310207,158428,151779,41506,18668,22838,356714
121.011604309082031,30.698259353637695,3304,33,330482,ƽ,Pinghu,City,3,507899,249848,258051,138580,488884,241889,246995,91410,45791,45619,367071,182584,184487,49418,21473,27945,460539
120.543586730957031,30.633455276489258,3304,33,330483,ͩ,Tongxiang,City,3,713399,360567,352832,188926,690867,347794,343073,133031,67885,65146,511437,258542,252895,68931,34140,34791,631395
120.937057495117188,30.513408660888672,3304,33,330424,,Haiyan,County,3,387723,194340,193383,107995,371284,183619,187665,70536,35547,34989,281737,143595,138142,35450,15198,20252,344539
120.296859741210938,30.424386978149414,3301,33,330184,ຼ,Yuhang,City,3,817715,419877,397838,224471,760686,380236,380450,132714,67685,65029,605731,313962,291769,79270,38230,41040,724800
119.718620300292969,30.233724594116211,3301,33,330185,ٰ,Linan,City,3,514238,261852,252386,154564,489312,247049,242263,95383,48402,46981,372775,191206,181569,46080,22244,23836,456529
119.941246032714844,30.047843933105469,3301,33,330183,,Fuyang,City,3,628633,324172,304461,184710,594272,302813,291459,123336,64797,58539,447786,232025,215761,57511,27350,30161,539209
119.666412353515625,29.806499481201172,3301,33,330122,ͩ®,Tonglu,County,3,378060,191283,186777,121070,364560,183956,180604,78256,40698,37558,265056,134239,130817,34748,16346,18402,332383
119.039291381835938,29.602445602416992,3301,33,330127,,Chunan,County,3,382347,190940,191407,136951,376318,187291,189027,85248,43956,41292,258124,128730,129394,38975,18254,20721,353687
120.9080810546875,29.484197616577148,3306,33,330624,²,Xinchang,County,3,414907,215542,199365,145929,395730,204659,191071,71695,38047,33648,303210,157854,145356,40002,19641,20361,347590
121.861770629882812,29.474218368530273,3302,33,330225,ɽ,Xiangshan,County,3,484236,245253,238983,166735,467681,235961,231720,84396,44940,39456,353788,177545,176243,46052,22768,23284,421569
119.87896728515625,29.455583572387695,3307,33,330726,ֽ,Pujiang,County,3,364138,189737,174401,118700,335195,172495,162700,72359,42214,30145,259502,132516,126986,32277,15007,17270,298885
121.4302978515625,29.284774780273438,3302,33,330226,,Ninghai,County,3,518186,264413,253773,176912,499027,253589,245438,97916,54398,43518,372002,186420,185582,48268,23595,24673,431817
118.408958435058594,29.147638320922852,3308,33,330824,,Kaihua,County,3,271611,136977,134634,95366,266709,133917,132792,58985,31659,27326,184830,91511,93319,27796,13807,13989,254787
121.026069641113281,29.137409210205078,3310,33,331023,̨,Tiantai,County,3,407270,204350,202920,142325,399608,199883,199725,93074,50408,42666,272861,134503,138358,41335,19439,21896,370248
121.371665954589844,29.11308479309082,3310,33,331022,,Sanmen,County,3,315405,162537,152868,107974,311217,159535,151682,62934,35010,27924,223538,113196,110342,28933,14331,14602,291095
120.438987731933594,29.041717529296875,3307,33,330727,Ͱ,Panan,County,3,175834,89180,86654,68659,174020,88196,85824,34561,18091,16470,123497,62048,61449,17776,9041,8735,161867
119.177772521972656,29.038026809692383,3308,33,330825,,Longyou,County,3,368157,194193,173964,119114,356453,183447,173006,69828,36324,33504,261914,139238,122676,36415,18631,17784,344121
118.509407043457031,28.910928726196289,3308,33,330822,ɽ,Changshan,County,3,265467,137470,127997,88701,260725,133861,126864,56911,30414,26497,183810,95002,88808,24746,12054,12692,246851
119.807914733886719,28.896295547485352,3307,33,330723,,Wuyi,County,3,301223,156180,145043,107397,293946,151220,142726,58779,30513,28266,210588,109480,101108,31856,16187,15669,267516
120.734596252441406,28.854913711547852,3310,33,331024,ɾ,Xianju,County,3,367585,188197,179388,128621,359797,183176,176621,80673,42770,37903,250864,127899,122965,36048,17528,18520,331548
120.061355590820312,28.64599609375,3311,33,331122,,Jinyun,County,3,362252,187097,175155,128687,354438,181829,172609,75590,39259,36331,248761,128887,119874,37901,18951,18950,333073
121.253829956054688,28.643516540527344,3310,33,331003,,Huangyan,Qu,3,564120,285633,278487,180462,521341,261295,260046,93042,48275,44767,414455,210141,204314,56623,27217,29406,478777
119.267776489257812,28.590751647949219,3311,33,331123,,Suichang,County,3,207087,109014,98073,69111,205724,107980,97744,38767,19988,18779,145013,76830,68183,23307,12196,11111,192421
119.48187255859375,28.449880599975586,3311,33,331124,,Songyang,County,3,197340,102688,94652,67213,194225,101249,92976,40966,21383,19583,135609,70622,64987,20765,10683,10082,183997
120.700279235839844,28.159740447998047,3303,33,330324,,Yongjia,County,3,722390,379334,343056,203199,666683,346062,320621,163231,91249,71982,494516,255583,238933,64643,32502,32141,564451
120.28936767578125,28.146543502807617,3311,33,331121,,Qingtian,County,3,361062,187715,173347,114440,353844,182741,171103,86637,45651,40986,236916,122848,114068,37509,19216,18293,299031
119.565155029296875,28.111007690429688,3311,33,331125,ƺ,Yunhe,County,3,103273,54991,48282,31353,101945,54085,47860,18745,9683,9062,73703,39390,34313,10825,5918,4907,88852
119.6387939453125,27.970876693725586,3311,33,331127,,Jingningshezuzizhixian,County,3,153011,82128,70883,47808,151458,81065,70393,27994,14493,13501,109707,58918,50789,15310,8717,6593,127205
120.081199645996094,27.796005249023438,3303,33,330328,ĳ,Wencheng,County,3,264878,141399,123479,84688,261156,138861,122295,60170,32670,27500,173028,90852,82176,31680,17877,13803,223839
120.559440612792969,27.671136856079102,3303,33,330326,ƽ,Pingyang,County,3,740448,388020,352428,212480,717169,372929,344240,159256,87370,71886,517237,268409,248828,63955,32241,31714,636792
119.051872253417969,27.618854522705078,3311,33,331126,Ԫ,Qingyuan,County,3,179449,92930,86519,54433,177264,91706,85558,37049,19139,17910,128552,66343,62209,13848,7448,6400,160129
119.708381652832031,27.561960220336914,3303,33,330329,̩˳,Taishun,County,3,279799,151402,128397,84340,275279,148342,126937,66936,35594,31342,183184,98371,84813,29679,17437,12242,251276
120.38812255859375,27.510246276855469,3303,33,330327,,Cangnan,County,3,1167589,615972,551617,315503,1144967,600635,544332,274403,153989,120414,811065,420455,390610,82121,41528,40593,1012828
119.691192626953125,30.636089324951172,3305,33,330523,,Anji,County,3,432139,223684,208455,132338,418248,212900,205348,83670,42540,41130,309525,161692,147833,38944,19452,19492,404737
119.958267211914062,30.54212760925293,3305,33,330521,,Deqing,County,3,436524,220492,216032,122176,423401,213298,210103,82353,42144,40209,308546,155251,153295,45625,23097,22528,395740
121.51506429797908,29.836172804970793,3302,33,330227,۴,Yinxian,County,3,854627,432752,421875,303992,790759,398310,392449,134760,70061,64699,648732,329640,319092,71135,33051,38084,612515
118.873374938964844,28.685514450073242,3308,33,330821,,Quxian,County,3,464128,247200,216928,144404,448789,234134,214655,88846,46631,42215,328711,177075,151636,46571,23494,23077,442527
119.478553771972656,28.951141357421875,3307,33,330721,,Jinhua,County,3,475800,251729,224071,168321,449046,231355,217691,85321,44897,40424,341981,183365,158616,48498,23467,25031,449534
122.201193881042116,30.246137067360696,3309,33,330921,ɽ,Daishan,County,3,197483,98280,99203,72401,194931,96720,98211,32829,16677,16152,144702,73134,71568,19952,8469,11483,174671
122.448689736894096,30.725766967322151,3309,33,330922,,Shengsi,County,3,88362,45465,42897,30484,85651,43364,42287,14642,7430,7212,66094,34745,31349,7626,3290,4336,73833
122.298485355411501,29.949142040338302,3309,33,330903,,Putuo,Qu,3,346237,176801,169436,119724,331611,167556,164055,50313,25567,24746,265227,137383,127844,30697,13851,16846,271191
121.226550168483811,28.137760978100381,3310,33,331021,,Yuhuan,County,3,460091,243731,216360,135336,415976,214711,201265,71531,38901,32630,355667,189095,166572,32893,15735,17158,347120
120.692176818847656,30.524892807006836,3304,33,330481,,Haining,City,3,666080,331349,334731,185638,645421,319612,325809,117587,59626,57961,480590,241363,239227,67903,30360,37543,598329
121.239761352539062,30.168289184570312,3302,33,330282,Ϫ,Cixi,City,3,1214537,615279,599258,378363,1100979,550768,550211,197550,101269,96281,914845,465642,449203,102142,48368,53774,931206
120.263984680175781,30.156728744506836,3301,33,330181,ɽ,Xiaoshan,City,3,1233348,613229,620119,369398,1141599,563256,578343,223879,114577,109302,902529,448078,454451,106940,50574,56366,1020561
121.158454895019531,30.045766830444336,3302,33,330281,Ҧ,Yuyao,City,3,852719,429835,422884,278937,822161,411404,410757,150006,77010,72996,616496,311784,304712,86217,41041,45176,740275
120.234062194824219,29.710105895996094,3306,33,330681,,Zhuji,City,3,1070675,535820,534855,339663,993626,494331,499295,191623,99912,91711,775092,385590,389502,103960,50318,53642,894087
121.410453796386719,29.652004241943359,3302,33,330283,,Fenghua,City,3,471558,239252,232306,167325,452090,228914,223176,83104,43909,39195,344298,174329,169969,44156,21014,23142,395385
120.814994812011719,29.589481353759766,3306,33,330683,,Shengzhou,City,3,671221,345614,325607,240772,643468,331527,311941,120543,63891,56652,479836,247441,232395,70842,34282,36560,601669
119.269790649414062,29.477514266967773,3301,33,330182,,Jiande,City,3,473062,242606,230456,152710,466530,238381,228149,105198,56637,48561,323177,164278,158899,44687,21691,22996,435064
120.062995910644531,29.304224014282227,3307,33,330782,,Yiwu,City,3,912670,461103,451567,259711,706158,361202,344956,146690,81648,65042,705603,350631,354972,60377,28824,31553,539940
119.478828430175781,29.218738555908203,3307,33,330781,Ϫ,Lanxi,City,3,607196,314090,293106,200973,588066,302504,285562,123316,67551,55765,423842,218217,205625,60038,28322,31716,559159
120.0228271484375,28.896661758422852,3307,33,330784,,Yongkang,City,3,557067,290946,266121,177415,512369,259647,252722,105677,56276,49401,403985,212349,191636,47405,22321,25084,446068
121.112899780273438,28.845638275146484,3310,33,331082,ٺ,Linhai,City,3,948618,479625,468993,302534,903398,454530,448868,176896,95310,81586,682222,341026,341196,89500,43289,46211,858027
118.625106811523438,28.740964889526367,3308,33,330881,ɽ,Jiangshan,City,3,473222,241301,231921,164028,466939,237278,229661,100855,54502,46353,321122,161505,159617,51245,25294,25951,429779
121.353607177734375,28.363906860351562,3310,33,331081,,Wenling,City,3,1162783,604031,558752,351550,996788,503677,493111,196158,106205,89953,862617,449353,413264,104008,48473,55535,904604
120.957687377929688,28.13067626953125,3303,33,330382,,Leqing,City,3,1162765,605494,557271,305050,1025625,523608,502017,253099,140489,112610,825051,423487,401564,84615,41518,43097,843330
119.123207092285156,28.082565307617188,3311,33,331181,Ȫ,Longquan,City,3,250398,131534,118864,75847,247715,129963,117752,50072,25497,24575,175557,92484,83073,24769,13553,11216,229722
120.626235961914062,27.79132080078125,3303,33,330381,,Ruian,City,3,1207788,627593,580195,310201,1081799,551794,530005,236654,128784,107870,883303,456239,427064,87831,42570,45261,883821
120.878890991210938,30.01231575012207,3306,33,330682,,Shangyu,City,3,722523,354917,367606,237697,709317,347266,362051,144733,73857,70876,502391,246388,256003,75399,34672,40727,674457
121.83538818359375,29.917533874511719,3302,33,330206,,Beilun,Qu,3,382278,196659,185619,128059,335545,167144,168401,56654,29030,27624,291913,151846,140067,33711,15783,17928,276824
120.752044677734375,27.976116180419922,3303,33,330303,,Longwan,Qu,3,204935,110429,94506,39100,133121,69995,63126,24229,13312,10917,173709,93688,80021,6997,3429,3568,75049
121.379463195800781,28.578960418701172,3310,33,331004,·,Luqiao,Qu,3,464997,243607,221390,124533,404218,205771,198447,74862,39802,35060,352421,186061,166360,37714,17744,19970,345201
120.1693601461524,30.227887119256323,3301,33,330102,ϳ,Shangcheng,Qu,3,335050,172635,162415,114425,308084,153553,154531,40132,20599,19533,253635,132799,120836,41283,19237,22046,214219
120.167719875794319,30.278735500356834,3301,33,330103,³,Xiacheng,Qu,3,412406,217574,194832,136907,360016,182616,177400,47832,24864,22968,326853,174095,152758,37721,18615,19106,245429
120.211187040283463,30.300879150190926,3301,33,330104,,Jianggan,Qu,3,565360,308513,256847,170222,448978,230807,218171,62638,33018,29620,467414,258367,209047,35308,17128,18180,266524
120.143935955602146,30.332044286994467,3301,33,330105,,Gongshu,Qu,3,429292,228865,200427,141317,366500,189497,177003,49219,25705,23514,347120,186876,160244,32953,16284,16669,229399
120.112326698257064,30.289437203693101,3301,33,330106,,Xihu,Qu,3,593324,313454,279870,145821,431251,216183,215068,67421,34823,32598,483012,256862,226150,42891,21769,21122,409176
120.196424607060735,30.195901847273745,3301,33,330108,,Binjiang,Qu,3,115887,60062,55825,30263,100629,50124,50505,20031,10086,9945,86830,45771,41059,9026,4205,4821,94025
121.528918134662419,29.859409148507321,3302,33,330203,,Haishu,Qu,3,349739,179327,170412,119952,305312,152258,153054,44769,23362,21407,277236,143016,134220,27734,12949,14785,204848
121.553775385196261,29.861983219987692,3302,33,330204,,Jiangdong,Qu,3,292552,148756,143796,101165,261435,130398,131037,39852,20821,19031,233087,118603,114484,19613,9332,10281,170460
121.527146633948703,29.888611971235239,3302,33,330205,,Jiangbei,Qu,3,271223,140086,131137,89795,232101,117020,115081,35902,18654,17248,213277,110816,102461,22044,10616,11428,187740
121.710589142542929,29.954444161819456,3302,33,330211,,Zhenhai,Qu,3,271707,140022,131685,98946,251309,126935,124374,39610,20305,19305,211529,109771,101758,20568,9946,10622,191238
120.655424874358786,28.024599383906803,3303,33,330302,¹,Lucheng,Qu,3,875006,467579,407427,214763,624139,314063,310076,106263,56461,49802,719229,387183,332046,49514,23935,25579,330399
120.609194403442899,27.962650552879516,3303,33,330304,걺,Ouhai,Qu,3,835607,449993,385614,198394,681913,354538,327375,130014,71893,58121,657006,354539,302467,48587,23561,25026,452222
121.150090913158735,27.840602109661585,3303,33,330322,ͷ,Dongtou,County,3,96435,49416,47019,31110,94099,47553,46546,19932,11119,8813,67669,34292,33377,8834,4005,4829,81183
120.750149911683337,30.751742276838264,3304,33,330402,,Xiucheng,Qu,3,500298,253080,247218,159060,468280,234655,233625,81422,41618,39804,373155,189930,183225,45721,21532,24189,392794
120.758865648079279,30.777889486026094,3304,33,330411,,Xiuzhou,Qu,3,381625,192566,189059,105858,360632,180113,180519,69658,35267,34391,277347,141536,135811,34620,15763,18857,315148
120.098667296884827,30.867595941404744,3305,33,330501,Ͻ,Districts,Qu,3,1145414,573421,571993,311244,1081124,536370,544754,198358,100312,98046,824225,412180,412045,122831,60929,61902,940463
119.911202045067895,31.006944422964807,3305,33,330522,,Changxing,County,3,611518,315743,295775,185670,599568,305694,293874,121370,62513,58857,436479,226063,210416,53669,27167,26502,548593
120.587069049964668,30.011745759791122,3306,33,330602,Խ,Yuecheng,Qu,3,633118,310860,322258,204029,580700,284053,296647,110125,56447,53678,466475,227834,238641,56518,26579,29939,476782
120.473391113361245,30.074785342816661,3306,33,330621,,Shaoxing,County,3,791797,392804,398993,241919,732067,361117,370950,154215,79559,74656,567176,280428,286748,70406,32817,37589,644035
119.643260020990553,29.100612338670857,3307,33,330702,ĳ,Wucheng,Qu,3,424859,216773,208086,137621,357954,181780,176174,61981,32574,29407,333753,169269,164484,29125,14930,14195,279700
118.855890733779432,28.965069076462363,3308,33,330802,³,Kecheng,Qu,3,286271,148054,138217,92920,265078,134674,130404,47348,24556,22792,215911,111701,104210,23012,11797,11215,237322
122.099601913573764,30.01957284240407,3309,33,330902,,Dinghai,Qu,3,369448,185625,183823,128477,345659,172192,173467,55228,28288,26940,279091,141323,137768,35129,16014,19115,275570
121.442026588930389,28.678931477664516,3310,33,331002,,Jiaojiang,Qu,3,462846,237257,225589,144065,428353,215450,212903,81755,43489,38266,341546,174977,166569,39545,18791,20754,365758
119.91239710002003,28.455280046020533,3311,33,331102,,Liandu,Qu,3,348241,178908,169333,115937,324718,167613,157105,66353,34514,31839,249559,127620,121939,32329,16774,15555,279118
120.222421787326255,29.265286032961125,3307,33,330783,,Dongyang,City,3,753094,375565,377529,251829,702105,346485,355620,148711,80998,67713,528736,259427,269309,75647,35140,40507,654063
