chname,ename,gbcode,a100009_10,a100010_10,a100003_10,a100004_10,a100011_10,a100007_10,a100008_10,a100006_10,a100005_10,a100002_10,a100001_10
Žֵ,DongHuaMenJieDao,110101001,50163,6741,30849,14842,33646,22142,4462,19804,41946,30517,61366
ɽֵ,JingShanJieDao,110101002,32036,5144,20562,14781,27331,19451,3128,18161,37612,19746,40308
ڽֵ,JiaoDaoKouJieDao,110101003,40397,4976,23012,16026,35070,21007,3823,19453,40460,26184,49196
Žֵ,AnDingMenJieDao,110101004,35326,5231,22513,16151,30916,21388,3801,20076,41464,21845,44358
Žֵ,BeiXinQiaoJieDao,110101005,66434,9672,42032,28871,60744,39090,6167,36844,75934,40241,82273
Ľֵ,DongSiJieDao,110101006,35203,4773,22545,14788,28753,19773,3755,18086,37859,21186,43731
Žֵ,ZhaoYangMenJieDao,110101007,29074,4318,18842,12747,24054,17176,3310,15575,32751,17860,36702
Žֵ,JianGuoMenJieDao,110101008,48001,5925,27349,15081,32156,20046,3244,18933,38979,29821,57170
ֱŽֵ,DongZhiMenJieDao,110101009,36557,6304,23372,16680,28855,20772,3157,19054,39826,22646,46018
ƽֵ,HePingLiJieDao,110101010,85784,16951,57198,40225,68753,51992,9323,47220,99212,54860,112058
�ֵֽ,XiChangAnJieJieDao,110102001,42076,5559,25689,17538,27864,22035,3842,20421,42456,25788,51477
½ֿڽֵ,XinJieKouJieDao,110102003,76379,11177,48164,33611,52618,44028,7941,41083,85111,47333,95497
ֵ̳,YueTanJieDao,110102007,88634,18715,59430,39284,71604,52800,9194,47055,99855,57113,116543
չ·ֵ,ZhanLanLuJieDao,110102009,103608,17766,65853,42921,70629,56527,9551,52311,108838,65072,130925
ʤֵ,DeShengJieDao,110102010,88697,17326,59239,41234,68631,54067,10745,50823,104890,57529,116768
ڽֵֽ,JinRongJieJieDao,110102011,55874,6998,29421,19221,43252,25067,5016,23189,48256,38467,67888
ʲɲֵ,ShiChaHaiJieDao,110102012,77047,10653,47900,34495,54358,43003,7733,40133,83136,47533,95433
ǰŽֵ,QianMenJieDao,110103001,10512,1585,6160,4447,7972,5705,827,5491,11196,6764,12924
ֵ,ChongWenMenWaiJieDao,110103002,40801,4886,25107,16507,22247,20847,3130,18994,39841,23710,48817
нֵ,DongHuaShiJieDao,110103003,43034,5769,27166,19477,23008,23815,3972,22009,45824,25609,52775
̶ֵ,LongTanJieDao,110103004,43355,7744,29177,21300,33894,28039,5158,25684,53723,27080,56257
·ֵ,TiYuGuanLuJieDao,110103005,31810,5812,20457,14304,28017,19409,2681,18469,37878,19846,40303
ֵ̳,TianTanJieDao,110103006,40230,7024,25577,16134,36043,23158,3050,21831,44989,24727,50304
ֵ,YongDingMenWaiJieDao,110103007,68175,10317,42857,32041,51117,41826,6201,40377,82203,41836,84693
դֵ,DaShanLanJieDao,110104001,30420,4009,18820,14731,21386,17409,2568,16582,33991,18177,36997
Žֵ,TianQiaoJieDao,110104002,36812,6377,23921,16851,26082,21317,3196,19763,41080,22464,46385
ֵ,ChunShuJieDao,110104003,25268,3191,14121,10545,17685,12984,2088,12142,25126,16426,30547
Ȼֵͤ,TaoRanTingJieDao,110104004,34563,5641,22079,16249,25812,20771,3251,19235,40006,21376,43455
㰲ڽֵ,GuangAnMenNeiJieDao,110104005,57849,10550,37954,27789,45373,35458,5293,32945,68403,35738,73692
ţֵֽ,NiuJieJieDao,110104006,41172,7128,26665,19487,29072,24656,3577,22898,47554,25212,51877
ֵֽ,BaiZhiFangJieDao,110104007,75175,13739,48994,35727,57425,46372,6823,43519,89891,46743,95737
㰲ֵ,GuangAnMenWaiJieDao,110104008,147239,18462,90894,69635,75733,84359,13835,79369,163728,88642,179536
ӵ,QingHeDiQu,110104400,9988,323,1601,1767,3098,1504,247,1841,3345,8957,10558
ֵ,JianWaiJieDao,110105001,29006,3892,17483,11570,13797,13822,1794,12677,26499,17209,34692
ֵ,ChaoWaiJieDao,110105002,33022,4670,19613,13355,17255,16045,2307,15225,31270,20386,39999
¥ֵ,HuJiaLouJieDao,110105003,48772,9265,30659,20783,33970,26260,3551,24316,50576,30929,61588
ͽֵ,SanLiTunJieDao,110105004,27023,5775,17689,11804,18713,15507,2596,13497,29004,17705,35394
ׯֵ,ZuoJiaZhuangJieDao,110105005,63219,12104,41301,29265,42094,36377,4926,33914,70291,38948,80249
԰ֵ,XiangHeYuanJieDao,110105006,41492,7221,26398,21159,23823,24507,3167,23382,47889,25482,51880
ƽֵֽ,HePingJieJieDao,110105007,88132,14117,55238,33507,64330,41403,6157,39626,81029,53168,108406
ֵ,AnZhenJieDao,110105008,53815,10514,35627,24262,31201,29576,4125,27289,56865,32827,68454
˴ֵ,YaYunCunJieDao,110105009,58316,9835,35929,25956,29431,29527,4264,28441,57968,36486,72415
Сؽֵ,XiaoGuanJieDao,110105010,58007,7010,37204,19089,30622,23450,3346,22345,45795,31159,68363
Žֵ,JiuXianQiaoJieDao,110105011,44285,13773,30914,24358,44697,30084,4069,30021,60105,31213,62127
ӵֵ,MaiZiDianJieDao,110105012,26927,3209,16758,10717,12457,12503,1605,11231,23734,14983,31741
Žֵ,TuanJieHuJieDao,110105013,28893,6563,19390,14639,21369,17746,2218,16289,34035,18284,37674
ͽֵ,LiuLiTunJieDao,110105014,91295,11333,47663,38844,55097,43565,5315,41201,84766,60280,107943
ׯֵ,BaLiZhuangJieDao,110105015,85458,14707,55050,41734,55348,50893,7377,47784,98677,52492,107542
˫ֵ,ShuangJingJieDao,110105016,79947,10775,49476,46265,41721,47551,6176,44894,92445,47422,96898
ɽֵ,JinSongJieDao,110105017,85592,14045,54167,40837,48402,49231,7346,46096,95327,52816,106983
˼԰ֵ,PanJiaYuanJieDao,110105018,89459,16715,57524,44216,59066,54167,6941,51719,105886,55591,113115
ͷֵ,FaTouJieDao,110105019,45406,5287,26800,20623,19204,25147,4179,25232,50379,28072,54872
ĥ´,NanMoFangDiQuBanShiChu,110105021,112623,7594,62735,45514,37768,53426,9627,52048,105474,67109,129844
߱´,GaoBeiDianDiQuBanShiChu,110105022,102226,7160,56824,46956,32437,50215,8708,50480,100695,61270,118094
̨´,JiangTaiDiQuBanShiChu,110105023,63546,3759,33224,33483,15855,29623,4036,32090,61713,38117,71341
̫�´,TaiYangGongDiQuBanShiChu,110105024,59907,5597,34148,27489,24155,30492,4863,30231,60723,36219,70367
ͽֵ,DaTunJieDao,110105025,119390,11463,72674,45561,48808,54681,10580,51195,105876,68759,141433
ֵ,WangJingJieDao,110105026,142574,12004,85312,55590,56849,66678,13589,62986,129664,82855,168167
Сŵ´,XiaoHongMenDiQuBanShiChu,110105027,49973,2668,26714,22374,20337,25235,5110,27066,52301,31037,57751
ʮ´,ShiBaLiDianDiQuBanShiChu,110105028,176808,5226,86591,72704,30056,74942,18850,85038,159980,114293,200884
ƽ´,PingFangDiQuBanShiChu,110105029,102641,4581,56515,49757,23497,53491,13383,57785,111276,64090,120605
´,DongFengDiQuBanShiChu,110105030,75144,5059,40714,37947,21762,39395,6322,42050,81445,45811,86525
˴ֵ,AoYunCunJieDao,110105031,86331,9382,52107,37846,32753,45561,9550,43590,89151,53156,105263
Ӫ´,LaiGuangYingDiQuBanShiChu,110105032,104460,6635,60156,44272,29605,52905,12570,51799,104704,63509,123665
Ӫ´,ChangYingDiQuBanShiChu,110105033,40043,2984,24664,19485,14921,23281,5443,22540,45821,23806,48470
䷿´,SanJianFangDiQuBanShiChu,110105034,109819,8131,64667,44212,48211,48128,8233,49277,97405,61516,126183
ׯ´,GuanZhuangDiQuBanShiChu,110105035,87861,7316,50297,40869,35371,47993,10230,49255,97248,55110,105407
յ´,JinZhanDiQuBanShiChu,110105036,50852,2086,23711,20215,16627,20528,4680,24378,44906,33907,57618
ӵ´,SunHeDiQuBanShiChu,110105037,21094,1135,9692,5651,9656,7748,1647,7982,15730,14184,23876
޸ׯ´,CuiGeZhuangDiQuBanShiChu,110105038,91623,2654,45166,49895,16965,42063,7719,50512,92575,56830,101996
ӵ´,DongBaDiQuBanShiChu,110105039,75398,4369,40068,32955,24217,36933,8774,40383,77316,48473,88541
ׯ´,HeiZhuangHuDiQuBanShiChu,110105040,49662,3274,24805,18500,16587,20271,4321,22169,42440,32452,57257
ׯ´,DouGeZhuangDiQuBanShiChu,110105041,27262,1749,14744,10582,8693,13428,3524,13167,26595,17791,32535
Ӫ´,WangSiYingDiQuBanShiChu,110105042,75672,2125,36532,31933,16187,27905,6597,33443,61348,47862,84394
׶ֵ,ShouDuJiChangJieDao,110105400,16957,2453,10479,7790,10922,8536,1102,8241,16777,10033,20512
ֵ,DongHuJieDao,110105501,51422,5512,32793,23282,22642,29981,7140,28063,58044,31281,64074
ҰŽֵ,YouAnMenJieDao,110106001,68636,9540,42718,32202,35146,38907,5760,37610,76517,41218,83936
̫ƽŽֵ,TaiPingQiaoJieDao,110106002,52955,5798,32083,24061,20546,28609,4835,27992,56601,31505,63588
԰ֵ,XiLuoYuanJieDao,110106003,65582,12771,42535,32295,40716,41222,5077,39549,80771,40895,83430
Žֵ,DaHongMenJieDao,110106004,161343,15444,95623,72962,53994,90903,16595,90219,181122,97759,193382
Էֵ,NanYuanJieDao,110106005,39191,3910,23684,18118,19323,21801,4975,21111,42912,24392,48076
ߵؽֵ,DongGaoDiJieDao,110106006,30257,11022,22141,16926,32168,21207,3633,20633,41840,22771,44912
Ӫֵ,DongTieJiangYingJieDao,110106007,118826,16147,73113,56696,61533,67972,9921,65638,133610,71781,144894
¬Žֵ,LuGouQiaoJieDao,110106008,149614,14326,89860,69666,53020,84153,17726,82450,166603,91806,181666
ֵ̨,FengTaiJieDao,110106009,115172,16095,71435,51516,79575,67365,12918,62048,129413,72750,144185
´ֵ,XinCunJieDao,110106010,132965,10925,78994,53862,49683,67220,15467,66926,134146,80363,159357
ֵ,ChangXinDianJieDao,110106011,61851,11733,40079,30133,53961,38363,7055,36476,74839,40560,80639
Ƹڽֵ,YunGangJieDao,110106012,23312,6337,16147,12367,24842,15627,3062,15329,30956,16564,32711
ׯ´,FangZhuangDiQuBanShiChu,110106013,66371,11090,42251,33665,32547,38663,5993,36491,75154,41203,83454
ƽǵ´,WanPingChengDiQuBanShiChu,110106014,40710,2987,22795,18546,15653,21788,5483,23306,45094,26385,49180
ұֵ,MaJiaBaoJieDao,110106015,99308,10632,60396,47357,37316,57679,9655,55950,113629,59199,119595
ֵ,HeYiJieDao,110106016,33383,3900,20138,14525,14457,18763,3194,18325,37088,20339,40477
,ChangXinDianZhen,110106100,39748,3168,22567,16926,27784,21716,5070,22719,44435,25419,47986
,WangZuoZhen,110106101,44029,3703,25510,16820,31303,24178,6076,24803,48981,28298,53808
¬,LuGouQiaoXiang,110106201,149541,6899,80901,63592,50137,71643,17250,75914,147557,92789,173690
,HuaXiang,110106202,122218,6332,66344,52738,43086,61238,14491,66306,127544,76697,143041
Է,NanYuanXiang,110106203,125456,4216,64670,60195,30813,56667,10483,63050,119717,75485,140155
˱ɽֵ,BaBaoShanJieDao,110107001,42946,4969,26651,20187,17876,25083,5691,24330,49413,26955,53606
ɽֵ,LaoShanJieDao,110107002,33510,5628,20882,14930,21418,19533,3468,19533,39066,21724,42606
˽ǽֵ,BaJiaoJieDao,110107003,95740,11676,56255,38513,51516,47519,9000,46369,93888,60161,116416
ųǽֵ,GuChengJieDao,110107004,49113,5914,26685,20299,27072,24383,4756,24836,49219,33098,59783
ƻ԰ֵ,PingGuoYuanJieDao,110107005,82862,9119,51384,38355,45059,48273,9794,46271,94544,50391,101775
𶥽ֵֽ,JinDingJieJieDao,110107006,61270,8694,38552,26915,45644,37076,5772,35968,73044,37184,75736
ֵ,GuangNingJieDao,110107009,13831,1792,8171,6589,9115,7838,1772,7913,15751,9224,17395
ֵ,WuLiTuoJieDao,110107010,25193,2089,14561,9301,12659,12203,3180,11137,23340,15901,30462
³Ƚֵ,LuGuJieDao,110107011,78497,7642,46571,36597,32410,43783,9316,43901,87684,48884,95455
׸Ǩ,ShouGangQianAnKuangQu,110107400,18361,1988,10133,8221,6040,9940,2500,10268,20208,12716,22849
·ֵ,WanShouLuJieDao,110108001,131857,22079,90894,54763,117002,80416,18520,70231,150647,81562,172456
·ֵ,YongDingLuJieDao,110108002,38097,7825,22916,11999,31538,16821,3424,16628,33449,26430,49346
򷻵ֵ,YangFangDianJieDao,110108003,98815,17212,65493,45509,73717,59673,11107,52860,112533,61641,127134
ʼҿڽֵ,GanJiaKouJieDao,110108004,93034,16275,60834,37031,71091,49368,9146,46120,95488,57621,118455
ׯֵ,BaLiZhuangJieDao,110108005,112242,12592,69873,44135,63360,53938,11150,51768,105706,66111,135984
Ժֵ,ZiZhuYuanJieDao,110108006,117302,13506,73023,33784,91094,42778,7603,40209,82987,65388,138411
¹ؽֵ,BeiXiaGuanJieDao,110108007,132139,16298,77274,41893,97757,53388,10339,50775,104163,81502,158776
̫ƽׯֵ,BeiTaiPingZhuangJieDao,110108008,174120,16631,99561,51113,106344,62105,10863,59652,121757,102053,201614
ѧԺ·ֵ,XueYuanLuJieDao,110108010,212764,17448,118013,53657,131975,65238,13095,64171,129409,125294,243307
йشֵ,ZhongGuanCunJieDao,110108011,130621,15505,75788,39409,78197,52678,13511,51553,104231,83849,159637
ֵ,HaiDianJieDao,110108012,124436,10155,68269,34941,76772,43797,10109,41318,85115,76431,144700
Žֵ,QingLongQiaoJieDao,110108013,110902,8852,61082,49773,54403,49524,9133,50970,100494,67805,128887
廪԰ֵ,QingHuaYuanJieDao,110108014,43914,5354,21243,9275,36305,12180,2517,11912,24092,30542,51785
԰ֵ,YanYuanJieDao,110108015,33431,2707,16737,5742,23242,6925,1410,6650,13575,20811,37548
ɽֵ,XiangShanJieDao,110108016,24617,2110,13877,11510,9953,10715,1808,10521,21236,14658,28535
ӽֵ,QingHeJieDao,110108017,115126,9040,67403,46439,46086,57512,15586,56226,113738,72349,139752
԰·ֵ,HuaYuanLuJieDao,110108018,121716,17386,71904,43142,83619,54806,9727,49390,104196,76925,148829
ֵ,XiSanQiJieDao,110108019,120368,10614,70429,47924,49611,58795,13144,57979,116774,73697,144126
ݽֵ,MaLianWaJieDao,110108020,90730,6520,51455,41726,34616,42793,9335,44283,87076,55130,106585
·ֵ,TianCunLuJieDao,110108021,88337,7941,53035,42503,35555,49947,10466,48346,98293,53709,106744
ϵؽֵ,ShangDiJieDao,110108022,92783,3195,44312,30287,22421,27987,6127,30151,58138,57793,102105
´,WanLiuDiQuBanShiChu,110108023,25816,599,11929,12556,4092,10188,1647,12481,22669,16133,28062
´,DongShengDiQuBanShiChu,110108024,42358,2336,23300,15403,12055,18451,5158,19581,38032,26552,49852
ֵ,ShuGuangJieDao,110108025,84769,7258,51430,30306,38957,40361,10370,36961,77322,50967,102397
Ȫ,WenQuanZhen,110108101,40537,5060,23578,16617,20521,20974,5203,21542,42516,27222,50800
ļ,SiJiQingZhen,110108102,151496,7688,76738,51435,44608,54039,11395,55352,109391,93841,170579
,XiBeiWangZhen,110108103,125635,4559,62560,45980,28241,47717,12470,52668,100385,80104,142664
ռ,SuJiaTuoZhen,110108104,37743,4611,22476,13820,28491,19793,4432,19603,39396,24310,46786
ׯ,ShangZhuangZhen,110108105,36869,3706,20719,13704,19374,17958,4239,18464,36422,24095,44814
ֵ,DaYuJieDao,110109001,62723,9509,40769,28945,45303,40099,8181,38438,78537,39644,80413
ӽֵ,ChengZiJieDao,110109002,27156,4067,17517,12587,19316,17326,3332,16645,33971,17038,34555
ֵ,DongXinFangJieDao,110109003,21172,3494,13723,9916,19684,13592,2669,13206,26798,13612,27335
ֵ̨,DaTaiJieDao,110109004,9127,1046,4749,4452,5231,4674,1123,5382,10056,6547,11296
ƽ´,WangPingDiQuBanShiChu,110109005,4772,1247,3168,2851,4995,3129,494,3088,6217,3345,6513
̶,TanZheSiZhen,110109101,6817,908,4161,3310,7452,4137,947,4170,8307,4511,8672
,YongDingZhen,110109102,34503,3132,20061,14118,23370,19291,4811,19421,38712,22385,42446
Ȫ,LongQuanZhen,110109103,26149,2267,15940,12158,17365,15720,3733,15630,31350,16209,32149
ׯ,JunZhuangZhen,110109104,9980,1335,6035,4460,9142,5975,1201,5921,11896,6481,12516
,YanChiZhen,110109105,4991,1135,3069,2678,5828,3053,461,3257,6310,3518,6587
ի,ZhaiTangZhen,110109106,8398,1435,5239,4417,9702,5206,984,5370,10576,5578,10817
ˮ,QingShuiZhen,110109107,5888,1256,3727,3488,7057,3687,762,4055,7742,4179,7906
ɽ,MiaoFengShanZhen,110109108,7222,1174,4533,3629,8074,4480,875,4504,8984,4738,9271
ǹؽֵ,ChengGuanJieDao,110111001,76654,7661,47250,33415,58404,46157,11928,45718,91875,48993,96243
ֵ,XinZhenJieDao,110111002,5993,2172,4230,4017,5637,4131,677,4241,8372,4612,8842
ֵ,XiangYangJieDao,110111004,6889,811,4297,3431,5629,4045,869,3787,7832,4272,8569
ֵ,DongFengJieDao,110111005,19652,2270,11663,9516,16877,11551,2399,11580,23131,12658,24321
ӭֵ,YingFengJieDao,110111006,24736,3205,15743,12583,22782,14969,3352,14681,29650,15550,31293
ǳǽֵ,XingChengJieDao,110111007,17053,3353,11041,8604,19417,10966,1455,10744,21710,10820,21861
´,LiangXiangDiQuBanShiChu,110111008,15288,1575,9035,5266,13076,8333,2115,8460,16793,9943,18978
ܿڵ´,ZhouKouDianDiQuBanShiChu,110111009,34668,3628,20699,13718,30661,20187,4544,20268,40455,22141,42840
ӵ´,LiuLiHeDiQuBanShiChu,110111010,47560,6738,29777,19436,50142,28295,5633,28480,56775,30154,59931
ֵ,GongChenJieDao,110111011,109411,9244,64554,43343,57611,55008,13665,53287,108295,67766,132320
ºֵ,XiLuJieDao,110111012,51256,4225,32458,21905,27573,31575,9276,30554,62129,32299,64757
ִ,YanCunZhen,110111101,39469,3265,23013,15476,27124,21992,6039,22582,44574,25760,48773
,DouDianZhen,110111103,54236,5310,31937,18296,33901,25574,6028,25523,51097,33637,65574
ʯ¥,ShiLouZhen,110111104,23192,2654,14137,8905,24858,13866,3056,14032,27898,14765,28902
,ChangYangZhen,110111105,54590,3550,29127,17933,26351,24967,6856,25479,50446,35869,64996
ӱ,HeBeiZhen,110111107,15415,2395,9922,7564,16887,9817,2067,9712,19529,9955,19877
,ChangGouZhen,110111108,19232,2161,11794,7048,21718,11706,2398,11785,23491,11997,23791
ʯ,DaShiWoZhen,110111109,24311,3409,15418,10915,28386,15278,3419,15319,30597,15721,31139
ŷ,ZhangFangZhen,110111110,14493,2099,9174,6486,16803,9088,1854,9045,18133,9272,18446
ʮ,ShiDuZhen,110111111,7423,1426,4885,4096,8463,4720,929,4686,9406,4893,9778
,QingLongHuZhen,110111112,36255,3753,21374,14486,34958,20723,4590,21213,41936,23224,44598
,HanCunHeZhen,110111115,31485,3510,19279,11467,35021,19001,4215,19251,38252,19931,39210
ϼ,XiaYunLingXiang,110111208,5268,1115,3477,2905,6753,3460,757,3550,7010,3663,7140
Ͻ,NanJiaoXiang,110111209,2811,486,1844,1627,3493,1842,442,1846,3688,1895,3739
ׯ,FoZiZhuangXiang,110111210,6659,1195,4429,3708,8053,4372,1071,4332,8704,4496,8925
ɽ,DaAnShanXiang,110111211,9001,677,4444,4031,5792,4373,1539,5067,9440,6773,11217
ʷӪ,ShiJiaYingXiang,110111212,4892,611,2887,2621,5671,2870,797,3233,6103,3413,6300
,PuWaXiang,110111213,1652,589,1231,1214,2351,1231,231,1238,2469,1241,2472
вֵֽ,ZhongCangJieDao,110112001,46530,5858,28683,21695,28724,27120,5162,26171,53291,28867,57550
»ֵ,XinHuaJieDao,110112002,7041,1033,4524,3447,5527,4425,817,4269,8694,4367,8891
Էֵ,BeiYuanJieDao,110112003,59647,6415,37227,28080,24926,34141,7361,32526,66667,36196,73423
Žֵ,YuQiaoJieDao,110112004,52470,4537,32292,24220,24178,31181,7475,30029,61210,32190,64482
˳´,YongShunDiQuBanShiChu,110112005,163482,13014,97366,72017,48221,85964,18698,85486,171450,97828,195194
԰´,LiYuanDiQuBanShiChu,110112006,116295,8619,69945,56030,38171,65943,15606,65483,131426,70575,140520
ׯ,SongZhuangZhen,110112104,87513,7904,48317,31530,55907,42144,8726,43844,85988,55826,104143
ż,ZhangJiaWanZhen,110112105,74969,7361,43114,32709,52732,40328,6943,40618,80946,46159,89273
t,KuoXianZhen,110112106,49596,6524,29338,22582,46020,28172,5293,29067,57239,32075,61413
,MaJuQiaoZhen,110112109,94757,5476,50028,33363,40842,36480,6815,38404,74884,57020,107048
,XiJiZhen,110112110,34560,5475,21101,14436,36548,20623,3209,20498,41121,22143,43244
̨,TaiHuZhen,110112114,85552,5435,44483,31629,42922,36183,8052,38939,75122,54556,99039
ֵ,YongLeDianZhen,110112117,31890,4752,19730,13568,34857,19306,3599,19450,38756,20511,40241
º,LuChengZhen,110112119,59673,6188,34671,25553,36453,32430,6750,33407,65837,37940,72611
ڼ,YuJiaWuHuiZuXiang,110112209,22082,2787,12904,8250,21421,12227,2315,12680,24907,14280,27184
ʤֵ,ShengLiJieDao,110113001,27512,3483,17811,13122,14115,16897,3863,15719,32616,17047,34858
ֵ,GuangMingJieDao,110113002,44151,3651,27673,19386,19541,26262,6929,24964,51226,27058,54731
ʺ͵´,RenHeDiQuBanShiChu,110113003,41950,2761,22372,17514,15700,20123,4293,21794,41917,26632,49004
ɳ´,HouShaYuDiQuBanShiChu,110113004,34898,1918,18764,15627,12279,17117,3977,18582,35699,22029,40793
õ´,TianZhuDiQuBanShiChu,110113005,29377,1412,16373,11442,6881,12626,2553,13540,26166,16969,33342
´,YangZhenDiQuBanShiChu,110113006,43815,5709,27095,16570,39492,25111,4882,25424,50535,27311,54406
ţɽ´,NiuLanShanDiQuBanShiChu,110113007,30287,2834,16782,9812,21461,13561,2668,13748,27309,19007,35789
Ϸŵ´,NanFaXinDiQuBanShiChu,110113008,22592,891,11546,9980,5560,10411,2670,12242,22653,14607,26153
µ´,MaPoDiQuBanShiChu,110113009,9141,799,4792,3169,5506,4289,910,4574,8863,6058,10850
ʯ԰ֵ,ShiYuanJieDao,110113010,39023,3731,24049,16641,13644,22950,5777,21993,44943,24482,48531
ո۽ֵ,KongGangJieDao,110113011,36498,2924,21348,14948,11660,18652,4392,18515,37167,22466,43814
˫ֵ,ShuangFengJieDao,110113012,19903,1318,11591,6154,7137,7715,1654,7980,15695,11284,22875
Ȫֵ,WangQuanJieDao,110113013,36697,2388,21374,14817,12087,20622,5300,20282,40904,23011,44385
Ӫ,GaoLiYingZhen,110113101,37546,2798,20521,16447,20526,19437,4117,21031,40468,23940,44461
,LiQiaoZhen,110113104,58938,4927,32945,24582,31361,30041,5965,31659,61700,36885,69830
,LiSuiZhen,110113105,16144,2267,9857,6081,16122,9510,1635,9493,19003,10189,20046
ϲ,NanCaiZhen,110113106,42276,3996,24000,18088,30481,23318,4367,24857,48175,26639,50639
,BeiWuZhen,110113108,9057,1354,5459,3737,8293,5245,1002,5369,10614,5954,11413
ׯ,DaSunGeZhuangZhen,110113109,18866,3273,11990,7807,20707,11552,2084,11723,23275,12233,24223
,ZhangZhen,110113110,18886,2588,11398,7300,18174,10910,2162,11268,22178,12238,23636
,LongWanTunZhen,110113111,12207,1893,7603,4890,12972,7385,1357,7484,14869,7854,15457
ľ,MuLinZhen,110113112,26514,4026,16242,10928,27612,16052,3017,16650,32702,17315,33557
СӪ,BeiXiaoYingZhen,110113113,30863,3475,18187,11508,28047,17574,3621,18136,35710,19772,37959
ʯ,BeiShiCaoZhen,110113115,12418,1838,7388,4494,11343,6624,1130,6752,13376,7998,15386
ȫӪ,ZhaoQuanYingZhen,110113116,24760,3178,14255,9570,19959,13400,2544,13889,27289,16227,30482
Ǳֵ,ChengBeiJieDao,110114001,157952,11855,91490,56566,83097,72181,17421,69032,141213,95738,187228
Ͽڵ´,NanKouDiQuBanShiChu,110114002,56546,5750,32141,20734,36655,26522,5515,26207,52729,35670,67811
ؿڵ´,MaChiKouDiQuBanShiChu,110114003,64171,3642,32939,18197,28059,23818,6092,25365,49183,40966,73905
ɳӵ´,ShaHeDiQuBanShiChu,110114004,99172,4676,48942,25015,32482,30111,6960,31403,61514,61866,110808
Ͻֵ,ChengNanJieDao,110114005,49074,2656,27594,17733,14485,21896,6397,22790,44686,30533,58127
۵´,HuiLongGuanDiQuBanShiChu,110114006,261109,16170,142884,100572,44707,114627,29032,118065,232692,163427,306311
Сڵ´,DongXiaoKouDiQuBanShiChu,110114007,307687,20625,174608,120881,36820,143771,31103,146732,290503,184807,359415
,YangFangZhen,110114104,19205,1853,11514,7336,13126,10368,2643,9877,20245,12187,23701
Сɽ,XiaoTangShanZhen,110114110,46333,4836,25923,17369,24074,21766,4568,22345,44111,29814,55737
,NanShaoZhen,110114111,19850,1634,11211,6929,13096,10191,2696,10213,20404,12969,24180
޴,CuiCunZhen,110114112,17476,1947,9446,5924,11578,8077,1896,8225,16302,11873,21319
,BaiShanZhen,110114113,18045,1672,9905,6047,11853,8607,1945,8835,17442,11757,21662
߼,BeiQiJiaZhen,110114115,239826,9597,110928,67955,28180,69107,13900,74142,143249,152395,263323
,XingShouZhen,110114116,26599,3660,15577,10345,23719,14295,2880,14655,28950,17562,33139
,ChangLingZhen,110114117,11620,1968,7301,4732,12963,6966,1436,7247,14213,7723,15024
,LiuCunZhen,110114118,13831,2381,8367,5886,14593,7929,1688,8556,16485,9533,17900
ʮ,ShiSanLingZhen,110114119,17484,1856,10425,4646,11940,7192,1571,7180,14372,10486,20911
˷ֵ,XingFengJieDao,110115001,47395,4409,25558,17075,23560,22991,5674,22094,45085,31920,57478
У·ֵ,LinXiaoLuJieDao,110115002,40337,4424,25903,17136,21462,23818,6156,23007,46825,25014,50917
Դֵ,QingYuanJieDao,110115003,83441,7639,50584,31847,30205,43358,11322,41636,84994,51818,102402
ׯ´,YiZhuangDiQuBanShiChu,110115004,46293,3823,26230,16600,22820,22347,5202,21821,44168,29088,55318
ƴ´,HuangCunDiQuBanShiChu,110115005,144834,5712,74233,57664,44674,64625,17898,72791,137416,94211,168444
ɹ´,JiuGongDiQuBanShiChu,110115006,168494,9767,89976,73345,24043,75400,15324,80595,155995,103609,193585
ŵ´,XiHongMenDiQuBanShiChu,110115007,124640,4925,61753,46743,19840,48011,11790,54478,102489,79602,141355
孺´,YingHaiDiQuBanShiChu,110115008,42847,2293,21963,14222,17657,17908,4472,19040,36948,27649,49612
½ֵ,GuanYinSiJieDao,110115009,60704,5329,33136,23684,18555,28984,7028,29536,58520,39925,73061
칬Ժֵ,TianGongYuanJieDao,110115010,18418,1721,9695,6641,6671,8359,2294,8287,16646,12738,22433
Ƶ,QingYunDianZhen,110115103,58998,3742,31871,18779,31312,25929,6417,27707,53636,37286,69157
,CaiYuZhen,110115104,28026,3193,15531,10375,26850,14905,2854,15268,30173,18542,34073
,AnDingZhen,110115105,23933,2842,14529,8509,26361,14273,3188,14684,28957,15434,29963
,LiXianZhen,110115106,25729,3492,16419,10475,28385,16293,4126,16446,32739,16928,33347
,YuFaZhen,110115107,45871,4790,28093,14262,40008,23136,5341,23100,46236,27909,56002
Ӹׯ,PangGeZhuangZhen,110115108,37652,3821,22466,13849,36056,21152,5159,22135,43287,24166,46632
갴,BeiZangCunZhen,110115109,26614,1721,13845,9767,15162,12124,3189,12969,25093,17679,31524
κׯ,WeiShanZhuangZhen,110115110,36410,3223,19554,12065,27648,18070,4079,19089,37159,24158,43712
Ӫ,ZhangZiYingZhen,110115111,27168,2703,15129,10322,23390,14506,3114,15615,30121,17856,32985
ü�,BeiJingJingJiJiShuKaiFaQu,110115403,66534,2772,30074,11796,4326,14572,3806,13832,28404,43038,73112
Ȫӽֵ,QuanHeJieDao,110116001,43913,3274,27518,18485,26440,26096,7284,24506,50602,26953,54471
ɽֵ,LongShanJieDao,110116002,35464,3239,22180,15504,22925,21410,5500,20425,41835,22023,44203
´,HuaiRouDiQuBanShiChu,110116003,55315,3213,30301,26584,22553,29053,7957,31810,60863,36184,66485
ܵ´,YanQiDiQuBanShiChu,110116004,21723,1660,11190,10330,10023,10502,2550,11754,22256,14743,25933
ǵ´,MiaoChengDiQuBanShiChu,110116005,27996,2372,15401,12320,16310,14858,3659,16211,31069,18626,34027
,BeiFangZhen,110116102,19562,2078,11365,8877,13769,11069,2901,11933,23002,13176,24541
,YangSongZhen,110116103,19620,2087,11308,8420,13209,10343,2935,11191,21534,13334,24642
,QiaoZiZhen,110116105,17089,2755,10534,8074,15701,10239,2070,10607,20846,11380,21914
,HuaiBeiZhen,110116106,9847,1447,5828,4142,8357,5430,1181,5638,11068,6647,12475
ӿ,TangHeKouZhen,110116107,4630,1071,2989,2444,5252,2876,671,3046,5922,3383,6372
,BoHaiZhen,110116108,10170,2331,6869,5270,12113,6664,1515,6814,13478,7147,14016
Ŷɺ,JiuDuHeZhen,110116109,10930,2503,7442,5355,14161,7405,1773,7686,15091,7764,15206
,LiuLiMiaoZhen,110116110,4330,1050,2662,2130,5051,2622,558,2820,5442,3276,5938
ɽ,BaoShanZhen,110116111,5986,1367,3878,2588,7268,3787,891,4065,7852,4366,8244
Ӫ,ChangShaoYingManZuXiang,110116211,4665,1170,3181,2505,5747,3068,735,3170,6238,3389,6570
ȹ,LaBaGouMenManZuXiang,110116213,3493,891,2297,1877,4115,2212,511,2277,4489,2598,4895
ܾÿ,YanQiJingJiKaiFaQu,110116400,2773,48,990,739,23,564,134,761,1325,1965,2955
ӽֵ,BinHeJieDao,110117001,35328,3549,22879,16223,28041,22153,6020,21006,43159,22018,44897
˹Ƚֵ,XingGuJieDao,110117002,43671,2960,25649,18658,26573,23842,6369,25006,48848,27351,53000
´,YuYangDiQuBanShiChu,110117003,44831,4363,27449,19389,35183,26681,6821,27232,53913,28566,56015
ڵ´,YuKouDiQuBanShiChu,110117004,20622,3293,12903,8991,22024,12535,2578,12796,25331,13590,26493
�´,MaFangDiQuBanShiChu,110117005,14197,2124,8510,5158,15245,8153,1628,8331,16484,9439,17949
𺣺´,JinHaiHuDiQuBanShiChu,110117006,20723,3474,13103,8526,24584,12905,2638,13255,26160,13732,26835
ߴ,DongGaoCunZhen,110117101,21861,3481,13547,8837,24674,13336,2603,13889,27225,14398,27945
ɽׯ,ShanDongZhuangZhen,110117102,12937,1971,7970,5324,13785,7747,1531,8131,15878,8469,16439
϶ֺ,NanDuLeHeZhen,110117104,15999,2500,9984,6559,18221,9790,1950,10205,19995,10465,20449
ɽ,DaHuaShanZhen,110117105,12590,2308,7980,5599,14898,7884,1498,8266,16150,8416,16396
ĸׯ,XiaGeZhuangZhen,110117106,16513,2452,9981,6293,17446,9416,1993,9755,19171,10977,20958
Ӫ,MaChangYingZhen,110117108,13205,1720,7958,4590,13437,7177,1378,7447,14624,8345,16303
ׯ,WangXinZhuangZhen,110117110,23110,3632,14386,9375,24865,14067,2944,14579,28646,15300,29686
ׯ,DaXingZhuangZhen,110117111,13514,2165,8458,5376,15033,8121,1618,8395,16516,8839,17297
ҵ,LiuJiaDianZhen,110117112,5765,1163,3691,2751,6718,3663,581,3669,7332,3818,7509
Ӫ,ZhenLuoYingZhen,110117114,6693,1324,4307,3038,8210,4294,858,4448,8742,4568,8875
,HuangSongYuXiang,110117213,4284,720,2610,1834,4726,2537,494,2656,5193,2888,5498
ܶկ,XiongErZhaiXiang,110117214,2566,521,1670,1174,3118,1669,327,1722,3391,1744,3414
¥ֵ,GuLouJieDao,110228001,83144,7447,52488,37908,62289,51231,13888,49713,100944,51991,104479
԰ֵ,GuoYuanJieDao,110228002,43076,3153,26519,18900,23671,25002,6611,24524,49526,26321,52840
̴Ӫ´,TanYingDiQuBanShiChu,110228003,6119,451,3738,2969,3133,3723,1001,3765,7488,3833,7571
,MiYunZhen,110228100,15308,1064,8857,7712,7920,8675,2350,9259,17934,9865,18722
Ϫׯ,XiWengZhuangZhen,110228101,15127,2535,9650,8941,16155,9335,2149,9388,18723,10161,19811
ׯ,XiTianGeZhuangZhen,110228102,27656,4662,17800,14019,32129,17550,3738,17978,35528,18256,36056
ʮﱤ,ShiLiPuZhen,110228103,20581,2043,11871,10635,15326,11582,2462,12317,23899,13215,25086
կ,HeNanZhaiZhen,110228104,19079,2595,11821,8432,18829,11286,2393,11588,22874,12246,24067
޸ׯ,JuGeZhuangZhen,110228105,17742,2906,11184,8059,19249,10928,2369,11144,22072,11833,23017
¼,MuJiaYuZhen,110228106,26081,3395,16207,12876,25697,15705,3669,15776,31481,16938,33145
̫ʦ,TaiShiTunZhen,110228107,20441,3568,13580,11246,22726,13210,3302,13317,26527,13731,27311
,GaoLingZhen,110228108,10493,2052,7016,6120,13358,6985,1641,7077,14062,7170,14186
,BuLaoTunZhen,110228109,11226,2920,7877,6556,15037,7873,1664,7899,15772,7933,15810
,FengJiaYuZhen,110228110,4818,1187,3144,2490,5940,3117,635,3218,6335,3496,6640
ű,GuBeiKouZhen,110228111,5957,1017,3960,2877,7416,3952,958,3953,7905,3972,7932
,DaChengZiZhen,110228112,8282,1926,5829,4385,11011,5816,1440,5765,11581,5819,11648
,DongShaoQuZhen,110228113,9377,1727,5942,5585,11111,5891,1172,6192,12083,6334,12276
ׯ,BeiZhuangZhen,110228114,5714,1059,3821,3016,6501,3732,996,3868,7600,3948,7769
³,XinChengZiZhen,110228115,5599,1485,3982,3444,7376,3910,909,3915,7825,4011,7993
ʯ,ShiChengZhen,110228116,3994,779,2688,2494,5094,2669,680,2692,5361,2765,5453
ҵ,GongYeKaiFaQu,110228400,5801,14,3218,829,1,478,53,686,1164,2650,5868
,YanQingZhen,110229100,101240,9014,62280,45311,82810,60832,15405,60209,121041,63379,125659
ׯ,KangZhuangZhen,110229101,28187,2899,16622,9216,22562,12754,2401,12924,25678,16865,33487
˴,BaDaLingZhen,110229102,6354,791,3796,2503,6287,3571,949,3646,7217,4298,8094
,YongNingZhen,110229103,18528,3079,11729,8327,22180,11683,2468,12237,23920,12346,24075
,JiuXianZhen,110229104,15329,2517,9594,7040,17620,9578,2086,10302,19880,10338,19932
ɽӪ,ZhangShanYingZhen,110229105,18249,3054,11472,7942,21296,11237,2466,11662,22899,12297,23769
ĺ,SiHaiZhen,110229106,4445,908,2877,2130,5812,2871,648,3095,5966,3124,6001
ǧҵ,QianJiaDianZhen,110229107,7075,1329,4624,3190,9158,4621,1059,4811,9432,4839,9463
Ӫ,ShenJiaYingZhen,110229108,9427,1372,5892,4226,10434,5841,1222,6026,11867,6129,12021
,DaYuShuZhen,110229109,18519,1609,10493,4870,12904,7169,1502,7363,14532,11137,21630
ׯ,JingZhuangZhen,110229110,8014,1532,5079,3790,9597,5013,1100,5368,10381,5567,10646
ׯ,DaZhuangKeXiang,110229207,3853,782,2557,1677,5103,2554,641,2697,5251,2719,5276
,LiuBinBaoXiang,110229209,4360,956,2932,2011,5817,2927,772,3149,6076,3156,6088
Ӫ,XiangYingXiang,110229210,5858,1131,3756,2770,7171,3745,793,3971,7716,4026,7782
Ȫ,ZhenZhuQuanXiang,110229214,2563,537,1681,1167,3340,1673,403,1794,3467,1822,3503
Ȱҵֵ,QuanYeChangJieDao,120101001,47197,6931,28619,18907,32029,23019,5423,22067,45086,30932,59551
С¥ֵ,XiaoBaiLouJieDao,120101002,24395,4756,15059,11052,20633,13635,1831,13014,26649,15923,30982
ݽֵ,TiYuGuanJieDao,120101003,32053,5598,20261,12861,27519,16969,3770,15555,32524,21160,41421
˽ֵ,XinXingJieDao,120101004,47433,8459,32080,19901,42106,26420,4451,24107,50527,28263,60343
Ӫֵ,NanYingMenSheQuJieDao,120101005,36786,7001,23340,16095,29923,21461,3519,19523,40984,23966,47306
нֵ,NanShiJieDao,120101006,27162,3804,15923,11336,22485,15230,2908,14565,29795,17951,33874
ׯֵ,DaiWangZhuangJieDao,120102001,52482,9071,33847,24277,44132,30633,4061,28631,59264,31767,65614
ֱֵ,DaZhiGuJieDao,120102002,71534,11426,44725,33792,59014,43905,5900,42475,86380,44135,88860
ɽŽֵ,ZhongShanMenJieDao,120102003,75845,12505,47890,34908,72905,47351,6412,46045,93396,46872,94762
·ֵ,FuMinLuJieDao,120102004,36394,5451,22462,16033,26881,21708,3574,20880,42588,22957,45419
Žֵ,ErHaoQiaoJieDao,120102005,49190,7388,30048,22274,35931,28589,4969,28600,57189,31499,61547
ֵ,ChunHuaJieDao,120102006,56148,8059,35344,26158,46140,34854,5622,33316,68170,34485,69829
Ƽҿڽֵ,TangJiaKouJieDao,120102007,60883,7062,34119,21344,52052,28436,4900,27181,55617,38726,72845
¥ֵ,XiangYangLouJieDao,120102008,64756,9261,41106,29669,54354,40537,6661,38644,79181,39572,80678
ݵֵ,ChangZhouDaoJieDao,120102009,41526,6417,25679,18977,34333,25320,3504,24662,49982,25768,51447
Ϻ·ֵ,ShangHangLuJieDao,120102010,53317,7129,32304,23590,40389,32053,5718,31411,63464,33860,66164
½ֵ,DongXinJieDao,120102011,71650,13311,44811,33450,78917,43594,5848,43432,87026,45998,90809
³ɽֵ,LuShanDaoJieDao,120102012,34800,3804,20947,14751,17880,20648,4505,20518,41166,22162,43109
ֵ,TianJinTieChangJieDao,120102013,23092,2398,14539,11321,23645,14325,4279,14383,28708,15230,29769
ӪŽֵ,DaYingMenJieDao,120103001,22100,4150,14786,10141,19489,13341,2108,12218,25559,13572,28358
߷ֵ,XiaWaFangJieDao,120103002,39432,6441,25471,17631,35188,23375,3894,21468,44843,24296,49767
԰ֵ,TaoYuanJieDao,120103003,41763,5731,27856,16153,36999,21618,3567,19894,41512,23205,51061
Ҽ½ֵ,GuaJiaSiJieDao,120103004,70629,11157,44771,31876,63802,43343,6404,40142,83485,43419,88190
�ֵ,MaChangJieDao,120103005,43085,7857,27883,17719,34950,24344,4007,22369,46713,27066,54949
Խ·ֵ,YueXiuLuJieDao,120103006,60792,10369,35989,25356,53024,33846,5248,31537,65383,40420,76409
·ֵ,YouYiLuJieDao,120103007,61253,11413,40002,29514,54065,38190,5217,35581,73771,37881,77883
ֵ,TianTaJieDao,120103008,66315,12679,41536,29557,54613,37303,4759,35070,72373,42217,83753
ɽֵ,JianShanJieDao,120103009,75526,9530,47215,29342,49997,37113,6711,36473,73586,44552,91767
ׯֵ,ChenTangZhuangJieDao,120103010,47639,7325,29330,21585,38377,27936,4292,27473,55409,29926,59256
ֵֽ,LiuLinJieDao,120103011,86477,9687,53597,26928,66703,34883,5515,34716,69599,48082,101679
ֵ,DongHaiJieDao,120103012,63075,10624,39988,29129,59771,38472,6314,38571,77043,40025,80013
÷ֵ,MeiJiangJieDao,120103013,21845,2611,14133,8647,12020,12248,3091,11776,24024,13414,27547
ֵ,ChangHongJieDao,120104001,62249,7298,34680,20270,36867,26991,3799,25986,52977,38666,73346
¥ֵ,GuLouJieDao,120104002,23819,1264,11769,7232,8988,9833,3705,9689,19522,17019,28788
Ͻֵ,XingNanJieDao,120104003,35806,4922,21983,15318,28073,20513,3016,19138,39651,21761,43744
㿪ֵ,GuangKaiJieDao,120104004,59167,7357,36577,23461,48095,32794,6775,31074,63868,36722,73299
˽ֵ,WanXingJieDao,120104005,112968,18900,73115,46148,93235,61094,8816,57681,118775,67569,140684
ѧֵ,XueFuJieDao,120104006,88133,11137,48791,21254,73224,27694,4049,26168,53862,54528,103319
·ֵ,XiangYangLuJieDao,120104007,120821,16425,69208,45368,80693,59768,8017,59230,118998,76055,145263
ֵ,JiaLingDaoJieDao,120104008,82126,13767,51500,34039,64235,46346,6512,43892,90238,50905,102405
�ֵ̽,WangDingDiJieDao,120104009,95727,18368,61523,45701,81929,58642,8504,57148,115790,61076,122599
ˮϹ԰ֵ,ShuiShangGongYuanJieDao,120104010,55221,6389,32382,16182,37993,20736,3243,20120,40856,32471,64853
Ľֵ,TiYuZhongXinJieDao,120104011,55199,6292,32771,19861,23958,25864,5457,24773,50637,34177,66948
Էֵ,HuaYuanJieDao,120104012,40257,7304,26704,17554,29964,23764,5387,22684,46448,26244,52948
⸴ֵ,GuangFuDaoJieDao,120105001,46155,4482,17641,12957,24629,16445,2770,16040,32485,35766,53407
¥ֵ,WangHaiLouJieDao,120105002,70525,9707,41822,26475,56353,36629,6169,34509,71138,44579,86401
˳ֵ,HongShunLiJieDao,120105003,78514,11239,44927,28923,59576,37018,4658,35833,72851,49484,94411
¿ӽֵ,XinKaiHeJieDao,120105004,68120,9116,38961,29487,50078,37293,5425,37504,74797,43700,82661
·ֵ,TieDongLuJieDao,120105005,60248,8563,34557,23084,36658,31821,4911,31725,63546,39165,73722
ֵ,JianChangDaoJieDao,120105006,74449,10594,41793,28853,55003,37781,5319,37376,75157,48569,90362
԰ֵ,NingYuanJieDao,120105007,39685,4605,22147,14940,26435,19381,2963,19235,38616,25106,47253
�ֵ,WangChuanChangJieDao,120105008,94082,13037,55037,35029,72411,50008,6990,48081,98089,59072,114109
·ֵ,JiangDouLuJieDao,120105009,48313,8516,29555,19826,37609,26033,3732,25480,51513,31006,60561
ӽֵ,YueYaHeJieDao,120105010,67403,13110,41773,30618,62075,41259,5051,41202,82461,43791,85564
ׯֵ,XiYuZhuangJieDao,120106001,66553,9421,38951,26009,45922,34356,4914,33143,67499,41937,80888
˫ֵ,ShuangHuanCunJieDao,120106002,27888,5096,17586,13507,16896,17506,2364,17464,34970,17762,35348
·ֵ,XianYangBeiLuJieDao,120106003,59811,11139,36262,24418,46216,31423,3849,30052,61475,38537,74799
ֵֹ,DingZiGuJieDao,120106004,82330,11401,46800,28092,63729,36242,4921,34735,70977,51852,98652
ֵ,XiGuJieDao,120106005,70946,8883,42071,30092,43450,40343,7142,39384,79727,44900,86971
ʯֵ,SanTiaoShiJieDao,120106006,15764,2121,9043,6450,10025,8701,1370,8348,17049,10212,19255
۹ׯֵ,ShaoGongZhuangJieDao,120106008,44069,6698,26938,19742,34429,26462,3646,25460,51922,27475,54413
԰ֵ,JieYuanJieDao,120106009,27401,3226,15700,10542,15889,14859,2585,14254,29113,17512,33212
ֵ,LingChengGeJieDao,120106010,31445,5151,19573,14505,25648,19109,2561,18249,37358,19584,39157
ֵͬ,DaHuTongJieDao,120106011,8133,41,4469,150,39,151,65,190,341,3770,8239
Է³С,HeYuanXinChengXiaoQu,120106401,590,2,72,0,0,0,0,0,0,520,592
Źׯֵ,ZhangGuiZhuangJieDao,120110001,36284,4535,23341,17141,20205,22870,5112,21694,44564,22590,45931
ֵ,FengNianCunJieDao,120110002,15522,1723,9124,6621,6710,8682,1830,8662,17344,9951,19075
½ֵ,WanXinJieDao,120110003,80025,8616,47188,37117,22610,45982,10032,48920,94902,51485,98673
覽ֵ,WuXiaJieDao,120110004,46708,2366,18941,12411,23852,17274,5052,17634,34908,35185,54126
ֵ,XinLiJieDao,120110005,114944,6852,59560,37959,69683,51353,14561,53984,105337,76797,136357
ֵ,HuaMingJieDao,120110006,50590,4173,29659,20741,40823,28359,9375,28558,56917,34479,64138
ӽֵ,JinZhongJieDao,120110007,61561,3903,33075,25605,32851,29862,8268,33166,63028,40657,73732
ǽֵ,JunLiangChengJieDao,120110008,41587,3827,24422,16438,39153,23279,6698,23246,46525,27690,52112
ô,MeLiuQiaoXiang,120110200,11322,926,6820,4278,8457,6032,2004,6032,12064,7432,14252
,KaiFaQuXiQu,120110400,7163,7,1346,229,0,152,4,188,340,5828,7174
˰ո۹,BaoShuiQuKongGangGuoJiWuLiuQu,120110401,106,1,46,4,0,4,1,5,9,62,108
˰ո۹�,BaoShuiQuKongGangGuoJiWuLiuJingJiQu,120110402,21383,55,5589,239,507,284,142,333,617,15991,21580
�,DongLiQuKaiFaQu,120110403,5120,10,2065,44,42,49,12,48,97,3077,5142
,DongLiHu,120110404,3249,121,1211,706,309,876,280,915,1791,2439,3650
ۺϱ˰,ZongHeBaoShuiQu,120110405,54,0,8,0,0,0,0,0,0,46,54
³,HangKongXinCheng,120110406,2441,155,1251,915,1524,1098,266,1174,2272,1611,2862
ӪŽֵ,XiYingMenJieDao,120111001,25279,2582,14251,11295,6461,13331,2355,14439,27770,15965,30216
ׯֵ,LiQiZhuangJieDao,120111002,61945,4561,34988,24980,23288,30082,8256,30840,60922,39774,74762
б,ZhongBeiZhen,120111100,78068,6036,43506,28883,34668,37809,8710,38425,76234,49308,92814
,YangLiuQingZhen,120111101,97463,9127,50069,34399,77950,47505,11701,46689,94194,68222,118291
,XinKouZhen,120111102,32893,3647,20598,14008,34946,19466,5734,19537,39003,21676,42274
ż,ZhangJiaWoZhen,120111103,38492,3382,22924,15196,29431,19635,5912,20008,39643,24862,47786
,JingWuZhen,120111104,39287,3009,21978,14926,26321,19930,6880,20612,40542,27198,49176
,DaSiZhen,120111105,97518,5442,59199,29238,34780,36440,10330,36859,73299,54091,113290
ׯ,WangWenZhuangZhen,120111106,30893,2938,20004,12768,32269,19495,7532,20345,39840,21359,41363
΢С,KaiFaQuXiQingWeiDianZiXiaoQu,120111400,11128,1,10346,45,0,45,4,5,50,787,11133
¼ҵ԰,XinJiShuChanYeYuanQu,120111401,16635,247,5730,1386,349,1538,355,1546,3084,11507,17237
У,XiQingGaoXiaoQu,120111402,66433,19,36480,16,39295,23,42,38,61,30014,66494
�,XiQingQuKaiFaQu,120111450,8181,13,5450,72,165,102,30,101,203,2774,8224
ˮ,XianShuiGuZhen,120112100,122542,9777,61961,38778,93550,58189,16283,56473,114662,86641,148602
,GeGuZhen,120112101,56474,4236,30046,16875,47690,26886,8313,26922,53808,38977,69023
Сվ,XiaoZhanZhen,120112102,66656,5655,37834,23549,54609,33873,10271,34095,67968,44748,82582
˫,ShuangGangZhen,120112103,89934,4884,43008,22860,41711,31734,8367,31859,63593,60177,103185
ׯ,XinZhuangZhen,120112104,32852,1998,16072,8721,19182,12720,3816,12801,25521,22594,38666
˫ź,ShuangQiaoHeZhen,120112106,30386,2236,16309,10253,23198,14836,4571,14877,29713,20884,37193
̨,BaLiTaiZhen,120112107,45882,3472,26806,15979,42227,24775,9823,24761,49536,32371,59177
բ,BeiZhaKouZhen,120112108,37438,2670,21532,11489,27468,17291,5633,17065,34356,24209,45741
·ʮ˾,TieLuShiBaJu,120112401,3113,185,1872,1242,1285,1813,462,1507,3320,1888,3760
Ͽ,JinNanKaiFaQuDongQu,120112404,1904,0,364,5,6,4,4,5,9,1544,1908
Ͽ,JinNanKaiFaQuXiQu,120112405,2021,40,857,262,35,365,86,376,741,1290,2147
̩ϣ΢ӹҵ,TaiDaJinNanWeiDianZiGongYeQu,120112406,650,0,227,0,0,0,0,0,0,423,650
˫ũ,ShuangLinNongChang,120112500,218,0,77,35,0,53,29,66,119,170,247
Ϲũҵ԰,JinNanGuoJiaNongYeYuanQu,120112501,181,0,92,0,0,0,1,0,0,90,182
԰´ֵ,GuoYuanXinCunJieDao,120113001,30954,4281,19882,15078,23775,19505,4372,18935,38440,19725,39607
ֵ,JiXianLiJieDao,120113002,13516,2377,8867,6935,9398,8832,1579,8534,17366,8605,17472
նֵ,PuDongJieDao,120113003,47447,5549,28242,20135,6757,27068,4625,27128,54196,29379,57621
𾰽ֵ,RuiJingJieDao,120113004,61030,6269,35658,26822,5141,34213,5543,34740,68953,37184,72842
,TianMuZhen,120113100,96889,9873,58983,35842,45640,48680,9322,48451,97131,57101,116084
,BeiCangZhen,120113101,37811,3796,22467,14798,26924,20862,5314,20719,41581,24454,46921
˫,ShuangJieZhen,120113102,47705,2393,23337,12520,20364,16826,4466,16978,33804,31227,54564
˫,ShuangKouZhen,120113103,54898,3742,28505,11957,44252,19258,5359,19171,38429,35494,63999
,QingGuangZhen,120113104,35437,2706,20134,13215,23407,18313,5137,18828,37141,23146,43280
˲,YiXingBuZhen,120113106,35093,3229,19692,12798,19668,16508,3663,16758,33266,22293,41985
С,XiaoDianZhen,120113107,29285,1562,17098,8028,20332,11523,3665,11600,23123,17414,34512
ׯ,DaZhangZhuangZhen,120113108,23487,2649,14456,9152,25071,13659,3764,13470,27129,15444,29900
ͷ,XiDiTouZhen,120113111,36031,3023,21547,12136,36538,18416,6353,19083,37499,23860,45407
Ƽ԰,KeJiYuanQuBeiQu,120113400,1552,6,432,2,3,1,13,2,3,1139,1571
Ƽ԰,KeJiYuanQuNanQu,120113401,1841,3,610,0,77,0,15,0,0,1249,1859
ҽҩҽеҵ԰,TianJinYiYaoYiLiaoQiXieGongYeYuan,120113402,0,0,0,0,0,0,0,0,0,0,0
½·װҵ԰,TianJinLuLuGangWuLiuZhuangBeiChanYeYuan,120113403,0,0,0,0,0,0,0,0,0,0,0
ҵ԰,TianJinFengDianChanYeYuan,120113404,0,0,0,0,0,0,0,0,0,0,0
ũ,HongQiNongChang,120113500,1191,96,648,465,357,520,126,594,1114,765,1413
ũ,ShuGuangNongChang,120113501,61,15,37,33,63,37,8,47,84,47,84
ֵ,YangCunJieDao,120114001,37608,2334,19839,12264,23867,18690,6005,18090,36780,26108,45947
ׯֵ,XiaZhuZhuangJieDao,120114002,19820,1383,12159,6562,11573,10274,3092,10032,20306,12136,24295
ݽֵ,DongPuWaJieDao,120114003,36775,2086,17454,10124,23897,17293,5947,16845,34138,27354,44808
ׯֵ,HuangZhuangJieDao,120114004,13156,1479,8091,4347,13565,7252,2246,7249,14501,8790,16881
ͽֵ,XuGuanTunJieDao,120114005,14573,835,5735,3357,8102,5212,1573,5118,10330,11246,16981
˺ֵ,YunHeXiJieDao,120114006,55004,4324,33474,18387,47442,29704,9333,28312,58016,35187,68661
÷,MeiChangZhen,120114101,27396,3168,16961,10199,29717,15980,4469,16089,32069,18072,35033
,DaJianChangZhen,120114102,16951,2073,11167,5919,19256,10348,3299,10530,20878,11156,22323
޻ƿ,CuiHuangKouZhen,120114103,37804,5881,25605,14038,50116,25423,7856,25583,51006,25936,51541
,DaLiangZhen,120114104,29161,4279,19405,11534,38049,19384,5939,19908,39292,19974,39379
,XiaWuQiZhen,120114105,18178,2602,11720,6718,23751,11687,3109,12130,23817,12169,23889
ϲ̴,NanCaiCunZhen,120114106,35621,4562,23125,13797,39155,22704,6908,23137,45841,23966,47091
ׯ,DaMengZhuangZhen,120114107,16932,2221,10668,6260,20979,10642,3009,10664,21306,11494,22162
,SiCunDianZhen,120114108,13178,1654,8098,5490,15684,8046,2415,8077,16123,9149,17247
,HeXiWuZhen,120114109,35785,4201,21836,12537,38655,20068,5828,20351,40419,23978,45814
ǹ,ChengGuanZhen,120114110,20875,2612,13281,7985,23949,12312,3563,12481,24793,13769,27050
Ȧ,DongMaQuanZhen,120114111,12386,1436,7593,4569,14159,7335,2028,7374,14709,8257,15850
ƻ,HuangHuaDianZhen,120114112,18373,2310,11734,6333,21546,11040,3417,11193,22233,12366,24100
ʯׯ,ShiGeZhuangZhen,120114113,17625,1981,11227,6727,20692,10937,3703,11106,22043,12082,23309
,WangQingTuoZhen,120114114,34644,3117,21831,11697,38452,20665,7255,20783,41448,23185,45016
,ChaGuGangZhen,120114115,35073,2756,21275,9780,35358,17907,7014,17860,35767,23568,44843
ӱ,HeBeiTunZhen,120114116,22788,3197,14893,8150,29633,14574,4433,15287,29861,15525,30418
̨,ShangMaTaiZhen,120114117,17842,1518,8932,5632,15810,8553,2721,11850,20403,13149,22081
ׯ,DaiWangGuZhuangZhen,120114118,19441,2135,11749,6271,20855,10832,3485,10966,21798,13312,25061
¾,ChenJuZhen,120114119,22851,2718,14951,9248,28140,14812,4624,15098,29910,15242,30193
ׯ,DouZhangZhuangXiang,120114203,17794,2166,11537,7563,20767,11330,3461,11398,22728,11884,23421
,CaoZiLiXiang,120114206,21408,2311,12760,5929,20357,10290,3414,10369,20659,14373,27133
Ʊ,DaiHuangBaoXiang,120114207,14152,1550,8566,5240,16601,8372,2730,8493,16865,9866,18432
ߴ,GaoCunXiang,120114213,13836,1889,8887,5807,16926,8589,2485,8655,17244,9323,18210
׹,BaiGuTunXiang,120114214,16113,2045,10313,6593,19687,10047,3285,10277,20324,11130,21443
԰С,KaiFaQuWuQingYiXianYuanXiaoQu,120114400,1573,0,593,35,0,17,2,31,48,982,1575
�,WuQingQuKaiFaQu,120114401,26949,485,10337,3122,7161,4780,1557,4658,9438,18654,28991
ũ,WuQingNongChang,120114500,1514,193,886,633,1500,869,193,955,1824,1014,1900
ֵ,HaiBinJieDao,120115001,45241,3576,27194,16683,27716,24992,7004,24734,49726,28627,55821
ƽֵ,BaoPingJieDao,120115002,83117,4010,47360,22593,55823,32884,10037,32993,65877,49804,97164
ڻֵ,YuHuaJieDao,120115003,42863,2287,17572,7849,22722,12942,3675,12938,25880,31253,48825
,DaKouTunZhen,120115101,44639,5407,26230,13314,46078,23119,6480,23581,46700,30296,56526
ׯ,DaBaiZhuangZhen,120115102,14578,1289,8413,5142,14902,7897,2272,7248,15145,9726,18139
ׯ,WangBuZhuangZhen,120115103,24864,3501,15436,10487,30810,15231,3936,15793,31024,16865,32301
ׯ,FangJiaZhuangZhen,120115104,23989,2828,13576,9400,26881,13433,3521,14054,27487,16762,30338
ͤ,LinTingKouZhen,120115105,25165,2983,15115,9734,27068,13567,3662,13802,27369,16695,31810
ų,BaMenChengZhen,120115106,19376,2196,11905,8574,23890,11832,3753,12459,24291,13420,25325
ׯ,DaZhongZhuangZhen,120115107,29122,3099,17739,10937,30853,15392,4185,16000,31392,18667,36406
°,XinAnZhen,120115108,24117,3088,14804,9744,27939,13952,3578,14508,28460,15979,30783
ҵ,MaJiaDianZhen,120115110,24133,2599,13247,7990,23712,12147,3358,12387,24534,16843,30090
ׯ,HuoGeZhuangZhen,120115111,21071,2402,12174,7868,24118,11953,3134,12620,24573,14433,26607
¿,XinKaiKouZhen,120115113,19816,2578,12367,6700,24097,12020,3354,12532,24552,13381,25748
ׯ,DaTangZhuangZhen,120115115,10483,1139,6521,3620,12493,6237,1890,6505,12742,6991,13512
߼ׯ,GaoJiaZhuangZhen,120115117,31507,3474,19438,10761,36040,17931,4960,18556,36487,20503,39941
ڶ,KouDongZhen,120115118,22959,2837,14298,8547,25890,12850,3385,13264,26114,14883,29181
ţ,NiuDaoKouZhen,120115119,36138,4891,22415,13251,43948,21902,6139,22664,44566,24753,47168
ʷׯ,ShiGeZhuangZhen,120115120,19881,2586,12442,6933,24703,11975,3316,12550,24525,13341,25783
¸ׯ,HaoGeZhuangZhen,120115121,14179,2105,9065,6019,17576,8707,2468,9113,17820,9687,18752
ׯ,ZhouLiangZhuangZhen,120115122,9965,897,4837,2940,8478,4313,1282,4476,8789,7307,12144
ţ,NiuJiaPaiXiang,120115204,12699,1694,8215,5032,15558,7966,2362,8117,16083,8540,16755
ׯ,ErWangZhuangXiang,120115207,10115,1143,6223,3989,11870,6058,1862,6190,12248,6897,13120
ׯ,HuangZhuangXiang,120115210,8787,866,5554,3551,10877,5441,1822,5603,11044,5921,11475
챦ҵ԰,TianBaoGongYeYuanQu,120115453,2069,4,1218,0,0,0,0,0,0,855,2073
԰ҵ԰,JiuYuanGongYeYuanQu,120115454,2061,2,360,0,1,0,0,0,0,1703,2063
³,JingJinXinCheng,120115455,19960,47,7196,86,4949,98,31,151,249,12842,20038
Թũ,LiZiGuNongChang,120115500,397,64,253,182,368,223,44,207,430,252,505
ׯũ,HuangZhuangNongChang,120115501,81,16,56,45,84,55,7,45,100,48,104
ũ,DaZhongNongChang,120115502,508,90,291,295,659,291,62,369,660,369,660
´ֵ,XinCunJieDao,120116001,57867,7708,35591,24320,43032,31291,7256,30530,61821,37240,72831
ڼұֵ,YuJiaBaoJieDao,120116002,67902,6319,38217,23189,37852,30589,6580,29654,60243,42584,80801
¸۽ֵ,XinGangJieDao,120116003,78577,5301,37844,25082,34603,31519,7898,32684,64203,53932,91776
ֵ,XiangYangJieDao,120116004,74974,5001,42919,26137,37069,35207,8387,34511,69718,45443,88362
ݵֵ,HangZhouDaoJieDao,120116005,92984,8342,54887,34021,54251,45852,10847,44905,90757,57286,112173
ºӽֵ,XinHeJieDao,120116006,61994,4417,31521,20233,21560,26557,6749,26913,53470,41639,73160
ֵ,DaGuJieDao,120116007,38098,1871,16729,10686,16087,13959,3456,15343,29302,26696,43425
±ֵ,XinBeiJieDao,120116008,72641,1903,33074,16624,10729,20600,6158,21722,42322,47628,80702
ֵ,BeiTangJieDao,120116009,13914,968,5896,4109,8750,5351,1524,5474,10825,10510,16406
ʯͽֵ,BoHaiShiYouJieDao,120116010,24865,3176,14159,10441,21044,13435,2934,13566,27001,16816,30975
԰ֵ,HuJiaYuanJieDao,120116011,96411,5300,47006,36181,43762,44720,15524,48418,93138,70229,117235
ֵ,HanGuJieDao,120116031,41232,4268,23837,17431,28957,22528,5185,22307,44835,26848,50685
կϽֵ,ZhaiShangJieDao,120116032,56637,4924,27997,18550,34171,23658,4949,23155,46813,38513,66510
ֵ,HeXiJieDao,120116033,30456,4835,18184,13112,26314,16913,3038,16357,33270,20145,38329
ӭֵ,YingBinJieDao,120116051,113089,6721,67133,32538,66596,44281,14071,43324,87605,66748,133881
ʤֵ,ShengLiJieDao,120116052,38688,5357,24134,19150,33740,23563,5290,22976,46539,25201,49335
ֵֽ,GuLinJieDao,120116053,37884,3417,21915,15480,21640,19877,5749,20129,40006,25135,47050
ֵ,HaiBinJieDao,120116054,115458,13571,70181,50075,100855,66416,16980,66126,132542,75828,146009
ֵ,GangXiJieDao,120116055,24603,2355,14816,10588,18634,13612,4167,13892,27504,16309,31125
³,XinChengZhen,120116100,35366,2100,19527,12994,15625,17116,5662,18275,35391,23601,43128
,DaTianZhen,120116134,9097,1086,5910,4244,8296,5851,1791,5950,11801,6064,11974
Ҳ,YangJiaBoZhen,120116135,17218,1594,8705,5476,15239,7979,2747,8362,16341,12854,21559
,ChaDianZhen,120116136,22000,2186,12547,8658,21451,11833,3864,12217,24050,15503,28050
̫ƽ,TaiPingZhen,120116156,26887,3274,17787,11095,30100,16513,6913,17420,33933,19287,37074
Сׯ,XiaoWangZhuangZhen,120116157,16626,2261,11097,7803,20809,10929,4197,11545,22474,11987,23084
,ZhongTangZhen,120116158,40994,3649,27074,17670,39619,26525,10943,27281,53806,28512,55586
,KaiFaQu,120116400,120092,2809,59649,19376,32555,24399,7187,23835,48234,70439,130088
˰,BaoShuiQu,120116401,4723,9,2175,76,51,74,19,94,168,2576,4751
¼ҵ,TianJinBinHaiXinQuGaoXinJiShuChanYeKaiFaQu,120116402,7536,37,604,4,3,4,10,3,7,6979,7583
˰,DongJiangBaoShuiGangQu,120116403,40419,69,27149,17,35,8,7,24,32,13346,40495
,ZhongXinShangWuQu,120116404,93565,349,37317,89,45088,65,87,187,252,56684,94001
ٸ۹ҵ,LinGangGongYeQu,120116405,97818,59,813,31,0,15,18,115,130,97082,97895
̬,ZhongXinTianJinShengTaiCheng,120116406,91103,99,54065,7,22737,1,78,6,7,37215,91280
,BinHaiLvYouQu,120116407,90295,782,960,8,0,6,1,7,13,90118,91078
ϸ۹ҵ,NanGangGongYeQu,120116408,91947,460,1074,12,0,8,445,133,141,91778,92852
ٸ۲ҵ԰һ,LinGangChanYeYuanQuYi,120116409,89898,53,14028,0,0,0,17,0,0,75940,89968
ٸ۲ҵ԰,LinGangChanYeYuanQuEr,120116410,91700,253,78658,0,20428,0,35,0,0,13330,91988
«̨,LuTaiZhen,120221100,109955,8995,61082,37175,103062,57468,17429,58049,115517,75297,136379
,NingHeZhen,120221102,16829,2063,10756,7349,20331,10133,2797,10618,20751,10933,21689
ׯ,MiaoZhuangZhen,120221103,13277,1642,8493,4710,15309,7889,2377,8019,15908,8803,17296
̨,FengTaiZhen,120221104,17779,2514,11661,7862,22895,11608,3497,12039,23647,12129,23790
,YueLongZhen,120221105,11523,1344,6985,4376,13056,6801,2147,7058,13859,8029,15014
,BanQiaoZhen,120221106,7726,952,4751,2851,8981,4567,1474,4687,9254,5401,10152
ׯ,PanZhuangZhen,120221107,23290,2316,14745,9384,27935,14712,4607,15397,30109,15468,30213
׳,ZaoJiaChengZhen,120221109,22803,1718,13098,8713,24841,12654,5015,13169,25823,16438,29536
ﺣ,QiLiHaiZhen,120221110,21191,1864,12849,6936,25625,12785,4952,13727,26512,15158,28007
󱱽,DaBeiJianGuZhen,120221111,11154,1210,7025,3368,12085,6201,2482,6693,12894,7821,14846
,DongJiTuoZhen,120221112,22422,2320,14225,7947,27320,13633,5027,14192,27825,15544,29769
,BeiHuaiDianXiang,120221204,16036,1408,9945,5402,18841,9229,3492,10011,19240,10991,20936
l,BiaoKouXiang,120221205,15384,1608,9805,4883,18250,9194,3509,9981,19175,10696,20501
ׯ,LianZhuangZiXiang,120221206,13677,1298,8208,4569,15661,7876,2340,8358,16234,9107,17315
ׯũ,PanZhuangNongChang,120221500,535,93,362,283,573,356,72,333,689,338,700
,JingHaiZhen,120223100,118659,8984,75608,50543,104653,74136,26682,75887,150023,78717,154325
ƹ,TangGuanTunZhen,120223101,32278,4244,21651,14453,40677,21371,7645,22026,43397,22516,44167
,DuLiuZhen,120223102,27166,3223,17880,12017,33726,17833,6101,18492,36325,18610,36490
,WangKouZhen,120223103,24014,2859,15698,9596,31319,15578,5749,16742,32320,16924,32622
̨ͷ,TaiTouZhen,120223104,16690,2049,11092,7292,21981,11087,4055,11691,22778,11702,22794
,ZiYaZhen,120223105,23737,2080,15164,9376,26625,14921,5940,16030,30951,16593,31757
¹,ChenGuanTunZhen,120223106,20923,2905,14365,9587,28048,14348,5409,14846,29194,14872,29237
,ZhongWangZhen,120223107,21812,3109,15016,10069,29680,14963,6207,16031,30994,16112,31128
ׯ,DaQiuZhuangZhen,120223108,54453,3190,33808,23102,37461,33299,14551,35744,69043,38386,72194
̹ׯ,CaiGongZhuangZhen,120223109,15367,1618,10199,7057,18086,10153,4513,11090,21243,11299,21498
ͷ,LiangTouZhen,120223110,18076,1937,11953,7886,22013,11701,4819,12116,23817,12879,24832
Ų,TuanBoZhen,120223111,15352,533,7950,3541,7715,5281,2414,5663,10944,10349,18299
˫,ShuangTangZhen,120223112,12705,1220,7452,4528,12882,6736,2731,7121,13857,9204,16656
,DaFengDuiZhen,120223113,11506,1130,7737,5109,13169,7701,3469,8194,15895,8368,16105
ׯ,YanZhuangZhen,120223114,24746,2767,15673,10278,30759,15395,5668,16564,31959,17508,33181
ׯ,XiZhaiZhuangZhen,120223115,9514,1197,6404,4384,12388,6394,2599,6856,13250,6906,13310
ׯ,LiangWangZhuangXiang,120223200,15488,1753,10041,6757,17984,9793,3465,9936,19729,10665,20706
ׯ,YangChengZhuangXiang,120223201,17352,1650,12169,7280,22299,11963,5985,12192,24155,12818,24987
򾲺ÿ,TianJinJingHaiJingJiKaiFaQu,120223400,2117,64,774,270,788,392,206,447,839,1613,2387
ҵ԰,TianJinZiYaGongYeYuanQu,120223402,298,5,57,17,0,16,0,19,35,246,303
Ĳֵ´,WenChangJieDaoBanShiChu,120225001,69529,5490,45014,31667,70267,44391,14188,42770,87161,44193,89207
,YuYangZhen,120225100,43360,5307,28584,16502,54289,28381,9002,28694,57075,29085,57669
,YinLiuZhen,120225101,17682,2350,11582,6643,22712,11509,3883,12129,23638,12333,23915
ׯ,GuanZhuangZhen,120225102,22868,2959,14845,8617,29219,14773,4813,15534,30307,15795,30640
,MaShenQiaoZhen,120225103,25742,3676,16973,9912,33861,16828,5345,17527,34355,17790,34763
Ӫ,XiaYingZhen,120225104,14132,1879,9124,5605,18297,9100,2748,9592,18692,9635,18759
,BangJunZhen,120225105,23455,3188,15300,8659,30134,14525,4700,15218,29743,16043,31343
ɽ,BieShanZhen,120225106,32136,4679,21533,13227,41986,21502,7033,22213,43715,22315,43848
ȹׯ,YouGuZhuangZhen,120225108,17960,2409,11808,7181,23388,11708,4232,12583,24291,12793,24601
ϲ,ShangCangZhen,120225109,24635,3716,16535,9838,32553,16482,5029,16780,33262,16845,33380
²,XiaCangZhen,120225111,31318,4629,20256,12918,40689,20229,5770,21391,41620,21461,41717
ׯ,LuoZhuangZiZhen,120225112,9285,1314,5870,3558,11907,5866,1654,6370,12236,6383,12253
׽,BaiJianZhen,120225113,13836,2077,8964,5449,17331,8909,2733,9449,18358,9682,18646
ٻ,WuBaiHuZhen,120225114,16354,2612,11178,7037,22065,11174,3726,11504,22678,11514,22692
Ӫ,HouJiaYingZhen,120225115,27562,3714,18334,9553,36736,18330,6070,19003,37333,19012,37346
ɣ,SangZiZhen,120225116,26207,3732,17708,10407,35278,17708,6647,18877,36585,18878,36586
ʩ,DongShiGuZhen,120225117,11878,1563,7654,4628,15508,7652,2553,8313,15965,8340,15994
ͷ,XiaWoTouZhen,120225118,19840,2859,12985,7665,26267,12873,4070,13645,26518,13784,26769
ׯ,YangJinZhuangZhen,120225119,24744,3464,15929,10028,32041,15907,4820,17082,32989,17099,33028
ͷ,ChuTouLingZhen,120225120,24723,3220,17063,10583,33589,17034,6419,17272,34306,17299,34362
,XiLongHuYuZhen,120225121,17621,2401,12415,8022,24573,12413,5174,12769,25182,12781,25196
,ChuanFangYuXiang,120225202,10859,1483,7102,4248,14322,7102,2206,7446,14548,7446,14548
ׯ,SunGeZhuangXiang,120225203,5015,611,3291,1951,6462,3291,1091,3426,6717,3426,6717
Ӫ,DongErYingXiang,120225208,12552,1705,8172,4723,16315,8146,2704,8721,16867,8789,16961
̨,XuJiaTaiXiang,120225210,7930,960,5244,2733,10508,5223,1744,5263,10486,5390,10634
ׯ,LiMingZhuangXiang,120225212,17436,2388,11450,7084,22774,11394,3758,12057,23451,12132,23582
Ըׯ,DongZhaoGeZhuangXiang,120225219,14383,2087,9471,5999,19016,9460,3163,10118,19578,10162,19633
ֵ´,JianBeiJieDaoBanShiChu,130102001,28359,2935,18171,12034,18522,16867,4620,16162,33029,17743,35914
԰ֵ´,QingYuanJieDaoBanShiChu,130102002,23783,4876,17112,10136,20827,14393,3200,13264,27657,14747,31859
㰲ֵ´,GuangAnJieDaoBanShiChu,130102003,31661,5772,21690,10190,28065,14611,2816,13381,27992,18559,40249
Žֵ´,YuCaiJieDaoBanShiChu,130102004,30291,5251,20782,11663,29569,17032,3675,16198,33230,18435,39217
Ծֵ´,YueJinJieDaoBanShiChu,130102005,28983,3722,18630,13459,21690,18205,5122,17545,35750,19197,37827
Ӷֵ´,HeDongJieDaoBanShiChu,130102007,42286,8255,29095,20146,41527,27917,6421,26466,54383,27867,56962
ֵ´,ChangFengJieDaoBanShiChu,130102010,37294,3249,23155,15803,24226,22656,6988,22987,45643,24376,47531
̸ֵ̽´,TanGuJieDaoBanShiChu,130102011,57357,4461,35634,23216,38587,33652,10221,32796,66448,36405,72039
ͨ,XiZhaoTongZhen,130102100,35910,3219,22814,11698,35009,21366,6582,20917,42283,22897,45711
ϴ,NanCunZhen,130102101,29352,3301,19628,9938,36396,19537,5955,18770,38307,18980,38608
Ӫ,GaoYingZhen,130102102,27671,1885,15710,8598,24043,14413,4328,13504,27917,18174,33884
ɽ·ֵ´,ZhongShanDongLuJieDaoBanShiChu,130103001,34042,3148,16647,7223,30009,11971,3409,11163,23134,23952,40599
ֵ´,PengHouJieDaoBanShiChu,130103002,32406,4083,21078,14440,28479,20488,4842,19487,39975,20253,41331
ֵ´,DongFengJieDaoBanShiChu,130103003,25605,3807,16249,10686,24772,15222,3376,15049,30271,16539,32788
ֵ´,DongHuaJieDaoBanShiChu,130103004,14955,2128,9278,6341,14187,8284,1868,8250,16534,9673,18951
Žֵ´,XiuMenJieDaoBanShiChu,130103005,19481,2479,12536,8274,19454,11587,2481,11031,22618,11905,24441
ֵ´,FuKangJieDaoBanShiChu,130103006,23243,1859,12843,8770,15858,11750,3434,12243,23993,15693,28536
ֵ´,JianAnJieDaoBanShiChu,130103007,36914,5783,23999,16194,35459,22869,5059,22309,45178,23757,47756
ʤֵ´,ShengLiBeiJieDaoBanShiChu,130103008,65107,6323,36337,20950,55169,28680,7035,28185,56865,42128,78465
ֵͨ´,HuiTongJieDaoBanShiChu,130103009,38149,3761,24027,17346,27843,23958,6430,24166,48124,24313,48340
԰,TaoYuanZhen,130103101,39530,3047,23793,14622,31110,21772,6332,21570,43342,25116,48909
ֵ´,DongLiJieDaoBanShiChu,130104001,32883,4932,22054,14787,26258,21495,5207,20104,41599,20968,43022
ɽֵ´,ZhongShanJieDaoBanShiChu,130104002,5376,328,3156,2320,1718,2877,814,3007,5884,3362,6518
ϳֵ´,NanChangJieDaoBanShiChu,130104004,10839,1039,6933,4778,5587,6741,1983,6584,13325,6928,13861
άֵ´,WeiMingJieDaoBanShiChu,130104005,27898,4616,17930,11338,24161,16190,3564,15017,31207,18148,36078
ԣֵ´,YuXiJieDaoBanShiChu,130104006,19118,1640,12236,8301,10551,11575,3089,11241,22816,11611,23847
ֵ´,YouYiJieDaoBanShiChu,130104007,42428,7162,29266,20077,41236,27864,7269,26343,54207,27593,56859
ֵ´,HongQiJieDaoBanShiChu,130104008,55691,2897,35765,12535,32312,18178,5709,17375,35553,28532,64297
ʯֵ´,XinShiJieDaoBanShiChu,130104009,37811,3090,22971,15218,23049,20708,5592,20241,40949,23522,46493
Էֵ´,YuanDongJieDaoBanShiChu,130104010,34298,4696,23730,15279,30160,22809,6249,20126,42935,21513,45243
ֵ´,XiLiJieDaoBanShiChu,130104011,44077,4459,28462,17864,36347,26568,7657,25288,51856,27731,56193
ͷֵ´,ZhenTouJieDaoBanShiChu,130104012,95899,3890,61989,22213,58568,32526,9655,31936,64462,47455,109444
Ӫֵ´,LiuYingJieDaoBanShiChu,130104013,77237,4494,49021,25748,42657,37019,12578,36674,73693,45288,94309
½ֵ´,GeXinJieDaoBanShiChu,130105001,17142,2552,11768,7375,12997,10339,2440,9714,20053,10366,22134
»·ֵ´,XinHuaLuJieDaoBanShiChu,130105003,17453,1308,10735,7769,7700,10402,2968,10703,21105,10994,21729
ֵ´,NingAnJieDaoBanShiChu,130105004,30948,5517,21581,14132,30733,21132,4906,19232,40364,19790,41371
ֵ´,DongJiaoJieDaoBanShiChu,130105005,38037,4887,23235,14535,28577,20226,5047,18973,39199,24736,47971
Էֵ´,XiYuanJieDaoBanShiChu,130105006,37609,3875,23885,15112,27672,21354,6266,19982,41336,23865,47750
·ֵ´,HeZuoLuJieDaoBanShiChu,130105007,31461,4541,21233,14564,27399,20389,5448,19144,39533,20217,41450
˽ֵ´,LianMengJieDaoBanShiChu,130105008,48418,4978,31801,20928,37849,29673,9051,28371,58044,30646,62447
ʯڽֵ´,ShiGangJieDaoBanShiChu,130105009,64371,6135,40738,30490,42288,39656,11733,39293,78949,41501,82239
ֵ߽´,WuQiJieDaoBanShiChu,130105010,53082,495,33499,1097,19171,1552,391,1472,3024,20469,53968
Էֵ´,TianYuanJieDaoBanShiChu,130105011,16722,1534,10622,7339,12631,10500,2974,10286,20786,10608,21230
Էֵ´,BeiYuanJieDaoBanShiChu,130105012,24341,1707,14144,8941,18359,12987,3665,12646,25633,15569,29713
,DaGuoZhen,130105100,30695,2858,19329,10053,24157,16186,4616,15623,31809,18840,38169
,ZhaoLingPuZhen,130105101,37705,2456,23455,14966,21915,22922,7777,22294,45216,24483,47938
ׯ,XiSanZhuangXiang,130105201,34483,1910,22031,7862,17013,12705,4162,12335,25040,18524,40555
ű,DuBeiXiang,130105202,20859,2202,12811,6135,20499,12094,3394,11659,23753,13644,26455
нֵֽ´,KuangShiJieJieDaoBanShiChu,130107001,20865,3654,13716,9964,21870,13386,3317,12768,26154,14120,27836
΢ֵ´,SiWeiJieDaoBanShiChu,130107002,13039,2420,8786,6328,6641,7209,1741,6848,14057,8414,17200
ׯ,JiaZhuangZhen,130107100,18779,2038,11536,6261,20985,11181,3428,11384,22565,12709,24245
ɽ,FengShanZhen,130107101,9141,1203,6100,3716,11655,6100,1954,6198,12298,6198,12298
ὧ,HengJianXiang,130107200,10414,1145,6624,4114,11084,6566,2032,6534,13100,6967,13591
ԣ˽ֵ´,YuXingJieDaoBanShiChu,130108001,30189,2340,19523,10966,26342,18189,5724,17147,35336,18730,38253
ԣǿֵ´,YuQiangJieDaoBanShiChu,130108002,42305,2262,26798,17179,34782,26197,8809,25721,51918,26578,53376
Էֵ´,DongYuanJieDaoBanShiChu,130108003,58000,7516,38382,23838,57263,35902,9107,34415,70317,36241,74623
ֵͨ´,JianTongJieDaoBanShiChu,130108004,60067,2900,33587,12450,31206,20362,6231,19600,39962,35611,69198
׽ֵ´,HuaiDiJieDaoBanShiChu,130108005,66150,6692,42237,19054,51765,28695,8076,26763,55458,38681,80918
ԣ·ֵ´,YuHuaLuJieDaoBanShiChu,130108006,42876,7150,29158,18346,41399,26605,7020,25449,52054,27888,57046
ԣֵ´,YuDongJieDaoBanShiChu,130108007,57368,3546,35572,21474,45684,32860,10190,31839,64699,35532,71104
ֵ´,ChangJiangJieDaoBanShiChu,130108010,55303,2054,35967,11604,38265,18489,6337,17630,36119,27727,63694
̫нֵ´,TaiHangJieDaoBanShiChu,130108011,12006,954,6964,2959,10579,5918,1782,5630,11548,7778,14742
Ӫ,SongYingZhen,130108100,44075,3399,28928,14480,45456,26935,8932,26212,53147,27478,56406
,FangCunZhen,130108101,40750,3064,25047,9499,35025,18530,5398,17933,36463,24165,49212
΢ˮ,WeiShuiZhen,130121100,48929,4762,31837,17859,52763,30380,11031,30785,61165,32885,64722
ϰ,ShangAnZhen,130121101,17988,2439,11482,5976,22397,10888,3970,11552,22440,12915,24397
쳤,TianChangZhen,130121102,28724,3814,19223,10575,34574,17676,6118,17505,35181,19433,38656
,XiuLinZhen,130121103,18576,2484,12357,7545,22539,11961,4475,12261,24222,13178,25535
,NanYuZhen,130121104,9753,1560,6638,4182,13352,6637,2428,7095,13732,7103,13741
,WeiZhouZhen,130121105,18792,2375,12674,7049,24813,12571,4663,13047,25618,13156,25830
С,XiaoZuoZhen,130121106,13302,1899,9069,4847,17117,9032,3137,9180,18212,9269,18338
ϳ,NanZhangChengZhen,130121107,6125,1266,4326,3012,7696,4003,1316,4039,8042,4381,8707
ɽ,CangYanShanZhen,130121108,4458,1024,3555,2565,6576,3479,1426,3236,6715,3353,6908
,CeYuZhen,130121109,9258,1585,6220,4061,12800,6142,2318,6732,12874,6941,13161
Ҥ,WuJiaYaoXiang,130121200,9335,1251,6128,3291,12540,6128,2238,6696,12824,6696,12824
,BeiZhengXiang,130121201,7978,916,5323,3134,8506,5323,1786,5357,10680,5357,10680
ڼ,YuJiaXiang,130121202,4206,851,2839,1937,5575,2811,948,2852,5663,3166,6005
ׯ,SunZhuangXiang,130121203,12000,1532,7900,4220,16133,7845,2753,8161,16006,8385,16285
,NanJingXiang,130121204,4274,725,3059,2036,5769,3059,1264,3204,6263,3204,6263
ׯ,XinZhuangXiang,130121205,6203,1249,4339,2610,8679,4324,1334,4403,8727,4447,8786
ׯ,NanWangZhuangXiang,130121206,6324,1094,4325,2887,8721,4313,1626,4698,9011,4719,9044
,ZhengDingZhen,130123100,124108,10876,81768,38819,135096,71407,23615,67680,139087,76831,158599
,ZhuFuTunZhen,130123101,26305,2865,17879,9042,34082,17821,5755,16976,34797,17046,34925
³,XinChengPuZhen,130123102,24874,2795,16941,8283,32080,16861,5579,16199,33060,16307,33248
°,XinAnZhen,130123103,28410,3666,19040,10184,36827,18564,5639,18354,36918,18675,37715
ţ,NanNiuXiang,130123200,30298,3469,20442,10259,39161,20418,6859,20151,40569,20184,40626
¥,NanLouXiang,130123201,38455,4079,25474,13214,49880,25474,8412,25472,50946,25472,50946
ƽ,XiPingLeXiang,130123202,15073,1703,10027,5221,19474,10027,3177,9924,19951,9926,19953
,BeiZaoXianXiang,130123203,31287,3097,20445,9382,39826,19177,6199,19250,38427,20138,40583
,QuYangQiaoXiang,130123204,37488,3988,25524,11709,48846,24859,8736,24250,49109,24688,50212
,LuanChengZhen,130124100,67178,5731,42047,20505,76951,37120,11159,37493,74613,42021,84068
ۧ,QieMaZhen,130124101,20866,2121,13586,6613,26524,13585,3855,13256,26841,13256,26842
ұ,YeHeZhen,130124103,35621,3596,23207,10454,43902,22538,7116,22537,45075,23126,46333
,DouYuZhen,130124104,38638,3694,24780,11167,48278,24169,7582,24553,48722,25134,49914
¥,LouDiZhen,130124105,29992,2748,19711,9029,38085,19508,6287,19071,38579,19316,39027
ϸ,NanGaoXiang,130124200,19156,2318,12859,5965,24643,12806,4197,12783,25589,12812,25671
,LiuLinTunXiang,130124201,30229,3387,19406,9595,38471,19406,5781,19990,39396,19991,39397
Ӫ,XiYingXiang,130124202,33681,3661,21968,10147,44073,21968,7181,22554,44522,22555,44523
,LongZhouZhen,130125100,51687,5170,36248,20140,58373,33599,13757,32285,65884,34366,70614
,NanQiaoZhen,130125101,20680,2723,14665,8677,27749,14167,6105,14386,28553,14843,29508
ϱ,ShangBeiZhen,130125102,10458,1324,7389,4558,14356,7389,3120,7509,14898,7513,14902
ͷ,KouTouZhen,130125103,17518,1878,12288,7005,24005,12282,5378,12478,24760,12486,24774
,DuYangGangXiang,130125200,27873,3213,19692,10752,37779,19690,8368,19734,39424,19762,39454
,AnXiangXiang,130125201,27360,2877,18841,10555,36344,18557,8108,19358,37915,19504,38345
ֻ,ZhiLiXiang,130125202,29693,3244,20593,11284,37086,19604,8058,19775,39379,20402,40995
ͬ,ShiTongXiang,130125203,16312,1584,11347,6186,21130,10967,4779,11056,22023,11328,22675
Ӫ,ZhaiYingXiang,130125204,22534,2560,16081,9336,31606,16081,7255,16263,32344,16268,32349
կ,ChengZhaiXiang,130125205,14365,1563,9833,5700,19732,9745,4311,10270,20015,10406,20239
Ϸ,ShangFangXiang,130125206,17289,2163,11975,7016,23451,11888,4946,12310,24198,12423,24398
ͤ,YuTingXiang,130125207,14509,1997,10192,5723,19843,10192,4017,10331,20523,10331,20523
,BeiHeXiang,130125208,4545,665,3090,2033,6269,3080,1258,3291,6371,3378,6468
ׯ,ShangYanZhuangXiang,130125209,4062,479,2774,1768,5460,2751,1187,2921,5672,2954,5728
ſ,JiuKouZiXiang,130125210,10721,1285,7482,4444,14977,7462,3375,7885,15347,7899,15381
,LingShouZhen,130126100,48170,4143,31764,16140,52742,29266,10400,28845,58111,30949,62713
ͬ,QingTongZhen,130126101,22164,2061,14414,6597,27411,13267,4900,13550,26817,14711,29125
,TaShangZhen,130126102,7777,834,5169,3040,10092,5168,1846,5286,10454,5288,10457
ׯ,ChenZhuangZhen,130126103,15480,1962,10286,6058,20045,9892,3488,10271,20163,10644,20930
,CiYuZhen,130126104,25730,2367,16669,8716,32812,15549,6324,15989,31538,17752,34421
ͷ,ChaTouZhen,130126105,14412,1322,9078,4620,18041,8948,3532,9220,18168,10188,19266
ʥԺ,SanShengYuanXiang,130126200,18834,2174,12513,6141,22847,12497,3985,12454,24951,12480,24993
,BeiWaXiang,130126201,16640,1542,11184,4962,21263,10941,3770,10489,21430,10768,21952
ţ,NiuChengXiang,130126202,17798,1954,11407,5468,23108,10821,3920,11189,22010,12265,23672
̨,GouTaiXiang,130126203,17293,1643,11054,5508,21632,10925,3945,11428,22353,11827,22881
կ,NanZhaiXiang,130126204,11705,1358,7849,4156,14966,7837,2691,7872,15709,7905,15754
ന,NanYanChuanXiang,130126205,9566,924,6521,3431,12793,6323,2566,6281,12604,6535,13056
̷ׯ,BeiTanZhuangXiang,130126206,8749,832,5883,3136,11418,5717,2174,5725,11442,5872,11755
կͷ,ZhaiTouXiang,130126207,10107,1329,6529,3724,13464,6526,2136,7007,13533,7043,13572
Ӫ,NanYingXiang,130126208,6457,1068,4420,2708,8820,4419,1486,4564,8983,4591,9011
,GaoYiZhen,130127100,39288,3703,25376,13533,43337,23465,9138,24236,47701,26753,52129
Ӫ,DaYingZhen,130127101,23846,2844,15725,7947,30397,15722,5326,16289,32011,16291,32016
,FuCunZhen,130127102,27932,3149,18177,9553,35152,18138,6529,18957,37095,19433,37610
к,ZhongHanXiang,130127201,17491,2049,11571,6027,22569,11571,4103,12071,23642,12072,23643
,WanChengXiang,130127202,31264,3287,19994,9899,38768,19994,6529,21086,41080,21086,41080
,ShenZeZhen,130128100,37096,4221,24386,13449,42294,21693,6804,21399,43092,23735,48121
,TieGanZhen,130128101,31293,4138,19068,11783,37160,18968,5252,19292,38260,21615,40683
ׯ,BaiZhuangXiang,130128200,32152,4646,21018,12006,41798,20462,6268,21121,41583,22048,43066
,LiuCunXiang,130128201,26507,3024,16290,8520,33610,16039,5401,16435,32474,18642,34932
԰,ZhaoBaXiang,130128202,27413,2645,16316,8147,32117,15831,5689,16995,32826,19431,35747
ͷ,QiaoTouXiang,130128203,35627,4366,23510,13359,45838,22760,7722,23388,46148,24205,47715
޻,ZanHuangZhen,130129100,49818,3808,31996,15467,60133,27774,12629,29176,56950,34259,66255
Ժͷ,YuanTouZhen,130129101,14639,1532,9967,6218,20288,9965,4226,10428,20393,10430,20397
,XiLongMenXiang,130129200,17713,1854,11929,6305,24094,11928,5021,12658,24586,12659,24588
Ϲ,NanXingGuoXiang,130129201,16578,1564,11588,6151,22997,11542,5481,11887,23429,12035,23623
,NanQingHeXiang,130129202,14590,1244,9789,5298,19882,9789,4357,10402,20191,10402,20191
,XiYangZeXiang,130129203,18691,1724,12391,6776,25326,12385,5051,13075,25460,13075,25466
,TuMenXiang,130129204,9665,979,6349,3943,13136,6349,2613,6903,13252,6908,13257
Ʊƺ,HuangBeiPingXiang,130129205,7494,997,5131,3491,10498,5131,2218,5578,10709,5578,10709
ʯ,ZhangShiYanXiang,130129206,4142,584,2883,1911,5786,2883,1134,2977,5860,2977,5860
ͤ,XuTingXiang,130129207,13982,1475,9403,5872,19414,9403,4251,10305,19708,10305,19708
,ZhangLengXiang,130129208,10598,1228,7140,4245,14527,7140,2919,7604,14744,7605,14745
޼,WuJiZhen,130130100,70696,6302,45800,24684,80582,42210,14954,42856,85066,46152,91952
߼,QiJiZhen,130130101,30984,3605,20041,10535,39755,19870,6545,20555,40425,21093,41134
Ŷι,ZhangDuanGuZhen,130130102,31976,3517,20961,11457,41426,20808,7418,21623,42431,21950,42911
,BeiSuZhen,130130103,39985,4061,26251,13837,51443,26120,8706,26320,52440,26501,52752
ׯ,GuoZhuangZhen,130130104,30748,3494,20484,10648,39773,20269,6758,20119,40388,20516,41000
,DaChenZhen,130130105,22835,2680,15514,7650,30293,15513,5436,15435,30948,15437,30951
ͷ,GaoTouXiang,130130200,24209,2433,15811,7994,30023,15681,5516,16069,31750,16347,32158
ׯ,HaoZhuangXiang,130130201,39130,3984,26166,12305,51267,25922,10281,26555,52477,27229,53395
,DongHouFangXiang,130130202,35913,4049,24081,13355,45508,23984,8529,24220,48204,24410,48491
ǵ,LiChengDaoXiang,130130203,32036,3684,21846,10239,42271,21710,7703,21354,43064,21577,43423
,NanLiuXiang,130130204,18126,2208,12174,6307,24114,12171,4161,12319,24490,12321,24495
ƽɽ,PingShanZhen,130131100,90651,8530,60366,31762,99093,57550,21450,57300,114850,60265,120631
,DongHuiSheZhen,130131101,25678,2648,16679,9287,31184,16406,6197,17168,33574,17844,34523
,WenTangZhen,130131102,14904,1787,9870,5608,18724,9496,3650,9973,19469,10471,20341
ϵ,NanDianZhen,130131103,17354,1599,11435,6359,20801,11279,4633,11516,22795,12151,23586
,GangNanZhen,130131104,19500,2505,13222,7847,26095,13215,5110,13887,27102,13893,27115
й,ZhongGuYueZhen,130131105,12978,1685,8388,4731,16454,8189,2947,8998,17187,9222,17610
»,XiaHuaiZhen,130131106,10791,1772,7269,4489,14742,7252,2556,7817,15069,7850,15119
ϼׯ,MengJiaZhuangZhen,130131107,3672,928,2752,1997,5455,2686,1054,2833,5519,2902,5654
С,XiaoJiaoZhen,130131108,11360,1587,7617,4674,15383,7381,2877,7796,15177,8207,15824
̶ׯ,JiaoTanZhuangZhen,130131109,4523,952,3231,2126,6445,3217,1101,3313,6530,3345,6576
,XiBaiPoZhen,130131110,3586,576,2563,1829,4516,2447,980,2459,4906,2579,5142
¿,XiaKouZhen,130131111,5513,751,3743,2470,7446,3675,1436,3822,7497,3957,7700
,XiDaWuXiang,130131200,13766,1539,9286,5073,18076,9284,3724,9737,19021,9743,19029
,ShangSanJiXiang,130131201,14586,1657,9846,5445,19416,9845,3606,9998,19843,10003,19849
,LiangHeXiang,130131202,12799,1372,8999,5027,17173,8996,3898,9066,18062,9070,18069
,DongWangPoXiang,130131203,13577,1730,9420,5763,18439,9420,3995,9882,19302,9882,19302
ռׯ,SuJiaZhuangXiang,130131204,4744,852,3478,2253,6662,3456,1487,3568,7024,3605,7083
լ,ZhaiBeiXiang,130131205,6714,1223,4840,3135,9755,4777,2076,5060,9837,5173,10013
ұ,BeiYeXiang,130131207,11771,1755,7989,4605,16206,7775,2930,8094,15869,8467,16456
Ϲ,ShangGuanYinTangXiang,130131209,1931,556,1492,1149,2924,1468,538,1491,2959,1533,3025
,YangJiaQiaoXiang,130131210,5128,871,3684,2470,7134,3664,1454,3736,7400,3769,7453
Ӫ,YingLiXiang,130131211,6522,1021,4425,2770,9016,4423,1613,4721,9144,4731,9156
Ϻӿ,HeHeKouXiang,130131212,2779,645,2030,1428,4064,1930,749,1965,3895,2143,4173
ֵ´,ChengQuJieDaoBanShiChu,130132001,23741,1326,15471,7847,19951,12815,5935,13356,26171,15531,31002
,HuaiYangZhen,130132100,37790,3629,25049,11288,48916,25048,9440,25809,50857,25810,50859
,YinCunZhen,130132101,21999,2402,14134,6882,27720,13661,4943,14368,28029,15210,29344
,NanZuoZhen,130132102,11742,1264,7810,3545,15452,7733,2698,7827,15560,7894,15704
β,SongCaoZhen,130132103,25031,2423,16384,7597,33141,16129,6147,16743,32872,17217,33601
,NanYinZhen,130132104,26426,2464,17372,7475,34532,17354,6454,17943,35297,17972,35344
,JiCunZhen,130132105,20732,2204,13853,6067,27028,13853,4602,13685,27538,13685,27538
,MaCunXiang,130132200,25518,2508,16564,7646,32888,16561,5242,16700,33261,16704,33268
,DongZhangXiang,130132201,27660,2588,18908,7795,38034,18908,8064,19403,38311,19404,38312
ͬ,ZhaoTongXiang,130132202,21140,2078,13755,6541,26834,13754,4947,14410,28164,14410,28165
,BeiChuXiang,130132203,15496,1625,10099,5314,20227,10098,3576,10587,20685,10598,20697
մ,SuCunXiang,130132204,10258,1085,6838,3527,14147,6837,2811,7296,14133,7316,14154
,SuYangXiang,130132205,17264,1552,11733,5350,23178,11697,4792,11805,23502,11875,23608
,BeiZhengXiang,130132206,9718,918,6347,3278,13173,6347,2553,6842,13189,6842,13189
ǰ,QianXianXiang,130132207,7027,911,4626,2269,9618,4569,1789,4966,9535,5101,9727
ˮ,HeiShuiHeXiang,130132208,10098,1255,6722,3408,13737,6720,2601,7226,13946,7232,13954
,ZhaoZhouZhen,130133100,96984,9420,61709,36693,110375,56243,21141,59788,116031,65836,127545
ׯ,FanZhuangZhen,130133101,52340,5414,33197,16507,66854,33089,11401,35876,68965,35958,69155
,BeiWangLiZhen,130133102,32581,3594,21259,11063,42393,21042,7937,22642,43684,22853,44112
կ,XinZhaiDianZhen,130133103,21776,2827,14592,8078,28012,14551,5422,15228,29779,15433,30025
,HanCunZhen,130133104,36077,4198,23974,12454,47924,23686,9046,25184,48870,25347,49321
ϰ,NanBaiSheZhen,130133105,30052,3220,19651,10096,39271,19528,7866,20923,40451,21487,41138
ɳӵ,ShaHeDianZhen,130133106,23396,2821,15481,8577,30372,15095,5153,15594,30689,15889,31370
ǰ,QianDaZhangXiang,130133200,33495,4036,21868,11496,43091,21860,6969,22609,44469,22632,44500
лׯ,XieZhuangXiang,130133201,51735,4978,32855,15555,66447,32855,11127,34985,67840,34985,67840
ߴ,GaoCunXiang,130133202,29124,3264,19062,10629,38264,19052,6837,20133,39185,20163,39225
,WangXiZhangXiang,130133203,19512,2403,12937,7178,25269,12937,4931,13908,26845,13909,26846
,XinJiZhen,130181100,141271,11489,89066,49517,126859,76682,23548,76306,152988,87242,176308
ɳ,JiuChengZhen,130181101,30060,4159,19325,10670,36552,18121,4413,18370,36491,19307,38632
Źׯ,ZhangGuZhuangZhen,130181102,22344,3114,14336,8100,28684,14336,3621,14743,29079,14743,29079
λ,WeiBoZhen,130181103,29439,3832,19476,10414,36172,18235,5477,18201,36436,19272,38748
ͷ,XinLeiTouZhen,130181104,30735,4241,20665,11234,40256,20660,5785,20086,40746,20096,40761
³,XinChengZhen,130181105,16390,2507,10540,6359,19275,9800,2002,9631,19431,10359,20899
,NanZhiQiuZhen,130181106,26919,3706,17497,9763,34716,17442,4540,17618,35060,17668,35165
,WangKouZhen,130181107,26843,4224,17517,10833,33952,16966,3817,16821,33787,17367,34884
칬Ӫ,TianGongYingXiang,130181200,20846,2980,13526,8201,27072,13519,3464,13745,27264,13764,27290
ǰӪ,QianYingXiang,130181201,21557,3315,14299,8405,28098,14291,3673,14233,28524,14246,28545
ׯ,MaZhuangXiang,130181202,18037,2944,11922,8035,23377,11909,2686,11724,23633,11745,23667
,HeMuJingXiang,130181203,23494,3550,15662,8982,30665,15628,4145,15397,31025,15527,31189
ׯ,TianJiaZhuangXiang,130181204,35246,4950,23677,12765,46223,23672,6696,23210,46882,23215,46892
,ZhongLiXiangXiang,130181205,15351,2216,9925,6397,20127,9919,2775,10413,20332,10417,20342
Сׯ,XiaoXinZhuangXiang,130181206,17763,2737,11542,7216,23002,11513,3018,11865,23378,11976,23518
,LianZhouZhen,130182100,99965,9488,64971,36946,114007,63886,18756,62286,126172,63238,128209
˰,XingAnZhen,130182101,39083,4511,25261,12975,50305,25133,7109,25354,50487,25442,50703
ׯ,JiaShiZhuangZhen,130182102,37893,4372,23941,11222,47851,23559,6009,24098,47657,24333,48274
Ӫ,NanYingZhen,130182103,32134,4093,21035,10322,42727,20810,6791,21621,42431,21983,43018
÷,MeiHuaZhen,130182104,45600,5561,29492,14663,60144,29156,9630,30834,59990,31299,60791
,GangShangZhen,130182105,29317,3480,19558,8549,33441,16306,4447,16141,32447,17686,37244
ͷ,QiuTouZhen,130182106,35169,4368,23358,12213,45453,23265,6754,22837,46102,22933,46291
϶,NanDongZhen,130182107,32694,3917,21800,10640,42377,21557,6323,20683,42240,21134,42934
żׯ,ZhangJiaZhuangZhen,130182108,39778,4175,26499,13193,51969,26498,8651,26105,52603,26105,52604
,NanMengZhen,130182109,33589,3462,22366,10804,43368,22159,7266,21726,43885,21951,44317
,ZengCunZhen,130182110,44534,4283,28669,14609,57347,28669,9522,29669,58338,29670,58339
,ChangAnZhen,130182111,40766,4435,26112,12736,52514,26112,7622,26710,52822,26711,52823
,XiGuanZhen,130182112,33069,3367,21436,10592,42688,21436,6708,21708,43144,21708,43144
Ż,JiuMenHuiZuXiang,130182200,31316,3372,20814,11055,40626,20814,6310,20184,40998,20184,40998
ʯׯü�,ShiJiaZhuangJingJiJiShuKaiFa,130182500,19555,2454,13209,6544,24644,13096,3412,12123,25219,12212,25421
,JinZhouZhen,130183100,105495,9717,67254,39987,120066,64633,20309,66246,130879,68267,135521
ʮׯ,ZongShiZhuangZhen,130183101,37758,4176,24146,12709,47994,23918,7080,24702,48620,24868,49014
Ӫ,YingLiZhen,130183102,24585,2885,15683,7952,30800,15682,4511,16298,31980,16298,31981
԰,TaoYuanZhen,130183103,41514,4683,26489,13508,52834,26482,7629,27327,53809,27337,53826
׿,DongZhuoSuZhen,130183104,34464,4255,22526,12918,43108,22099,7029,22343,44442,23222,45748
,MaYuZhen,130183105,32356,3869,20932,10941,40937,20932,5922,21213,42145,21215,42147
С,XiaoQiaoZhen,130183106,46324,4842,29971,14851,57763,29917,8714,29839,59756,29909,59880
,HuaiShuZhen,130183107,40644,4896,26739,15368,52393,26736,8706,27479,54215,27507,54246
ׯ,DongLiZhuangZhen,130183108,37834,4318,24424,12839,47052,24132,6534,23970,48102,24262,48686
ܼׯ,ZhouJiaZhuangXiang,130183201,12478,1264,8297,3597,12756,6495,2888,6637,13132,8333,16630
ٽֵ´,ChangShouJieDaoBanShiChu,130184001,77455,5486,50252,24652,76246,44581,16406,44414,88995,49095,99347
Ƥ,HuaPiZhen,130184101,15660,1650,10690,5238,20646,10627,3969,10533,21160,10589,21279
а,ChengAnZhen,130184102,54728,4231,36588,17527,70974,35507,14190,35952,71459,36561,73149
Ī,ZhengMoZhen,130184103,15698,1506,10565,5558,20998,10473,4173,10686,21159,10812,21377
ϴ,NanDaYueZhen,130184104,15254,1209,9958,5029,19776,9832,3642,10018,19850,10147,20105
Ź,DuGuZhen,130184105,22645,1977,15494,7571,30584,15391,6732,15698,31089,15860,31354
ۢ,HanTaiZhen,130184106,52784,5131,36048,16843,70531,35695,14718,36347,72042,36585,72633
,DongWangZhen,130184107,20612,1999,14010,6748,27660,14009,5706,14305,28314,14307,28317
ͷ,MaTouPuZhen,130184108,29221,3079,19778,9624,38510,19727,7710,20175,39902,20232,40010
Э,XieShenXiang,130184200,28283,2810,19696,9097,36488,18707,7921,18602,37309,19318,39014
ľ,MuCunXiang,130184201,15330,1351,10287,4826,20325,10139,4069,10252,20391,10463,20750
ׯ,PengJiaZhuangXiang,130184202,14812,1474,10044,4703,19789,9853,4031,9979,19832,10273,20317
¹,HuoLuZhen,130185100,61727,5822,38574,20637,58738,35401,10701,33962,69363,39676,78250
ͭұ,TongYeZhen,130185101,57618,5652,36664,16489,59057,32460,10158,31698,64158,36764,73428
¼ׯ,SiJiaZhuangZhen,130185102,29493,3243,19456,9373,35654,19403,5667,18813,38216,18947,38403
ׯ,ShangZhuangZhen,130185103,37062,3463,25002,13244,34671,23916,7869,23183,47099,23392,48394
,LiCunZhen,130185104,25039,3178,16779,9008,32578,16743,5498,16827,33570,16936,33715
˰,YiAnZhen,130185105,20975,2636,13563,7774,25932,13422,4542,13711,27133,14590,28153
Ʊׯ,HuangBiZhuangZhen,130185106,12396,1515,8160,4520,15936,8160,2558,8308,16468,8309,16469
,DaHeZhen,130185107,33355,3978,22096,10297,41789,21255,6778,20846,42101,22015,44111
ɽ,ShanYinCunZhen,130185108,9910,1184,6535,3074,12355,6406,1863,6219,12625,6422,12957
ʯ,ShiJingXiang,130185200,8434,1218,5537,3105,10060,5434,1712,5435,10869,5827,11364
¹Ȫ,BaiLuQuanXiang,130185201,5752,980,3757,2277,7334,3746,1047,3972,7718,4022,7779
կ,ShangZhaiXiang,130185202,7047,918,4463,2580,8929,4463,1211,4713,9176,4713,9176
ӱ¹Ȫÿ,HeBeiLuQuanJingJiKaiFaQu,130185500,27299,1250,17781,3879,13820,7670,2188,7285,14955,12956,30737
ѧԺ·ֵ´,XueYuanNanLuJieDaoBanShiChu,130202001,26474,4189,17564,11674,27028,17035,3302,16036,33071,16401,33965
ֵ´,YouYiJieDaoBanShiChu,130202002,30277,3547,20086,12163,22792,17511,4317,16501,34012,18055,38141
㳡ֵ´,GuangChangJieDaoBanShiChu,130202003,29970,3568,16142,8178,24625,12017,2446,11334,23351,19842,35984
Žֵ´,YongHongQiaoJieDaoBanShiChu,130202004,17911,1839,9667,7033,13420,9504,1991,9849,19353,12074,21741
Сɽֵ´,XiaoShanJieDaoBanShiChu,130202005,11031,1664,6942,5331,9901,6878,1401,7055,13933,7154,14096
ıֵ´,WenBeiJieDaoBanShiChu,130202006,22706,2070,12896,8573,18970,11712,2639,11431,23143,14519,27415
ǮӪֵ´,QianYingJieDaoBanShiChu,130202007,4852,413,3009,2282,4759,3008,794,3020,6028,3050,6059
«̨�,LuTaiKaiFaQuHaiBeiZhen,130202100,20520,2207,13336,7761,25035,13045,4916,13797,26842,14307,27643
,HanGuGuanLiQuHanFengZhen,130202101,18557,2294,12038,6873,22534,12036,3788,12537,24573,12601,24639
Ů֯կ,NvZhiZhaiXiang,130202200,38229,3173,22883,14100,30023,21289,6233,21174,42463,24752,47635
«ֵ̨´,LuTaiKaiFaQuJieDaoBanShiChu,130202450,9883,2130,6633,5143,11658,6222,1385,6128,12350,6765,13398
ũ´,HanGuGuanLiQuXingNongBanShiChu,130202451,2226,496,1492,1150,1994,1476,299,1509,2985,1529,3021
˽ֵ´,HanGuGuanLiQuZhenXingJieDaoBanShiChu,130202452,13599,1613,8025,5714,12904,7914,2127,7885,15799,9314,17339
ͽֵ´,QiaoTunJieDaoBanShiChu,130203001,35160,5200,22211,13390,35373,20180,3838,19265,39445,21987,44198
Ļ·ֵ´,WenHuaLuJieDaoBanShiChu,130203002,53110,8300,34303,19554,56967,27922,5266,26076,53998,32373,66676
ֵ̨´,DiaoYuTaiJieDaoBanShiChu,130203003,45414,7199,29293,20340,48942,28993,6120,28230,57223,29440,58733
´ֵ´,DongXinCunJieDaoBanShiChu,130203004,8039,991,4426,2990,8464,4262,741,4314,8576,5345,9771
Ҥֵ´,GangYaoJieDaoBanShiChu,130203005,32623,4283,20112,13622,33658,18525,3577,18197,36722,20371,40483
·ֵ´,JiChangLuJieDaoBanShiChu,130203006,58225,7568,36727,24207,61579,35213,7944,33901,69114,37010,73737
ӱ·ֵ´,HeBeiLuJieDaoBanShiChu,130203007,32069,4597,20066,12827,36231,19283,3931,18841,38124,20531,40597
ֵ´,LongDongJieDaoBanShiChu,130203008,34655,3869,20080,13396,37818,19167,3383,19569,38736,21827,41907
ֵ´,DaLiJieDaoBanShiChu,130203009,48823,4810,30878,20481,41487,28442,6110,27119,55561,28865,59743
ֵ´,GuangMingJieDaoBanShiChu,130203010,69230,6655,42105,26303,69193,37479,8910,36876,74355,42690,84795
Ƶֵ´,XiangYunDaoJieDaoBanShiChu,130203011,24040,2157,15073,10341,19161,15047,3872,14923,29970,14996,30069
԰,GuoYuanXiangZhengFu,130203200,70157,6441,45399,27696,62826,44667,12831,42663,87330,44030,89429
ӱɽ¼ҵ԰,HeBeiTangShanGaoXinJiShuChanYeYuanQu,130203450,87707,5309,51669,24597,58208,35598,10350,35132,70730,51697,103366
ֵ´,LinXiJieDaoBanShiChu,130204001,63076,9089,40706,29873,69899,40391,8440,39399,79790,39899,80605
Ƽׯֵ´,TangJiaZhuangJieDaoBanShiChu,130204002,42188,6345,27064,19548,48914,26753,4679,25859,52612,26148,53212
ұֵ´,GuYeJieDaoBanShiChu,130204003,21456,2757,13334,9728,18111,12620,2529,12425,25045,13408,26742
Ըׯֵ´,ZhaoGeZhuangJieDaoBanShiChu,130204004,47735,6694,29622,21295,56323,29542,5488,29280,58822,30295,59917
ֵ´,LvJiaTuoJieDaoBanShiChu,130204005,43685,5584,27272,19049,52549,27231,7070,27115,54346,29067,56339
ҵ,BeiJiaDianXiang,130204200,21402,2999,14065,9388,26733,14058,3965,14289,28347,14301,28366
ׯ,WangNianZhuangXiang,130204201,21997,3144,14372,9612,26676,14354,3850,14559,28913,14619,28991
ϰ,XiJiaTaoXiang,130204202,9022,1364,5935,3928,10635,5904,1526,5904,11808,5977,11912
ׯ,DaZhuangTuoXiang,130204203,9544,1318,6184,4083,11080,6147,1515,6140,12287,6193,12377
ҹֵ´,MaJiaGouJieDaoBanShiChu,130205001,20365,2925,12441,9228,19927,12364,2514,12047,24411,13363,25804
ƽֵ´,KaiPingJieDaoBanShiChu,130205002,23602,2130,14878,10498,19739,14311,4451,14241,28552,15305,30183
˰ׯֵ´,ShuiWuZhuangJieDaoBanShiChu,130205003,14983,1406,8837,6580,12642,8728,1886,8652,17380,9438,18275
ֵ´,DouDianJieDaoBanShiChu,130205005,2396,258,1354,1213,2618,1344,158,1399,2743,1458,2812
ׯֵ´,JingGeZhuangJieDaoBanShiChu,130205006,5528,527,2981,2142,5175,2959,689,2916,5875,3763,6744
ƽ,KaiPingZhen,130205100,47166,5221,29580,20447,47381,29424,7747,29586,59010,30554,60134
԰,LiYuanZhen,130205101,22726,2675,14781,9939,26141,14719,4069,14518,29237,14689,29470
֣ׯ,ZhengZhuangZiZhen,130205102,17384,1952,11165,7695,16979,11079,3008,11025,22104,11179,22344
˫,ShuangQiaoZhen,130205103,10309,1319,6800,4373,12930,6766,2097,6865,13631,6925,13725
,WaLiZhen,130205104,15164,1800,10114,6756,18384,10077,3409,10129,20206,10259,20373
Խ,YueHeZhen,130205105,25562,2649,15861,11071,22617,15452,4496,15763,31215,16846,32707
,DaoDiZhen,130207102,26078,2886,16226,10216,25880,14738,3957,15353,30091,16695,32921
С,XiaoJiZhen,130207103,25645,3772,16712,12678,32235,16657,4675,17208,33865,17380,34092
Ƹׯ,HuangGeZhuangZhen,130207104,40091,4563,25502,17101,44946,25269,7480,26104,51373,26632,52134
,XiGeZhen,130207105,17705,2168,11570,7179,22130,11552,3483,11681,23233,11786,23356
ׯ,DaXinZhuangZhen,130207106,39986,6145,26745,19593,52177,26443,8184,27245,53688,27570,54315
ǮӪ,QianYingZhen,130207107,34530,4383,22566,15150,43498,22528,7053,23262,45790,23400,45966
Ʒ,TangFangZhen,130207108,13892,1620,8564,5396,15807,8137,2267,8696,16833,9215,17779
ׯ,WangLanZhuangZhen,130207109,29220,3185,18410,11926,35989,18288,5460,19313,37601,19455,37865
,LiuShuQuanZhen,130207110,19969,2376,12653,8024,25062,12550,3833,13380,25930,13525,26178
,HeiYanZiZhen,130207111,14400,1467,9085,6020,18102,9070,2870,9565,18635,9652,18737
,BinHaiZhen,130207112,12622,1654,8192,5437,15522,8191,2261,8339,16530,8345,16537
,FengNanZhen,130207113,103526,8470,65110,40053,89426,59818,19152,59899,119717,66038,131148
ׯ,DaQiGeZhuangZhen,130207114,10341,1293,6607,4710,12594,6573,1947,6861,13434,6974,13581
ׯ,NanSunZhuangXiang,130207201,16118,1896,10042,6506,20022,10028,2635,10557,20585,10607,20649
ׯ,DongTianZhuangXiang,130207202,12691,1380,8119,4509,15841,8119,2285,8233,16352,8237,16356
ֹ,JianZiGuXiang,130207203,12525,1395,8045,4626,15579,8033,2355,8181,16214,8230,16275
ӱϱÿ,HeBeiNanBaoJingJiKaiFaQu,130207450,31610,1972,13951,10004,25228,13249,3996,13238,26487,23627,37578
̫ƽ·ֵ´,TaiPingLuJieDaoBanShiChu,130208001,61657,7075,34731,24251,59023,31940,8227,31276,63216,42228,76959
ɽ·ֵ´,YanShanLuJieDaoBanShiChu,130208002,41113,6518,27660,20607,40913,27146,6878,25480,52626,26849,54509
ֵ´,GengYangJieDaoBanShiChu,130208003,59365,5675,38183,27066,52070,37861,12196,38031,75892,39053,77236
,FengRunZhen,130208100,52693,5990,35124,21950,61611,33678,11622,34034,67712,35181,70305
ׯ,LaoZhuangZiZhen,130208101,27146,3485,17849,12833,33208,17841,5421,18142,35983,18203,36052
θׯ,RenGeZhuangZhen,130208102,25460,2782,15967,9688,25020,13776,4512,14199,27975,16787,32754
,ZuoJiaWuZhen,130208103,26636,3992,18035,13033,34806,18021,6215,18753,36774,18808,36843
Ȫͷ,QuanHeTouZhen,130208104,17727,2493,12076,8574,22785,12019,4345,12301,24320,12489,24565
Ӫ,WangGuanYingZhen,130208105,26973,3456,18090,12206,34483,17680,6833,18706,36386,19172,37262
ʯӪ,HuoShiYingZhen,130208106,19351,3004,12928,8829,25116,12886,4548,13681,26567,13975,26903
,HanChengZhen,130208107,48208,5208,29849,20424,45605,29045,8616,29521,58566,32183,62032
,ChaHeZhen,130208108,19258,2618,12591,8466,23269,12582,3922,13177,25759,13207,25798
¾,XinJunTunZhen,130208109,28321,3857,18719,12428,34499,18442,5715,18847,37289,19174,37893
СŸׯ,XiaoZhangGeZhuangZhen,130208110,11788,1657,7775,5016,14801,7766,2400,7993,15759,8070,15845
,FengDengWuZhen,130208111,27669,3994,18529,12418,35418,18518,6081,19151,37669,19215,37744
ׯ,LiZhaoZhuangZhen,130208112,16172,2276,10684,7873,20560,10674,3396,11110,21784,11160,21844
׹,BaiGuanTunZhen,130208113,29713,4319,19893,13113,38454,19852,6361,20353,40205,20500,40393
ʯׯ,ShiGeZhuangZhen,130208114,20392,3038,13781,9347,26318,13777,4565,14168,27945,14214,27995
ɳ,ShaLiuHeZhen,130208115,23558,3518,16209,11621,31274,16207,5702,16544,32751,16569,32778
ׯ,QiShuZhuangZhen,130208116,13139,1830,8734,6297,15876,8488,2806,8757,17245,9041,17775
,YangGuanLinZhen,130208117,18953,2555,12659,9102,24401,12604,4396,13106,25710,13245,25904
Ӫ,JiangJiaYingXiang,130208202,11342,1371,7409,5273,13468,7383,2627,7849,15232,7931,15340
ϲׯ,HuanXiZhuangXiang,130208205,10967,1485,7203,4853,13639,7203,2310,7550,14753,7559,14762
,YinChengPuXiang,130208207,24583,2725,15966,11129,26468,15844,5163,16068,31912,16505,32471
Ӫ,LiuJiaYingXiang,130208208,10479,1166,6743,4808,11576,6674,2258,6884,13558,7160,13903
ׯ,ChangZhuangXiang,130208209,15526,1606,9675,6698,17462,9555,3095,9632,19187,10552,20227
кӽֵ´,LuanHeJieDaoBanShiChu,130223001,32611,2326,21422,13085,30711,19193,6847,18941,38134,20362,41784
ųǽֵ´,GuChengJieDaoBanShiChu,130223002,29375,4039,19576,11375,34060,17586,5307,17708,35294,19145,38721
,LuanZhouZhen,130223100,43221,5340,27908,18358,52821,27295,8976,28251,55546,29629,57537
,XiangTangZhen,130223101,30433,4076,19408,13036,38224,19302,5849,19828,39130,20950,40358
ׯ,DongAnGeZhuangZhen,130223102,46167,5960,30393,19789,59173,30344,10682,32133,62477,32416,62809
ׯ,LeiZhuangZhen,130223103,27425,3246,17609,11532,34947,17607,5569,18603,36210,18631,36240
,CiYuTuoZhen,130223104,19315,2484,12869,8435,24790,12803,4270,13037,25840,13200,26069
,ZhenZiZhen,130223105,40679,5005,27265,17152,53047,27225,9532,27821,55046,27951,55216
ׯ,YangLiuZhuangZhen,130223106,16432,2257,10861,7308,21479,10831,3649,11389,22220,11477,22338
ե,YouZhaZhen,130223107,32829,4156,21972,13352,44224,21780,8432,23141,44921,23445,45417
,GuMaZhen,130223108,23331,3228,15311,10507,30240,15270,4830,15877,31147,16078,31389
Сׯ,XiaoMaZhuangZhen,130223109,26551,3381,17590,11725,35252,17552,6266,18520,36072,18608,36198
Űٻ,JiuBaiHuZhen,130223110,24478,2996,16344,10388,32068,16330,6508,17278,33608,17638,33982
,WangDianZiZhen,130223111,19275,2671,12721,8376,25257,12712,4311,13492,26204,13536,26257
ǽֵ´,BenChengJieDaoBanShiChu,130224001,33999,2412,22026,13658,29431,19649,6801,19272,38921,21186,43212
,BenChengZhen,130224100,46965,6196,31028,19696,58057,30210,9690,30258,60468,31823,62851
ε,SongDaoKouZhen,130224101,38118,5625,25634,16202,49574,25365,7435,25149,50514,25544,51178
,ChangNingZhen,130224102,25795,3766,17016,10766,33002,16364,4915,16739,33103,17460,34476
ׯ,HuGeZhuangZhen,130224103,27048,4028,17919,10770,33921,17166,4645,17308,34474,17802,35721
,TuoLiZhen,130224104,13728,1980,9150,5690,18019,9072,2613,9056,18128,9171,18321
Ҧׯ,YaoWangZhuangZhen,130224105,12578,1963,8377,5446,16614,8281,2418,8461,16742,8582,16959
˾ׯ,SiGeZhuangZhen,130224106,31127,5229,20895,14033,41370,20315,6104,20775,41090,21565,42460
ׯ,AnGeZhuangZhen,130224107,18569,3084,12473,8659,24857,12471,3804,12971,25442,12984,25457
ǳݸ,BaChiGangZhen,130224108,27781,4238,18845,11991,36888,18396,6357,18962,37358,19531,38376
ׯ,ChengZhuangZhen,130224109,37210,5310,24701,15809,50131,24672,8308,26005,50677,26127,50828
Ӫ,QingTuoYingZhen,130224110,20195,3378,13688,9496,27465,13688,4438,14323,28011,14323,28011
ظׯ,BaiGeZhuangZhen,130224111,34799,5061,23581,14232,46597,23517,7340,23444,46961,23619,47200
,LiuZanZhen,130224113,9434,1174,6242,4040,12255,6172,2131,6357,12529,6497,12739
ϱ,NanBaoZhen,130224114,11754,1449,7264,4023,14231,7207,2392,7210,14417,8331,15595
ׯ,FangGeZhuangZhen,130224115,21477,3415,14317,9379,28345,14317,4118,14693,29010,14693,29010
,DongHuangTuoZhen,130224116,11744,1810,8046,5185,15882,8046,2663,8165,16211,8171,16217
,MaChengZhen,130224117,11796,1697,7872,5189,15724,7866,2414,8017,15883,8035,15907
ְֵ´,LeAnJieDaoBanShiChu,130225001,60625,5707,38397,23405,57707,32782,10771,31156,63938,38706,77103
ͤ,LeTingZhen,130225100,27789,4460,18331,13172,34642,18331,4485,18398,36729,18403,36734
Һ,TangJiaHeZhen,130225101,21469,3225,13367,8899,25784,12781,3040,12952,25733,14367,27734
,HuJiaTuoZhen,130225102,16167,2432,10504,7311,19856,10499,2449,10533,21032,10544,21048
̲,WangTanZhen,130225103,35715,5116,23337,16120,44137,23324,5814,23268,46592,23308,46645
Ƹׯ,YanGeZhuangZhen,130225104,26717,4105,17349,12091,33027,17331,3811,17239,34570,17284,34633
ͷӪ,MaTouYingZhen,130225105,21844,3510,14195,9547,28333,13872,3667,14083,27955,14826,29021
կ,XinZhaiZhen,130225106,19659,2989,12822,8539,23107,11806,2932,11908,23714,12758,25580
͡,TingLiuHeZhen,130225107,19720,2963,12888,8872,24608,12473,3257,12593,25066,13052,25940
ׯ,JiangGeZhuangZhen,130225108,36839,5471,24149,16666,47256,24102,6336,24140,48242,24497,48646
ëׯ,MaoZhuangZhen,130225109,23570,3763,15338,10762,29529,15317,3577,15526,30843,15572,30910
б,ZhongBaoZhen,130225110,23254,3967,15351,10925,30021,15144,3784,15253,30397,15654,31005
Ӹׯ,PangGeZhuangXiang,130225201,16091,3005,10637,7522,20305,10600,2407,10478,21078,10866,21503
ׯ,DaXiangGeZhuangXiang,130225202,16092,2444,10626,7438,20740,10618,2756,10659,21277,10666,21292
ź,GuHeXiang,130225203,16078,2397,10583,7092,20754,10583,2747,10639,21222,10639,21222
«γ,ChangLuDaQingHeYanChang,130225450,3250,351,1409,1146,3832,1385,300,1540,2925,2492,3901
,HaiGangQu,130225451,20548,447,8448,5695,6622,6720,2310,7285,14005,14857,23305
ֵ´,LiXiangJieDaoBanShiChu,130227001,30192,1977,19114,12438,25431,18572,6736,18719,37291,19791,38905
˳,XingChengZhen,130227100,38939,4550,26138,15888,49605,26134,9325,26551,52685,26676,52814
,JinChangYuZhen,130227101,12666,1300,8138,4818,16456,8133,3323,8537,16670,9151,17289
,SaHeQiaoZhen,130227102,14197,1520,9438,5204,17798,9164,3699,9292,18456,9978,19416
̫ƽկ,TaiPingZhaiZhen,130227103,25297,2574,16864,9721,34161,16843,7326,18063,34906,18333,35197
޼,LuoJiaTunZhen,130227104,18106,2144,11995,7041,23607,11655,4435,12253,23908,12690,24685
,DongHuangYuZhen,130227105,10583,1069,6895,4275,13608,6828,2784,7214,14042,7541,14436
¼,XinJiZhen,130227106,18584,2534,12604,7895,25015,12513,4735,13082,25595,13249,25853
Ӫ,SanTunYingZhen,130227107,21415,2168,13602,7742,26163,13405,5391,13901,27306,15372,28974
,LuanYangZhen,130227108,13853,1344,9380,4942,18810,9257,3921,9593,18850,9738,19118
,BaiMiaoZiXiang,130227200,13240,1530,8881,5146,17143,8801,3340,9017,17818,9229,18110
Ӫ,ShangYingXiang,130227201,8343,834,5492,3282,11390,5439,2464,6063,11502,6149,11641
ׯ,HanErZhuangXiang,130227202,15132,1496,10267,5378,20276,10162,4293,10333,20495,10654,20921
滧կ,YuHuZhaiXiang,130227203,7783,758,4963,2970,9772,4917,2141,5227,10144,5719,10682
ɳ,JiuChengXiang,130227204,6495,675,4323,2529,8421,4278,1821,4473,8751,4668,8991
ׯ,YinZhuangXiang,130227205,14010,1599,9474,5677,18444,9196,3838,9661,18857,9973,19447
Ժ,DongLianHuaYuanXiang,130227206,8693,1178,5770,3799,11681,5675,2023,5963,11638,6124,11894
ׯ,XinZhuangZiXiang,130227207,8512,1205,5612,3746,11236,5607,2038,6101,11708,6143,11755
,YuTianZhen,130229100,101080,10438,65790,39336,104905,60098,20687,60329,120427,66415,132205
׵,LiangJiaDianZhen,130229101,29064,4018,19381,12774,37289,19354,6166,19764,39118,19867,39248
ѻ,YaHongQiaoZhen,130229102,44009,5083,28600,17025,52514,28373,9292,29259,57632,29784,58384
,WoLuoGuZhen,130229103,39055,4992,25223,16037,49210,25196,7518,26288,51484,26342,51565
ʯ,ShiJiuWoZhen,130229104,26885,3479,17708,10987,34913,17607,5546,18102,35709,18202,35910
,HongQiaoZhen,130229105,22820,3176,14903,9776,28784,14848,4617,15601,30449,15710,30613
ɢˮͷ,SanShuiTouZhen,130229106,19606,2785,12913,8173,25228,12896,4100,13544,26440,13578,26491
ϲ,LinNanCangZhen,130229107,18395,2129,11834,6643,20733,10791,3163,10942,21733,11853,23687
,LinXiZhen,130229108,22831,3099,14750,9333,29367,14365,4608,15089,29454,15788,30538
Ұ,YangJiaBanQiaoZhen,130229109,19752,2671,12752,8503,25896,12569,3807,13029,25598,13478,26230
ͤ,CaiTingQiaoZhen,130229110,14474,1919,9664,6332,18183,9649,3271,9976,19625,10000,19664
,GuShuZhen,130229111,18666,2342,12089,7781,24117,12060,4032,12817,24877,12951,25040
,DaAnZhen,130229112,22436,2932,14729,8653,29502,14649,4845,15378,30027,15484,30213
ͷ,TangZiTouZhen,130229113,13293,2046,8611,5617,17531,8598,2813,9475,18073,9541,18152
,GuoJiaTunXiang,130229200,25581,3429,16861,10767,33479,16849,5499,17527,34376,17648,34509
ͷ,LinTouTunXiang,130229201,15170,2163,10365,6823,20240,10357,3672,10630,20987,10640,21005
,YangJiaTaoXiang,130229202,19496,2540,12962,8774,24601,12897,4528,13315,26212,13602,26564
,ChaoLuoWoXiang,130229203,16827,2065,10829,7082,21971,10806,3300,11310,22116,11363,22192
¼,ChenJiaPuXiang,130229204,11944,1638,7753,4835,14706,7393,2218,7722,15115,8047,15800
,GuoJiaQiaoXiang,130229205,12653,1770,8312,5521,16095,8312,2400,8511,16823,8511,16823
ƺ,TangHaiZhen,130230100,44989,4140,24917,16719,37158,22362,5805,22758,45120,30017,54934
һũ,YiNongChang,130230401,7794,1261,5257,3792,10118,5253,1304,5094,10347,5102,10359
ũ,SanNongChang,130230403,5092,692,3266,2221,5936,3133,806,3097,6230,3324,6590
ũ,SiNongChang,130230404,7716,779,3997,2743,6700,3831,993,3887,7718,5491,9488
ũ,WuNongChang,130230405,5388,733,3322,2322,5969,3260,874,3205,6465,3673,6995
ũ,LiuNongChang,130230406,4676,771,3138,2385,5799,3117,800,3052,6169,3109,6247
ũ,QiNongChang,130230407,2068,214,1237,682,1781,918,271,927,1845,1316,2553
ũ,BaNongChang,130230408,20075,3039,13724,10090,25965,13711,4080,13395,27106,13470,27194
ũ,JiuNongChang,130230409,10573,1728,7149,5068,14028,7149,1980,7132,14281,7132,14281
ʮũ,ShiNongChang,130230410,8401,1239,5633,4064,10927,5632,1623,5620,11252,5630,11263
ʮһũ,ShiYiNongChang,130230411,5469,754,3671,2692,7082,3642,1145,3637,7279,3697,7368
ֳ̲,BaLiTanYangZhiChang,130230412,139,5,57,42,0,48,10,56,104,97,154
ʮﺣֳ,ShiLiHaiYangZhiChang,130230413,993,45,432,172,765,284,102,278,562,708,1140
鹤ҵ,CaoFeiDianGongYeQu,130230451,26277,78,3216,474,4,318,10,479,797,23149,26365
·ֵ´,HuaMingLuJieDaoBanShiChu,130281001,24201,2042,16197,10488,15811,15950,5961,15410,31360,16007,32204
Ļ·ֵ´,WenHuaLuJieDaoBanShiChu,130281002,37976,3180,25703,17001,26307,25678,9207,24597,50275,24660,50363
,ZunHuaZhen,130281100,34874,2636,22385,10830,35964,19549,7360,18279,37828,22485,44870
ӵ,BuZiDianZhen,130281101,28075,3568,19059,10812,36052,18868,7016,19247,38115,19600,38659
,MaLanYuZhen,130281102,18081,1940,11914,6084,23046,11906,4548,12301,24207,12655,24569
ƽ,PingAnChengZhen,130281103,37498,4633,25502,16104,49776,25461,9500,26096,51557,26129,51631
ׯ,DongXinZhuangZhen,130281104,27074,3654,18036,11278,34906,17914,5700,18266,36180,18392,36428
µ,XinDianZiZhen,130281105,36002,4345,24040,13608,45876,23235,8485,24101,47336,24792,48832
,DangYuZhen,130281106,20344,2946,13455,7500,27646,12791,4757,13385,26176,14592,28047
رͷ,DiBeiTouZhen,130281107,15248,2382,10250,7037,20621,10250,3564,10944,21194,10944,21194
կ,DongJiuZhaiZhen,130281108,18063,2430,12002,7089,23579,11929,4002,12430,24359,12493,24495
,TieChangZhen,130281109,13505,1993,8814,5874,17702,8814,2832,9516,18330,9516,18330
ռ,SuJiaWaZhen,130281110,22270,2404,15151,8125,29046,15138,5847,15298,30436,15370,30521
,JianMingZhen,130281111,23105,2507,15658,8674,30708,15592,6046,15796,31388,16000,31658
ʯ,ShiMenZhen,130281112,23748,2858,15979,8886,31204,15975,5735,16280,32255,16362,32341
,XiLiuCunXiang,130281200,18100,1889,12195,6393,21563,11561,4216,11542,23103,12010,24205
޼ׯ,CuiJiaZhuangXiang,130281201,14306,1621,9900,5370,18986,9900,3898,9925,19825,9925,19825
կ,XingWangZhaiXiang,130281202,15670,1647,10702,5659,20823,10672,4158,10645,21317,10773,21475
Ӫ,XiXiaYingManZuXiang,130281203,7813,874,5313,2969,10185,5312,2043,5416,10728,5417,10730
Ȫ,TangQuanManZuXiang,130281204,6330,633,4376,2450,8466,4376,1795,4382,8758,4382,8758
,DongLingManZuXiang,130281205,16601,1806,11011,6024,21677,11011,4073,11469,22480,11469,22480
կ,LiuBeiZhaiXiang,130281206,15583,2320,10354,6794,20899,10354,3395,10943,21297,10944,21298
ưׯ,TuanPiaoZhuangXiang,130281207,19896,2636,13528,8074,25874,13528,4468,13472,27000,13472,27000
ׯ,NiangNiangZhuangXiang,130281208,15768,2229,10154,6356,20228,10154,2917,10760,20914,10760,20914
,XiSanLiXiang,130281209,12208,1240,8417,4584,14249,8343,3336,8225,16568,8367,16784
կ,HouJiaZhaiXiang,130281210,10240,944,6633,3710,12827,6613,2532,6852,13465,7083,13716
С,XiaoChangXiang,130281211,11519,1338,7729,4314,15408,7729,2827,7955,15684,7955,15684
ֵ´,ChengQuJieDaoBanShiChu,130283001,70246,3615,43890,26388,48540,39735,15522,40144,79879,45493,89383
Ǩ,QianAnZhen,130283100,88171,8790,57674,31802,109146,56821,19228,57527,114348,58515,116189
ĹӪ,XiaGuanYingZhen,130283101,22955,3016,15259,9718,30263,15073,5332,15799,30872,16044,31303
ׯ,YangGeZhuangZhen,130283102,28696,3693,18762,11187,38422,18754,6153,19772,38526,19780,38542
Ӫ,JianChangYingZhen,130283103,32848,3799,21297,11899,41898,20752,7249,22028,42780,22599,43896
Ե,ZhaoDianZiZhen,130283104,15047,1658,9626,6396,18499,9353,3061,9952,19305,10140,19766
Ұ,YeJiTuoZhen,130283105,26964,3060,17438,11153,34329,17404,6194,18631,36035,18780,36218
ׯ,DaCuiZhuangZhen,130283106,17315,1849,11568,6967,22740,11568,4467,12059,23627,12063,23631
,YangDianZiZhen,130283107,49293,4448,29126,18867,54899,28439,9400,29609,58048,34015,63141
԰,CaiYuanZhen,130283108,18736,1995,12725,7422,23174,12615,5154,12646,25261,13160,25885
ׯ,MaLanZhuangZhen,130283109,13842,1486,9618,5660,18682,9603,3841,9545,19148,9551,19169
ɳ,ShaHeYiZhen,130283110,21611,2304,13651,8844,26380,13236,4749,13803,27039,15013,28664
ľ,MuChangKouZhen,130283111,17595,2195,11685,7306,22387,11438,4699,11664,23102,12804,24489
ׯ,KouZhuangXiang,130283200,29984,3457,19635,12283,38826,19604,6940,20716,40320,20746,40381
,PengDianZiXiang,130283201,16537,1901,11105,6372,21912,11093,3874,11185,22278,11207,22312
ׯ,ShangSheYanZhuangXiang,130283202,17084,2136,11067,6646,22442,11049,3707,11772,22821,11860,22927
Ƽҵ,YanJiaDianXiang,130283203,17349,1871,11161,6602,22189,11140,3878,11908,23048,11937,23098
ذ,WuZhongAnXiang,130283204,18353,2466,12141,7572,24177,11938,4482,12709,24647,13160,25301
,DaWuLiXiang,130283205,12985,1659,8849,5597,16636,8821,3252,8940,17761,9047,17896
̫ƽׯ,TaiPingZhuangXiang,130283206,11647,1321,7652,5057,14818,7499,3001,7911,15410,8317,15969
Ļ·ֵ´,WenHuaLuJieDaoBanShiChu,130302001,31083,3955,20501,14633,26466,20247,5127,19409,39656,19664,40165
·ֵ´,HaiBinLuJieDaoBanShiChu,130302002,41438,6345,27070,19736,40679,26459,5691,25460,51919,26404,53474
·ֵ´,BeiHuanLuJieDaoBanShiChu,130302003,39165,4426,25374,18235,32598,25166,6681,24390,49556,24898,50272
ֵֽ´,JianSheDaJieJieDaoBanShiChu,130302004,37213,4286,24030,17134,31811,23849,5417,22768,46617,22886,46916
Ӷֵ´,HeDongJieDaoBanShiChu,130302005,36083,4133,22791,16256,29018,21507,4450,20863,42370,21875,44666
·ֵ´,XiGangLuJieDaoBanShiChu,130302006,47506,6132,30215,22881,35209,30059,7061,29544,59603,30484,60699
ɽֵֽ´,YanShanDaJieJieDaoBanShiChu,130302007,23590,3397,15496,11382,18875,15124,3289,14352,29476,14780,30276
۳Ǵֵֽ´,GangChengDaJieJieDaoBanShiChu,130302008,40158,5517,27320,18805,37483,26690,7257,24859,51549,25612,52932
·ֵ´,DongHuanLuJieDaoBanShiChu,130302009,48018,4561,31303,21548,36903,29428,8009,28633,58061,29285,60588
ֵ´,BaiTaLingJieDaoBanShiChu,130302010,92464,4385,49774,14689,59481,18841,4177,19032,37873,51252,101026
ػʵü�齭ֵ´,QinHuangDaoJingJiJiShuKaiFaQuZhuJiangDaoJieDaoBanShiChu,130302011,36556,2784,23422,15825,19662,22869,6865,22095,44964,22783,46205
ƺӵֵ´,HuangHeDaoJieDaoBanShiChu,130302012,12790,775,7026,4173,9520,5992,1689,6139,12131,8228,15254
ڷ·ֵ´,TengFeiLuJieDaoBanShiChu,130302013,21145,1074,13502,4867,21069,7726,2511,7877,15603,11228,24730
,DongGangZhen,130302100,19354,1730,11975,8484,16614,11717,3521,11923,23640,12630,24605
,HaiGangZhen,130302101,28568,2167,17215,13430,18612,16934,4716,17248,34182,18236,35451
,XiGangZhen,130302102,16107,1252,9814,6081,11805,8446,2392,8665,17111,9937,19751
,HaiYangZhen,130302103,21335,1718,13235,9334,16718,13156,4052,13630,26786,13870,27105
,BeiGangZhen,130302104,24631,2013,14733,9600,22391,13986,4495,14596,28582,16406,31139
Ϲؽֵ´,NanGuanJieDaoBanShiChu,130303001,22198,3646,14538,10720,21639,14379,3109,13817,28196,14415,28953
ֵֽ´,DongJieJieDaoBanShiChu,130303002,3940,683,2725,1613,2135,2175,434,2064,4239,2332,5057
ֵֽ´,XiJieJieDaoBanShiChu,130303003,14726,2501,9768,7247,12974,9720,2076,9475,19195,9535,19303
·Ͻֵ´,LuNanJieDaoBanShiChu,130303004,25760,4543,16018,12157,25465,15722,2817,15437,31159,17102,33120
·ֵ´,ChuanChangLuJieDaoBanShiChu,130303005,20601,1153,7488,4867,5822,6257,1607,6453,12710,15873,23361
һ,DiYiGuanZhen,130303100,14801,1428,9308,6756,13269,9304,2409,9265,18569,9330,18638
ʯ,ShiHeZhen,130303101,16772,2011,10591,6966,18210,10428,2873,10686,21114,11065,21656
Ͻ,MengJiangZhen,130303102,13972,1512,8763,6058,15052,8757,2338,9038,17795,9059,17822
,BoHaiXiang,130303200,8792,704,5071,3405,7634,4841,1363,4855,9696,5788,10859
ɽֵ´,XiShanJieDaoBanShiChu,130304001,18278,2341,13279,7018,14365,8954,1963,8424,17378,9303,22582
ɽֵ´,DongShanJieDaoBanShiChu,130304002,10215,1444,6116,4182,6606,5169,992,5020,10189,6535,12651
,HaiBinZhen,130304100,10853,1426,7150,5485,10210,7131,1822,6900,14031,6951,14101
,DaiHeZhen,130304101,29841,2819,18986,10044,24850,13912,3653,13759,27671,17327,36313
,QingLongZhen,130321100,58142,5528,37707,22482,63975,36150,14907,38340,74490,40870,78577
ɽ,ZuShanZhen,130321101,15749,2048,10456,6346,19631,10398,3925,10795,21193,11266,21722
ľͷ,MuTouDengZhen,130321102,21391,2860,13815,7866,28173,13503,5074,15238,28741,15510,29325
˫ɽ,ShuangShanZiZhen,130321103,15060,2014,9722,5794,19868,9520,3583,10517,20037,10935,20657
Ȧ,MaQuanZiZhen,130321104,16123,1881,10437,6392,21114,10422,4077,11532,21954,11644,22081
ФӪ,XiaoYingZiZhen,130321105,24153,2967,15817,9305,31517,15442,6093,16980,32422,17396,33213
,DaWuLanZhen,130321106,18509,2670,12340,7771,24684,12258,4708,13103,25361,13547,25887
,TuMenZiZhen,130321107,18435,2406,12099,8031,24905,12080,4629,13228,25308,13371,25470
˵,BaDaoHeZhen,130321108,20779,2274,13512,7923,26969,13445,5446,14591,28036,14987,28499
ͷ,GeHeTouZhen,130321109,18095,2141,11191,6762,22895,11155,4015,12134,23289,13060,24251
¦,LouZhangZiZhen,130321110,16624,2117,10873,6277,21943,10739,4010,11802,22541,11878,22751
ɽ,FengHuangShanXiang,130321200,6024,993,4208,2638,8393,4202,1573,4374,8576,4382,8590
,LongWangMiaoXiang,130321201,11142,1499,7346,4198,14945,7336,2865,8150,15486,8160,15506
ǿ,SanXingKouXiang,130321202,8708,1267,5729,3284,11953,5726,2192,6437,12163,6438,12167
ɹ,GanGouXiang,130321203,5426,903,3531,2112,7406,3531,1273,4071,7602,4071,7602
ʯ,DaShiLingXiang,130321206,8185,988,5172,3109,10858,5169,1918,5898,11067,5919,11091
ٳ,GuanChangXiang,130321208,6426,1062,4441,2900,8769,4441,1477,4520,8961,4524,8965
ɽ,CiYuShanXiang,130321209,12877,1682,8201,5192,17055,8201,2734,9092,17293,9092,17293
ƽ,PingFangZiXiang,130321210,7039,1045,4715,2816,9596,4715,1742,5106,9821,5111,9826
,AnZiLingXiang,130321211,9780,1250,6350,3734,13015,6341,2492,7154,13495,7172,13522
,ZhuZhangZiXiang,130321212,9760,1214,6328,3995,12862,6313,2449,7020,13333,7095,13423
,CaoNianXiang,130321213,6252,931,4238,2725,8294,4238,1679,4619,8857,4624,8862
ߵ,QiDaoHeXiang,130321214,5688,798,3934,2341,7667,3934,1544,4096,8030,4096,8030
,SanBoZiXiang,130321217,7918,1054,5285,3248,10688,5275,2131,5773,11048,5818,11103
ˮ,LiangShuiHeXiang,130321218,13180,1460,8698,5054,17799,8679,3673,9543,18222,9615,18313
,ChangLiZhen,130322100,102969,11496,67270,39551,103317,55683,18113,54590,110273,65308,132578
,JingAnZhen,130322101,32140,4712,21059,13807,40633,20516,6234,21206,41722,22027,43086
ɽ,AnShanZhen,130322102,33700,4928,22488,15119,44243,22480,7176,23266,45746,23316,45804
ҵ,LongJiaDianZhen,130322103,30897,4682,20639,14559,40152,20511,6298,21090,41601,21238,41877
ྮ,NiJingZhen,130322104,19129,2985,12517,8813,24849,12517,3496,13093,25610,13093,25610
Ѻ,DaPuHeZhen,130322105,22396,2847,14899,9280,28079,14587,4676,14512,29099,15020,29919
¼,XinJiZhen,130322106,22697,3950,15014,11371,30047,15013,4181,15812,30825,15814,30828
̨ׯ,LiuTaiZhuangZhen,130322107,17000,2519,11244,7904,22148,11244,3278,11553,22797,11553,22797
,RuHeZhen,130322108,11454,1910,7524,5650,14756,7521,2068,7864,15385,7908,15432
ׯ,ZhuGeZhuangZhen,130322109,22387,3187,14890,10705,28773,14869,4950,15533,30402,15634,30524
ĵׯ,HuangDianZhuangZhen,130322110,21438,3518,14159,10504,27483,14106,3882,14573,28679,14679,28838
,TuanLinXiang,130322201,16162,2225,10731,6835,20940,10687,3210,10602,21289,10866,21597
,GeTiaoGangXiang,130322202,17146,2341,11358,7698,21103,11098,3416,11364,22462,11545,22903
,MaTuoDianXiang,130322203,26337,4365,17467,12452,34575,17467,5060,18295,35762,18295,35762
ɽ,LiangShanXiang,130322206,14417,2020,9109,6270,17732,9077,2628,9814,18891,9956,19065
ʮ,ShiLiPuXiang,130322207,9744,1282,6404,4403,12186,6393,2051,6661,13054,6673,13077
ǽֵ´,LiChengJieDaoBanShiChu,130323001,30560,2766,19957,12322,24415,17797,5936,17171,34968,19305,39262
ϴӽֵ´,NanDaiHeJieDaoBanShiChu,130323002,15695,1648,9758,7007,15349,9531,2446,9386,18917,10031,19789
,FuNingZhen,130323100,57729,7757,37443,25129,73181,37332,10974,38528,75860,39017,76460
Ӫ,LiuShouYingZhen,130323101,48746,6377,31858,21609,61845,31832,8713,31908,63740,31978,63836
ܹ,YuGuanZhen,130323102,37466,4744,24639,15497,49069,24364,7660,25036,49400,25231,49870
ţͷ,NiuTouYaZhen,130323103,35500,4707,23106,15083,42969,23027,5964,22970,45997,23065,46171
ʯկ,ShiMenZhaiZhen,130323104,35361,4015,23113,14122,43214,22757,6980,22873,45630,23243,46356
̨Ӫ,TaiYingZhen,130323105,31087,4473,20317,12865,41363,20021,6400,21424,41445,21643,41960
կ,DaXinZhaiZhen,130323106,24768,3910,16222,10309,33314,16218,5031,17424,33642,17487,33709
פӪ,ZhuCaoYingZhen,130323107,16515,2522,10853,6974,21532,10849,3239,11408,22257,11423,22276
ׯ,DuZhuangZhen,130323108,22140,1826,13799,9604,20618,13622,4865,14118,27740,15032,28831
,ChaPengXiang,130323200,27953,3955,18119,11810,36862,18105,5518,19281,37386,19307,37426
,ShenHeXiang,130323202,8222,1067,5432,3614,10654,5428,1838,5686,11114,5695,11127
¬,LuLongZhen,130324100,49437,6175,33721,22519,60603,33220,12253,33640,66860,34144,67865
ׯ,PanZhuangZhen,130324101,17695,2601,11762,7681,23200,11409,4067,12328,23737,12601,24363
Ӫ,YanHeYingZhen,130324102,21847,3878,15336,11124,29511,15326,4774,15131,30457,15163,30499
˫,ShuangWangZhen,130324103,18337,3195,12865,9112,24916,12860,4339,12995,25855,13006,25871
ׯ,LiuTianGeZhuangZhen,130324104,30610,4759,20360,14443,40108,20095,6307,21142,41237,21316,41676
ʯ,ShiMenZhen,130324105,29439,4304,20288,14255,39417,20265,7477,20889,41154,20932,41220
կ,XiaZhaiXiang,130324200,13491,2205,9342,6438,18159,9326,3355,9677,19003,9709,19051
Ӫ,LiuJiaYingXiang,130324201,10283,1559,7117,4912,13829,7067,2689,7299,14366,7414,14531
¹,ChenGuanTunXiang,130324202,18043,2784,12205,8143,23877,12181,4043,12649,24830,12665,24870
ӡׯ,YinZhuangXiang,130324203,18524,2732,12355,8611,24453,12346,4206,13086,25432,13107,25462
,HaBoXiang,130324204,19478,3097,13153,9441,25205,13139,3996,13390,26529,13418,26571
ľ,MuJingXiang,130324205,30906,4614,20777,14170,41046,20521,6940,21351,41872,21683,42460
ĥֵ´,HuoMoJieDaoBanShiChu,130402001,6397,806,4261,2899,5210,4228,1295,4124,8352,4237,8498
԰·ֵ´,LingYuanLuJieDaoBanShiChu,130402002,10644,1382,7167,4939,10251,7095,1956,6773,13868,6815,13982
·ֵ´,GuangMingLuJieDaoBanShiChu,130402003,13922,1647,9295,6015,10109,9170,2595,8773,17943,8869,18164
涫ֵ´,FuDongJieDaoBanShiChu,130402004,33422,3231,21529,14575,23041,21413,6293,21130,42543,21417,42946
޳ͷֵ´,LuoChengTouJieDaoBanShiChu,130402005,75837,5393,42866,19163,51101,27466,7479,27199,54665,45843,88709
侺ӽֵ´,ZhuHeJieDaoBanShiChu,130402006,40047,4826,25606,16320,32530,24337,6470,23558,47895,25737,51343
ԡϽֵ´,YuXinNanJieDaoBanShiChu,130402007,26702,2019,16087,10579,23967,15782,4265,15885,31667,16899,32986
ũ·ֵ´,NongLinLuJieDaoBanShiChu,130402008,7873,1754,5433,3524,8607,5082,1238,4800,9882,5432,10865
óֵ´,MaoDongJieDaoBanShiChu,130402009,12573,1778,8792,5772,11548,8667,2668,8128,16795,8227,17019
óֵ´,MaoXiJieDaoBanShiChu,130402010,14702,1842,9815,6356,12071,9787,2978,9641,19428,9707,19522
ͷ,MaTouZhen,130402100,24236,2933,16119,9219,29855,16062,5211,15659,31721,16261,32380
ׯ,BeiZhangZhuangZhen,130402101,20285,1883,14168,7481,27311,14087,6028,13949,28036,14028,28196
ׯ,MaZhuangXiang,130402200,15437,1264,10668,5835,14973,10636,4315,10288,20924,10348,21016
ֵ̨´,CongTaiXiJieDaoBanShiChu,130403001,18009,2030,11953,7237,13937,10982,3394,10502,21484,11480,23433
ֵ´,LianFangXiJieDaoBanShiChu,130403002,26463,3901,16742,11153,25028,15863,3808,15644,31507,17430,34172
Ķֵ´,LianFangDongJieDaoBanShiChu,130403003,32157,5326,22008,13571,32570,21297,4849,20037,41334,20324,42332
Žֵ´,GuangMingQiaoJieDaoBanShiChu,130403004,36039,5074,23634,15188,37182,23292,6572,22538,45830,24051,47685
ֵ̨´,CongTaiDongJieDaoBanShiChu,130403005,48053,7262,31894,18563,56684,29585,8997,28172,57757,32418,64312
ļֵ´,SiJiQingJieDaoBanShiChu,130403006,17925,1401,12003,7442,10501,11759,4401,11463,23222,11724,23727
ƽֵ´,HePingJieDaoBanShiChu,130403007,8261,1059,5279,3724,8418,5167,1256,5121,10288,5297,10576
лֵ´,ZhongHuaJieDaoBanShiChu,130403008,12821,1667,8319,5432,12355,8012,2066,7892,15904,8235,16554
·ֵ´,RenMinLuJieDaoBanShiChu,130403009,23025,3532,15883,8339,26861,14662,4292,13974,28636,14966,30849
Žֵ´,LiuLinQiaoJieDaoBanShiChu,130403010,26303,1969,16767,10113,17761,16260,5179,15822,32082,16684,33451
ղ,SuCaoXiang,130403200,27781,2466,18463,10707,21920,18437,6440,18144,36581,18224,36687
ʤŽֵ´,ShengLiQiaoJieDaoBanShiChu,130404001,20755,1758,13288,9025,15057,13222,4026,13099,26321,13251,26539
ټҴֵ´,BaiJiaCunJieDaoBanShiChu,130404002,22873,2819,14688,9966,25779,14661,4083,14990,29651,15087,29775
·Ժֵ´,TieLuDaYuanJieDaoBanShiChu,130404003,15407,1780,9010,5472,13554,8523,2111,8587,17110,10288,19298
·ֵ´,HuaLinLuJieDaoBanShiChu,130404004,36913,4255,20868,13227,38822,20059,6344,19342,39401,26644,47512
Ӵֵ´,PangCunJieDaoBanShiChu,130404005,5351,891,3395,2417,4620,3339,771,3372,6711,3618,7013
2672ֵ´,2672JieDaoBanShiChu,130404006,12014,972,6725,4839,13001,6432,2213,6530,12962,8474,15199
ʯֵ´,ShiHuaJieDaoBanShiChu,130404007,3831,769,2520,1862,3887,2482,697,2504,4986,2777,5297
կ,PengJiaZhaiXiang,130404200,31382,2737,20683,11224,33425,20580,7271,20130,40710,20707,41390
ˮ,LinShuiZhen,130406100,101090,9584,63574,35751,115921,59025,17759,58319,117344,64859,128433
,FengFengZhen,130406101,63285,8499,40912,23448,76113,39730,9847,38991,78721,40719,81631
,XinPoZhen,130406102,20553,2223,12827,7418,25729,12814,4122,12971,25785,14071,26898
,DaSheZhen,130406103,36207,4735,21741,12116,45979,21092,6732,21188,42280,25933,47674
ʹ,HeCunZhen,130406104,50581,6506,27590,16544,61976,27341,7990,28405,55746,37487,65077
微,YiJingZhen,130406105,41649,4972,25651,13236,52976,23010,8278,23460,46470,29248,54899
,PengChengZhen,130406106,44704,4577,28251,16992,51527,27910,7430,27765,55675,28460,56711
,JieChengZhen,130406107,19822,1747,12124,6675,23933,11603,3726,11730,23333,13171,25295
,DaYuZhen,130406108,13239,1457,8664,4880,16267,8655,2597,8543,17198,8629,17293
,ShangBiZhen,130421100,39284,3663,28132,13049,53034,28131,12666,27481,55612,27481,55613
,HuangLiangMengZhen,130421101,41838,3468,28241,13258,52018,27131,11590,27590,54721,28655,56896
ɳ,HeShaZhenZhen,130421102,28277,2679,19685,9455,37147,19680,8305,19509,39189,19576,39261
,HuCunZhen,130421104,22237,1991,14621,7789,25077,14563,5665,15010,29573,15272,29893
ϱ,NanBaoXiang,130421200,50315,3838,32644,17644,51250,31288,13544,31622,62910,35053,67697
,NanLvGuXiang,130421201,23064,2095,16136,8030,30618,16136,7885,16908,33044,16908,33044
ׯ,JianZhuangXiang,130421202,68294,5270,45826,25248,55344,43905,16610,41801,85706,44348,90174
,DaiZhaoXiang,130421203,23693,2225,17065,9270,30223,17060,8292,17142,34202,17145,34210
ׯ,KangZhuangXiang,130421204,22851,2077,14374,8050,25643,14315,5213,14810,29125,15767,30141
,SanLingXiang,130421205,18235,1720,12268,6696,23691,12265,5128,12813,25078,12815,25083
,LinZhangZhen,130423100,65316,5097,43421,20026,78033,40791,16566,41199,81990,43558,86979
϶,NanDongFangZhen,130423101,17036,1696,12856,6113,23840,12847,6384,12242,25089,12260,25116
ռ,SunTaoJiZhen,130423102,39401,4052,29667,14443,56699,29667,13932,27718,57385,27718,57385
԰,LiuYuanZhen,130423103,41487,4232,30828,14374,58664,30415,13705,28122,58537,28596,59424
ƹ,ChengGouJiZhen,130423104,29109,3241,21204,10799,41242,21012,9241,20002,41014,20387,41591
,DiQiuXiang,130423200,19641,1939,14690,6810,28076,14690,7122,13976,28666,14012,28702
Ŵ弯,ZhangCunJiXiang,130423201,36694,3790,25814,13382,51141,25811,11365,26028,51839,26035,51849
,XiYangGaoXiang,130423202,15801,1704,11301,5617,21950,11301,4714,10918,22219,10918,22219
Ӫ,XiangCaiYingXiang,130423203,20917,1816,15482,7649,29056,15410,7287,14405,29815,14538,30020
Ŵ弯,DuCunJiXiang,130423204,30487,3276,23130,11303,43902,23087,11067,21571,44658,21700,44830
Ｏ,ZhangLiJiXiang,130423205,26118,2263,18569,9468,35437,18433,8131,17743,36176,17943,36512
ϰ,XiWenXiang,130423206,26569,2075,17968,9182,36274,17959,8364,19033,36992,19040,37008
שկӪ,ZhuanZhaiYingXiang,130423207,28636,3181,21598,10125,39436,21589,8910,19088,40677,19129,40727
غ׼,BaiHeJiXiang,130423208,25843,2949,20147,9405,36823,20082,9446,18023,38105,18091,38238
ɰ,ChengAnZhen,130424100,55264,4628,38471,18152,64299,36168,16183,35738,71906,37604,76075
̳,ShangChengZhen,130424101,42962,4110,30773,14512,55536,30101,13074,28227,58328,29373,60146
ĺӵ,ZhangHeDianZhen,130424102,23525,3247,17727,9198,33822,17684,8052,16974,34658,17097,34824
,LiJiaTuanZhen,130424103,24997,3024,19532,9887,35767,19445,8994,17372,36817,17483,37015
,XinYiXiang,130424200,29003,3207,21628,11130,39504,21628,9323,19905,41533,19905,41533
Ӫ,BaiSiYingXiang,130424201,14436,1812,11119,5744,20056,11119,5120,10249,21368,10249,21368
,DaoDongBaoXiang,130424202,30358,3753,23162,11706,41886,23138,10449,21264,44402,21398,44560
,BeiXiangYiXiang,130424203,24931,3971,20163,10852,36941,20160,9309,18045,38205,18048,38211
,ChangXiangXiang,130424204,15890,1872,12562,6574,22396,12556,5904,11099,23655,11104,23666
,DaMingZhen,130425100,43981,3902,30199,16066,50179,29679,11786,29216,58895,29470,59669
,YangQiaoZhen,130425101,32902,3312,23525,10890,46814,23520,11175,23849,47369,23864,47389
,WanDiZhen,130425102,22556,2023,15969,7281,31718,15964,7353,15924,31888,15963,31932
,LongWangMiaoZhen,130425103,35763,3595,25574,11466,50117,25572,11996,25773,51345,25780,51354
,ShuGuanZhen,130425104,27638,2999,19676,8389,40129,19593,9668,20420,40013,20629,40305
̲,JinTanZhen,130425105,33128,3160,23460,11282,46455,23460,10686,23514,46974,23514,46974
ɳ,ShaGeDaXiang,130425200,19530,2547,15308,8634,28636,15303,7270,14025,29328,14039,29347
,WangCunXiang,130425201,28371,3173,20411,8449,39947,20382,9045,20126,40508,20178,40589
,PuShangXiang,130425202,21908,1979,15593,6713,30802,15593,7146,15440,31033,15440,31033
ƽ,HuangJinDiXiang,130425203,23180,2237,16887,8083,33092,16799,8509,16894,33693,17039,33926
,DaJieXiang,130425204,24870,2701,18831,8950,36109,18831,9719,18459,37290,18459,37290
,JiuZhiXiang,130425205,31084,3050,22405,10328,43109,22401,10693,22404,44805,22422,44827
δׯ,XiWeiZhuangXiang,130425206,20390,2152,14867,7071,28372,14867,7199,14874,29741,14874,29741
ʵ,SunGanDianXiang,130425207,26294,2590,19119,9071,37380,19119,9658,19422,38541,19423,38542
�,XiFuJiXiang,130425208,28024,3312,20274,9819,40034,19997,9107,19104,39101,20169,40443
ͷ,NianTouXiang,130425209,30914,3243,22602,10185,44447,22531,10871,22311,44842,22426,45028
,BeiFengXiang,130425210,22192,2554,16499,8644,32113,16481,8365,16574,33055,16612,33111
,ZhangTieJiXiang,130425211,24886,3034,19173,9713,37370,19147,10075,18794,37941,18822,37995
,HongMiaoXiang,130425212,21494,2362,16148,8419,31833,16148,8331,16038,32186,16039,32187
Ӫ,YingZhenHuiZuXiang,130425213,10337,1127,7629,4083,15237,7623,3889,7712,15335,7724,15353
,SheChengZhen,130426100,64862,3774,40455,24477,58030,36796,15307,38960,75756,43488,83943
ϵ,HeNanDianZhen,130426101,22824,1994,14619,8477,27692,14256,5327,15184,29440,15526,30145
,SuoBaoZhen,130426102,17659,1622,11226,6656,22533,11101,4137,12032,23133,12192,23418
,XiXuZhen,130426103,11824,1053,7560,5279,13712,7344,2806,7631,14975,8123,15683
,JingDianZhen,130426104,31124,2534,19974,12413,38388,19566,7816,20928,40494,21500,41474
,GengLeZhen,130426105,17044,1448,11033,7509,20944,10951,4143,11489,22440,11602,22635
,GuXinZhen,130426106,18422,1705,11835,6818,23829,11800,4277,12482,24282,12569,24404
,XiDaZhen,130426107,12304,1050,7903,4429,16187,7792,3074,8297,16089,8525,16428
ƫ,PianChengZhen,130426108,9947,943,6393,4037,12854,6354,2178,6504,12858,6675,13068
ͷ,ShenTouXiang,130426200,10510,1171,6668,4641,13404,6559,2534,7241,13800,7547,14215
ɳ,LiaoChengXiang,130426201,14916,1360,9524,5798,18977,9383,3404,9911,19294,10156,19680
ƫ,PianDianXiang,130426202,13979,1008,9061,5640,17493,8953,3386,9115,18068,9312,18373
,LongHuXiang,130426203,15524,1292,10174,6071,19728,10131,3921,10457,20588,10563,20737
ľ,MuJingXiang,130426204,13077,921,8459,4873,16456,8392,3239,8694,17086,8778,17237
ط,GuanFangXiang,130426205,10622,986,6604,4176,13523,6564,2424,7333,13897,7428,14032
,HeZhangXiang,130426206,15729,1224,9962,5834,20275,9930,3758,10643,20573,10749,20711
¹ͷ,LuTouXiang,130426207,12629,1156,8204,4873,16183,8112,3089,8481,16593,8670,16874
,CiZhouZhen,130427100,108505,7891,71233,34674,115494,67804,27069,68626,136430,72232,143465
,GaoYuZhen,130427101,32042,2790,23262,10827,44983,23201,11427,22921,46122,22997,46259
»,XiGuangLuZhen,130427102,29488,2243,20834,10260,37982,20810,10584,21294,42104,21481,42315
,JiangWuChengZhen,130427103,35161,3059,23888,12194,46143,23695,9845,23873,47568,24177,48065
,YueChengZhen,130427104,25708,1778,17610,8480,33145,17608,7942,17814,35422,17818,35428
̨,GuanTaiZhen,130427105,24762,1733,15245,8275,29954,15075,5703,15763,30838,16953,32198
̹,LinTanZhen,130427106,22717,2000,15262,8170,28470,15259,6406,15823,31082,15861,31123
,BaiTuZhen,130427107,15740,1596,10655,5994,19996,10619,3799,10427,21046,10480,21135
ɳ,HuangShaZhen,130427108,13037,723,7448,3549,13939,7377,2819,7565,14942,9131,16579
·Ӫ,LuCunYingXiang,130427200,17635,1227,11954,5378,22678,11954,4953,11861,23815,11861,23815
,XiGuYiXiang,130427201,15522,1410,10799,5429,20604,10799,4863,10996,21795,10996,21795
ׯӪ,XinZhuangYingXiang,130427202,31331,2882,21708,10710,41494,21683,9362,21856,43539,21867,43575
Ӫ,HuaGuanYingXiang,130427203,25246,2264,17289,8317,32740,17289,7437,17658,34947,17658,34947
ʱӪ,ShiCunYingXiang,130427204,19064,1618,13017,6389,24427,12908,5710,13174,26082,13375,26392
ϳ,NanChengXiang,130427205,16801,1738,11298,6405,20118,11295,4518,11751,23046,11759,23057
̨,TaiChengXiang,130427206,19275,1596,13277,6434,24004,13276,5776,13343,26619,13370,26647
Ȫ,TaoQuanXiang,130427207,11869,1526,8406,4884,15909,8388,3083,8046,16434,8072,16478
,DouDangXiang,130427208,12085,993,7933,4174,15260,7924,2931,8032,15956,8076,16009
ֱ,BeiJiaBiXiang,130427209,21511,1964,14298,7615,27248,14279,5127,14268,28547,14304,28602
,FeiXiangZhen,130428100,55660,5256,38880,17670,74475,37506,17055,38041,75547,39091,77971
̨ɽ,TianTaiShanZhen,130428101,27845,3128,19701,10072,39142,19700,8755,20027,39727,20027,39728
,DaXiHanXiang,130428200,22235,2341,15809,8255,31576,15807,7395,16162,31969,16162,31971
,XinAnZhenXiang,130428201,19888,2111,14209,6367,28278,14209,6493,14283,28492,14283,28492
ëݱ,MaoYanBaoXiang,130428202,27326,2799,19502,9646,38538,19502,9223,19846,39348,19846,39348
Ԫ,YuanGuXiang,130428203,28660,3686,21058,9601,40786,21058,9169,20457,41515,20457,41515
ׯӪ,TunZhuangYingXiang,130428204,20779,2815,15114,7539,29439,15112,6575,15038,30150,15055,30169
ı,DongZhangBaoXiang,130428205,21485,2362,15624,7985,30952,15624,7726,15949,31573,15949,31573
ɵ,JiuDianXiang,130428206,21355,2430,15267,7921,30370,15267,7138,15651,30918,15656,30923
ٛ,LinMingGuanZhen,130429100,98571,7008,64482,35210,114402,59602,26514,62923,122525,67611,132093
,DaBeiWangZhen,130429101,26122,2243,18236,8649,36382,18236,8453,18582,36818,18582,36818
,ZhangXiBaoZhen,130429102,30714,2979,22464,10064,44726,22462,11921,23130,45592,23150,45614
㸮,GuangFuZhen,130429103,35250,2807,24863,10846,46452,23361,11659,23699,47060,24853,49716
ش,NanYanCunZhen,130429104,36410,3279,26042,12704,52952,26042,13522,27169,53211,27169,53211
ϻ,YongHeHuiZhen,130429105,28907,2540,19429,10167,35531,19299,8728,19706,39005,20746,40175
,XiSuXiang,130429200,42674,3930,30526,15416,57941,30517,14262,30284,60801,30340,60866
ӵ,JieHeDianXiang,130429201,23141,1836,16122,7169,28002,14464,6699,14695,29159,15554,31676
Ӫ,LiuYingXiang,130429202,37009,3204,25843,11422,50718,25418,12139,26094,51512,26509,52352
,LiuHanXiang,130429203,31275,2595,21938,11861,42840,21938,10329,22261,44199,22261,44199
,ZhengXiXiang,130429204,26832,2551,18655,9853,36948,18655,8570,19296,37951,19298,37953
,JiangWuXiang,130429205,32548,2993,22627,12111,44814,22626,10200,23114,45740,23114,45741
İ,QuMoXiang,130429206,27182,2733,19354,9741,38311,19354,9146,19692,39046,19707,39061
ׯ,XinZhuangBaoXiang,130429207,29227,2619,21103,10192,42779,21103,11427,22170,43273,22170,43273
С,XiaoLongMaXiang,130429208,38049,3028,25100,12598,49873,25095,9976,25947,51042,25953,51053
ׯ,DongYangZhuangXiang,130429209,27789,2812,20461,10337,39130,20461,10092,20232,40693,20232,40693
С,XiaoXiBaoXiang,130429210,25412,2031,18448,8843,37430,18446,10654,19628,38074,19649,38097
ׯ,XiHeZhuangXiang,130429211,20957,2108,16040,7754,31283,16038,9263,16286,32324,16288,32328
Ҧկ,YaoZhaiXiang,130429212,28630,3096,21095,10700,42031,21064,11455,21988,43052,22086,43181
,XiYangChengXiang,130429213,18458,1568,12898,6349,24705,12898,5809,12937,25835,12937,25835
ͷ,XinMaTouZhen,130430100,55799,4161,36643,20303,65234,35254,16837,35891,71145,40154,76797
,QiuChengZhen,130430101,22413,2059,16646,8788,31294,16625,8133,15887,32512,15959,32605
ׯ,LiangErZhuangZhen,130430102,18296,1908,14017,7476,26899,14016,7157,13344,27360,13344,27361
ǹ,XiangChengGuZhen,130430103,20578,1864,15183,8889,29668,15152,7603,14822,29974,14862,30045
,NanXinDianXiang,130430201,16544,1563,11987,6975,23410,11986,5748,11868,23854,11868,23855
ųӪ,GuChengYingXiang,130430203,20179,1869,15422,8831,29745,15422,8640,15266,30688,15266,30688
´,ChenCunHuiZuXiang,130430204,4223,442,3071,1640,6180,3066,1562,3150,6216,3156,6227
,JiZeZhen,130431100,48568,3818,31631,15939,56961,29271,12614,31277,60548,33369,65000
Сկ,XiaoZhaiZhen,130431101,26898,2727,19396,10437,36560,19396,9382,19611,39007,19611,39007
˫,ShuangTaZhen,130431102,24610,2226,18502,9009,33441,18492,10059,18346,36838,18393,36895
ͼ,FuTuDianXiang,130431200,33181,3407,24266,11809,45638,24266,11654,23975,48241,23976,48242
Ӫ,WuGuanYingXiang,130431201,17498,1719,12804,6867,23685,12804,6515,12928,25732,12928,25732
,FengZhengXiang,130431202,16872,1450,11994,6262,23089,11975,6157,12464,24439,12485,24479
ׯ,CaoZhuangXiang,130431203,23620,2376,17166,9099,31231,17166,8977,17807,34973,17807,34973
ƽ,GuangPingZhen,130432100,48766,4773,33914,15661,62632,33664,12845,32404,66068,32470,66384
ƽ̵,PingGuDianZhen,130432101,26043,2316,18265,8486,34961,18232,7782,17835,36067,17876,36141
˫,ShuangMiaoXiang,130432200,32344,3734,22770,10333,43972,22666,9136,22277,44943,22444,45214
ʮ,ShiLiPuXiang,130432201,28749,2955,21047,8936,39220,20854,8485,18877,39731,19142,40189
Ϻ,NanHanCunXiang,130432202,21290,2161,15603,7587,29125,15602,6721,14569,30171,14569,30172
,NanYangBaoXiang,130432203,19420,2051,14102,6478,26645,13969,5721,12906,26875,13090,27192
,DongZhangMengXiang,130432204,16086,1630,12015,6079,22238,11986,5985,11633,23619,11686,23701
,GuanTaoZhen,130433100,47895,3594,32923,18448,53853,31653,14883,32399,64052,33449,66372
կ,FangZhaiZhen,130433101,17426,2201,13040,6804,25266,13040,5810,12397,25437,12397,25437
,ChaiBaoZhen,130433102,29127,2542,21571,12074,41410,21204,11322,21081,42285,21420,42991
κɮկ,WeiSengZhaiZhen,130433103,25001,2137,17363,10007,34169,17290,8686,18206,35496,18461,35824
ɽ,ShouShanSiXiang,130433200,26936,2785,20103,10768,38413,20087,9660,19231,39318,19278,39381
,WangQiaoXiang,130433201,25370,2413,17752,9214,35297,17752,7730,17761,35513,17761,35513
,NanXuCunXiang,130433202,17369,1981,13477,7750,26102,13386,7275,13091,26477,13148,26625
·,LuQiaoXiang,130433203,24481,2495,18881,10390,36608,18790,9913,17803,36593,18008,36889
κ,WeiChengZhen,130434100,99580,8301,65860,30596,108333,63370,25853,65829,129199,67874,133734
,DeZhengZhen,130434101,17340,1901,11769,4772,23499,11134,4793,10987,22121,12265,24034
,BeiGaoZhen,130434102,43786,5009,31788,14567,61527,31105,13835,29426,60531,30842,62630
˫,ShuangJingZhen,130434103,31514,3333,21376,8843,41649,19239,8782,18308,37547,22253,43629
,YaLiZhen,130434104,35044,4165,25054,11355,48778,24606,11082,23933,48539,25237,50291
,CheWangZhen,130434105,25677,2961,18174,7980,34706,18096,7177,17480,35576,17641,35815
¡,HuiLongZhen,130434106,33818,3518,21959,9035,42053,19843,7132,19642,39485,22509,44468
Ŷׯ,ZhangErZhuangZhen,130434107,40407,3867,28597,12420,54762,28597,12701,28378,56975,28378,56975
,DongDaiGuXiang,130434200,21456,2261,14992,6226,27986,14992,5654,14379,29371,14379,29371
կ,JiZhenZhaiXiang,130434201,16679,1856,11910,5616,23487,11854,5336,11590,23444,11961,23871
ɳڼ,ShaKouJiXiang,130434202,28702,3146,21362,9991,41057,21103,9709,20006,41109,20195,41557
Ұ,YeHuGuaiXiang,130434203,12059,1482,8928,4309,17156,8928,3790,8403,17331,8403,17331
,ShiWangJiXiang,130434204,14425,1654,10118,4517,19725,10116,4191,10145,20261,10152,20270
ǰĥ,QianDaMoXiang,130434205,18348,2210,13403,6415,25868,13403,5539,12694,26097,12694,26097
Ժ,YuanBaoXiang,130434206,12607,1621,9710,4740,17737,9710,4182,8700,18410,8700,18410
˫,NanShuangMiaoXiang,130434207,24143,2933,17819,7834,33683,17819,7444,16701,34520,16701,34520
ׯ,DaXinZhuangXiang,130434208,22229,2224,15824,7268,30244,15822,6603,15230,31052,15232,31056
,DaMaCunXiang,130434209,13071,1352,9135,4325,18518,9133,4294,9579,18712,9582,18717
,BianMaXiang,130434210,31161,3611,23169,11318,43917,23164,10270,21855,45019,21873,45042
̨ͷ,BeiTaiTouXiang,130434212,10613,1645,8760,4543,15311,8760,4009,7505,16265,7507,16267
,BoKouXiang,130434213,24681,2870,17944,7810,32577,17944,7557,17164,35108,17164,35108
,QuZhouZhen,130435100,49943,4892,34700,18013,64440,34468,15125,34966,69434,35260,69960
կ,AnZhaiZhen,130435101,37654,4139,27164,13831,53883,27162,12848,27477,54639,27477,54641
,HouCunZhen,130435102,40063,3689,29372,13537,59157,29370,15547,29918,59288,29927,59299
,HeNanTuanZhen,130435103,29377,3380,21114,11589,42667,21012,10377,21818,42830,22020,43134
,DiSiTuanZhen,130435104,27129,2722,19706,10547,38152,19706,9976,20121,39827,20121,39827
,HuaiQiaoXiang,130435200,19167,1984,13714,7966,26779,13614,6633,13994,27608,14070,27784
,NanLiYueXiang,130435201,22300,2338,15807,7763,30908,15807,7194,16025,31832,16025,31832
կ,BaiZhaiXiang,130435202,34656,4191,24773,13075,47223,24511,10914,24736,49247,24988,49761
ӵ,DaHeDaoXiang,130435203,16518,1842,11553,6095,23350,11553,5043,11850,23403,11850,23403
ׯ,YiZhuangXiang,130435204,18523,1939,14179,6941,27319,14179,7507,13790,27969,13790,27969
䰲,WuAnZhen,130481100,105085,6306,65290,33859,83822,57999,23094,59078,117077,69195,134485
,KangErChengZhen,130481101,29561,2578,18564,9678,29656,18478,7814,19363,37841,21389,39953
缳,WuJiZhen,130481102,33402,2998,22163,12411,37693,22017,9376,22953,44970,23613,45776
ɽ,CiShanZhen,130481103,25608,2404,15527,8013,26973,14347,5462,14976,29323,17947,33474
,BoYanZhen,130481104,14770,1715,9886,5482,19172,9886,3587,10185,20071,10186,20072
,ShuCunZhen,130481105,19204,1793,12100,6264,22899,11958,4965,12253,24211,13862,25962
ͬ,DaTongZhen,130481106,32367,2312,21794,10329,41427,21186,9316,21538,42724,22201,43995
س,YiChengZhen,130481107,27862,2215,19590,9586,37831,19590,8745,19217,38807,19232,38822
ɽ,KuangShanZhen,130481108,39264,2747,24577,13311,40013,24479,9781,24389,48868,27215,51792
ؽ,HeJinZhen,130481109,17671,1657,12409,6772,23743,12393,5153,12056,24449,12072,24481
,YangYiZhen,130481110,34855,2750,22585,12120,43809,22501,9221,23115,45616,24241,46826
ǻ,PaiHuaiZhen,130481111,19688,2086,13533,7569,26634,13527,5815,14038,27565,14056,27589
ұ,YeTaoZhen,130481112,16393,1752,11033,6182,21954,10680,4499,11041,21721,11611,22644
ų,ShangTuanChengXiang,130481200,25137,2136,16399,8287,29604,16236,7001,16440,32676,17875,34274
ׯ,BeiAnZhuangXiang,130481201,12211,1244,8103,4537,15387,8103,3229,8275,16378,8581,16684
,BeiAnLeXiang,130481202,21239,1685,14747,7607,29355,14734,6965,15112,29846,15142,29889
ɽ,XiTuShanXiang,130481203,46211,3188,29177,13767,46589,27354,11949,28310,55664,32171,61348
ׯ,XiSiZhuangXiang,130481204,28959,2538,19986,9352,38712,19783,8572,19587,39370,20083,40069
ˮ,HuoShuiXiang,130481205,14662,1430,10700,7130,20281,10666,4951,10236,20902,10343,21043
ʯ,ShiDongXiang,130481206,15794,1601,10831,5870,21496,10811,4794,11266,22077,11358,22189
,GuanTaoXiang,130481207,14193,1400,9749,5802,19144,9744,3872,9708,19452,9716,19465
ׯ,MaJiaZhuangXiang,130481208,13187,1408,8880,5435,17589,8878,3573,9285,18163,9288,18168
ϳֵֽ´,NanChangJieJieDaoBanShiChu,130502001,63606,4434,39305,20064,44012,30886,9403,30444,61330,38138,77443
ֵֽ´,BeiDaJieJieDaoBanShiChu,130502002,28795,2598,18407,10657,20494,16326,5143,15886,32212,18129,36536
ֵֽ´,XiDaJieJieDaoBanShiChu,130502003,36212,3726,23895,16390,26856,23706,7547,23424,47130,23590,47485
ֵ´,XiMenLiJieDaoBanShiChu,130502004,35780,3931,21398,14700,29482,21210,5880,20645,41855,24193,45591
,DongGuoCunZhen,130502100,16072,1374,10485,6274,14834,10414,3542,10283,20697,10503,20988
ׯ,DaLiangZhuangXiang,130502200,17983,1331,11268,6878,11372,11202,3524,11433,22635,11570,22838
и¼�,ShiGaoXinJiShuKaiFaQu,130502400,14015,1110,9359,5687,12961,9354,3597,9317,18671,9363,18722
·ֵ´,GangTieLuJieDaoBanShiChu,130503001,38748,3000,23059,13775,31134,21105,6716,21002,42107,25405,48464
·ֵ´,ZhongXingLuJieDaoBanShiChu,130503002,39843,3702,22359,13705,30197,20464,6239,20292,40756,27425,49784
Ȫֵ´,DaHuoQuanJieDaoBanShiChu,130503003,28570,1879,17762,11161,12969,16655,5360,16390,33045,18047,35809
ſֵ´,ZhangKuanJieDaoBanShiChu,130503004,25529,2488,15637,9112,30706,15143,4352,15161,30304,16732,32369
´ֵ´,ZhangCunJieDaoBanShiChu,130503005,26034,2176,12787,8155,29726,12730,3427,12738,25468,18850,31637
лֵֽ´,ZhongHuaDaJieJieDaoBanShiChu,130503006,39730,4006,25620,16627,31148,24526,6988,24035,48561,25104,50724
Ž·ֵ´,TuanJieLuJieDaoBanShiChu,130503007,53723,5675,34811,21920,44835,32214,9381,31514,63728,33968,68779
Ȫֵ´,QuanXiJieDaoBanShiChu,130503008,36086,1313,21003,7785,15869,12107,4417,11913,24020,20813,41816
ϴ,NanDaGuoZhen,130503100,19809,1713,13252,7678,19794,13235,4508,12753,25988,12778,26030
,LiCunZhen,130503101,11466,1011,7576,3909,14091,7535,2662,7356,14891,7563,15139
ԥŽֵ,YuRangQiaoJieDao,130521001,21383,1739,13811,7990,22310,12609,4616,12527,25136,13927,27738
,DongWangZhen,130521100,24378,1764,16034,8951,25110,15867,6415,16078,31945,16523,32557
,WangKuaiZhen,130521101,25390,2187,16461,9948,31439,16299,6332,16929,33228,17448,33909
ף,ZhuCunZhen,130521102,29978,2919,20024,10115,38701,19603,7420,19648,39251,20293,40317
̼,YanJiaTunZhen,130521103,26095,2454,16261,8529,30673,15570,5082,15496,31066,17370,33631
ʯ,NanShiMenZhen,130521104,38264,3869,24752,13821,45082,23580,7902,23310,46890,25283,50035
,YangFanZhen,130521105,22034,2218,14712,8813,28040,14701,5311,14832,29533,14851,29563
,HuangSiZhen,130521106,23950,2483,15614,8708,30971,15428,5408,15797,31225,16227,31841
,HuiNingZhen,130521107,27927,2890,18394,9784,32074,16622,5671,16317,32939,18094,36488
ƴ,XiHuangCunZhen,130521108,14549,1618,9403,5692,18353,8747,3236,8936,17683,10000,19403
·,LuLuoZhen,130521109,12258,1065,8037,4736,15428,7777,2936,7693,15470,8222,16259
Ĺ,JiangJunMuZhen,130521110,9734,1325,6469,4148,12072,6120,2361,6306,12426,6951,13420
ˮ,JiangShuiZhen,130521111,18523,1912,12263,6585,21565,10806,3921,10761,21567,12093,24356
μׯ,SongJiaZhuangZhen,130521112,13054,1844,8577,5104,16925,8366,2932,8778,17144,9253,17830
̫Ӿ,TaiZiJingXiang,130521200,8609,1196,5909,3774,11271,5908,1864,5757,11665,5760,11669
Ȫ,LongQuanSiXiang,130521201,8747,875,5816,3412,11330,5628,2241,5586,11214,6047,11863
Сׯ,BeiXiaoZhuangXiang,130521202,6180,750,4007,2535,7764,3997,1226,4052,8049,4149,8156
Ǽͷ,ChengJiTouXiang,130521203,6817,610,4538,2718,9021,4403,1768,4428,8831,4657,9195
װ,BaiAnXiang,130521204,6900,708,4608,2984,9111,4500,1669,4515,9015,4669,9277
Ҵ,JiJiaCunXiang,130521206,6302,906,4331,2747,8394,4293,1608,4394,8687,4485,8816
ٳ,LinChengZhen,130522100,49771,4431,31755,15514,53821,26200,10045,26622,52822,32492,64247
,DongZhenZhen,130522101,19113,2258,12463,6277,25454,11594,4281,11964,23558,13189,25652
,XiShuZhen,130522102,13331,1238,8785,5095,17636,8723,3279,8964,17687,9063,17848
ׯ,HaoZhuangZhen,130522103,9577,997,6425,4225,12811,6412,2487,6585,12997,6636,13061
ڳ,HeiChengXiang,130522200,18604,2168,12563,7229,24797,12561,4776,12982,25543,12985,25548
ѼӪ,YaGeYingXiang,130522201,21298,2776,14377,8232,28476,14347,5173,14793,29140,14870,29247
ʯ,ShiChengXiang,130522203,7979,780,5193,3091,10636,5192,1955,5520,10712,5521,10714
ׯ,ZhaoZhuangXiang,130522205,13020,1402,8504,5410,17383,8403,3347,9066,17469,9265,17769
,NeiQiuZhen,130523100,50045,3942,32032,16751,54622,29128,10427,29239,58367,32382,64414
ϴ,DaMengCunZhen,130523101,24263,2037,16188,8844,31279,16179,6242,16151,32330,16354,32542
,JinDianZhen,130523102,47094,4562,30912,15472,61653,30491,10728,30845,61336,31472,62384
ׯ,GuanZhuangZhen,130523103,22464,1906,14278,7597,28627,14096,4698,14525,28621,14790,29068
,LiuLinZhen,130523104,16271,1267,10477,5615,21494,10275,4133,10846,21121,11194,21671
,WuGuoDianXiang,130523200,19722,2091,13340,7215,26031,13235,4677,12778,26013,13150,26490
,NanSaiXiang,130523203,8336,768,5396,3088,11152,5395,2106,5812,11207,5814,11210
ô,ZhangMeXiang,130523204,4679,446,3179,1787,6437,3179,1365,3311,6490,3311,6490
ׯ,HouJiaZhuangXiang,130523205,8878,1206,5961,3871,12309,5860,2267,6140,12000,6390,12351
,BaiXiangZhen,130524100,35294,3651,23226,12555,42941,22339,8542,23393,45732,24261,47487
̳ǵ,GuChengDianZhen,130524101,27122,3013,18505,9806,36630,18475,7491,19095,37570,19121,37626
,XiWangZhen,130524102,22982,2470,15457,7385,30715,15452,5704,15689,31141,15699,31156
ׯ,WangJiaZhuangXiang,130524200,12956,1473,8663,4597,17539,8658,3344,9105,17763,9110,17773
,LongHuaXiang,130524202,27327,3266,18565,9182,36952,18565,7145,19173,37738,19173,37738
ڲ,NeiBuXiang,130524203,13811,1407,9061,4538,18335,9053,3227,9378,18431,9384,18445
¡Ң,LongYaoZhen,130525100,63537,5686,40995,19550,77916,38775,12534,38839,77614,40762,81757
κׯ,WeiJiaZhuangZhen,130525101,24339,2553,15765,7854,31700,15680,4977,15949,31629,16104,31869
,YinCunZhen,130525102,36162,3241,23288,11315,47780,23148,8608,24360,47508,24723,48011
ɽ,ShanKouZhen,130525103,25421,2257,16435,7762,33612,16430,6347,17588,34018,17590,34025
,LianZiZhen,130525104,47762,3385,30093,10084,52552,20652,6648,19980,40632,27702,57795
̳,GuChengZhen,130525105,31755,3291,20873,11383,42682,20809,8167,22269,43078,22340,43213
¥,BeiLouXiang,130525200,23187,2242,14879,7397,30288,14865,5177,15698,30563,15727,30606
,DongLiangXiang,130525201,42182,3866,25371,12470,50295,25367,8162,26334,51701,28839,54210
˫,ShuangBeiXiang,130525202,22408,1943,14228,7278,28923,14228,4899,15022,29250,15022,29250
ţ,NiuJiaQiaoXiang,130525203,19836,1971,12879,6454,25716,12690,3990,12754,25444,12918,25797
ǧӪ,QianHuYingXiang,130525204,24429,3184,16571,8913,32995,16545,5636,16657,33202,16678,33249
ׯ,DaZhangZhuangXiang,130525205,26070,2666,17387,9041,34560,17235,6325,17437,34672,17674,35061
ũ,LiuXingNongChang,130525400,1271,158,828,582,1503,828,280,881,1709,881,1709
γ,RenChengZhen,130526100,44633,3676,28891,13918,50675,27115,10011,27950,55065,29429,58320
ϼ,XingJiaWanZhen,130526101,30229,3053,19973,9441,39295,19801,7268,20192,39993,20577,40550
,XinDianZhen,130526102,26144,2639,17685,8893,35035,17684,7412,18495,36179,18510,36195
̳,XiGuChengXiang,130526200,28713,2569,19189,9430,37880,19188,8003,20095,39283,20096,39285
ׯ,YongFuZhuangXiang,130526201,23427,2126,15632,7133,31775,15632,6328,16248,31880,16249,31881
,DaTunXiang,130526202,35007,3031,22640,11756,45045,22482,8238,23354,45836,23636,46276
,TianKouXiang,130526203,32362,3584,21818,11687,43862,21818,8432,22556,44374,22560,44378
ׯ,LuoZhuangXiang,130526204,22314,2370,15348,7761,30658,15348,6357,15693,31041,15693,31041
,HeYangZhen,130527100,34752,3181,22616,12598,39761,22363,7638,22652,45015,22955,45571
,JiaSongZhen,130527101,36967,3154,23947,12948,48097,23935,8991,25155,49090,25165,49112
,HaoQiaoZhen,130527102,42098,3836,28007,14176,56764,28007,11379,29305,57312,29306,57313
,DongSanZhaoXiang,130527200,31061,3065,21368,11461,42217,21368,9034,21792,43160,21792,43160
,YanLiXiang,130527201,25599,2519,16870,9455,34056,16864,6355,17589,34453,17603,34473
ӹ,HeGuoXiang,130527202,23907,1976,15497,8778,30490,15101,5643,15754,30855,16029,31526
ʷ,ShiZhaoXiang,130527203,24278,2380,16670,8168,33527,16670,7119,17107,33777,17107,33777
˼,SanSiXiang,130527204,22502,2012,14906,8308,30037,14906,5886,15494,30400,15494,30400
,FengHuangZhen,130528100,108374,8641,69373,34836,116998,62831,23677,65165,127996,71319,140692
,HeQuZhen,130528101,47662,5303,31348,15654,63922,30941,12167,33136,64077,33784,65132
ׯ,BeiHeZhuangZhen,130528102,36833,4081,24552,13454,48623,24537,9337,25692,50229,25699,50251
ׯ,GengZhuangQiaoZhen,130528103,40641,5351,28704,14748,55714,28648,11625,28833,57481,28913,57617
,DongWangZhen,130528104,26326,3247,17669,8983,34755,17231,6124,17338,34569,18028,35697
ּҿ,JiaJiaKouZhen,130528105,35931,4061,25004,12883,47895,24854,9643,24446,49300,24631,49635
֥,SiZhiLanZhen,130528106,44138,4756,28819,14440,55556,27665,9062,27985,55650,29137,57956
½,DaLuCunZhen,130528107,33057,3475,22425,11153,44048,21926,8806,22397,44323,22913,45338
ռׯ,SuJiaZhuangZhen,130528108,46238,4860,30562,14890,59961,30330,10929,31204,61534,31465,62027
,HuanMaDianZhen,130528109,37636,3748,25061,12534,49014,24750,10241,26231,50981,26564,51625
,HouKouXiang,130528200,15752,2300,11330,6980,21735,11311,4222,10922,22233,10944,22274
Ͳׯ,JiChangZhuangXiang,130528202,20658,2513,13769,7676,27084,13679,4368,13600,27279,13770,27539
,TangQiuXiang,130528203,34717,3379,22955,11463,45395,22712,8981,23754,46466,24122,47077
,BeiYuXiang,130528205,7042,834,5051,2586,8977,4999,1848,4629,9628,4673,9724
Һ,XuJiaHeXiang,130528206,15581,1745,10786,5810,21275,10732,4616,11020,21752,11156,21942
ׯ,DaCaoZhuangXiang,130528207,12258,1256,8074,4423,16218,8058,3195,8614,16672,8635,16709
ׯ,DaCaoZhuangGuanLiQu,130528400,2733,375,1696,1133,3119,1510,485,1570,3080,1897,3593
¹,JuLuZhen,130529100,69210,5416,44972,25049,82794,43198,15685,44191,87389,45339,90311
կ,WangHuZhaiZhen,130529101,18927,2210,12568,6660,24670,12494,4639,13096,25590,13208,25776
,XiGuoChengZhen,130529102,10415,1153,7035,3754,13358,6959,2565,6869,13828,7098,14133
ͤ,GuanTingZhen,130529103,25246,3127,17153,9268,33843,16876,6210,17009,33885,17430,34583
,YanTuanZhen,130529104,20368,2643,13618,7984,27117,13418,4342,13378,26796,13735,27353
Сկ,XiaoLvZhaiZhen,130529105,17176,1937,11593,5626,22553,11407,3984,11142,22549,11504,23097
̴,DiCunXiang,130529200,34182,3704,22742,13601,45099,22619,8203,23135,45754,23347,46089
,ZhangWangTuanXiang,130529201,31198,3419,21220,12226,42215,21219,8172,21568,42787,21569,42789
կ,GuanZhaiXiang,130529202,25557,2947,17487,9418,34200,17392,6769,17607,34999,17786,35273
ռӪ,SuJiaYingXiang,130529203,25399,3306,17478,10098,35001,17340,6525,17492,34832,17752,35230
º,XinHeZhen,130530100,37706,3328,24841,14338,46680,23058,7875,22598,45656,24068,48909
Ѱկ,XunZhaiZhen,130530101,18327,2300,12447,7575,24750,12447,4356,12536,24983,12536,24983
,BaiShenShouXiang,130530200,13336,1441,8945,5495,17441,8945,2823,8655,17600,8655,17600
ׯ,JingJiaZhuangXiang,130530201,17697,2113,11995,7318,23811,11995,4352,12167,24162,12167,24162
,XiLiuXiang,130530202,21759,2290,13976,8540,28033,13976,4090,14163,28139,14163,28139
,RenRangLiXiang,130530203,19622,2381,13056,8037,25818,13051,4062,12994,26045,13009,26065
,GuangZongZhen,130531100,43025,3591,28916,16241,51003,27469,11650,28050,55519,29350,58266
«,HuLuXiang,130531200,15620,1778,11050,6503,22220,11050,5048,11396,22446,11396,22446
ƽ̨,DaPingTaiXiang,130531201,29328,3166,20226,11366,40060,20214,8027,20283,40497,20295,40521
ֻ,JianZhiXiang,130531202,19350,2233,13837,8158,26757,13818,5385,13117,26935,13131,26968
԰,HeTaoYuanXiang,130531203,19895,2892,14364,9114,27138,14337,4961,13377,27714,13384,27748
,DongZhaoXiang,130531204,14040,1774,10016,5922,19770,10016,4122,9920,19936,9920,19936
,BeiTangTuanXiang,130531205,33371,2798,23363,14767,46448,23362,10953,23758,47120,23759,47122
կ,FengJiaZhaiXiang,130531206,27743,2449,20208,10705,39827,20208,10652,20636,40844,20636,40844
,FengZhouZhen,130532100,49076,4426,32547,18069,61818,31346,12635,32931,64277,33590,66137
ƽ,PingXiangZhen,130532101,26296,2668,18131,10440,36243,17885,7943,18599,36484,18776,36907
ӹ,HeGuMiaoZhen,130532102,30005,2633,20919,10557,39891,20571,10434,21536,42107,22153,43072
ڹ,JieGuXiang,130532200,30579,3018,19539,11344,40184,19539,7556,21614,41153,21614,41153
,YouZhaoXiang,130532201,30446,3360,22287,11383,43616,22287,10889,22408,44695,22408,44695
︶,TianFuCunXiang,130532202,22914,2160,15927,8883,31492,15887,7329,16380,32267,16476,32403
Ѱ,XunZhaoXiang,130532203,25477,3134,17280,9671,35193,17273,7051,18370,35643,18382,35662
,MingZhouZhen,130533100,54632,4285,33820,21286,66040,31678,11007,33693,65371,36104,69924
Ԫ,LiYuanTunZhen,130533101,23598,2173,15637,9134,31263,15637,5759,15893,31530,15893,31530
̨,ZhangTaiZhen,130533102,26938,2389,17848,10606,35587,17843,6676,18153,35996,18155,36003
,HouGuanZhen,130533103,26147,2263,17435,9311,34787,17435,6645,17620,35055,17620,35055
߼,QiJiZhen,130533104,25043,2604,15990,9534,32224,15990,4768,16425,32415,16425,32415
Ӫ,FangJiaYingXiang,130533200,19112,1986,13282,7273,26490,13282,5441,13257,26539,13257,26539
ʲӪ,DiShenYingXiang,130533201,28145,2503,19512,12264,39143,19512,8666,19802,39314,19802,39314
԰,ZaoYuanXiang,130533202,28826,2609,19186,10472,38987,19186,7651,19897,39083,19900,39086
,GuXianXiang,130533203,23238,2302,15910,9308,32066,15910,6787,16415,32325,16417,32327
,HeZhaoXiang,130533204,25297,2367,16781,9998,34415,16781,6885,17768,34549,17768,34549
Ӫ,HeYingXiang,130533205,22934,2187,15681,9369,31567,15681,6524,15964,31645,15964,31645
Ӫ,ZhangYingXiang,130533206,18626,1855,12502,7668,25100,12502,4713,12692,25194,12692,25194
,ChangTunXiang,130533207,23606,2200,15602,9430,31827,15602,6150,16354,31956,16354,31956
ׯ,ChangZhuangXiang,130533208,21742,1902,14423,7901,28601,14423,5358,14579,29002,14579,29002
߹ׯ,GaoGongZhuangXiang,130533209,23043,2098,14770,9399,30135,14770,5025,15396,30166,15396,30166
Դ,ZhaoCunXiang,130533210,24418,2279,15793,8746,31837,15793,5222,16126,31919,16126,31919
ׯ,GeXianZhuangZhen,130534100,94915,6919,59556,31694,106885,55869,21083,58506,114375,63361,122917
ׯ,LianZhuangZhen,130534101,44781,4048,28957,15341,59105,28846,10747,30412,59258,30619,59576
ͷ,YouFangZhen,130534102,37016,3939,24570,15396,49206,24554,9481,25783,50337,25866,50436
л¯,XieLuZhen,130534103,39674,3992,26086,15171,52479,26086,10026,27584,53670,27606,53692
ׯ,WangGuanZhuangZhen,130534104,41431,4064,27030,15657,54476,26888,9763,27977,54865,28228,55258
Ӫ,BaYingZhen,130534105,33036,3642,21589,12637,43799,21387,7674,22316,43703,22763,44352
,LinXiZhen,130535100,39477,2859,24824,12051,46863,20565,10388,21525,42090,27900,52724
,HeXiZhen,130535101,30922,2499,20321,10751,40813,20213,8372,21341,41554,21472,41793
±,XiaBaoSiZhen,130535102,23646,2163,16546,9359,33285,16545,7660,16923,33468,16923,33469
ڣ,JianZhongZhen,130535103,26618,2255,18422,9309,35963,18417,8456,18902,37319,18907,37329
Ϲկ,LaoGuanZhaiZhen,130535104,27146,2624,18199,9880,36476,18199,7743,19314,37513,19314,37513
԰,DongZaoYuanXiang,130535200,17832,1910,12670,7213,24698,12670,6183,13255,25925,13255,25925
կ,LvZhaiXiang,130535202,27553,2670,18373,10055,37191,18283,7211,18906,37189,19061,37434
ҡ,YaoAnZhenXiang,130535203,29061,2440,19911,11172,40322,19910,9113,20700,40610,20703,40614
ׯ,DaLiuZhuangXiang,130535204,26399,2330,17890,9706,35742,17890,7854,18691,36581,18693,36583
ڽֵ´,FengGangJieDaoBanShiChu,130581001,61049,4797,37579,20317,62619,32051,8975,32052,64103,37242,74821
϶Žֵ´,NanDuJieDaoBanShiChu,130581002,8493,968,5425,3281,10382,5335,1355,5291,10626,5391,10816
ֵ´,BeiHuJieDaoBanShiChu,130581003,16034,1976,10054,6041,19965,9721,2330,9756,19477,10286,20340
�ֵ´,XiDingJieDaoBanShiChu,130581004,8806,998,5503,3367,11064,5417,1293,5508,10925,5594,11097
մ,SuCunZhen,130581100,17012,2124,10775,5995,21649,10717,2925,10870,21587,11286,22061
ߴ,DaGaoCunZhen,130581101,16990,1685,10667,6569,21124,10607,2669,10568,21175,10677,21344
,ChuiYangZhen,130581102,32063,2831,20493,12365,41124,20165,6673,20724,40889,21074,41567
,MingHuaZhen,130581103,26185,2640,16275,10751,33615,15866,4962,16614,32480,17512,33787
«ͷ,DuanLuTouZhen,130581104,40399,3935,26190,15550,50150,26187,9030,27115,53302,27174,53364
ڣ,ZiZhongZhen,130581105,31646,3395,20724,12783,40603,20683,7155,21420,42103,21472,42196
,DaCunXiang,130581200,18452,2485,12001,7679,24388,11993,3531,12422,24415,12467,24468
ϱ,NanBianCunXiang,130581201,23084,2762,14957,8797,30277,14849,4549,15309,30158,15438,30395
,DaTunXiang,130581202,17729,2062,11335,6987,22295,11121,2766,10826,21947,11222,22557
կ,WangDaoZhaiXiang,130581203,19581,2150,12780,7010,25184,12577,3646,12221,24798,12597,25377
Ѧ,XueWuCunXiang,130581204,27107,2464,17124,10839,34192,16983,5269,17195,34178,17716,34840
ͽֵ´,DaLianJieDaoBanShiChu,130582001,44820,4867,28602,16423,41074,25704,8188,25965,51669,29273,57875
Ŷֵ´,QiaoDongJieDaoBanShiChu,130582002,41498,2658,25918,13163,35900,23438,9161,24669,48107,27399,53317
ֵ´,QiaoXiJieDaoBanShiChu,130582003,16067,1309,10233,5306,16994,10219,3711,10624,20843,10854,21087
ư´,ZanShanBanShiChu,130582004,25178,1980,16828,8316,31351,16327,7011,16678,33005,17341,34169
ׯֵ´,ZhouZhuangJieDaoBanShiChu,130582005,11774,1028,7844,4024,13916,7452,2972,7798,15250,7930,15774
ɳӳ,ShaHeChengZhen,130582100,28472,2598,18597,9533,35443,18589,6652,19119,37708,19125,37722
³,XinChengZhen,130582101,30024,2161,20371,8926,38774,20252,9103,20275,40527,20917,41288
,BaiTaZhen,130582102,35363,2378,23178,10354,40945,22331,9268,21869,44200,23831,47009
ʮͤ,ShiLiTingZhen,130582103,20905,1544,14035,6637,26725,13932,6262,14158,28090,14676,28711
,QiCunZhen,130582104,21693,1610,14973,6879,28107,14959,6624,14871,29830,14954,29927
,LiuCunXiang,130582200,36306,2974,24056,13158,46216,24001,10263,25377,49378,25487,49543
ᾮ,CeJingXiang,130582201,18240,1638,12880,7321,24121,12862,5876,12843,25705,12874,25754
ʯ,LiuShiGangXiang,130582202,17797,1526,12083,5951,22845,12077,4881,11892,23969,12121,24204
,ChaiGuanXiang,130582203,11132,1128,7948,4365,14947,7879,3569,7745,15624,7881,15829
,ChanFangXiang,130582204,11352,929,8099,4415,15589,7999,3926,7917,15916,8108,16207
ȷֵ´,XianFengJieDaoBanShiChu,130602001,55062,8873,38203,25626,50860,36295,9123,34356,70651,34855,73058
гֵ´,XinShiChangJieDaoBanShiChu,130602002,50537,7823,33771,24323,48129,33321,7921,32000,65321,32510,66281
ֵ´,DongFengJieDaoBanShiChu,130602003,38096,5592,24958,15982,28331,21693,5045,20464,42157,23775,48733
Ͻֵ´,JianNanJieDaoBanShiChu,130602004,47279,5177,29817,20291,37505,28729,8378,27667,56396,31017,60834
山·ֵ´,HanCunBeiLuJieDaoBanShiChu,130602005,46215,5641,30300,20522,37990,29405,7514,28212,57617,29070,59370
ׯ,JieZhuangXiang,130602200,16104,1687,10921,5899,16654,10881,3504,10296,21177,10374,21295
,FuChangXiang,130602201,17562,1643,11797,6137,19544,11727,3893,11246,22973,11301,23098
,HanCunXiang,130602202,13562,817,7621,5220,9649,7210,2440,7645,14855,9198,16819
,NanQiXiang,130602203,15080,1843,10224,5213,19328,10213,3402,10091,20304,10101,20325
,JiangChengXiang,130602204,25315,2835,17102,8577,33081,17090,6096,17135,34225,17144,34246
�,DaMaFangXiang,130602205,12516,1210,8620,4088,16549,8615,3285,8316,16931,8391,17011
Ҹ,BaoDingGuoJiaGaoXinQu,130602400,17953,1370,11117,7269,12566,10247,3005,9838,20085,11211,22328
ƽֵ´,HePingLiJieDaoBanShiChu,130603001,39397,4956,25281,16712,34467,23354,6083,21517,44871,25155,50436
·ֵ´,WuSiLuJieDaoBanShiChu,130603002,66137,4614,36875,22494,38737,32880,10283,31411,64291,44159,81034
ؽֵ´,XiGuanJieDaoBanShiChu,130603003,26367,3550,17799,12235,21317,17117,4363,15985,33102,16481,34280
л·ֵ´,ZhongHuaLuJieDaoBanShiChu,130603004,26224,3938,18249,12286,24446,17725,4763,16240,33965,16676,34925
ؽֵ´,DongGuanJieDaoBanShiChu,130603005,63147,5312,38483,18560,44671,25811,6568,24851,50662,36544,75027
ׯ,HanZhuangXiang,130603200,37483,1604,21148,6797,26820,12211,4341,11845,24056,22280,43428
ׯ,DongJinZhuangXiang,130603201,16342,1391,10710,5349,18465,10422,3500,10025,20447,10523,21233
¥,BaiLouXiang,130603202,41730,1590,26401,5339,25514,10362,3656,10379,20741,20575,46976
˽ֵ´,LianMengJieDaoBanShiChu,130604001,21170,2322,14551,7523,13443,10565,2940,9693,20258,11881,26432
ǽֵ´,HongXingJieDaoBanShiChu,130604002,11827,2265,8473,6054,11488,8442,2095,7694,16136,7714,16187
ԣֵ´,YuHuaJieDaoBanShiChu,130604003,10815,1556,7322,5138,10829,7302,1875,6915,14217,6924,14246
ֵ´,YongHuaJieDaoBanShiChu,130604004,23379,2961,15725,10745,22740,15573,4293,14729,30302,14908,30633
Ϲؽֵ´,NanGuanJieDaoBanShiChu,130604005,62450,4604,38387,14280,38683,20527,6003,20337,40864,34670,73057
ׯ,YangZhuangXiang,130604200,12619,1144,8281,4662,12466,8259,2513,7955,16214,7995,16276
ϴ԰,NanDaYuanXiang,130604201,41744,2492,24485,10803,28202,17812,5812,17403,35215,25563,50048
ׯ,JiaoZhuangXiang,130604202,25219,2325,16619,8405,28075,16322,5761,16142,32464,16686,33305
Ң,WuYaoXiang,130604203,21809,1661,12521,6000,24299,11981,4130,11888,23869,15079,27600
ֵ´,HuiYangJieDaoBanShiChu,130621001,2721,1025,2087,1897,21,2087,384,2043,4130,2043,4130
,ManChengZhen,130621100,89747,7868,54735,29571,93659,52766,20489,52861,105627,63369,118104
Ӫ,DaCeYingZhen,130621101,26088,2587,17861,8687,35079,17854,7416,18215,36069,18230,36091
,ShenXingZhen,130621102,27037,3121,18392,10101,36734,18386,7387,19127,37513,19153,37545
Ϻ,NanHanCunZhen,130621103,31751,3746,21348,12018,41850,21320,7644,21735,43055,21793,43141
˳,FangShunQiaoXiang,130621200,31541,3524,20934,10998,41459,20930,7509,21638,42568,21640,42574
ڼׯ,YuJiaZhuangXiang,130621201,16585,1884,11067,5682,21644,11065,3743,11144,22209,11145,22212
̨,XianTaiXiang,130621202,14579,1506,9640,5439,18883,9631,3285,9710,19341,9730,19370
Ҫׯ,YaoZhuangXiang,130621203,15978,1682,10751,5593,21229,10750,3917,10815,21565,10826,21577
,BaiLongXiang,130621204,11777,1535,7844,4810,15520,7835,2761,8205,16040,8229,16073
ʯ,ShiJingXiang,130621205,16748,1874,11299,6543,22233,11296,4167,11487,22783,11490,22789
,TuoNanXiang,130621206,12277,1455,8095,4764,16367,8089,3038,8672,16761,8675,16770
̨,LiuJiaTaiXiang,130621207,4536,686,3064,1914,6095,3061,1079,3232,6293,3237,6301
Է,QingYuanZhen,130622100,62606,5159,41270,22683,62631,38008,13618,37648,75656,40113,81383
Ƚׯ,RanZhuangZhen,130622101,26887,3402,17653,9916,34876,17649,5830,18451,36100,18466,36119
,YangChengZhen,130622102,28479,3531,18507,10762,36282,18506,5971,19468,37974,19474,37981
κ,WeiCunZhen,130622103,28671,3627,18935,10229,37365,18934,6086,19448,38382,19449,38384
,WenRenZhen,130622104,34894,4383,23241,12955,45851,23217,8143,24145,47362,24179,47420
ŵ,ZhangDengZhen,130622105,27183,3405,18145,9606,35396,18043,6558,18804,36847,19001,37146
ׯ,DaZhuangZhen,130622106,17431,2071,11562,5956,22593,11562,4057,11997,23559,11997,23559
갴,ZangCunZhen,130622107,23859,2306,15184,8491,30089,15089,4942,15839,30928,15923,31107
,BaiTuanXiang,130622200,25252,3041,16479,8814,32141,16478,5301,17114,33592,17115,33594
,BeiDianXiang,130622201,18195,2286,12094,6766,23579,12090,4276,12605,24695,12663,24757
ʯ,ShiQiaoXiang,130622202,31654,3320,20848,10938,41242,20848,7607,21730,42578,21733,42581
ׯ,LiZhuangXiang,130622203,19531,2659,12734,7390,25443,12674,4113,13487,26161,13569,26303
,BeiWangLiXiang,130622204,19880,2515,12862,7116,25716,12819,3639,12995,25814,13172,26034
,DongLvXiang,130622205,30438,3706,20919,10902,41195,20905,8264,21468,42373,21489,42408
,HeQiaoXiang,130622206,19916,2298,13320,7258,25834,13315,4907,13785,27100,13801,27121
,SunCunXiang,130622207,12367,1294,7950,4341,15662,7935,2641,8212,16147,8352,16302
ׯ,YanZhuangXiang,130622208,15385,1551,9971,5085,19680,9934,3340,10275,20209,10305,20276
ͤ,WangTingXiang,130622209,28479,2724,19105,10034,38232,19090,7981,20049,39139,20079,39184
칫ҽֵ´,ChengQuSheQuGuanLiBanGongShiJieDaoBanShiChu,130623001,22093,1469,14239,8704,21311,12485,4298,12276,24761,13621,27860
ˮ,LaiShuiZhen,130623100,28484,2697,18129,9878,34247,17984,4998,17781,35765,18050,36179
,YongYangZhen,130623101,22865,2330,14574,7918,28664,14547,4437,14809,29356,15058,29632
尲,YiAnZhen,130623102,23194,2592,14808,8184,28777,14701,4027,14889,29590,15005,29813
ʯͤ,ShiTingZhen,130623103,27069,2918,17183,9995,34662,17038,5116,17704,34742,17920,35103
Ըׯ,ZhaoGeZhuangZhen,130623104,17036,2277,10788,7287,22291,10498,3201,11041,21539,11726,22514
,JiuLongZhen,130623105,12931,1365,8051,5136,15304,8007,2538,8432,16439,8783,16834
,SanPoZhen,130623106,11233,1146,6553,4148,12215,6438,1986,6479,12917,7812,14365
,MingYiXiang,130623200,15904,1795,10169,5455,20052,10151,2728,10231,20382,10258,20427
,WangCunXiang,130623201,16295,1782,10341,5882,20495,10338,2920,10607,20945,10656,20997
ɽ,DongWenShanXiang,130623202,12102,1300,7722,4393,14971,7719,2272,7929,15648,7952,15674
¦,LouCunManZuXiang,130623203,22272,2558,13920,7771,28063,13856,4198,14404,28260,15108,29028
θׯ,SongGeZhuangXiang,130623204,7232,771,4660,2564,9287,4623,1388,4694,9317,4731,9391
п,QiZhongKouXiang,130623205,5017,639,3166,2058,6504,3164,899,3389,6553,3389,6555
,LongMenXiang,130623206,8113,1189,5183,3279,10552,5176,1415,5523,10699,5534,10717
ׯ,HuJiaZhuangXiang,130623207,10712,1249,6995,3910,13751,6994,2013,6971,13965,6979,13974
ƽ,FuPingZhen,130624100,42268,3994,29870,17376,48202,28540,12955,28128,56668,29347,59217
Ȫ,LongQuanGuanZhen,130624101,5038,1001,3666,2383,7262,3652,1355,3668,7320,3728,7394
ƽ,PingYangZhen,130624102,16440,1842,11882,6853,23333,11882,5754,12154,24036,12154,24036
ׯ,ChengNanZhuangZhen,130624103,14462,2201,10120,6130,19841,9806,4149,10019,19825,10692,20812
,TianShengQiaoZhen,130624104,6120,1010,4518,2916,8578,4488,2021,4422,8910,4633,9151
ֿ,WangLinKouXiang,130624201,13294,1509,9294,5228,18350,9294,3978,9487,18781,9487,18781
̨,TaiYuXiang,130624202,4577,717,3234,2154,6547,3232,1424,3480,6712,3484,6718
̨,DaTaiXiang,130624203,7563,1149,5332,3549,10663,5330,2263,5638,10968,5643,10975
ʷկ,ShiJiaZhaiXiang,130624204,5897,1044,4064,2749,8258,4060,1452,4304,8364,4329,8393
ɰ,ShaWoXiang,130624205,6983,1242,5060,3131,10221,5028,2098,5205,10233,5263,10323
,WuWangKouXiang,130624206,2769,717,2062,1593,4167,2062,790,2214,4276,2214,4276
ׯ,XiaZhuangXiang,130624207,3051,662,2311,1465,4616,2292,925,2293,4585,2327,4638
Ԫ,BeiGuoYuanXiang,130624208,14245,1869,10071,5877,20249,10062,4471,10463,20525,10514,20585
,AnSuZhen,130625100,108766,10806,71197,37703,114977,64867,21639,63998,128865,70014,141211
ׯ,CuiZhuangZhen,130625101,50022,5733,32683,17941,64525,32511,10992,33764,66275,34064,66747
,DaYinZhen,130625102,39926,4522,26246,15059,52664,26229,9420,27553,53782,27622,53868
,SuiChengZhen,130625103,34639,3902,22652,12807,43301,22220,7096,22541,44761,22985,45637
ִ,GaoLinCunZhen,130625104,30443,3996,20331,11698,39318,20279,6290,20358,40637,20398,40729
,DaiWangDianZhen,130625105,29370,3379,19307,11473,37895,19245,6435,19732,38977,19877,39184
,CaoHeZhen,130625106,25421,2859,16752,9020,32430,16661,5678,17105,33766,17206,33958
ʷ,DongShiDuanXiang,130625200,24456,2947,16137,8676,31775,16113,5405,16604,32717,16671,32808
,LiuCunXiang,130625201,21009,2523,13853,7757,26751,13795,4520,14093,27888,14199,28052
,ZhengCunXiang,130625202,17926,2009,11764,6649,22964,11747,3815,11949,23696,11986,23750
ľ,HuMuXiang,130625203,17481,1776,11312,5978,22101,11310,3437,11371,22681,11382,22694
ٺ,BaoHeXiang,130625204,10193,1291,6845,4069,13493,6845,2347,6986,13831,6986,13831
ɽ,DongFuShanXiang,130625205,9385,1020,6311,3861,12516,6299,2415,6497,12796,6509,12820
ׯ,YiLianZhuangXiang,130625206,5790,715,3742,2359,7577,3740,1236,3997,7737,3999,7741
,DingXingZhen,130626100,74666,6438,47438,24214,83346,42396,14352,42546,84942,48018,95456
̳,GuChengZhen,130626101,33400,4393,23394,12715,44202,23351,7636,21991,45342,22035,45429
Ԣ,XianYuZhen,130626102,30528,3895,20621,11001,40629,20620,6618,20410,41030,20420,41041
,BeiHeZhen,130626103,14482,1820,10072,5522,18312,9753,3335,9291,19044,9565,19637
䱤,DongLuoBaoXiang,130626200,18178,1944,12104,6639,23370,11972,3774,11689,23661,11792,23896
,GaoLiXiang,130626201,35720,4456,23984,12912,47315,23900,7611,23723,47623,23803,47787
żׯ,ZhangJiaZhuangXiang,130626202,11793,1618,8385,4774,16183,8353,2919,7902,16255,7945,16330
Ҧ,YaoCunXiang,130626203,13893,1657,9360,5047,18394,9360,3012,9201,18561,9202,18562
Ф,XiaoCunXiang,130626204,16502,2024,11211,5978,21818,11211,3484,10799,22010,10799,22010
׿,LiuZhuoXiang,130626205,16078,2039,11341,5811,21515,11341,3562,10338,21679,10338,21679
,YangCunXiang,130626206,20418,2482,14211,7510,27263,14209,4852,13522,27731,13541,27752
,BeiTianXiang,130626207,26262,3089,17588,9133,35033,17588,6127,17890,35478,17890,35478
ϲ,BeiNanCaiXiang,130626208,14588,1772,9498,4686,19181,9498,3185,10047,19545,10047,19545
ׯ,LiYuZhuangXiang,130626209,13119,1591,8955,4656,17209,8954,3061,8813,17767,8816,17771
칬,TianGongSiXiang,130626210,25322,2759,17077,8745,33491,17070,6132,17109,34179,17136,34213
Сׯ,XiaoZhuZhuangXiang,130626211,23103,2743,15213,7517,30896,15213,5442,16075,31288,16075,31288
ʺ,RenHouZhen,130627100,57231,5973,38185,19972,67891,35006,14405,34153,69159,39424,77609
,WangJingZhen,130627101,35362,4162,25619,12552,48657,25395,9705,23385,48780,23610,49229
߲,GaoChangZhen,130627102,22135,2880,16271,9026,31103,16244,6735,15451,31695,15479,31750
,BeiLuoZhen,130627103,36455,3495,26008,12150,50781,25960,10999,24793,50753,24941,50949
׺,BaiHeZhen,130627104,20110,2201,14113,7781,28392,14098,6614,14704,28802,14812,28925
,JunChengZhen,130627105,15140,1676,10672,5919,21269,10538,4916,11011,21549,11060,21732
,ChuanLiZhen,130627106,6772,787,4598,2360,9004,4554,1781,4692,9246,4742,9340
ų,ChangGuChengXiang,130627200,25288,2999,19782,10118,36109,19775,8650,17128,36903,17155,36937
ͤ,DouTingXiang,130627201,15452,1763,11656,6276,21514,11656,4761,10320,21976,10320,21976
ϵͷ,NanDianTouXiang,130627202,14592,1635,11037,5456,20555,11037,4526,9716,20753,9716,20753
ͷ,BeiDianTouXiang,130627203,21167,2749,15143,8656,29862,15132,6643,15400,30532,15416,30559
ׯ,LuoZhuangXiang,130627204,24847,2448,17918,8593,33852,17918,7589,16966,34884,16966,34884
ˮ,BaoShuiXiang,130627205,10903,1265,8411,4209,15567,8410,3554,7277,15687,7311,15722
,DaYangXiang,130627206,16287,1916,11869,6174,22675,11779,4786,11019,22798,11120,22989
Գ,MiChengXiang,130627207,7115,959,5286,3151,10329,5286,2407,5195,10481,5195,10481
,QiJiaZuoXiang,130627208,16875,2143,11605,6693,23624,11605,4707,12120,23725,12120,23725
,YangJiaoXiang,130627209,8566,1129,5804,3057,11782,5803,2336,6221,12024,6227,12031
ʯ,ShiMenXiang,130627210,5854,655,4107,2213,8549,4107,2109,4511,8618,4511,8618
ʯ,HuangShiKouXiang,130627211,11422,1478,7865,4664,16010,7865,3296,8331,16196,8331,16196
,DaoMaGuanXiang,130627212,3375,447,2218,1271,4532,2218,840,2444,4662,2444,4662
,GaoYangZhen,130628100,60250,5006,40197,20476,53963,34356,13200,34110,68466,38259,78456
ӿ,PangKouZhen,130628101,33938,4199,22873,13006,42773,22816,9002,24100,46916,24266,47139
,XiYanZhen,130628102,34147,4379,23462,12563,43830,23255,9098,23911,47166,24162,47624
ϼ,XingJiaNanZhen,130628103,26099,3082,17256,9250,31183,16371,5791,16747,33118,17716,34972
ׯ,JinZhuangXiang,130628201,25066,2943,16635,8894,30594,16109,5879,16384,32493,17253,33888
ѿ,PuKouXiang,130628202,17482,1968,11803,6587,22239,11473,4629,11768,23241,12276,24079
Сׯ,XiaoWangGuoZhuangXiang,130628203,20543,2525,13959,7837,26237,13844,5330,14317,28161,14439,28398
,LongHuaXiang,130628204,19554,2512,13531,8268,25966,13488,5228,13747,27235,13763,27294
Ӽ,PangJiaZuoXiang,130628205,16682,2263,11512,6607,21628,11511,4365,11795,23306,11798,23310
ݳ,RongChengZhen,130629100,52604,5579,34387,16742,60617,30638,10960,31350,61988,34756,69143
С,XiaoLiZhen,130629101,18756,2297,12258,6385,23992,11833,3962,12280,24113,12757,25015
,NanZhangZhen,130629102,32236,3799,21382,11123,41754,21188,7366,21669,42857,22019,43401
,DaHeZhen,130629103,17304,2147,11449,5935,21262,10729,3675,11406,22135,11677,23126
̨,LiangMaTaiZhen,130629104,19814,2157,12707,6188,24197,12194,4472,12882,25076,13736,26443
,BaYuXiang,130629200,15040,1865,9777,5124,18994,9490,3268,9776,19266,10396,20173
ֹ,JiaGuangXiang,130629201,18088,2303,12052,6128,23631,11926,4041,12329,24255,12380,24432
ƽ,PingWangXiang,130629203,20073,1996,12813,6361,22828,11359,4377,12080,23439,13633,26446
Դ,LaiYuanZhen,130630100,68473,5275,45412,27553,66601,43186,18943,44536,87722,47279,92691
,YinFangZhen,130630101,8457,1234,5695,3631,11840,5695,2396,6349,12044,6392,12087
,ZouMaYiZhen,130630102,10569,1531,7024,4779,14765,7024,2978,8054,15078,8054,15078
ˮ,ShuiBaoZhen,130630103,4928,597,2910,2112,5962,2861,1262,3200,6061,3877,6787
,WangAnZhen,130630104,9967,1356,6733,4553,13166,6700,2840,7388,14088,7430,14163
ׯ,YangJiaZhuangZhen,130630105,10289,999,6380,4008,11968,6249,2651,6352,12601,7559,13939
ʯɽ,BaiShiShanZhen,130630106,11138,1451,7242,5198,14825,7234,2899,8166,15400,8246,15488
,NanTunXiang,130630200,6169,902,3896,2761,7939,3878,1551,4483,8361,4726,8622
ׯ,NanMaZhuangXiang,130630201,5781,1023,3878,2785,8277,3874,1653,4571,8445,4579,8457
ʯ,BeiShiFoXiang,130630202,12398,1466,8182,5396,16873,8182,3446,9128,17310,9128,17310
Ҿ,JinJiaJingXiang,130630203,7978,1151,5161,3654,10842,5161,1997,5965,11126,5965,11126
ׯ,LiuJiaZhuangXiang,130630204,4064,610,2559,1777,5363,2559,948,3063,5622,3063,5622
ׯ,ShangZhuangXiang,130630205,8543,1212,5569,4009,11695,5569,2165,6349,11918,6351,11920
ű,DongTuanBaoXiang,130630206,8558,1276,5503,3890,11885,5503,2177,6508,12011,6508,12011
,TaYaYiXiang,130630207,4794,665,3122,2209,6437,3119,1205,3540,6659,3542,6664
,WuLongGouXiang,130630208,4143,583,2706,1809,5640,2697,1173,3185,5882,3193,5899
ú,YanMeiDongXiang,130630209,2061,351,1307,1073,2796,1303,402,1502,2805,1507,2814
,WangDouZhen,130631100,43165,4580,28201,16120,48384,27082,8543,27149,54231,28087,56288
̵,GuDianZhen,130631101,21202,2532,13977,7421,27128,13710,4398,13963,27673,14155,28132
ׯ,SiZhuangXiang,130631200,23628,2633,15770,8989,30884,15770,5272,15763,31533,15763,31533
ׯ,ZhaoZhuangXiang,130631201,20651,2256,12643,7133,26417,12559,4137,12871,25430,14401,27044
ڱ,HeiBaoXiang,130631202,20386,2219,13377,7333,26448,13376,4346,13573,26949,13574,26951
,GaoLingXiang,130631204,20272,2512,13231,6823,26287,13215,3962,13497,26712,13515,26746
кׯ,ZhongHanZhuangXiang,130631205,19419,2437,13045,7046,25871,13042,4723,13459,26501,13534,26579
ִ,JiaCunXiang,130631206,20179,2604,12996,7777,26461,12987,3958,13724,26711,13745,26741
,AnXinZhen,130632100,52151,4925,34540,20677,58684,32423,11886,32301,64724,34422,68962
,DaiWangZhen,130632101,19210,2273,12831,7377,25567,12778,5055,13552,26330,13707,26538
̨,SanTaiZhen,130632102,52479,2664,26952,7466,30007,15039,5522,15709,30748,33713,60665
˴,DuanCunZhen,130632103,28509,3133,19575,12590,38429,19455,7494,19422,38877,19561,39136
Ա,ZhaoBeiKouZhen,130632104,12289,1493,8597,5081,16742,8591,3370,8552,17143,8555,17152
ͬ,TongKouZhen,130632105,22763,2571,15545,8992,30599,15511,6242,15967,31478,16031,31576
ׯ,LiuLiZhuangZhen,130632106,32463,3340,22201,13646,44752,22198,9473,23064,45262,23075,45276
,AnZhouZhen,130632107,26158,2447,17760,11003,35609,17711,8014,18817,36528,18859,36619
Ϻͷ,LaoHeTouZhen,130632108,29465,2761,20012,11089,39439,19985,9034,21194,41179,21248,41260
Ȧͷ,QuanTouXiang,130632200,12612,1738,9595,6687,18056,9594,4171,8915,18509,8926,18521
կ,ZhaiLiXiang,130632201,23047,2672,15469,9525,31158,15390,6029,16127,31517,16279,31748
«ׯ,LuZhuangXiang,130632202,14630,1473,9746,5451,18868,9601,3822,9977,19578,10179,19925
,YiZhouZhen,130633100,73458,5600,47329,25324,81643,43996,15052,43193,87189,46781,94110
ׯ,LiangGeZhuangZhen,130633101,20511,2364,13886,7724,26861,13859,4835,13784,27643,13824,27710
,XiLingZhen,130633102,10975,1448,7499,4299,14419,7499,2630,7552,15051,7554,15053
ɽ,PeiShanZhen,130633103,25197,2627,16570,9092,33089,16547,5976,17210,33757,17230,33800
,TangHuZhen,130633104,30557,3521,20018,11565,40509,19983,7057,21087,41070,21117,41135
ɽ,LangYaShanZhen,130633105,12108,1683,7979,4691,16135,7842,2810,8448,16290,8622,16601
,LiangGangZhen,130633106,8988,1255,6183,3449,12299,6165,2511,6507,12672,6571,12754
Ͼ,ZiJingGuanZhen,130633107,15033,2257,9788,6263,19790,9320,3522,10287,19607,11024,20812
ͷ,QiaoTouXiang,130633200,20332,2115,13417,6933,25184,13031,4360,13121,26152,13390,26807
,BaiMaXiang,130633201,10527,1321,7150,4027,13845,7132,2774,7432,14564,7472,14622
,LiuJingXiang,130633202,12132,1446,8018,4595,16069,8017,2895,8452,16469,8455,16473
ߴ,GaoCunXiang,130633203,27220,2747,17554,9659,34823,17519,6103,18271,35790,18516,36070
İ,GaoMoXiang,130633204,34363,3779,22549,11687,44630,22544,6817,22405,44949,22410,44959
,DaLongHuaXiang,130633205,8036,1088,5633,3443,11033,5607,2194,5680,11287,5685,11318
ׯ,AnGeZhuangXiang,130633206,7609,1017,5047,2821,10250,4940,1738,5108,10048,5317,10364
Ʋ,LingYunCeXiang,130633207,22071,2423,14640,7818,28926,14639,4806,14658,29297,14660,29300
ɽ,XiShanBeiXiang,130633208,15466,1810,10576,5844,21034,10490,4306,10922,21412,11006,21582
ξ,WeiDouXiang,130633209,10396,1297,6941,4201,13632,6912,2342,7052,13964,7094,14035
,DuLeXiang,130633210,7533,932,4837,2799,9963,4837,1618,5246,10083,5246,10083
,QiYuXiang,130633211,1879,349,1226,798,2495,1219,443,1381,2600,1445,2671
,FuGangXiang,130633212,3834,642,2647,1646,5329,2643,1015,2810,5453,2844,5491
²,PoCangXiang,130633213,3968,608,2684,1671,5273,2672,983,2859,5531,2875,5559
ţ,NiuGangXiang,130633214,3883,641,2624,1564,5432,2624,927,2827,5451,2827,5451
żҺ,QiaoJiaHeXiang,130633215,2858,466,1847,1382,3785,1847,710,2143,3990,2187,4034
ʺӾ,GanHeJingXiang,130633216,1113,234,669,577,1264,622,177,707,1329,855,1524
̼,CaiJiaYuXiang,130633217,1881,325,1187,837,2516,1187,358,1377,2564,1377,2564
ϳ˾,NanChengSiXiang,130633218,9264,1378,6155,3959,12302,6147,2040,6486,12633,6527,12682
,HengZhouZhen,130634100,59261,5014,40839,20208,71679,37712,17558,37269,74981,40994,81833
ɽ,LingShanZhen,130634101,48703,4216,33860,17406,67790,33640,16391,35018,68658,35450,69310
,YanZhaoZhen,130634102,31443,2618,22362,12144,43950,22357,10218,21914,44271,21917,44279
ƽ,YangPingZhen,130634103,29282,2613,20718,10614,41224,20715,10196,21371,42086,21373,42091
ĵ,WenDeXiang,130634104,31209,2904,22227,11446,43256,22216,10119,21991,44207,22005,44232
·ׯ,LuZhuangZiXiang,130634200,15319,1176,10333,4420,17785,8864,3638,9000,17864,9800,20133
º,XiaHeXiang,130634201,21738,2264,16091,8113,31224,16091,7526,15437,31528,15437,31528
ׯ,ZhuangKeXiang,130634202,8686,743,6053,3079,12151,6053,2848,6221,12274,6224,12277
ТĹ,XiaoMuXiang,130634203,18383,1861,12953,7409,25595,12948,6200,13486,26434,13491,26444
,DongWangXiang,130634205,25699,2445,18199,9893,35646,18089,8461,18240,36329,18406,36605
,XiaoLinXiang,130634206,27068,2397,18826,10064,37480,18825,8670,19308,38133,19309,38135
ۡ,DiCunXiang,130634207,17784,1542,12241,7047,24748,12240,5470,12555,24795,12555,24796
,ChanDeXiang,130634208,24163,2254,16317,9375,32644,16316,7180,17276,33592,17280,33597
,QiCunXiang,130634209,10035,1130,7496,4093,14445,7493,3607,7273,14766,7276,14772
,DangChengXiang,130634210,15994,1401,11197,6607,22738,11188,5842,12032,23220,12040,23237
ɼׯ,LangJiaZhuangXiang,130634211,16637,1640,11814,6252,23254,11763,5839,12179,23942,12302,24116
ׯ,FanJiaZhuangXiang,130634212,6465,582,4407,2258,8861,4405,2053,4685,9090,4693,9100
̨,BeiTaiXiang,130634213,8225,732,5871,3142,11828,5871,3117,6202,12073,6203,12074
,LiWuZhen,130635100,80364,8084,52969,26480,97228,50297,17677,50108,100405,53156,106125
ʷ,LiuShiZhen,130635101,38633,4109,26083,12507,50123,26032,11409,27964,53996,28068,54151
ٳ,DaBaiChiZhen,130635102,40068,4386,26960,14328,52435,26892,11333,28797,55689,28827,55787
,XinXingZhen,130635103,35884,4065,23966,13185,47530,23906,9212,25138,49044,25195,49161
,BeiGuoDanZhen,130635104,14687,1541,9625,5517,18323,9590,3701,10233,19823,10304,19929
,WanAnZhen,130635105,21124,2223,13780,7451,27305,13774,4749,14295,28069,14316,28096
ɣ԰,SangYuanZhen,130635106,19307,2135,12900,6832,25890,12841,5241,13669,26510,13783,26683
ׯ,NanZhuangZhen,130635107,25940,3464,17551,10338,34837,17544,6489,18330,35874,18342,35893
С,XiaoChenXiang,130635200,16241,1927,11100,6054,21913,11100,4533,11601,22701,11601,22701
ֱ,LinBaoXiang,130635201,14262,1678,9516,5202,18531,9516,3631,10055,19571,10055,19571
ͷ,BeiNianTouXiang,130635202,16700,2205,11202,6939,22002,11202,4023,11721,22923,11726,22928
,BaoXuXiang,130635203,29100,3525,19045,9389,37922,18995,7525,20107,39102,21105,40150
,DaQuDiXiang,130635204,17323,2115,11863,5970,22447,11862,4959,12532,24394,12534,24397
,PuYangZhen,130636100,53354,5461,35365,19533,67021,33945,11490,33844,67789,34940,70305
,GaoYuPuZhen,130636101,37743,4051,25575,12900,50224,25474,9629,25749,51223,25848,51423
ɽ,YaoShanZhen,130636102,25783,2736,17287,9352,33807,17262,6534,17739,35001,17766,35053
,PuShangZhen,130636103,22154,2654,14967,8350,29601,14939,5326,15080,30019,15167,30134
,BaiYunXiang,130636201,21274,2456,13868,8056,27785,13844,4514,14338,28182,14376,28244
ӿ,HeKouXiang,130636202,11968,1418,8177,4702,16470,8177,3288,8497,16674,8497,16674
,AnYangXiang,130636203,12209,1665,8206,5185,16876,8206,3233,8901,17107,8901,17107
̨,TaiYuXiang,130636204,12111,1424,8191,4576,16700,8191,3419,8761,16952,8763,16954
,DaBeiXiang,130636205,13497,1794,9146,5365,18661,9146,3642,9785,18931,9787,18933
,ShenNanXiang,130636206,7802,1053,5278,3213,10862,5278,2082,5659,10937,5659,10937
Ұ,BoYeZhen,130637100,44365,4735,29663,16400,55202,28550,10728,29310,57860,30165,59828
С,XiaoDianZhen,130637101,22271,2549,15240,8000,29893,15240,5876,15452,30692,15456,30696
ί,ChengWeiZhen,130637102,28635,4172,19720,11929,38914,19719,7304,20387,40106,20391,40111
,DongXuXiang,130637200,17514,1985,11954,6832,23219,11954,4547,12092,24046,12092,24046
,BeiYangCunXiang,130637201,19021,2023,12854,6910,25407,12854,4780,12970,25824,12970,25824
Ƕ,ChengDongXiang,130637202,21748,2492,14381,8611,29028,14381,5057,14916,29297,14916,29297
С,NanXiaoWangXiang,130637203,25917,3202,17746,9625,35086,17746,6583,17956,35702,17956,35702
,XiongZhouZhen,130638100,74148,6703,48868,26747,92226,48134,18842,49735,97869,50825,99693
ø,ZanGangZhen,130638101,23392,2455,15643,8231,30701,15562,5824,15911,31473,16028,31671
Ӫ,DaYingZhen,130638102,26896,3106,17869,9857,35921,17819,6658,18775,36594,18791,36660
,LongWanZhen,130638103,35599,3531,24557,13063,48745,24364,10819,24959,49323,25392,49949
ׯ,ZhuGeZhuangZhen,130638104,25195,2787,16593,8670,33742,16557,6183,17502,34059,17572,34165
׼,MiJiaWuZhen,130638105,26641,3084,17673,9302,35226,17568,6230,18200,35768,18282,35955
ɳ,BeiShaKouXiang,130638200,15622,1930,10586,5446,20707,10583,3819,10773,21356,10785,21371
˫,ShuangTangXiang,130638203,14978,1817,10275,5700,20528,10275,4157,10677,20952,10677,20952
Ÿ,ZhangGangXiang,130638204,20624,2321,14152,7937,28442,14129,6145,14915,29044,14938,29090
˫ֵ´,ShuangTaJieDaoBanShiChu,130681001,48607,5226,32240,18913,45822,28799,8506,27380,56179,30099,62339
԰ֵ´,TaoYuanJieDaoBanShiChu,130681002,34160,4504,22658,14941,31413,22339,6459,21845,44184,22465,45123
½ֵ´,QingLiangSiJieDaoBanShiChu,130681003,50754,5076,33679,21767,46683,33451,10724,32093,65544,32875,66554
ֵ,SongLinDianZhen,130681100,41917,4899,27394,15432,42912,25762,7651,25589,51351,27073,54467
ͷ,MaTouZhen,130681101,26401,2771,16950,9505,32943,16861,5109,17155,34016,17331,34281
Ƿ,DongChengFangZhen,130681102,32817,3188,21073,10974,36642,18901,6059,19557,38458,20991,42064
߹ׯ,GaoGuanZhuangZhen,130681103,19296,2413,12500,7195,23883,12295,3680,12599,24894,12889,25389
,DongXianPoZhen,130681104,24469,2357,15249,8514,28605,14990,4584,15482,30472,16161,31410
ٳ߸,BaiChiGanZhen,130681105,31473,3318,19966,11728,38741,19891,5957,20565,40456,20782,40748
ׯ,YiHeZhuangXiang,130681202,26238,3205,16635,9464,32612,16572,4916,17553,34125,17724,34359
ּ,LinJiaTunXiang,130681203,25464,2824,16367,9027,31883,16352,4907,16754,33106,16828,33195
ׯ,SunZhuangXiang,130681204,12923,1435,7983,4974,15785,7909,2224,8354,16263,8599,16582
ׯ,DouZhuangXiang,130681205,26491,2922,16941,9173,33412,16877,5547,17877,34754,18019,34960
,DiaoWoXiang,130681206,26422,2689,16421,9288,30841,15863,5193,16583,32446,17883,34304
ίԱ,KaiFaQuGuanLiWeiYuanHui,130681400,37526,3044,24354,15134,22732,22401,7190,21271,43672,23406,47760
ϳֵ´,NanChengQuJieDaoBanShiChu,130682001,77559,6223,45581,24524,78780,42066,14540,42241,84307,52741,98322
ֵ´,BeiChengQuJieDaoBanShiChu,130682002,60587,5217,39666,17999,62152,32404,11581,30953,63357,37719,77385
ֵ´,XiChengQuJieDaoBanShiChu,130682003,62685,5814,41612,22918,56708,38526,13412,38084,76610,40299,81911
,LiuZaoZhen,130682100,32401,4117,21840,12275,43670,21774,7849,22467,44241,22527,44367
,QingFengDianZhen,130682101,32488,4031,22008,11571,42835,21788,7184,21615,43403,21695,43703
Ӵ,PangCunZhen,130682102,34199,3901,23221,11282,45742,23201,8482,23337,46538,23361,46582
ש·,ZhuanLuZhen,130682103,37567,3890,26981,11828,52534,26708,12240,26470,53178,26716,53697
µ,MingYueDianZhen,130682104,33742,2973,22933,11311,45113,22924,9334,23108,46032,23116,46049
̵,DingNingDianZhen,130682105,38765,4640,26938,14694,52660,26926,11089,27534,54460,27556,54494
ͤ,DongTingZhen,130682106,24942,3099,16894,8882,32782,16753,5731,16727,33480,16878,33772
ׯ,DaXinZhuangZhen,130682107,22440,2810,14921,8166,29445,14244,5133,14836,29080,15462,30383
,DongWangZhen,130682108,24219,3016,15746,8431,31690,15595,4718,16006,31601,16207,31953
,GaoPengZhen,130682109,31405,3662,21403,10744,42755,20926,8252,21331,42257,21916,43319
,XingYiZhen,130682110,24604,3057,17208,9419,33088,17022,6240,16530,33552,16693,33901
׹,LiQinGuZhen,130682111,35386,3981,23622,12281,43597,21229,8031,21545,42774,23776,47398
λ,ZiWeiZhen,130682112,30878,3621,21124,11996,41792,21099,8619,21937,43036,21994,43118
Ԫ,KaiYuanZhen,130682113,36703,3106,24465,12328,48620,24413,9729,24760,49173,25073,49538
Դ,ZhaoCunZhen,130682114,39329,3677,26287,13142,50533,25980,9934,26005,51985,26653,52940
ܴ,ZhouCunZhen,130682115,35250,3465,24528,11871,47623,24524,10376,24558,49082,24563,49091
Ϣڣ,XiZhongZhen,130682116,27299,3117,19062,9999,37476,19057,7903,19247,38304,19257,38319
,DongLiuChunXiang,130682203,21799,3025,14593,7935,28628,14577,4743,14952,29529,14974,29567
ͷׯ,HaoTouZhuangHuiZuXiang,130682204,25569,3172,17429,9719,34105,17282,6437,17595,34877,17749,35178
ׯ,YangJiaZhuangXiang,130682205,22332,2787,15098,8266,29444,15091,5307,15321,30412,15328,30426
¹ׯ,DaLuZhuangXiang,130682206,33359,3935,22035,11810,43481,22015,7261,22489,44504,22520,44555
,XiChengXiang,130682208,18303,2456,12671,7216,24564,12665,4455,12524,25189,12543,25214
ҩнֵ´,QiZhouYaoShiJieDaoBanShiChu,130683001,43349,3983,27710,16905,41982,27390,8666,27871,55261,28288,55998
,QiZhouZhen,130683100,44169,4626,28801,16132,47583,26498,7901,26050,52548,27895,56696
,WuRenQiaoZhen,130683101,22522,3070,15319,8637,30163,15318,5320,15592,30910,15593,30912
ʯ,ShiFoZhen,130683102,24032,2973,15848,9685,31217,15848,5261,16417,32265,16418,32266
֣,ZhengZhangZhen,130683103,27679,3560,18015,10457,34335,17409,4990,17666,35075,18214,36229
Ů,DaWuNvZhen,130683104,17868,2495,11977,6801,23600,11957,3616,11903,23860,12002,23979
,XiFoLuoZhen,130683105,16570,1966,10904,6782,21484,10752,3494,10995,21747,11126,22030
ٵ,MingGuanDianXiang,130683200,22143,3113,14968,8751,29391,14968,4569,14857,29825,14857,29825
¦,NanLouDiXiang,130683201,24648,3482,17100,9327,33786,17092,6232,17239,34331,17262,34362
�,XiAnGuoChengXiang,130683202,20667,2548,13835,8183,27256,13834,4394,13771,27605,13774,27609
δ,BeiDuanCunXiang,130683204,14986,1848,10454,6356,20191,10448,3577,9949,20397,9957,20411
ƽֵ´,HePingJieDaoBanShiChu,130684001,26657,2431,17417,8754,33140,17395,5433,16962,34357,17104,34521
ǽֵ´,JunChengJieDaoBanShiChu,130684002,11888,1080,6952,3712,12768,6554,2070,6447,13001,8086,15038
ʢֵ´,DongShengJieDaoBanShiChu,130684003,19795,1914,12760,6936,23106,12375,3985,12032,24407,12934,25694
ǽֵ´,BeiChengJieDaoBanShiChu,130684004,16474,1646,10657,5586,20069,10461,3230,10408,20869,10693,21350
˻·ֵ´,XingHuaLuJieDaoBanShiChu,130684005,74577,6291,48527,30261,66398,45165,14910,43628,88793,47251,95778
,FangGuanZhen,130684100,35233,4320,22777,12065,45174,22720,6537,23172,45892,23313,46090
³,XinChengZhen,130684101,33141,4220,22147,11636,43303,21923,7178,22058,43981,22392,44539
ׯ,SiZhuangZhen,130684102,26949,3158,17456,8361,33956,16812,5285,17177,33989,17936,35392
׹,BaiGouZhen,130684103,103138,4400,60407,23932,49211,48357,16736,50436,98793,63867,124274
ׯ,XinLiZhuangZhen,130684104,28934,3814,19519,10654,38527,19465,6726,19840,39305,19955,39474
Ӫ,DongMaYingZhen,130684105,23624,2405,15523,6671,26571,13806,4812,14267,28073,15318,30841
ФӪ,XiaoGuanYingXiang,130684200,20956,2704,13815,7276,27238,13811,3940,13780,27591,13785,27600
Ӫ,LiangJiaYingXiang,130684201,20282,1987,12410,6219,23639,12065,3932,11721,23786,13791,26201
ׯ,ZhangLiuZhuangXiang,130684202,26832,3252,17696,9117,34925,17681,5821,18167,35848,18209,35905
,XinQiaoXiang,130684204,27958,3570,18546,9552,36833,18405,6055,18820,37225,19037,37583
¥ֵ´,HongQiLouJieDaoBanShiChu,130702001,41289,6742,26341,20343,34707,25899,5355,25226,51125,27045,53386
ʤ·ֵ´,ShengLiBeiLuJieDaoBanShiChu,130702002,40447,5816,27042,20422,34683,26764,6496,25280,52044,25717,52759
һ·ֵ´,WuYiLuJieDaoBanShiChu,130702003,40112,5513,24744,18036,27663,23546,5427,22577,46123,26308,51052
԰ֵֽ´,HuaYuanJieJieDaoBanShiChu,130702004,20255,3272,13498,9584,17936,12649,2787,11791,24440,12816,26314
ҵ·ֵ´,GongYeLuJieDaoBanShiChu,130702005,28791,3460,16756,12136,21935,15905,3632,15547,31452,19127,35883
վֵ´,NanZhanJieDaoBanShiChu,130702006,30147,1720,16861,6817,9820,8802,2218,8540,17342,17224,34085
·ֵ´,MaLuDongJieDaoBanShiChu,130702007,16136,1276,8574,4572,5699,5747,1547,5713,11460,10385,18959
ѻׯ,LaoYaZhuangZhen,130702100,34649,2998,22496,16734,22153,22340,7729,22543,44883,22880,45376
Ҧׯ,YaoJiaZhuangZhen,130702101,16383,1502,10265,7347,12568,10154,3673,10614,20768,11293,21558
»ֵֽ´,XinHuaJieJieDaoBanShiChu,130703001,32159,3740,20453,15513,16190,20117,5183,19719,39836,20629,41082
Žֵ´,DaJingMenJieDaoBanShiChu,130703002,17733,1919,12261,6364,10240,8125,1946,8151,16276,9337,21598
±ֵֽ´,MingDeBeiJieJieDaoBanShiChu,130703003,29445,3927,18583,10888,21710,14895,3816,14154,29049,18605,37188
Ͻֵֽ´,MingDeNanJieJieDaoBanShiChu,130703004,30365,4940,20359,14294,20404,18967,4029,18063,37030,18975,39334
ֵ´,BuZiLiJieDaoBanShiChu,130703005,10818,1685,7036,5809,5907,6967,1538,6891,13858,7005,14041
Ӫֵ´,NanYingFangJieDaoBanShiChu,130703006,31494,4179,20090,14570,20622,18608,4179,18084,36692,19762,39852
´ֵ´,GongRenXinCunJieDaoBanShiChu,130703007,20424,2393,13226,9757,15024,13135,3410,12836,25971,13001,26227
Ҥ,DongYaoZiZhen,130703100,19989,1867,12949,9597,11831,12839,4384,13117,25956,13291,26240
,ShenJiaTunZhen,130703101,32603,2827,20659,13252,22621,19019,6908,19680,38699,21679,42338
̩½ֵ´,TianTaiSiJieDaoBanShiChu,130705001,32360,3728,21032,14462,21140,19222,5613,18467,37689,20669,41701
ʳǽֵ´,HuangChengJieDaoBanShiChu,130705002,22356,2817,15099,10691,13688,13783,3783,13041,26824,13857,28956
Ϲؽֵ´,NanGuanJieDaoBanShiChu,130705003,40920,5918,27388,21098,28263,27262,7808,27076,54338,27258,54646
ϴֵֽ´,NanDaJieJieDaoBanShiChu,130705004,30928,4514,20874,15906,24511,20661,5094,19419,40080,19662,40536
󱱽ֵֽ´,DaBeiJieJieDaoBanShiChu,130705005,29933,3116,19487,13156,19679,17464,5385,16929,34393,18947,38434
ҵֵֽ´,GongYeJieJieDaoBanShiChu,130705006,21067,3118,13447,9476,11965,12235,3974,12358,24593,14712,28159
ֵֽ´,JianGuoJieJieDaoBanShiChu,130705007,56525,5252,35737,26575,43375,35460,10324,35683,71143,36364,72101
Ӽұ,PangJiaBaoZhen,130705100,14938,3320,9701,7959,18776,9004,2653,9637,18641,11210,20911
,HeZiXiXiang,130705200,14889,1559,9520,7071,13888,9440,3358,9831,19271,10286,19806
,ChunGuangXiang,130705201,8996,965,5819,4267,6674,5804,1791,5891,11695,5933,11752
,HouJiaMiaoXiang,130705202,10346,1162,6574,5049,9423,6553,2059,6871,13424,6993,13567
ֵ´,ChengZhenJieDaoBanShiChu,130706001,22024,3157,14124,11192,22283,13960,3355,13657,27617,14412,28536
úֵ´,MeiKuangJieDaoBanShiChu,130706002,6982,1532,4670,3910,8159,4654,886,4604,9258,4730,9400
԰,HuaYuanXiang,130706200,8793,1161,5685,4316,9959,5556,1651,5682,11238,5920,11605
ׯ,XinZhuangZiXiang,130706201,3194,586,1786,1507,3336,1692,459,1909,3601,2453,4239
ˮ,DingFangShuiXiang,130706202,5343,987,3419,2631,6777,3416,867,3743,7159,3778,7197
μұ,DuanJiaBaoXiang,130706203,1309,278,792,697,1650,792,200,933,1725,995,1787
,YangHeNanZhen,130721100,28040,2694,18681,13218,23214,18556,8188,20012,38568,20241,38922
,ShenJingZhen,130721101,15035,3694,10122,8089,20920,10085,2920,11390,21475,11527,21649
ƴ,GuoCunZhen,130721102,10984,2202,7208,5727,14656,7201,2211,8180,15381,8189,15397
ɳ,ShaLingZiZhen,130721103,26066,2261,17122,9261,21593,13090,4633,13680,26770,15838,32960
Ҧҷ,YaoJiaFangZhen,130721104,15923,2074,10621,7988,18652,10584,3729,11075,21659,11105,21726
ָ,DaCangGaiZhen,130721105,15913,2058,9823,7104,18512,9778,3105,10727,20505,11253,21076
ּӪ,JiaJiaYingZhen,130721106,15180,2198,9895,7191,19008,9891,3069,10525,20416,10552,20447
˼Ӫ,GuJiaYingZhen,130721107,11446,1257,7317,4505,11724,6384,2228,6740,13124,7614,14931
Դ,ZhaoChuanZhen,130721108,21938,3156,14492,10605,26889,14364,5125,15498,29862,15727,30219
,WangJiaWanXiang,130721200,2137,797,1392,1383,3061,1379,217,1685,3064,1759,3151
,TaErCunXiang,130721201,5036,1171,3275,2774,6718,3264,841,3747,7011,3773,7048
,JiangJiaTunXiang,130721202,16650,2395,11176,7886,20605,11036,4439,12026,23062,12308,23484
ɽ,DongWangShanXiang,130721203,10822,1837,7026,5462,13459,7022,2121,7747,14769,7754,14780
ұ,LiJiaBaoXiang,130721204,5564,1050,3654,2992,7132,3643,1102,4034,7677,4062,7716
ű,ZhangBeiZhen,130722100,96923,7311,64406,42087,52434,59190,25104,58235,117425,64932,129338
,GongHuiZhen,130722101,5504,1342,3932,2931,7501,3915,1077,3946,7861,3991,7923
̨,ErTaiZhen,130722102,13568,2170,9133,6415,17142,9112,2935,9523,18635,9540,18673
,DaHuLunZhen,130722103,8231,1563,5534,3932,10444,5491,1520,5684,11175,5780,11314
̨·,TaiLuGouXiang,130722200,5155,1131,3457,2718,6967,3446,896,3619,7065,3725,7182
¨,YouLouGouXiang,130722201,8977,2004,6089,4635,11753,6024,1666,6190,12214,6558,12647
ͷӪ,ManTouYingXiang,130722202,6515,1389,4384,3203,8564,4349,1082,4506,8855,4602,8986
Ȫ,ErQuanJingXiang,130722203,8052,1808,5590,4526,11073,5588,1671,5938,11526,5941,11531
,DanJingHeXiang,130722204,5688,1285,3811,3058,7785,3680,971,3824,7504,4133,7944
,DaHeXiang,130722205,8572,1606,5678,4309,11547,5665,1562,6007,11672,6062,11740
ͼ,HaiLiuTuXiang,130722206,8310,1824,5677,3870,11540,5636,1636,5974,11610,6093,11770
澮,LiangMianJingXiang,130722207,7251,1586,4961,3507,10039,4857,1348,5022,9879,5224,10185
,DaXiWanXiang,130722208,5110,1280,3492,2282,7004,3433,886,3593,7026,3784,7276
¼Ӫ,HaoJiaYingXiang,130722209,6483,1231,4383,2918,8516,4364,1242,4459,8823,4573,8956
̲,BaiMiaoTanXiang,130722210,5522,1048,3707,2466,7202,3674,988,3777,7451,3851,7558
С̨,XiaoErTaiXiang,130722211,5461,1328,3893,3067,7521,3892,1069,3945,7837,3965,7858
ս,ZhanHaiXiang,130722212,5733,845,3684,2513,7322,3649,1050,3858,7507,3944,7628
,SanHaoXiang,130722213,7267,1097,4822,3441,9374,4675,1526,4830,9505,5068,9890
ɳ,ShaGouXiang,130722214,4132,595,2839,2197,4853,2803,972,2782,5585,2860,5699
Ӫ,YuZhouYingXiang,130722215,3225,513,2203,1642,4169,2200,700,2234,4434,2235,4438
챱,ChaBei,130722500,7472,994,4985,4320,6157,4898,1667,4954,9852,5148,10133
,KangBaoZhen,130723100,47312,5061,32388,22734,43589,31550,11406,30645,62195,31391,63779
ż,ZhangJiZhen,130723101,10742,1804,7127,4653,13673,7097,2188,7382,14479,7607,14734
,TuChengZiZhen,130723102,8224,1483,5502,3650,10438,5493,1531,5683,11176,5736,11238
ͷ,DengYouFangZhen,130723103,7060,1445,4854,3199,9318,4822,1379,4980,9802,5030,9884
ҵ,LiJiaDiZhen,130723104,7542,1084,4941,3393,9948,4930,1518,5163,10093,5203,10144
,ZhaoYangHeZhen,130723105,4617,890,3072,2079,6010,3064,744,3156,6220,3179,6251
Ϳ,TunKenZhen,130723106,11150,1582,7177,4953,14396,7174,2004,7543,14717,7559,14736
ͷ,YanYouFangXiang,130723200,8785,1274,5722,3569,11461,5694,1765,6016,11710,6102,11824
,DanQingHeXiang,130723201,5943,1187,4000,2985,7870,3986,1041,4138,8124,4171,8171
,HaBieGaXiang,130723202,6085,1058,3977,2799,8034,3962,1120,4258,8220,4286,8263
Ų,ErHaoBuXiang,130723203,8487,1537,5756,3756,11405,5741,1674,5824,11565,5942,11698
«Ӫ,LuJiaYingXiang,130723204,6243,917,3999,2674,8095,3990,1131,4266,8256,4292,8291
,ZhongYiXiang,130723205,4561,824,3041,1981,5955,3032,861,3178,6210,3205,6246
,ChuZhangDiXiang,130723206,7270,1081,4851,3390,9647,4849,1457,4913,9762,4957,9808
,ManDeTangXiang,130723207,6944,1008,4452,2917,8865,4440,1276,4744,9184,4776,9228
,KangBaoMuChang,130723500,464,48,255,242,471,255,55,303,558,312,567
Ϳֳ,TunKenLinChang,130723501,97,14,50,56,73,50,2,61,111,63,113
ƽ,PingDingBaoZhen,130724100,41385,4081,26989,19653,37523,26171,9478,26175,52346,27955,54944
С,XiaoChangZhen,130724101,7582,1060,4872,3360,9579,4830,1440,5066,9896,5210,10082
Ƹ,HuangGaiNaoZhen,130724102,7516,1205,4947,3397,9787,4839,1414,5035,9874,5188,10135
,JiuLianChengZhen,130724103,10084,1616,6637,4721,13184,6637,1954,7015,13652,7017,13654
ɽ,GaoShanBaoXiang,130724200,4734,713,3009,2092,6023,3005,875,3175,6180,3313,6322
С,XiaoHeZiXiang,130724201,8180,1430,5290,3963,10777,5289,1422,5738,11027,5742,11032
,ErDaoQuXiang,130724202,6127,691,3945,2755,7663,3933,1319,4184,8117,4192,8137
Ż,DaErHaoHuiZuXiang,130724203,1949,242,1280,1016,2506,1279,433,1340,2619,1344,2624
,ShanDianHeXiang,130724204,6946,844,4480,3121,8765,4469,1365,4660,9129,4675,9155
,ChangLiangXiang,130724205,6627,919,4269,2952,8591,4265,1226,4498,8763,4503,8772
Դ,FengYuanDianXiang,130724206,5644,700,3417,2504,7070,3415,1058,3791,7206,3985,7402
Ӫ,XiXinYingXiang,130724207,8329,1194,5341,3394,10527,5312,1615,5535,10847,5797,11138
̲,LianHuaTanXiang,130724208,3568,524,2219,1714,4654,2217,643,2510,4727,2516,4735
Ҥ,BaiTuYaoXiang,130724209,7433,1136,4993,3708,9845,4987,1558,5131,10118,5134,10127
,YuShuGou,130724501,3864,410,2205,1787,2650,2080,582,2196,4276,2651,4856
ɳ,ShaLiangZi,130724502,313,75,215,190,364,215,51,221,436,224,439
С,XiaoChengZi,130724503,491,70,295,264,537,293,70,323,616,336,631
,DongDaMen,130724504,322,64,205,201,340,205,48,229,434,229,434
Ϻǵ,NanHaoQianZhen,130725100,39748,4121,27008,19956,30427,26251,10202,26367,52618,27063,54071
๵,DaQingGouZhen,130725101,11106,1677,7720,5497,12953,7695,2643,7593,15288,7706,15426
˵,BaDaoGouZhen,130725102,6722,1236,4627,3328,9045,4512,1357,4519,9031,4688,9315
,HongTuLiangZhen,130725103,6176,1225,4192,3301,7616,4126,1126,4245,8371,4335,8527
С⹵,XiaoSuanGouZhen,130725104,6058,1240,3971,3012,7677,3899,1160,3960,7859,4487,8458
,SanGongDiZhen,130725105,4431,800,3063,2373,5914,3058,882,3038,6096,3050,6113
,ManJingZhen,130725106,5671,1110,3812,2996,7633,3722,968,3822,7544,3937,7749
Ӫ,DaYingPanXiang,130725200,6332,1110,4212,2780,8485,4202,1180,4386,8588,4410,8622
ռ,DaSuJiXiang,130725201,6113,934,4133,3037,8094,4129,1279,4172,8301,4193,8326
ʯ,ShiJingXiang,130725202,4913,1119,3338,2627,6671,3320,882,3406,6726,3576,6914
߼,QiJiaXiang,130725205,3753,595,2536,1952,4954,2529,765,2543,5072,2577,5113
ׯ,TaoLiZhuangXiang,130725206,3431,818,2396,2008,4769,2273,602,2348,4621,2455,4851
ʯ,JiaShiHeXiang,130725207,3920,754,2685,1752,5412,2661,846,2789,5450,2835,5520
Ȧ,XiaMaQuanXiang,130725208,1814,489,1261,977,2509,1251,331,1322,2573,1373,2634
ε,WeiZhouZhen,130726100,73624,6343,52267,32548,62789,50693,24028,50309,101002,51728,103995
,DaiWangChengZhen,130726101,19116,2638,13163,8779,24512,13160,5528,14103,27263,14119,27282
Ӫ,XiHeYingZhen,130726102,32026,4777,22434,15153,39974,22155,9494,23608,45763,23863,46297
ׯ,JiJiaZhuangZhen,130726103,14325,2603,10153,7239,19132,10064,4251,10889,20953,11026,21179
,BaiLeZhen,130726104,10586,2115,7749,5757,14862,7727,3328,8263,15990,8280,16029
ůȪ,NuanQuanZhen,130726105,9974,1696,6925,4693,13020,6910,2861,7567,14477,7606,14531
ׯ,NanLiuZhuangZhen,130726106,18963,2225,13496,8771,20094,13478,6965,14558,28036,14657,28153
ˮȪ,BeiShuiQuanZhen,130726107,7468,1518,5292,3852,10222,5285,2081,5742,11027,5775,11067
һ,TaoHuaZhen,130726108,12960,2228,8785,6293,17954,8752,3369,9655,18407,9772,18557
,YangJuanZhen,130726109,9061,1194,6014,4158,10628,6009,2585,6520,12529,6826,12840
μׯ,SongJiaZhuangZhen,130726110,15182,2547,10147,6987,19597,10146,4257,11831,21977,11839,21986
¹,XiaGongCunXiang,130726200,12040,2081,8180,5828,16190,8172,3442,9347,17519,9383,17563
ׯ,NanYangZhuangXiang,130726202,8583,1409,6030,4034,11308,6022,2755,6693,12715,6717,12747
,BaiShuXiang,130726203,6416,1308,4137,3352,8934,4136,1698,5283,9419,5285,9422
,ChangNingXiang,130726204,5299,1120,3715,2924,7520,3685,1659,4279,7964,4363,8078
ӿȪׯ,YongQuanZhuangXiang,130726205,15792,2226,10329,6467,19030,10242,4256,11007,21249,11945,22274
ׯ,YangZhuangKeXiang,130726206,9531,1698,6586,4451,12637,6516,2809,7145,13661,7452,14038
ׯ,NanLingZhuangXiang,130726207,6046,1400,4571,3403,8475,4557,1835,4678,9235,4710,9281
¼,ChenJiaWaXiang,130726208,3826,874,2824,2162,5263,2824,1132,3000,5824,3008,5832
÷,HuangMeiXiang,130726209,5510,1104,3857,2762,7610,3831,1452,4165,7996,4209,8066
ײݴ,BaiCaoCunXiang,130726210,9418,731,4350,2623,6125,4113,1764,4374,8487,7563,11913
ݹ,CaoGouBaoXiang,130726211,6418,1074,4061,3140,8116,4048,1614,5009,9057,5045,9106
,XiChengZhen,130727100,53638,4878,37730,24711,51661,36433,16761,36867,73300,37547,75277
,DongChengZhen,130727101,11831,1937,8460,5440,15004,8459,3386,8661,17120,8694,17154
Ӫ,HuaShaoYingZhen,130727102,16870,2744,11932,8754,21655,11922,4965,12568,24490,12647,24579
,ChuaiGuTuanZhen,130727103,15327,2656,10724,7307,20195,10724,3963,11219,21943,11222,21946
,DongJingJiZhen,130727104,18569,3412,12834,9120,24790,12834,4580,13684,26518,13727,26561
Ҫׯ,YaoJiaZhuangXiang,130727200,12565,1870,8774,5352,15923,8766,3237,8830,17596,8898,17672
Ǳ,DongFangChengBaoXiang,130727201,5527,1069,3841,2466,7164,3841,1231,3964,7805,3986,7827
,JingErGouXiang,130727202,7091,1257,4772,3145,9346,4771,1571,5123,9894,5147,9919
�,SanMaFangXiang,130727203,6160,1144,4352,2919,8246,4352,1640,4592,8944,4592,8944
ǽ,GaoQiangXiang,130727204,8965,2238,6541,4638,12690,6541,2417,7072,13613,7079,13620
,DaTianWaXiang,130727205,3042,711,2078,1454,4297,2045,726,2333,4378,2401,4479
,XinBaoXiang,130727206,8477,1515,5806,3887,11434,5806,2167,6351,12157,6353,12159
Ȧ,MaQuanBaoXiang,130727207,5529,932,3826,2456,7023,3826,1416,4045,7871,4051,7877
ͼ,FuTuJiangXiang,130727208,7027,1269,4899,3207,9160,4894,1776,5167,10061,5173,10072
񹵱,ChaiGouBaoZhen,130728100,53219,6983,36552,25613,60554,35475,12826,35394,70869,36476,73028
,ZuoWeiZhen,130728101,24824,3597,16930,11024,32520,16819,6248,17512,34331,17739,34669
ͷٻ,TouBaiHuZhen,130728102,9517,1596,6678,4329,12359,6675,2319,6718,13393,6754,13432
,HuaiAnChengZhen,130728103,19155,3144,12837,8572,25188,12150,4068,12530,24680,13530,26367
ɿڱ,DuKouBaoXiang,130728200,9303,1937,6519,4364,12802,6514,2056,6767,13281,6777,13296
,DiLiuTunXiang,130728201,6320,1128,4302,2846,8313,4255,1605,4547,8802,4751,9053
層,XiWanBaoXiang,130728202,4201,930,2922,2259,5520,2919,730,2902,5821,2939,5861
ɳ,XiShaChengXiang,130728203,5502,1174,3795,2554,7413,3795,1160,4034,7829,4041,7836
̫ƽׯ,TaiPingZhuangXiang,130728204,4542,1206,3207,2593,6118,3207,878,3408,6615,3419,6626
,WangHuTunXiang,130728205,7234,1500,4833,3526,9132,4811,1411,4985,9796,5312,10145
,DiSanBaoXiang,130728206,7485,1585,5193,3567,10176,5188,1531,5380,10568,5408,10601
׼ׯ,KongJiaZhuangZhen,130729100,60118,5980,40448,27561,57563,39279,15811,39874,79153,41461,81909
ȫ,WanQuanZhen,130729101,12436,1751,8394,5582,15102,8313,3030,8701,17014,8823,17217
ϴ,XiMaLinZhen,130729102,5119,1387,3590,2877,7046,3581,926,3818,7399,3842,7432
ׯ,GuoLeiZhuangZhen,130729103,16133,2701,11227,7477,20290,11139,3889,11306,22445,11496,22723
ŷ,ShanFangBaoXiang,130729200,6781,1259,4540,2997,9064,4527,1337,4803,9330,4837,9377
,BeiXinTunXiang,130729201,3977,1076,2716,2044,5522,2653,665,2825,5478,3002,5718
ƽ,XuanPingBaoXiang,130729202,7563,1058,5050,3719,9668,5043,1721,5234,10277,5292,10342
�,GaoMiaoBaoXiang,130729203,6694,1783,4652,3387,9274,4610,1439,5138,9748,5264,9916
ɱ,JiuBaoXiang,130729204,6734,1559,4795,3324,9128,4794,1423,4911,9705,4921,9716
ұ,AnJiaBaoXiang,130729205,15185,2717,10724,7276,19970,10703,3759,10889,21592,10937,21661
ɳ,BeiShaChengXiang,130729206,10726,2204,7833,5451,14926,7833,2765,7848,15681,7862,15695
ɳ,ShaChengZhen,130730100,87839,8786,57080,39401,84455,54451,17944,54015,108466,57489,114569
,BeiXinBaoZhen,130730101,13146,1662,8473,5245,16592,8073,2539,8337,16410,8874,17347
±,XinBaoAnZhen,130730102,15528,2543,9593,8116,18982,9393,2728,10941,20334,11206,20799
԰,DongHuaYuanZhen,130730103,11429,1551,7345,4826,13898,7161,2280,7524,14685,7915,15260
,GuanTingZhen,130730104,8011,1143,5280,3820,10431,5235,1709,5486,10721,5583,10863
ɣ԰,SangYuanZhen,130730105,18981,2377,12597,8210,24970,12501,4300,12967,25468,13061,25658
,CunRuiZhen,130730106,18592,2555,12025,8296,23942,12012,4044,13121,25133,13166,25191
ľ,TuMuZhen,130730107,17667,2105,11565,7862,20060,11543,4230,12346,23889,12437,24002
ׯ,DaiHuangZhuangZhen,130730108,12338,1495,7924,4902,16014,7918,2605,8486,16404,8514,16438
,XiBaLiZhen,130730109,15897,1862,10403,6532,20581,10140,3571,10539,20679,10927,21330
С,XiaoNanXinBaoZhen,130730110,11132,1675,7228,4838,14727,7074,2327,7671,14745,7906,15134
ɽ,LangShanXiang,130730200,8804,1096,5701,3519,10970,5431,1908,5687,11118,6107,11808
,JiMingYiXiang,130730203,5874,853,3815,2776,7258,3797,1242,4067,7864,4154,7969
,DongBaLiXiang,130730205,7196,996,4695,3070,9338,4654,1519,4976,9630,5016,9711
ƹ,RuiYunGuanXiang,130730207,3503,720,2287,1651,4693,2200,650,2463,4663,2586,4873
ׯ,SunZhuangZiXiang,130730208,2966,604,1987,1477,4204,1984,729,2308,4292,2312,4299
¥,WangJiaLouHuiZuXiang,130730210,5321,834,3188,2492,6146,3108,901,3441,6549,3868,7056
¹,ZhuoLuZhen,130731100,55920,6249,34993,22291,61365,31168,10369,30982,62150,37545,72538
żұ,ZhangJiaBaoZhen,130731101,16721,2094,10824,7118,20655,10701,3371,11173,21874,11362,22186
ҹ,WuJiaGouZhen,130731102,10346,1683,6428,4414,13111,6423,2109,7267,13690,7710,14138
層,WuBaoZhen,130731103,19487,2510,12627,8242,24701,12598,4276,13559,26157,13646,26273
,BaoDaiZhen,130731104,21078,2943,13404,9060,27031,13170,4484,14911,28081,15101,28505
ɽ,FanShanZhen,130731105,15696,1982,10176,7316,20567,10138,3570,11009,21147,11072,21248
,DaBaoZhen,130731106,12573,1960,8048,5553,16768,7932,2825,9038,16970,9310,17358
Ӷ,HeDongZhen,130731107,8176,1329,4997,3571,9934,4585,1684,5146,9731,6192,11189
Сׯ,DongXiaoZhuangZhen,130731108,23211,3058,14896,9380,30164,14562,4828,15669,30231,16201,31097
ҫ,HuiYaoZhen,130731109,8044,1271,5246,3679,10801,5243,2046,6104,11347,6115,11361
,DaHeNanZhen,130731110,7341,963,4841,3156,9746,4702,1749,4971,9673,5212,10053
Ȫ,WenQuanTunZhen,130731111,10022,1245,6746,3945,13498,6730,2602,7061,13791,7123,13869
ʯ,MangShiKouZhen,130731112,6565,984,4346,2873,8748,4178,1424,4473,8651,4627,8973
ׯ,LuanZhuangXiang,130731201,13752,2090,8643,5898,18134,8613,3030,10151,18764,10229,18872
ɽ,HeiShanSiXiang,130731204,7517,1076,5001,3671,10371,4999,2025,5615,10614,5617,10618
Է,WoFoSiXiang,130731205,7434,1168,4445,3637,9190,4357,1689,5115,9472,5846,10291
лұ,XieJiaBaoXiang,130731206,3998,648,2327,1906,4618,2206,717,2402,4608,3036,5363
,ChiChengZhen,130732100,45963,4881,30852,20833,39737,28245,11213,28450,56695,31205,62057
Ҥ,TianJiaYaoZhen,130732101,11697,1916,7963,5899,16014,7961,3065,8714,16675,8715,16678
,LongGuanZhen,130732102,19294,2661,13226,9515,23463,13204,5684,14253,27457,14413,27639
,DiaoEZhen,130732103,7958,1566,5418,4291,11133,5409,2107,6112,11521,6213,11631
ʯ,DuShiKouZhen,130732104,3197,648,2104,1526,4297,2099,628,2359,4458,2369,4473
ײ,BaiCaoZhen,130732105,5016,1163,3578,2813,7097,3562,1333,3921,7483,3934,7512
,LongMenSuoZhen,130732106,6040,1317,4028,3010,8469,4025,1334,4655,8680,4663,8691
,HouChengZhen,130732107,9491,1962,6815,5005,13865,6797,2649,7258,14055,7287,14102
î,DongMaoZhen,130732108,10727,2044,7402,5007,15273,7333,2972,8137,15470,8341,15743
,PaoLiangXiang,130732200,4091,639,2573,2073,4777,2546,923,2813,5359,3080,5653
,DaHaiTuoXiang,130732201,5269,1060,3526,2749,7348,3526,1219,4020,7546,4022,7548
,ZhenNingBaoXiang,130732202,5188,1258,3460,2555,7249,3396,1072,3894,7290,4058,7518
Ӫ,MaYingXiang,130732203,3796,1089,2706,2148,5549,2684,849,2996,5680,3028,5734
,YunZhouXiang,130732204,8478,1837,5453,4620,11674,5448,1607,6413,11861,6469,11922
,SanDaoChuanXiang,130732205,3557,763,2481,1958,4917,2443,863,2605,5048,2702,5183
,DongWanKouXiang,130732206,8145,1581,5559,3601,11489,5523,2057,6053,11576,6224,11783
Ӫ,CiYingZiXiang,130732207,5236,992,3550,2657,7200,3537,1246,3903,7440,3924,7474
,YangTianXiang,130732208,4802,793,3232,2381,6714,3218,1233,3577,6795,3596,6828
ӽֵ,XiWanZiJieDaoBan,130733001,17636,1345,11557,7995,13598,11004,4364,10974,21978,11788,23345
,XiWanZiZhen,130733100,11217,1697,7446,5693,11007,7360,2620,7666,15026,8088,15534
߼Ӫ,GaoJiaYingZhen,130733101,17345,2506,11647,8485,20591,11472,3933,11809,23281,12137,23784
̨,SiTaiZuiXiang,130733200,7129,1140,3985,3002,7713,3881,1078,4248,8129,5362,9347
Ӫ,HongQiYingXiang,130733201,3586,912,2437,1811,4887,2417,619,2640,5057,2680,5117
ʯҤ,ShiYaoZiXiang,130733202,3181,814,2125,1856,4380,2106,487,2321,4427,2357,4482
ͼ,YiMaTuXiang,130733203,4078,862,2695,1935,5459,2675,628,2828,5503,2873,5568
ʯ,ShiZuiZiXiang,130733204,4476,1006,3086,2254,5987,3060,835,3135,6195,3231,6317
ʨӹ,ShiZiGouXiang,130733205,3351,666,2170,1637,4318,2153,525,2308,4461,2372,4542
Ӫ,QingSanYingXiang,130733206,2459,555,1677,1303,3341,1663,471,1776,3439,1808,3485
,BaiQiXiang,130733207,3379,689,2227,1523,4522,2227,533,2374,4601,2374,4601
ֵֽ,XiDaJieJieDao,130802001,20175,2999,13226,9675,19480,12804,2727,12349,25153,12675,25901
ͷ¥ֵ,TouDaoPaiLouJieDao,130802002,17818,2645,11646,7300,15548,10072,2636,9667,19739,11453,23099
˼ҹֵ,PanJiaGouJieDao,130802003,21280,2613,13816,9846,18940,13568,3316,13087,26655,13393,27209
л·ֵ,ZhongHuaLuJieDao,130802004,21645,2803,11369,6453,17895,8605,2260,7965,16570,15339,26708
»·ֵ,XinHuaLuJieDao,130802005,15628,2452,10373,6700,14625,9155,2364,8782,17937,10071,20444
ʯӹֵ,ShiDongZiGouJieDao,130802006,33265,4185,21456,15529,28930,20953,5316,20446,41399,21310,42766
Ŷֵ,QiaoDongJieDao,130802007,17990,2240,11339,7951,15214,11242,2490,11058,22300,11381,22720
ˮȪ,ShuiQuanGouZhen,130802100,20432,1564,12451,7891,13452,12291,3942,12662,24953,13487,25938
ʨӹ,ShiZiGouZhen,130802101,20264,1548,13828,5880,12780,8389,2303,7862,16251,10287,24115
ţȦӹ,NiuJuanZiGouZhen,130802102,42077,3101,27378,14787,30096,21759,6699,21408,43167,24499,51877
ʯ,DaShiMiaoZhen,130802103,26614,2105,16452,8987,26177,15302,5902,15450,30752,18169,34621
Ӫ,FengYingZiZhen,130802104,35551,1009,21054,4097,16922,7462,3197,7594,15056,18703,39757
˫,ShuangFengSiZhen,130802105,18809,1902,12537,7736,23838,12528,4732,12878,25406,12906,25443
ϰ,ShangBanChengZhen,130802106,26650,2842,15176,8985,32368,14765,4807,15499,30264,19123,34299
Ԫɽֵ,YuanBaoShanJieDao,130803001,27943,2580,17559,11670,22166,15889,4851,15524,31413,17815,35374
ֳǽֵ,GangChengJieDao,130803002,24442,3089,14539,11264,24696,14148,3603,14698,28846,16595,31134
˫ɽ,ShuangTaShanZhen,130803100,13851,1234,8997,5503,14970,8910,3165,9100,18010,9253,18250
к,LuanHeZhen,130803101,9212,1002,5776,3462,7875,5590,1736,5521,11111,6174,11950
,DaMiaoZhen,130803102,8192,1033,5311,3826,8874,5256,1725,5450,10706,5639,10950
ƫ,PianQiaoZiZhen,130803103,5576,600,3614,2197,7074,3608,1307,3804,7412,3869,7483
դ,ChenShanZiXiang,130803200,8744,1065,5803,3460,11600,5803,2310,6316,12119,6316,12119
,XiDiManZuXiang,130803201,14742,1344,9639,5202,18045,9054,3532,9367,18421,9979,19618
ӥӪ,YingShouYingZiZhen,130804100,22673,3323,14665,10759,24091,14407,3668,14233,28640,14999,29664
Ȧ,BeiMaQuanZiZhen,130804101,9795,1135,5808,4064,9463,5712,1589,5841,11553,6711,12519
,ShouWangFenZhen,130804102,8481,1513,5649,4413,10413,5624,1312,5578,11202,5657,11306
ׯ,WangJiaZhuangZhen,130804103,6837,1166,4381,3484,7769,4381,962,4548,8929,4584,8965
°,XiaBanChengZhen,130821100,61160,5526,39429,24725,57641,37938,13651,38248,76186,40908,80337
ɽ,JiaShanZhen,130821102,15506,1634,9455,5410,17587,8919,2793,9535,18454,10478,19933
,LiuGouZhen,130821103,20193,2377,13128,7412,24711,12093,4514,12918,25011,13956,27084
,SanGouZhen,130821104,15453,1900,9678,5553,19225,9640,3403,10618,20258,11078,20756
ͷ,TouGouZhen,130821105,17612,2113,11169,6777,22409,11120,3698,12101,23221,12254,23423
̨,GaoSiTaiZhen,130821106,9699,1203,6152,3989,11941,6126,2130,6642,12768,6880,13032
С,DongXiaoBaiQiXiang,130821200,6330,764,4020,2375,8311,4019,1478,4548,8567,4552,8572
,AnJiangXiang,130821201,10992,1355,7105,4126,14274,7105,2509,7751,14856,7751,14856
,LiuZhangZiXiang,130821202,7483,923,4863,2882,9780,4814,1692,5136,9950,5235,10098
,XinZhangZiXiang,130821203,9597,1048,5848,3460,12083,5840,1811,6569,12409,6608,12456
ϼԺ,MengJiaYuanXiang,130821204,7405,1039,4684,2858,9586,4678,1520,5201,9879,5280,9964
Ӫ,DaYingZiXiang,130821205,6593,817,3988,2493,8360,3988,1183,4605,8593,4605,8593
˼,BaJiaXiang,130821206,6536,611,4091,2553,8166,4089,1372,4417,8506,4428,8519
Ϲ,ShangGuXiang,130821207,14323,1940,8972,5369,18117,8708,2959,9400,18108,10250,19222
,ManZhangZiXiang,130821208,6276,794,3687,2317,7670,3652,1197,4262,7914,4580,8267
ʯҤ,ShiHuiYaoXiang,130821209,14539,1840,9480,5401,19335,9472,3460,10342,19814,10359,19839
,WuDaoHeXiang,130821210,5471,781,3526,2009,7257,3524,1193,3895,7419,3919,7445
�,ChaGouXiang,130821211,9849,1374,6311,3796,12791,6230,2251,6983,13213,7163,13474
,GangZiManZuXiang,130821212,5463,700,3589,2170,7122,3580,1264,3820,7400,3838,7427
,DengShangXiang,130821213,11066,1574,7284,4402,14887,7234,2605,7904,15138,7961,15245
,LiangJiaManZuXiang,130821214,7241,913,4609,2681,9216,4544,1476,4932,9476,5021,9630
,SanJiaXiang,130821215,15041,1903,9491,5560,19814,9482,3376,10776,20258,10829,20320
,CangZiXiang,130821216,7406,1005,4808,2828,9699,4804,1651,5250,10054,5254,10062
¡,XingLongZhen,130822100,58169,5594,37539,24137,63123,35495,11618,35632,71127,37842,75381
ɽ,BanBiShanZhen,130822101,16270,1564,10849,5753,20513,10836,4195,11098,21934,11180,22029
,GuaLanYuZhen,130822102,10438,968,6979,3801,13144,6835,3027,7048,13883,7454,14433
,QingSongLingZhen,130822103,9940,1335,6396,3735,12738,6269,2132,6699,12968,7011,13407
,LiuDaoHeZhen,130822104,11640,1765,7722,4581,15306,7604,2469,7968,15572,8152,15874
ƽ,PingAnBaoZhen,130822105,10463,1172,6656,4345,12465,6642,2235,7085,13727,7214,13870
Ӫ,BeiYingFangZhen,130822106,9380,1132,6031,3640,11608,6023,1891,6320,12343,6372,12403
ɽ,GuShanZiZhen,130822107,8211,741,5553,3089,10511,5545,2136,5496,11041,5535,11088
Ӫ,LanQiYingZhen,130822108,10282,1167,6922,3728,13399,6854,2699,7177,14031,7226,14148
,NanTianMenManZuXiang,130822200,5229,542,3448,1839,6551,3423,1263,3509,6932,3586,7034
,BaGuaLingManZuXiang,130822202,10795,1040,7354,3841,14032,7350,3110,7544,14894,7591,14945
,DouZiYuXiang,130822203,4705,689,3087,1841,6069,3027,869,3097,6124,3176,6263
ʯ,ShangShiDongXiang,130822204,1804,401,1166,822,2411,1158,280,1301,2459,1319,2485
ˮȪ,BeiShuiQuanXiang,130822205,8145,1101,5337,3454,10237,5308,1845,5692,11000,5754,11091
Ӫ,LiJiaYingXiang,130822206,7219,974,4585,2872,9010,4574,1493,4898,9472,5101,9686
,DaZhangZiXiang,130822207,12710,1309,8054,4559,16307,8047,2877,8813,16860,8842,16896
Ģ,MoGuYuXiang,130822208,12746,1363,8240,4850,16616,8234,3170,9015,17249,9039,17279
,SanDaoHeXiang,130822209,12303,1359,8120,4274,16228,8119,3092,8632,16751,8634,16754
,AnZiLingXiang,130822211,3822,472,2481,1416,4969,2481,900,2705,5186,2713,5194
ˮȪ,DaShuiQuanXiang,130822212,10877,1263,6914,3786,14107,6893,2330,7514,14407,7556,14470
ƽȪ,PingQuanZhen,130823100,82558,8353,55127,34744,90014,53315,19735,53147,106462,55519,110646
,HuangTuLiangZiZhen,130823101,15072,1813,10172,5322,19155,9384,3946,9631,19015,10659,20831
,YuShuLinZiZhen,130823102,20791,2595,13767,8081,28264,13744,5300,14903,28647,14919,28686
,YangShuLingZhen,130823103,21144,3074,14292,8840,28550,14217,5245,14828,29045,15171,29463
߹,QiGouZhen,130823104,17919,2357,11911,6794,24516,11905,4785,13146,25051,13150,25061
С¹,XiaoSiGouZhen,130823105,16521,2097,11086,6304,22263,11035,4087,11537,22572,11619,22705
,DangBaZhen,130823106,17530,2502,11506,6668,23683,11490,4137,12635,24125,12663,24169
,WoLongZhen,130823107,20420,2807,13665,7864,26882,13509,5155,14171,27680,14717,28382
ʮ,NanWuShiJiaZiZhen,130823108,14867,1734,9829,5178,17708,9051,3258,9296,18347,10030,19859
ʮ,BeiWuShiJiaZiZhen,130823109,8368,1107,5828,3290,11705,5824,2465,6091,11915,6112,11940
,WangTuFangXiang,130823200,3921,511,2550,1521,5249,2548,987,2821,5369,2869,5419
Ϫ,LiuXiManZuXiang,130823202,7775,968,5368,3149,10852,5355,2298,5625,10980,5673,11041
߼,QiJiaDaiManZuXiang,130823203,5460,788,3896,2391,7834,3896,1664,4015,7911,4016,7912
ƽɹ,PingFangManZuMengGuZuXiang,130823204,10792,1513,7429,4276,15003,7424,2993,7854,15278,7869,15298
éɹ,MaoLanGouManZuMengGuZuXiang,130823206,11638,1811,8048,4891,16441,8045,3307,8695,16740,8708,16756
̨ͷɽ,TaiTouShanXiang,130823207,13454,1861,9107,5702,18858,9065,3766,9896,18961,9974,19081
̨,SongShuTaiXiang,130823209,11392,1722,7668,4688,15809,7665,2840,8281,15946,8286,15954
,DaoHuGouXiang,130823210,10734,1582,7204,4328,14622,7184,2546,7599,14783,7658,14862
,GuoZhangZiManZuXiang,130823212,13202,1804,8864,5197,18621,8864,3868,10009,18873,10010,18874
·ֵ´,ZhongXingLuJieDaoBanShiChu,130824001,35962,2464,23772,13548,29999,21380,8237,20693,42073,22891,46663
ƽ,LuanPingZhen,130824100,12425,1434,8265,4632,14524,7713,2865,8010,15723,8459,16724
ɽ,ChangShanYuZhen,130824101,14342,1998,9685,5587,19307,9647,3684,10142,19789,10339,20024
,HongQiZhen,130824102,10311,1128,6868,3729,13563,6850,2724,7199,14049,7295,14163
,JinGouTunZhen,130824103,12044,1441,8045,4842,15944,8038,3217,8620,16658,8657,16702
ʲ,HuShenHaZhen,130824104,14144,1872,9432,5798,18690,9403,3479,9938,19341,10063,19495
ͿʲӪ,BaKeShenYingZhen,130824105,12078,1547,8488,5113,16464,8471,3591,8647,17118,8728,17216
Ű,ZhangBaiWanZhen,130824106,16849,1905,11074,6492,20988,10989,4237,11242,22231,11917,22991
ƽ,PingFangManZuXiang,130824200,3736,709,2640,1788,5100,2630,907,2690,5320,2712,5352
,AnChunGouMenManZuXiang,130824201,7538,1280,5145,3266,10499,5142,2005,5667,10809,5678,10823
Ӫ,FuYingZiXiang,130824204,11917,1504,7953,4568,15778,7942,3296,8678,16620,8764,16717
СӪ,XiaoYingManZuXiang,130824205,10193,987,6341,3822,11647,6225,2654,6591,12816,7493,13834
,XiGouManZuXiang,130824206,4385,628,2913,1728,5962,2905,1148,3234,6139,3248,6161
˳,DengChangManZuXiang,130824207,1457,265,965,643,1971,959,335,1074,2033,1092,2057
Ӫ,WuDaoYingZiManZuXiang,130824208,2717,497,1794,1200,3660,1788,608,1998,3786,2028,3822
Ӫ,MaYingZiManZuXiang,130824209,4736,923,3321,2229,6631,3302,1185,3459,6761,3523,6844
ҵ,FuJiaDianManZuXiang,130824210,2665,471,1957,1301,3748,1956,817,1980,3936,1996,3953
ɽ,HuoDouShanXiang,130824211,8595,1395,6112,3870,11938,6095,2420,6254,12349,6298,12410
䷿,LiangJianFangXiang,130824212,6042,865,4225,2511,8429,4225,1803,4485,8710,4485,8710
,LaoWaXiang,130824213,4110,598,2831,1653,5637,2829,1186,3056,5885,3063,5894
,DaTunManZuXiang,130824214,12872,1620,8525,5156,16898,8503,2939,8787,17290,8906,17431
¡,LongHuaZhen,130825100,63931,5806,42408,25572,62473,39757,15960,40523,80280,43289,85697
Ӫ,HanMaYingZhen,130825101,14841,1575,9897,5903,19531,9739,4297,10372,20111,10816,20713
й,ZhongGuanZhen,130825102,6781,852,4369,2686,8936,4255,1742,4766,9021,5006,9375
߼,QiJiaZhen,130825103,7846,968,5220,3363,10484,5193,1990,5549,10742,5584,10804
ͷ,TangTouGouZhen,130825104,17541,2111,11982,6951,24161,11829,5078,12531,24360,12748,24730
Ӫ,ZhangSanYingZhen,130825105,13780,1793,9726,5999,19010,9484,4170,9746,19230,10017,19743
Ӫ,TangSanYingZhen,130825106,16609,2053,11208,6333,23089,10888,4840,11792,22680,12294,23502
,LanQiZhen,130825107,10497,1627,7192,4493,14735,6946,3037,7460,14406,7969,15161
Ź,BuGuGouZhen,130825108,9089,1379,6453,3955,12735,6335,2798,6661,12996,6813,13266
,GuoJiaTunZhen,130825109,13053,1860,8941,5467,17511,8671,3580,9157,17828,9552,18493
ĵ,HuangDiXiang,130825200,10016,1368,6857,4258,13989,6652,2838,7007,13659,7365,14222
¼Ӫ,ZhangJiYingXiang,130825201,10486,1329,6928,4147,14172,6866,2694,7413,14279,7581,14509
é,MaoJingBaXiang,130825202,6147,744,3974,2292,8111,3974,1484,4397,8371,4401,8375
Ӫ,YinJiaYingManZuXiang,130825203,5056,655,3389,2063,7064,3350,1524,3753,7103,3846,7235
ӹɹ,MiaoZiGouMengGuZuManZuXiang,130825204,4033,563,2789,1673,5751,2784,1250,3033,5817,3057,5846
ƫӪ,PianPoYingManZuXiang,130825205,7896,980,5201,3071,10821,5201,2182,5856,11057,5857,11058
ɽ,ShanWanXiang,130825206,5192,830,3527,2293,7229,3523,1382,3853,7376,3877,7404
˴Ӫɹ,BaDaYingMengGuZuXiang,130825207,6830,1164,4884,3277,9772,4707,2063,4931,9638,5173,10057
̫ƽׯ,TaiPingZhuangManZuXiang,130825208,5285,724,3698,2355,7388,3690,1473,3778,7468,3784,7482
,JiuTunManZuXiang,130825209,4179,598,2845,1825,5798,2838,1187,3116,5954,3119,5964
�ɹ,XiAChaoManZuMengGuZuXiang,130825210,5428,894,3816,2403,7764,3705,1527,3829,7534,4033,7849
׻ɹ,BaiHuGouManZuMengGuZuXiang,130825211,4094,624,2924,1797,5720,2885,1251,2964,5849,3045,5969
,JianFangXiang,130825212,4033,578,2722,1815,5553,2676,1100,2937,5613,2989,5711
ҵ,HanJiaDianXiang,130825213,7518,1125,5368,3190,10535,5313,2483,5636,10949,5758,11126
幵,WanGouMenXiang,130825214,5299,773,3808,2243,7259,3798,1667,3891,7689,3931,7739
,DaGeZhen,130826100,74407,6922,49337,28952,70098,45212,18344,44843,90055,50336,99673
̲,DaTanZhen,130826101,13862,1593,8998,5252,18034,8803,3165,9336,18139,9622,18620
ɽ,YuErShanZhen,130826102,7836,1064,5184,3617,9981,5029,1894,5329,10358,5610,10794
,TuChengZhen,130826103,10451,1668,7085,4647,13739,6902,2587,7359,14261,7621,14706
,HuangQiZhen,130826104,8239,1486,5775,3829,11588,5679,2115,5932,11611,6065,11840
ɽ,FengShanZhen,130826105,25049,3368,17444,10507,32833,16792,6795,17113,33905,17768,35212
ŵ,BoLuoNuoZhen,130826106,7211,954,4863,3004,9537,4779,1982,5016,9795,5284,10147
ɽ,HeiShanJuZhen,130826107,14153,1783,9257,5284,18475,8916,3434,9618,18534,10113,19370
,TianQiaoZhen,130826108,6112,795,4060,2455,8061,4054,1415,4207,8261,4262,8322
ʤ,WanShengYongXiang,130826200,2658,357,1718,1152,3512,1716,592,1840,3556,1889,3607
Ĳ,SiChaKouXiang,130826201,3873,502,2508,1530,5076,2442,904,2590,5032,2771,5279
ռҵ,SuJiaDianXiang,130826202,2866,474,1934,1356,3994,1927,723,2090,4017,2129,4063
⹵,WaiGouMenXiang,130826203,3828,435,2386,1536,4835,2338,812,2555,4893,2689,5075
ԭ,CaoYuanXiang,130826204,3748,364,2276,1324,4524,2270,765,2359,4629,2601,4877
ɽ,KuLongShanXiang,130826205,1705,387,1203,1016,2394,1170,374,1226,2396,1263,2466
С,XiaoBaZiXiang,130826206,2552,416,1685,1109,3454,1647,567,1800,3447,1850,3535
Ӫ,WuDaoYingXiang,130826207,5253,879,3475,2148,7034,3384,1087,3596,6980,3744,7219
Ϲɹ,NanGuanMengGuZuXiang,130826208,10693,1723,7458,4820,15102,7445,3022,7906,15351,7980,15438
ѡӪ,XuanJiangYingXiang,130826209,8027,1224,5592,3242,11251,5591,2331,5986,11577,5990,11582
Ӫ,XiGuanYingXiang,130826210,7147,1034,4916,2833,10066,4843,2083,5214,10057,5348,10264
Ӫ,WangYingXiang,130826211,3348,563,2389,1605,4673,2384,914,2413,4797,2436,4825
ͷӪ,BeiTouYingXiang,130826212,4634,700,3102,1844,6301,2980,1195,3196,6176,3427,6529
Ӫ,HuMaYingXiang,130826213,10847,1454,7272,4749,14434,7057,2906,7390,14447,7935,15207
ʯ˹,ShiRenGouXiang,130826214,10519,1593,7019,4332,14583,6827,2814,7553,14380,7907,14926
,TangHeXiang,130826215,4924,841,3218,1959,6603,3173,1056,3425,6598,3603,6821
ľդ,YangMuShanZiXiang,130826216,4807,821,3107,1843,6538,3037,1004,3450,6487,3525,6632
,KuanChengZhen,130827100,55882,3900,35056,20766,52931,33634,13896,35659,69293,38622,73678
,LongXuMenZhen,130827101,14932,1896,9777,5603,19835,9528,3654,10333,19861,10705,20482
,YuErYaZhen,130827102,20330,1865,12453,7958,24288,12278,4904,13489,25767,14646,27099
,BanChengZhen,130827103,15850,1735,10315,6152,20968,10314,3883,11151,21465,11153,21468
,TangDaoHeZhen,130827104,13807,1712,8711,5114,17975,8693,3075,9792,18485,9883,18594
K̨,BoLuoTaiZhen,130827105,5704,563,3808,2207,7107,3788,1485,3884,7672,3944,7752
,NianZiYuZhen,130827106,11013,1105,7224,4372,14767,7182,2974,7779,14961,7868,15092
Ƥ,HuaPiLiuZiXiang,130827200,6666,604,4261,2466,8500,4243,1601,4531,8774,4610,8871
ɽ,TaShanXiang,130827201,3977,398,2516,1561,5077,2514,910,2762,5276,2769,5285
,MengZiLingXiang,130827203,4886,548,3117,1918,6319,3112,1154,3463,6575,3471,6588
ʯ,DuShiGouXiang,130827204,881,118,590,364,1074,586,205,602,1188,614,1204
,DongDaDiXiang,130827206,4186,421,2683,1649,5334,2636,1118,2904,5540,3042,5725
,HuaJianXiang,130827207,5131,438,3298,2015,6777,3278,1465,3700,6978,3736,7034
ƻ,DongHuangHuaChuanXiang,130827208,4358,453,2694,1631,5526,2663,1104,2995,5658,3221,5915
̨,LiangJiaTaiXiang,130827209,5500,603,3445,2005,7209,3445,1279,3937,7382,3937,7382
έӹ,WeiZiGouXiang,130827210,5187,687,3286,1994,6853,3259,1215,3747,7006,3803,7089
ֹ,DaZiGouMenXiang,130827211,3763,458,2320,1334,4961,2319,823,2696,5015,2724,5044
ʯ,DaShiZhuZiXiang,130827212,4346,645,2896,1628,5830,2888,1011,3065,5953,3106,6002
Χ,WeiChangZhen,130828100,67368,5223,44598,27893,52453,40738,16953,40640,81378,44946,89544
ĺ,SiHeYongZhen,130828101,18436,1604,12138,6691,21352,11572,4302,11755,23327,12204,24342
չ,KeLeGouZhen,130828102,10417,1234,7144,4443,14092,7141,3089,7488,14629,7596,14740
ɽ,QiPanShanZhen,130828103,12833,1507,8754,5537,16928,8736,3524,8930,17666,9110,17864
,BanJieTaZhen,130828104,6763,831,4645,3063,9082,4641,1948,4876,9517,4897,9542
,ZhaoYangDiZhen,130828105,9663,1214,6734,4360,13187,6731,2896,7025,13756,7039,13773
,ZhaoYangWanZhen,130828106,10575,1280,7562,4659,14753,7561,3300,7584,15145,7593,15155
,DaoBaZiXiang,130828200,5289,652,3749,2476,7144,3747,1507,3695,7442,3699,7448
ͷɽ,LongTouShanXiang,130828201,6293,714,4385,2887,8190,4385,1816,4421,8806,4438,8823
վ,YaoZhanXiang,130828202,12747,1415,8854,5488,17248,8846,3726,9010,17856,9034,17888
,HuangTuKanXiang,130828203,7467,1072,5180,3447,10253,5180,1992,5347,10527,5351,10531
ĵ,SiDaoGouXiang,130828204,4303,667,3068,2022,5842,3063,1204,3093,6156,3106,6174
쿨,LanQiKaLunXiang,130828205,7017,833,4725,2958,9470,4724,1917,5039,9763,5042,9767
ѹ,YinWoGouXiang,130828206,8990,1155,6527,4049,12613,6510,2897,6494,13004,6515,13042
µ,XinDiXiang,130828207,12298,1140,8299,4748,16543,8299,3697,8836,17135,8836,17135
㷢,GuangFaYongXiang,130828208,5915,648,4111,2642,8096,4109,1745,4161,8270,4197,8308
̫,YuTaiHeXiang,130828209,4340,472,3009,1877,5779,3007,1138,2938,5945,2941,5950
,GuoJiaWanXiang,130828210,5728,829,4112,2704,8135,4111,1774,4210,8321,4219,8331
,YangJiaWanXiang,130828211,5581,778,3978,2610,7730,3978,1686,4066,8044,4067,8045
,DaHuanQiXiang,130828212,5041,544,3537,2327,6812,3537,1546,3593,7130,3594,7131
,HaLiHaXiang,130828213,5723,698,3902,2411,7568,3901,1439,3951,7852,3958,7860
²,XinBoXiang,130828214,8875,1036,6042,4007,11937,6037,2485,6335,12372,6354,12396
ż,ZhangJiaWanXiang,130828215,2898,335,1950,1278,3754,1949,798,2075,4024,2081,4031
Ԫջ,BaoYuanZhanXiang,130828216,5262,576,3622,2460,6920,3622,1500,3716,7338,3716,7338
ɽ,ShanWanZiXiang,130828217,5770,653,3994,2559,7805,3994,1732,4161,8155,4161,8155
,SanYiYongXiang,130828218,4836,607,3418,2236,6778,3415,1500,3521,6936,3525,6943
ҵ,JiangJiaDianXiang,130828219,4452,462,3032,2075,5668,3023,1274,3095,6118,3156,6188
»﷿,XiaHuoFangXiang,130828220,4226,703,3027,2147,5909,3027,1197,3094,6121,3099,6126
,YanGeBaiXiang,130828221,2792,406,1983,1395,3794,1983,773,1987,3970,1988,3971
¥,PaiLouXiang,130828222,4337,734,3200,2399,6095,3196,1319,3185,6381,3190,6390
,ChengZiXiang,130828223,5527,916,4040,3010,7738,4040,1588,3980,8020,3991,8031
,LaoWoPuXiang,130828224,1946,236,1288,898,2521,1288,495,1389,2677,1389,2677
,YuDaoKouXiang,130828225,2748,264,1777,1239,3341,1767,735,1935,3702,1970,3747
ʯ,ShiZhuoZiXiang,130828226,3021,484,2222,1475,4240,2222,932,2211,4433,2215,4437
ͷɽ,DaTouShanXiang,130828227,5553,864,4029,2738,7752,4028,1643,4027,8055,4031,8060
ɽ,NanShanZuiXiang,130828228,2330,375,1603,1116,3206,1599,631,1724,3323,1733,3336
ͷ,XiLongTouXiang,130828229,2502,388,1753,1228,3441,1753,727,1864,3617,1864,3617
ӻеֳ,SaiHanBaJiXieLinChangZhen,130828450,1116,61,628,544,944,623,179,701,1324,728,1356
Ӫ,GuoYingYuDaoKouMuChangXiang,130828500,2430,373,1521,1247,2733,1508,405,1570,3078,1687,3208
豱ֵֽ´,JianSheBeiJieJieDaoBanShiChu,130902001,33515,3509,21680,14546,30527,21230,6463,21054,42284,21807,43487
վֵ´,CheZhanJieDaoBanShiChu,130902002,8843,1333,6024,3898,9534,5875,1679,5734,11609,5831,11855
ϴְ´,NanDaJieBanShiChu,130902003,24786,2119,16149,10195,19194,16111,5228,15958,32069,15984,32133
нֵֽ´,DongHuanZhongJieJieDaoBanShiChu,130902004,35895,3306,23556,15863,29774,23505,8008,23525,47030,23653,47209
ֵ´,DaoDongJieDaoBanShiChu,130902005,30055,4084,19056,12752,31049,17468,5283,16981,34449,20366,39422
Сׯ,XiaoZhaoZhuangXiang,130902200,24570,2425,16287,10141,28156,16136,6125,16739,32875,16833,33120
,KaiFaQu,130902400,16182,1269,10386,5759,15688,9082,3664,9393,18475,10729,21115
ˮ½ֵ´,ShuiYueSiJieDaoBanShiChu,130903001,18813,2496,12540,8007,18092,11688,3268,11223,22911,12037,24577
ϻ·ֵ´,NanHuanZhongLuJieDaoBanShiChu,130903002,47789,4514,30408,18631,37984,27197,8272,26732,53929,30167,60575
Ϻֵ´,NanHuJieDaoBanShiChu,130903003,9837,1031,6526,4247,7990,6420,1882,6156,12576,6224,12750
гֵ´,ShiChangJieDaoBanShiChu,130903004,5592,536,3721,2357,3847,3538,1087,3359,6897,3494,7215
нֵֽ´,XiHuanZhongJieJieDaoBanShiChu,130903005,41570,4100,25407,16148,34733,23868,6797,23488,47356,27060,52467
԰ֵ´,GongYuanJieDaoBanShiChu,130903006,47382,3899,27611,17478,38007,25845,7768,25272,51117,31438,59049
Сׯ,XiaoWangZhuangZhen,130903100,27265,2637,18230,11402,29554,18224,6671,18330,36554,18343,36573
ϳ,NanChenTunXiang,130903200,43484,3085,30091,13420,39232,21996,8679,22387,44383,25157,55248
,JiuZhouZhen,130921100,17077,1888,11162,7123,22587,11069,4091,11767,22836,11894,23056
˼,XingJiZhen,130921101,33165,3663,21881,13434,44409,21880,8021,22958,44838,22968,44849
,DuShengZhen,130921102,30394,3138,20309,12903,39369,19978,8242,21196,41174,21465,41774
޶ׯ,CuiErZhuangZhen,130921103,40966,3977,27192,17360,55585,27169,11153,28873,56042,28904,56096
Ѧ,XueGuanTunXiang,130921200,15769,1769,10547,5461,21585,10547,4308,11297,21844,11299,21846
ݵػ,JieDiHuiZuXiang,130921201,24346,2191,15507,8055,25963,13475,5012,14133,27608,16042,31549
Ź,ZhangGuanTunXiang,130921202,33024,3448,21666,13491,43844,21604,8207,22939,44543,23013,44679
ľ,LiTianMuHuiZuXiang,130921203,26011,2877,17550,11079,35395,17547,7574,18894,36441,18912,36462
绯,FengHuaDianXiang,130921204,29521,3344,19660,11313,39667,19650,7485,20675,40325,20690,40350
Ҧ,YaoGuanTunXiang,130921205,24588,2635,16428,10325,33164,16405,6572,17319,33724,17367,33795
ֻ,DuLinHuiZuXiang,130921206,32931,3604,21919,13949,44290,21893,8411,23001,44894,23027,44946
,WangJiaPuXiang,130921207,24561,2905,16331,10754,32469,16322,6083,17173,33495,17218,33549
,LiuJiaMiaoXiang,130921208,19504,2284,12862,7558,26197,12718,4787,13436,26154,13713,26575
,WuLongTangXiang,130921209,20739,2566,14018,8877,27804,13973,5499,14726,28699,14786,28804
,DaGuanTingXiang,130921210,28064,3206,19109,12133,37980,19109,7900,20059,39168,20061,39170
ߴ,GaoChuanXiang,130921211,23002,2280,15444,9593,30333,15444,6497,16333,31777,16335,31779
Ƶ,HuangDiPuXiang,130921212,17738,2056,11784,7787,23779,11767,4682,12567,24334,12692,24476
Ҵ,DaChuCunHuiZuXiang,130921213,18680,1916,12541,7786,24779,12226,5162,12934,25160,13217,25758
ֽͷ,ZhiFangTouXiang,130921214,28773,3100,19311,11207,37812,19115,7633,19745,38860,20195,39506
,QingZhouZhen,130922100,85156,8155,55616,35393,92673,53140,17987,53566,106706,55682,111298
ţ,JinNiuZhen,130922101,30669,3684,20389,12834,40427,20373,7905,21807,42180,21869,42258
,XinXingZhen,130922102,27341,3387,18043,10976,35126,18002,6012,18623,36625,18697,36740
,LiuHeZhen,130922103,24826,3047,16255,11507,31794,16236,5901,17462,33698,17519,33774
ľŵ,MuMenDianZhen,130922104,21444,2700,14237,8440,27478,14237,4853,14760,28997,14760,28997
�,MaChangZhen,130922105,30228,3500,19863,13162,37148,19782,7165,20801,40583,21030,40893
,ShangWuXiang,130922200,14691,1779,9797,5531,19177,9728,3489,10087,19815,10162,19959
,CaoSiXiang,130922201,29223,3650,19427,12543,38046,19417,6908,20336,39753,20354,39781
̹,PanGuXiang,130922202,20717,2564,13486,8489,26713,13484,4318,14110,27594,14113,27599
¾,ChenJuXiang,130922203,12544,1506,8162,5107,15881,8162,2705,8593,16755,8593,16755
ũ,NongChang,130922400,2973,462,1942,1297,3528,1903,648,1986,3889,2141,4083
,DongGuangZhen,130923100,57336,5232,37420,23292,62250,35721,12431,36027,71748,37579,74999
,LianZhenZhen,130923101,31819,3487,20588,12636,40073,20005,6329,20594,40599,21047,41635
,ZhaoWangZhen,130923102,19803,2227,12904,8217,25906,12904,4061,13187,26091,13187,26091
ش,QinCunZhen,130923103,21151,2697,14175,8611,28293,14173,4532,14183,28356,14205,28380
,DengMingSiZhen,130923104,22979,2904,15025,9236,30666,14873,4927,15582,30455,15785,30810
ϼ,NanXiaKouZhen,130923105,28118,3162,18199,11713,36448,18194,5663,18706,36900,18744,36943
,DaDanZhen,130923106,33106,3903,21812,12682,44477,21787,7753,22888,44675,22950,44762
,LongWangLiXiang,130923200,28332,3384,18840,11546,38031,18833,6533,19399,38232,19409,38249
,YuQiaoXiang,130923201,25927,3040,16901,10682,34407,16883,5666,17681,34564,17732,34633
ջ,SuJiZhen,130924100,35782,3489,24231,14531,41497,23569,10372,24530,48099,25412,49643
,XinJiZhen,130924101,15209,1763,10330,6290,20043,10243,4115,10629,20872,10757,21087
,GaoWanZhen,130924102,17149,2643,12127,7527,23283,12121,5036,12695,24816,12701,24828
ë,ZhaoMaoTaoXiang,130924200,22420,3149,15790,9254,31058,15787,6923,16691,32478,16702,32492
㷻,XiangFangXiang,130924201,12294,1655,8620,5549,16549,8618,3613,8941,17559,8942,17562
Сɽ,XiaoShanXiang,130924202,17095,2186,11796,7230,23209,11796,5200,12685,24481,12685,24481
Żͤ,ZhangHuiTingXiang,130924203,19126,2840,13356,8345,26034,13356,5123,13732,27088,13733,27089
ũ,HaiXingXianNongChang,130924400,1604,156,1033,630,2158,1032,424,1146,2178,1151,2184
ũ,QingXianNongChang,130924401,862,45,472,265,905,463,192,451,914,627,1099
ũ,QingFengNongChang,130924402,820,35,524,365,893,524,218,549,1073,549,1073
ɽ,YanShanZhen,130925100,74641,5802,46368,24692,81691,41031,16912,43415,84446,50987,97355
,WangShuZhen,130925101,19337,2132,12789,7000,26240,12789,5089,13767,26556,13769,26558
,QingYunZhen,130925102,29193,3549,19478,10715,39617,18778,7375,19612,38390,20639,40117
,HanJiZhen,130925103,27441,3097,17981,9023,36914,17910,6601,19080,36990,19158,37139
ǧͯ,QianTongZhen,130925104,15911,1909,11146,5728,22188,10858,4671,11036,21894,11345,22491
ʥ,ShengFoZhen,130925105,30245,3543,20403,10990,42061,20080,8371,21242,41322,21756,42159
,BianWuXiang,130925200,20397,2494,13864,7759,28552,13864,5766,14793,28657,14793,28657
СӪ,XiaoYingXiang,130925201,18434,1972,12357,6785,25223,12252,4992,12931,25183,13041,25398
,YangJiXiang,130925202,19793,2333,13579,7801,27589,13407,5645,13963,27370,14192,27771
ϵ,MengDianXiang,130925203,28748,3492,19110,10125,39431,18798,7299,19968,38766,20429,39539
ׯ,ChangZhuangXiang,130925204,14179,1649,9377,4794,19371,9079,3547,9609,18688,9998,19375
Сׯ,XiaoZhuangXiang,130925205,22078,2736,14537,8278,30156,14398,5439,15471,29869,15716,30253
,SuNingZhen,130926100,50677,4716,31509,16644,48590,28083,9921,28090,56173,33805,65314
Ҵ,LiangJiaCunZhen,130926101,35395,4630,23617,12782,45740,23571,8232,24594,48165,24640,48257
ѱ,WoBeiZhen,130926102,24107,3309,16127,9218,30247,16117,5215,16480,32597,16504,32631
д,ShangCunZhen,130926103,25313,3196,16610,9465,30237,16523,5759,17247,33770,17658,34268
,WanLiZhen,130926104,25354,3165,16669,9263,32496,16642,5643,17366,34008,17493,34162
ʦ,ShiSuXiang,130926201,27063,3632,17854,10143,34087,17846,5537,18266,36112,18378,36232
ӱ,HeBeiLiuShanSiXiang,130926203,23909,3091,15995,8390,31304,15995,5887,16892,32887,16892,32887
,FuJiaZuoXiang,130926204,20351,2772,13483,7993,25627,13479,4482,14103,27582,14122,27605
ׯ,ShaoZhuangXiang,130926205,17358,2256,11383,6922,22051,11382,3669,11900,23282,11900,23283
Ƥ,NanPiZhen,130927100,47387,4738,31259,20361,53538,30527,12255,32685,63212,33121,64380
ҿ,FengJiaKouZhen,130927101,29895,3338,20116,12344,39195,20111,7819,20918,41029,20936,41052
կ,ZhaiZiZhen,130927102,37753,4841,25594,13161,52353,25584,10173,27161,52745,27173,52767
,BaoGuanTunZhen,130927103,23840,3185,16058,9224,32427,16058,5899,16866,32924,16866,32924
,WangSiZhen,130927104,27249,3447,18168,10434,36700,18139,6488,18983,37122,19016,37184
Ӫ,WuMaYingZhen,130927105,18046,2300,12148,7531,24979,12143,4874,13058,25201,13072,25220
˵,DaLangDianXiang,130927200,22321,2819,15072,8847,30501,15038,5671,15692,30730,15739,30811
,LiuBaLiXiang,130927201,22979,2117,14810,8262,24174,12835,5159,13688,26523,15445,30255
º,LuGuanXiang,130927202,37057,4130,24698,14072,51299,24655,10452,26859,51514,26941,51639
ɣ԰,SangYuanZhen,130928100,43129,4098,28476,16143,50865,24735,8522,24029,48764,27273,55749
,TieChengZhen,130928101,28509,3905,19305,11393,38249,19305,6071,19180,38485,19180,38485
ڼ,YuJiZhen,130928102,20870,2496,13001,7463,26548,12054,3396,12166,24220,13761,26762
,LiangJiZhen,130928103,15612,1869,9845,6206,20051,9687,2883,9897,19584,10519,20364
,AnLingZhen,130928104,17735,2504,11729,7017,23419,11194,3399,11099,22293,11909,23638
ܼ,CaoJiaWaXiang,130928200,15530,1942,10561,6297,20430,10290,3409,10000,20290,10320,20881
,SongMenXiang,130928201,18429,2222,12294,7725,24318,11549,4029,11521,23070,12386,24680
,YangJiaSiXiang,130928202,15399,2119,10452,6524,20805,10164,3782,10325,20489,10848,21300
,GouDianPuXiang,130928203,18316,3097,12492,7769,24957,11865,3787,11599,23464,12708,25200
ׯ,HeZhuangXiang,130928204,18484,2950,12545,7733,25131,11797,3851,11759,23556,12740,25285
žü�,WuQiaoJingJiJiShuKaiFaQu,130928400,65,1,10,4,0,7,0,9,16,56,66
,LeShouZhen,130929100,66933,5707,44097,22691,74537,39278,15429,39677,78955,43972,88069
,HuaiZhenZhen,130929101,29396,2751,19792,11337,38914,19503,8554,20603,40106,20909,40701
ׯ,GuoZhuangZhen,130929102,22882,2258,15143,8374,30817,15132,6269,16057,31189,16266,31409
ӳǽ,HeChengJieZhen,130929103,30578,3281,20966,11497,39901,19809,8554,20533,40342,21447,42413
,HanCunXiang,130929200,35310,3810,23823,14597,49119,23774,10257,25495,49269,25554,49377
İ,MoNanXiang,130929201,27021,3333,18791,10171,37526,18761,7804,19327,38088,19367,38158
ׯ,ChenZhuangXiang,130929204,24113,2714,16183,8936,31660,15758,6141,16551,32309,16785,32968
߹,GaoGuanXiang,130929205,20681,2059,13471,7726,27617,13471,5266,14532,28003,14535,28006
,ShangLinXiang,130929206,17604,2284,12350,7629,24254,12340,5094,12562,24902,12632,24982
δ,DuanCunXiang,130929207,18891,2377,12978,7799,26362,12963,5256,13474,26437,13546,26524
Ŵ,ZhangCunXiang,130929209,16630,2138,11728,6620,22921,11728,4790,11829,23557,11830,23558
ٺ,LinHeXiang,130929210,17898,2594,13187,7479,25748,13160,5518,12794,25954,12823,26010
Сƽ,XiaoPingWangXiang,130929211,13125,1612,9011,4676,18444,8945,3807,9455,18400,9533,18544
ʮ弶,ShiWuJiXiang,130929212,18419,1919,12580,7093,25301,12492,5361,13030,25522,13119,25699
ͷ,LeiTouXiang,130929213,15219,1689,10510,5950,21181,10507,4616,11002,21509,11014,21524
Ϻͷ,NanHeTouXiang,130929214,15778,1932,10984,5589,21157,10947,4637,11294,22241,11363,22347
,XiChengXiang,130929215,17314,2237,11805,6544,23978,11802,4625,12368,24170,12371,24176
ի,BenZhaiXiang,130929216,10812,1184,7171,4008,14524,7170,2758,7582,14752,7583,14754
ũ,NongChang,130929400,461,53,310,172,607,310,98,302,612,302,612
ϴ,MengCunZhen,130930100,42343,4153,28015,16346,51989,26930,11565,28517,55447,30046,58061
,XinXianZhen,130930101,22167,2721,14936,8251,30670,14800,6220,15906,30706,16172,31108
,XinDianZhen,130930102,19312,2280,12839,8251,25621,12828,5298,13956,26784,14051,26890
կ,GaoZhaiZhen,130930103,16647,1809,10942,6552,22678,10837,4562,11887,22724,12076,23018
ׯ,SongZhuangZiXiang,130930200,22336,2691,15020,8246,30883,15020,6138,16145,31165,16145,31165
ţׯ,NiuJinZhuangXiang,130930201,22486,2418,15762,8770,31387,15758,7425,16547,32305,16567,32329
Žֵ´,JieFangJieDaoBanShiChu,130981001,40472,2726,25419,14801,41890,21212,7304,22643,43855,25083,50502
Ӷֵ´,HeDongJieDaoBanShiChu,130981002,29594,2463,18777,12273,25874,18773,6514,19766,38539,19794,38571
¥ֵ´,GuLouJieDaoBanShiChu,130981003,22165,1680,14001,6520,18455,10846,3508,11011,21857,13352,27353
,BoZhen,130981100,33047,2823,21946,12430,39554,21946,8193,22117,44063,22117,44063
,JiaoHeZhen,130981101,31950,3559,21397,13532,41824,21392,8038,22143,43535,22150,43547
,QiQiaoZhen,130981102,38912,3713,25369,16209,51531,25369,9951,27207,52576,27207,52576
Ŵ,SiMenCunZhen,130981103,24445,2838,16368,10051,32877,16115,6336,16719,32834,17251,33619
´,HaoCunZhen,130981104,24970,3239,17131,10879,33632,17116,6388,17442,34558,17466,34597
,FuZhenZhen,130981105,23874,2810,16684,9889,31697,16682,6687,16684,33366,16687,33371
,WenMiaoZhen,130981106,28411,2904,18840,11044,37812,18620,7766,19836,38456,20241,39081
,WaLiWangZhen,130981107,28458,2578,18554,11080,37305,18262,7224,19323,37585,19706,38260
ׯ,WangWuZhuangXiang,130981201,23393,2364,15258,9743,30456,15216,5426,15780,30996,15925,31183
Ӫ,YingZiXiang,130981202,32698,3317,21586,12595,43533,21551,8510,22855,44406,22939,44525
Ӫ,SiYingXiang,130981203,21275,2576,14596,8695,28772,14596,5539,14792,29388,14794,29390
,XiXinDianXiang,130981204,26036,2975,18414,10639,35676,18414,7710,18307,36721,18307,36721
ҵί,GongYeQuGuanWeiHui,130981400,5114,435,3405,1998,6072,3364,1400,3522,6886,3544,6949
»·ֵ´,XinHuaLuJieDaoBanShiChu,130982001,86255,6442,55485,30922,81488,51067,18930,51195,102262,56142,111627
·ֵ´,XiHuanLuJieDaoBanShiChu,130982002,22329,2135,14351,8150,21736,14269,4737,14590,28859,14850,29201
·ֵ´,YongFengLuJieDaoBanShiChu,130982003,11049,1127,7189,4437,9994,7117,2525,7400,14517,7512,14701
,ChuAnZhen,130982100,28143,3419,18248,10190,33940,17927,5979,18520,36447,19293,37541
ʯ,ShiMenQiaoZhen,130982101,33461,4176,22078,10845,41666,22025,7720,23150,45175,23279,45357
,LvGongBaoZhen,130982102,28032,3319,18366,10185,36056,18356,6875,19851,38207,19860,38226
,ChangFengZhen,130982103,33567,3766,22416,11655,44893,22415,8916,23832,46247,23833,46249
|,MaoZhouZhen,130982104,19424,2265,12511,7572,24001,12443,3820,12874,25317,12998,25509
ׯ,GouGeZhuangZhen,130982105,20461,2407,13613,8208,26157,13564,4587,13794,27358,13842,27455
,LiangZhaoZhen,130982106,30941,3552,20222,11607,39235,20146,7366,21489,41635,21637,41859
,XinZhongYiZhen,130982107,29769,3576,19441,10062,37989,19317,6736,20358,39675,20640,40081
,MaJiaWuXiang,130982202,30219,3764,19856,10931,38593,19789,7241,21197,40986,21368,41224
۱,YiLunBaoXiang,130982203,28537,3506,18828,10845,35194,18672,7085,19834,38506,20300,39128
,QingTaXiang,130982204,22926,2759,15008,8675,28087,14946,4881,15375,30321,15558,30566
ׯ,BeiXinZhuangXiang,130982205,23454,2626,15476,8953,29598,15476,5796,16400,31876,16400,31876
߼䷿,QiJianFangXiang,130982206,19526,1885,12917,6814,24645,12849,4887,13289,26138,13381,26298
,BeiHanXiang,130982207,21118,2718,13958,7611,27056,13916,4952,14689,28605,14830,28788
ڴ,YuCunXiang,130982208,29052,3309,18911,11613,37181,18906,6369,19810,38716,19819,38730
йʯȻɷ޹˾ֹ˾,ZhongGuoShiYouTianRanQiGuFenYouXianGongSiHuaBeiYouTianFenGongSi,130982400,91946,14616,61319,45527,93692,59357,14861,56707,116064,60104,121423
ίԱ,KaiFaQuGuanLiWeiYuanHui,130982500,4938,504,3317,1690,5727,3088,1174,3122,6210,3299,6616
趫ֵ´,HuaDongJieDaoBanShiChu,130983001,9142,518,5435,2044,3541,3034,1393,3185,6219,5618,11053
нֵ´,HuaZhongJieDaoBanShiChu,130983002,13306,863,9120,5083,8519,7489,3263,7813,15302,8312,17432
ֵ´,HuaXiJieDaoBanShiChu,130983003,39749,1728,23608,13627,25197,20004,9026,21401,41405,26895,50503
,HuangHuaZhen,130983100,37043,4057,24570,15800,39072,24435,10356,26635,51070,26886,51456
ź,NanPaiHeZhen,130983101,33030,3702,21111,13601,41700,20985,7599,22958,43943,23220,44331
,LvQiaoZhen,130983102,26580,3116,17603,10952,37055,17603,7813,19906,37509,19906,37509
ɳ,JiuChengZhen,130983103,24821,3480,16902,10894,34322,16900,6881,18262,35162,18280,35182
ׯ,YangErZhuangXiang,130983200,29089,4762,20028,13202,40065,20009,7696,21506,41515,21519,41547
,ChangGuoXiang,130983202,27782,3836,19062,11736,39041,19049,8463,21000,40049,21019,40081
ׯ,TengZhuangZiXiang,130983203,27163,3467,18550,11034,37997,18538,8092,20159,38697,20172,38722
ׯ,GuanZhuangXiang,130983204,20753,2653,14014,8178,28639,14007,5870,15255,29262,15262,29276
,QiJiaWuXiang,130983205,27148,3369,18345,11842,37270,18341,7742,19905,38246,19914,38259
۳ǿ´,GangChengKaiFaQuXinCunXiang,130983206,6042,546,3973,2516,6698,3960,1585,4083,8043,4200,8173
ľ,YangSanMuXiang,130983207,5663,685,3964,2305,7769,3964,1827,4198,8162,4211,8175
ϴ۲ҵ԰,BoHaiXinQuNanDaGangChanYeYuanQu,130983400,30947,4026,19767,12938,38655,19612,7307,22217,41829,22513,42280
ݲнݲҵ԰,CangZhouBoHaiXinQuZhongJieChanYeYuanQu,130983401,29683,4117,19640,12783,36387,18817,6636,19571,38388,20796,40436
ۿ,HuangHuaGangKaiFaQu,130983402,11631,92,4155,2344,3084,3015,1247,3385,6400,8815,12970
ٸۻ԰,LinGangHuaGongYuanQu,130983403,1117,5,258,0,0,0,0,0,0,864,1122
,YingZhouZhen,130984100,88231,7880,58424,32023,84226,53400,19276,53216,106616,56963,115387
׸ׯ,MiGeZhuangZhen,130984101,41387,4961,26972,13941,53675,26144,10229,27716,53860,29605,56577
,JingHeZhen,130984102,21246,2300,14461,8505,26589,13419,5792,14059,27478,14877,29338
Է,WoFoTangZhen,130984103,34851,4292,23729,12999,45934,23661,9843,25135,48796,25257,48986
,ShuChengZhen,130984104,35889,4434,24691,13010,48607,24672,11067,26677,51349,26699,51390
,LiuGuSiZhen,130984105,23603,3065,15825,8290,31494,15559,5751,16319,31878,16594,32419
ɳ,ShaHeQiaoZhen,130984106,30579,3422,20582,12543,40013,20539,8450,21701,42240,21869,42451
,GuXianXiang,130984200,26939,2921,18096,10986,35388,17985,7603,19223,37208,19367,37463
,LiMinJuXiang,130984201,32651,3683,21760,14238,42333,21520,8955,23022,44542,23529,45289
˴,XingCunXiang,130984202,39538,5027,26780,13725,52644,26772,10368,28138,54910,28153,54933
ɳ,ShaWaXiang,130984203,24876,3088,17136,9036,32373,17005,6876,17416,34421,17704,34840
ż,XiJiuJiXiang,130984204,20915,2800,14474,8278,28028,14454,5734,14931,29385,14975,29449
ʯ,BeiShiCaoXiang,130984205,15954,2244,10821,6067,21425,10793,4096,11430,22223,11473,22294
ʫ,ShiJingCunXiang,130984207,21418,2722,14805,7901,28297,14801,5896,15220,30021,15231,30036
,GuoCunXiang,130984208,19362,2638,13001,7162,25320,12902,4700,13481,26383,13699,26700
ʱ,ShiCunXiang,130984209,17642,2563,12315,7064,24335,12086,5004,12597,24683,12894,25209
бӪ,XingBieYingXiang,130984210,28672,3413,19254,10676,37923,19138,7749,20427,39565,20580,39834
ׯ,ZunZuZhuangXiang,130984211,25700,3078,17575,9947,34735,17571,7613,18814,36385,18816,36391
,LongHuaDianXiang,130984212,20982,2583,14345,7501,27529,14313,5561,14715,29028,14781,29126
,GuoZiWaXiang,130984213,16235,1830,10938,5772,20261,10934,4129,11248,22182,11256,22194
·ֵ´,YinHeNanLuJieDaoBanShiChu,131002001,16394,1331,9913,7237,11256,9842,2512,10113,19955,10324,20237
ֵ´,GuangMingXiDaoJieDaoBanShiChu,131002002,55812,1833,30974,9966,36113,14674,4633,14243,28917,31304,62278
ֵ´,YongHuaDaoJieDaoBanShiChu,131002003,19732,1405,11928,8415,11919,11238,2976,11598,22836,12185,24113
ȷӸ¼ҵ,LangFangLongHeGaoXinJiShuChanYeQu,131002004,24048,877,12466,3000,9994,5763,1888,5770,11533,14347,26813
,LuoFaZhen,131002100,16107,2333,10491,6570,19887,10469,2929,10800,21269,10878,21369
ͷ,MaTouZhen,131002101,31995,3993,20868,12469,39650,20804,6648,21536,42340,21768,42636
,GeYuChengZhen,131002102,28993,2973,18337,10382,36229,18335,5486,19098,37433,19115,37452
,DongGuGangZhen,131002103,27457,2906,17741,9615,34691,17685,5573,18122,35807,18195,35936
˰,YangShuiWuXiang,131002200,25315,3281,16348,9099,30873,16267,4849,16826,33093,17097,33445
ׯ,ChouZhuangXiang,131002201,17856,2377,11662,6651,21625,11549,3488,11734,23283,12059,23721
ͷ,DiaoHeTouXiang,131002202,17865,2258,11279,7002,22957,11278,3210,12044,23322,12054,23333
ʷ,BeiShiJiaWuXiang,131002203,12642,991,8273,4677,10990,8227,2704,7960,16187,8064,16337
ӱ·ֵ´,YinHeBeiLuJieDaoBanShiChu,131003001,21968,2488,13522,8625,18215,11894,2751,11583,23477,13685,27207
񶫵ֵ´,AiMinDongDaoJieDaoBanShiChu,131003002,45834,4271,28693,20293,43010,28109,7321,27918,56027,28733,57426
ŵֵ´,JieFangDaoJieDaoBanShiChu,131003003,37832,3989,23875,16285,35186,23482,5882,22813,46295,23828,47703
¿·ֵ´,XinKaiLuJieDaoBanShiChu,131003004,55010,6849,31926,19717,58369,26014,5293,26379,52393,35226,67152
Դֵ´,XinYuanDaoJieDaoBanShiChu,131003005,32448,1437,19159,13538,21785,17095,4687,17801,34896,19413,38572
ϼ,NanJianTaZhen,131003100,22152,1724,14136,6425,20404,13236,4355,12832,26068,14095,28231
ׯ,WanZhuangZhen,131003101,51647,6474,33505,21599,59686,33155,9037,33046,66201,33653,67158
,JiuZhouZhen,131003102,38394,4343,24398,12731,46934,24385,6879,25173,49558,25218,49616
,BeiWangXiang,131003200,24792,2404,16159,8737,27244,16112,5002,15914,32026,16039,32198
ȷü�,LangFangJingJiJiShuKaiFaQu,131003450,70357,3874,43584,16711,47857,29567,10476,29768,59335,41123,84707
ͲнֹίԱ,XinShiJiBuXingJieGuanLiWeiYuanHui,131003500,423,1,227,101,32,56,2,73,129,199,426
̰,GuAnZhen,131022100,94770,8769,59031,29552,93280,51979,16540,52099,104078,61048,120079
,GongCunZhen,131022101,28079,3200,17711,8852,34663,17544,4870,17828,35372,18438,36149
Ȫ,LiuQuanZhen,131022102,33920,3969,22130,11306,43639,22028,6876,22563,44591,22635,44765
ţ,NiuTuoZhen,131022103,29596,3673,19160,10380,37955,19117,5678,19603,38720,19787,38947
ׯ,MaZhuangZhen,131022104,24280,2668,15878,8038,30502,15579,5546,16302,31881,16616,32494
,DongWanXiang,131022200,29491,3451,18825,9724,37807,18765,5770,19746,38511,19887,38712
,PengCunXiang,131022201,20786,2294,13003,6682,24161,12028,3897,11939,23967,13974,26977
,QuGouXiang,131022202,23866,2603,15435,8055,30265,15306,4830,15600,30906,15864,31299
õ,LiRangDianXiang,131022203,14631,1922,9777,5282,19051,9733,3174,9820,19553,9950,19727
̰Ȫҵ԰,GuAnWenQuanXiuXianShangWuChanYeYuanQu,131022400,22326,2507,14662,7455,28339,14606,4707,14673,29279,14878,29540
,YongQingZhen,131023100,90589,9376,58641,31264,109647,56996,18529,58225,115221,59853,118494
,HanCunZhen,131023101,20344,2431,12942,7001,26038,12942,3768,13601,26543,13601,26543
,HouYiZhen,131023102,18336,2139,11894,6359,23936,11894,3748,12325,24219,12329,24223
ׯ,BieGuZhuangZhen,131023103,18948,2386,12059,6987,23971,12030,3257,12475,24505,12532,24591
,LiLanChengZhen,131023104,19187,2458,12389,7129,24222,12349,3677,12652,25001,12933,25322
ܼ,GuanJiaWuHuiZuXiang,131023200,7667,858,4974,2639,9730,4968,1514,5061,10029,5065,10039
ܼ,CaoJiaWuXiang,131023201,17903,2232,11834,6610,22658,11761,4038,12031,23792,12339,24173
ׯ,LongHuZhuangXiang,131023202,20753,2338,13692,7487,27075,13667,4866,14218,27885,14265,27957
,LiuJieXiang,131023203,23572,2653,15796,8998,30307,15649,6098,16282,31931,16527,32323
ʥ,SanShengKouXiang,131023204,24635,2676,15658,8417,32155,15454,5057,16444,31898,16710,32368
幤ҵ԰,YongQingGongYeYuanQu,131023400,8007,784,4927,2580,9311,4842,1657,4997,9839,5521,10448
,ShuYangZhen,131024100,84436,6719,48555,27855,61427,43037,12504,43088,86125,55104,103659
,JiangXinTunZhen,131024101,11263,1659,7224,4217,13609,7020,1637,7028,14048,7335,14559
,QuKouZhen,131024102,35858,4932,23428,13195,45036,23330,6926,24002,47332,24288,47716
ͷ,AnTouTunZhen,131024103,19715,2723,12350,6904,23749,12082,2963,12424,24506,13051,25401
ƽ,AnPingZhen,131024104,16175,1913,9802,5880,17792,9676,2362,9704,19380,10648,20450
,LiuSongZhen,131024105,25151,3687,16131,9598,31556,15989,4438,16642,32631,17145,33276
ٻ,WuBaiHuZhen,131024106,27799,3758,17535,10008,33065,17413,4595,18069,35482,18617,36152
Ǯ,QianWangXiang,131024200,19621,2519,11886,6928,20503,11365,3089,11817,23182,13343,25229
ǯ,QianTunXiang,131024201,16615,2245,10194,6013,17825,9862,2646,10087,19949,11312,21506
Ӿü�,XiangHeJingJiJiShuKaiFaQu,131024500,2907,105,1624,1135,540,1322,407,1339,2661,1795,3419
ִҵ԰,XiangHeXianDaiChanYeYuan,131024501,9302,1330,5686,3330,10864,5610,1373,5737,11347,6319,12005
ƽ,PingShuZhen,131025100,63985,5012,41374,23887,67885,38213,14811,39970,78183,42434,83808
,WangCunZhen,131025101,30055,3447,20037,13160,39956,20003,8208,21521,41524,21673,41710
,DaShangTunZhen,131025102,45858,5353,31365,17119,61018,31129,13460,32975,64104,33306,64671
Է,NanZhaoFuZhen,131025103,31688,3733,21177,13816,42640,21177,8702,22942,44119,22946,44123
ׯ,LiuGeZhuangZhen,131025104,30630,3474,20669,11692,40929,20654,8507,21920,42574,21942,42611
Ȩ,QuanCunZhen,131025105,26657,2989,17778,10525,35610,17778,6944,18811,36589,18812,36590
̹,LiTanZhen,131025106,17109,2013,11589,7217,22651,11589,4866,12225,23814,12399,23988
㰲,GuangAnZhen,131025107,28488,3196,18794,11040,37493,18787,7178,20052,38839,20068,38862
λ,BeiWeiXiang,131025200,32822,3559,21926,12605,43883,21926,8693,23148,45074,23148,45074
,ZangTunXiang,131025202,32453,3882,22080,13877,43406,22064,9202,23345,45409,23457,45537
ǹҵ԰,DaChengGongYeYuanQu,131025400,7542,734,5187,2455,10029,5130,2523,5454,10584,5612,10799
İ,WenAnZhen,131026100,62337,5483,40075,24677,70821,37467,13949,39404,76871,41694,81769
,XinZhenZhen,131026101,24538,1987,15180,8384,29421,14875,5769,15718,30593,17114,32294
,SuQiaoZhen,131026102,26139,2651,17017,10232,31777,16935,5783,17387,34322,17556,34573
,DaLiuHeZhen,131026103,29814,2571,18459,11202,34670,17385,6375,18571,35956,20301,38760
ׯ,ZuoGeZhuangZhen,131026104,27987,1702,15282,7174,23215,12433,4959,12876,25309,19366,34648
̲,TanLiZhen,131026105,24302,2145,15408,8542,28650,15030,5555,15477,30507,16594,32002
ʷׯ,ShiGeZhuangZhen,131026106,17305,1721,10974,5883,21789,10923,3549,11134,22057,11601,22575
Ըׯ,ZhaoGeZhuangZhen,131026107,34798,3414,22600,13155,41783,22377,8283,23447,45824,23895,46495
¡,XingLongGongZhen,131026108,21666,2232,14047,8021,26122,13721,4637,13783,27504,14488,28535
,DaLiuZhenZhen,131026109,30104,3102,19340,12029,37890,19296,6633,20330,39626,20499,39839
,SunShiZhen,131026110,43010,4875,28132,16996,55667,28062,10095,29743,57805,29848,57980
¹,DeGuiZhen,131026111,15384,1690,9993,6234,19415,9937,3439,10282,20219,10520,20513
Χӻ,DaWeiHeHuiZuManZuXiang,131026200,23191,2246,15169,8126,29795,15114,5547,15730,30844,15815,30984
,DaChangZhen,131028100,35376,4112,22453,14899,38073,21213,5810,21069,42282,22845,45298
ĵ,XiaDianZhen,131028101,25409,2851,16347,8344,28655,14934,4426,14931,29865,16339,32686
ׯ,QiGeZhuangZhen,131028102,16340,2140,9887,7990,18540,9798,2161,9902,19700,10754,20641
۸,ShaoFuXiang,131028201,6749,908,4286,3316,8470,4283,1040,4373,8656,4411,8697
¸,ChenFuXiang,131028202,8027,1140,5197,3255,10217,5197,1311,5281,10478,5281,10478
󳧹ҵ԰,DaChangGongYeYuanQu,131028400,647,9,221,154,0,151,18,164,315,453,674
,BaZhouZhen,131081100,78935,6783,51225,28351,95989,49321,17908,50112,99433,52401,103626
,NanMengZhen,131081101,31416,3439,20475,12017,31425,20227,6164,20219,40446,20544,41019
Ű,XinAnZhen,131081102,22384,2255,14277,6944,26688,14067,5024,14195,28262,15386,29663
ö,TangErLiZhen,131081103,23413,2457,15132,7950,29770,15097,4949,15622,30719,15687,30819
,JianChaPuZhen,131081104,30689,3295,20306,11731,38054,20197,7629,21148,41345,21307,41613
ʤ,ShengFangZhen,131081105,93763,6676,57462,33345,89830,56221,20889,60369,116590,63866,121328
Ҹ,YangFenGangZhen,131081106,29009,2868,18955,10764,36968,18842,6623,19244,38086,19545,38500
Ӽ,ChaHeJiXiang,131081200,36563,4102,24104,12780,45315,23872,8102,24112,47984,24663,48767
ׯ,KangXianZhuangXiang,131081201,36088,3966,23614,12861,44437,23467,8371,24286,47753,24811,48425
ׯ,DongYangZhuangXiang,131081202,16276,1730,11101,6595,21276,11064,4471,11332,22396,11376,22477
ׯ,WangZhuangZiXiang,131081203,27282,2263,17594,10565,31566,17366,8236,18399,35765,20187,37781
,DongDuanXiang,131081204,35839,3050,22674,10820,40944,21518,8044,22128,43646,24259,46933
ݾü�,BaZhouJingJiJiShuKaiFaQu,131081450,9371,699,5943,3286,5372,5638,1954,5703,11341,6081,12024
ʢֵֽ´,DingChengDongDaJieJieDaoBanShiChu,131082001,16313,1886,10801,7386,8931,10763,3625,10396,21159,11023,21824
tֵֽ´,JuYangXiDaJieJieDaoBanShiChu,131082002,35916,1944,22959,14265,19912,21369,6659,19978,41347,21560,44519
t,JuYangZhen,131082100,39199,4964,25724,14641,43051,25334,8316,25842,51176,26755,52479
ׯ,LiQiZhuangZhen,131082101,20941,2397,13254,6372,21746,11151,3329,11093,22244,13413,26667
ׯ,YangZhuangZhen,131082102,19643,2800,12946,7255,22797,12392,4026,12732,25124,13523,26469
ׯ,HuangZhuangZhen,131082103,28886,4334,19421,10530,36355,19346,6167,19800,39146,19966,39387
¼,XinJiZhen,131082104,28795,4077,19848,10901,37161,19824,7536,20516,40340,20560,40408
μ,DuanJiaLingZhen,131082105,13998,2105,9132,5554,16757,9127,2769,9647,18774,9740,18872
ׯ,HuangTuZhuangZhen,131082106,24083,3503,15991,9010,28625,15939,5166,16446,32385,16761,32752
¥,GaoLouZhen,131082107,27247,3654,17355,9796,29214,15960,4161,16325,32285,17707,35062
ׯ,QiXinZhuangZhen,131082108,16085,2423,10377,6045,18906,10263,2890,10467,20730,11021,21398
ོ,YanJiaoZhen,131082109,57455,5239,34258,19809,48215,32470,10053,32916,65386,38489,72747
ོü�,YanJiaoJingJiJiShuKaiFaQu,131082450,187989,9305,104469,63315,94331,78932,22160,78626,157558,114985,219454
Ӹ¼ũҵ԰,SanHeGaoXinJiShuNongYeYuanQu,131082451,2,0,2,2,0,2,2,2,4,2,4
ֵ´,HeXiJieDaoBanShiChu,131102001,55891,4654,37573,21075,60499,33881,11466,33234,67115,34438,72011
Ӷֵ´,HeDongJieDaoBanShiChu,131102002,44015,3432,27103,17109,44061,25376,8768,25525,50901,29112,56215
·ֵ´,LuBeiJieDaoBanShiChu,131102003,40314,2081,24727,13804,36479,19822,8012,20094,39916,25680,50407
лֵ´,ZhongHuaJieDaoBanShiChu,131102004,92755,5889,57916,30017,94897,44384,15261,44334,88718,55989,113905
֣Һ,ZhengJiaHeYanZhen,131102100,29583,3959,19657,12365,37593,19520,5624,19024,38544,19509,39166
ԼȦ,ZhaoJiaQuanZhen,131102101,24999,4105,16603,12554,32129,16534,4472,16808,33342,16973,33576
μׯ,HeJiaZhuangXiang,131102200,20431,1561,13316,8236,19380,12954,4475,12727,25681,13151,26467
ɭ,DaMaSenXiang,131102201,19984,2744,13236,8455,24700,12965,4028,13135,26100,13520,26756
˼ׯ,DengJiaZhuangXiang,131102202,19577,2748,12710,8675,24811,12664,3756,12783,25447,13371,26081
Ŵ,PengDuCunXiang,131102203,23873,2613,15856,8525,26282,13701,4574,13598,27299,15204,31060
ˮ¼ҵ,HengShuiGaoXinJiShuChanYeKaiFaQu,131102400,31421,2396,20325,11860,24991,17797,6493,18109,35906,19985,40310
ˮȻ�,HengShuiHuZiRanBaoHuQuGuanLiChu,131102401,4492,648,3180,1732,6051,3179,1053,3012,6191,3013,6193
ǿ,ZaoQiangZhen,131121100,79531,7762,53316,32150,91082,48184,18712,47952,96136,52689,106005
,EnChaZhen,131121101,11443,1452,7726,4947,15348,7338,2699,7486,14824,7868,15594
Ӫ,DaYingZhen,131121102,55816,4855,37808,23414,69929,37488,16129,38151,75639,38992,76800
λ,JiaHuiZhen,131121103,9053,1091,6263,3496,12250,5961,2375,5978,11939,6256,12519
,MaTunZhen,131121104,26495,3636,18125,11512,35697,18055,6284,18171,36226,18290,36415
Ф,XiaoZhangZhen,131121105,10604,1188,6842,3894,12544,6386,2379,6420,12806,7329,14171
,ZhangXiuTunXiang,131121200,24705,2953,15941,10016,31604,15720,4356,15560,31280,16073,32014
,XinTunXiang,131121201,24706,2643,16989,10922,33231,16951,6906,17216,34167,17266,34255
,WangJunXiang,131121202,16025,2017,11009,6539,21893,10941,4024,10974,21915,11057,22066
,TangLinXiang,131121203,17968,2067,11473,6795,21693,11038,4006,11129,22167,12568,24041
,WangChangXiang,131121204,14847,2063,10187,6663,20325,10172,3679,10328,20500,10402,20589
,WuYiZhen,131122100,63855,5503,40901,22839,75296,35993,13168,36476,72469,41625,82526
,QingLiangDianZhen,131122101,22416,2929,15171,9562,29341,15160,4881,15006,30166,15055,30226
,ShenPoZhen,131122102,25877,3139,17304,10234,34517,17299,5732,17410,34709,17444,34748
,ZhaoQiaoZhen,131122103,26264,2717,17855,9860,35960,17855,7142,18268,36123,18268,36123
ׯ,HanZhuangZhen,131122104,27319,3066,18561,10629,37241,18534,7360,19161,37695,19184,37745
Фͷ,XiaoQiaoTouZhen,131122105,20135,2572,13679,8499,27614,13677,5056,14084,27761,14084,27763
,LongDianXiang,131122200,19878,2331,13236,7640,26917,13236,4875,13848,27084,13848,27084
Ȧͷ,QuanTouXiang,131122201,15973,1973,10779,6376,21056,10770,3424,10536,21306,10591,21370
,DaZiTaXiang,131122203,13269,1824,9105,6297,17958,9081,3015,8956,18037,9003,18108
ǿ,WuQiangZhen,131123100,47881,4966,31560,16333,56994,29814,10193,30073,59887,31480,63040
ֹ,JieGuanZhen,131123101,24000,2921,15791,8642,31413,15548,5107,15919,31467,16237,32028
,ZhouWoZhen,131123102,19623,2167,12753,6529,24748,12442,3974,12619,25061,13011,25764
,DouCunXiang,131123200,23415,2638,15286,7958,30705,15280,4938,15692,30972,15705,30991
,BeiDaiXiang,131123201,21518,2567,14338,7971,28957,14302,5352,14976,29278,15099,29437
ׯ,SunZhuangXiang,131123202,24797,3255,16521,8715,32961,16518,5237,16751,33269,16768,33289
,RaoYangZhen,131124100,49900,5349,31952,17788,55806,29612,8310,29764,59376,31607,63559
,DaYinCunZhen,131124101,17710,2246,11473,6330,22938,11455,3177,11637,23092,11660,23133
幫,WuGongZhen,131124102,28080,4123,18028,10220,35741,17750,4402,18353,36103,18577,36605
ͤ,DaGuanTingZhen,131124103,30196,4008,19375,11819,39106,19364,5467,20278,39642,20296,39671
ͬ,WangTongYueXiang,131124200,21782,3180,14088,8400,28139,14071,3586,14372,28443,14460,28548
,LiuChuXiang,131124202,39320,5669,25681,14637,51411,25662,6999,26207,51869,26307,51988
,DongLiManXiang,131124203,27688,4453,18034,11161,36556,18030,4853,18911,36941,18960,36994
ƽ,AnPingZhen,131125100,78033,6946,48454,27439,80315,44998,15056,45853,90851,51581,100035
,MaDianZhen,131125101,35412,5032,23493,13554,47073,23336,7348,24098,47434,24299,47792
ׯ,NanWangZhuangZhen,131125102,23993,3869,16306,9861,32368,16216,5086,16543,32759,16642,32948
ׯ,DaHeZhuangXiang,131125200,23602,3992,15902,9686,32085,15902,4805,16497,32399,16497,32399
,ChengYouZiXiang,131125201,26806,3693,17720,9557,35557,17567,5508,18028,35595,18287,36007
,XiLiangWaXiang,131125202,15648,2097,10278,5832,19935,9946,3271,10110,20056,10738,21016
,DaZiWenXiang,131125203,21897,3356,14850,9234,29320,14688,4516,14677,29365,14919,29769
Ƴ,DongHuangChengXiang,131125204,21266,2976,13566,7979,27122,13372,4304,14066,27438,14980,28546
֣,ZhengKouZhen,131126100,83809,6543,54447,28519,101824,49339,19475,50758,100097,55380,109827
ׯ,XiaZhuangZhen,131126101,28174,3024,19042,10412,37261,18488,7138,18638,37126,19294,38336
ັ,QingHanZhen,131126102,19936,2381,13414,7628,26679,13185,5166,13618,26803,14069,27483
ʳ,GuChengZhen,131126103,19718,2482,13198,6941,26059,12666,4345,12742,25408,13347,26545
կ,WuGuanZhaiZhen,131126104,26346,2408,18025,10598,36645,18025,7975,18704,36729,18704,36729
,RaoYangDianZhen,131126105,23327,2397,16057,10013,31812,15748,7098,16294,32042,16765,32822
,JunTunZhen,131126106,13373,1400,8852,5112,18068,8504,3434,8897,17401,9355,18207
,JianGuoZhen,131126107,35570,3683,24163,13564,48038,24133,9700,24714,48847,24790,48953
,XiBanTunZhen,131126108,29547,3228,20448,11674,40560,19976,8409,20021,39997,20736,41184
ׯ,XinZhuangXiang,131126200,21364,2188,13787,7784,27773,13770,4548,14282,28052,14313,28100
,LiLaoXiang,131126201,14255,1541,9418,5377,18374,9410,3319,9636,19046,9697,19115
ׯ,FangZhuangXiang,131126202,24009,2897,16393,10304,32597,16322,5923,16265,32587,16436,32829
,SanLangXiang,131126203,19366,2360,13341,8215,26006,13282,5169,13460,26742,13554,26895
,JingZhouZhen,131127100,54813,4718,36486,19709,58623,33439,13275,33437,66876,36320,72806
,LongHuaZhen,131127101,32043,3150,21601,12390,41688,21425,8148,21595,43020,21740,43341
㴨,GuangChuanZhen,131127102,24114,2609,15863,9290,32551,15850,5844,16655,32505,16704,32567
ͫ,WangTongZhen,131127103,19691,2520,13246,7419,26301,12689,4741,12611,25300,13706,26952
䮺,JiangHeLiuZhen,131127104,19450,2170,13028,6924,26223,12389,4895,12638,25027,13487,26515
,AnLingZhen,131127105,17737,2086,11574,6094,23567,10924,3756,10998,21922,12005,23579
,DuQiaoZhen,131127106,26198,2876,17364,10082,35295,17360,6493,18202,35562,18203,35567
ǫ,WangQianSiZhen,131127107,20238,2160,13540,8336,26756,13538,4953,13786,27324,13811,27351
,BeiLiuZhiZhen,131127108,22043,2509,15120,8808,29642,15077,5718,15059,30136,15150,30270
,LiuZhiMiaoZhen,131127109,27814,2904,18393,10583,34701,18348,6371,18597,36945,18696,37089
,LiuJiXiang,131127200,19901,2501,13578,7403,26591,13198,4928,13168,26366,13752,27330
,LianZhenXiang,131127201,18023,1980,12148,6784,24376,12036,4491,12055,24091,12346,24494
,LiangJiXiang,131127202,28985,3539,19746,10445,36062,17992,6994,18279,36271,19772,39518
³,WenChengXiang,131127203,17561,1813,11595,6814,23506,11475,4237,11761,23236,12016,23611
,HouLiuMingFuXiang,131127204,20652,2577,14101,8021,27943,13636,5147,13542,27178,14275,28376
,QingLanXiang,131127205,21476,2303,14465,8705,29165,14457,5548,14852,29309,14862,29327
,FuChengZhen,131128100,50488,4708,34609,20954,61154,32625,13453,32309,64934,34040,68649
ų,GuChengZhen,131128101,33044,3485,22802,13358,44203,22159,8780,21934,44093,22507,45309
ͷ,MaTouZhen,131128102,28861,3238,19410,10819,39370,19209,7447,19700,38909,20136,39546
ϼ,XiaKouZhen,131128103,22997,2382,15172,9122,30476,15136,5623,15741,30877,15830,31002
޼,CuiJiaMiaoZhen,131128104,30006,3392,20094,13118,40759,19668,7519,20001,39669,20823,40917
,ManHeXiang,131128200,20071,2055,13480,8284,27297,13373,5379,13736,27109,14025,27505
,JianQiaoXiang,131128201,12127,1524,8438,5302,16761,8373,3124,8223,16596,8337,16775
,JiangFangXiang,131128202,19420,2302,13437,7888,27115,13434,5401,13675,27109,13686,27123
,DaBaiXiang,131128203,14553,1805,9776,6076,19951,9757,3654,10220,19977,10236,20012
,WangJiXiang,131128204,17854,2024,11611,7405,24140,11330,4371,11944,23274,12638,24249
,JiZhouZhen,131181100,101198,7632,61314,32835,80118,47952,15886,46801,94753,63402,124716
κ,WeiTunZhen,131181101,12542,1608,8286,5787,16437,8270,2461,8291,16561,8325,16611
ٵ,GuanDaoLiZhen,131181102,14109,2390,9364,6310,18492,9122,2290,9023,18145,9425,18789
,NanWuCunZhen,131181103,22885,3442,15548,11639,30096,15537,4100,14827,30364,14879,30427
ܴ,ZhouCunZhen,131181104,16260,2492,10772,8213,20982,10763,2649,10599,21362,10629,21401
ͷ,MaTouLiZhen,131181105,20079,3258,13568,9767,26623,13552,3550,13249,26801,13319,26887
,XiWangZhen,131181106,20840,2930,13925,9761,27561,13925,3886,13730,27655,13731,27656
ׯ,MenZhuangXiang,131181200,14334,2401,9681,6602,18942,9674,2359,9398,19072,9413,19094
ׯ,XuJiaZhuangXiang,131181201,19376,2825,12674,8111,25109,12647,2952,12421,25068,12479,25153
Ļ,BeiZhangHuaiXiang,131181202,16332,2382,10602,6952,21226,10289,2557,10105,20394,10669,21271
Сկ,XiaoZhaiXiang,131181203,22729,3570,15071,10844,29692,15004,3709,14845,29849,14937,30008
Ʒ,TangFengZhen,131182100,30335,4316,19715,12060,38872,19647,5690,19842,39489,20626,40341
,ShenZhouZhen,131182101,67788,6479,42801,22268,66647,36543,11897,37059,73602,43363,86164
ʱ,ChenShiZhen,131182102,31281,4443,20461,11532,40246,20184,5905,20883,41067,21168,41629
ܿ,YuKeZhen,131182103,20241,2883,13278,7786,26028,13212,3699,13491,26703,13545,26823
κ,WeiQiaoZhen,131182104,22525,3121,14710,8299,28737,14449,3695,14288,28737,14631,29341
,DaDiZhen,131182105,18002,2594,11928,6891,23324,11795,3167,11588,23383,11835,23763
ǰĥͷ,QianMoTouZhen,131182106,17724,2648,11307,6984,22270,10826,2910,10792,21618,11975,23282
Ҿ,WangJiaJingZhen,131182107,26410,3893,17275,10553,33625,17093,4504,17229,34322,17532,34807
ݳ,HuJiaChiZhen,131182108,18585,2569,11693,6856,23625,11169,2951,11629,22798,12412,24105
,DaTunZhen,131182109,19845,2966,12778,8266,25118,12778,2851,12884,25662,12884,25662
,BingCaoXiang,131182200,12481,1813,8279,4650,16497,8164,2553,8448,16612,8568,16847
´,MuCunXiang,131182201,22603,2453,14360,7335,28546,14172,4186,14688,28860,14882,29242
ׯ,DongAnZhuangXiang,131182202,29061,3826,19098,10507,36663,19059,5563,19253,38312,19352,38450
Ϫ,BeiXiCunXiang,131182203,23705,3662,15509,8479,31365,15508,4366,16224,31732,16224,31733
Ӫ,DaFengYingXiang,131182204,24130,3391,15806,8618,31390,15743,4387,15961,31704,16102,31908
,QiaoTunXiang,131182206,14893,1990,9439,6019,18197,9306,2513,9363,18669,9957,19396
̫ׯ,TaiGuZhuangXiang,131182207,17299,2392,11043,7054,21868,11035,2517,11159,22194,11165,22208
ӱʡ,HeBeiShengXuNiDiQu,131182400,4097,188,272,343,412,272,25,325,597,4038,4310
˫ÿ,ShuangJingJingJiKaiFaQu,131182402,12133,1660,7920,4374,15685,7767,2283,8036,15803,8156,16076
ǽֵ´,WuChengJieDaoBanShiChu,140105001,124797,9210,75412,37853,98870,50744,15131,49916,100660,73726,149138
Ӫֵ̽´,YingPanJieDaoBanShiChu,140105002,108969,10539,68105,51087,66449,64753,17136,64438,129191,68539,136644
Ӫֵ´,BeiYingJieDaoBanShiChu,140105003,44858,3066,26050,13078,25929,16987,5333,16998,33985,27207,53257
ƽ·ֵ´,PingYangLuJieDaoBanShiChu,140105004,119153,7921,71617,51292,61688,60949,18068,62061,123010,73525,145142
ֵ´,HuangLingJieDaoBanShiChu,140105005,46967,3099,29586,15092,31290,19989,7008,20260,40249,27488,57074
Сֵ´,XiaoDianJieDaoBanShiChu,140105006,80330,4749,48148,30815,55400,40489,14757,41446,81935,51688,99836
,BeiGeZhen,140105100,27607,2820,16939,9482,31198,16359,5967,16606,32965,19455,36394
ׯ,XiWenZhuangXiang,140105200,35777,1380,21589,5572,25888,8611,3227,8669,17280,18795,40384
ұ,LiuJiaBaoXiang,140105201,23925,2684,15726,8130,29628,15620,5624,15759,31379,16507,32233
̫ԭ¼ҵ,TaiYuanGaoXinJiShuChanYeKaiFaQu,140105401,8656,176,4036,1847,2561,2522,1082,2577,5099,5878,9914
̫ԭü�,TaiYuanJingJiJiShuKaiFaQu,140105501,41897,603,16959,7252,8613,6048,2021,7961,14009,27562,44521
ֵ´,LiuXiangJieDaoBanShiChu,140106001,31363,3822,20383,14368,20446,19009,4396,18058,37067,19198,39581
ֵ´,WenMiaoJieDaoBanShiChu,140106002,62926,8018,41143,25870,48764,36882,9313,35705,72587,39114,80257
ǰֵ´,MiaoQianJieDaoBanShiChu,140106003,49828,8268,33486,22928,41515,32075,7361,30630,62705,31971,65457
ӭֵ´,YingZeJieDaoBanShiChu,140106004,96955,11186,63695,32693,84622,46583,10813,44542,91125,55259,118954
Ŷֵ´,QiaoDongJieDaoBanShiChu,140106005,102229,11851,66961,44049,70973,60159,15342,58752,118911,62461,129422
ϾӪֵ´,LaoJunYingJieDaoBanShiChu,140106006,53656,8077,35340,23263,49366,34424,8831,32704,67128,35224,70564
ׯ,HaoZhuangZhen,140106100,67185,3397,40771,30218,26719,39022,13716,39846,78868,43527,84298
Ӫ,MinYingQu,140106401,2800,109,1605,1040,0,1469,565,1531,3000,1869,3474
ֵֽ´,JuLunJieDaoBanShiChu,140107001,60931,8776,39637,27430,46557,39012,9378,37783,76795,39448,79085
Žֵ´,SanQiaoJieDaoBanShiChu,140107002,64067,10580,42146,27962,56797,40137,9360,38048,78185,41861,84007
¥ֵ´,GuLouJieDaoBanShiChu,140107003,28132,4529,19165,12328,24180,18068,4606,17272,35340,18102,37267
ӻֵ´,XingHuaLingJieDaoBanShiChu,140107004,31330,4214,21224,14404,25930,20736,5625,19489,40225,19945,41169
Žֵ´,BaLingQiaoJieDaoBanShiChu,140107005,35411,4568,22572,13829,28679,19713,5009,18906,38619,22416,44988
󶫹ؽֵ´,DaDongGuanJieDaoBanShiChu,140107006,44039,4382,25508,16811,24279,23160,6534,22987,46147,29447,54955
ְ½ֵֽ´,ZhiGongXinJieJieDaoBanShiChu,140107007,38556,4676,24106,16395,28743,22432,5575,22902,45334,24701,48807
ػֵ´,DunHuaFangJieDaoBanShiChu,140107008,59443,10919,39563,27780,52669,39070,8903,38665,77735,39702,79265
ӽֵ´,JianHeJieDaoBanShiChu,140107009,59795,7576,37283,26213,50121,36973,8816,37827,74800,38904,76187
ֵ´,YangJiaYuJieDaoBanShiChu,140107010,38482,2295,24118,16838,10364,23124,9207,24122,47246,25866,49984
н,ZhongJianHeXiang,140107200,24306,1821,15493,9830,13881,15136,6064,15876,31012,16698,32191
С,XiaoFanXiang,140107201,4859,576,3135,2137,5157,3049,1139,3196,6245,3439,6574
Ӫ,MinYingQu,140107401,7139,379,4335,3048,2329,4189,1587,4234,8423,4770,9105
ƺֵ´,JianCaoPingJieDaoBanShiChu,140108001,24416,3406,15796,11005,19437,15629,3856,15398,31027,15882,31678
ֵ´,GuangSheJieDaoBanShiChu,140108002,15843,2135,10056,7220,12811,10029,2677,10194,20223,10599,20655
ֵ´,ShangLanJieDaoBanShiChu,140108003,44501,1768,18183,5092,31442,7610,2467,7572,15182,30553,48736
կֵ´,NanZhaiJieDaoBanShiChu,140108004,49011,7799,30946,18884,48312,26229,6882,25978,52207,32746,63692
ӭ½ֵ´,YingXinJieDaoBanShiChu,140108005,18647,2715,12027,8213,18165,11865,3476,12094,23959,12811,24838
ųǽֵ´,GuChengJieDaoBanShiChu,140108006,26933,2352,16675,10212,18479,14024,3737,13872,27896,16347,33022
ֵ´,HuiFengJieDaoBanShiChu,140108007,68494,5804,43807,27284,35609,36697,11137,37423,74120,41628,85435
ֵ´,ChaiCunJieDaoBanShiChu,140108008,29713,2851,19743,10803,29570,19048,7579,19525,38573,20400,40143
³ǽֵ´,XinChengJieDaoBanShiChu,140108009,13644,1441,8877,6325,10723,8856,2857,8982,17838,9065,17942
,XiangYangZhen,140108100,12922,1592,8445,5033,14501,8417,2784,8706,17123,8853,17298
,YangQuZhen,140108101,11654,1330,7464,4766,12457,7279,2815,7414,14693,8335,15799
ͷˮ,MaTouShuiXiang,140108200,590,270,406,460,828,403,46,456,859,500,906
ذ,BaiBanXiang,140108201,8356,955,5229,2817,9956,5229,1794,5424,10653,5876,11105
,XiYanXiang,140108202,3209,486,2099,1516,4033,2061,761,2231,4292,2357,4456
ǧֵ´,QianFengJieDaoBanShiChu,140109001,50012,3489,25762,17167,32134,20083,5226,20176,40259,32965,58727
Ԫֵ´,XiaYuanJieDaoBanShiChu,140109002,75144,6388,45041,30423,42564,33917,7953,35170,69087,44444,89485
ƽֵ´,HePingJieDaoBanShiChu,140109003,69035,7428,39731,25489,54179,34095,9706,34716,68811,46438,86169
˻ֵ´,XingHuaJieDaoBanShiChu,140109004,57538,4353,35350,24256,31615,32974,9205,32425,65399,35746,71096
ֵֽ´,WanBoLinJieDaoBanShiChu,140109005,37295,4779,24517,17557,29103,24295,7432,24289,48584,24989,49506
Ŷƺֵ´,DuErPingJieDaoBanShiChu,140109006,22088,2586,14098,9819,23109,14087,3796,14232,28319,14372,28470
׼ׯֵ´,BaiJiaZhuangJieDaoBanShiChu,140109007,22940,3156,15095,10541,22782,15076,4589,15405,30481,15590,30685
Ϻֵ´,NanHanJieDaoBanShiChu,140109008,68938,8217,44292,29915,65555,43258,11421,42776,86034,44284,88576
ֵ´,DongSheJieDaoBanShiChu,140109009,19588,1498,11276,6792,14380,11026,4341,11172,22198,14151,25427
ͷֵ´,HuaKeTouJieDaoBanShiChu,140109010,9376,930,5782,3983,8342,5742,2156,6028,11770,6680,12462
Сֵ´,XiaoJingYuJieDaoBanShiChu,140109011,68300,4387,40592,30758,34892,38948,13528,41174,80122,45623,86215
ֵ´,XiMingJieDaoBanShiChu,140109012,14596,1981,9672,6610,14078,9655,3051,9886,19541,9956,19628
ֵֽ´,ChangFengXiJieJieDaoBanShiChu,140109013,69882,3440,36501,28041,26531,30284,9327,33995,64279,46148,82649
ùֵ´,ShenTangGouJieDaoBanShiChu,140109014,14168,1875,7244,5074,11035,7234,1921,7210,14444,10720,17964
,WangFengXiang,140109200,1652,398,821,970,1672,783,146,983,1766,1375,2196
微ֵ´,YiJingJieDaoBanShiChu,140110001,42306,4445,25764,15643,31133,22128,6824,22178,44306,27811,53575
޳ǽֵ´,LuoChengJieDaoBanShiChu,140110002,17839,2343,11214,6365,18056,9052,2696,8994,18046,11664,22878
Դֵ´,JinYuanJieDaoBanShiChu,140110003,30917,3152,19869,11031,36334,19717,7224,19561,39278,21424,41293
ʤ,JinShengZhen,140110100,30842,2506,18481,10743,31460,17025,6141,16932,33957,21008,39489
,JinCiZhen,140110101,32596,2500,21210,9564,33858,16219,5775,16119,32338,19661,40871
Ҧ,YaoCunZhen,140110102,16950,1840,11499,5969,21724,11430,4535,11602,23032,11826,23325
Դ,QingYuanZhen,140121100,85899,7737,57612,31197,96362,54745,22962,54248,108993,58986,116598
칵,XuGouZhen,140121101,36242,3666,23815,12509,40681,21219,8132,21108,42327,24225,48040
,DongYuZhen,140121102,20466,1965,13207,7899,26826,12838,5189,13376,26214,14413,27620
Ϸ,MengFengZhen,140121103,23177,2877,15675,8556,29978,15528,5434,15449,30977,15813,31488
,MaYuXiang,140121200,13660,1522,9122,6568,18038,9117,3446,9408,18525,9506,18628
,LiuDuXiang,140121201,14292,1680,9651,5894,18522,9633,3477,9706,19339,9798,19449
,XiGuXiang,140121202,13985,1907,9488,5754,17578,9298,3194,9338,18636,9598,19086
,WangDaXiang,140121203,27987,2506,15213,8614,25377,14282,5437,14193,28475,20717,35930
,JiYiXiang,140121204,19929,2443,13008,7689,25322,12912,4650,13295,26207,14014,27022
կ,HuangZhaiZhen,140122100,16524,2139,10535,6497,12215,9626,3570,10379,20005,11698,22233
,DaYuZhen,140122101,7684,1458,5127,3464,9604,5076,1817,5518,10594,5832,10959
ˮ,DongHuangShuiZhen,140122102,6896,1423,4488,3314,8700,4431,1403,4765,9196,5234,9722
,NiTunZhen,140122103,11907,2228,7788,5774,15769,7756,2719,8692,16448,9066,16854
칫,SheQuJianSheGuanLiBanGongShi,140122104,19956,1787,13261,8615,16687,13026,5131,12823,25849,13613,26874
ߴ,GaoCunXiang,140122200,7027,1181,4689,3196,8773,4667,1696,5048,9715,5215,9904
,HouCunXiang,140122201,7478,1364,4934,3499,9848,4909,1514,5378,10287,5422,10356
辮,LingJingDianXiang,140122202,5891,1111,3545,2595,6981,3486,1088,3812,7298,4545,8090
辮,XiLingJingXiang,140122203,631,169,411,387,815,410,94,462,872,483,894
С,BeiXiaoDianXiang,140122204,1141,339,746,633,1493,741,158,814,1555,892,1638
,YangXingXiang,140122205,1909,519,1247,1094,2611,1246,276,1411,2657,1457,2704
¦,LouFanZhen,140123100,30153,2378,20819,12261,24529,20155,9989,20695,40850,21701,42520
,JingYouZhen,140123101,12862,1735,8255,5359,15864,8163,3324,8871,17034,9666,17921
Ž,DuJiaoQuZhen,140123102,3202,515,2018,1537,3881,1995,776,2082,4077,2475,4493
,MiaoWanXiang,140123200,1834,537,1270,1127,2644,1270,334,1432,2702,1435,2705
ׯ,MaJiaZhuangXiang,140123201,11062,1015,7422,5066,12957,7396,3709,8002,15398,8364,15786
Ǽׯ,GaiJiaZhuangXiang,140123202,3561,342,1966,1191,3833,1924,865,2251,4175,2802,4768
,MiYuZhenXiang,140123203,5763,729,3718,2047,7411,3686,1578,4296,7982,4352,8070
ص,TianChiDianXiang,140123204,6753,885,4563,2642,8927,4562,1940,5006,9568,5015,9578
ֵ´,DongQuJieDaoBanShiChu,140181001,32410,1754,19857,13244,26556,19691,6708,20531,40222,21015,40872
ֵ´,XiQuJieDaoBanShiChu,140181002,12772,769,7829,5402,10913,7812,2905,8506,16318,8617,16446
԰ֵ´,TaoYuanJieDaoBanShiChu,140181003,30447,1599,18571,11215,25300,17352,6469,18527,35879,19944,38515
ֵ´,TunLanJieDaoBanShiChu,140181004,13940,735,7621,5166,7803,7433,2913,8016,15449,9967,17588
ӿ,HeKouZhen,140181100,11176,1309,7282,4438,13841,7251,2676,7712,14963,7879,15161
ǵ,ZhenChengDiZhen,140181101,6757,625,4093,2741,6359,4027,1640,4347,8374,4929,9022
,MaLanZhen,140181102,15909,1403,9940,6447,16816,9856,3744,10618,20474,11116,21056
,GeShangXiang,140181200,354,92,234,201,413,233,66,278,511,278,512
Ȫ,JiaLeQuanXiang,140181201,5333,566,3204,2415,4819,3195,1260,3650,6845,3955,7159
,SuoYuXiang,140181202,12630,961,7969,5761,12393,7959,2930,8518,16477,8552,16521
,ChaKouXiang,140181203,4669,706,3185,2002,6105,3179,1254,3423,6602,3444,6629
,ChangAnXiang,140181204,4314,615,2755,1792,5311,2736,1194,3020,5756,3368,6123
ԭ,YuanXiangXiang,140181205,2624,537,1696,1270,3146,1671,618,1808,3479,2083,3779
ϼ,XingJiaSheXiang,140181206,3949,692,2644,1945,5277,2641,1119,3053,5694,3116,5760
Ϲؽֵ´,NanGuanJieDaoBanShiChu,140202001,85153,8145,54900,37253,71633,51517,15952,51335,102852,54350,109250
ؽֵ´,BeiGuanJieDaoBanShiChu,140202002,86456,6104,54395,37886,61859,52181,18000,52172,104353,56165,110560
ֵֽ´,DongJieJieDaoBanShiChu,140202003,20821,2350,13954,9996,23807,13810,4489,13585,27395,13706,27660
ֵֽ´,XiJieJieDaoBanShiChu,140202004,20463,2261,13667,9331,20400,13210,4359,12954,26164,13416,27083
Ͻֵֽ´,NanJieJieDaoBanShiChu,140202005,14200,1653,8940,6196,13528,8611,2260,8398,17009,9173,18113
ֵֽ´,BeiJieJieDaoBanShiChu,140202006,26358,3207,17634,12651,23181,16716,4945,16581,33297,16876,34510
½·ֵ´,XinJianNanLuJieDaoBanShiChu,140202007,42305,4507,28421,17856,40743,25255,6987,24600,49855,25378,53799
½·ֵ´,XinJianBeiLuJieDaoBanShiChu,140202008,35517,3946,23235,15979,38628,22909,6712,22569,45478,22940,46175
·ֵ´,DaQingLuJieDaoBanShiChu,140202009,33213,4343,20615,14890,30368,19290,5545,19095,38385,22486,43101
»ֵֽ´,XinHuaJieJieDaoBanShiChu,140202010,70876,8576,46341,32249,66807,44356,11235,43090,87446,44346,90687
԰ֵ´,XiHuaYuanJieDaoBanShiChu,140202011,19019,3825,13003,9997,23607,12730,3574,12764,25494,13415,26418
ƽֵ´,LaoPingWangJieDaoBanShiChu,140202012,12295,1581,8822,5060,9774,6565,2029,6506,13071,7083,15905
ֵ´,XiangYangLiJieDaoBanShiChu,140202013,35917,2576,21181,15292,24349,20720,6570,20883,41603,23882,45063
Ͻֵֽ´,ZhenHuaNanJieJieDaoBanShiChu,140202014,58177,5757,37271,25993,52462,36662,10755,36251,72913,37418,74689
ʤֵ´,XinShengJieDaoBanShiChu,140203001,55679,4204,31252,20365,42350,28990,8505,29259,58249,37136,68388
ƽֵ´,XinPingWangJieDaoBanShiChu,140203002,42697,5448,27571,18348,44225,27387,6818,26990,54377,27392,54963
úڽֵ´,MeiYuKouJieDaoBanShiChu,140203003,8049,1384,5179,3859,10141,5179,1095,5348,10527,5349,10528
ׯֵ´,YongDingZhuangJieDaoBanShiChu,140203004,5877,955,3699,2813,6431,3698,801,3932,7630,3934,7633
ֵͬ´,TongJiaLiangJieDaoBanShiChu,140203005,7292,1036,4617,3394,8142,4617,1083,4794,9411,4794,9411
Ϲֵ´,SiLaoGouJieDaoBanShiChu,140203006,5998,1047,3839,2710,7611,3839,1001,4205,8044,4207,8046
Ҥֵ´,XinZhouYaoJieDaoBanShiChu,140203007,4084,677,2655,1807,4793,2655,569,2670,5325,2675,5330
׶ֵ´,BaiDongJieDaoBanShiChu,140203008,861,203,586,438,1141,586,161,639,1225,639,1225
½ֵ´,YanYaJieDaoBanShiChu,140203009,7589,1262,4619,4006,9718,4610,1280,5283,9893,5512,10131
ڽֵ´,WaJinWanJieDaoBanShiChu,140203010,521,55,321,245,649,321,91,346,667,346,667
�ֵ´,JinHuaGongJieDaoBanShiChu,140203011,15197,1881,9759,7111,18738,9759,3328,10647,20406,10647,20406
�ֵ´,MaJiLiangJieDaoBanShiChu,140203012,7578,490,4304,3490,9158,4298,1546,5045,9343,5310,9614
󶷹ֵ´,DaDouGouJieDaoBanShiChu,140203013,1108,206,719,547,1169,716,176,736,1452,771,1490
ֵ´,WangCunJieDaoBanShiChu,140203014,2608,178,1573,1188,3093,1573,575,1784,3357,1788,3361
ֵ´,JiangJiaWanJieDaoBanShiChu,140203015,17123,1317,10768,7072,15774,10757,3440,11001,21758,11112,21880
Ȫ·ֵ´,XinQuanLuJieDaoBanShiChu,140203016,13061,1799,8400,6134,11654,8400,2400,8598,16998,8860,17260
ʤֵ´,MinShengJieDaoBanShiChu,140203017,14318,1768,9171,6397,13167,9133,2410,9238,18371,9325,18496
Ȫֵ´,KouQuanJieDaoBanShiChu,140203018,24109,3349,15887,11660,18324,15782,4554,15969,31751,16125,32012
ڽֵ´,MaKouJieDaoBanShiChu,140203019,3121,146,1825,1236,2061,1793,684,1976,3769,2126,3951
ɽֵ´,YanZiShanJieDaoBanShiChu,140203020,10829,456,6408,4380,11228,6408,2138,7015,13423,7015,13423
Ӷֵ´,XingErGouJieDaoBanShiChu,140203021,3881,86,2179,1355,1632,2154,784,2348,4502,2572,4751
Ҥֵ´,QingCiYaoJieDaoBanShiChu,140203022,5819,430,3857,2521,3702,3857,1328,3720,7577,3720,7577
ƽȪ·ֵ´,PingQuanLuJieDaoBanShiChu,140203023,50326,4119,31851,22224,45199,31783,9473,32006,63789,32067,63918
ֵ̨´,SiTaiGouJieDaoBanShiChu,140203024,6693,500,4225,2796,5930,4223,1620,4343,8566,4588,8813
˳ֵ´,HeShunJieDaoBanShiChu,140203025,33884,4075,22039,15408,14951,22035,6841,22743,44778,22761,44800
ֵ´,HeRuiJieDaoBanShiChu,140203026,38283,5268,25839,17723,15499,25814,8530,26203,52017,26242,52081
ŵ,GuDianZhen,140211100,11093,1135,7572,5409,7900,7571,3216,7827,15398,7872,15444
ɽ,GaoShanZhen,140211101,10584,1073,6887,4836,11132,6887,2230,6990,13877,7000,13887
Ƹ,YunGangZhen,140211102,15031,1154,9705,6719,11550,9705,3581,10032,19737,10061,19766
Ȫ,KouQuanXiang,140211200,43221,3993,26456,18095,33481,25460,9834,27155,52615,30592,57048
,XinWangXiang,140211201,31610,1771,20035,14104,13368,19847,7353,20195,40042,20699,40734
ˮ,ShuiBoSiXiang,140211202,65165,3881,41938,21326,57891,32013,13312,33254,65267,40420,82358
Ӫ,MaJunYingXiang,140211205,72269,3556,46269,31569,32441,45956,20042,48137,94093,49598,95867
,XiHanLingXiang,140211206,22136,2400,14372,9524,20362,13888,5297,14712,28600,15461,29833
ƽ,PingWangXiang,140211207,31854,2204,20655,13396,20545,20644,8162,21464,42108,21565,42220
ѻ,YaErYaXiang,140211210,6838,730,4257,3420,7431,4257,1139,4435,8692,4450,8707
,XinRongZhen,140212100,9254,993,6290,4647,11321,6289,2572,6526,12815,6529,12819
³,PoLuBaoXiang,140212200,6913,873,4507,2904,8927,4507,1469,4738,9245,4748,9255
Ҥ,GuoJiaYaoXiang,140212202,8862,1315,5661,4118,11640,5624,1907,6292,11916,6423,12084
Ԫ,HuaYuanTunXiang,140212203,10771,1821,7242,5548,13284,7242,2518,7810,15052,7868,15110
,XiCunXiang,140212206,7885,956,5050,3701,7509,5032,1813,5340,10372,5604,10654
,ShangShenJianXiang,140212207,8553,809,5412,3724,8778,5371,1908,5638,11009,5858,11270
,BuZiWanXiang,140212209,10776,1509,6998,4942,12636,6972,2485,7603,14575,7772,14770
,XinRongQuSheQuJianSheGuanLiFuWuZhongXin,140212400,16639,735,11019,6749,8089,10624,5146,10916,21540,11501,22520
Ȫ,LongQuanZhen,140221100,70441,7399,48039,30912,74637,45556,18009,45005,90561,47810,95849
,LuoWenZaoZhen,140221101,19499,2991,13162,8530,24094,13048,4552,13591,26639,13880,27042
׵,DaBaiDengZhen,140221102,13911,1887,9275,6263,17481,9274,3071,9565,18839,9594,18869
,WangGuanTunZhen,140221103,14781,2301,9848,6033,18435,9671,3406,10478,20149,10640,20488
ų,GuChengZhen,140221104,12416,1894,8505,5662,16408,8505,3354,9120,17625,9159,17664
С,DongXiaoCunZhen,140221105,7640,1265,5194,3509,10176,5191,1779,5451,10642,5490,10684
,YouZaiZhen,140221106,6459,1226,4297,3302,8051,4284,1332,4689,8973,4720,9017
,ChangChengXiang,140221201,3929,602,2585,1844,4933,2561,798,2663,5224,2744,5329
,BeiXuTunXiang,140221202,11827,1421,7966,4592,14989,7965,2561,7842,15807,7843,15809
ʨ,ShiZiTunXiang,140221204,10128,1619,6943,4783,13070,6943,2453,7233,14176,7257,14200
,XiaShenJingXiang,140221209,9566,1592,6514,4586,12634,6514,2068,6712,13226,6712,13226
,MaJiaZaoXiang,140221211,10139,1523,7060,4475,13638,7060,2549,7151,14211,7151,14211
ʯ,AoShiXiang,140221212,7331,1170,4894,3521,9237,4889,1599,5183,10072,5206,10100
Ȫ,YuQuanZhen,140222100,48104,4897,33437,25073,52652,32916,14448,33651,66567,34012,67449
ǰ,GuQianBaoZhen,140222101,14220,1800,9624,6264,17494,9528,3401,9634,19162,9797,19421
н,MiXinGuanZhen,140222102,12827,1816,8972,5064,16629,8972,2736,8396,17368,8407,17379
ּ,LuJiaWanZhen,140222103,9318,1658,6333,3939,11835,6289,1923,6215,12504,6566,12899
ƽ,XinPingZhen,140222104,8722,1603,5709,3856,10866,5681,1783,5892,11573,6399,12108
ئ,SaLiPuXiang,140222200,15713,2189,10926,6599,19881,10924,3644,10597,21521,10620,21546
Ϻӱ,NanHeBaoXiang,140222202,16513,2060,11172,7395,20829,11171,3609,11009,22180,11010,22182
ּ,JiaJiaTunXiang,140222204,6386,1011,4542,2648,8518,4542,1371,4226,8768,4226,8768
Լҹ,ZhaoJiaGouXiang,140222206,4213,838,2957,2049,5642,2953,912,2977,5930,3006,5963
ϸ,NanGaoYaXiang,140222208,4890,779,3372,1932,6481,3371,919,3206,6577,3216,6588
,ZhangXiHeXiang,140222209,8640,1208,5863,3339,11081,5839,1858,5745,11584,5843,11706
Ȫ,HuQuanZhen,140223100,48108,4495,32471,21630,50609,31389,13668,33090,64479,33800,66271
ϴ,NanCunZhen,140223101,18542,2409,12551,7447,24167,12321,4759,12809,25130,13159,25710
Ȫ,DouQuanXiang,140223200,7000,891,5103,3049,9783,5103,2658,5445,10548,5446,10549
ɽ,JiaoShanXiang,140223202,12044,1409,7671,4787,14289,7605,3546,8362,15967,9328,16999
Ӷ,JiaDouXiang,140223203,11611,1502,7986,4862,15571,7984,3435,8558,16542,8562,16548
,YiXingXiang,140223206,7928,1103,5324,3528,10120,5323,2164,5856,11179,5871,11195
,ZuoTuanXiang,140223207,13288,1743,9001,5580,17457,9001,3632,9662,18663,9662,18663
ׯ,LiangZhuangXiang,140223209,7579,985,5279,3449,10250,5278,2203,5449,10727,5488,10767
,WangHuXiang,140223211,4321,558,2894,1893,5681,2894,1032,2984,5878,3017,5911
,WuLingZhen,140224100,88239,7112,57795,40281,93964,55534,25759,60196,115730,63315,121110
,DongHeNanZhen,140224101,18607,2249,12838,8055,24602,12838,5227,13232,26070,13245,26083
կ,ShangZhaiZhen,140224102,10465,1373,7042,4562,13915,7024,2954,7623,14647,7750,14792
ˮ,LuoShuiHeXiang,140224200,15408,1919,9859,6614,19174,9809,4044,10946,20755,11512,21371
ʷׯ,ShiZhuangXiang,140224203,3561,522,2328,1733,4546,2328,832,2577,4905,2587,4915
Ա,ZhaoBeiXiang,140224205,8089,1102,5404,3277,10463,5353,1814,5469,10822,5601,11005
ʯ,ShiJiaTianXiang,140224206,5040,690,3377,2203,6603,3372,1361,3698,7070,3714,7091
,LiuKeXiang,140224207,4107,522,2673,1857,5427,2662,1083,2919,5581,3039,5712
̨,BaiYaTaiXiang,140224208,2851,510,1962,1370,3928,1959,662,2050,4009,2061,4023
ʯܨ,HongShiLengXiang,140224210,2381,308,1555,1202,2964,1544,597,1711,3255,1731,3286
¹,XiaGuanXiang,140224212,4721,708,3217,2190,5983,3179,1349,3283,6462,3561,6778
,DuYuXiang,140224213,5642,804,3495,2368,6793,3439,1392,3703,7142,4343,7838
,YongAnZhen,140225100,91732,8603,62378,36986,96596,58067,22516,57547,115614,60473,122851
�,XiFangChengZhen,140225101,9884,1285,6838,4049,13080,6836,2728,7052,13888,7059,13897
̴,CaiCunZhen,140225102,9288,1080,6231,4216,12138,6215,2306,6322,12537,6443,12674
ɳ,ShaGeTuoZhen,140225103,17854,1987,11634,6965,22639,11614,4392,12078,23692,12599,24233
ׯ,WangZhuangBaoZhen,140225104,12373,1268,8368,5038,16606,8303,3391,8523,16826,8664,17032
Ҥ,DaCiYaoZhen,140225105,4352,488,2760,1810,5090,2728,1009,2649,5377,3089,5849
,DongFangChengXiang,140225201,20943,2200,13827,7557,24831,13598,4802,13463,27061,14118,27945
,PeiCunXiang,140225203,11438,1429,7746,4863,14881,7741,2862,7945,15686,7983,15729
շ,TuoFengXiang,140225204,7542,1044,5155,3051,9730,5155,1812,5243,10398,5243,10398
,XiLiuCunXiang,140225205,8275,1059,5762,3505,10611,5762,2147,5719,11481,5719,11481
º,XiaHanCunXiang,140225206,6539,858,4440,2814,8116,4429,1650,4481,8910,4607,9047
,NanYuLinXiang,140225208,7141,994,4314,3126,8023,4269,1309,4549,8818,5130,9444
,WuChengXiang,140225210,5880,800,3947,2420,7767,3942,1329,4048,7990,4062,8009
ƻ̲,HuangHuaTanXiang,140225212,7967,652,4722,2683,8831,4659,1641,4398,9057,5538,10260
ׯ,DaRenZhuangXiang,140225213,5591,517,3514,1922,6667,3485,1208,3344,6829,3802,7316
ǧ,QianFoLingXiang,140225215,12527,1222,7982,4070,15032,7895,2865,7515,15410,8632,16614
ٶ,GuanErXiang,140225218,8204,972,5518,3079,10868,5518,1733,5391,10909,5391,10909
Ҥ,QingCiYaoXiang,140225220,7307,787,4855,2911,9038,4831,1704,4651,9482,4943,9798
,YunXingZhen,140226100,54631,4170,36237,26158,51372,36065,14609,36698,72763,37173,73410
ȵɽ,QueErShanZhen,140226101,9116,670,5869,4018,7964,5869,2162,6075,11944,6079,11948
,DianWanZhen,140226102,9666,795,6290,4511,9446,6287,2318,6489,12776,6489,12779
ܼұ,GuanJiaBaoXiang,140226200,6689,986,4427,3123,8423,4427,1099,4347,8774,4347,8774
żҳ,ZhangJiaChangXiang,140226201,9042,1158,6103,4805,10847,6101,1922,6009,12110,6019,12122
,SanTunXiang,140226205,8868,1150,5836,4176,11546,5826,1782,5929,11755,5964,11800
ͷ,MaDaoTouXiang,140226206,7548,935,4960,3671,9354,4960,1604,5127,10087,5127,10087
Сׯ,XiaoJingZhuangXiang,140226207,7428,1092,4782,3462,9396,4771,1350,4862,9633,5088,9870
ˮҤ,ShuiYaoXiang,140226209,4127,404,2661,1684,4939,2661,842,2709,5370,2712,5373
ƺ,XiPingZhen,140227100,20091,2049,13285,8757,18828,13094,5592,14100,27194,14447,27732
,BeiJiaZaoZhen,140227101,13486,1421,9227,5659,14766,9137,3832,9398,18535,9512,18739
ʿׯ,ZhouShiZhuangZhen,140227102,12506,1735,8210,5230,13409,8120,3379,8582,16702,9410,17620
ׯ,JiJiaZhuangXiang,140227201,5107,1197,3469,2472,6631,3464,1002,3779,7243,3837,7306
,FengYuXiang,140227202,5183,1121,3556,2305,6704,3555,1021,3742,7297,3769,7325
ׯ,DuZhuangXiang,140227204,8661,1335,5667,3798,10512,5664,1840,6142,11806,6169,11836
ׯ,DangLiuZhuangXiang,140227205,9319,1238,6022,4077,10805,6007,2399,6608,12615,6934,12956
԰,GuaYuanXiang,140227207,4817,950,3385,2091,6011,3354,1067,3441,6795,3449,6834
,JuLeXiang,140227209,4839,1006,3175,2021,5890,3158,987,3383,6541,3657,6832
�,XuBaoXiang,140227211,11716,2115,7819,5426,14890,7813,2691,8657,16470,8703,16522
ü�,JingJiJiShuKaiFaQu,140227400,12320,682,7937,4741,7345,7122,3159,7424,14546,8224,16161
´,HuDongBanShiChu,140227401,2586,114,1312,1037,513,1298,274,1412,2710,1662,2974
ְ´,DongJieBanShiChu,140227402,17068,929,10097,5945,11446,9453,4538,9859,19312,12438,22535
ְ´,XiJieBanShiChu,140227403,7627,367,5036,3147,4790,5010,2411,5146,10156,5369,10405
վֵ´,ShangZhanJieDaoBanShiChu,140302001,42804,5450,27708,19546,39941,26750,7374,26270,53020,27920,55628
վֵ´,XiaZhanJieDaoBanShiChu,140302002,19356,2467,12623,9079,16557,12392,3374,12111,24503,12574,25197
ֵֽ´,BeiDaJieJieDaoBanShiChu,140302003,27201,2750,17130,11377,19786,15940,4423,15841,31781,17244,34374
ɽ·ֵ´,NanShanLuJieDaoBanShiChu,140302004,50799,4353,32191,21978,41992,30996,9669,30666,61662,32630,64821
微ֵ´,YiJingJieDaoBanShiChu,140302005,7869,846,5051,3602,6059,4951,1676,5007,9958,5340,10391
µ׽ֵ´,PoDiJieDaoBanShiChu,140302006,2037,217,1324,1044,2243,1323,441,1369,2692,1371,2695
ƽ̶ֵֽ´,PingTanJieJieDaoBanShiChu,140303001,40184,5130,26459,17861,39880,25959,6868,25195,51154,25723,52182
ͷֵ´,QiaoTouJieDaoBanShiChu,140303002,34000,3433,21117,14040,33955,21002,6319,21471,42473,22635,43752
ݽֵ´,CaiWaJieDaoBanShiChu,140303003,31796,3202,19903,13664,31560,19850,6087,20512,40362,21182,41085
ֵ´,SaiYuJieDaoBanShiChu,140303004,39361,3514,24550,15922,42321,24392,7682,25055,49447,26007,50557
ɳƺֵ´,ShaPingJieDaoBanShiChu,140303005,26873,2615,16685,11184,28924,16640,5370,17267,33907,18173,34858
ʯֵ´,GuiShiGouJieDaoBanShiChu,140303006,16241,1067,9488,6200,14680,9094,3252,9693,18787,11072,20560
Ӫ,YinYingZhen,140311100,54957,5893,31988,20888,58754,31831,9764,33273,65104,38626,70614
ӵ,HeDiZhen,140311101,34061,4320,19369,13377,37522,19260,5651,20489,39749,24663,44032
微,YiJingZhen,140311102,32744,2660,20206,13583,17649,19907,6807,20874,40781,22005,42211
ƽ̹,PingTanZhen,140311103,23198,2422,14448,9598,15561,14335,4620,15176,29511,15792,30240
,XiNanYuXiang,140311200,9073,1427,5783,3993,11285,5760,1847,6426,12186,6564,12347
ׯ,YangJiaZhuangXiang,140311201,7631,1065,4799,3170,8981,4766,1369,5131,9897,5266,10065
ׯ,LiJiaZhuangXiang,140311202,15172,1603,9315,5856,14636,9110,2672,9508,18618,10132,19447
ɽ,JiuJieXiang,140311203,4719,660,2929,1958,5339,2921,1005,3146,6067,3455,6384
,KaiFaQu,140311450,41553,2037,23732,15251,20088,21625,7125,22172,43797,26983,50715
ɽ,GuanShanZhen,140321100,93628,6323,60640,35875,89981,56891,22724,58055,114946,62035,122675
ұ,YeXiZhen,140321101,10646,1095,6931,4468,12475,6926,2424,7192,14118,7234,14165
,SuoHuangZhen,140321102,23801,2232,15656,9324,30436,15631,5945,16272,31903,16322,31978
ׯ,ZhangZhuangZhen,140321103,29060,3237,18278,11873,36611,18034,6715,19515,37549,20734,39012
,DongHuiZhen,140321104,19769,3015,13675,8680,26887,13672,4951,14058,27730,14060,27735
ؾ,BaiJingZhen,140321105,13549,1852,9399,6063,18538,9288,3874,9696,18984,9876,19275
ӹ,NiangZiGuanZhen,140321106,11901,1653,8197,4953,15632,8171,3007,8319,16490,8364,16561
޳,JuChengZhen,140321107,19600,2790,12988,8999,25856,12651,4628,13493,26144,14030,27018
ʯſ,ShiMenKouXiang,140321200,12766,1564,8349,5164,15638,8267,3144,8746,17013,9125,17474
,ChaKouXiang,140321201,14528,2142,8212,5827,16702,7909,2702,8968,16877,11160,19372
ˮ,XiuShuiZhen,140322100,71313,5822,44925,28686,69816,44019,15878,44883,88902,48088,93013
ׯ,SunJiaZhuangZhen,140322101,20548,2053,12963,7814,22005,12668,4297,12920,25588,13935,26898
·Ҵ,LuJiaCunZhen,140322102,18837,1834,11344,6332,21496,10921,3908,10956,21877,13235,24579
¦,NanLouZhen,140322103,23702,2359,14350,8923,26636,13699,5126,13869,27568,16837,31187
ţ,NiuCunZhen,140322104,14363,1807,9342,5795,17338,9333,3110,9562,18895,9938,19280
ɳ,ChangChiZhen,140322105,17868,2477,11965,7219,22526,11953,3893,12151,24104,12273,24238
,ShangSheZhen,140322106,10593,1805,7162,4878,13878,7161,2080,7315,14476,7316,14478
,XiYanZhen,140322107,13231,2006,8959,5781,17859,8942,3189,9429,18371,9467,18426
,XianRenXiang,140322200,9647,1540,6238,4276,11931,6228,1964,6781,13009,6913,13151
ׯ,BeiXiaZhuangXiang,140322201,8174,1214,5397,3451,10141,5333,1597,5499,10832,5588,10985
,XiaSheXiang,140322202,5616,880,3736,2303,7423,3656,1254,3808,7464,4014,7750
կ,LiangJiaZhaiXiang,140322203,6603,1097,4502,3007,9125,4369,1645,4638,9007,4843,9345
,XiPanXiang,140322204,5802,941,3689,2594,7800,3688,1240,4293,7981,4294,7983
,DongLiangXiang,140322205,6953,1057,4503,3085,8828,4394,1759,4764,9158,5266,9769
ֵֽ´,DongJieJieDaoBanShiChu,140402001,42070,2929,28022,12322,40825,19481,6600,18374,37855,23577,51599
ֵֽ´,XiJieJieDaoBanShiChu,140402002,38243,2878,23769,14375,39971,22697,7496,22493,45190,24848,48617
Ӣ·ֵ´,YingXiongNanLuJieDaoBanShiChu,140402003,32278,3039,21328,12503,30453,19950,6338,19178,39128,20327,41655
Ӣ·ֵ´,YingXiongZhongLuJieDaoBanShiChu,140402004,27850,2081,17029,9842,23949,15098,4725,14356,29454,17627,34656
Ͻֵֽ´,ZiJinJieJieDaoBanShiChu,140402005,25875,2617,16887,10653,27077,16557,4965,16273,32830,16570,33457
̫жֵֽ´,TaiHangDongJieJieDaoBanShiChu,140402006,44829,2465,27428,12262,42113,18675,6046,17654,36329,25912,53340
ֵֽ̫´,TaiHangXiJieJieDaoBanShiChu,140402007,29760,2890,18905,12228,28199,17814,5136,17346,35160,18881,37786
Ӱ·ֵ´,YanAnNanLuJieDaoBanShiChu,140402008,44256,5937,28469,18381,48785,26619,6951,26183,52802,28675,57144
ֵ´,ChangQingJieDaoBanShiChu,140402009,37567,1920,22789,14362,27732,22063,7531,22417,44480,24229,47018
ֵ´,WuMaJieDaoBanShiChu,140402010,25562,1878,16062,8572,21989,14986,5098,15089,30075,16476,32538
θ¼�,ChangZhiGaoXinJiShuKaiFaQu,140402400,36177,2071,23053,14305,28546,22088,7570,21877,43965,22765,45818
ֵ´,ChangBeiJieDaoBanShiChu,140411001,19783,2987,13485,9099,21667,11777,2917,11579,23356,12202,25687
ؽֵ´,GuXianJieDaoBanShiChu,140411002,53420,3959,31058,19482,61150,30209,9599,30604,60813,35920,66978
϶ɽ,LaoDingShanZhen,140411100,30420,2537,19357,10082,32849,19232,6379,19499,38731,19979,39336
ܩׯ,HouBeiZhuangZhen,140411101,30789,2269,20264,10022,36045,20158,7948,20407,40565,20742,41006
ׯ,DaXinZhuangZhen,140411102,23100,1717,14953,7661,21907,14677,5222,14846,29523,15086,30039
�,MaChangZhen,140411103,25433,2012,16429,8678,30084,16308,5996,16782,33090,17012,33441
,HuangNianZhen,140411104,27114,2240,17090,8722,28132,16973,6141,17558,34531,18405,35495
,XiBaiTuXiang,140411200,6917,619,4378,2346,7976,4357,1695,4745,9102,4853,9231
,HanDianZhen,140421100,54177,3367,35446,18956,50547,32522,12025,31415,63937,34123,69569
յ,SuDianZhen,140421101,33045,2880,20523,10806,34915,19770,6807,19708,39478,22209,42732
,YinChengZhen,140421102,34484,2966,22653,12448,43688,21748,7987,21437,43185,22784,45437
,XiHuoZhen,140421103,18276,1604,12321,6491,23435,12284,5065,12224,24508,12624,24945
,BaYiZhen,140421104,17589,1668,11779,6204,21710,11771,4070,11433,23204,11548,23327
,JiaZhangZhen,140421105,11663,1111,7683,4251,14854,7683,2715,7806,15489,7806,15489
¼ׯ,HaoJiaZhuangXiang,140421200,19994,1599,13267,6817,23891,13249,4887,12992,26241,13213,26480
,XiChiXiang,140421201,17048,1656,11214,6673,21517,11209,3988,11424,22633,11478,22692
,BeiChengXiang,140421202,16374,1598,10834,5863,20395,10794,3629,10608,21402,10767,21601
,DongHeXiang,140421203,14840,1480,9880,5614,18476,9880,3270,9708,19588,9710,19590
,NanSongXiang,140421204,13384,1140,8524,4386,16256,8516,3095,8274,16790,9095,17619
԰,KaiFaYuanQu,140421406,8785,737,5667,2794,9744,5631,1960,5674,11305,5815,11482
ź,GuHanZhen,140423100,62444,5286,39782,21584,74956,39279,14595,40499,79778,42543,82325
,WangQiaoZhen,140423101,25612,2476,15535,8837,31122,15322,5506,16322,31644,18059,33594
,HouBaoZhen,140423102,34308,2674,21102,12636,34487,19899,7378,20744,40643,23258,44360
ĵ,XiaDianZhen,140423103,21475,2261,13752,7874,24534,13594,5093,14416,28010,15077,28829
̌ͤ,TiTingZhen,140423104,11091,1480,7307,4528,14060,7285,2576,7763,15048,7840,15147
Ӫ,XiYingZhen,140423105,7421,1036,4931,2989,9455,4884,1865,5267,10151,5391,10322
,WangCunZhen,140423106,10569,1425,6747,4416,13178,6742,2279,7526,14268,7526,14273
,XiaLiangZhen,140423107,11843,1403,7443,4405,14432,7397,2698,7848,15245,8501,15944
Ƹ,ShanFuXiang,140423200,7191,701,4537,2541,8499,4535,1677,4791,9326,5032,9569
,BeiDiXiang,140423201,6360,707,3980,2186,7194,3835,1460,4305,8140,4547,8527
,ShangMaXiang,140423202,5396,711,3479,2237,6823,3454,1219,3821,7275,3847,7326
,LinJiangZhen,140424100,37124,2667,24652,13393,38739,23332,9697,23273,46605,24836,49488
ϴ,ShangCunZhen,140424101,15398,1283,10102,5796,19038,10079,4061,10214,20293,10640,20742
,YuZeZhen,140424102,20608,1027,11535,6643,19673,11267,4357,11623,22890,14457,25992
,YuWuZhen,140424103,13591,1231,8859,5145,16999,8814,3664,9235,18049,9627,18486
Ԫ,WuYuanZhen,140424104,11557,1185,7419,4613,15100,7400,2788,8048,15448,8111,15530
ŵ,ZhangDianZhen,140424105,15936,1470,10021,5789,20365,10020,3635,11006,21026,11020,21041
,FengYiZhen,140424106,6967,672,4554,2562,9078,4553,1758,4841,9394,4843,9397
,LiGaoXiang,140424200,11926,1111,7900,4268,15136,7861,2964,8014,15875,8101,16001
·,LuCunXiang,140424201,24484,1993,15629,8193,28756,15487,6141,15954,31441,16989,32618
,HeShenMiaoXiang,140424202,12734,1213,8227,4604,16450,8227,3052,8746,16973,8772,16999
,XiJiaXiang,140424203,11546,874,7481,3292,12155,6239,2528,6492,12731,7467,14948
կ,XiLiuZhaiKaiFaQu,140424400,3256,399,2142,1345,4281,2142,703,2201,4343,2216,4358
ׯҵ԰,KangZhuangGongYeYuanQu,140424401,10477,751,6919,3422,13317,6873,2942,6988,13861,7251,14170
,ShangLianKaiFaQu,140424402,3111,340,1903,1266,3834,1882,623,2138,4020,2171,4074
,QingYangZhen,140425100,25739,1881,16736,10210,26353,16291,6478,16016,32307,17362,34098
Ϫ,LongXiZhen,140425101,13110,1216,8562,5015,17043,8352,3296,8600,16952,9060,17622
ʯ,ShiChengZhen,140425102,9524,921,6033,3936,11995,5896,2218,6343,12239,6630,12663
ׯ,MiaoZhuangZhen,140425103,6551,650,4162,2304,8350,4086,1518,4261,8347,4557,8719
ӳ,XingChengZhen,140425104,8863,929,5855,3531,11556,5752,2074,5686,11438,6011,11866
,XiGouXiang,140425200,5240,554,3396,2013,6725,3393,1068,3461,6854,3466,6862
ͷ,DongSiTouXiang,140425201,6857,871,4431,2829,8737,4351,1276,4144,8495,4573,9004
ݹ,HongTiGuanXiang,140425202,5947,733,3593,2378,7040,3509,1100,3570,7079,4187,7780
,YangGaoXiang,140425203,6761,689,4225,2874,8675,4189,1337,4518,8707,4562,8787
,BeiDanCheXiang,140425204,7238,896,4561,3141,9459,4508,1442,4894,9402,5015,9576
微,ZhongWuJingXiang,140425205,5708,550,3693,2275,7390,3690,1182,3745,7435,3747,7440
,BeiSheXiang,140425206,12597,1354,7949,4968,16218,7905,2587,8474,16379,8589,16538
,LiHouZhen,140426100,40841,3295,27953,17429,41629,26792,12768,27477,54269,28951,56904
,DongYangGuanZhen,140426101,10626,1428,7219,4603,14444,7128,3247,7742,14870,8082,15301
ң,ShangYaoZhen,140426102,12655,1515,8164,5245,16492,8135,3054,8854,16989,9060,17224
,XiJingZhen,140426103,18641,1971,12333,7982,24950,12241,5179,13079,25320,13458,25791
¶,HuangYaDongZhen,140426104,9931,862,6779,3736,13294,6760,3064,6906,13666,7078,13857
,XiWuXiang,140426200,5331,598,3377,1999,6422,3340,1378,3550,6890,3930,7307
ͣ,TingHePuXiang,140426201,5359,706,3661,2359,6604,3644,1517,3801,7445,3921,7582
̼ɽ,ChengJiaShanXiang,140426202,4334,825,2908,2158,5898,2893,1076,3190,6083,3327,6235
龮,HongJingXiang,140426203,6053,775,3970,2532,7950,3949,1512,4246,8195,4370,8340
Ȫ,LongQuanZhen,140427100,54791,3795,37707,20517,55481,35995,16025,34995,70990,36904,74611
ٳ,BaiChiZhen,140427101,23759,2181,16314,8388,31651,16219,6559,15975,32194,16185,32499
,DianShangZhen,140427102,21185,2305,14286,7405,28237,14173,5353,14219,28392,14557,28843
ׯ,JinZhuangZhen,140427103,17882,1833,12527,6777,24207,12527,5133,12314,24841,12321,24848
,ShuZhangZhen,140427104,8114,945,5383,3207,10787,5383,1998,5674,11057,5674,11057
,JiDianXiang,140427200,18138,1769,12261,5980,23805,12114,4982,12306,24420,12628,24889
ɽ,HuangShanXiang,140427201,19141,1805,12840,6729,25231,12769,5045,12858,25627,13151,25991
,DongJingLingXiang,140427202,12999,1356,8700,4636,17032,8700,3245,8898,17598,8900,17600
ʯ,ShiPoXiang,140427203,8997,1061,6405,3577,12406,6370,2643,6179,12549,6296,12701
ɽ,WuLongShanXiang,140427204,6492,770,4525,2625,8781,4521,1761,4490,9011,4498,9023
,EWuXiang,140427205,5477,627,3946,2174,7662,3946,1714,3870,7816,3872,7818
,QiaoShangXiang,140427206,6369,705,4264,2582,8287,4198,1547,4127,8325,4357,8621
ƽÿ,ChangPingJingJiKaiFaQu,140427400,10228,596,6076,2698,9617,5233,2284,5309,10542,7032,13108
,DanZhuZhen,140428100,68909,5867,43578,18924,75678,34867,14767,34916,69783,45965,89543
,BaoDianZhen,140428101,16899,1454,11165,5643,22099,11138,4332,11462,22600,11520,22685
ʯ,ShiZheZhen,140428102,20942,2159,13580,8358,26633,13564,4542,13994,27558,14063,27643
ͷ,DaBaoTouZhen,140428103,27340,2448,18039,9472,34860,17969,6768,18247,36216,18517,36556
,CiLinZhen,140428104,26465,1905,14903,7989,26250,13907,4857,13605,27512,18324,33227
ɫͷ,SeTouZhen,140428105,14699,1174,9374,4977,18060,9062,3404,8785,17847,9903,19277
,NanZhangZhen,140428106,18688,1542,12389,6677,23418,12294,4530,11979,24273,12371,24760
ˮ,LanShuiXiang,140428200,11769,1252,7847,4278,15626,7818,2927,8047,15865,8101,15948
,NianZhangXiang,140428201,9999,1161,6680,3574,13189,6668,2506,6904,13572,6986,13666
,ChangZhangXiang,140428202,11456,1184,7483,3876,14848,7481,2589,7745,15226,7746,15229
ϳ,NanChenXiang,140428203,15489,1507,9976,5423,19435,9970,3360,10244,20214,10380,20356
δ,SongCunXiang,140428204,25555,2068,17128,8476,33612,17112,6753,17207,34319,17248,34376
,FengZhouZhen,140429100,35454,2859,24411,15642,37620,23722,11281,24183,47905,25183,49594
ˮ,HongShuiZhen,140429101,16248,2011,10488,6841,21319,10259,4249,11418,21677,12020,22508
,PanLongZhen,140429102,15205,2001,9990,6416,20454,9857,4022,10983,20840,11238,21228
,JianZhangZhen,140429103,6382,866,4131,2582,8305,4094,1435,4523,8617,4552,8683
ʳ,GuChengZhen,140429104,11285,1430,7316,4683,15110,7249,3146,8432,15681,8545,15861
ī,MoDengXiang,140429200,5726,543,3305,2141,6575,3232,1335,3380,6612,4299,7604
,HanBeiXiang,140429201,8155,998,5041,3186,10013,5014,1944,5515,10529,6056,11097
,DaYouXiang,140429202,8055,940,5061,3042,10683,5032,1922,5804,10836,5856,10917
ֻ,JiaHuoXiang,140429203,3737,802,2511,2267,5137,2496,803,2815,5311,2831,5342
,GuXianXiang,140429204,3162,389,2000,1252,4157,2000,747,2298,4298,2298,4298
˾,ShangSiXiang,140429205,5089,724,3237,2147,6872,3205,1183,3683,6888,3759,6996
ʯ,ShiBeiXiang,140429206,3403,486,2127,1465,4486,2105,800,2531,4636,2562,4689
ӿȪ,YongQuanXiang,140429207,5453,630,3537,2171,7210,3495,1520,4019,7514,4066,7603
ˮ,FenShuiLingXiang,140429208,4599,650,2382,1714,5124,2311,880,2970,5281,3747,6129
,DingChangZhen,140430100,41400,3308,28923,15755,45271,26135,12356,26343,52478,28141,57064
,GuoCunZhen,140430101,8022,1094,5181,3328,10371,5170,1910,5825,10995,5845,11026
,GuXianZhen,140430102,9699,1133,5943,3572,12327,5895,2171,7003,12898,7060,13003
µ,XinDianZhen,140430103,10760,1401,6990,4433,13820,6760,2677,7462,14222,7848,14838
Դ,ZhangYuanZhen,140430104,9603,1299,6090,3988,12765,6030,2465,7187,13217,7277,13367
,CeCunZhen,140430105,9691,1187,6101,3571,12365,6021,2306,6901,12922,7083,13184
,DuanLiuXiang,140430200,11465,1308,7296,4338,13352,7224,2493,7857,15081,7970,15266
ɴ,SongCunXiang,140430201,7748,936,4821,3288,10083,4805,1822,5660,10465,5685,10506
δ,CiCunXiang,140430202,2958,426,1797,1185,3764,1760,487,2059,3819,2074,3871
ţ,NiuSiXiang,140430203,4362,634,2731,1856,5742,2664,1068,3245,5909,3333,6064
,NanLiXiang,140430204,5980,704,3704,2254,7509,3629,1257,4125,7754,4237,7941
Ȫ,NanQuanXiang,140430205,2317,274,1359,868,2857,1320,447,1624,2944,1679,3038
,YangAnXiang,140430206,2317,275,1376,919,2804,1351,445,1608,2959,1661,3037
ߺ,QinHeZhen,140431100,37810,2313,24843,15010,34940,23590,10020,23962,47552,25300,50143
,GuoDaoZhen,140431101,12688,1335,8241,5317,15149,8225,3175,8906,17131,8957,17198
ɽ,LingKongShanZhen,140431102,7739,534,3752,2549,6940,3575,1338,4046,7621,5859,9611
,WangHeZhen,140431103,7994,1127,5023,3144,9971,4889,2002,5516,10405,6100,11123
Ԫ,LiYuanZhen,140431104,11913,700,5375,3247,8721,4498,2082,5122,9620,9320,14695
,ZhongYuXiang,140431200,3554,372,2220,1546,4507,2200,798,2462,4662,2504,4724
,FaZhongXiang,140431201,5858,706,3685,2261,7472,3547,1153,3895,7442,4032,7717
,JiaoKouXiang,140431202,5874,652,3590,2236,7405,3480,1235,4055,7535,4171,7761
,CongZiYuXiang,140431203,5044,401,2596,1642,4650,2454,996,2850,5304,3845,6441
,HanHongXiang,140431204,6336,760,3912,2754,8067,3899,1217,4353,8252,4401,8313
̲,GuanTanXiang,140431205,2551,312,1532,996,3362,1532,578,1909,3441,1909,3441
,JingFengXiang,140431206,1531,293,893,655,2017,890,253,1170,2060,1184,2077
ʯ,ChiShiQiaoXiang,140431207,4362,717,2726,1753,5725,2713,858,3157,5870,3211,5937
,WangTaoXiang,140431208,6741,832,4185,2764,8054,4098,1948,4693,8791,5336,9521
ºֵ´,LuHuaJieDaoBanShiChu,140481001,56315,3361,35317,19509,49246,32828,13768,32563,65391,38127,73444
ɼҴֵ´,ChengJiaChuanJieDaoBanShiChu,140481002,21402,2495,14187,9364,26984,14179,4807,14459,28638,14517,28704
,DianShangZhen,140481100,23353,1853,14845,8110,26496,14593,6108,15367,29960,16469,31314
΢,WeiZiZhen,140481101,13732,1628,9257,5354,17136,9227,3489,9362,18589,9592,18849
Ȫ,XinAnQuanZhen,140481102,8850,1099,6121,3723,11847,6120,2495,6302,12422,6323,12444
Ե,ZhaiDianZhen,140481103,15985,1348,10776,5303,20047,10766,4484,11030,21796,11041,21817
,HeShiXiang,140481200,6069,764,4008,2464,7766,4007,1442,4262,8269,4267,8275
ţ,HuangNiuTiXiang,140481201,9397,1083,6344,3711,12353,6342,2385,6496,12838,6521,12865
ʷ,ShiHuiXiang,140481202,14233,1229,9187,4907,17588,9175,3700,9750,18925,9975,19162
ֵֽ´,DongJieJieDaoBanShiChu,140502001,43681,2545,27570,16049,33682,24207,8445,23432,47639,27101,54671
ֵֽ´,XiJieJieDaoBanShiChu,140502002,44652,2382,29234,18883,29339,27757,10757,27057,54814,28557,57791
Ͻֵֽ´,NanJieJieDaoBanShiChu,140502003,40599,1529,25963,16754,28698,24482,9819,24661,49143,25984,51947
ֵֽ´,BeiJieJieDaoBanShiChu,140502004,32045,2465,21038,12951,25350,19188,7413,18961,38149,20885,41923
ֵ´,KuangQuJieDaoBanShiChu,140502005,37183,3677,22904,14737,42740,22396,6652,21830,44226,24608,47512
Ӽׯ´,ZhongJiaZhuangBanShiChu,140502006,88166,3308,54223,33554,60885,49173,19604,48809,97982,56855,111078
ׯ´,XiShangZhuangBanShiChu,140502007,28178,1811,17803,10856,23976,17313,6471,17613,34926,18657,36460
ʯ,BeiShiDianZhen,140502100,25638,1652,16363,10764,21395,16206,6117,16267,32473,17044,33407
,KaiFaQu,140502400,37720,984,21556,5323,16073,8989,3452,8941,17930,20600,42156
,LongGangZhen,140521100,45167,3430,29127,18392,43059,27954,10063,26893,54847,29533,58660
д,ZhongCunZhen,140521101,9969,894,6086,4037,11443,5762,2190,6026,11788,6967,13053
֣ׯ,ZhengZhuangZhen,140521102,11188,1323,6708,4936,13183,6535,1881,6817,13352,7684,14392
,DuanShiZhen,140521103,23199,1856,13957,9331,22858,13040,4479,13087,26127,15577,29534
η,JiaFengZhen,140521104,30849,1500,16164,10617,22104,14883,5727,15673,30556,21912,38076
֣,ZhengCunZhen,140521105,11979,965,7570,4719,13764,7345,3048,7104,14449,8422,15992
ׯ,ShiZhuangZhen,140521106,7422,885,4685,3127,9347,4674,1261,4747,9421,4883,9568
,FanCunHeXiang,140521200,930,158,528,599,1114,528,65,625,1153,625,1153
,TuWoXiang,140521201,3770,497,2369,1776,4647,2316,619,2392,4708,2517,4886
Ŵ,ZhangCunXiang,140521202,2932,401,1860,1323,3541,1829,492,1862,3691,1965,3825
ׯ,SuZhuangXiang,140521203,1118,157,682,559,1378,676,146,728,1404,739,1421
,HuDiXiang,140521204,6927,776,4092,2789,7750,3935,1232,3908,7843,4843,8935
,GuXianXiang,140521205,4831,527,3023,2036,5817,2976,856,2988,5964,3191,6214
ʮ,ShiLiXiang,140521206,5686,771,3535,2694,7084,3476,850,3628,7104,3772,7307
,FengChengZhen,140522100,99471,7019,63849,36323,101092,57453,20470,55852,113305,63111,126960
,BeiLiuZhen,140522101,28331,2444,18478,10967,32229,17954,7026,17673,35627,19323,37801
,RunChengZhen,140522102,25769,2300,16602,8740,32003,15704,5982,15415,31119,17449,34051
,DingDianZhen,140522103,12256,1089,7819,4530,14105,7342,2380,7199,14541,7906,15725
۳,QinChiZhen,140522104,11926,1222,7510,4608,14210,7280,2354,7201,14481,7992,15502
Ӫ,CiYingZhen,140522105,9607,1195,6381,4393,11824,6351,1793,6132,12483,6214,12595
,HengHeZhen,140522106,2960,395,1843,1358,3741,1824,471,1914,3738,1983,3826
ӱ,HeBeiZhen,140522107,9187,1329,6148,4496,11661,6098,1600,5829,11927,5968,12116
,MangHeZhen,140522108,15123,1479,9707,6378,19013,9576,3044,9664,19240,9939,19646
ұ,DongYeZhen,140522109,15734,1569,10208,6731,20184,10083,3228,10044,20127,10323,20531
ɣ,BaiSangXiang,140522200,10607,1184,6857,4226,12622,6781,1941,6706,13487,6875,13732
ͷ,SiTouXiang,140522201,6744,826,4255,2944,8291,4116,1216,4214,8330,4531,8786
,XiHeXiang,140522202,12816,971,8275,4171,13107,7052,2154,6843,13895,7666,15941
,YanLiXiang,140522203,9838,1032,6470,3862,11855,6372,1856,6129,12501,6256,12726
¡,GuLongXiang,140522204,6050,659,3955,2493,7571,3954,1140,3859,7813,3894,7849
,DongFengXiang,140522205,5278,724,3294,2409,6493,3255,715,3318,6573,3423,6717
,JiaLingXiang,140522206,5933,787,3890,2856,7467,3782,1023,3659,7441,3853,7743
ǽֵ´,DongChengJieDaoBanShiChu,140522400,12785,812,8380,4741,14107,7463,2821,7202,14665,8038,16418
ֳ�,LinChangGuanLiChu,140522401,94,21,53,68,123,53,9,71,124,71,124
,ChongWenZhen,140524100,51449,3940,33392,19501,54491,31970,12690,32427,64397,34687,68079
,LiYiZhen,140524101,21029,2056,13948,7918,27419,13812,5323,14117,27929,14460,28408
,FuChengZhen,140524102,19621,2324,13513,8483,25570,13314,4886,13039,26353,13318,26831
ӵ,XiHeDiZhen,140524103,12553,1427,8733,5332,16625,8700,3420,8632,17332,8667,17400
ƽ,PingChengZhen,140524104,15825,1563,10635,6260,20342,10558,4354,10944,21502,11107,21742
,YangCunZhen,140524105,11647,964,8118,4276,15535,8104,3612,8079,16183,8105,16223
º,LuChengZhen,140524106,10879,1085,6693,4260,13898,6639,2344,7458,14097,7615,14308
,DuoHuoXiang,140524204,3041,373,1867,1323,3803,1837,543,2005,3842,2090,3957
ٵ,MaGeDangXiang,140524206,4196,455,2503,1768,5201,2477,787,2812,5289,2935,5438
Ž,GuJiaoXiang,140524207,5814,596,3491,2409,6917,3398,1061,3707,7105,3980,7471
Ȫ,LiuQuanXiang,140524209,7782,986,4950,3551,10036,4926,1658,5371,10297,5476,10426
ؼׯ,QinJiaZhuangXiang,140524212,8138,877,5428,3343,10666,5419,2062,5615,11034,5649,11077
ϴ,NanCunZhen,140525100,38740,2820,22538,12682,34654,20978,7366,20831,41809,26388,48926
´,XiaCunZhen,140525101,35505,2511,22217,13254,40549,21591,8910,21440,43031,24709,46926
󶫹,DaDongGouZhen,140525102,23877,2177,15442,9272,29677,15392,5678,14920,30312,16290,31732
ܴ,ZhouCunZhen,140525103,17647,1835,11709,7442,22288,11465,4001,11289,22754,11774,23483
紨,LiChuanZhen,140525104,10505,1121,7147,4315,14060,7072,2778,7087,14159,7257,14404
,JinMiaoPuZhen,140525105,14000,1255,9416,5290,18818,9297,3852,9454,18751,9691,19107
,JinCunZhen,140525106,40212,3376,24634,13224,45866,23810,8292,23660,47470,27246,51880
߶,GaoDouZhen,140525107,28194,2652,18604,10216,35272,18395,6172,17993,36388,18414,37018
͹,BaGongZhen,140525108,48278,3380,30317,16896,55392,29056,10499,28090,57146,31840,62157
,DaYangZhen,140525109,19655,1798,13286,7565,24395,13235,4832,12844,26079,12999,26285
ɽ,ShanHeZhen,140525110,16724,1800,11151,7204,22221,11150,3876,11241,22391,11249,22400
,DaJiZhen,140525111,13141,1333,8675,5113,16628,8651,2926,8604,17255,8725,17400
,LiuShuKouZhen,140525112,11390,1131,7272,4196,14824,7046,2430,7260,14306,7679,14951
,BeiYiChengZhen,140525113,20818,1844,13954,7368,26497,13800,5035,13510,27310,13743,27697
,ChuanDiXiang,140525200,16075,1434,10524,6221,19916,10292,3982,9953,20245,10967,21491
կ,LiZhaiXiang,140525201,9044,1022,6064,3691,11817,6028,2027,5956,11984,6029,12093
,NanLingXiang,140525202,4465,837,3099,2107,6118,3070,922,3058,6128,3125,6224
ǽֵ´,BeiChengJieDaoBanShiChu,140581001,33618,2367,22184,12712,28236,21094,7574,19970,41064,21375,43559
ǽֵ´,DongChengJieDaoBanShiChu,140581002,32585,1840,21386,11153,22192,19392,7523,18023,37415,20562,41948
ϳǽֵ´,NanChengJieDaoBanShiChu,140581003,51422,3050,33391,16462,41841,29110,11560,27556,56666,32641,66032
ɽ,MiShanZhen,140581101,22348,2301,15210,8345,28429,15102,5257,14098,29200,14696,29906
,SanJiaZhen,140581102,17649,1753,11486,6221,21528,11390,3514,10802,22192,11430,22916
ũ,ShenNongZhen,140581103,15686,1742,10715,6348,19854,10677,3592,10220,20897,10305,21020
,ChenQuZhen,140581104,20028,2002,14633,7926,27426,14627,6156,13499,28126,13553,28186
ʫ,BeiShiZhen,140581105,20356,2395,14448,8254,27400,14381,5573,13630,28011,13876,28324
,HeXiZhen,140581106,32672,2923,22034,11892,40502,21845,7944,20662,42507,21505,43539
,MaCunZhen,140581107,23087,2126,16253,9267,29666,16212,6356,14957,31169,15316,31569
Ұ,YeChuanZhen,140581108,15740,1624,10737,6099,20122,10608,3663,9990,20598,10290,21027
ׯ,SiZhuangZhen,140581109,33632,3111,20411,12314,37276,20022,6193,19517,39539,22525,42936
,JianNingXiang,140581201,13054,1103,8899,5103,16946,8820,3621,8498,17318,8879,17778
ʯĩ,ShiMoXiang,140581202,11165,1313,7531,4402,14365,7448,2815,7388,14836,7762,15293
ԭ,YuanCunXiang,140581203,14155,1371,9646,5448,17565,9490,3698,8819,18309,9578,19224
¼,YongLuXiang,140581204,8809,856,5867,3180,10417,5830,1940,5454,11284,5738,11605
ǽֵ´,BeiChengJieDaoBanShiChu,140602001,59102,2661,37057,21719,52262,32883,14369,35196,68079,39075,76132
ϳǽֵ´,NanChengJieDaoBanShiChu,140602002,77876,4703,49481,31679,38133,47926,23181,50970,98896,56279,105760
ͷֵ´,ShenTouJieDaoBanShiChu,140602003,23146,1642,14574,10137,22071,14028,5710,14886,28914,15924,30498
ׯֵ´,BeiWangZhuangJieDaoBanShiChu,140602004,77494,4026,48827,27147,54829,41224,19277,43359,84583,51970,100797
ͷ,ShenTouZhen,140602100,21816,2832,14416,7850,27222,14407,4810,14862,29269,15042,29458
,LiMinZhen,140602101,6070,980,3595,3013,7877,3592,875,4329,7921,4330,7925
ű,XiaTuanBaoXiang,140602200,18532,1948,11528,6540,19522,11416,4661,11956,23372,13613,25141
Сƽ,XiaoPingYiXiang,140602201,17578,1808,11212,6340,19984,11182,4272,11770,22952,12446,23658
,ZiRunXiang,140602202,9600,1800,6769,3938,13035,6769,2168,6799,13568,6799,13568
ׯ,FuShanZhuangXiang,140602203,8051,1487,5600,3541,11118,5600,2054,5992,11592,5992,11592
,NanYuLinXiang,140602204,5407,1387,3949,2695,7535,3919,1219,3971,7890,4064,8013
ׯ,JiaZhuangXiang,140602205,10306,1405,6735,3881,13310,6689,2572,6987,13676,7548,14283
ɳܨ,ShaLengHeXiang,140602206,10394,1396,6593,4137,12501,6589,2310,6967,13556,7507,14100
Ҥͷ,YaoZiTouXiang,140602207,7459,1108,4913,3247,9683,4892,1628,5201,10093,5282,10195
Ųׯ,ZhangCaiZhuangXiang,140602208,6535,974,4427,2619,8986,4399,1599,4615,9014,4681,9108
˷пί,ShuoZhouShiKaiFaQuGuanWeiHui,140602400,20372,946,13642,5386,13405,8253,3748,8702,16955,11424,25066
ƺ,JingPingZhen,140603100,74608,4685,49355,26980,49843,48120,22004,49652,97772,51942,101297
˳,FengHuangChengZhen,140603101,4177,565,2721,1532,5561,2698,880,2803,5501,2901,5622
,BaiTangXiang,140603200,12584,973,5913,2947,10781,5158,1974,5299,10457,9618,15531
մ,TaoCunXiang,140603201,10226,896,5919,2805,10970,5859,2265,5636,11495,7468,13387
ˮͷ,XiaShuiTouXiang,140603202,5504,730,3301,1963,6559,3264,816,3444,6708,3749,7050
˫,ShuangNianXiang,140603203,3128,365,1906,947,3896,1887,555,2059,3946,2142,4048
転,ZuHuXiang,140603204,4859,590,3181,1736,6493,3181,1105,3373,6554,3373,6554
ʯׯ,GaoShiZhuangXiang,140603205,4704,608,3101,1728,6075,3094,923,3122,6216,3134,6235
ˮ,XiShuiJieXiang,140603206,3337,597,2289,1437,4584,2284,834,2412,4696,2479,4768
,XiaMianGaoXiang,140603207,10855,1519,7020,4627,14260,6972,2381,7300,14272,7735,14755
ľ,XiaMuJiaoXiang,140603208,1700,291,1050,679,2143,1050,250,1190,2240,1191,2241
,XiangYangBaoXiang,140603209,9309,1211,5989,3245,11918,5981,1860,6129,12110,6391,12380
,YuLingXiang,140603210,7458,752,4825,2568,9242,4799,1715,4683,9482,5100,9925
ǹίԱ,DongChengGuanLiWeiYuanHui,140621001,17382,948,11531,7172,14705,11258,5263,11808,23066,12062,23593
ǹίԱ,XiChengGuanLiWeiYuanHui,140621002,34941,1816,22635,13334,28101,20196,9274,21172,41368,23396,46031
,YuJingZhen,140621100,9015,1147,5324,3445,9271,5220,1701,5505,10725,6539,11863
ׯ,BeiZhouZhuangZhen,140621101,16432,1914,9263,4998,16200,8990,3321,9572,18562,12404,21667
ų,GuChengZhen,140621102,13352,1892,8983,5128,16658,8479,3009,8732,17211,9270,18253
Ӫ,WuMaYingXiang,140621200,1769,407,1182,862,2403,1182,279,1266,2448,1273,2455
Ӫ,MaYingXiang,140621201,8101,696,4525,2813,8302,4414,1640,4573,8987,5912,10437
,XiaLaBaXiang,140621202,2272,491,1567,1036,3131,1566,444,1621,3187,1640,3207
ʢ,HeShengBaoXiang,140621203,6328,1101,4229,2510,8109,4192,1432,4468,8660,4632,8861
,DaiYueXiang,140621204,26056,3080,17574,11242,26898,17557,6758,18263,35820,18320,35894
,AnRongXiang,140621205,8089,1193,5336,3038,9804,5283,1741,5504,10787,5687,11023
ѦG,XueKuLveXiang,140621206,6792,975,4548,2717,8639,4506,1612,4745,9251,4831,9379
,HouSuoXiang,140621207,10081,1554,6813,4166,13090,6801,2475,7221,14022,7297,14110
żׯ,ZhangJiaZhuangXiang,140621208,4583,850,3117,2078,5760,3082,1079,3160,6242,3395,6512
Ӫׯ,MaYingZhuangXiang,140621209,9573,1543,6379,3774,12512,6364,1949,6595,12959,6686,13065
ɽũ,ShanYinNongMuChang,140621400,1891,222,1232,843,2033,1203,422,1242,2445,1303,2535
,JinChengZhen,140622100,80870,5719,49700,27905,63878,42951,18449,46258,89209,55338,105038
Ϻ,NanHeZhongZhen,140622101,28076,4032,18447,11206,37928,18447,6494,20154,38601,20155,38602
,XiaSheZhen,140622102,15793,2280,10571,6631,20871,10556,3708,11200,21756,11210,21781
,ZhenZiLiangXiang,140622200,13355,1628,8988,5088,17513,8986,3521,9513,18499,9516,18504
微,YiJingXiang,140622201,14745,2050,9603,5726,19129,9593,3110,10282,19875,10302,19905
կ,CangZhaiXiang,140622202,19451,2874,12572,7322,24861,12562,3684,13424,25986,13437,26009
Ρ,DaiHuangWeiXiang,140622203,10466,1319,6850,3989,12590,6840,2123,7054,13894,7058,13908
կ,XingZhaiXiang,140622204,12294,1795,8230,4911,15959,8230,2882,8740,16970,8741,16971
,XiaMaYuXiang,140622205,7141,1160,4720,3119,9646,4718,1621,5187,9905,5202,9922
Ȫ,NanQuanXiang,140622206,11738,1734,7881,4875,15638,7858,2723,8280,16138,8314,16195
ٺ,DaLinHeXiang,140622207,21455,2912,14547,8275,28534,14547,5040,14860,29407,14860,29407
ʯ,BaiMaShiXiang,140622208,8647,1274,5630,3055,11410,5630,1810,6091,11721,6101,11731
³,XinChengZhen,140623100,38540,3033,26005,16139,26302,25188,11330,25580,50768,26898,52903
,YouWeiZhen,140623101,7302,1370,4812,3593,9057,4699,1345,4928,9627,5205,10017
Զ,WeiYuanZhen,140623102,6235,913,4131,2463,8249,4127,1320,4283,8410,4337,8468
Ԫ,YuanBuZiZhen,140623103,9794,675,4183,3085,7163,3987,1368,4533,8520,7654,11837
ţı,NiuXinBaoXiang,140623200,3248,581,2070,1548,4168,2055,626,2203,4258,2385,4455
ͷ,BaiTouLiXiang,140623201,4680,415,1997,1225,3799,1927,592,2079,4006,3690,5687
߼ұ,GaoJiaBaoXiang,140623202,5225,827,3238,2420,6748,3227,906,3580,6807,3720,6958
Ҥ,DingJiaYaoXiang,140623203,1767,259,1113,692,2261,1113,309,1222,2335,1222,2335
ǧ,YangQianHeXiang,140623204,2125,341,1409,962,2875,1409,459,1516,2925,1516,2925
Ҥ,LiDaYaoXiang,140623205,4834,749,2920,2108,6130,2913,895,3356,6269,3558,6478
,YunZhongZhen,140624100,130828,7563,79745,45869,105688,72031,31090,78741,150772,89736,169481
Ҥ,WuJiaYaoZhen,140624101,5893,629,3908,2667,5689,3895,1595,4045,7940,4209,8117
ɳ̲,JinShaTanZhen,140624102,15291,2286,10114,6306,15716,9949,3567,10513,20462,11030,21144
ë,MaoJiaZaoZhen,140624103,8992,1415,6278,3777,10452,6223,2393,6419,12642,6522,12800
μұ,HeJiaBaoXiang,140624200,15198,1744,10170,6466,12723,10144,4244,10880,21024,11016,21186
¼԰,XinJiaYuanXiang,140624201,33699,3231,21911,13979,32296,20941,8885,22376,43317,23904,45815
׺,QinHeXiang,140624202,14657,2207,9987,5996,16433,9901,3606,10442,20343,10483,20470
ͷ,HaiBeiTouXiang,140624203,10413,1423,6857,3496,9871,5662,2177,6061,11723,7156,14013
ׯ,MaXinZhuangXiang,140624204,3521,789,2460,1768,4441,2438,831,2638,5076,2681,5141
ͷ,HeTouXiang,140624205,6064,1325,4272,2850,7632,4185,1293,4365,8550,4410,8682
ؽֵ´,BeiGuanJieDaoBanShiChu,140702001,17950,2628,12320,8081,18353,11975,3587,11506,23481,11845,24165
ڽֵ´,JinLunJieDaoBanShiChu,140702002,31895,3420,21521,13656,28785,20116,6398,19009,39125,20192,41713
»ֵ´,XinHuaJieDaoBanShiChu,140702003,25025,2856,16175,10515,16994,15056,4700,14554,29610,16406,32581
Ͻֵ´,XiNanJieDaoBanShiChu,140702004,17767,1872,11867,7849,12025,11276,3534,10851,22127,11306,23173
·ֵ´,LuXiJieDaoBanShiChu,140702005,18724,2128,12080,8700,13706,11894,3386,11712,23606,12158,24238
γֵ´,JingWeiJieDaoBanShiChu,140702006,15160,2782,10208,7441,16903,9653,2095,9338,18991,9829,20037
ֵ´,AnNingJieDaoBanShiChu,140702007,56519,4638,35095,16933,46298,23747,6888,23202,46949,32950,68045
½ֵ´,XinJianJieDaoBanShiChu,140702008,31244,2491,18653,11264,18520,16344,4899,16030,32374,19981,38634
ֵ´,JinHuaJieDaoBanShiChu,140702009,37799,5199,25646,17275,33683,25011,7415,23859,48870,24767,50413
ڽɽ,WuJinShanZhen,140702100,25232,2547,14595,10416,24489,13973,5336,14907,28880,18520,33115
,DongYangZhen,140702101,19084,2175,12608,8164,23947,12544,4677,13180,25724,13328,25936
ʲ,ShenTieZhen,140702102,8864,1676,5777,4212,11431,5714,1754,6423,12137,6517,12294
,ChangNingZhen,140702103,6816,1352,4520,3360,8826,4513,1309,4938,9451,4957,9477
,BeiTianZhen,140702104,14670,2097,9703,6130,18360,9614,3483,10293,19907,10547,20250
,XiuWenZhen,140702105,21692,2549,14224,8506,25376,14155,4942,14742,28897,14959,29183
ұ,GuoJiaBaoXiang,140702200,55358,4038,36809,19921,36692,30963,11046,31674,62637,33633,70442
,ZhangQingXiang,140702201,30348,2880,17642,9163,28068,15045,5367,15705,30750,20953,38595
ׯ,ZhuangZiXiang,140702202,9071,1496,5903,4073,11588,5868,1889,6466,12334,6553,12456
,DongZhaoXiang,140702203,8026,1475,5262,3856,10176,5227,1683,5700,10927,5922,11184
оÿ,JinZhongJingJiKaiFaQu,140702400,38834,3164,24698,14934,31826,21528,7722,21866,43394,25022,49720
,JiChengZhen,140721100,31486,2567,20300,13220,32765,19991,9431,21411,41402,23184,43484
ƴ,YunCuZhen,140721101,11793,1277,7547,5228,15529,7504,3083,8518,16022,8606,16153
±,HaoBeiZhen,140721102,9713,952,6047,4356,11904,6021,2398,6966,12987,7016,13063
,SheChengZhen,140721103,4790,677,3026,2058,6316,3019,1079,3497,6516,3520,6546
,HeYuXiang,140721200,8335,1013,4990,3430,10437,4938,1793,5781,10719,6151,11141
կ,BeiZhaiXiang,140721201,4999,673,3112,2079,6478,3109,984,3540,6649,3544,6656
,XiMaXiang,140721202,7532,916,4677,3263,9751,4670,1743,5509,10179,5514,10191
,LanYuXiang,140721203,3016,457,1863,1512,3939,1856,559,2153,4009,2169,4032
,JiangTangXiang,140721204,1991,358,1255,922,2628,1254,352,1445,2699,1446,2701
ίԱ,ChengQuGuanLiWeiYuanHui,140721400,15144,868,10459,6163,13013,9840,4669,9564,19404,10222,20681
ֵίԱ,ChengQuJieDaoGuanLiWeiYuanHui,140722001,36811,1827,22593,13684,22016,20946,8765,21187,42133,24810,47403
,LiaoYangZhen,140722100,14362,1403,8366,5114,14626,8284,2873,8686,16970,10272,18638
ͩ,TongYuZhen,140722101,6938,741,4412,3039,8716,4332,1744,4768,9100,5011,9423
,MaTianZhen,140722102,13525,1327,8778,5696,17983,8618,3316,9196,17814,9390,18168
Ȫ,QinQuanZhen,140722103,9208,937,5914,3929,12223,5860,2454,6580,12440,6685,12599
ն,GuaiErZhen,140722104,7173,970,4650,3397,9348,4520,1532,4790,9310,5025,9675
,HanWangXiang,140722200,9761,1103,5707,3590,11232,5353,1865,5618,10971,7022,12729
ʯϻ,ShiXiaXiang,140722201,8494,1400,4156,2980,8245,3673,987,4221,7894,6725,10881
Ȫ,LongQuanXiang,140722202,5673,750,3441,2317,6893,3408,1053,3521,6929,4035,7476
ڳ,SuChengXiang,140722203,6588,515,3856,2488,7605,3755,1715,4133,7888,4962,8818
,YangJiaoXiang,140722204,4102,463,2714,2073,5325,2693,939,2730,5423,2790,5504
,YiXingZhen,140723100,54954,4032,33855,21896,46487,32887,12285,34054,66941,37416,71271
,LiYangZhen,140723101,13795,1501,8309,5130,17050,8245,2452,8857,17102,9439,17748
,SongYanZhen,140723102,10136,1184,6356,4234,13074,6324,2201,7104,13428,7165,13521
,QingChengZhen,140723103,5668,906,3536,2545,7343,3502,972,3963,7465,4010,7546
,HengLingZhen,140723104,3482,499,2174,1407,4412,2145,559,2341,4486,2366,4540
ι,WeiMaXiang,140723200,6116,544,3162,2105,5757,3116,991,3207,6323,4489,7651
ƽ,PingSongXiang,140723201,5537,821,3548,2323,7322,3546,1048,3855,7401,3858,7406
ţ,NiuChuanXiang,140723202,5481,728,3563,2325,7311,3563,1151,3797,7360,3797,7360
�,MaFangXiang,140723203,3069,446,1751,1439,3809,1724,383,2098,3822,2147,3898
ռ,YangGuangZhanXiang,140723204,2439,412,1494,1092,3128,1490,386,1742,3232,1743,3237
ƽ,LePingZhen,140724100,67224,5423,42466,29401,61872,41136,15912,41816,82952,46093,88559
,GaoLuoZhen,140724101,8280,1005,5203,3937,10879,5200,1760,5825,11025,5842,11045
ұͷ,YeTouZhen,140724102,8897,1447,5876,4138,11704,5684,1997,6251,11935,6465,12341
մ,ZhanShangZhen,140724103,5823,974,3581,2547,7475,3551,1011,4159,7710,4227,7808
կ,DaZhaiZhen,140724104,23955,2905,14942,10985,27437,14429,5244,15303,29732,17162,32104
ׯ,LiJiaZhuangXiang,140724200,11143,1328,7002,4979,13870,6973,2545,7414,14387,8014,15016
綼,JieDouXiang,140724201,8769,1308,5453,3792,11191,5418,1598,6022,11440,6222,11675
,SanDouXiang,140724202,6690,892,3620,3095,7015,3561,1228,3845,7406,5190,8810
Ա,ZhaoBiXiang,140724203,12103,2255,8075,7179,16230,8015,2501,8668,16683,8784,16859
,KongShiXiang,140724204,7277,1374,5041,3650,10355,5025,1964,5552,10577,5574,10615
ׯ,YanZhuangXiang,140724205,6773,836,4301,3299,8746,4265,1536,4747,9012,4844,9145
կ,XiZhaiXiang,140724206,2940,512,1801,1402,3819,1799,467,2105,3904,2118,3919
,ZhaoYangZhen,140725100,68315,6019,42125,27784,57811,40389,14882,41269,81658,47091,89216
,NanYanZhuZhen,140725101,9834,1957,6269,5074,12579,6253,1900,7019,13272,7422,13691
ڰ,ZongAiZhen,140725102,8896,1425,5334,4050,9562,5027,1402,5497,10524,6389,11723
ƽͷ,PingTouZhen,140725103,15589,2437,9538,6336,18782,9487,3247,10425,19912,11735,21273
,SongTaZhen,140725104,5725,1205,3458,2960,7606,3453,872,4334,7787,4344,7802
,XiLuoZhen,140725105,5385,1294,3526,2956,7333,3512,834,3950,7462,3987,7513
֥,YinLingZhiZhen,140725106,6411,1561,3993,3283,8371,3947,943,4820,8767,4922,8915
ƽ,PingShuXiang,140725200,11077,1561,5713,4672,10907,5636,1767,6582,12218,8692,14405
,JieChouXiang,140725201,7418,1161,3781,3105,7145,3575,978,4074,7649,5776,9557
¼ׯ,WenJiaZhuangXiang,140725202,6786,754,3266,2516,5134,3205,1063,3525,6730,5337,8603
,JingShangXiang,140725203,3313,679,2022,1648,4306,1998,601,2449,4447,2571,4593
Ϻ,ShangHuXiang,140725204,2214,696,1447,1342,3064,1446,309,1769,3215,1772,3219
ͷ,YangTouYaXiang,140725205,4158,968,2585,2226,5457,2575,560,3013,5588,3101,5686
,MaShouXiang,140725206,3401,838,2218,1859,4319,2202,579,2565,4767,2600,4818
,MingXingZhen,140726100,64142,5671,40357,25028,56947,36308,13168,35042,71350,42624,82981
,HuCunZhen,140726101,33039,3649,22154,12871,41084,21934,8671,22655,44589,23205,45359
,FanCunZhen,140726102,9501,1332,6367,4321,12094,6235,2397,6679,12914,6863,13230
,HouChengXiang,140726200,46041,4035,27672,13284,36734,19199,6344,19876,39075,28748,56420
,BeiWangXiang,140726201,16754,2184,10998,7207,21465,10947,3752,11574,22521,11692,22690
ˮ,ShuiXiuXiang,140726202,17570,2113,11251,7708,21427,10803,3902,11256,22059,12334,23585
,YangYiXiang,140726203,17121,2785,11611,8202,21961,11536,3790,11849,23385,12085,23696
С,XiaoBaiXiang,140726204,11190,1644,7613,4824,14716,7612,2822,8023,15635,8043,15656
δ,RenCunXiang,140726205,11033,1326,7347,4360,13876,7282,2807,7612,14894,7819,15166
ԴίԱ,ChangYuanChengQuGuanLiWeiYuanHui,140727001,15218,940,9373,5621,13183,8445,3713,8253,16698,10498,19871
ίԱ,DanFengChengQuGuanLiWeiYuanHui,140727002,16607,1182,8279,5674,14107,8140,3027,7951,16091,12537,20816
´̨ίԱ,LuTaiChengQuGuanLiWeiYuanHui,140727003,12557,1317,8781,5973,11851,8564,3289,8218,16782,8382,17163
,ZhaoYuZhen,140727100,22643,2363,15745,10460,26316,15578,6679,15730,31308,15940,31685
,DongGuanZhen,140727101,37956,4211,25035,15029,47670,24672,9391,25899,50571,26523,51558
,GuXianZhen,140727102,22824,3211,15216,10203,29675,15179,5503,16175,31354,16322,31538
,JiaLingZhen,140727103,18804,2520,12556,8069,24684,12543,4618,13298,25841,13386,25942
,ChengZhaoZhen,140727104,25154,3112,16680,10217,32375,16444,6622,17758,34202,18208,34888
Զ,LaiYuanZhen,140727105,1412,414,923,861,1853,907,185,1014,1921,1088,2011
֧,XiLiuZhiXiang,140727200,14858,1680,9907,5981,18304,9823,3989,10384,20207,10620,20527
,YuKouXiang,140727201,7175,999,4479,3145,8698,4449,1137,4717,9166,4832,9311
,GuTaoZhen,140728100,97341,8561,65942,39955,106018,60819,27773,61199,122018,67733,133675
δ,DuanCunZhen,140728101,22625,2930,15080,9003,30130,14869,6374,16147,31016,16849,31929
Ȫ,DongQuanZhen,140728102,15669,2216,8532,5299,16562,8403,3052,9130,17533,12405,20937
,HongShanZhen,140728103,25543,3117,16949,8978,32959,16575,6658,17693,34268,18369,35318
,NingGuZhen,140728104,26336,3551,17868,10306,34946,16985,6821,18017,35002,18840,36708
,NanZhengXiang,140728200,27496,3148,18718,11267,37018,18713,7721,19638,38351,19647,38365
ж,ZhongDouXiang,140728201,23959,2824,16135,10108,31342,15833,6655,16941,32774,17303,33438
,YueBiXiang,140728202,35204,4508,23880,13896,45283,23578,9401,24812,48390,25233,49113
,BuYiXiang,140728203,23854,3427,15700,10041,31543,15337,6315,16493,31830,17896,33596
ɽ,MengShanXiang,140728204,1563,375,687,732,1555,640,115,915,1555,1366,2053
,ZhuKengXiang,140728205,17982,3329,12016,7821,24185,11670,4172,12752,24422,13467,25483
ԫ,XiangYuanXiang,140728206,15921,2109,10517,6202,20473,10300,4046,11208,21508,11559,22076
żׯ,DuJiaZhuangXiang,140728207,11960,1798,8300,4677,16700,8223,3312,8722,16945,8770,17070
,XiangLeXiang,140728208,16088,2166,11097,6581,22194,11015,4697,11740,22755,11854,22951
ǹίԱ,DongChengGuanLiWeiYuanHui,140729001,18228,1109,12080,7774,14829,11564,5573,11769,23333,12830,24910
ǹίԱ,XiChengGuanLiWeiYuanHui,140729002,13820,1250,9429,5709,11163,8616,3976,8405,17021,9617,19046
ǹίԱ,BeiChengGuanLiWeiYuanHui,140729003,10428,731,7083,4606,8942,6948,3473,7178,14126,7549,14632
,CuiFengZhen,140729100,27897,2480,18063,12044,27447,17894,8171,18617,36511,20485,38548
,JingShengZhen,140729101,21457,1797,13730,7703,18913,11366,5513,12039,23405,15037,28767
,LiangDuZhen,140729102,20692,1989,12199,8789,20908,12013,4988,12801,24814,15470,27669
,XiaMenZhen,140729103,8335,1033,5407,3644,9686,5336,2285,5787,11123,6246,11653
Ϲ,NanGuanZhen,140729104,25342,2847,15787,10745,27612,15407,6438,16165,31572,18840,34627
δ,DuanChunZhen,140729105,10918,1190,6459,4442,11396,6230,2969,6773,13003,8618,15077
,MaHeXiang,140729200,6373,747,4069,2768,7148,3946,1731,4258,8204,4782,8851
Ӣ,YingWuXiang,140729201,6029,561,2863,1897,5416,2834,1330,3178,6012,5057,7920
,WangYuXiang,140729202,4299,664,2798,2180,5171,2747,1132,2908,5655,3297,6095
̳,TanZhenXiang,140729203,4915,696,2900,2038,5218,2747,1140,2932,5679,3851,6751
,LiangJiaYanXiang,140729204,5158,802,3469,2364,6459,3380,1497,3603,6983,3988,7457
,JiaoKouXiang,140729205,7213,618,3628,2371,5982,3444,1568,3736,7180,5771,9399
ؽֵ´,BeiGuanJieDaoBanShiChu,140781001,15474,1818,10651,7465,13706,10527,3756,10214,20741,10397,21048
ؽֵ´,XiGuanJieDaoBanShiChu,140781002,16452,1525,10806,7722,9459,10534,4064,10591,21125,11235,22041
Ͻֵ´,DongNanJieDaoBanShiChu,140781003,18170,1589,12042,8234,11765,11885,4402,11941,23826,12119,24161
Ͻֵ´,XiNanJieDaoBanShiChu,140781004,23266,2522,14833,10287,19718,13782,3791,13693,27475,14746,29579
ֵ̳´,BeiTanJieDaoBanShiChu,140781005,13184,604,8764,4886,4769,7052,2847,7217,14269,7871,16635
尲,YiAnZhen,140781100,39555,4222,25335,16956,47387,24970,10469,27018,51988,28911,54246
,ZhangLanZhen,140781101,30839,3965,20579,14178,39045,20028,8347,21801,41829,22572,43151
,LianFuZhen,140781102,20160,2654,13180,9364,25066,13153,5207,14176,27329,14841,28021
ɽ,HongShanZhen,140781103,8070,1113,5424,3646,9997,5417,2152,5806,11223,5911,11335
,LongFengZhen,140781104,9204,1145,6115,3947,11616,6104,2317,6459,12563,6551,12666
ɽ,MianShanZhen,140781105,21831,2374,14163,9595,24279,14061,5373,14984,29045,15415,29578
,YiTangZhen,140781106,20413,2122,13619,9369,25098,13586,5702,14353,27939,14618,28237
ǹ,ChengGuanXiang,140781200,23243,1511,15198,9423,15133,15069,6295,15569,30638,15851,31049
ι,SongGuXiang,140781201,27202,2178,17766,10640,27086,17134,7076,17897,35031,18690,36456
,SanJiaXiang,140781202,13338,1481,8722,5958,15639,8459,3495,8897,17356,9592,18314
гǽֵ´,ZhongChengJieDaoBanShiChu,140802001,16332,1608,10540,8020,10026,10343,3036,10260,20603,10436,20976
ǽֵ´,DongChengJieDaoBanShiChu,140802002,86241,5962,55091,33242,70060,45810,15677,45141,90951,52789,107880
ǽֵ´,XiChengJieDaoBanShiChu,140802003,23727,1782,15022,9802,20977,14339,4632,14713,29052,15119,30141
ϳǽֵ´,NanChengJieDaoBanShiChu,140802004,27196,2713,17827,10890,26887,16147,5770,16428,32575,17852,35679
ǽֵ´,BeiChengJieDaoBanShiChu,140802005,65002,3925,40782,26959,41503,38457,13805,39400,77857,41950,82732
ؽֵ´,AnYiJieDaoBanShiChu,140802006,40869,3243,26355,10622,41779,21016,7619,20678,41694,25376,51731
ֵ´,DaQuJieDaoBanShiChu,140802007,10718,1130,6939,3539,12792,6898,2301,6701,13599,7210,14149
ҦϽֵ´,YaoMengJieDaoBanShiChu,140802008,13151,1065,7871,3928,14106,6983,2652,7036,14019,8997,16868
,JieZhouZhen,140802100,43335,4860,28391,15252,55085,27826,9578,28626,56452,29382,57773
,LongJuZhen,140802101,25613,3359,17481,9461,33832,17479,5748,17223,34702,17239,34720
,BeiXiangZhen,140802102,24751,2669,17987,7734,29035,14830,6069,14515,29345,15502,33489
֥,HongZhiYiZhen,140802103,12675,1922,9049,5148,17757,8993,3359,8844,17837,8907,17956
·,SanLuLiZhen,140802104,8675,1372,5916,3293,11841,5915,1893,6020,11935,6024,11940
մ,TaoCunZhen,140802105,18682,2069,12383,6183,24681,12362,4192,12525,24887,12560,24943
,DongGuoZhen,140802106,10723,1472,7078,3539,14120,7078,2125,7242,14320,7242,14320
ϯ,XiZhangXiang,140802200,9900,1407,6721,3854,13281,6719,2246,6826,13545,6832,13553
,JinJingXiang,140802201,16213,1982,10989,5804,21652,10932,3739,10885,21817,10945,21934
,WangFanXiang,140802202,12624,1498,8244,4212,16708,8221,2636,8494,16715,8514,16758
,FengCunXiang,140802203,11218,1687,7857,4597,15394,7857,2722,7770,15627,7770,15627
Ϲ,ShangGuoXiang,140802204,14379,1897,9559,5207,19013,9559,2939,9656,19215,9656,19215
,ShangWangXiang,140802205,6594,1011,4529,2587,9013,4446,1441,4387,8833,4517,9046
�ü�,YuDouJingJiJiShuKaiFaQu,140802400,9068,301,5355,3888,3270,5019,1928,5301,10320,5942,11297
ոۿ,KongGangKaiFaQu,140802500,16562,104,10626,1426,1194,1628,643,1521,3149,6683,17309
,YiShiZhen,140821100,79611,5364,50288,27601,76634,43007,17115,44404,87411,51802,102090
,MeiYangZhen,140821101,21066,2142,12894,6279,25314,12368,3740,12544,24912,14054,26948
ٽ,LinJinZhen,140821102,29614,2860,18987,10087,34952,18180,5626,18250,36430,19113,38100
߼,QiJiZhen,140821103,22276,2018,14293,7164,28619,14203,4571,14423,28626,14572,28865
,DongZhangZhen,140821104,25892,2603,16489,8132,32938,16351,5109,16736,33087,17115,33604
Ｊ,SunJiZhen,140821105,40816,5004,27027,12762,54534,26846,9156,27757,54603,27949,54976
,SanGuanZhen,140821106,14135,1863,9287,4455,18717,9253,2784,9331,18584,9495,18782
ţ,NiuDuZhen,140821107,26625,3065,17184,8205,32926,16399,5280,16516,32915,17786,34970
,DanZiZhen,140821108,17423,2055,11352,5994,22433,11082,3749,10970,22052,11875,23227
,ChuHouXiang,140821200,20127,2829,14091,7344,27277,13737,5011,13388,27125,13876,27967
,MiaoShangXiang,140821201,23990,2584,15478,7647,31405,15312,5000,15809,31121,16096,31574
Ǳ,JiaoBeiXiang,140821202,30489,3581,19922,9917,38541,19746,6193,20017,39763,20341,40263
,BeiXinXiang,140821203,23201,3074,15234,7957,30832,15226,4687,15710,30936,15728,30962
,BeiJingXiang,140821204,30710,3964,20191,10377,39701,20019,6546,20309,40328,21029,41220
׿﹤ó,ZhuoLiGongMaoQu,140821400,11114,1275,6937,3670,12870,6769,2065,6868,13637,7517,14454
Ƽׯó,YanJiaZhuangGongMaoQu,140821401,18459,2287,12056,6222,24291,12056,3760,12450,24506,12450,24506
,JieDianZhen,140822100,61083,5015,40222,22878,68096,37159,15288,38219,75378,41164,81386
ͨ,TongHuaZhen,140822101,21909,2555,14417,6705,29492,14406,5254,15227,29633,15301,29718
Ѧ,HanXueZhen,140822102,18365,2798,12393,6300,24341,12128,3747,12212,24340,12517,24910
ٺ,RongHeZhen,140822103,31815,3942,20941,10232,42228,20417,7098,21427,41844,21914,42855
Ȫ,WanQuanXiang,140822200,10777,1462,7260,3722,14383,7250,2513,7380,14630,7492,14752
,LiWangXiang,140822201,18555,2247,12421,6439,25077,12284,4784,13066,25350,13165,25586
,XiCunXiang,140822202,13970,1674,9358,4607,18679,9358,3297,9583,18941,9583,18941
,NanZhangXiang,140822203,23052,2590,15307,7730,31050,15130,5829,16015,31145,16164,31471
ߴ,GaoCunXiang,140822204,22806,2754,15617,7786,30876,15613,6004,15935,31548,15947,31564
ʸ,HuangFuXiang,140822205,15321,2215,10263,5713,20095,10242,3161,10413,20655,10434,20697
ִ,JiaCunXiang,140822206,18214,2190,12381,6495,24883,12375,4690,12703,25078,12713,25094
,WangXianXiang,140822207,21264,2785,14260,7430,28293,14250,4813,14591,28841,14602,28862
⻪,GuangHuaXiang,140822208,26407,3068,17633,8406,35803,17579,6600,18356,35935,18442,36075
ׯ,PeiZhuangXiang,140822209,20004,2293,13411,6123,27308,13316,5156,13919,27235,14042,27453
ͩ,TongChengZhen,140823100,88990,8523,57820,32418,104138,57301,21000,59748,117049,60693,118513
ׯ,GuoJiaZhuangZhen,140823101,24014,3261,15994,8192,31681,15979,4946,16164,32143,16227,32221
,AoDiZhen,140823102,20940,2733,13945,7024,27783,13945,4684,14412,28357,14412,28357
Ѧ,XueDianZhen,140823103,10089,1174,6425,3195,13402,6386,2349,6948,13334,7187,13612
,DongZhenZhen,140823104,39786,3697,25193,13135,42257,23385,8861,24256,47641,27151,52344
Ԫ,LiYuanZhen,140823105,23266,2313,15498,7188,31027,15488,6342,16259,31747,16423,31921
ӵ,HeDiZhen,140823106,26055,2694,17272,8550,34699,16885,6343,17443,34328,17820,35092
,ShenBaiXiang,140823200,8585,1185,5664,2800,11476,5637,1708,5810,11447,5814,11478
,YangYuXiang,140823201,10744,1413,6995,3564,14167,6991,2265,7347,14338,7427,14422
,HouCunXiang,140823202,16681,2211,11517,5784,23037,11451,4296,11566,23017,11671,23188
,PeiSheXiang,140823203,12971,1463,8529,4546,17572,8517,3203,9079,17596,9108,17637
,HouGongXiang,140823204,13635,1502,8913,4453,18294,8842,3288,9403,18245,9512,18425
ʯ,ShiMenXiang,140823205,5269,555,3342,1803,6869,3320,1116,3552,6872,3598,6940
,JiFengZhen,140824100,99073,8692,65461,30082,115983,59061,24744,61717,120778,67048,132509
,XiSheZhen,140824101,20840,2142,13948,6494,27686,13941,5352,14338,28279,14386,28334
,HuaYuZhen,140824102,28471,3180,19535,9367,38796,19528,7957,20061,39589,20073,39608
Ե,ZhaiDianZhen,140824103,27220,3689,18157,10081,35526,17544,6530,18408,35952,19282,37439
,QingHeZhen,140824104,21987,2664,14817,7390,29752,14718,5500,15207,29925,15334,30151
̴,CaiCunXiang,140824200,21261,2719,14462,7260,29376,14462,5532,15049,29511,15050,29512
̫,TaiYangXiang,140824201,36078,4639,24459,12182,49304,24301,9155,25081,49382,25413,49872
,LongXingZhen,140825100,43507,3642,26878,11630,42866,22255,9232,22583,44838,29503,56381
Ȫ,SanQuanZhen,140825101,29461,3003,19776,9415,39101,19704,7763,20295,39999,20451,40227
,ZeZhangZhen,140825102,20276,2401,13770,6859,27259,13664,5096,13865,27529,14003,27773
,BeiZhangZhen,140825103,16490,1836,11298,5334,22463,11298,4356,11380,22678,11384,22682
Ž,GuJiaoZhen,140825104,29845,3236,20159,9446,39841,19407,8040,20316,39723,20962,41121
,WanAnZhen,140825105,13569,1767,9119,4465,18444,8826,3239,9129,17955,9456,18575
,YangWangZhen,140825106,15835,2233,10940,6117,21372,10931,3698,10785,21716,10826,21766
Ȫ,QuanZhangZhen,140825107,12580,1584,8737,4191,17443,8722,3414,8789,17511,8841,17578
,HengQiaoXiang,140825200,29159,3416,19476,9784,39470,19212,7579,20177,39389,20678,40154
´,SheQuBanShiChu,140825400,25406,2331,16472,9321,23117,14420,5545,14523,28943,16810,33282
ú԰ί,XinJiangXianMeiHuaYuanQuGuanWeiHui,140825498,909,0,298,92,0,104,28,103,207,639,937
,KaiFaQu,140825500,8883,853,5887,2684,9463,5458,2261,5560,11018,6110,11997
,GuJiangZhen,140826100,63675,5779,41638,22881,68127,38652,14024,38721,77373,41840,83478
ˮ,HengShuiZhen,140826101,34211,3533,23005,11559,44146,22852,8937,23462,46314,23676,46681
´,ChenCunZhen,140826102,8387,1126,5578,3386,10836,5561,1637,5554,11115,5572,11150
ׯ,WeiZhuangZhen,140826103,10679,913,6307,3269,12107,6185,2067,6320,12505,7352,13659
ô,MeLiZhen,140826104,7060,1232,4855,3325,9576,4849,1455,4885,9734,4892,9747
Ϸ,NanFanZhen,140826105,18503,2049,11840,5957,23838,11371,3508,11538,22909,12220,24060
,AnYuZhen,140826106,22431,2540,14612,7492,29106,14523,4590,14792,29315,14949,29561
,DaJiaoZhen,140826107,21625,2912,14175,8001,28249,13606,4123,13792,27398,14485,28660
ׯ,HaoZhuangXiang,140826200,13864,1475,9220,4068,18508,9073,3451,9311,18384,9570,18790
,LengKouXiang,140826201,6574,821,4300,2125,8715,4196,1521,4409,8605,4616,8916
ɽؾÿ,ShanXiJiangXianJingJiKaiFaQu,140826400,5169,909,3390,2921,5946,3383,863,3514,6897,3551,6941
³,XinChengZhen,140827100,56845,5371,37664,24894,59921,37451,14170,37882,75333,38722,76386
ɽ,LiShanZhen,140827101,10849,659,6208,3549,12237,6118,2247,6661,12779,7547,13755
ų,GuChengZhen,140827102,18214,1362,11305,7110,23228,11291,3949,12206,23497,12220,23525
é,WangMaoZhen,140827103,8095,644,5121,2894,10227,5121,1777,5395,10516,5395,10516
ë,MaoJiaZhen,140827104,8744,733,4660,2952,8406,4191,1355,4550,8741,6172,10832
,PuZhangXiang,140827200,12446,816,7785,4088,14239,7763,3437,8455,16218,8914,16699
Ӣ,YingYanXiang,140827201,13124,849,8455,5331,17202,8454,3691,9167,17621,9209,17664
,JieYuXiang,140827202,4894,423,3030,1859,6197,3017,1015,3268,6285,3302,6332
,HuaFengXiang,140827203,16507,1249,10597,5736,21419,10597,3835,10993,21590,10994,21591
ֱ,ChangZhiXiang,140827204,9996,852,6215,3490,12760,5881,2150,6243,12124,6783,12998
,GaoLuoXiang,140827205,15873,1435,10060,5969,18753,9755,3412,9805,19560,10660,20720
,YaoFengZhen,140828100,65975,6557,41979,20239,79456,38757,13903,41023,79780,44456,86435
ǰ,MiaoQianZhen,140828101,21071,2784,13664,6664,27997,13548,4616,14627,28175,14807,28471
,PeiJieZhen,140828102,36635,4708,23644,11423,49025,23556,8159,25762,49318,25858,49502
ˮͷ,ShuiTouZhen,140828103,35111,3639,22092,10046,45679,20833,7164,21664,42497,23822,45914
,NianZhangZhen,140828104,9243,992,5924,2942,11969,5775,2028,6102,11877,6339,12263
,SiJiaoZhen,140828105,7157,771,4446,2338,9308,4432,1398,4838,9270,4880,9326
ξ,WeiGuoXiang,140828200,19514,2326,12452,5736,25912,12288,4080,13214,25502,13468,25920
,YuWangXiang,140828201,22884,2885,14813,7198,30243,14629,4843,15501,30130,15799,30612
,HuZhangXiang,140828202,27344,2858,17690,8247,36163,17591,6296,18709,36300,18808,36498
ϴ,NanDaLiXiang,140828203,13801,1515,8786,4212,18020,8728,2899,9327,18055,9429,18215
Һ,QiJiaHeXiang,140828204,7223,970,4570,2549,9628,4536,1472,5001,9537,5095,9665
ʥ˽,ShengRenJianZhen,140829100,62932,6722,41629,24576,73915,39704,14675,39866,79570,42700,84329
,ChangLeZhen,140829101,33291,4553,22055,11632,44506,22050,7270,23006,45056,23059,45114
ŵ,ZhangDianZhen,140829102,13840,1730,9000,4804,17409,8745,2769,8977,17722,9339,18339
Ŵ,ZhangCunZhen,140829103,19600,2605,12862,6802,25975,12672,3858,12915,25587,13201,26063
ܴ,CaoChuanZhen,140829104,16727,1919,10276,6333,20358,9931,3454,10530,20461,11824,22100
,SanMenZhen,140829105,6887,850,4387,2535,8747,4311,1497,4459,8770,4847,9234
,HongChiXiang,140829200,11162,1518,7536,3843,15100,7483,2727,7743,15226,7871,15407
,DuMaXiang,140829201,9617,1219,6204,3282,12724,6202,1929,6559,12761,6561,12765
,BuGuanXiang,140829202,11532,1406,7518,4075,15067,7518,2310,7730,15248,7730,15248
µ,PoDiXiang,140829203,7204,929,4627,2734,9329,4556,1509,4764,9320,5015,9642
Ρ,GuWeiZhen,140830100,68313,5922,45350,25611,61619,41357,16990,41802,83159,45875,91225
,FengLingDuZhen,140830101,46402,5624,31432,17622,62744,31160,11492,31828,62988,32086,63518
İ,MoNanZhen,140830102,32143,4330,21181,12140,42798,20986,7378,22021,43007,22670,43851
İ,XiMoZhen,140830103,16155,2152,10571,5653,21595,10489,3349,10991,21480,11085,21656
,YongLeZhen,140830104,16909,1989,10910,5509,22063,10890,3307,11273,22163,11295,22205
,DaiWangZhen,140830105,22169,2799,14408,7773,28994,14404,4269,14829,29233,14829,29237
,YangChengZhen,140830106,27165,3598,18018,9671,36226,17955,5791,18461,36416,18536,36554
,DongLuXiang,140830200,14458,2213,9807,5672,19601,9747,3330,10128,19875,10194,20001
,NanWeiXiang,140830201,22868,3144,15234,8020,29591,15125,4603,15147,30272,15381,30615
ѧ,XueZhangXiang,140830202,18202,2306,11733,6017,23385,11701,3290,11999,23700,12065,23798
ɾÿ,FengLingDuJingJiKaiFaQu,140830400,9899,214,5568,3092,7781,4001,2076,4256,8257,6621,12189
ֵ´,ChengXiJieDaoBanShiChu,140881001,49773,4456,31240,19977,52058,29848,9098,30156,60004,32087,63327
Ǳֵ´,ChengBeiJieDaoBanShiChu,140881002,43965,3197,26120,13881,38915,22417,7810,23224,45641,28852,54972
Ƕֵ´,ChengDongJieDaoBanShiChu,140881003,39416,4310,26000,16035,44780,25836,8650,25871,51707,26376,52376
,YuXiangZhen,140881100,32221,4321,21383,11261,42934,20887,6644,20946,41833,21803,43186
ͷ,QingTouZhen,140881101,35715,4512,23434,12068,46360,22929,7380,23073,46002,24173,47607
,KaiZhangZhen,140881102,28746,3746,19158,10002,38064,19118,6086,19097,38215,19420,38578
,KaoLaoZhen,140881103,36244,4155,23788,11751,47338,23785,7235,23836,47621,23846,47634
,PuZhouZhen,140881104,30946,3728,20118,9808,39728,19902,6143,20143,40045,20699,40817
,HanYangZhen,140881105,16563,2123,11305,5778,22262,11305,3944,11324,22629,11325,22630
Ӫ,ZhangYingZhen,140881106,23162,2523,15191,7134,29645,15171,5036,14805,29976,15530,30721
պũ,WuXingHuNongChang,140881400,599,149,408,318,728,407,80,407,814,420,828
ũ,YuXiangNongChang,140881401,719,125,438,397,812,434,97,487,921,503,941
ũ,DongCunNongChang,140881402,827,180,527,459,1003,527,100,573,1100,580,1107
ֵ´,ChengQuJieDaoBanShiChu,140882001,79313,5794,49304,26711,84170,45108,18358,49118,94226,54161,103465
彧ֵ´,QingJianJieDaoBanShiChu,140882002,20920,1866,13370,8294,19016,13201,5224,14360,27561,14640,28010
,FanCunZhen,140882100,35673,3467,22631,11570,45193,21779,9061,24243,46022,25570,48201
ɮ¥,SengLouZhen,140882101,36759,3955,24232,13038,49715,24166,10179,26363,50529,26661,50893
С,XiaoLiangXiang,140882200,21619,2816,14179,7657,28856,13933,5013,15002,28935,15269,29448
,ChaiJiaXiang,140882201,21168,2328,14099,7421,28388,14018,5575,14802,28820,14972,29071
Լׯ,ZhaoJiaZhuangXiang,140882202,23165,2455,15025,8274,30622,14909,6155,16550,31459,16750,31775
»,XiaHuaXiang,140882203,10470,1024,7188,4163,14509,7183,3526,7762,14945,7832,15020
,YangCunXiang,140882204,15937,1733,10385,5472,20522,10276,4019,11045,21321,11304,21689
ɽ,ShanXiLvChang,140882450,29595,3165,18244,14551,35329,18125,5195,19448,37573,19711,37955
ݽֵ´,XiuRongJieDaoBanShiChu,140902001,32838,3604,21675,13741,28456,20960,8421,20892,41852,23188,44863
ֵֽ´,ChangZhengJieJieDaoBanShiChu,140902002,93611,7015,62582,33975,90842,49908,19219,49220,99128,57263,119845
½·ֵ´,XinJianLuJieDaoBanShiChu,140902003,57317,4518,39500,21950,50379,32366,13051,31709,64075,35386,74886
,BoMingZhen,140902100,28701,2067,19149,7239,23752,11726,5102,11942,23668,16721,35870
,QiCunZhen,140902101,20155,3423,14098,9217,25940,13977,4740,14158,28135,14220,28318
,SanJiaoZhen,140902102,5473,1241,3722,2849,7483,3660,1216,4005,7665,4208,7930
ׯĥ,ZhuangMoZhen,140902103,8553,1546,5959,3861,11816,5957,2134,6250,12207,6274,12233
,DouLuoZhen,140902104,13183,2158,8818,6169,17268,8732,3314,9600,18332,9837,18655
,DongCunZhen,140902105,15707,2609,11029,6834,20795,10992,3679,10909,21901,10966,21995
,CaoZhangXiang,140902200,12737,1861,8857,5259,16438,8841,3419,9135,17976,9160,18017
߳,GaoChengXiang,140902201,10599,1430,7411,4574,13665,7345,2954,7360,14705,7572,14983
س,QinChengXiang,140902202,15776,2044,10770,6927,19465,10741,4094,10954,21695,11144,21914
ԭ,JieYuanXiang,140902203,20663,2749,14178,9091,24346,13918,5111,14222,28140,14345,28523
,HeSuoXiang,140902204,11674,2062,7906,6075,13982,7899,2627,8436,16335,8457,16363
,YangPoXiang,140902205,1813,507,1166,985,2300,1149,231,1211,2360,1385,2551
,LanCunXiang,140902206,13001,2068,8594,5279,15269,8431,3283,8753,17184,9758,18352
,ZiYanXiang,140902207,9699,1450,6683,4439,12191,6682,2496,6953,13635,6962,13645
,XiZhangXiang,140902208,9203,1287,6037,3923,11217,6023,2264,6369,12392,6717,12754
¥,DongLouXiang,140902209,13162,1624,9097,5491,15094,8399,3418,8704,17103,9107,18204
微,BeiYiJingXiang,140902210,10548,1526,7381,4527,13493,7372,2708,7395,14767,7401,14782
,JinChangZhen,140921100,40239,3835,27569,16453,43993,26011,10459,25420,51431,26964,54533
ӱ,HeBianZhen,140921101,19420,2937,13462,8031,25384,13340,5006,13628,26968,13901,27363
,HongDaoZhen,140921102,18900,3032,13231,7910,24582,12844,4828,13212,26056,13529,26760
,YangFangXiang,140921200,11618,1615,8047,4763,14579,8042,2821,8001,16043,8007,16054
,NanWangXiang,140921201,18657,2946,12881,7965,22926,12847,4361,12943,25790,13083,25964
,JiangCunXiang,140921202,11176,1694,7744,4564,13671,7743,2662,7785,15528,7788,15532
ɽ,ShenShanXiang,140921203,11662,1610,8127,4938,13946,8009,3042,7953,15962,8187,16314
ׯ,JiZhuangXiang,140921204,12356,1896,8248,5159,16201,8247,2827,8830,17077,8831,17079
¼,ShouLuXiang,140921205,12933,2040,8720,5588,16839,8705,2896,9105,17810,9149,17869
̨,TaiChengZhen,140922100,29355,2873,19890,12200,29270,18358,7917,18474,36832,20255,40145
̨,TaiHuaiZhen,140922101,9386,759,5695,2816,7282,4253,1669,4241,8494,6119,11814
,GengZhenZhen,140922102,10720,1568,7297,4388,14036,7241,2573,7424,14665,7564,14861
,DouCunZhen,140922103,19079,3240,13066,7924,24853,12687,4561,13335,26022,13814,26880
׼ׯ,BaiJiaZhuangZhen,140922104,8422,1118,5836,3260,11381,5821,2128,5772,11593,5832,11668
ұ,DongYeZhen,140922105,26969,3989,18829,11697,31656,16970,6790,17254,34224,18919,37748
,GouNanXiang,140922200,17216,2372,11178,6389,18554,10549,3860,10984,21533,12270,23448
,DongLeiXiang,140922201,7253,1416,4922,3006,9831,4857,1642,5265,10122,5389,10311
ߺ,GaoHongKouXiang,140922202,5210,786,3431,2061,6815,3411,1161,3672,7083,3726,7157
ʯ,MenXianShiXiang,140922203,6083,977,4170,2457,8140,4111,1459,4250,8361,4349,8519
¼ׯ,ChenJiaZhuangXiang,140922204,10832,1719,7207,4496,14416,7117,2388,7555,14672,7732,14939
,JianAnXiang,140922205,9682,1782,6781,4605,12859,6758,2524,7171,13929,7207,13988
,ShenXiXiang,140922206,4528,685,3079,2050,5777,3015,1106,2993,6008,3240,6319
,JiangFangXiang,140922207,7371,1353,5104,3324,10199,5086,1697,5279,10365,5317,10421
龳,LingJingXiang,140922208,1351,289,851,522,1718,836,201,929,1765,990,1841
,YangBaiXiang,140922209,15250,2764,10291,5725,20696,10267,3410,11087,21354,11133,21424
,RuCunXiang,140922210,22189,3319,14709,8392,29816,14537,5104,15573,30110,15903,30612
ʯ,ShiJuXiang,140922211,3759,618,2588,1664,4544,2525,863,2433,4958,2652,5240
ڿ,JinGangKuXiang,140922212,1428,287,1041,689,1852,1011,341,932,1943,1015,2056
Ϲ,ShangGuanZhen,140923100,49398,4402,32462,19125,40866,29184,12160,29620,58804,33498,65960
,YangMingBaoZhen,140923101,14466,2130,9811,5941,17487,9709,3244,9747,19456,10029,19840
,EKouZhen,140923102,19776,2897,13127,8667,24344,12919,4770,13768,26687,14316,27443
Ӫ,NieYingZhen,140923103,8481,1387,5165,2913,9977,4982,1760,5364,10346,6463,11628
,ZaoLinZhen,140923104,13463,2011,8869,5236,16781,8673,3063,9295,17968,9668,18537
̲,TanShangZhen,140923105,4167,895,2688,1997,5238,2626,749,2751,5377,3123,5811
¸,XinGaoXiang,140923200,16095,2140,9931,5990,19026,9908,3202,10116,20024,11506,21437
,YuKouXiang,140923201,13125,1995,8863,5391,16932,8785,2877,8991,17776,9134,17997
ĥ,MoFangXiang,140923202,8961,1437,5960,3764,10983,5943,1949,6303,12246,6387,12347
,HuYuXiang,140923203,3773,618,2550,1446,5065,2550,837,2676,5226,2678,5228
Ź,YanMenGuanXiang,140923204,5862,894,3523,2228,6443,3452,1107,3651,7103,4340,7863
,FanChengZhen,140924100,55194,4471,37376,22519,45923,35672,16423,37104,72776,38712,76088
ɰ,ShaHeZhen,140924101,43621,3629,29223,16543,44563,28530,13474,30401,58931,31501,60724
Ӫ,DaYingZhen,140924102,11925,1607,8242,4800,15295,8237,3729,8971,17208,9019,17261
Խ,XiaRuYueXiang,140924200,5722,949,3884,2462,7723,3884,1357,4144,8028,4144,8028
԰,XingYuanXiang,140924201,12196,2041,8363,5430,15242,8363,3138,9003,17366,9012,17375
ԣ,GuangYuBaoXiang,140924202,5822,1078,3987,2601,8002,3987,1358,4270,8257,4271,8258
ׯ,JiYiZhuangXiang,140924203,8078,1203,5365,3216,10691,5363,1936,5850,11213,5852,11217
ɽ,DongShanXiang,140924204,14462,2066,9686,5745,18274,9577,3904,10443,20020,10746,20432
ɽ,JinShanPuXiang,140924205,10183,1265,6610,3699,12995,6593,2575,7402,13995,7413,14023
ؼׯ,BaiJiaZhuangXiang,140924206,5820,751,3819,2292,8026,3819,1617,4369,8188,4369,8188
ὧ,HengJianXiang,140924207,8592,1038,5823,3204,11077,5823,2423,6230,12053,6230,12053
ñ,ShenTangBaoXiang,140924208,4645,743,3106,2225,6307,3104,1150,3208,6312,3432,6538
ͷ,YanTouXiang,140924209,4665,886,3069,2241,5835,3038,1064,3244,6282,3546,6615
ֵ´,JieDaoJuMinBanShiChu,140925001,28660,2004,18555,11612,26626,17599,7746,18491,36090,19855,38410
,FengHuangZhen,140925100,15744,1333,9728,6546,13705,9689,3990,10297,19986,11339,21067
�,YangFangKouZhen,140925101,8534,848,5589,3771,8781,5561,2223,5801,11362,6016,11605
կ,DongZhaiZhen,140925102,12722,1464,7965,5458,15821,7734,3266,8622,16356,9487,17452
ʯׯ,ShiJiaZhuangZhen,140925103,2689,418,1703,1097,3408,1651,624,1936,3587,2028,3731
Ѧ,XueJiaWaXiang,140925200,4380,531,2522,1742,5292,2506,750,2588,5094,3139,5661
ׯ,YuZhuangXiang,140925201,5972,657,3747,2080,7544,3673,1306,3951,7624,4188,7935
ɽ,CenShanXiang,140925202,2680,324,1693,1272,3459,1678,570,1805,3483,1881,3574
,HuaBeiTunXiang,140925203,9595,1062,5567,3339,10827,5431,2161,6212,11643,7251,12818
�,XiMaFangXiang,140925204,6130,727,3821,2582,8271,3821,1489,4521,8342,4525,8346
±,XinBaoXiang,140925205,4542,597,2694,1767,5482,2655,1018,3079,5734,3463,6157
̨,DieTaiSiXiang,140925206,2306,400,1461,1107,3114,1458,599,1834,3292,1844,3305
,GeLiaoXiang,140925207,2248,290,1420,989,2909,1401,585,1596,2997,1703,3123
,HuaiDaoXiang,140925208,3574,552,2329,1517,4571,2316,916,2499,4815,2713,5042
�,DongMaFangXiang,140925209,4386,699,3090,2133,6179,3064,1365,3230,6294,3360,6450
�ú,YangFangKouMeiKuangShengHuoQu,140925400,4789,486,3074,2230,4481,3070,1213,3338,6408,3414,6488
,EChengZhen,140926100,41468,3013,27428,15918,34869,25784,11952,27377,53161,29005,56433
żҴ,DuJiaCunZhen,140926101,8942,1209,5603,3711,10670,5563,2244,6182,11745,6792,12395
һ,KangJiaHuiZhen,140926102,4709,618,3112,1557,6287,3111,1153,3367,6478,3368,6480
,FengRunZhen,140926103,3971,659,2609,1604,5257,2594,898,2885,5479,2919,5528
ö,TangErShangXiang,140926201,2691,429,1731,946,3502,1711,600,1939,3650,1989,3720
ׯ,ZhongZhuangXiang,140926202,4187,628,2745,1451,5680,2726,1106,3155,5881,3176,5921
˫·,ShuangLuXiang,140926203,7816,1010,5133,3271,10890,5128,2145,5823,10951,5838,10971
μկ,DuanJiaZhaiXiang,140926204,6933,1012,4443,2806,9259,4323,1721,4998,9321,5223,9666
,XinCunXiang,140926205,4802,714,3017,1860,6332,3014,1078,3544,6558,3577,6594
,WangCunXiang,140926206,7213,1015,4449,3014,9649,4430,1635,5317,9747,5414,9863
,ShenYuGouXiang,140926207,5513,696,3477,1444,7336,3317,1377,3802,7119,4109,7586
,NiangZiShenXiang,140926208,6273,755,3779,2078,7893,3779,1486,4351,8130,4735,8514
,SuoPoXiang,140926209,3907,656,2650,1425,5393,2617,1070,2881,5498,2983,5633
,ChiNiWaXiang,140926210,5289,708,3491,2016,7331,3464,1545,3969,7433,4051,7542
Ȫ,LongQuanZhen,140927100,31014,2214,18910,12795,29373,18722,7334,19702,38424,21652,40562
微,YiJingZhen,140927101,8969,919,5392,3400,11036,5344,1835,6122,11466,6331,11723
˽,BaJiaoZhen,140927102,6712,820,4121,2547,8582,4121,1244,4655,8776,4655,8776
,DongHuXiang,140927200,7263,995,4465,2887,9126,4450,1339,5031,9481,5132,9597
̫ƽׯ,TaiPingZhuangXiang,140927201,5054,617,3045,1955,6294,3041,979,3540,6581,3605,6650
,HuBeiXiang,140927202,4406,579,2634,1619,5647,2626,905,3094,5720,3256,5890
ְ,HeZhiXiang,140927203,6262,668,3694,2212,7341,3625,1062,3818,7443,4298,7992
,ChangZhenXiang,140927204,3900,484,2435,1513,4923,2435,672,2621,5056,2621,5056
ұ,LieBaoXiang,140927205,4076,388,2435,1458,5102,2435,639,2668,5103,2668,5103
ϱ,DaYanBeiXiang,140927206,4082,539,2415,1627,5174,2415,568,2774,5189,2774,5189
,YanChengZhen,140928100,34116,2849,22853,13853,31257,19889,7997,20603,40492,22109,44962
Сͷ,XiaoHeTouZhen,140928101,3438,398,2211,1393,4231,2185,637,2232,4417,2262,4473
,SanChaZhen,140928102,9486,991,6181,4340,9357,6145,2384,6506,12651,6680,12861
ǰ,QianSuoXiang,140928200,8011,836,5002,3063,8644,4429,1515,4968,9397,5360,10362
ƺ,LiJiaPingXiang,140928201,2847,403,1793,1154,3676,1793,542,1995,3788,1999,3792
ƺ,SunJiaPingXiang,140928202,3302,460,2038,1472,4187,2038,630,2354,4392,2354,4392
ƺ,LiangJiaPingXiang,140928203,1897,254,1153,805,2314,1153,363,1345,2498,1361,2514
,HuHuiXiang,140928204,4294,529,2697,1710,5273,2686,807,2900,5586,2933,5630
կ,XinZhaiXiang,140928205,3689,528,2426,1502,4758,2426,809,2600,5026,2600,5026
¥,HanJiaLouXiang,140928206,3943,461,2542,1705,4909,2542,923,2785,5327,2785,5327
ׯ,DongXiuZhuangXiang,140928207,3638,475,2247,1371,4746,2247,680,2546,4793,2546,4793
,XingLingZiXiang,140928208,2635,432,1603,1172,3408,1602,433,1895,3497,1897,3500
,LanYiZhen,140929100,28543,2445,18563,11922,26191,18175,7443,19111,37286,19868,38431
,SanJingZhen,140929101,5054,619,3251,2023,6270,3241,1123,3467,6708,3545,6796
ƺ,ShenTangPingXiang,140929200,5346,591,3249,1810,6596,3248,1017,3675,6923,3705,6954
߼һ,GaoJiaHuiXiang,140929201,5120,496,3047,1974,6397,3034,1023,3542,6576,3592,6639
ҹ,LiJiaGouXiang,140929202,1279,190,797,505,1610,797,246,918,1715,918,1715
ˮ,ShuiYuGuanXiang,140929203,3018,440,1956,1130,4038,1942,766,2220,4162,2268,4224
,XiBaoYuXiang,140929204,2055,288,1253,810,2689,1253,379,1469,2722,1469,2722
Ȫ,WenQuanXiang,140929205,1658,234,1084,650,2223,1083,350,1155,2238,1158,2242
ƺ,YangPingXiang,140929206,1979,270,1184,776,2555,1184,330,1395,2579,1395,2579
,DaJianXiang,140929207,3257,381,1909,1145,4029,1909,506,2235,4144,2235,4144
μҹ,SongJiaGouXiang,140929208,4697,639,2479,1531,5320,2438,713,3067,5505,3570,6049
Ҳ,WangJiaChaXiang,140929209,1457,198,826,585,1774,826,245,1063,1889,1074,1900
ı,WenBiZhen,140930100,55202,4140,34700,22751,35712,32749,14965,34964,67713,39607,74307
¥Ӫ,LouZiYingZhen,140930101,4943,958,3404,2581,6266,3385,1306,3621,7006,3803,7207
,LiuJiaTaZhen,140930102,7040,1291,4470,2833,8704,4231,1363,4460,8691,5224,9694
Ѳ,XunZhenZhen,140930103,10814,1966,7215,5558,12460,7181,2264,7551,14732,7829,15044
¹,LuGuXiang,140930200,3716,1067,2529,2050,4895,2520,629,2678,5198,2883,5412
ǰ,QianChuanXiang,140930201,2177,578,1542,1236,3064,1542,418,1626,3168,1631,3173
կ,DanZhaiXiang,140930202,2331,584,1576,1247,3210,1563,468,1780,3343,1807,3383
,TuGouXiang,140930203,1759,361,1131,758,2368,1131,301,1290,2421,1290,2421
,JiuXianXiang,140930204,4601,801,3017,2207,5310,2989,970,3145,6134,3355,6372
ɳƺ,ShaPingXiang,140930205,2742,798,1863,1623,3817,1859,441,2102,3961,2118,3981
,SheLiangXiang,140930206,3623,667,2436,1739,4987,2436,774,2628,5064,2628,5064
ɳȪ,ShaQuanXiang,140930207,5440,775,3399,2286,6455,3345,1206,3771,7116,4022,7421
Լҹ,ZhaoJiaGouXiang,140930208,1178,193,764,588,1647,764,286,893,1657,893,1657
,DongGuanZhen,140931100,54813,2942,36165,22319,30902,34526,17380,36925,71451,38970,75135
,YiMenZhen,140931101,10754,1365,7095,4558,14018,7052,2992,7732,14784,8016,15111
ͷ,QiaoTouZhen,140931102,12794,1079,7313,4241,13515,7019,3210,7422,14441,9770,17083
,YangJiaWanZhen,140931103,5676,747,3705,2323,7478,3688,1451,4054,7742,4169,7874
ׯ,YaoZhuangXiang,140931200,4923,689,3246,2131,6480,3232,1261,3414,6646,3627,6873
Ҵ,HanJiaChuanXiang,140931201,3136,461,2130,1491,4429,2130,865,2332,4462,2332,4462
,LinZheYuXiang,140931202,2613,312,1743,1086,3533,1743,740,1922,3665,1922,3665
Ҵ,FengJiaChuanXiang,140931203,2691,433,1923,1197,3749,1904,777,1938,3842,1978,3901
,TuYaTaXiang,140931204,2193,367,1522,1001,3066,1520,565,1601,3121,1603,3125
ҹ,SunJiaGouXiang,140931205,5737,639,3104,1916,5966,3039,1174,3169,6208,4446,7550
Ҥ,YaoWaXiang,140931206,2938,381,1397,965,2671,1334,517,1448,2782,2439,3836
Ң̨,YaoGeTaiXiang,140931207,2671,338,1732,1046,3419,1684,710,1856,3540,1987,3719
Ϻӹ,NanHeGouXiang,140931208,5559,843,3662,2399,7569,3652,1299,3937,7589,4039,7701
¹,XinGuanZhen,140932100,39474,3095,26826,17028,32520,26419,12412,27479,53898,28155,54981
ƺ,TianFengPingZhen,140932101,4597,820,3102,2187,6053,3077,920,3122,6199,3235,6337
Ӫ,LaoYingZhen,140932102,4727,752,3150,2204,6215,3138,1045,3289,6427,3374,6524
կ,WanJiaZhaiZhen,140932103,5390,693,3564,2303,7083,3532,1368,3725,7257,3887,7451
Ҥͷ,YaoTouXiang,140932200,8406,1231,5397,3784,10687,5386,1734,5892,11278,5974,11371
¥,LouGouXiang,140932201,6425,938,4105,2806,8377,4086,1196,4436,8522,4454,8559
,ShangYuXiang,140932202,3008,479,1969,1447,3968,1963,572,2074,4037,2090,4059
ϱ,NanBuZiXiang,140932203,2668,356,1649,1116,3460,1645,535,1874,3519,1910,3559
ˮȪ,ShuiQuanXiang,140932204,2605,480,1761,1332,3519,1752,568,1878,3630,1892,3653
¼Ӫ,ChenJiaYingXiang,140932205,4059,647,2686,2067,5199,2679,911,2838,5517,2931,5617
ǽֵ´,BeiChengJieDaoBanShiChu,140981001,32250,2142,21216,11794,20828,17982,7575,17536,35518,20751,41967
ϳǽֵ´,NanChengJieDaoBanShiChu,140981002,41556,3028,27698,17684,32746,24964,11363,24973,49937,28249,55947
ڽֵ´,XuanGangJieDaoBanShiChu,140981003,23847,2476,15367,10112,26819,14749,5996,15258,30007,16952,32319
,DongSheZhen,140981100,22045,4780,15191,8969,31160,14823,5104,15932,30755,16738,31929
,SuLongKouZhen,140981101,11066,2179,7025,5056,14491,7000,2102,7513,14513,8322,15347
,GuoYangZhen,140981102,21775,3964,15441,9142,26109,14873,5135,14879,29752,15433,30874
ţ,DaNiuDianZhen,140981103,13525,2902,9505,6542,17597,9250,2971,9388,18638,9893,19398
ׯ,YanZhuangZhen,140981104,15283,2627,10829,7356,20334,10784,3881,10915,21699,10962,21791
,ChangLiangGouZhen,140981105,12269,1614,7980,5117,15861,7939,2800,8630,16569,8703,16683
,XuanGangZhen,140981106,14789,1958,9116,6604,15661,8980,3216,9741,18721,10847,19963
ԭ,XinYuanXiang,140981200,31981,3638,21822,14408,29164,21565,8439,21886,43451,22236,44058
ϰ,NanBaiXiang,140981201,5487,1211,3740,2689,7501,3740,1132,4090,7830,4090,7830
Ӹ,ZiGanXiang,140981202,11933,2212,8612,5586,16377,8597,3061,8561,17158,8594,17206
,ZhongYangXiang,140981203,8779,2007,6278,4152,11904,6242,1905,6345,12587,6413,12691
ع,YanGouXiang,140981204,13783,2696,9558,6409,18836,9369,2902,9568,18937,9823,19381
,DaLinXiang,140981205,10567,2112,7332,4959,14378,7329,2450,7792,15121,7797,15129
,XiZhenXiang,140981206,22169,3529,15065,9185,24835,13840,4916,14433,28273,15549,30614
,JieCunXiang,140981207,8438,1575,5887,3897,10276,5743,2105,6025,11768,6231,12118
ׯ,WangJiaZhuangXiang,140981208,10363,1542,6882,4310,12665,6831,2292,6932,13763,7315,14197
¥կ,LouBanZhaiXiang,140981209,4267,1002,2949,2241,5699,2908,882,3132,6040,3202,6151
μұ,DuanJiaBaoXiang,140981210,14187,1848,8682,5234,15872,8196,3026,8630,16826,10379,19061
ɽ³ܽҵ,ShanXiLuNengJinBeiLvYeGongKuangQu,140981400,1237,4,497,296,268,318,111,366,684,855,1352
ԭƽʯú󹤿,YuanPingShiShiBaoGouMeiKuangGongKuangQu,140981401,1807,193,1085,949,1920,1084,432,1323,2407,1347,2432
ԭƽũ,YuanPingNongChang,140981403,2508,152,471,439,503,409,115,480,889,2304,2775
·ֵ´,JieFangLuJieDaoBanShiChu,141002001,47719,3805,29640,12058,38094,18907,8546,17958,36865,30430,60070
¥ֵֽ´,GuLouXiJieJieDaoBanShiChu,141002002,47229,2053,32279,13053,31057,18465,6717,17653,36118,23720,55999
ˮֵֽ´,ShuiTaJieJieDaoBanShiChu,141002003,25492,1664,17339,10148,23814,15633,6493,14548,30181,16310,33649
Ͻֵֽ´,NanJieJieDaoBanShiChu,141002004,44013,3233,30407,15456,39369,23120,8630,22161,45281,25469,55876
ͽֵֽ´,XiangXianJieJieDaoBanShiChu,141002005,45830,2906,29496,17634,31105,26446,9571,26222,52668,28811,58307
½ֵֽ´,XinSiJieJieDaoBanShiChu,141002006,28475,1965,17786,10948,17103,15920,5416,15906,31826,18070,35856
·ֵ´,TieLuDongJieDaoBanShiChu,141002007,76103,6305,45898,27998,68184,37483,11690,38358,75841,48200,94098
վֵֽ´,CheZhanJieJieDaoBanShiChu,141002008,31526,3241,20727,13159,25866,18943,5823,18394,37337,19863,40590
ںӽֵ´,FenHeJieDaoBanShiChu,141002009,8483,315,4655,1413,5878,2385,892,2474,4859,5035,9690
,TunLiZhen,141002100,16148,1392,9656,4465,16647,8657,2990,8686,17343,10874,20530
,QiaoLiZhen,141002101,13505,1382,9026,4769,16834,8990,3218,8958,17948,9079,18105
,DaYangZhen,141002102,16838,2049,10993,6278,21216,10968,3541,11243,22211,11435,22428
ص,XianDiZhen,141002103,26046,2963,17125,7851,29645,15385,4509,15286,30671,16393,33518
,LiuCunZhen,141002104,41283,3464,27099,12207,49467,25055,12103,25205,50260,29751,56850
,JinDianZhen,141002105,47831,5162,32474,15065,64265,30213,12802,30646,60859,33321,65795
,WuCunZhen,141002106,17479,2128,11541,6073,22700,11529,3571,11618,23147,11637,23178
,TuMenZhen,141002107,22286,2277,14237,7301,28124,14011,5385,14728,28739,15711,29948
κ,WeiCunZhen,141002108,10649,1155,6925,3435,13054,6769,2560,6996,13765,7439,14364
Ң,YaoMiaoZhen,141002109,28828,1759,18227,9932,21803,16731,6430,16671,33402,18790,37017
ε,DuanDianXiang,141002200,34001,2471,21093,9381,31791,18049,6702,18247,36296,22081,43174
ֵ,JiaDeXiang,141002201,36402,3788,23580,12861,40512,23395,7547,23727,47122,24157,47737
ؼׯ,HeJiaZhuangXiang,141002202,3253,643,2159,1590,4199,2144,456,2134,4278,2193,4352
һƽԫ,YiPingYuanXiang,141002203,12140,1100,7175,3849,14380,7028,2741,7428,14456,8806,15981
ͷ,ZhenTouXiang,141002204,14064,1103,9062,4318,18537,9017,3947,9643,18660,10052,19114
ӵ,HeDiXiang,141002205,7789,503,4336,2252,8327,4296,1819,4524,8820,5775,10111
Ӱ´,BinHeBanShiChu,141002400,29665,1595,19302,10686,14765,16830,6453,17015,33845,18411,37713
ֲ,LeChangZhen,141021100,50514,4393,31386,16911,56292,30237,9680,30332,60569,33201,64587
ʷ,ShiCunZhen,141021101,31550,3443,20552,10230,40575,20520,6204,20588,41108,20645,41197
,QuCunZhen,141021102,19187,2033,12619,5995,23936,12008,3915,11802,23810,12516,25135
,GaoXianZhen,141021103,23475,2177,14035,7204,25385,13510,4173,13715,27225,15790,29825
,LiCunZhen,141021104,13662,1372,8906,4475,17237,8905,2952,9060,17965,9080,17986
,BeiDongXiang,141021200,28369,3141,18422,9111,36639,18420,5724,18793,37213,18812,37234
̸,YangTanXiang,141021201,15810,1540,10497,5106,20308,10472,3719,10546,21018,10572,21069
,TangXingZhen,141022100,65842,5130,43674,23738,72755,42160,15890,41735,83895,43188,86862
,NanLiangZhen,141022101,33680,4114,22546,12305,43717,22298,7304,22271,44569,22552,45098
կ,LiZhaiZhen,141022102,21624,2266,14313,7242,28388,14245,5121,14557,28802,14698,29011
¡,LongHuaZhen,141022103,27371,3013,17677,8974,35550,17210,6042,17754,34964,18749,36426
,QiaoShangZhen,141022104,7199,812,4788,2425,9462,4745,1701,4832,9577,4924,9712
,XiYanZhen,141022105,4475,530,2945,1699,5864,2872,1049,2958,5830,3109,6054
,ZhongWeiXiang,141022200,25020,2669,16841,8558,32049,16835,5766,16608,33443,16614,33455
,NanTangXiang,141022201,20460,2171,13623,6908,26658,13613,4629,13619,27232,13637,27260
ׯ,WangZhuangXiang,141022202,23789,2372,15392,8394,28494,15348,5334,15762,31110,16103,31495
,JiaoDiXiang,141022203,4556,556,2962,1572,5885,2959,986,3133,6092,3136,6098
³,XinChengZhen,141023100,61893,5507,39918,21492,69084,35453,12414,35970,71423,39896,79814
Կ,ZhaoKangZhen,141023101,19316,2817,14076,8003,27281,13955,5583,13529,27484,13640,27716
ڳ,FenChengZhen,141023102,37800,4365,25594,13265,48736,24389,9215,24555,48944,25786,51380
ϼ,NanJiaZhen,141023103,19909,2716,13516,7852,26827,13504,4667,13702,27206,13776,27292
ų,GuChengZhen,141023104,32868,3732,22599,11847,43633,22366,8485,22207,44573,22486,45085
,XiangLingZhen,141023105,29865,3144,20394,10049,39316,19965,7702,19631,39596,20317,40711
ׯ,DengZhuangZhen,141023106,31319,3624,20611,10623,40139,20177,6798,20694,40871,21130,41741
,TaoSiXiang,141023200,14534,2026,9782,5533,18519,9734,3163,9536,19270,9941,19723
,YongGuXiang,141023201,9927,1678,7425,4479,14207,7317,3410,7203,14520,7590,15015
ë,JingMaoXiang,141023202,12531,1435,8179,4120,15684,8104,2592,8128,16232,8379,16558
,XiJiaXiang,141023203,13269,1946,9342,5190,18095,9231,3402,9221,18452,9275,18617
,NanXinDianXiang,141023204,32557,3112,21052,10871,40924,20432,7268,20630,41062,21885,42937
,DaDengXiang,141023205,11833,1668,7957,4605,15367,7912,2524,7954,15866,8068,16025
,DaHuaiShuZhen,141024100,114886,8661,74939,39730,148355,73219,27490,73865,147084,76098,151037
ͤ,GanTingZhen,141024101,28207,2393,18874,9531,37841,18866,7747,19435,38301,19473,38347
ͤ,QuTingZhen,141024102,38748,3259,25415,12271,51493,25310,9793,26253,51563,26385,51800
ձ,SuBaoZhen,141024103,20558,1838,13777,7144,27572,13717,5479,14028,27745,14098,27875
ʤ,GuangShengSiZhen,141024104,35745,2733,23656,13464,44510,22937,8532,22741,45678,23354,47010
,MingJiangZhen,141024105,34989,2772,23723,12150,46487,23595,9655,23615,47210,23693,47416
Գ,ZhaoChengZhen,141024106,57318,4441,38975,22878,74153,38296,16306,38678,76974,39090,78065
,WanAnZhen,141024107,47157,4220,31640,15858,63658,31609,13081,32700,64309,32818,64458
ԫ,LiuJiaYuanZhen,141024108,18646,1670,12743,6628,24589,12610,6170,12870,25480,13743,26486
͵,YanDiXiang,141024200,27872,2582,18484,9239,37002,18389,7028,18888,37277,18998,37482
,XingTangSiXiang,141024201,10744,914,7255,4002,14209,7171,3474,7386,14557,7877,15132
̴,DiCunXiang,141024202,34619,3077,25121,13735,48273,25055,13055,25502,50557,25630,50751
,XinCunXiang,141024203,41927,3870,27470,13751,53851,27075,10503,28155,55230,28830,56300
,LongMaXiang,141024204,19234,2030,12410,5965,24384,12324,4317,12850,25174,13171,25581
ɽͷ,ShanTouXiang,141024205,6104,496,3938,2021,7871,3937,1793,4060,7997,4455,8393
ľ,ZuoMuXiang,141024206,5420,471,3468,2021,6784,3424,1396,3435,6859,3819,7287
,YueYangZhen,141025100,26988,1705,17180,9750,28040,15727,6566,16253,31980,18079,35259
ƽ,BeiPingZhen,141025101,9409,604,5460,3321,10906,5421,2381,5988,11409,6934,12394
,GuYangZhen,141025102,9623,683,5503,3360,10578,5412,2306,5791,11203,7109,12612
,JiuXianZhen,141025103,8407,767,5150,2905,10154,5109,1924,5272,10381,5948,11098
ʯ,ShiBiXiang,141025200,4444,506,2909,1753,5855,2909,994,3028,5937,3035,5944
,YongLeXiang,141025201,4218,325,2539,1396,5135,2526,944,2721,5247,2948,5487
ԫ,NanYuanXiang,141025202,6790,695,4286,2387,8639,4251,1519,4563,8814,4718,9004
,FuChengZhen,141026100,24759,1577,15718,10056,24475,14814,6480,15010,29824,17098,32816
ʹ,HeChuanZhen,141026101,7530,811,4884,3232,9729,4850,1782,5187,10037,5239,10123
Ƴ,TangChengZhen,141026102,9743,518,4474,3214,7561,4203,1683,4813,9016,7470,11944
,JiShiZhen,141026103,7008,506,4587,2874,8965,4551,1947,4828,9379,4874,9461
,MaBiXiang,141026200,5160,439,3258,2248,6559,3224,1211,3501,6725,3552,6810
Ŵ,DuCunXiang,141026201,3793,333,2477,1727,4817,2454,924,2538,4992,2573,5050
,LiangMaXiang,141026202,4479,366,2678,1806,5359,2597,963,2791,5388,3130,5808
̳,TianTanZhen,141027100,34934,3116,23677,15865,37977,23373,9686,23442,46815,24059,47736
ˮ,XiangShuiHeZhen,141027101,12382,1306,7814,5042,14737,7674,2810,8011,15685,8684,16498
ׯ,ZhangZhuangXiang,141027200,12938,1779,8597,5294,16170,8588,2719,8812,17400,8839,17436
,DongZhangXiang,141027201,10419,917,6048,3632,10881,5955,2423,6420,12375,7711,13759
,HuaiNianXiang,141027202,5202,652,3354,1993,6547,3346,1098,3556,6902,3598,6952
,BeiWangXiang,141027203,8406,1085,5534,3511,10521,5479,1825,5722,11201,5782,11316
,BeiHanXiang,141027204,3674,437,2267,1498,4585,2261,783,2545,4806,2627,4894
׼ԫ,MiJiaYuanXiang,141027205,3371,566,2117,1521,4357,2105,571,2366,4471,2391,4508
կ,ZhaiGeDaXiang,141027206,3522,353,2304,1494,4289,2299,857,2403,4702,2428,4732
,JiChangZhen,141028100,31752,2773,21197,13720,31461,20737,8864,21478,42215,22192,43389
,TunLiZhen,141028101,9178,1032,6120,3232,12042,6110,2325,6267,12377,6415,12535
,HuKouZhen,141028102,2947,278,1814,965,3487,1740,651,1871,3611,2062,3876
,CheChengXiang,141028200,6044,585,3743,2051,6948,3454,1335,3686,7140,4221,7964
ĳ,WenChengXiang,141028201,6461,708,4258,2442,8534,4257,1542,4447,8704,4453,8711
,DongChengXiang,141028202,4713,470,2864,1596,5663,2773,1029,2925,5698,3348,6212
ɽ,BaiShanSiXiang,141028203,8362,840,5654,3088,11154,5649,2295,5809,11458,5843,11497
ж,ZhongDuoXiang,141028204,8903,902,6021,3268,11996,6021,2418,6201,12222,6202,12223
,ChangNingZhen,141029100,51668,3218,33323,18087,57698,30109,13926,31872,61981,35489,68812
⻪,GuangHuaZhen,141029101,15492,1265,10319,5572,19990,10205,4865,10913,21118,11303,21622
̨ͷ,TaiTouZhen,141029102,10422,568,5641,3583,8926,5294,2598,5739,11033,7947,13588
ͷ,GuanTouZhen,141029103,15496,1212,9415,5053,18395,9109,4274,9662,18771,11567,20982
,XiPoZhen,141029104,11485,722,7162,3668,13399,7048,3548,7708,14756,8593,15755
˫,ShuangHeXiang,141029200,15889,1518,10428,5177,21451,10347,4723,11238,21585,11702,22130
,GuanWangMiaoXiang,141029201,14101,1453,10012,5331,20045,9956,4942,10342,20298,10484,20496
ξׯ,WeiZhuangXiang,141029202,9770,817,6556,3296,13213,6490,3016,6788,13278,7047,13603
�,XiJiaoKouXiang,141029203,7619,674,5184,2787,10574,5112,2582,5526,10638,5691,10875
,ZaoLingXiang,141029204,17807,1636,11814,6358,24492,11580,5861,12701,24281,13490,25304
ˮ,XinShuiZhen,141030100,25183,1999,16791,10053,28546,16573,7484,17407,33980,17875,34666
,QuEZhen,141030101,5965,641,3928,2335,8060,3928,1497,4175,8103,4175,8103
,SanDuoXiang,141030200,5205,559,3400,1827,6971,3398,1261,3618,7016,3625,7025
̫,TaiDeXiang,141030201,3016,278,1902,980,3898,1902,646,2038,3940,2038,3940
Ҷ,XuJiaDuoXiang,141030202,5070,619,3272,1768,6841,3265,1240,3636,6901,3657,6929
̫,TaiGuXiang,141030203,2883,294,1843,1045,3822,1843,661,1995,3838,1995,3838
Ȫ,LongQuanZhen,141031100,29108,2300,19345,12542,32062,19228,8214,20013,39241,20277,39622
,WuChengZhen,141031101,7541,782,4822,2915,9975,4818,1771,5196,10014,5272,10094
,HuangTuZhen,141031102,8367,852,5463,2984,11241,5439,2250,5877,11316,6006,11469
ͷ,YangTouShengXiang,141031200,7078,610,4503,2298,9462,4503,1775,4960,9463,4960,9463
կ,ZhaiZiXiang,141031201,4823,436,3079,1664,6318,3079,1137,3317,6396,3317,6396
,DouPoXiang,141031202,2956,312,1858,921,4020,1858,764,2174,4032,2174,4032
,XiaLiXiang,141031203,6314,714,4078,2258,8517,4078,1595,4545,8623,4545,8623
,ChengNanXiang,141031204,10601,1044,6469,3821,13597,6449,2273,7170,13619,7449,13918
֥,ZhiHeZhen,141032100,19427,1450,12838,7777,18439,12813,5341,13350,26163,13380,26218
ɣ,SangBiZhen,141032101,4173,367,2562,1490,5263,2562,836,2814,5376,2814,5376
,GeDiXiang,141032200,8037,723,5073,2766,10581,5073,1977,5664,10737,5664,10737
ׯ,NanZhuangXiang,141032201,4155,363,2630,1477,5442,2612,982,2847,5459,2870,5500
ʯ,DaShiYaoXiang,141032202,4035,357,2571,1461,5250,2567,923,2726,5293,2744,5315
ͷ,PoTouXiang,141032203,3239,321,2040,1159,4066,2031,663,2152,4183,2183,4223
,JiaoKouXiang,141032204,4838,507,2967,1597,6278,2967,935,3313,6280,3313,6280
ѳ,PuChengZhen,141033100,23722,1719,15737,8815,24382,14943,6799,15419,30362,16503,32240
Ѧ,XueGuanZhen,141033101,3728,555,2551,1745,4733,2550,892,2599,5149,2624,5175
,HeiLongGuanZhen,141033102,15533,1208,8304,4863,16144,7913,3380,8569,16482,11817,20121
˳,KeChengZhen,141033103,12127,938,8155,4251,15620,7994,4083,8318,16312,8993,17148
ɽ,ShanZhongXiang,141033200,2120,259,1336,811,2749,1336,429,1455,2791,1472,2808
,GuXianXiang,141033201,3625,349,2083,1091,4207,2057,840,2259,4316,2731,4814
,HongDaoXiang,141033202,1960,292,1157,779,2354,1132,364,1258,2390,1459,2616
Ǽ,QiaoJiaWanXiang,141033203,10406,645,5431,2706,10100,5103,2347,5456,10559,7967,13398
̫,TaiLinXiang,141033204,7093,427,3328,2280,5584,3186,1499,3645,6831,5691,9019
,YongAnZhen,141034100,15498,1624,10093,5576,20195,10088,4003,10854,20942,11032,21125
,DuiZhuZhen,141034101,8717,964,5648,3091,11567,5647,2214,6242,11889,6247,11895
,QingXiangZhen,141034102,12910,1009,8432,4076,16820,8430,3735,9219,17649,9222,17654
ƽ,HePingZhen,141034103,9453,902,6690,3555,13399,6690,3498,7163,13853,7163,13853
ɮ,SengNianZhen,141034104,10248,908,6932,3639,13660,6925,3077,7300,14225,7301,14233
ƺ,DianPingXiang,141034200,7605,752,4866,2726,10098,4866,2039,5530,10396,5530,10396
Ű,TuanBaiXiang,141034201,7893,684,5682,3098,10886,5679,2992,5887,11566,5887,11569
ϼҪ,XingJiaYaoXiang,141034202,5051,549,3380,1682,6729,3366,1486,3697,7063,3706,7086
ίԱ,SheQuGuanLiWeiYuanHui,141034400,25757,1302,18211,10192,23810,17468,9921,17955,35423,18769,36980
·ֵ´,LuDongJieDaoBanShiChu,141081001,27454,2535,17653,12073,28313,17473,5399,17501,34974,17735,35388
·ֵ´,LuXiJieDaoBanShiChu,141081002,22184,3195,14622,10386,24165,14380,4287,14387,28767,15044,29666
䫱ֵ´,HuiBinJieDaoBanShiChu,141081003,36969,4006,23141,14186,35406,20264,5856,19564,39828,23690,46831
ֵ´,ShangMaJieDaoBanShiChu,141081004,19176,2250,12561,6691,22954,12479,4227,12724,25203,13092,25653
Ŵֵ´,ZhangCunJieDaoBanShiChu,141081005,19084,1777,12204,6576,22152,12153,4261,12521,24674,12918,25122
,XinTianXiang,141081200,32947,3155,21447,11405,33822,21375,6724,21262,42637,21379,42826
ߴ,GaoCunXiang,141081201,12751,1369,8267,3974,15882,8240,2826,8294,16534,8679,16946
,FengChengXiang,141081202,13367,1450,8697,4495,16169,8684,2756,8846,17530,8876,17573
¥ֵ´,GuLouJieDaoBanShiChu,141082001,18821,1432,12343,6744,21693,12046,4808,12215,24261,12718,25061
·ֵ´,BeiHuanLuJieDaoBanShiChu,141082002,16993,927,11305,5840,16699,10258,4727,10590,20848,11342,22647
ϻ·ֵ´,NanHuanLuJieDaoBanShiChu,141082003,9178,759,5974,3483,8889,5972,2302,6258,12230,6265,12239
Ԫֵ´,KaiYuanJieDaoBanShiChu,141082004,14444,1052,9734,4748,14860,8769,3777,8843,17612,9539,19273
ɳֵ´,TuiShaJieDaoBanShiChu,141082005,14231,1136,9531,5503,17040,9461,4122,9623,19084,9958,19489
,BaiLongZhen,141082100,24718,1604,15734,8915,26254,15540,6403,16060,31600,16991,32725
,XinZhiZhen,141082101,36867,3436,23220,14685,42792,22842,8240,23620,46462,25323,48543
,DaZhangZhen,141082102,21858,1991,14552,7814,27319,14536,5649,14930,29466,14946,29498
,LiCaoZhen,141082103,19005,1708,12184,6245,23521,12097,4543,12434,24531,13072,25256
,TaoTangYuXiang,141082200,12423,1115,8043,4278,15542,7974,3181,8255,16229,8676,16719
,SanJiaoXiang,141082201,14567,1346,9483,4660,18793,9460,3808,9967,19427,10238,19721
ʦׯ,ShiZhuangXiang,141082202,8677,979,5558,3259,11297,5554,2078,6073,11627,6176,11734
ӽֵ´,BinHeJieDaoBanShiChu,141102001,64447,2776,42415,21757,56665,32919,15211,34258,67177,40019,82434
ɽֵ´,FengShanJieDaoBanShiChu,141102002,60690,2194,39597,24133,44933,36785,19023,39157,75942,42310,81907
ؽֵ´,LianHuaChiJieDaoBanShiChu,141102003,41686,1853,28720,15750,33687,24234,12592,25022,49256,27411,56131
Ǳֵ´,ChengBeiJieDaoBanShiChu,141102004,6938,617,4725,2623,8347,4697,2178,4899,9596,5008,9733
һֵ´,TianJiaHuiJieDaoBanShiChu,141102005,10736,931,7198,4443,11429,7157,3237,7571,14728,7706,14904
ڽֵ´,JiaoKouJieDaoBanShiChu,141102006,14240,948,8769,5277,12311,8587,4449,9234,17821,10868,19637
ͽֵ´,XiShuBaJieDaoBanShiChu,141102007,13666,1157,9645,4622,15590,7694,3560,7982,15676,8738,18383
,WuChengZhen,141102100,6797,839,4235,2989,8649,4222,1522,4849,9071,4923,9158
,XinYiZhen,141102101,6967,1186,4592,3301,9207,4583,1536,5061,9644,5097,9689
۴,HongYanChuanXiang,141102200,1309,254,739,592,1504,739,182,810,1549,1006,1745
,ZaoLinXiang,141102201,5478,705,3530,2369,6221,3482,1591,4033,7515,4244,7774
ƺͷ,PingTouXiang,141102202,6292,1133,3859,2892,8173,3832,1222,4429,8261,4788,8647
,FengChengZhen,141121100,95397,7585,63150,34786,111075,57117,25589,58061,115178,65421,128571
դ,KaiShanZhen,141121101,25302,2581,16358,8808,33304,16181,6322,17366,33547,17847,34205
ׯ,NanZhuangZhen,141121102,14460,1641,9774,5475,19536,9770,4094,10408,20178,10421,20195
ϰ,NanAnZhen,141121103,24837,2638,16776,8785,33657,16762,6754,17441,34203,17453,34229
,LiuHuLanZhen,141121104,26412,3406,18605,10076,35692,18357,7417,18502,36859,18630,37235
,XiaQuZhen,141121105,27254,3635,19608,9702,38376,19607,8443,19701,39308,19724,39332
Т,XiaoYiZhen,141121106,20105,2200,13594,7471,26746,13584,5676,14286,27870,14387,27981
,NanWuXiang,141121200,15262,1702,10784,4994,21153,10784,4801,10981,21765,10981,21765
,XiChengXiang,141121201,18583,1991,12259,6486,24902,12007,4901,12822,24829,13216,25475
,BeiZhangXiang,141121202,17703,2327,12457,6874,24521,12435,5075,12605,25040,12648,25105
,MaXiXiang,141121203,7887,969,5361,3078,10666,5359,2260,5684,11043,5755,11116
ͷ,XiCaoTouXiang,141121204,11063,1353,7907,4221,15703,7907,3574,8083,15990,8083,15990
,TianNingZhen,141122100,74559,5317,49974,28891,83829,47052,20647,47796,94848,50549,100523
ļӪ,XiaJiaYingZhen,141122101,26835,2613,18064,9682,33753,17985,7077,17985,35970,18461,36525
Ӫ,XiYingZhen,141122102,20904,2133,14021,7278,27303,13788,5526,14445,28233,14542,28563
ˮ,ShuiYuGuanZhen,141122103,9600,1029,6161,3858,13155,6028,2663,6606,12634,7131,13292
,XiSheZhen,141122104,7779,944,5028,2998,10043,5008,1972,5465,10473,5667,10695
Ȫ,PangQuanGouZhen,141122105,1295,223,823,652,1704,815,188,864,1679,883,1706
,HongXiangXiang,141122200,15343,1662,10128,6209,19677,10104,4193,10838,20942,11070,21198
,LingDiXiang,141122201,4712,636,3177,2099,6304,3175,1212,3359,6534,3383,6560
µ,DongPoDiXiang,141122202,3793,618,2339,1690,5123,2328,744,2769,5097,2816,5155
,HuiLiXiang,141122203,4879,613,2756,1747,5688,2689,812,3071,5760,3548,6304
ε,WeiFenZhen,141123100,73976,4862,49066,28658,63356,47974,21777,50322,98296,51549,100615
κ̲,WeiJiaTanZhen,141123101,18001,1760,9803,6403,19237,9483,3318,10173,19656,13276,23079
,WaTangZhen,141123102,12124,1133,7747,3996,15666,7729,2583,8006,15735,8093,15840
,KangNingZhen,141123103,13761,1138,8307,4680,16886,8221,2927,8679,16900,9519,17826
߼Ҵ,GaoJiaCunZhen,141123104,10494,1064,6924,3506,13709,6891,2453,6943,13834,7087,14011
,LuoYuKouZhen,141123105,5230,618,3359,1937,6881,3359,1045,3534,6893,3534,6893
̼һ,CaiJiaHuiZhen,141123106,7469,750,4611,2869,9755,4611,1595,5203,9814,5203,9814
¥,JiaoLouShenXiang,141123200,5722,735,3657,2144,7525,3656,1318,4050,7706,4118,7775
̲,EHuTanXiang,141123201,5770,452,3374,1780,6671,3340,1302,3565,6905,4150,7524
,DongHuiXiang,141123202,4954,621,3201,1961,6599,3188,1129,3477,6665,3503,6704
,GuXianXiang,141123203,6948,714,4395,2307,8883,4371,1564,4510,8881,4831,9226
¼,AoJiaWanXiang,141123204,11565,957,7576,4295,13285,7575,3095,7790,15365,8041,15617
̼,CaiJiaYaXiang,141123205,12318,1348,7308,4685,14344,7197,2370,7597,14794,8728,16036
ؼһ,HeJiaHuiXiang,141123206,4921,499,3222,1966,6372,3219,1117,3315,6534,3315,6537
ϼƺ,MengJiaPingXiang,141123207,8241,827,5207,2706,10529,5182,1577,5402,10584,5438,10645
Լƺ,ZhaoJiaPingXiang,141123208,3139,487,2000,1111,4068,2000,513,2139,4139,2139,4139
و,GeDaShangXiang,141123209,5366,473,3400,2053,7062,3400,1253,3692,7092,3692,7092
Ȫ,LinQuanZhen,141124100,67233,4819,45375,26683,66809,42518,19618,44166,86684,46295,91670
,BaiWenZhen,141124101,23248,2631,15709,9016,31401,15648,6372,16336,31984,16542,32251
ׯ,ChengZhuangZhen,141124102,17519,1824,11591,6385,23592,11573,4788,12448,24021,12540,24131
,TuBanZhen,141124103,15711,1410,10257,6130,20777,10203,4589,11388,21591,11453,21710
˻,KeHuZhen,141124104,8706,696,5485,3232,11313,5461,2349,5994,11455,6266,11751
,SanJiaoZhen,141124105,36626,3884,24750,13997,49156,24548,10742,26262,50810,26502,51252
ˮͷ,TuanShuiTouZhen,141124106,11966,1067,7844,4667,15922,7771,3654,8435,16206,8843,16687
ּƺ,LinJiaPingZhen,141124107,17476,1984,11568,7481,23824,11560,4985,12806,24366,12877,24445
,ZhaoXianZhen,141124108,10719,1021,6700,3945,13510,6593,2602,7203,13796,7642,14342
ӿ,QiKouZhen,141124109,22012,2348,14431,8259,29739,14295,5649,15424,29719,15578,30009
һ,LiuJiaHuiZhen,141124110,21143,2128,13863,6120,28555,13850,5860,15223,29073,15268,29131
,CongLuoYuZhen,141124111,12097,1195,8039,4181,16498,8035,3498,8746,16781,8751,16790
,QuYuZhen,141124112,19030,1695,12665,6671,25968,12643,5394,13430,26073,13454,26119
ľƺ,MuGuaPingXiang,141124200,13725,1186,8364,5357,15500,8240,3497,8922,17162,10044,18408
ҵ,AnYeXiang,141124201,15433,1548,10479,5819,20753,10468,4495,10976,21444,10997,21476
ƺ,YuPingXiang,141124202,12844,1441,8598,4341,17241,8593,3385,9067,17660,9072,17670
,QingLiangSiXiang,141124203,11209,1155,7217,4233,14763,7202,2811,7914,15116,7958,15175
ʯͷ,ShiBaiTouXiang,141124204,14385,1463,9328,5165,19301,9265,3917,10336,19601,10437,19765
׼,LeiJiaQiXiang,141124205,11343,1066,7238,4420,14778,7215,3035,8071,15286,8206,15444
ڰ˱,DiBaBaoXiang,141124206,8836,857,5815,3424,12017,5813,2468,6343,12156,6346,12161
,DaYuXiang,141124207,26145,2817,17701,9752,35406,17684,7447,18684,36368,18708,36409
,CheGanXiang,141124208,10077,1102,6888,4029,13960,6888,3035,7176,14064,7326,14214
ׯ,AnJiaZhuangXiang,141124209,13112,1335,8725,4911,17814,8710,3620,9323,18033,9342,18067
,LiuLinZhen,141125100,82733,3669,53948,29924,67118,51006,26511,53385,104391,58965,112913
´,MuCunZhen,141125101,24960,1456,15875,9488,19623,15083,8498,16151,31234,19039,34914
Ѧ,XueCunZhen,141125102,10981,1204,7072,4688,12973,6967,2988,7465,14432,8101,15173
ׯ,ZhuangShangZhen,141125103,13374,998,8496,4573,15594,8378,4070,8966,17344,9946,18442
,LiuYuZhen,141125104,9254,954,5886,3402,11948,5814,2398,6302,12116,6720,12606
,SanJiaoZhen,141125105,8346,1142,5693,4155,11585,5647,2484,6199,11846,6279,11972
ɼׯ,ChengJiaZhuangZhen,141125106,9388,977,5740,3874,11359,5617,2482,6286,11903,7107,12847
,MengMenZhen,141125107,12298,1072,5950,3872,11780,5631,2455,6224,11855,9875,15825
,LiJiaWanXiang,141125200,9913,939,6294,3817,11998,6189,2664,6873,13062,7222,13516
ּԫ,JiaJiaYuanXiang,141125201,5648,833,3744,2588,7851,3743,1435,4170,7913,4172,7916
¼,ChenJiaWanXiang,141125202,16870,1236,10000,5395,19043,9854,4779,10308,20162,12885,22885
ׯ,JinJiaZhuangXiang,141125203,7179,672,4851,2851,8946,4801,2661,5402,10203,5661,10512
߼ҹ,GaoJiaGouXiang,141125204,7183,1142,4681,3131,9653,4666,1747,5148,9814,5391,10072
ʯ,ShiXiXiang,141125205,6083,620,4178,2395,8579,4178,2025,4550,8728,4550,8728
ҹ,WangJiaGouXiang,141125206,8977,979,5385,3289,10272,5269,2399,5901,11170,6970,12355
Ȫ,LingQuanZhen,141126100,29334,2005,20374,12308,28470,20299,10657,21038,41337,21622,41996
޴,LuoCunZhen,141126101,8795,641,5368,3064,11136,5309,2220,5791,11100,6288,11656
,YiDieZhen,141126102,4650,362,3302,1959,6200,3301,1747,3454,6755,3457,6759
С,XiaoSuanZhen,141126103,6723,676,4479,2849,9111,4479,1911,4831,9310,4831,9310
,LongJiaoXiang,141126200,7008,614,4510,2537,9416,4508,2081,4943,9451,5193,9703
ͺ,HeHeXiang,141126201,7143,639,4664,2509,9662,4664,2011,5129,9793,5129,9793
ǰɽ,QianShanXiang,141126202,6183,501,4002,2197,8404,4002,1762,4436,8438,4444,8446
ܼԫ,CaoJiaYuanXiang,141126203,4987,385,3124,1646,6662,3124,1370,3618,6742,3618,6742
ṵ,PeiGouXiang,141126204,5306,475,3578,2145,7399,3578,1629,3832,7410,3832,7410
,DongCunZhen,141127100,43534,2787,29214,17075,36542,28261,13451,29912,58173,30558,59772
ᰳ,LanChengZhen,141127101,7822,898,5172,2826,10268,5172,2016,5560,10732,5564,10736
,PuMingZhen,141127102,15005,1466,10165,5494,20024,10165,4404,10709,20874,10710,20875
ӿ,JieHeKouZhen,141127103,4077,433,2627,1475,5234,2627,861,2744,5371,2744,5371
,TuYuXiang,141127200,4057,420,2670,1433,5307,2670,1009,2816,5486,2816,5486
,ShangMingXiang,141127201,10080,966,6635,3106,13629,6614,2659,7054,13668,7070,13705
ʨ,WangShiXiang,141127202,7353,715,4699,2582,9706,4683,2059,5246,9929,5428,10127
ׯ,LiangJiaZhuangXiang,141127203,9208,869,6026,3309,11751,5983,2680,6263,12246,6731,12757
˳,ShunHuiXiang,141127204,6281,683,4106,2021,8128,4104,1473,4327,8431,4331,8437
ӿ,HeKouXiang,141127205,3622,477,2386,1349,4881,2386,906,2610,4996,2619,5005
,SheKeXiang,141127206,11583,1138,7307,3975,14541,7292,2807,7706,14998,8221,15528
ͷ,DaSheTouXiang,141127207,4712,543,3057,1678,6278,3057,1128,3324,6381,3326,6383
ٶ,GeDongZhen,141128100,31769,2422,20882,13567,40005,20878,9218,22488,43366,22527,43409
�,MaFangZhen,141128101,12131,1236,7771,4266,15984,7768,3285,8872,16640,8881,16652
,YuKouZhen,141128102,18658,1891,11896,7112,23635,11752,4981,12977,24729,13634,25530
,DaWuZhen,141128103,25686,2109,15427,8755,27175,14726,6520,15931,30657,18888,34315
䵱,BeiWuDangZhen,141128104,4319,509,2670,1846,5552,2669,1018,3169,5838,3176,5846
,JiCuiXiang,141128200,6424,528,3989,2408,8326,3989,1558,4521,8510,4521,8510
ػ,MaDiHuiXiang,141128201,7011,612,4396,3259,9312,4393,1924,5147,9540,5151,9547
,NingXiangZhen,141129100,55352,2908,36399,21276,45049,35140,18230,37969,73109,40091,76490
,JinLuoZhen,141129101,15968,1370,10233,6040,17314,10130,4496,10691,20821,11601,21834
֦,ZhiKeZhen,141129102,4940,545,3248,1989,6715,3238,1376,3571,6809,3613,6861
ׯ,WuJiaZhuangZhen,141129103,5824,697,3193,1910,6618,3185,1064,3637,6822,4392,7585
ůȪ,NuanQuanZhen,141129104,7816,944,5064,3186,10557,5056,1968,5657,10713,5664,10728
ɽ,ZhangZiShanXiang,141129200,7423,906,4356,2607,8229,4313,1500,4462,8775,5473,9829
,XiaZaoLinXiang,141129201,6155,753,3437,2092,7086,3391,1139,3879,7270,4610,8047
ˮͷ,ShuiTouZhen,141130100,21795,1134,14450,7929,20755,13193,6826,14162,27355,15305,29755
,KangChengZhen,141130101,10431,1053,6984,4261,13578,6962,3383,7827,14789,7883,14867
˫,ShuangChiZhen,141130102,16762,1320,10571,5801,18949,10432,4844,10821,21253,12355,22926
Һ,TaoHongPoZhen,141130103,11865,1217,7784,4650,14779,7760,3296,8395,16155,8594,16378
ʯ,ShiKouXiang,141130200,9279,1014,6068,3336,12444,6028,2581,6722,12750,6806,12874
,HuiLongXiang,141130201,9591,1010,6472,3963,12258,6452,2982,6961,13413,7111,13583
Ȫ,WenQuanXiang,141130202,6750,831,4466,2743,9017,4447,1954,5034,9481,5069,9535
ֵ´,XinYiJieDaoBanShiChu,141181001,84237,5065,54428,31024,68215,48556,21243,49499,98055,56117,110545
¥ֵ´,ZhongYangLouJieDaoBanShiChu,141181002,28440,1942,17909,11264,25304,17682,7214,18448,36130,19687,37596
˽ֵ´,ZhenXingJieDaoBanShiChu,141181003,10744,1105,7221,4187,13699,7184,2960,7462,14646,7588,14809
ֵ´,DongXuJieDaoBanShiChu,141181004,7419,1019,4886,3219,9693,4886,1760,5312,10198,5312,10198
Ľֵ´,ChongWenJieDaoBanShiChu,141181005,27885,1439,17815,9479,20368,15009,6960,15414,30423,18469,36284
,DuiZhenZhen,141181100,31153,3465,20036,13846,36570,19814,7578,21185,40999,22160,42196
Ȫ,YangQuanQuZhen,141181101,26441,2699,16282,10798,31671,15210,5430,16245,31455,18288,34570
±,XiaBaoZhen,141181102,13137,1699,8823,5703,16355,8776,3283,9204,17980,9296,18119
ׯ,XiXinZhuangZhen,141181103,12412,1279,8297,5386,16583,8282,3148,8539,16821,8542,16839
,GaoYangZhen,141181104,29657,3316,19094,11858,36941,17386,7420,18527,35913,21299,40393
ͩ,WuTongZhen,141181105,19404,2056,13225,7970,24812,13224,5306,13523,26747,13541,26766
,ZhuPuZhen,141181106,7719,1089,5105,3283,10145,4946,1637,5156,10102,5340,10445
Т,DaXiaoBaoXiang,141181200,23434,2642,15519,10098,30186,15386,6298,16322,31708,16855,32374
դ,XiaShanXiang,141181201,11170,1290,6585,4035,12276,6165,2577,6750,12915,8452,15037
,YiMaXiang,141181202,5852,809,3097,2336,6019,3064,1132,3310,6374,4696,7793
,NanYangXiang,141181203,4563,674,2995,2014,5598,2942,1165,3273,6215,3407,6402
Ŵ,DuCunXiang,141181204,6047,850,3997,2521,7881,3919,1507,4342,8261,4407,8404
ķֵ´,WenFengJieDaoBanShiChu,141182001,28295,2461,19850,9846,26442,15159,7214,15373,30532,18120,37970
̫Žֵ´,TaiHeQiaoJieDaoBanShiChu,141182002,31165,2556,19982,10531,28257,15701,6146,15383,31084,19885,39867
ּׯ,JiaJiaZhuangZhen,141182100,21718,2522,14420,8575,28098,14276,5830,15456,29732,15650,30070
ӻ,XingHuaCunZhen,141182101,22991,2109,14716,8664,28796,13727,5446,14440,28167,15830,30546
,JiCunZhen,141182102,27805,3185,19209,11178,37965,19099,8148,19765,38864,19929,39138
Фׯ,XiaoJiaZhuangZhen,141182103,23617,2715,15954,9773,31533,15738,6425,16524,32262,16803,32757
,YanWuZhen,141182104,19388,2268,13497,7381,26671,13392,5696,13674,27066,13855,27352
Ȫ,SanQuanZhen,141182105,23812,2976,15732,9889,30788,15255,6160,16327,31582,17216,32948
ʯׯ,ShiZhuangZhen,141182106,6465,934,4321,2795,8395,4176,1386,4231,8407,4464,8785
ׯ,YangJiaZhuangZhen,141182107,10189,1361,6805,4327,13278,6780,2627,7213,13993,7372,14177
,YuDaoHeZhen,141182108,15176,1941,10007,6282,20327,10005,3682,10788,20793,10792,20799
,XiHeXiang,141182200,26591,1993,17267,10814,19083,16520,6473,16742,33262,17790,35057
,YangChengXiang,141182201,30794,3185,20829,12619,39964,20605,8613,21575,42180,21763,42592
ׯ,LiJiaZhuangXiang,141182202,17758,2112,11523,7245,21483,11333,4284,12141,23474,12631,24154
·ֵ´,HaiLaErDongLuJieDaoBanShiChu,150102001,67147,5147,39755,20236,34750,26339,6529,24468,50807,39068,78823
·ֵ´,XiLinLuJieDaoBanShiChu,150102002,23382,4179,15559,11343,17915,14772,3013,14253,29025,15015,30574
ɽ·ֵ´,ZhongShanDongLuJieDaoBanShiChu,150102003,13790,2764,9148,6647,10677,8382,1423,7794,16176,8829,17977
ֵֽ´,DongJieJieDaoBanShiChu,150102004,35075,4633,22869,16289,29596,22123,5336,21252,43375,22175,45044
ֵֽ´,XiJieJieDaoBanShiChu,150102005,33801,5458,23026,16314,30233,22099,5450,20666,42765,21683,44709
·ֵ´,DongFengLuJieDaoBanShiChu,150102006,62593,5083,40017,27522,41032,37549,11013,36311,73860,38672,78689
ӭ·ֵ´,YingXinLuJieDaoBanShiChu,150102007,34640,3293,22261,15007,22326,20244,5668,19955,40199,21340,43601
ɼ˼ֵֽ´,ChengJiSiHanDaJieJieDaoBanShiChu,150102008,169979,6904,102126,74758,44934,98432,39124,104230,202662,113881,216007
,BaoHeShaoZhen,150102101,8674,1504,5293,4332,10289,5272,1331,6067,11339,6216,11509
³ʢ߿Ƽ԰,XinChengQuHongShengGaoKeJiYuanQu,150102400,306,9,137,52,1,31,7,53,84,185,322
»·´,XinHuaXiLuBanShiChu,150103001,30776,4014,20776,12744,19005,16666,3730,16054,32720,17744,38520
ɽ·´,ZhongShanXiLuBanShiChu,150103002,15532,2378,10360,7324,10810,9443,1984,8907,18350,9534,19894
·´,GuangMingLuBanShiChu,150103003,35947,3948,23030,15618,21409,20522,5454,19739,40261,22319,45349
·´,HaiLaErXiLuBanShiChu,150103004,31913,3612,19484,14897,22629,19212,5131,19346,38558,21172,40656
ӽְ´,HuanHeJieBanShiChu,150103005,34723,4090,22515,16557,21600,21888,5735,21330,43218,22033,44548
ְͨ´,TongDaoJieBanShiChu,150103006,17159,2618,11293,8153,13940,10741,2384,10356,21097,10868,22161
·´,GangTieLuBanShiChu,150103007,23677,2381,13868,10519,12629,13570,3940,13598,27168,16130,29998
,YouYouBanZhen,150103100,125822,5004,77682,46486,28050,60219,22603,63581,123800,75747,153429
Сǰְ´,XiaoZhaoQianJieBanShiChu,150104001,19214,2472,12720,9211,12617,12298,3121,11804,24102,12087,24807
¡´,XingLongXiangBanShiChu,150104002,21193,2282,14003,10315,11170,13732,4063,13314,27046,13535,27538
Ȱ´,ChangHeLangBanShiChu,150104003,11184,1137,7102,5380,5460,6937,1983,6892,13829,7202,14304
ʯ·´,ShiDongLuBanShiChu,150104004,22714,2529,14667,10898,14528,14279,3703,13875,28154,14279,28946
Ͻְ´,DaNanJieBanShiChu,150104005,17896,1688,11781,7909,9996,10674,2709,10082,20756,10512,22293
˹·´,EErDuoSiLuBanShiChu,150104006,16155,1317,10196,7669,4208,10154,3494,10670,20824,10770,20966
԰´,XiCaiYuanBanShiChu,150104007,79619,3433,46833,34784,11469,46535,18602,48277,94812,54821,101654
Ѿ·´,ZhaoJunLuBanShiChu,150104008,62588,2562,38838,24480,8742,33010,13679,34593,67603,39991,78829
Сں,XiaoHeiHeZhen,150104100,49472,3765,29856,21729,24858,28489,10791,30970,59459,34172,64028
·ֵ´,RenMinLuJieDaoBanShiChu,150105001,48249,6885,31718,22528,37967,30133,7403,28679,58812,30819,62537
ѧ·ֵ´,DaXueXiLuJieDaoBanShiChu,150105002,52906,5179,33694,15160,29890,20326,4610,19175,39501,29001,62695
첼·ֵ´,WuLanChaBuLuJieDaoBanShiChu,150105003,31939,3769,20738,14949,20794,19942,4936,18790,38732,19906,40644
ѧ·ֵ´,DaXueDongLuJieDaoBanShiChu,150105004,50144,4490,28912,15418,24779,20617,4973,19399,40016,30695,59607
ר·ֵ´,ZhongZhuanLuJieDaoBanShiChu,150105005,45079,3448,27955,18284,17987,24302,6907,23768,48070,27479,55434
ɱ,QiaoBaoZhen,150105100,111876,5816,69375,51995,34411,67246,24564,69974,137220,72881,142256
,YuLinZhen,150105101,10754,2102,6480,5217,12800,6345,1390,6945,13290,7766,14246
,BaYanZhen,150105102,50426,1672,27081,6892,13058,9261,3446,9872,19133,28463,55544
ƺ,HuangHeShaoZhen,150105103,24106,4298,15245,11753,29047,14958,4001,16528,31486,17160,32405
,JinHeZhen,150105104,28108,2974,17133,12714,28523,16992,5542,18909,35901,19491,36624
դ,XiBaShanXiang,150105201,45907,2572,27009,19989,15789,26671,10336,28476,55147,31806,58815
žü�,JinQiaoJingJiJiShuKaiFaQu,150105400,8590,260,4283,2072,2098,2704,798,2604,5308,5365,9648
ͺ⿪,HuHeHaoTeShiRuYiKaiFaQu,150105401,4579,237,2235,1330,17,1777,328,1660,3437,2909,5144
,ChaSuQiZhen,150121100,68803,7846,43505,30868,68637,41500,13378,43762,85262,46522,90027
Ͽ,BiKeQiZhen,150121101,21165,3369,13733,9925,26803,13548,3959,14502,28050,14760,28493
,ShanDaiZhen,150121102,21906,4166,14137,10552,28560,14137,3533,15468,29605,15468,29605
̨,TaiGeMuZhen,150121103,21422,1665,13231,9547,14797,13142,4641,14137,27279,14497,27728
,BaiMiaoZiZhen,150121104,23114,3724,14825,10839,28299,14707,4640,16022,30729,16653,31478
ɳ,ShaErQinZhen,150121105,10787,1792,7093,5048,13465,7060,2371,7720,14780,7857,14950
ʲ,BeiShenZhouXiang,150121207,18166,2909,11416,8231,23152,11416,3147,12800,24216,12806,24222
,TaBuSaiXiang,150121208,12580,2333,8132,5705,16427,8130,2363,9121,17251,9144,17276
ֻ,ZhiJiLiangXiang,150121212,17247,3516,11372,8927,22226,11354,2919,12164,23518,12310,23682
ͺؾü�,HuHeHaoTeJingJiJiShuKaiFaQuJinChuanQu,150121400,15849,294,8091,3964,19,4620,1383,4859,9479,9435,17526
ͺؽɽü�,HuHeHaoTeJinShanJingJiJiShuKaiFaQu,150121401,7323,72,4485,210,16,185,44,214,399,2954,7439
ͺ⿪,HuHeHaoTeRuYiKaiFaQuNanQu,150121402,100,5,30,0,2,0,1,0,0,76,106
˫,ShuangHeZhen,150122100,69790,6566,44692,31619,67197,42610,16597,43625,86235,48261,92953
Ӫ,XinYingZiZhen,150122101,41136,4333,26317,16853,44514,25872,9968,27850,53722,29120,55437
,WuShenZhen,150122102,15801,2840,10067,7528,20367,10058,2375,10920,20978,10949,21016
ʲ,WuShenJiaZhen,150122103,7490,1295,4551,3591,8612,4523,1293,5241,9764,5527,10078
ų,GuChengZhen,150122104,16256,2149,10374,6156,20133,10362,2951,10923,21285,10982,21356
ǹ,ChengGuanZhen,150123100,39745,4229,25387,18088,36074,24343,8310,25504,49847,26897,52284
ʢ,ShengLeZhen,150123101,27205,3889,17042,10789,34539,16959,5077,18923,35882,19129,36171
µ,XinDianZiZhen,150123102,9045,1228,5649,3886,11629,5634,1636,6195,11829,6260,11909
,SheBiYaXiang,150123203,14885,2349,9334,6312,18264,9298,2270,10081,19379,10170,19504
,DaHongChengXiang,150123205,10663,1866,6661,4997,13790,6660,1508,7358,14018,7376,14037
Ⱥ,YangQunGouXiang,150123206,3378,424,2126,1248,4333,2126,570,2246,4372,2246,4372
ز,HeiLaoYaoXiang,150123207,3430,728,2099,1946,4465,2099,365,2424,4523,2424,4523
ʢ־ùҵ԰,ShengLeJingJiGongYeYuanQu,150123400,23347,898,15322,5797,7496,7389,2811,8179,15568,11734,27056
ǹ,ChengGuanZhen,150124100,29206,3083,19188,13251,25271,18495,6864,19031,37526,19965,39153
,HongHeZhen,150124101,9290,1676,5818,4820,11483,5749,1471,6099,11848,6619,12437
,LaMaWanZhen,150124102,11231,1081,7602,5292,10248,7569,3420,7996,15565,8130,15732
Ҥ,YaoGouXiang,150124200,10466,2163,6617,5187,13839,6567,1557,7143,13710,7569,14186
,BeiBaoXiang,150124201,4583,996,2778,2420,5921,2757,464,3136,5893,3265,6043
탲ׯ,JiuCaiZhuangXiang,150124202,4807,985,2903,2517,6185,2811,544,3146,5957,3433,6336
,KeZhen,150125100,38973,4070,26170,19082,27212,25898,9369,25915,51813,26242,52412
,HaLeZhen,150125101,12380,1985,7408,5827,15259,7393,1691,8533,15926,8648,16056
,XiWuLanBuLangZhen,150125102,6336,1286,3951,3281,7739,3941,840,4343,8284,4511,8462
ɽ,DaQingShanXiang,150125200,2506,446,1502,1426,2910,1499,333,1767,3266,1783,3285
ͺ,ShangTuHaiXiang,150125205,9565,1942,6064,5064,12429,6057,1204,6607,12664,6647,12711
ʤ,DeShengGouXiang,150125207,1929,450,1124,1128,2446,1124,157,1405,2529,1412,2536
,ErFenZiXiang,150125211,5707,1379,3602,3178,7403,3593,655,4046,7639,4139,7741
,HaLaHeShaoXiang,150125213,3945,993,2287,2217,4787,2238,307,2685,4923,2958,5245
ɹ䴨ÿ,NeiMengGuWuChuanJingJiKaiFaQu,150125400,182,8,70,61,0,62,17,90,152,137,207
䴨ǿ,WuChuanJinSanJiaoKaiFaQu,150125401,58,3,31,21,1,26,10,32,58,40,71
ƽ·ֵ´,HePingLuJieDaoBanShiChu,150202001,16833,1926,10869,7741,12580,10787,2358,10190,20977,10248,21117
ֵ´,CaiShenMiaoJieDaoBanShiChu,150202002,16591,2767,10836,8345,13735,10702,2258,10661,21363,10780,21616
԰ֵ´,XiNaoBaoJieDaoBanShiChu,150202003,37984,4797,24275,18401,27314,24070,6005,24333,48403,24511,48786
ֵ´,NanMenWaiJieDaoBanShiChu,150202004,26518,3021,16721,12643,17489,16549,3850,16401,32950,16668,33389
ٶֵ´,NanGeDongJieDaoBanShiChu,150202005,38643,4922,23866,17240,31664,23646,5651,23147,46793,25350,49216
վֵ´,DongZhanJieDaoBanShiChu,150202006,43965,8022,28450,20512,44668,27215,5278,26541,53756,28815,57265
ֵ´,HuiMinJieDaoBanShiChu,150202007,17849,2517,11211,8404,15343,10867,2093,10916,21783,11248,22459
ֵ´,ErLiBanJieDaoBanShiChu,150202008,27035,3490,16981,13309,18167,16936,3759,17197,34133,17303,34284
Ӷֵ´,HeDongJieDaoBanShiChu,150202009,29107,3541,18386,13833,20223,18084,4664,18329,36413,18926,37312
ֵ´,TieXiJieDaoBanShiChu,150202010,23990,3316,15368,11842,14558,15149,3958,15523,30672,15896,31264
˽ֵ´,DongXingJieDaoBanShiChu,150202011,24583,3923,15832,11918,24762,15436,3591,15446,30882,16265,32097
ֵ´,YangGeLengJieDaoBanShiChu,150202012,1919,255,1112,1038,1756,1111,263,1232,2343,1325,2437
Ӷ,HeDongZhen,150202100,54138,3541,33907,22845,19795,30009,10590,31632,61641,34362,68269
ɳ,ShaErQinZhen,150202101,41166,4240,25074,19133,45074,24960,7128,26911,51871,27460,52534
·ֵ´,ShaoXianLuJieDaoBanShiChu,150203001,45487,10423,31361,23017,51650,30734,6449,30050,60784,30998,62359
̶ֵ´,ZhaoTanJieDaoBanShiChu,150203003,42595,3249,18715,9698,25798,12233,2702,12415,24648,29831,48546
·ֵ´,LinYinLuJieDaoBanShiChu,150203004,17283,2962,11509,8685,14980,11117,2471,10815,21932,11207,22716
ֵֽ´,YouYiDaJieJieDaoBanShiChu,150203005,18548,4237,12741,10067,15483,12605,3063,12676,25281,13107,25848
ֵֽ´,AErDingDaJieJieDaoBanShiChu,150203006,32326,5645,22209,16397,25011,20921,5450,19843,40764,21212,43421
Žֵֽ´,TuanJieDaJieJieDaoBanShiChu,150203007,20151,2047,12743,9479,14600,12622,3585,12770,25392,13040,25783
ɽֵ´,AnShanDaoJieDaoBanShiChu,150203008,40469,5253,26498,18992,29551,25951,6904,25389,51340,26128,52626
ǰֵ´,QianJinDaoJieDaoBanShiChu,150203009,37058,4560,23861,16366,26199,21676,5905,20867,42543,23662,47523
и·ֵ´,ShiFuDongLuJieDaoBanShiChu,150203010,24991,2150,15231,10413,18885,14386,3437,14325,28711,15347,30578
·ֵ´,BaiYunLuJieDaoBanShiChu,150203011,21450,3746,14349,10752,18243,14114,3384,13744,27858,14231,28580
ƺ·ֵ´,HuangHeXiLuJieDaoBanShiChu,150203012,35973,4694,22361,17241,29760,22000,4836,22370,44370,23142,45503
·ֵ´,KunGongLuJieDaoBanShiChu,150203013,16899,4172,11941,8873,18241,11612,2735,11475,23087,11865,23806
ֵ´,KunBeiJieDaoBanShiChu,150203014,47544,2013,28824,22148,9170,28606,11035,30800,59406,31768,60592
,KunHeZhen,150203100,136241,5013,82852,61407,22658,82128,32878,87437,169565,91280,174132
ͼ,BuErHanTuZhen,150203102,26831,1499,15283,11976,10282,14945,5386,16222,31167,18433,33716
ֳ´,BaoGangChangQuBanShiChu,150203400,1019,33,317,507,0,314,57,531,845,792,1109
ȷֵ´,XianFengDaoJieDaoBanShiChu,150204001,28631,3811,17521,12472,19575,16238,3784,15898,32136,18705,36226
Ҹ·ֵ´,XingFuLuJieDaoBanShiChu,150204002,26220,3677,17261,12353,23506,16526,3714,15837,32363,16350,33611
·ֵ´,WanQingLuJieDaoBanShiChu,150204003,41292,3526,26111,18652,24320,24890,7503,24416,49306,26210,52321
ǿ·ֵ´,FuQiangLuJieDaoBanShiChu,150204004,35802,7223,24297,17876,35369,23539,5567,22799,46338,24295,48592
ѧ·ֵ´,KeXueLuJieDaoBanShiChu,150204005,53075,7150,32621,23858,44068,30719,6988,30121,60840,34592,67213
ɽ·ֵ´,QingShanLuJieDaoBanShiChu,150204006,35420,6755,23157,17913,34455,22417,5132,22202,44619,24150,47307
·ֵ´,ZiYouLuJieDaoBanShiChu,150204007,59673,7344,39197,24345,46261,31700,8340,31470,63170,36160,75357
ͼֵ´,WuSuTuJieDaoBanShiChu,150204008,20194,2630,11448,6883,13710,8290,1860,8171,16461,13236,24684
ร,QingFuZhen,150204100,35547,910,18538,14300,5767,15566,4969,17088,32654,22888,41426
ʤ,XingShengZhen,150204101,42691,2031,25774,19544,9626,25561,9759,27586,53147,28707,54481
ˮȪ,WanShuiQuanZhen,150204102,28841,2674,17696,12764,19430,17388,5747,18106,35494,19566,37262
ͷϡϡ·ֵ´,BaoTouXiTuGaoXinQuXiTuLuJieDaoBanShiChu,150204401,65467,3091,38704,28515,18917,36821,13246,38619,75440,43100,81804
ʯսֵ´,ShiGuaiJieDaoBanShiChu,150205001,5231,915,3456,2878,5436,3442,749,3430,6872,3439,6895
󷢽ֵ´,DaFaJieDaoBanShiChu,150205002,393,151,270,269,540,270,36,300,570,310,580
Žֵ´,DaCiJieDaoBanShiChu,150205003,2298,762,1603,1476,3138,1603,249,1698,3301,1706,3309
嵱ֵ´,WuDangGouJieDaoBanShiChu,150205004,4914,1133,3289,2800,6469,3288,608,3357,6645,3366,6655
׺ֵ´,BaiHuGouJieDaoBanShiChu,150205005,4020,775,2489,2140,5033,2485,400,2572,5057,2706,5195
º´,DaDeHengBanShiChu,150205006,2588,345,1444,1207,2604,1405,345,1528,2933,1834,3278
嵱,WuDangZhaoZhen,150205101,5212,951,2950,2921,6030,2942,508,3607,6549,3721,6671
ҵ԰ίԱ,GongYeYuanQuGuanLiWeiYuanHui,150205400,2670,356,1312,1348,1871,1258,194,1470,2728,1908,3220
ɽ·ֵ´,KuangShanLuJieDaoBanShiChu,150206001,9316,971,5758,4558,7002,5655,1686,5809,11464,6215,11973
ֵͨ´,TongYangDaoJieDaoBanShiChu,150206002,11009,1089,6796,5047,6679,6643,1979,6691,13334,7281,14077
ɳӽֵ´,ShaHeJieDaoBanShiChu,150207001,50642,3481,32494,23015,21590,31193,11372,31344,62537,33001,65495
ֵ´,SaiHanJieDaoBanShiChu,150207002,17040,877,10120,7843,3896,9944,3685,10604,20548,11482,21602
ֵ´,SaRuLaJieDaoBanShiChu,150207003,3557,404,2156,1703,3135,2129,604,2232,4361,2409,4565
ϯսֵ´,BaiYinXiLeJieDaoBanShiChu,150207004,27427,1818,15877,11607,5435,15030,6237,16227,31257,19605,35482
,MaChiZhen,150207103,25352,1720,15919,12263,11319,15815,5870,16677,32492,17023,32942
ָ,HaLinGeErZhen,150207105,16629,1886,9999,8005,13510,9724,3012,10359,20083,11528,21527
ҵͬ,HaYeHuTongZhen,150207110,9347,1381,5899,4741,10853,5785,1651,6159,11944,6480,12379
̩ľ,AGaRuTaiSuMu,150207202,1552,106,705,629,857,691,181,753,1444,1134,1839
ɽ,JinShanZhen,150222102,59759,6624,38150,27691,56544,37631,11532,38467,76098,39765,77915
,XiDouPuZhen,150222103,13253,1739,8003,5485,16634,7961,2034,8864,16825,9023,17026
ʪ,XiaShiHaoZhen,150222104,21369,2510,12678,8908,26637,12636,3682,14310,26946,14883,27561
,YinHaoZhen,150222105,14951,1721,8879,5580,18633,8875,2261,9994,18869,10054,18933
˷,HuaiShuoZhen,150222106,14966,2028,9059,6330,19078,9055,2324,10178,19233,10259,19318
˳,XingShunXiZhen,150222107,11483,1683,7010,4914,14641,6995,1655,7738,14733,7811,14821
,ManDouLaZhen,150223102,899,59,524,428,924,510,149,550,1060,583,1107
ϣ,XiLaMuRenZhen,150223103,1659,159,983,893,1632,980,259,1094,2074,1094,2077
,BaiLingMiaoZhen,150223104,29462,3334,18788,14007,24417,18367,5779,18276,36643,19787,38575
ʯ,ShiBaoZhen,150223105,20365,2439,12694,8284,23511,12631,3593,13457,26088,13703,26397
ڿ˺,WuKeHuDongZhen,150223106,20476,2786,12553,9556,25993,12549,3222,13928,26477,13931,26484
,MingAnZhen,150223107,1467,85,711,827,1300,711,162,997,1708,1003,1714
,BaYinHuaZhen,150223108,1200,94,700,665,1291,691,206,764,1455,800,1500
ľ,DaErHanSuMu,150223213,2648,240,1510,1438,2943,1504,365,1606,3110,1743,3253
ïҵ԰,DaMaoBaRunGongYeYuanQu,150223400,375,1,31,31,0,26,3,32,58,348,379
ֵ´,FengHuangLingJieDaoBanShiChu,150302001,53145,4103,32636,23754,43191,31987,9650,32189,64176,34262,66898
ֵ´,HaiBeiJieDaoBanShiChu,150302002,57479,5228,35785,26045,47773,35256,10496,35189,70445,37418,73203
»ֵ´,XinHuaJieDaoBanShiChu,150302003,36898,2871,22629,17305,25171,22317,6941,23502,45819,24081,46710
»ֵ´,XinHuaXiJieDaoBanShiChu,150302004,28641,2287,17253,13180,17430,17019,4900,17566,34585,18575,35828
ֵ´,KaBuQiJieDaoBanShiChu,150302005,13237,1483,6623,4952,9647,6453,1522,6919,13372,9619,16242
ӽֵ´,BinHeJieDaoBanShiChu,150302007,28236,1840,15523,10904,14295,14325,4254,15149,29474,18807,34330
ǧɽ,QianLiShanZhen,150302101,18450,1154,9971,7533,10808,9704,3362,10711,20415,12995,22966
ɮٽֵ´,LaSengZhongJieDaoBanShiChu,150303001,29604,1485,18010,13428,14157,17766,7116,18660,36426,20195,38205
׿ɽֵ´,XiZhuoZiShanJieDaoBanShiChu,150303002,6277,476,3770,3086,3950,3682,1225,3860,7542,4208,7978
,GongWuSuZhen,150303102,21365,1557,11986,8959,14128,11447,3934,12488,23935,14870,26856
ɮ,LaSengMiaoZhen,150303103,11057,1218,6603,4822,8539,6080,1937,6452,12532,7609,14212
պ,BaYinTaoHaiZhen,150303104,12918,1639,6110,4777,9549,5757,1547,6017,11774,9994,16104
ֵ´,SanDaoKanJieDaoBanShiChu,150304002,8942,499,4115,2828,3662,3501,1166,3851,7352,6492,10607
廢ɽֵ´,WuHuShanJieDaoBanShiChu,150304003,12501,1355,7790,6188,9963,7738,2487,8285,16023,8553,16343
´ֵ´,XinDaJieDaoBanShiChu,150304008,26598,3069,16709,12318,21259,15967,4132,15893,31860,17090,33799
ֵ´,BaYinSaiJieDaoBanShiChu,150304009,20158,1595,12752,9798,14787,12648,4020,12684,25332,13021,25773
ҹֵ´,LiangJiaGouJieDaoBanShiChu,150304010,11275,1942,7249,6011,12143,7240,1672,7546,14786,7640,14889
պͼֵ´,SuHaiTuJieDaoBanShiChu,150304011,9151,1650,6007,5116,10466,6005,1469,6247,12252,6263,12270
�ֵ´,BinHaiJieDaoBanShiChu,150304012,12633,961,7006,5108,6414,6687,1898,6856,13543,8486,15492
׶,WuLanNaoErZhen,150304101,3192,492,1989,1661,3187,1981,513,2076,4057,2208,4197
ͽֵ´,XiTunJieDaoBanShiChu,150402001,28085,2613,17853,12003,21762,16279,4673,16028,32307,17518,35371
нֵֽ´,SanZhongJieJieDaoBanShiChu,150402002,16128,1600,10335,6693,10610,9473,2704,9142,18615,10097,20432
޽ֵ´,YongJuJieDaoBanShiChu,150402003,22055,2519,14496,10281,19200,14374,4103,14011,28385,14181,28677
ǽֵ´,DongChengJieDaoBanShiChu,150402004,30259,2246,18990,13596,12155,18378,5910,18703,37081,19425,38415
½ֵֽ´,NanXinJieJieDaoBanShiChu,150402005,30795,4160,20528,14196,28022,20035,5401,19406,39441,19828,40356
վǰֵ´,ZhanQianJieDaoBanShiChu,150402006,45968,4782,30044,18239,34401,24612,6923,23988,48600,27629,57673
Ͻֵ´,TieNanJieDaoBanShiChu,150402007,21391,1733,13144,9743,11312,12847,3706,13206,26053,13686,26830
ֵ´,ChangQingJieDaoBanShiChu,150402008,26720,3628,17347,12037,25032,16767,4203,16239,33006,17204,34551
ֵ´,HaDaJieDaoBanShiChu,150402009,23746,3342,16228,11456,18330,15250,4090,14401,29651,14950,31178
ǽֵ´,XiChengJieDaoBanShiChu,150402010,40597,2695,25249,17692,22414,25072,8752,26459,51531,26795,52044
űֵ´,QiaoBeiJieDaoBanShiChu,150402011,8804,961,5513,3735,7874,5268,1904,5597,10865,6156,11669
,HongMiaoZiZhen,150402100,11711,1111,7376,4443,13887,7372,2345,7721,15093,7791,15167
,WenZhongZhen,150402102,22261,2265,13964,8960,25210,13917,4700,14758,28675,15262,29226
ɽҵ԰,HongShanGongYeYuanQu,150402400,5017,7,1966,1,0,1,0,1,2,3058,5024
ɽ԰,HongShanWuLiuYuanQu,150402401,8005,128,2767,122,2,122,39,163,285,5405,8172
¶ֵ´,XiLuTianJieDaoBanShiChu,150403001,12176,3135,8715,6829,14955,8699,2054,8583,17282,8650,17365
ƽׯֵ´,PingZhuangChengQuJieDaoBanShiChu,150403002,30293,3426,19525,13086,26609,18882,5589,18690,37572,19783,39308
ƽׯֵ´,PingZhuangDongChengQuJieDaoBanShiChu,150403003,33407,3589,21759,15463,28210,21592,6719,21772,43364,21956,43715
ƽׯֵ´,PingZhuangXiChengQuJieDaoBanShiChu,150403004,16304,1207,10274,6393,6669,9046,3108,8959,18005,10345,20619
ֵֽ´,MaLinJieDaoBanShiChu,150403005,4987,524,3103,2424,5314,3095,806,3165,6260,3214,6317
ɼ·ֵ´,YunShanLuJieDaoBanShiChu,150403006,28577,4188,19240,14529,28309,19144,5624,18932,38076,19149,38389
ˮ,FengShuiGouZhen,150403100,13008,1217,8133,5385,15215,8110,2551,8550,16660,8643,16776
Ԫɽ,YuanBaoShanZhen,150403101,27464,2682,17288,10776,31586,17212,5683,18219,35431,18541,35829
,MeiLiHeZhen,150403102,17646,1907,11087,6636,21578,11011,3627,11853,22864,12093,23180
ƽׯ,PingZhuangZhen,150403103,50789,4724,32067,18708,57710,31982,10665,33893,65875,34111,66178
,WuJiaZhen,150403104,12492,1674,8164,5428,14812,8109,2410,8260,16369,8412,16576
Դ;תͿ,ChiFengShiZiYuanXingJingJiZhuanXingKaiFaShiYanQu,150403400,916,2,253,0,4,0,0,0,0,665,918
˽ֵ´,ZhenXingJieDaoBanShiChu,150404001,28450,2068,17875,10943,11495,16070,6082,16475,32545,18725,36600
ֵ´,XiangYangJieDaoBanShiChu,150404002,14940,1090,9755,6695,7825,9699,3658,9875,19574,9933,19688
ݽֵ´,SongZhouJieDaoBanShiChu,150404003,28772,2035,16164,11122,8667,15997,6042,16276,32273,20685,36849
ֵ´,TieDongJieDaoBanShiChu,150404004,5683,550,3558,2529,2238,3422,1206,3573,6995,3881,7439
ֵ´,YuLongJieDaoBanShiChu,150404005,28355,1529,17249,10768,5957,15108,4748,14883,29991,17383,34632
˰ֵ´,XingAnJieDaoBanShiChu,150404007,17624,490,8584,3597,2026,4913,1496,4895,9808,11026,19610
ȫֵ´,QuanNingJieDaoBanShiChu,150404008,6407,306,3971,2726,544,3540,789,3135,6675,3531,7502
¼Ӫ,MuJiaYingZiZhen,150404100,77995,4234,48733,33017,53371,48036,19198,51539,99575,52694,101427
ͷ,ChuTouLangZhen,150404101,19201,2118,12044,7338,23166,11458,3860,12378,23836,13135,25179
,DaMiaoZhen,150404102,16600,1878,10388,6246,21402,10384,3329,11388,21772,11419,21807
,WangFuZhen,150404103,18885,2030,11945,6677,24151,11944,3923,12871,24815,12893,24838
ϸ,LaoFuZhen,150404104,20758,2490,13010,7918,27151,13003,4520,14725,27728,14758,27768
,HaLaDaoKouZhen,150404105,18532,1896,11754,6554,23295,11752,3728,12392,24144,12402,24156
Ϲٵ,ShangGuanDiZhen,150404106,10301,1335,6585,4480,13181,6564,2006,6992,13556,7057,13642
,AnQingZhen,150404107,19919,1695,12255,7077,24520,12250,3867,13203,25453,13226,25481
̫ƽ,TaiPingDiZhen,150404108,28817,2667,17979,10555,36502,17971,6114,19584,37555,19619,37598
̵,DangPuDiManZuXiang,150404200,24724,2434,15404,8883,30200,15341,5023,16452,31793,16777,32181
ļҵ,XiaJiaDianXiang,150404201,22273,2178,13700,7672,27179,13664,4127,14581,28245,14878,28578
,ChengZiXiang,150404202,18010,2077,11449,6982,23057,11436,3727,12310,23746,12365,23814
Ӫ,DaiFuYingZiXiang,150404203,10357,1523,6715,4552,13629,6707,2153,7228,13935,7318,14033
,GangZiXiang,150404204,8217,1108,5055,3154,10380,5054,1424,5587,10641,5694,10749
ɽ´,TianShanBanShiChu,150421001,46129,3881,30573,21846,48513,30154,10601,29579,59733,30038,60611
ɽ,TianShanZhen,150421100,24372,2462,15442,9728,29106,15015,4286,15173,30188,15678,31120
ɽ,TianShanKouZhen,150421101,23674,2564,14697,11876,29500,14499,4069,15285,29784,15610,30307
˫ʤ,ShuangShengZhen,150421102,12393,1359,8071,5814,15770,8063,2540,8136,16199,8221,16292
,KunDouZhen,150421103,6538,436,4136,2686,7627,4114,1365,4131,8245,4203,8339
廨,BaYanHuaZhen,150421104,18488,1675,11351,8666,22926,11343,3198,11970,23313,12010,23361
ܸ,ShaoGenZhen,150421105,14814,1080,9142,6017,17156,9032,2831,9246,18278,9583,18725
,XinMinXiang,150421200,7672,938,4889,3808,9351,4877,1319,4984,9861,5040,9929
ȷ,XianFengXiang,150421201,22969,1938,10514,8391,27307,10508,3069,10423,20931,17462,27976
ľľ,HanSuMuSuMu,150421202,14996,1021,9342,6531,18513,9226,3435,9785,19011,10110,19452
ľ,SaiHanTaLaSuMu,150421203,10989,750,6593,4615,12617,6563,2141,6936,13499,7287,13880
ľ,BaLaQiRuDeSuMu,150421204,9688,786,5902,4581,11948,5900,1739,6277,12177,6311,12213
ֶǽֵ´,LinDongXiChengJieDaoBanShiChu,150422001,36629,2355,23943,15586,25316,21315,8266,20832,42147,23307,47250
ֶǽֵ´,LinDongDongChengJieDaoBanShiChu,150422002,19198,1646,12854,9102,15816,12742,4607,12425,25167,12597,25451
ֶ,LinDongZhen,150422100,45455,3932,29147,17860,54262,29085,9255,29127,58212,29495,58642
¡,LongChangZhen,150422101,30823,2799,19581,12528,39236,19562,6337,20301,39863,20378,39959
ʮ,ShiSanAoBaoZhen,150422102,34738,3008,21900,14061,44130,21878,7151,22891,44769,22997,44897
̨,BiLiuTaiZhen,150422103,31274,2790,19810,12647,39882,19797,6449,20685,40482,20703,40513
,FuHeZhen,150422104,15347,1316,9744,6242,18816,9695,3093,9783,19478,10012,19756
ŵ,BaiYinNuoErZhen,150422105,8544,401,5178,3871,5586,5080,1860,5237,10317,5627,10805
,HaLaHaDaZhen,150422106,9937,876,6321,3967,12627,6316,2033,6492,12808,6525,12846
ɹľ,ChaGanHaDaSuMu,150422200,10020,910,6259,4194,12442,6177,1925,6441,12618,6596,12855
ľ,WuLanDaBaSuMu,150422201,11648,877,7250,5322,13505,7217,2266,7350,14567,7541,14791
,DaBanZhen,150423100,70262,4488,42289,29446,64622,40144,13766,40386,80530,46227,88516
ո,SuoBoRiGaZhen,150423101,13292,1163,8091,6080,16261,8091,2344,8706,16797,8708,16799
,BaoRiWuSuZhen,150423102,11463,899,7159,4992,14027,7151,2342,7508,14659,7545,14704
ŵ,ChaGanNuoErZhen,150423103,9580,966,5751,4029,11862,5642,1660,6153,11795,6455,12206
,ChaGanMuLunZhen,150423104,9630,764,5766,4270,11112,5753,1475,5966,11719,6103,11869
ľ,XiLaMuLunSuMu,150423200,9653,740,5972,3865,11689,5969,1853,6259,12228,6274,12246
ľ,BaYanTaLaSuMu,150423201,7758,710,4698,3566,9353,4696,1196,4964,9660,4966,9664
Ҹ֮·ľ,XingFuZhiLuSuMu,150423202,7537,744,4632,3172,8625,4456,1258,4580,9036,4907,9539
ֵ´,LinXiJieDaoBanShiChu,150424001,49206,4395,31974,23146,42667,30735,9459,29828,60563,31086,63060
,LinXiZhen,150424100,20142,1953,12892,8911,21470,12874,3783,12966,25840,12986,25878
³,XinChengZiZhen,150424101,13022,1550,8138,6165,16155,8065,2224,8519,16584,8658,16796
,XinLinZhen,150424102,9506,1218,6041,4965,11740,6023,1580,6136,12159,6263,12304
ʮ,WuShiJiaZiZhen,150424103,16307,1767,10656,7516,20779,10649,3425,10809,21458,10843,21499
ٵ,GuanDiZhen,150424104,12482,1289,7875,5855,15315,7873,2251,8128,16001,8147,16022
,DaJingZhen,150424105,9463,1021,5946,4550,10867,5945,1476,5980,11925,6014,11960
ͳ,TongBuZhen,150424106,14405,1530,9070,7039,17441,9068,2418,9260,18328,9283,18353
Ӫ,DaYingZiXiang,150424200,11383,1367,7243,4408,13998,7224,1997,7431,14655,7504,14747
,JingPengZhen,150425100,18364,2037,11138,8445,18170,10921,2715,11084,22005,11978,23116
,YuZhouDiZhen,150425101,10762,1023,6627,4639,12429,6608,1718,6769,13377,6876,13503
,TuChengZiZhen,150425102,12190,1649,8024,5894,15502,7985,2414,8063,16048,8229,16253
ͬ,TongXingZhen,150425103,9818,853,5026,3859,9343,4936,1277,5140,10076,6922,11948
,WanHeYongZhen,150425104,10844,1376,6740,5206,13134,6661,1721,6845,13506,7201,13941
֥,ZhiRuiZhen,150425105,17922,1861,10635,8192,20574,10520,2673,10868,21388,11821,22456
ŵ,DaLaiNuoRiZhen,150425106,3985,268,2443,1617,4358,2399,639,2338,4737,2449,4892
¿,XinKaiDiXiang,150425200,6837,804,4428,3473,8514,4420,1367,4522,8942,4580,9008
ɽ,HongShanZiXiang,150425201,5208,455,3120,2630,5830,3107,877,3335,6442,3420,6540
պľ,DaRiHanWuLaSuMu,150425202,18429,310,3590,2068,5401,2877,828,3068,5945,15977,19567
ľ,BaYanChaGanSuMu,150425203,7558,274,3576,2339,6397,3313,1140,3469,6782,5396,8972
쾭ֵ´ﱸ,KeQiJingPengJieDaoBanShiChuChouBeiChu,150425400,40055,3247,26065,18295,29975,25736,8332,25196,50932,25569,51634
ˮȪοί,ReShuiTangWenQuanLiaoYangLvYouKaiFaQuGuanWeiHui,150425401,1301,64,793,501,336,609,160,607,1216,732,1525
ͳοί,WuLanBuTongLvYouKaiFaQuGuanWeiHui,150425500,3156,178,1789,1334,3208,1767,496,1899,3666,2041,3830
Ƚֵ´ﱸ,HaoLaiHuReJieDaoBanShiChuChouBeiChu,150425501,3258,274,1863,1480,3275,1843,438,1940,3783,2107,3970
ڵ,WuDanZhen,150426100,107567,10499,68409,45839,121473,64463,20629,65953,130416,70286,138695
ڶ׺,WuDunTaoHaiZhen,150426101,22409,2256,14329,8622,28447,14279,4715,14982,29261,15051,29380
ֵ,WuFenDiZhen,150426102,31052,3426,19478,11482,39919,19292,5975,20678,39970,20975,40453
ͷ,QiaoTouZhen,150426103,40378,3947,24727,13937,51368,24100,7553,26325,50425,27151,51878
¹,GuangDeGongZhen,150426104,21877,2503,13510,8211,27563,13505,3652,14516,28021,14522,28032
ͩ,WuTongHuaZhen,150426105,27054,2718,16975,10407,34093,16969,4927,17700,34669,17724,34699
,HaiRiSuZhen,150426106,10864,885,6871,4806,12574,6852,2278,7060,13912,7156,14027
ںϹ,YiHeGongZhen,150426107,22633,2456,14167,8311,28812,14158,4208,15078,29236,15130,29297
Ӫ,JieFangYingZiXiang,150426200,14083,1551,8712,5131,17774,8710,2411,9310,18020,9333,18045
ʲľ,AShenHanSuMuXiang,150426201,4360,432,2719,2018,5617,2719,841,2914,5633,2914,5633
ľ,BaiYinTaLaSuMuXiang,150426202,20984,1630,13521,8573,26635,13516,4794,13865,27381,13887,27408
׺ľ,BaiYinTaoHaiSuMuXiang,150426203,11801,1132,7898,5514,15403,7894,2818,7811,15705,7853,15751
ɽ,JinShanZhen,150428100,57858,5330,37587,24981,60862,35848,13890,36930,72778,39491,77078
,MeiLinZhen,150428101,17051,2033,11694,8179,23151,11653,4696,11949,23602,12086,23780
ү,WangYeFuZhen,150428102,22011,3085,14456,10825,29165,14377,4963,15478,29855,15603,30059
СţȺ,XiaoNiuQunZhen,150428103,25633,3420,16870,11860,34253,16840,6053,18052,34892,18236,35106
ţӪ,NiuJiaYingZiZhen,150428104,34318,3698,22171,13539,44060,21798,7934,23202,45000,23779,45950
,NaiLinZhen,150428105,24529,2366,15780,9718,30168,15567,5118,15963,31530,16233,32013
,XiQiaoZhen,150428106,18932,1999,12174,7548,23851,12114,4028,12639,24753,12785,24959
ʮ,ShiJiaManZuXiang,150428200,17394,1989,11009,6667,21605,10942,3619,11680,22622,11993,23002
ֹũ,NaiLinGuoShuNongChang,150428400,616,58,393,262,667,387,111,390,777,392,785
�ɽ,MaAnShanYangChang,150428401,394,46,251,194,503,251,74,263,514,263,514
,TianYiZhen,150429100,94653,7518,59648,36113,94861,54564,19485,56094,110658,62008,121656
С,XiaoChengZiZhen,150429101,19174,2009,12153,7611,24508,12095,4025,12966,25061,13055,25208
,DaChengZiZhen,150429102,26071,2593,16454,9994,32877,16261,5264,17138,33399,17474,33928
ﺱ,BaLiHanZhen,150429103,28636,3279,18318,11761,34476,16974,6057,17992,34966,19654,37972
,HeiLiHeZhen,150429104,17198,1996,10619,6680,21775,10554,3104,11504,22058,11679,22298
,DianZiZhen,150429105,30685,3728,19563,11754,39732,19298,6339,20691,39989,21189,40752
˫,DaShuangMiaoZhen,150429106,31712,3438,19944,11294,40481,19901,6502,21561,41462,21708,41652
ϫ,XiZiZhen,150429107,40616,3828,25843,15193,51248,25655,8573,26823,52478,27174,53017
,DaMingZhen,150429108,36691,3798,23456,13929,47175,23429,7860,24693,48122,24893,48349
æũ,MangNongZhen,150429109,26481,2948,16526,10711,34120,16522,5276,17938,34460,18179,34705
廯,WuHuaZhen,150429110,15457,1967,9938,6374,20203,9925,3479,10825,20750,10965,20903
,SanZuoDianXiang,150429200,31213,3544,19888,11992,40347,19767,6523,21164,40931,21392,41280
˹Ӫ,BiSiYingZiXiang,150429201,18945,2352,11985,7458,24744,11952,3828,13040,24992,13140,25125
»,XinHuiZhen,150430100,91183,7856,59137,37888,87217,54560,20233,55428,109988,60135,119272
ļ,SiJiaZiZhen,150430101,32864,3741,21131,13773,42228,21085,7368,22478,43563,22842,43973
ʤ,ChangShengZhen,150430102,37776,3855,24415,14650,47863,24380,7972,25009,49389,25188,49603
Ӹ,BeiZiFuZhen,150430103,34678,3954,21800,13589,43729,21754,7005,23464,45218,23837,45637
ĵ,SiDaoWanZiZhen,150430104,25193,2201,15718,9163,30771,15649,5238,16732,32381,16914,32632
,XiaWaZhen,150430105,23592,2465,15140,8871,30017,15121,5047,15893,31014,15964,31104
𳧹,JinChangGouLiangZhen,150430106,21119,2437,13622,8895,26457,13592,4865,14470,28062,14799,28421
,BaoGuoTuXiang,150430200,22895,2346,14642,8815,29322,14628,5016,15461,30089,15615,30257
ţ,NiuGuTuXiang,150430201,28294,3058,18314,10315,36994,18299,6481,19447,37746,19519,37833
ľͷӪ,MuTouYingZiXiang,150430202,23807,2687,15292,8938,30771,15281,5000,16125,31406,16202,31494
³,GuLuBanHaoXiang,150430203,25263,2542,16029,10151,32518,16021,5089,16808,32829,16865,32894
,FengShouXiang,150430204,16589,1852,10499,6228,21582,10470,3479,11349,21819,11421,21920
ằ,MaNiHanXiang,150430205,10697,1377,6934,5036,13790,6910,2094,7142,14052,7234,14168
,SaLiBaXiang,150430206,13363,1392,8447,5546,17259,8428,2854,9119,17547,9162,17609
Īľ,AoRunSuMoSuMu,150430207,3073,315,1852,1457,3763,1852,537,2055,3907,2073,3925
Ӫ,GuoYingZhongYangChang,150430400,4818,583,3143,2219,5624,3135,900,3132,6267,3158,6301
ƶֵ߽´,KeErQinJieDaoBanShiChu,150502001,32423,3632,20833,15024,23344,20656,5216,20189,40845,20438,41271
Žֵ´,XiMenJieDaoBanShiChu,150502002,47390,3689,28288,16532,27390,22148,6176,21788,43936,28967,57255
ֵ´,YongQingJieDaoBanShiChu,150502003,44478,4098,27311,17239,32147,24100,7032,22959,47059,28297,55608
ʽֵ´,MingRenJieDaoBanShiChu,150502004,17356,1688,11439,7319,12877,10603,2878,9942,20545,10483,21922
ʩֵ´,ShiJieJieDaoBanShiChu,150502005,28886,3152,18783,13551,24916,18687,4818,18003,36690,18073,36856
ֵ´,QingZhenJieDaoBanShiChu,150502006,41655,3666,26495,18211,26065,26166,7032,25605,51771,25858,52353
ֵ´,DongJiaoJieDaoBanShiChu,150502007,22621,2788,13975,9697,15489,12936,2971,12748,25684,14405,28380
·ֵ´,TieLuJieDaoBanShiChu,150502008,42609,4742,26934,16940,40616,24434,5519,24073,48507,25936,52870
ǽֵ´,HongXingJieDaoBanShiChu,150502009,19621,1325,11625,6744,17387,11418,3425,11528,22946,12746,24371
ֵֽ´,HuoLinJieDaoBanShiChu,150502010,28616,3077,17692,12636,20624,17668,3796,17766,35434,17797,35489
ֵ´,JianGuoJieDaoBanShiChu,150502011,21695,1500,12735,7697,17553,12588,3738,12870,25458,14198,26933
ֵ´,HeXiJieDaoBanShiChu,150502020,26844,1714,15933,10269,15370,14933,4906,15621,30554,17531,33464
糧ֵ´,DianChangJieDaoBanShiChu,150502021,4671,478,2447,1860,2259,2112,432,2127,4239,3134,5581
,DaLinZhen,150502100,61698,5685,39156,24377,77209,38777,11875,39640,78417,40102,79258
Ǯҵ,QianJiaDianZhen,150502101,39880,3519,25271,14685,48396,25184,8020,26023,51207,26148,51419
,YuLiangBaoZhen,150502102,23307,2202,14949,9427,28370,14816,4758,15183,29999,15318,30267
ľͼ,MuLiTuZhen,150502103,32655,2258,19150,11662,34455,18458,5900,19217,37675,21663,40813
,FengTianZhen,150502104,21828,1764,13724,8308,27007,13724,4452,14314,28038,14320,28044
,QingHeZhen,150502105,27668,2311,17228,11183,32985,17220,5541,18255,35475,18292,35520
,YuXinZhen,150502106,24425,2042,15332,9018,29715,15324,4675,15800,31124,15810,31142
,QingHeZhen,150502107,17252,1436,10988,6336,20764,10940,3820,11384,22324,11520,22508
,AoLiBuGaoZhen,150502108,19708,1784,12378,7262,24588,12377,4016,13129,25506,13130,25508
ɺ,LiaoHeZhen,150502130,38973,2485,25086,12388,34878,20164,7188,20731,40895,23560,48646
Īľ,MoLiMiaoSuMu,150502200,13841,1258,8709,5423,16695,8693,2649,8983,17676,9039,17748
ũ,ZheNanNongChang,150502400,1773,130,1075,663,2029,1073,346,1132,2205,1174,2249
ũ,SanYiTangNongChang,150502401,2168,205,1389,866,2710,1382,453,1427,2809,1437,2826
,GaoLinTunZhongChuChang,150502402,3343,309,2020,1428,3710,2014,645,2158,4172,2277,4297
ԭֳַ,HuLiHaiYuanZhongFanZhiChang,150502403,3102,337,2018,1255,3821,2015,670,2088,4103,2091,4109
Ī,MoLiMiaoYangChang,150502404,1094,102,703,477,1276,703,235,728,1431,728,1431
ص,BanJieDianMuChang,150502405,560,50,376,226,666,376,147,381,757,381,757
,BaoKangZhen,150521100,74660,5590,47302,28063,85669,44424,14266,44830,89254,47214,94516
ɽ,BaoLongShanZhen,150521101,48543,3056,29825,18315,57431,29557,9447,30761,60318,31221,61046
Ხ,SheBoTuZhen,150521102,39947,2363,24815,13421,48364,24781,8153,25599,50380,25648,50463
,BaYanTaLaZhen,150521103,25936,1846,16148,9675,32478,16140,5545,17147,33287,17179,33327
Ŵ,MenDaZhen,150521104,19180,1700,12569,7489,24303,12323,4757,12761,25084,13068,25637
,JiaMaTuZhen,150521105,32589,2190,20234,11029,40615,20199,6344,20836,41035,20889,41123
ë,YaoLinMaoDouZhen,150521106,18386,1124,11390,6001,22654,11390,3774,11894,23284,11894,23284
ϣ,XiBoHuaZhen,150521107,34619,2130,21727,12524,43170,21622,7625,22518,44140,22647,44374
¹,HuaTuGuLaZhen,150521108,24472,1809,15564,8986,30420,15484,5672,16233,31717,16389,31953
,DaiLiJiZhen,150521109,15598,889,9530,5396,18643,9530,2972,9919,19449,9929,19459
Ŭľ,NuRiMuZhen,150521110,13446,1096,8260,4978,16430,8257,2596,8871,17128,8878,17138
˶ľ,HuaHuShuoSuMu,150521200,12845,735,7968,4287,15847,7968,2803,8415,16383,8415,16383
Эľ,XieDaiSuMu,150521201,9875,622,6413,3645,12701,6232,2712,6593,12825,6796,13209
ľ,BaiXingTuSuMu,150521202,11021,797,6849,4083,13635,6848,2333,7293,14141,7302,14151
ͼľ,TuBuXinSuMu,150521203,19391,1373,12129,7595,23751,11963,3743,12272,24235,12378,24507
ֳ,DongSuLinChang,150521400,3273,161,2073,1189,3952,2073,737,2098,4171,2098,4171
쿨,GanQiKaZhen,150522100,70160,6021,43981,31068,85569,43225,13270,44668,87893,45470,89451
,JiErGaLangZhen,150522101,18726,1308,11767,7165,23617,11576,4392,12423,23999,12659,24426
,JinBaoTunZhen,150522102,24630,1873,15856,10364,29332,15697,5788,16250,31947,16435,32291
ʤ,ChangShengZhen,150522103,33346,2975,21657,13313,42878,21655,8181,22804,44459,22845,44502
,ChaRiSuZhen,150522104,29182,1856,18044,10678,32400,18004,6839,18832,36836,19833,37877
˫ʤ,ShuangShengZhen,150522105,24926,2287,16553,9158,32055,15901,6617,16523,32424,17277,33830
,AGuLaZhen,150522106,10943,796,7068,4268,14168,6858,2813,7276,14134,7484,14552
³,ChaoLuTuZhen,150522107,12811,1046,7983,4952,16294,7983,2836,8707,16690,8710,16693
Ŭ˹̨,NuGuSiTaiZhen,150522108,13165,978,8183,4932,16160,8180,2619,8541,16721,8579,16762
³,HaiLuTuZhen,150522109,16238,1243,10197,6383,20762,10193,3879,11151,21344,11163,21360
ľ,ADouQinSuMu,150522200,13668,1016,8748,5046,17496,8748,3369,9300,18048,9305,18053
ïľ,MaoDaoTuSuMu,150522201,9265,688,5761,3328,11625,5739,2078,6189,11928,6270,12031
ʤũ,ShengLiNongChang,150522400,6163,612,4081,2660,7566,4079,1340,4021,8100,4034,8115
ϸ,MengGenDaBaMuChang,150522401,1367,118,823,541,1653,823,261,923,1746,923,1746
̨,ChaJinTaiMuChang,150522402,1584,144,1010,696,1930,1010,359,1077,2087,1077,2087
ԭֳ,YuanZhongChang,150522403,2305,169,1522,832,2798,1522,470,1422,2944,1422,2944
๵,DaQingGouGuanLiJu,150522404,542,31,335,264,645,335,105,343,678,343,678
,HaRiWuSuZhongChuChang,150522405,68,3,40,32,75,40,5,36,76,36,76
泡,WuLanAoDaoYuChang,150522406,155,8,91,61,174,91,28,100,191,100,191
ֳ,JinBaoTunLinChang,150522407,350,36,234,168,214,234,63,215,449,215,449
³ֳ,ChaoLuTuLinChang,150522408,115,7,64,51,121,64,21,79,143,79,143
ïֳ,MaoDaoTuLinChang,150522409,157,14,93,62,189,93,25,103,196,103,196
ֳ,YiHuTaLinChang,150522410,120,14,78,64,158,78,26,82,160,82,160
ڵֳ,WuDanTaLaLinChang,150522411,478,49,302,233,606,302,97,322,624,322,624
³,KaiLuZhen,150523100,92665,7186,59489,36846,99517,55586,20023,55991,111577,60385,119874
,DaYuShuZhen,150523101,19295,1278,11759,6802,23828,11759,3658,12456,24215,12472,24231
,HeiLongBaZhen,150523102,16957,1285,10668,6354,21006,10656,3418,10973,21629,10992,21660
,MaiXinZhen,150523103,25749,1791,16298,9351,31890,16197,5290,16357,32554,16532,32830
,YiHeTaLaZhen,150523104,23353,1558,14511,8594,28968,14486,4660,14982,29468,15060,29571
,JianHuaZhen,150523105,26504,1834,16689,9555,32060,16361,5636,16708,33069,17285,33974
Сֻ,XiaoJieJiZhen,150523106,41621,3252,26176,13519,50648,26133,7858,26445,52578,26555,52731
,DongFengZhen,150523107,16843,1230,10647,6383,20348,10607,3455,10745,21352,10881,21528
ո,JiRiGaLangTuZhen,150523108,16847,1218,10421,5140,20830,9175,3516,9688,18863,11160,21581
,DongLaiZhen,150523109,14607,1121,9420,5615,17967,9413,3295,9579,18992,9603,19023
,QingHeMuChang,150523400,2837,217,1867,1172,3149,1867,547,1734,3601,1734,3601
ɺũ,LiaoHeNongChang,150523401,4057,292,2534,1520,4893,2534,803,2614,5148,2618,5152
ũ,BaoAnNongChang,150523402,8060,673,5166,3120,9802,5164,1677,5233,10397,5244,10410
׽ֵ´,KuLunJieDaoBanShiChu,150524001,28086,2228,17317,11720,31052,16697,4697,16855,33552,17694,35011
,KuLunZhen,150524100,26606,2607,17198,10689,34896,17171,6391,18264,35435,18406,35604
ۺ,KouHeZiZhen,150524101,27287,2613,17296,10643,34895,17250,6456,18614,35864,19060,36356
,BaiYinHuaZhen,150524102,16097,1473,10340,6346,21177,10334,4121,11194,21528,11351,21691
,LiuJiaZiZhen,150524103,13313,1313,8732,5165,17208,8731,3261,9147,17878,9155,17887
˳,ELeShunZhen,150524104,7823,762,4956,3087,10045,4907,1761,5320,10227,5390,10346
ãľ,MangHanSuMu,150524200,7682,734,4849,3119,9809,4819,1709,5195,10014,5276,10125
,DaQinTaLaZhen,150525100,89723,7072,57807,33262,99913,52905,18511,53071,105976,57499,115306
Ͳ,BaXianTongZhen,150525101,37191,3369,24445,15095,47673,24257,8813,24684,48941,24928,49373
ɽ,QingLongShanZhen,150525102,24459,2328,15744,9197,31022,15712,5068,16033,31745,16111,31855
,XinZhen,150525103,26358,2136,17159,9835,33473,17112,6177,17380,34492,17512,34671
ΰ,ZhiAnZhen,150525104,14203,1186,9186,5314,17745,9060,3164,9252,18312,9367,18553
,DongMingZhen,150525105,31787,2597,20547,12314,40711,20506,7334,21098,41604,21171,41718
ɳպ,ShaRiHaoLaiZhen,150525106,16037,1364,10076,5634,19946,10074,3338,10642,20716,10663,20739
¡,YiLongYongZhen,150525107,13402,1240,8473,4859,16785,8434,2750,8804,17238,8919,17392
հ໨ľ,GuRiBanHuaSuMu,150525200,9828,885,6241,3675,12453,6110,2156,6427,12537,6628,12869
ľ,BaiYinTaLaSuMu,150525201,13093,1275,8590,5287,16809,8586,2984,8742,17328,8762,17352
ľ,MingRenSuMu,150525202,17906,1422,11541,7096,22576,11539,4155,11933,23472,11942,23483
ƻľ,HuangHuaTaLaSuMu,150525203,11447,943,7262,4130,14245,7257,2521,7640,14897,7649,14911
ũ,GuoYouLiuHaoNongChang,150525400,2476,244,1633,1064,3099,1633,567,1654,3287,1654,3287
³,LuBeiZhen,150526100,76103,5553,49054,32895,78210,47312,16584,47153,94465,49186,98240
ƻɽ,HuangHuaShanZhen,150526101,11870,749,7229,5434,12649,7202,2333,7658,14860,7723,14952
ºͼ,GaHaiTuZhen,150526102,23247,1401,14739,8670,28736,14723,5153,15012,29735,15062,29801
պ,JuRiHeZhen,150526103,18193,1552,11711,7536,23004,11611,4097,11917,23528,12131,23842
Ŷͼ˶,BaYaErTuHuShuoZhen,150526104,9352,504,5864,3368,11741,5821,2119,6003,11824,6111,11975
ɽ,XiangShanZhen,150526105,14139,1267,9081,6346,18048,9070,3161,9437,18507,9486,18567
,ARiKunDouLengZhen,150526106,6232,163,2361,1502,4122,2252,856,2349,4601,4890,7251
ľ,BaYanTaLaSuMu,150526200,12064,1090,7701,5430,15187,7683,2628,7972,15655,8081,15782
ľľ,WuLiJiMuRenSuMu,150526201,12039,779,7528,5168,14546,7522,2548,7789,15311,7838,15366
϶ľ,DaoLaoDuSuMu,150526202,7560,399,4635,2902,9073,4623,1503,4806,9429,4827,9462
ճ³ľ,GeRiChaoLuSuMu,150526203,9661,551,5958,3768,11328,5948,2149,6215,12163,6403,12361
ڶ,WuEGeQiMuChang,150526400,7272,613,4615,3005,8927,4613,1506,4766,9379,4776,9391
ɽũ,XiangShanNongChang,150526401,4964,503,3341,2386,6382,3341,1258,3378,6719,3384,6725
ոũ,WuRiGenTaLaNongChang,150526402,2885,214,1840,1212,3186,1816,600,1809,3625,1859,3699
´,GaDaSuZhongChuChang,150526403,1562,120,984,692,1632,984,275,973,1957,973,1957
˹ֵ´,ZhuSiHuaJieDaoBanShiChu,150581001,26088,1221,14869,10850,16489,14590,4191,15073,29663,16631,31500
Ī˹ֵ̨´,MoSiTaiJieDaoBanShiChu,150581002,22067,1173,13638,9429,13301,13134,4390,13408,26542,13992,27630
պ�ֵ´,BaoRiHuJiErJieDaoBanShiChu,150581003,18528,634,11228,8127,7419,11178,4093,11892,23070,12027,23255
ɳȽֵ´,ShaErHuReJieDaoBanShiChu,150581004,8891,471,4399,3232,5111,4147,1061,4548,8695,6024,10423
˶ֵ´,DaLaiHuShuoJieDaoBanShiChu,150581005,7225,377,3808,2582,4709,3687,1086,3916,7603,4880,8688
ũҵι˾,DongMengNongMuYeYouXianZeRenGongSi,150581400,652,8,306,304,428,306,58,412,718,412,718
ֵͨ´,JiaoTongJieDaoBanShiChu,150602001,52908,2778,30753,19557,15193,25481,8221,26020,51501,33154,63907
԰ֵ´,GongYuanJieDaoBanShiChu,150602002,54321,3333,32538,22436,19268,28787,9305,30149,58936,34421,66959
ֵ´,LinYinJieDaoBanShiChu,150602003,50008,2306,30546,21410,20215,28042,10295,28901,56943,32063,62609
ֵ´,JianSheJieDaoBanShiChu,150602004,38280,1483,19685,11603,9953,15759,6002,16169,31928,26080,45765
˽ֵ´,FuXingJieDaoBanShiChu,150602005,50951,1708,29494,18542,7644,25072,10840,27164,52236,34005,63499
콾ֵ´,TianJiaoJieDaoBanShiChu,150602006,35724,1091,16535,9617,7024,13039,5055,13584,26623,25335,41870
ڭ׽ֵ´,HeELunJieDaoBanShiChu,150602007,46336,1582,27477,19414,7601,26038,11108,27859,53897,31549,59026
ſ˽ֵ´,BaYinMenKeJieDaoBanShiChu,150602008,44097,1640,18115,11200,6569,15711,5845,15889,31600,33467,51582
͸ϣֵ´,HaBaGeXiJieDaoBanShiChu,150602009,40842,878,12040,5894,7169,6522,2300,7572,14094,31980,44020
�,BoErJiangHaiZiZhen,150602100,6314,1851,3800,3474,6985,3654,622,4053,7707,4987,8787
̨,HanTaiZhen,150602101,27772,1594,9028,5774,7940,7040,2190,8273,15313,22528,31556
ͭ,TongChuanZhen,150602102,37086,1544,14278,9988,9431,12359,4334,13631,25990,28686,42964
,ShuLinZhaoZhen,150621100,169329,12009,103753,74037,96156,97876,38207,101191,199067,115792,219545
˹̫,JiGeSiTaiZhen,150621101,8736,1959,5562,5149,10868,5472,1307,5962,11434,6440,12002
ྮ,BaiNiJingZhen,150621102,17310,2639,10416,9198,16690,10199,3151,11317,21516,12684,23100
,WangAiZhaoZhen,150621103,14514,3140,9262,7723,18156,9019,1959,9696,18715,10351,19613
Ѿ,ZhaoJunZhen,150621104,12110,2343,7022,6198,13307,6801,1249,7215,14016,8680,15702
,EnGeBeiZhen,150621105,6453,1483,4029,3792,7766,3924,808,4246,8170,4715,8744
к,ZhongHeXiZhen,150621106,3930,836,2538,2226,4923,2510,566,2667,5177,2794,5332
չľ,ZhanDanZhaoSuMu,150621200,14261,2321,7225,6257,12921,6791,1481,7316,14107,10838,18063
Ѧ,XueJiaWanZhen,150622100,142350,8164,81600,59471,92863,77354,33391,82294,159648,102305,183905
ɳٶ,ShaGeDuZhen,150622101,48318,5716,29490,21451,39977,26526,9798,28420,54946,34342,63832
·,DaLuZhen,150622102,3047,664,1884,1798,3634,1851,456,2049,3900,2283,4167
,NaRiSongZhen,150622103,24151,1926,9045,6952,13806,7870,3181,8984,16854,20213,29258
,LongKouZhen,150622104,22074,4103,13515,11653,25064,12988,4666,13868,26856,17328,30843
׼,ZhunGeErZhaoZhen,150622105,16192,1022,5610,3933,7272,4761,1755,5533,10294,13359,18969
ůˮ,NuanShuiXiang,150622200,4798,978,2672,2450,5131,2481,676,2861,5342,3780,6452
ʮ,ShiErLianChengXiang,150622201,10059,1813,6637,5545,12724,6478,2097,6922,13400,7332,13969
պľ,BuErTaoHaiSuMu,150622202,3809,818,2073,2059,4307,2042,479,2366,4408,3033,5106
,AoLeZhaoQiZhen,150623100,27403,2642,17763,12751,21837,17152,6097,17040,34192,18379,36142
Ϻ,ShangHaiMiaoZhen,150623101,10213,367,2872,2365,4343,2482,762,2895,5377,8470,11342
Ǵ,ChengChuanZhen,150623102,10771,1258,6675,5106,12667,6592,2041,6974,13566,7395,14070
,AngSuZhen,150623103,5502,491,3076,2396,5830,2989,735,3209,6198,3652,6728
,WuLanZhen,150624100,31492,2460,17773,12687,22683,16632,5303,16793,33425,21482,39255
̾,QiPanJingZhen,150624101,60849,1577,31727,22083,17038,28876,12508,30821,59697,43207,74934
,MengXiZhen,150624102,14033,560,5627,3265,5077,4005,1413,4356,8361,10379,16006
ľ׶,MuKaiNaoErZhen,150624103,5303,1175,3424,2830,6439,3379,616,3586,6965,3670,7094
ͼľ,SuMiTuSuMu,150624200,3646,333,1805,1473,3251,1685,402,1858,3543,2576,4381
˹ľ,AErBaSiSuMu,150624201,5775,414,3422,2520,5876,3365,985,3583,6948,3752,7174
,XiNiZhen,150625100,45518,5195,27819,21298,35035,26251,8512,26871,53122,31406,59225
,BaLaGongZhen,150625101,7521,842,4737,3892,7739,4687,1510,4969,9656,5136,9873
ոͼ,JiRiGaLangTuZhen,150625102,7274,971,4536,3672,8562,4472,1298,4762,9234,5007,9543
,DuGuiTeLaZhen,150625103,14765,2151,8448,7325,15836,8129,2125,8750,16879,10593,19041
ľ,HuHeMuDuZhen,150625104,3994,458,2479,1980,4666,2427,712,2569,4996,2685,5164
ľ,YiHeWuSuSuMu,150625200,6551,684,3871,3458,6361,3825,1021,4167,7992,4385,8256
³ͼ,GaLuTuZhen,150626100,48381,2375,26285,17883,24055,23846,9300,24674,48520,33771,60056
,WuShenZhaoZhen,150626101,7958,713,4869,3865,5732,4734,1835,5072,9806,5637,10506
ͼ,TuKeZhen,150626102,12531,932,5176,3647,8715,4592,1386,4856,9448,9673,14849
ո,WuLanTaoLeGaiZhen,150626103,8160,540,3865,2640,6363,3595,1037,3868,7463,5872,9737
޶,WuDingHeZhen,150626104,15281,2063,9263,7200,15855,8907,2733,9621,18528,10814,20077
ľ,SuLiDeSuMu,150626200,7397,846,4107,3228,7458,3850,1059,4263,8113,5195,9302
ϯ,ALeTengXiReZhen,150627100,69853,2898,35802,23930,24217,31803,13026,32942,64745,49975,85777
,ZhaSaKeZhen,150627101,13177,1761,8158,6843,13143,7824,2751,8379,16203,9531,17689
ľ,WuLanMuLunZhen,150627102,52831,2319,21639,17879,16977,19437,6820,22115,41552,40331,61970
պ,NaLinTaoHaiZhen,150627103,27471,1376,8929,7046,9530,7431,2735,8725,16156,22653,31582
ղ,SuBuErGaZhen,150627104,5212,1666,3491,3390,6802,3430,535,3684,7114,3922,7413
,HongQingHeZhen,150627105,8413,2275,5687,5091,10668,5512,1162,5732,11244,6163,11850
,YiJinHuoLuoZhen,150627106,8244,1361,4464,3870,6583,3965,866,4163,8128,6007,10471
´,ZhengYangBanShiChu,150702001,58542,4928,34218,23644,48158,31983,7485,30619,62602,36737,70955
ֵ´,JianKangJieDaoBanShiChu,150702002,42966,3634,24938,17667,32473,23363,5565,23431,46794,27227,52165
ɽֵ´,KaoShanJieDaoBanShiChu,150702003,31868,4180,19660,15005,28635,19606,3521,19881,39487,19909,39569
ʤֵ´,ShengLiJieDaoBanShiChu,150702004,42901,5388,28548,19584,43431,28007,7127,25571,53578,26868,55416
׽ֵ´,HuLunJieDaoBanShiChu,150702005,36952,3902,21724,16122,29207,21620,4817,21296,42916,23947,45671
ֵܶ´,FenDouJieDaoBanShiChu,150702006,28305,1698,17280,8612,16811,11682,2982,11049,22731,15705,32985
ֵ´,JianSheJieDaoBanShiChu,150702007,17041,1924,9740,7132,13880,9200,1893,9663,18863,11118,20858
,HaKeZhen,150702100,21889,2286,12986,9547,20527,12731,3140,13121,25852,14329,27315
Ǽ,NaJiZhen,150721100,52858,4055,33201,21280,50897,31228,9143,31007,62235,32855,66056
,LiuHeZhen,150721101,28750,2137,17416,12680,34672,17409,5146,18601,36010,18617,36033
Ƕ,YaDongZhen,150721102,40219,3188,24398,15074,47774,24348,7270,26206,50554,26279,50677
,HuoErQiZhen,150721103,33159,2848,20077,13924,39453,19747,5849,21299,41046,21779,41856
,XiangYangYuZhen,150721104,22194,1751,13306,9281,26689,13300,3836,14463,27763,14475,27781
¿,DeLiQiEWenKeMinZuXiang,150721200,8987,625,5361,3628,10108,5344,1704,5855,11199,5955,11316
¿,ChaBaQiEWenKeMinZuXiang,150721201,8608,709,5237,3546,8968,5204,1632,5649,10853,5712,10949
ӴӶ¿,YinHeDaWoErEWenKeMinZuXiang,150721202,8569,731,5318,3650,10070,5222,1631,5478,10700,5613,10931
·,XinFaChaoXianMinZuXiang,150721203,7137,505,4309,2863,7517,4298,1285,4579,8877,4618,8927
Ǽũ,NaJiTunNongChang,150721400,11248,1066,6811,4764,13199,6808,1904,7365,14173,7407,14218
,NiErJiZhen,150722100,78848,5793,50141,33819,88595,47757,16767,48869,96626,51267,101408
,HongYanZhen,150722101,11510,829,7053,4863,12548,7002,2318,7508,14510,7604,14657
ɽ,BaoShanZhen,150722102,12711,951,8032,5280,15902,7790,3089,8408,16198,8719,16751
,HaDaYangZhen,150722103,13021,906,8010,5170,15731,7919,2652,8433,16352,8569,16579
,AErLaZhen,150722104,10263,502,6170,4274,11776,6165,2229,6817,12982,6824,12994
߶ͼ,XiWaErTuZhen,150722106,18387,1158,11246,6937,22221,11147,3940,12076,23223,12239,23485
ڿ,TengKeZhen,150722108,10785,492,6429,4306,11365,6412,2180,6988,13400,7028,13457
°,TaWenAoBaoZhen,150722110,22157,1374,13411,8573,25221,13253,4519,14456,27709,14639,28050
¿,BaYanEWenKeMinZuXiang,150722200,33533,2401,20317,13899,37045,20196,6119,21464,41660,21736,42053
¿,DuLaErEWenKeMinZuXiang,150722203,5864,368,3606,2374,6873,3604,1246,3868,7472,3872,7478
,ALiHeZhen,150723100,25415,3962,16283,12431,29921,15946,3645,16008,31954,16739,33022
,DaYangShuZhen,150723101,77586,6569,48265,32716,73819,47014,13928,48529,95543,49818,98083
ʺ,GanHeZhen,150723102,30721,6756,20557,16675,39591,20524,3900,20721,41245,20820,41377
,TuoZhaMinZhen,150723103,11485,1976,7445,5647,14208,7431,1678,7651,15082,7694,15139
ŵ,NuoMinZhen,150723104,13227,1095,8282,5708,13703,8040,2746,8498,16538,8786,17068
³,WuLuBuTieZhen,150723105,11071,948,6709,4640,10623,6702,1791,7067,13769,7101,13810
,GuLiXiang,150723200,4363,325,2485,2011,3249,2473,565,2735,5208,2768,5253
к,BaYanTuoHaiZhen,150724100,22335,1969,13551,9816,20122,13386,3530,13462,26848,14283,27834
,BaYanZhen,150724101,46186,4667,28197,22270,51945,28061,6471,28842,56903,29127,57324
,YiMinHeZhen,150724102,22428,1977,13219,10457,18503,12843,3196,13469,26312,14382,27601
,XiNiHeZhen,150724103,8013,370,3553,2609,5593,3352,908,3677,7029,5738,9291
Ӷ,BaYanTaLaDaWoErMinZuXiang,150724200,1450,106,799,743,1515,799,187,940,1739,944,1743
ľ,YiMinSuMu,150724201,6138,380,3543,2623,4946,3507,862,3691,7198,3837,7380
ľ,HuiSuMu,150724202,3209,105,1787,1351,3150,1778,492,2008,3786,2019,3806
,BaYanKuRenZhen,150725100,19466,1608,11162,7973,16794,10769,2919,10853,21622,12831,23993
ϣ,BaoRiXiLeZhen,150725101,13994,1045,8203,5791,10979,8163,1929,8553,16716,8765,16968
ŵ,HuHeNuoErZhen,150725102,3303,265,1863,1399,2930,1854,353,2041,3895,2058,3921
ľ,WuZhuErSuMu,150725200,2687,93,1437,1128,1966,1436,292,1632,3068,1635,3072
¿ľ,EWenKeMinZuSuMu,150725201,1520,63,811,655,1232,797,172,904,1701,944,1755
°ͶӪͼ,ChenBaErHuQiGuoYingHaTuDaMuChang,150725501,2813,287,1623,1369,2766,1623,281,1758,3381,1758,3381
Ӫպũ,ChenQiGuoYingHaoTeTaoHaiNongMuChang,150725502,1961,255,1218,1000,1699,1218,300,1295,2513,1298,2516
Ӫ,ChenQiGuoYingTeNiHeMuChang,150725503,2204,187,1269,1060,2408,1269,247,1364,2633,1369,2638
ľ,AMuGuLangZhen,150726100,14531,1052,8896,6479,13146,8693,2664,8611,17304,9351,18247
ϸ,CuoGangZhen,150726101,3744,272,2285,1712,3876,2269,639,2338,4607,2370,4655
ڲľ,WuBuErBaoLiGeSuMu,150726200,5507,277,3088,2368,5156,3068,806,3375,6443,3502,6590
ͼľ,JiBuHuLangTuSuMu,150726201,3066,153,1553,1160,2732,1506,375,1665,3171,2041,3594
±ľ,XinBaoLiGeSuMu,150726202,3977,216,2206,1814,3754,2204,415,2390,4594,2402,4608
ϸ˫,CuoGangShuangWaMuChang,150726400,2082,235,1206,968,2044,1206,247,1358,2564,1358,2564
̹Ī,ALaTanEMoLeZhen,150727100,18697,1337,11378,8511,14975,11235,3172,11187,22422,11828,23206
չɳ,ARiHaShaTeZhen,150727101,2207,27,751,528,920,543,134,637,1180,1617,2368
,HuLunZhen,150727102,2965,139,1395,1214,2001,1314,218,1616,2930,1927,3322
ľ,BeiErSuMu,150727200,3320,118,1487,1114,2308,1322,284,1544,2866,2235,3722
˶ľ,KeErLunSuMu,150727201,2789,90,1267,1051,2232,1155,304,1395,2550,1916,3183
,AoErJinMuChang,150727500,481,50,233,220,287,216,24,277,493,322,555
ɽֵ´,DongShanJieDaoBanShiChu,150781001,41270,1927,22061,17619,25073,21606,6076,23215,44821,27212,49273
Ͻֵ´,DaoNanJieDaoBanShiChu,150781002,27329,2130,16139,12635,14236,15949,4074,17006,32955,17394,33533
ֵ´,DaoBeiJieDaoBanShiChu,150781003,28712,1695,17361,13488,15151,17026,5000,17536,34562,18046,35407
˻ֵ´,XingHuaJieDaoBanShiChu,150781004,19500,1113,11871,7814,10039,10408,3010,10736,21144,11752,23623
еһ´,ManZhouLiShiDiYiBanShiChu,150781005,9887,1118,6162,4903,9787,6153,1257,6084,12237,6100,12262
еڶ´,ManZhouLiShiDiErBanShiChu,150781006,10800,1088,6169,5327,9179,6159,1203,6676,12835,6922,13091
е´,ManZhouLiShiDiSanBanShiChu,150781007,14651,1706,9257,7634,14405,9247,1866,8961,18208,8966,18223
еİ´,ManZhouLiShiDiSiBanShiChu,150781008,19680,2101,12180,9419,14845,12161,2699,12142,24303,12300,24480
е´,ManZhouLiShiDiWuBanShiChu,150781009,10841,1493,6598,5741,11343,6588,1234,6958,13546,6970,13568
Ȫֵ´,LingQuanJieDaoBanShiChu,150781010,14604,2000,9133,7762,15523,9096,1732,9135,18231,9203,18336
¿ӽֵ´,XinKaiHeJieDaoBanShiChu,150781011,6151,732,3688,2935,5163,3679,793,3936,7615,3988,7676
ʤֵ´,ShengLiJieDaoBanShiChu,150782001,18290,1712,9562,7217,15374,9510,1946,9411,18921,12386,21948
ֵ´,HongQiJieDaoBanShiChu,150782002,18840,2591,11220,7766,15161,10800,1938,10221,21021,12149,23369
¹ֵ´,XinGongJieDaoBanShiChu,150782003,20264,3175,13587,9517,18867,13160,2569,12062,25222,12421,26008
˽ֵ´,YongXingJieDaoBanShiChu,150782004,25359,2650,13553,9578,19542,13398,3187,13012,26410,17643,31196
ֵ´,JianSheJieDaoBanShiChu,150782005,22343,3368,13480,9895,20507,13093,2395,13193,26286,14626,28106
ůȪֵ´,NuanQuanJieDaoBanShiChu,150782006,13869,1828,8345,5882,12417,7867,1617,7978,15845,8969,17314
˽ֵ´,DongXingJieDaoBanShiChu,150782007,12007,1552,6858,5547,10363,6723,1260,7376,14099,7961,14819
ɺ,MianDuHeZhen,150782100,30480,3699,17950,13961,31588,17832,3697,18688,36520,19926,37876
ͼ,BoKeTuZhen,150782101,21311,3677,13403,10418,23930,13249,2267,13701,26950,13852,27255
ºԴ,ChaoHeYuanZhen,150782102,20994,3259,13072,10810,24835,13047,2625,13497,26544,13806,26878
ڶ人,WuErQiHanZhen,150782103,27271,4630,17388,13881,30362,16719,3278,17059,33778,17791,35179
ⶼ,KuDouErZhen,150782104,19927,4243,12890,10935,23648,12028,2098,12367,24395,13378,26268
ͼ,TuLiHeZhen,150782105,27908,5669,17659,15787,33520,17555,2380,17986,35541,18298,35957
˻ֵ´,XingHuaJieDaoBanShiChu,150783001,22155,2901,14193,10094,20006,13295,3239,13186,26481,14102,28295
ֵ´,ZhengYangJieDaoBanShiChu,150783002,24993,2645,16093,10979,24176,15343,3696,14863,30206,15241,31334
ٽֵ´,FanRongJieDaoBanShiChu,150783003,20420,2085,12103,8419,18148,11521,2914,11361,22882,13316,25419
ֵ´,XiangYangJieDaoBanShiChu,150783004,20533,2001,12659,8871,19475,12566,3087,12765,25331,12962,25621
̨ӽֵ´,GaoTaiZiJieDaoBanShiChu,150783005,12284,1058,7252,5544,11603,7154,2005,7483,14637,8095,15347
ֵ´,TieDongJieDaoBanShiChu,150783006,11306,939,6868,4141,10494,5754,1479,5879,11633,6856,13724
ֵ´,HeXiJieDaoBanShiChu,150783007,10436,1298,6498,4351,10882,6476,1526,6719,13195,6762,13260
ĥ,MoGuQiZhen,150783100,45495,3950,28297,18370,55386,27778,9249,29774,57552,30397,58694
ݵ,WaDiZhen,150783101,14627,988,9028,6182,17017,8673,3127,9351,18024,9714,18742
ţ,WoNiuHeZhen,150783102,18837,2046,12097,8344,23167,11826,4081,12508,24334,12867,24964
ɼ˼,ChengJiSiHanZhen,150783103,36112,3465,22774,15642,42923,22354,7322,23592,45946,24125,46899
,DaHeWanZhen,150783104,21300,1737,12919,8140,25250,12850,3621,13621,26471,13739,26658
ɽ,HaoRaoShanZhen,150783105,8190,660,4883,3577,8460,4850,1414,5181,10031,5381,10264
Ӷ,DaWoErMinZuXiang,150783200,6731,527,4092,2827,7396,4088,1321,4435,8523,4487,8579
ľ״,NanMuELunChunMinZuXiang,150783201,8970,1083,5541,4338,10105,5535,1283,5781,11316,5795,11336
ֶ¿,SaMaJieEWenKeMinZuXiang,150783202,5718,385,3423,2356,6369,3400,1084,3732,7132,3764,7187
ֵֽ´,LaBuDaLinJieDaoBanShiChu,150784001,28241,2690,17584,13316,28345,17116,4796,17181,34297,18143,35727
Ͽֵ´,ShangKuLiJieDaoBanShiChu,150784002,5270,541,3274,2588,5719,3257,897,3396,6653,3434,6708
Ī,MoErDaoGaZhen,150784100,14215,1923,8944,7424,16646,8941,1832,8998,17939,9026,17970
ɽͷ,HeiShanTouZhen,150784101,1761,108,918,778,1106,896,160,1037,1933,1111,2029
ӻ,SanHeHuiZuXiang,150784200,8182,892,5162,4049,9237,5045,1574,5230,10275,5486,10648
Τ˹,ShiWeiELuoSiZuMinZuXiang,150784201,3061,195,1659,1381,2802,1641,329,1870,3511,1926,3585
Ӷֵ´,HeDongJieDaoBanShiChu,150785001,13404,1714,8585,6520,13164,8441,1891,8247,16688,8424,17009
ֵ´,HeXiJieDaoBanShiChu,150785002,11959,2130,7648,6290,13447,7587,1545,7585,15172,7986,15634
ɭֵ´,SenGongJieDaoBanShiChu,150785003,15684,2692,10224,8211,17671,10213,2035,10168,20381,10187,20411
,JinHeZhen,150785101,11831,2412,7767,6141,14714,7038,1371,7031,14069,7847,15614
ɽ,ALongShanZhen,150785102,10639,1826,6766,5549,13149,6754,1303,6961,13715,7002,13768
,ManGuiZhen,150785103,9196,1156,5685,4905,10675,5675,1270,5883,11558,5937,11622
³,AoLuGuYaXiang,150785200,12484,2324,7922,6206,15598,7887,1572,8303,16190,8458,16380
Ž´,TuanJieBanShiChu,150802001,34484,2736,21928,15064,21177,20683,6925,20194,40877,22217,44145
վ´,CheZhanBanShiChu,150802002,24937,1997,15129,10714,17464,14391,4250,14201,28592,16055,31184
ȷ´,XianFengBanShiChu,150802003,34068,2454,21270,14665,17739,19398,5904,19319,38717,21156,42426
Ű´,JieFangBanShiChu,150802004,27392,1643,17075,11188,15649,15521,5426,15247,30768,17386,34461
»´,XinHuaBanShiChu,150802005,36065,2615,22264,14495,23968,19717,5980,18815,38532,22396,44660
·´,DongHuanLuBanShiChu,150802006,25665,1589,16045,8703,8482,11957,3744,12303,24260,14953,30998
ϰ´,TieNanBanShiChu,150802007,17792,1658,10875,8132,10913,10111,2743,10406,20517,11318,22193
·´,XiHuanLuBanShiChu,150802008,18301,905,10749,7376,6041,10416,3806,10724,21140,12263,23012
·´,BeiHuanLuBanShiChu,150802009,27208,1441,15563,10657,10169,14588,4984,15432,30020,18070,33633
´,ShuGuangBanShiChu,150802010,7683,515,4698,3290,1528,4643,1531,4864,9507,5031,9729
𴨰´,JinChuanBanShiChu,150802011,7699,430,4560,3360,2584,4323,1502,4354,8677,5071,9631
´,HuiFengBanShiChu,150802012,15285,631,8352,4127,3205,5661,2088,5894,11555,9652,18004
ɽ,LangShanZhen,150802100,16513,2569,10474,7988,19560,10404,2618,11043,21447,11226,21700
»,XinHuaZhen,150802101,22249,3336,14162,10710,27090,14099,3858,15162,29261,15281,29443
,GanZhaoMiaoZhen,150802102,22585,3649,14424,10950,28245,14337,3615,15153,29490,15425,29849
ͼ,WuLanTuKeZhen,150802103,28657,3368,16704,12088,28744,15592,4296,16583,32175,19617,36321
˫,ShuangHeZhen,150802104,13289,1622,7988,5754,13376,7712,2041,8180,15892,8964,16952
ǹ,ChengGuanZhen,150802105,26112,1891,15810,10842,16809,15581,5175,16516,32097,17368,33178
԰,BaiNaoBaoZhen,150802106,16050,2651,10216,7969,20099,10214,2486,10950,21164,10971,21187
ɽũ,LangShanNongChang,150802400,2742,256,1656,1246,2963,1654,494,1827,3481,1836,3492
ٺũ,LinHeNongChang,150802401,4432,434,2704,1931,3420,2473,657,2666,5139,2819,5523
¡˲,LongXingChangZhen,150821100,118186,9002,73864,47072,82654,69026,22204,70100,139126,75528,149392
,TaErHuZhen,150821101,20887,2773,13267,10001,25298,13242,3602,13871,27113,13995,27262
׺,TaoHaiZhen,150821102,20486,3132,13251,10175,25056,13167,3621,13826,26993,13988,27239
¹,XinGongZhongZhen,150821103,14553,2032,9126,7114,18087,9123,2304,9721,18844,9763,18889
켪̫,TianJiTaiZhen,150821104,7950,1009,4880,3743,9175,4850,1272,5100,9950,5351,10231
ʤ,ShengFengZhen,150821105,11257,1625,7039,5288,14096,7022,1858,7465,14487,7701,14740
ͼ,YinDingTuZhen,150821106,7888,988,4919,3402,9708,4914,1226,5177,10091,5183,10102
׶нũ,BaYanNaoErShiJianFengNongChang,150821400,1816,176,1014,799,1710,1004,297,1073,2077,1275,2289
ɹ,NeiMengGuZiZhiQuXuNiDiQu,150821401,274,40,151,145,276,150,22,180,330,185,336
,BaYanGaoLeZhen,150822100,53286,5942,33495,25169,52375,32956,8938,33310,66266,34671,68166
¡ʢ,LongShengHeZhen,150822101,11142,1601,6970,5352,13355,6916,1645,7303,14219,7418,14388
ɿ,DuKouZhen,150822102,6817,1032,4323,3307,8436,4318,1057,4572,8890,4583,8906
ɳ׺ľ,ShaJinTaoHaiSuMu,150822200,6758,590,3900,3055,7537,3892,918,4336,8228,4366,8266
ũ,WuLanBuHeNongChang,150822500,3281,358,1962,1559,3511,1955,525,2137,4092,2202,4164
׺ũ,BaYanTaoHaiNongChang,150822501,1290,126,790,625,1215,785,240,850,1635,866,1656
׺ũ,HaTengTaoHaiNongChang,150822502,3107,347,1906,1517,3516,1906,493,2040,3946,2041,3947
ũ,BaoErGaiNongChang,150822503,2463,244,1522,1113,2647,1516,448,1621,3137,1633,3155
׺ũ,NaLinTaoHaiNongChang,150822504,2178,205,1268,1037,2279,1264,357,1454,2718,1472,2740
ɳĮҵʵũ,ShaMoLinYeShiYanZhongXinNongChang,150822505,1346,108,802,621,650,802,249,901,1703,901,1703
ɽ,WuLaShanZhen,150823100,92327,8316,56390,39817,62566,52576,18051,52333,104909,62304,118694
廨,BaiYanHuaZhen,150823101,6160,775,3697,3039,4118,3530,904,3681,7211,4142,7839
ȷ,XianFengZhen,150823102,24090,3324,13197,10619,23559,12919,3325,13877,26796,17542,30739
°,XinAnZhen,150823103,26841,3370,15284,11518,26606,14744,3739,15779,30523,18666,33950
С,XiXiaoZhaoZhen,150823104,17622,2254,9679,7452,18479,9418,2457,10183,19601,12654,22333
̫,DaSheTaiZhen,150823105,25485,2706,15386,12379,27163,14897,4562,15929,30826,17367,32753
,MingAnZhen,150823106,12032,1708,6854,5659,12822,6775,1789,7442,14217,8675,15529
С̫,XiaoSheTaiZhen,150823107,5770,698,3156,2596,5806,3056,764,3441,6497,4076,7232
ǲľ,EErDengBuLaGeSuMu,150823200,6510,430,2469,1851,3253,2144,568,2418,4562,5039,7508
̲ũ,ZhongTanNongChang,150823400,2729,205,1312,1118,1729,1273,366,1433,2706,1988,3300
ɽũ,XiShanJuNongChang,150823401,3536,318,2055,1517,1832,1998,615,2134,4132,2414,4469
°ũ,XinAnNongChang,150823402,1154,122,575,440,984,570,144,590,1160,845,1420
նũ,SuDuLunNongChang,150823403,2364,261,1230,981,2306,1227,360,1307,2534,1755,2985
̫,DaSheTaiMuChang,150823404,935,95,406,347,711,399,79,462,861,703,1109
ɹغʵҵչ޹˾,NeiMengGuWuLiangSuHaiShiYeFaZhanYouXianGongSi,150823405,2848,267,1299,1085,2100,1287,294,1355,2642,2110,3409
ͼ,HaiLiuTuZhen,150824100,44045,3241,21358,16469,23664,20311,6544,21010,41321,32472,53830
ڼӺ,WuJiaHeZhen,150824101,15601,1973,9994,7748,18594,9881,3020,10390,20271,10600,20594
ɽ,DeLingShanZhen,150824102,16050,1632,9429,6958,16280,9194,2807,9906,19100,11060,20489
ʯ,ShiHaHeZhen,150824103,8157,1251,4533,4138,8563,4447,809,5009,9456,5684,10217
,ChuanJingZhen,150824104,17731,113,3829,2020,1664,1782,362,2591,4373,14377,18206
³˹̫ľ,HuLuSiTaiSuMu,150824200,2358,219,1405,1161,2534,1400,366,1513,2913,1538,2943
ľ,BaYinWuLanSuMu,150824202,2236,146,1094,1162,2020,1073,157,1323,2396,1445,2539
ºľ,XinHuReSuMu,150824203,3146,214,1445,1241,2530,1387,329,1690,3077,2244,3689
,MuYangHaiMuChang,150824400,901,118,521,409,828,514,151,601,1115,649,1170
̫ͬ,TongHeTaiZhongChuChang,150824401,455,39,236,215,302,234,33,252,486,291,527
,BaYinBaoLiGeZhen,150825100,33193,2136,17191,12409,22465,15915,5039,16766,32681,23177,40368
¶,HuHeWenDouErZhen,150825101,9819,687,4447,3278,6272,4179,1299,4500,8679,7358,11805
¶,ChaoGeWenDouErZhen,150825102,6151,487,2783,2811,4599,2731,538,3182,5913,4393,7176
ľ,HuoGeQiSuMu,150825200,3622,116,957,1264,1101,857,153,1325,2182,2934,3891
ǰľ,BaYinQianDaMenSuMu,150825201,1742,98,692,818,1471,689,127,806,1495,1275,1967
°,ShanBaZhen,150826100,96261,7398,56344,37046,86585,53290,16087,54305,107595,63402,119746
ͷ,TouDaoQiaoZhen,150826101,15044,1743,9182,6103,15438,9160,2234,9771,18931,9839,19021
,ErDaoQiaoZhen,150826102,21705,2691,13530,7457,26752,13527,3108,13947,27474,13974,27504
,SanDaoQiaoZhen,150826103,18718,2392,11265,7540,21413,11252,2558,12194,23446,12403,23668
,ManHuiZhen,150826104,15873,2171,9596,6152,19169,9589,2422,10841,20430,10870,20466
Ž,TuanJieZhen,150826105,9334,1199,5852,3733,11548,5847,1643,6321,12168,6324,12176
˫,ShuangMiaoZhen,150826106,12317,1873,7983,5975,13271,7953,2087,8255,16208,8294,16277
ɳ,ShaHaiZhen,150826107,13852,1834,8421,5711,14176,8419,1915,9130,17549,9180,17601
̫ũ,TaiYangMiaoNongChang,150826500,1103,189,733,582,1344,732,192,747,1479,751,1484
·ֵ´,XinTiLuJieDaoBanShiChu,150902001,29245,4389,19367,15148,23473,19317,4780,18781,38098,19047,38414
Ŷֵ´,QiaoDongJieDaoBanShiChu,150902002,15031,2198,9888,7785,12198,9759,2117,9311,19070,9458,19346
ǰ·ֵ´,QianJinLuJieDaoBanShiChu,150902003,43019,5372,28298,20204,30135,26144,7074,25042,51186,27167,55465
ֵ´,ChangQingJieDaoBanShiChu,150902004,25128,3028,16523,12694,14617,16194,5058,16343,32537,16691,33214
ɽֵ´,HuShanJieDaoBanShiChu,150902005,43108,4209,29245,18487,27009,24436,7954,24165,48601,26026,55271
ֵ´,QiaoXiJieDaoBanShiChu,150902006,12264,2102,8227,6616,9662,8220,2063,8120,16340,8202,16429
»ֵ´,XinHuaJieDaoBanShiChu,150902007,32927,3003,21505,15541,17604,20808,7245,20999,41807,21670,43175
Ȫɽֵ´,QuanShanJieDaoBanShiChu,150902008,47769,2678,29409,20088,16457,26734,7962,25757,52491,29000,58409
׺,BaiHaiZiZhen,150902105,13319,1449,8777,4741,12158,6205,1628,6366,12571,7619,16396
,MaLianQuXiang,150902205,15645,1970,9908,7132,14776,9075,2401,9321,18396,10108,20016
׿ɽ,ZhuoZiShanZhen,150921106,39565,5410,24661,19528,40899,23710,6186,24926,48636,26500,51161
Ӫ,QiXiaYingZhen,150921107,19895,2906,11965,8801,23776,11836,2650,13229,25065,13486,25451
ʮ̨,ShiBaTaiZhen,150921108,13125,2875,7909,6524,16291,7861,1340,8851,16712,9431,17340
,BaYinXiLeZhen,150921109,9387,1604,5435,4314,11692,5432,843,6322,11754,6399,11834
滨,LiHuaZhen,150921110,10464,1849,6190,4765,13185,6187,1235,7303,13490,7358,13548
,DaYuShuXiang,150921210,10182,1777,5555,4774,11830,5492,1103,6676,12168,7507,13062
,HongZhaoXiang,150921211,3569,592,1978,1690,4327,1969,408,2412,4381,2591,4569
˳,ChangShunZhen,150922103,55584,5628,35729,28402,49935,34422,10185,34416,68838,35668,71397
,ZhaoYangZhen,150922104,12653,2236,8376,6884,16409,8376,2012,8496,16872,8525,16901
ߺ,QiHaoZhen,150922105,10373,1650,6442,5091,12982,6425,1315,6786,13211,6896,13338
°ͼ,DeBaoTuXiang,150922200,9778,1649,6055,5105,12467,6046,1208,6537,12583,6580,12635
,GongLaHuDongXiang,150922201,7108,1191,4555,3646,9220,4555,965,4709,9264,4709,9264
̨,QiTaiZhen,150923101,68749,8502,46509,33662,60158,44714,15085,43995,88709,45827,92336
ʮ,ShiBaQingZhen,150923102,11927,2089,7939,6908,15877,7932,2222,8233,16165,8299,16238
ɳ,DaHeiShaTuZhen,150923103,15199,2535,9880,7746,19884,9872,2652,10455,20327,10506,20386
,XiJingZiZhen,150923104,16379,2949,10419,8480,21608,10410,2727,11536,21946,11636,22055
ͿѶ,TunKenDuiZhen,150923105,17975,2931,11723,9390,23681,11718,3068,12198,23916,12251,23974
С,XiaoHaiZiZhen,150923106,15987,2674,10650,8641,21082,10638,2860,10811,21449,10871,21521
,DaKuLunXiang,150923200,9984,1766,6409,5435,12963,6401,1454,6774,13175,6795,13204
î,MaoDouXiang,150923201,6462,1230,4141,3805,8389,4139,866,4365,8504,4417,8558
,BoLiHuJingXiang,150923202,12157,2017,7874,6399,15911,7871,1971,8210,16081,8271,16145
ǹ,ChengGuanZhen,150924106,59631,6779,41264,29598,56777,40640,16201,40406,81046,41347,82611
Ÿ,ZhangGaoZhen,150924107,16009,2646,10165,7967,21190,10157,2802,11219,21376,11292,21457
,SaiWuSuZhen,150924108,17936,2900,11494,8893,22459,11422,3273,12179,23601,12615,24109
,EErDongZhen,150924109,12225,2389,7683,5489,15198,7586,1431,7952,15538,8362,16045
,DianZiZhen,150924110,13512,2502,8799,6663,17801,8787,2361,9437,18224,9576,18375
,DaKuLianXiang,150924209,21505,3160,14093,10848,28377,14091,3980,14482,28573,14552,28645
Ž,MinZuTuanJieXiang,150924210,21110,3599,13688,10068,27915,13686,3575,14564,28250,14596,28284
ϲί,NanBuKuangQuGuanWeiHui,150924400,421,79,275,276,491,275,41,266,541,266,541
᷺,DaiHaiZhen,150925103,62344,7202,41336,28519,65838,41078,14602,41880,82958,42812,84148
ľ,LiuSuMuZhen,150925104,18713,3147,11906,9448,24236,11903,3154,13041,24944,13108,25014
ͼ,MaiHuTuZhen,150925105,15414,2430,9801,6316,19583,9775,2568,10572,20347,10611,20412
,YongXingZhen,150925106,6617,1122,4065,2757,8583,4064,1067,4730,8794,4741,8806
,ManHanZhen,150925107,12200,2094,7317,4830,15847,7315,1919,8885,16200,8896,16213
,TianChengXiang,150925218,12759,2272,8247,4721,16631,8237,2077,8752,16989,8861,17108
,CaoNianManZuZiZhiXiang,150925219,9996,1944,6110,5239,13172,6110,1449,7239,13349,7279,13389
᷺ѭҵչ,DaiHaiXunHuanGongYeFaZhanQu,150925400,685,3,95,1,3,0,0,5,5,593,688
ɽֳ,ManHanShanLinChang,150925401,3,5297,0,2,0,0,0,3,3,3,3
ֳ᷺,DaiHaiLinChang,150925402,2,1,1,2,3,1,0,2,3,2,3
᷺´,DaiHaiLvYouQuBanShiChu,150925403,170,0,64,0,0,0,0,0,0,106,170
,TuGuiWuLaZhen,150926105,47004,6712,30524,24360,57972,30462,8317,31213,61675,31509,62033
ƽȪ,PingDiQuanZhen,150926106,13091,2524,8703,6418,15189,8617,2308,8875,17492,9220,17923
õӪ,MeiGuiYingZhen,150926107,12242,2641,7966,6380,15982,7957,1658,8448,16405,8575,16541
,BaYinTaLaZhen,150926108,11558,2067,7568,5750,15024,7561,1967,7975,15536,8024,15592
캣,HuangQiHaiZhen,150926109,14346,2388,9087,7631,16570,9008,2589,9499,18507,10236,19323
,WuLaHaWuLaXiang,150926209,6034,1203,3946,3415,7790,3943,867,4148,8091,4158,8104
ïӪ,HuangMaoYingXiang,150926210,8746,1799,5632,4687,11407,5611,1298,6053,11664,6211,11843
,SanChaKouXiang,150926211,9893,1917,6205,5383,12728,6197,1265,6716,12913,6870,13075
Ʋ,KeBuErZhen,150927103,36177,4353,22851,17924,38204,22120,5817,22770,44890,23496,46347
ɳ,TieShaGaiZhen,150927104,18311,2502,11433,8716,23290,11432,2665,12020,23452,12045,23478
,HuangYangChengZhen,150927105,10655,1572,6375,4708,13417,6367,1222,7035,13402,7074,13449
¡,GuangYiLongZhen,150927106,8534,1282,5048,3804,10527,5039,1013,5603,10642,5781,10829
ͼ,WuSuTuZhen,150927107,6073,693,3878,2730,7600,3878,1153,4040,7918,4041,7919
̲,DaTanXiang,150927216,8299,1220,4840,3827,10354,4835,958,5582,10417,5637,10477
,HongPanXiang,150927217,9103,1445,5459,4336,11379,5456,959,6022,11478,6048,11507
,BaYinXiang,150927218,5865,761,3568,2546,6786,3563,886,3840,7403,3944,7512
ľ,KuLunSuMu,150927219,1294,116,760,580,1489,752,202,769,1521,852,1612
ҳľ,WuLanHaYeSuMu,150927220,9979,1411,5761,4392,12170,5761,904,6506,12267,6533,12294
԰ίԱ,HuiTengXiLeYuanQuGuanLiWeiYuanHui,150927400,3240,389,1905,1440,3873,1900,430,2086,3986,2154,4059
,BaiYinChaGanZhen,150928105,47547,5423,31073,23216,49776,30708,9322,30855,61563,31219,62292
̨,TuMuErTaiZhen,150928106,17676,3123,11720,9948,21118,11700,2686,11637,23337,11765,23485
ͼ,HongGeErTuZhen,150928107,14005,1696,8438,5900,15516,8174,2213,8553,16727,9476,17914
ں,BenHongZhen,150928108,17407,3015,11303,8337,22377,11279,2800,11723,23002,11919,23222
ɺľ,DangLangHuDongSuMu,150928209,6895,1206,4522,4004,9046,4514,1168,4661,9175,4747,9269
ľ,WuLanHaDaSuMu,150928210,5979,909,3846,2648,7397,3833,878,3876,7709,3920,7766
,XiLeXiang,150928211,4784,1011,2889,2685,5982,2885,431,3217,6102,3337,6226
,WuLanHuaZhen,150929100,50326,5685,34575,25451,35284,33975,12311,32914,66889,33747,68322
̫,JiShengTaiZhen,150929101,14242,2008,8778,7403,18074,8772,2197,9598,18370,9669,18447
ͼ,KuLunTuZhen,150929102,12474,1700,7633,6044,15808,7633,1734,8265,15898,8275,15908
,GongJiTangZhen,150929103,13257,1686,8128,6523,16988,8128,2087,8902,17030,8902,17030
�ͼ,BaiYinChaoKeTuZhen,150929104,4184,253,2361,2023,3525,2346,635,2552,4898,2711,5072
ľ,HongGeErSuMu,150929200,2285,255,1325,1141,2498,1310,246,1449,2759,1461,2786
ľ,JiangAnSuMu,150929201,2158,141,1132,1100,2154,1108,288,1260,2368,1455,2587
ɲľ,ChaGanBuLiGeSuMu,150929202,1856,170,1088,929,2107,1088,270,1208,2296,1208,2296
ľľ,NaoMuGengSuMu,150929203,1372,80,766,708,1413,763,172,850,1613,858,1624
˺,DongBaHaoXiang,150929204,21148,2733,13074,10420,27232,13071,3681,14434,27505,14488,27562
ͼ,HuJiTuXiang,150929205,11688,1607,7142,5755,14924,7142,1749,7899,15041,7902,15044
,WuLanMuChang,150929400,113,18,67,58,138,67,9,73,140,73,140
³ֵ´,XinChengQuJieDaoBanShiChu,150981005,29581,2816,19593,14582,19954,19522,6946,19573,39095,19750,39343
ɳֵ´,JiuChengQuJieDaoBanShiChu,150981006,16246,2316,10853,8691,13814,10438,3019,10172,20610,10728,21581
ֵ´,BeiChengQuJieDaoBanShiChu,150981007,17246,2327,11378,9487,16438,11358,3506,11482,22840,11701,23079
ҵֵ´,GongYeQuJieDaoBanShiChu,150981008,20524,1594,13317,10696,14888,13268,4791,13528,26796,13592,26909
ϳֵ´,NanChengQuJieDaoBanShiChu,150981009,18195,1859,11257,8323,20337,11110,3430,11567,22677,12227,23484
¡ʢׯ,LongShengZhuangZhen,150981107,13907,3146,9138,6647,17881,9103,1892,9689,18792,9807,18945
̨,HeiTuTaiZhen,150981108,11782,2391,7540,5410,15636,7527,1659,8237,15764,8292,15832
ɰ,HongShaBaZhen,150981109,7315,1519,4640,3949,9323,4639,877,5046,9685,5071,9711
ޱׯ,JuBaoZhuangZhen,150981110,17861,2759,11659,7745,22084,11642,3461,12349,23991,12422,24081
Ȫ,SanYiQuanZhen,150981111,7422,1507,4603,3912,9655,4600,931,5225,9825,5257,9860
ԴҤ,HunYuanYaoXiang,150981207,12845,2416,8136,6186,16787,8135,1715,8831,16966,8840,16976
ͱ,GuanTunBaoXiang,150981208,11566,2186,7458,5256,15102,7348,2055,8098,15446,8349,15807
´,AiGuoBanShiChu,152201001,22632,2052,14190,9818,18019,13849,3318,13486,27335,13812,28002
ƽ´,HePingBanShiChu,152201002,35475,2613,22326,14897,26368,21131,5665,20219,41350,21427,43753
˰´,XingAnBanShiChu,152201003,33183,3014,21537,13132,33001,19621,5599,18178,37799,20259,41796
ʤ´,ShengLiBanShiChu,152201004,22320,1721,13788,8318,19750,11620,3887,11362,22982,14140,27928
´,TieXiBanShiChu,152201005,17870,1553,10908,8163,14727,10665,2571,10765,21430,11086,21994
ְ´,DouLinBanShiChu,152201006,23595,2312,14855,11276,20919,14779,3673,14426,29205,14725,29580
һ´,WuYiBanShiChu,152201007,27296,2767,16763,12252,23114,15816,3644,15247,31063,16944,33707
ǽ´,ChengJiaoBanShiChu,152201008,29982,2120,18116,11270,24398,16047,4085,16831,32878,18071,36187
,WuLanHaDaZhen,152201100,25964,2167,15474,10572,26918,15322,4703,16785,32107,17360,32834
,GeGenMiaoZhen,152201101,21046,1701,12960,8714,24331,12949,4125,13805,26754,13912,26872
ԭֳ,WuLanHaDaYuanZhongChang,152201400,848,72,539,352,753,539,166,545,1084,547,1086
�,HuHeMaChang,152201401,2701,215,1561,1224,2553,1556,426,1725,3281,1781,3342
ֵֺ´,LinHaiJieDaoBanShiChu,152202001,20413,3193,12631,9438,22760,12455,2427,12556,25011,13402,26033
³ǽֵ,XinChengJieDao,152202002,2697,368,1585,1236,2685,1578,361,1649,3227,1841,3426
Ȫֵ,WenQuanJieDao,152202003,11534,396,4042,2331,4724,2999,936,3024,6023,8824,12866
,TianChiZhen,152202100,3763,299,1343,1134,1748,1235,241,1396,2631,2960,4303
,BaiLangZhen,152202101,2031,194,1135,899,1695,1093,224,1155,2248,1314,2449
�,WuChaGouZhen,152202102,15673,1162,9308,5878,8316,9276,2399,9608,18884,9926,19234
ƶ,KeErQinZhen,152221100,64627,5631,39773,25156,69516,36987,11522,38823,75810,42007,81780
,SuoLunZhen,152221101,14246,1257,8666,6446,16017,8657,2482,9293,17950,9319,17985
²˹,DeBoSiZhen,152221102,20899,1155,12392,7848,24652,12370,3988,13628,25998,13650,26042
ʯկ,DaShiZhaiZhen,152221103,26450,2094,16030,10062,32088,16004,4586,16994,32998,17100,33130
,GuiLiuHeZhen,152221104,22369,1571,13560,8913,27063,13539,4376,14595,28134,14756,28316
,JuLiHenZhen,152221105,14798,1257,9023,6302,14573,8966,2618,9407,18373,9650,18673
ɭ,ChaErSenZhen,152221106,13610,780,8153,5526,16505,7949,2837,8719,16668,9074,17227
ͼ,EErGeTuZhen,152221107,14741,816,8959,5172,16812,8904,2768,9167,18071,9366,18325
,ManZuTunManZuXiang,152221200,3343,134,1973,1258,3510,1965,698,2172,4137,2202,4175
ëľ,WuLanMaoDouSuMu,152221201,8030,336,4885,2809,8285,4852,1670,5055,9907,5151,10036
öľ,ALiDeErSuMu,152221202,23719,1495,14476,8286,28246,14446,4659,15261,29707,15397,29873
Ծ�,YueJinMaChang,152221400,4245,424,2618,1927,4725,2605,767,2784,5389,2818,5436
,SuoLunMuChang,152221401,3761,397,2441,1711,4521,2437,714,2431,4868,2431,4872
ö,ALiDeErMuChang,152221403,1207,91,753,548,1207,750,233,770,1520,778,1531
,GongZhuLingMuChang,152221404,1309,158,834,666,1435,824,227,820,1644,860,1694
ˮ,LvShuiZhongChuChang,152221405,630,28,352,263,506,349,81,377,726,387,739
,BaYanHuShuZhen,152222100,71440,4735,44657,29053,75244,42549,13068,42570,85119,44586,89243
ľ,BaRenZheLiMuZhen,152222101,14587,689,8443,5731,15878,8077,3082,8786,16863,9915,18358
ë,TuLieMaoDuZhen,152222102,22477,1374,14083,9135,27680,13755,5135,14475,28230,14903,28986
Ŷ,DuErJiZhen,152222103,15817,936,9873,6146,19131,9847,3494,10238,20085,10374,20247
,GaoLiBanZhen,152222104,20540,1328,12947,8011,25378,12622,4520,13076,25698,13441,26388
ľ,HaoYaoSuMuZhen,152222105,21431,1352,13429,8369,26763,13029,4786,13665,26694,14140,27569
ľ,DaiQinTaLaSuMu,152222200,12126,899,7608,5327,14998,7526,2500,7821,15347,7917,15525
¼ľľ,XinJiaMuSuMu,152222201,9308,536,5654,3716,11268,5640,1903,6043,11683,6093,11747
ػ,BuDunHuaMuChang,152222400,4462,260,2762,1908,5160,2755,832,2779,5534,2792,5554
ëũ,TuLieMaoDuNongChang,152222401,2078,160,1287,1098,2184,1282,424,1370,2652,1375,2662
Ǧ,QianKuangGuanLiQu,152222402,2661,316,1722,1553,3054,1720,392,1639,3359,1647,3369
ͭ,TongKuangGuanLiQu,152222403,1475,82,898,676,1496,895,256,893,1788,915,1813
¶,YinDeErZhen,152223100,100565,7084,61080,40588,101464,57688,20349,58508,116196,66918,127998
,XinLinZhen,152223101,24721,1695,14912,9724,28821,14786,4443,15770,30556,15947,30859
,BaYanGaoLeZhen,152223102,39437,2414,23615,14781,46692,23335,6558,24514,47849,24794,48409
,HuErLeZhen,152223103,28507,1331,17055,10963,33609,16566,5942,18186,34752,18725,35780
,AErBenGeLeZhen,152223104,28386,1647,16862,11502,33371,16824,4953,18030,34854,18124,34986
ʹ,BaDaErHuZhen,152223105,18587,986,10878,7524,21984,10550,3648,11924,22474,12343,23221
ͼ,TuMuJiZhen,152223106,10171,610,6111,3984,11854,6107,1815,6465,12572,6485,12596
,HaoLiBaoXiang,152223200,35043,2378,21311,13603,41154,21236,6267,22239,43475,22377,43688
ľ,BaYanWuLanSuMu,152223201,14886,695,8873,5606,17658,8851,2930,9582,18433,9638,18511
ͼ,TuMuJiXuNiDiQu,152223400,1925,238,1135,983,1567,1130,186,1188,2318,1214,2349
,XuNiDiQu,152223401,1106,224,723,607,1128,708,120,698,1406,727,1450
,XuNiDiQu,152223402,1111,223,672,630,1145,669,71,693,1362,733,1405
,XuNiDiQu,152223403,4191,742,2617,2315,3914,2605,416,2633,5238,2732,5349
,ZhongChuChang,152223404,1789,89,1113,762,1982,1068,426,1141,2209,1191,2304
һ,BaYiMuChang,152223405,1382,205,828,724,1497,819,108,858,1677,867,1695
ʹũ,BaDaErHuNongChang,152223406,1425,120,809,671,1504,792,201,900,1692,937,1746
ͻȪ,TuQuanZhen,152224100,73558,6235,46614,31580,80132,44693,14195,45259,89952,47374,93988
,LiuHuZhen,152224101,34356,3118,21272,14410,42347,21227,6108,22216,43443,22310,43582
Ŷ,DongDuErJiZhen,152224102,31726,2874,19588,13074,38480,19566,5461,20396,39962,20473,40061
,YongAnZhen,152224103,17491,1687,10959,7548,21429,10920,3340,11410,22330,11559,22518
ˮȪ,ShuiQuanZhen,152224104,26630,2153,16448,11055,31445,16331,4844,16945,33276,17179,33627
ʯ,BaoShiZhen,152224105,29834,2616,18748,12089,37155,18724,5826,19485,38209,19528,38276
ŶӪũ,DongDuErJiGuoYingNongChang,152224400,1631,158,1074,747,1967,1074,372,1087,2161,1087,2161
ֵ´,WuLanJieDaoBanShiChu,152501001,18232,858,10941,8118,7712,10376,3652,10665,21041,11801,22742
ֵֽ´,XiLinJieDaoBanShiChu,152501002,30300,768,18868,12911,9400,18350,7223,18879,37229,19423,38291
ǽֵ´,DongChengJieDaoBanShiChu,152501003,8348,439,5030,3750,3112,4914,1635,5088,10002,5392,10422
հľ,GeRiLeAoDouSuMu,152501200,2318,111,1189,818,1723,1107,295,1134,2241,1535,2724
ϣֵ´,XiRiTaLaJieDaoBanShiChu,152502001,34221,2950,21262,15609,25923,20771,6089,19967,40738,21998,43260
ֵ´,BaoLiGenJieDaoBanShiChu,152502002,21152,2134,13198,9979,13221,13031,3765,13344,26375,13853,27051
ǽֵ´,HangGaiJieDaoBanShiChu,152502003,38721,2376,23773,16673,18535,22862,7375,23570,46432,24699,48472
ֵ´,ChuGuLanJieDaoBanShiChu,152502004,38514,3595,24526,17324,23375,22743,6645,22533,45276,24228,48754
ؽֵ´,EErDunJieDaoBanShiChu,152502005,33632,3044,21132,14419,21182,18679,5037,18480,37159,20581,41713
Ͻֵ´,NanJiaoJieDaoBanShiChu,152502006,5518,646,3296,2639,5135,3251,645,3406,6657,3513,6809
ɽֵ´,BaYanChaGanJieDaoBanShiChu,152502007,9387,318,4299,2437,2338,3019,937,3193,6212,6343,10642
Ʊ,AErShanBaoLaGeZhen,152502100,5650,149,2259,1385,2122,1828,526,1984,3812,4066,6325
ľ,BaoLiGenSuMu,152502200,3547,131,1592,1050,2574,1459,398,1569,3028,2484,4076
ľ,ChaoKeWuLaSuMu,152502201,2051,101,1165,760,2041,1145,389,1209,2354,1376,2541
հ´,BaYanXiLeBanShiChu,152502202,4254,444,2446,2149,4348,2437,634,2746,5183,2886,5332
ë,MaoDengMuChang,152502502,792,45,339,294,460,315,74,389,704,572,911
̨,BieLiGuTaiZhen,152522100,17941,1821,11391,8199,16068,10687,3265,10537,21224,11636,23027
,HongGeErGaoLeZhen,152522101,3945,235,1974,1361,3381,1876,509,2043,3919,2715,4689
׶,ChaGanNaoErZhen,152522102,4280,265,2315,1503,4374,2274,679,2487,4761,2909,5224
ʱľ,NaRenBaoLaGeSuMu,152522200,2716,142,1398,1060,2557,1360,345,1500,2860,1805,3203
͸ľ,YiHeGaoLeSuMu,152522201,2314,120,1339,938,2323,1326,383,1446,2772,1478,2817
ͼľ,JiErGaLangTuSuMu,152522202,2609,126,1308,923,2111,1276,366,1465,2741,1793,3101
ͼú,MaNiTuMeiKuang,152522400,1479,10,274,210,260,197,24,240,437,1239,1513
ͼ,ManDouLaTuZhen,152523100,14812,1455,9402,7126,12902,9244,2946,9228,18472,9811,19213
ɰ,ChaGanAoBaoZhongXinZhen,152523101,1816,77,965,694,1869,940,325,1121,2061,1253,2218
׶,BaYanNaoErZhen,152523102,4337,214,2553,1645,4712,2540,793,2710,5250,2791,5344
ľ,BaYanWuLaSuMu,152523200,3284,149,1706,1284,3214,1655,423,1940,3595,2150,3856
߱ľ,SaiHanGaoBiSuMu,152523201,2560,86,1148,770,1966,1098,375,1264,2362,1873,3021
,SaiHanTaLaZhen,152524100,35129,4256,22799,16883,27594,22435,6331,21810,44245,22917,45716
պ,ZhuRiHeZhen,152524101,8362,714,4308,3551,6577,4090,1086,4368,8458,5854,10162
ո,WuRiGenTaLaZhen,152524102,6535,356,3796,3166,4799,3757,1130,4022,7779,4225,8021
ɣľ,SangBaoLiGeSuMu,152524200,2266,157,1297,1001,2471,1281,421,1359,2640,1547,2844
׶ľ,ERenNaoErSuMu,152524201,1450,83,821,609,1400,808,264,919,1727,976,1797
ľ,SaiHanWuLiJiSuMu,152524202,2017,115,1234,893,2319,1232,391,1281,2513,1289,2523
˹̫,WuLiYaSiTaiZhen,152525100,31564,2114,19900,13775,24270,19692,6612,19615,39307,20390,40290
׶,DaoTeNaoErZhen,152525101,4092,195,2402,1477,4142,2285,878,2439,4724,2763,5165
´ﲼ,GaDaBuQiZhen,152525102,2652,94,1531,905,2731,1462,562,1494,2956,1777,3308
,ManDouHuBaoLaGeZhen,152525103,5009,190,2290,1230,2964,1983,759,2213,4196,3668,5958
׶,EJiNaoErZhen,152525104,5150,211,2612,1574,4898,2566,933,2741,5307,3682,6294
˶,BaYinHuShuoZhen,152525105,11379,762,6961,5276,8544,6859,2450,7171,14030,7630,14591
ͼ׶ľ,HuReTuNaoErSuMu,152525200,3991,147,2343,1516,4048,2333,783,2481,4814,2578,4921
ľ,SaMaiSuMu,152525201,2941,78,1570,1059,2586,1532,415,1729,3261,1864,3434
ͼũ,HaLaGaiTuNongMuChang,152525500,2139,158,1230,1013,1789,1222,428,1433,2655,1495,2725
˹ũ,HeSiGeWuLaNongMuChang,152525501,4068,97,1395,1070,882,1262,380,1543,2805,3150,4545
,WuLaGaiMuChang,152525502,1971,82,724,665,1150,679,214,883,1562,1543,2267
ܳ,BaoGeDaWuLaZongChang,152525503,372,25,203,182,286,203,67,261,464,261,464
¶,BaLaGaErGaoLeZhen,152526100,33513,2425,20459,13578,30242,19921,6131,19998,39919,21610,42069
廨,BaYanHuaZhen,152526101,18287,464,8032,4795,12495,7392,2301,7761,15153,13020,21052
ʸ,JiRenGaoLeZhen,152526102,6288,295,3325,2362,6176,3263,890,3409,6672,4148,7473
ͼ,HaoLeTuGaoLeZhen,152526103,4630,242,2415,1723,4276,2336,669,2518,4854,3126,5541
պ,GaoRiHanZhen,152526104,2951,216,1849,1304,3703,1849,662,1980,3829,1980,3829
ľ,BaYanHuShuSuMu,152526200,5611,255,3463,2276,6450,3462,1092,3486,6948,3495,6958
ҵܳ,LinYeZongChang,152526500,575,29,281,237,503,262,88,278,540,411,692
,BaoChangZhen,152527100,46692,6387,30812,25424,51924,30708,8820,30724,61432,31087,61899
ǧ﹵,QianJinGouZhen,152527101,13049,2338,8533,7592,16856,8512,2113,8889,17401,8967,17500
,HongQiZhen,152527102,11319,2248,7277,6575,14520,7266,1473,7660,14926,7763,15040
ɽ,LuoTuoShanZhen,152527103,6899,1250,4494,4000,8879,4490,1143,4794,9284,4798,9292
Ҹ,XingFuXiang,152527200,4459,1060,3030,2819,5785,3024,580,3032,6056,3069,6099
ľ,GongBaoLaGeSuMu,152527201,2067,205,1222,1137,2208,1221,237,1282,2503,1287,2509
±,XinBaoLaGeZhen,152528100,17262,1459,10450,7761,16650,10303,2774,10294,20597,11045,21495
,BaYanTaLaZhen,152528101,3420,252,1907,1297,3458,1848,505,1886,3734,2270,4177
̹ľ,WengGongWuLaSuMu,152528200,2254,145,1331,920,2607,1328,379,1381,2709,1447,2778
ͼ,MingAnTuZhen,152529100,25361,2401,16346,11591,22698,16195,4991,15858,32053,16407,32753
ҫ,XingYaoZhen,152529101,9106,1566,5588,4451,11560,5580,1157,6175,11755,6241,11829
׶ľ,YiHeNaoErSuMu,152529200,3890,241,2281,1621,4576,2276,583,2420,4696,2433,4714
鲼ľ,WuLanChaBuSuMu,152529201,3639,251,2177,1448,4269,2177,534,2244,4421,2247,4424
ͼ,ELiTuZhongChuChang,152529500,498,61,281,215,549,274,58,287,561,336,617
ոͼֳ,ZheRiGenTuLinChang,152529502,94,1,36,23,53,32,11,29,61,70,106
϶,ShangDouZhen,152530100,32346,2467,18642,13531,27959,18067,4912,18152,36219,21083,39725
ɣ,SangGenDaLaiZhen,152530101,8631,551,5104,3933,8775,5034,1429,5078,10112,5507,10611
ո,HaBiRiGaZhen,152530102,9018,1196,5570,4121,10868,5504,1246,5705,11209,5890,11460
ľ,BaoShaoDaiSuMu,152530200,3549,233,2097,1348,4169,2087,497,2155,4242,2182,4279
ͼľ,NaRiTuSuMu,152530201,5591,363,3402,2009,6405,3390,900,3321,6711,3452,6854
ľ,SaiYinHuDouGaSuMu,152530202,3529,193,2046,1280,4009,2012,555,2085,4097,2231,4277
һܳ,WuYiZhongChuChangZongChang,152530500,1773,285,1168,941,2163,1157,346,1209,2366,1236,2404
ڳʾ,HeiChengZiShiFanQu,152530501,1896,194,1126,875,2119,1097,267,1126,2223,1231,2357
󱱹,DaBeiGouZhen,152531100,18857,1670,11122,6986,21967,11063,3001,11817,22880,12406,23528
ŵ,DuoLunNuoErZhen,152531101,42736,3535,26079,18491,36766,24867,8155,25050,49917,28347,54426
ӿ,DaHeKouXiang,152531200,8373,703,4965,3209,9851,4936,1467,5377,10313,5578,10543
ľɽ,CaiMuShanXiang,152531201,9951,890,5813,3909,11589,5781,1555,6215,11996,6583,12396
¶ͼ,WenDouErLeTuZhen,152921102,1854,139,1111,793,1963,1081,432,1201,2282,1314,2425
˹̫,WuSiTaiZhen,152921104,16805,164,7051,4207,920,4764,1814,5525,10289,11732,18783
,BaRunBieLiZhen,152921105,5682,505,3048,2274,4808,2813,768,3028,5841,3907,6955
,BaYanHaoTeZhen,152921110,72746,7565,46489,33734,60317,45475,14134,44360,89835,47956,94445
ζ,JiaErGaLeSaiHanZhen,152921111,5344,496,3066,2220,4732,2826,1048,3093,5919,3822,6888
̩,JiLanTaiZhen,152921112,12551,1172,7743,6302,10777,7554,2360,7796,15350,8340,16083
ڱ,ZongBieLiZhen,152921113,12895,432,4861,5116,3468,4557,1211,6093,10650,9677,14538
ײ,AoLunBuLaGeZhen,152921114,3311,272,1795,1344,2483,1703,511,1860,3563,2299,4094
ڸ˹,TengGeLiELiSiZhen,152921115,1744,94,545,275,672,319,50,342,661,1343,1888
ľľ,BaYanMuRenSuMu,152921203,1716,171,1025,690,1927,993,370,1076,2069,1232,2257
ľ,WuLiJiSuMu,152921213,1516,111,721,491,1249,673,182,736,1409,1088,1809
ŵչľ,BaYanNuoRiGongSuMu,152921214,2044,214,1102,831,1881,1035,226,1099,2134,1382,2484
˹ʲľ,EErKeHaShenHaSuMu,152921215,624,72,400,300,783,399,149,440,839,445,845
Ϻ�,EKenHuDouGeZhen,152922103,13449,1229,7549,5482,10861,7235,2120,7208,14443,9249,16798
Ų,YaBuLaiZhen,152922104,2759,280,1627,1466,2751,1579,340,1651,3230,1752,3379
ڰ,ALaTengAoBaoZhen,152922105,1758,231,1051,899,2001,1028,231,1077,2105,1169,2220
ľ,ManDeLaSuMu,152922211,1398,131,627,467,1066,604,121,624,1228,1023,1650
ڳľ,ALaTengChaoGeSuMu,152922212,1102,154,657,568,1266,651,127,655,1306,726,1383
,DaLaiHuBuZhen,152923100,13677,1031,7932,5607,11322,7732,2219,7782,15514,8995,16927
,DongFengZhen,152923101,5776,282,4766,3526,654,4180,2292,2482,6662,3584,8350
ľ,SaiHanTaoLaiSuMu,152923200,1391,59,444,409,587,404,65,441,845,1071,1515
ɽľ,MaZongShanSuMu,152923201,1192,8,194,71,124,76,22,95,171,1028,1222
ղ׶ľ,SuBoNaoErSuMu,152923202,3552,115,1050,619,898,714,125,803,1517,2742,3792
ũҵҵʾ԰,BaYanTaoLaiNongMuYeChanYeHuaShiFanYuanQu,152923400,489,37,276,218,502,275,78,311,586,328,604
ֵ,HunHeWanJieDao,210102001,39999,6745,25636,19477,35326,25500,4193,25038,50538,25301,50937
»ֵ,XinHuaJieDao,210102002,71084,10075,44890,32504,74431,44497,7929,43394,87891,44198,89088
ֵ,XiTaJieDao,210102007,29682,4673,18615,14290,27847,17903,2246,17087,34990,17986,36601
˾ֵ,BaJingJieDao,210102013,44249,6748,28462,18442,42148,25665,4061,23886,49551,26596,55058
·ֵ,MaLuWanJieDao,210102016,43414,8747,29064,20331,47847,28711,4338,26762,55473,27435,56499
ͽֵ,JiXianJieDao,210102017,46566,9655,30613,20722,45857,29184,4227,27549,56733,29835,60448
Ϻֵ,NanHuJieDao,210102019,77361,10455,44051,24199,62880,32275,5752,30892,63167,49517,93568
׽ֵ,ChangBaiJieDao,210102021,21110,1711,12384,9806,9381,12176,3201,12211,24387,13638,26022
̫ԭֵֽ,TaiYuanJieJieDao,210102022,69512,8039,41460,25613,55226,32466,5435,31169,63635,41526,82986
гֵ,BeiShiChangJieDao,210102023,32140,4212,19688,14720,27651,18596,2630,18033,36629,19294,38982
гֵ,NanShiChangJieDao,210102025,48476,8525,30942,21511,48798,29574,4342,28497,58071,30401,61343
ˮֵ,ShenShuiWanJieDao,210102027,6431,586,3898,2974,3233,3872,967,3881,7753,4086,7984
վֵ,HunHeZhanXiJieDao,210102028,33564,2366,19770,15880,13154,18928,5546,20488,39416,21706,41476
ֵ,DaXiJieDao,210103004,40891,6094,25863,18239,41545,24946,3593,23603,48549,24715,50578
ӽֵ,BinHeJieDao,210103005,49666,6953,31754,23229,43513,30942,5729,29789,60731,30594,62348
ֵ,WanLianJieDao,210103006,28274,5853,19113,14029,31333,18883,3508,17797,36680,18522,37635
Ͻֵ,DaNanJieDao,210103010,56345,8910,36011,26554,55365,35231,5423,33857,69088,34667,70678
ɽֵ,ShanDongMiaoJieDao,210103011,63944,10656,40109,27863,64094,37375,4988,35822,73197,39479,79588
¯ֵ,ZhuJianLuJieDao,210103013,49265,6905,30594,21736,48723,29733,4390,28153,57886,29966,60560
±վֵ,XinBeiZhanJieDao,210103014,30657,3642,18208,12941,23857,16764,2491,16122,32886,18582,36790
ֵ̳,FengYuTanJieDao,210103015,47562,6890,30703,21825,50528,29755,5107,28202,57957,28856,59559
ʳǽֵ,HuangChengJieDao,210103017,40026,5771,24352,17156,39701,22801,3546,21821,44622,24991,49343
ӽֵ,WuLiHeJieDao,210103018,37056,5091,24657,13740,33224,19572,4513,18323,37895,22003,46660
ֵ,NanTaJieDao,210103019,21057,3978,13510,9747,10025,12301,2059,12015,24316,13584,27094
Ȫ԰ֵ,QuanYuanJieDao,210103020,35251,6101,22924,18103,22202,22351,3898,21727,44078,22326,45250
ֵֽ,FengLeJieDao,210103021,55702,6176,34007,25448,26605,32195,6929,32365,64560,34800,68807
Žֵ,MaGuanQiaoJieDao,210103022,37015,3800,23209,11684,15923,13806,2506,13367,27173,20112,43321
ֵ,DongLingJieDao,210103023,89926,9323,54971,44012,37362,54435,11807,54978,109413,56085,111056
󱱽ֵ,DaBeiJieDao,210104002,57751,7141,36561,26858,48750,36024,6649,34056,70080,34980,71541
Ȫֵ,WanQuanJieDao,210104003,37218,6420,24557,17895,34985,24026,3893,22518,46544,22974,47531
䬲ֵ,TaoChangJieDao,210104004,68560,7942,42615,26737,59926,35787,6127,34902,70689,40014,82629
Ĺٽֵ,WenGuanJieDao,210104006,48301,7763,29877,19886,45112,26003,3845,25832,51835,30032,59909
̨ӽֵ,ErTaiZiJieDao,210104007,28156,3220,17057,13813,17260,16675,2990,16806,33481,17309,34366
Žֵ,JinQiaoJieDao,210104008,53317,7417,33497,24886,50987,33055,5173,31724,64779,32410,65907
վֵ,DongZhanJieDao,210104009,38129,6526,23642,19484,38736,23467,3390,23987,47454,24403,48045
ֵ,BeiHaiJieDao,210104010,40694,6119,25310,20701,37498,25110,3757,24995,50105,25260,50570
ֵ,ChangAnJieDao,210104012,48149,7938,31515,23465,52590,31481,5825,30359,61840,30397,61912
¶ֵ,XinDongJieDao,210104014,38995,7386,25019,19437,38146,24817,4085,24426,49243,25447,50466
ֵ,DongTaJieDao,210104015,35232,8093,22966,17648,36633,22628,2962,21905,44533,23321,46287
Сֵ,XiaoDongJieDao,210104016,26149,3729,16280,11969,26007,16127,2405,15379,31506,16003,32283
԰ֵ,ShangYuanJieDao,210104017,55889,7650,35143,27018,46227,34965,6191,34370,69335,34587,69730
ǰֵ,QianJinJieDao,210104018,50809,3999,28954,22856,19707,27618,6883,29400,57018,32737,61691
̨ӽֵ,SanTaiZiJieDao,210105001,66841,14418,43701,31126,73080,41982,7073,41233,83215,44631,88332
ɺӽֵ,LiaoHeJieDao,210105003,73321,12546,47700,32096,69396,43067,6884,40765,83832,45051,92751
ƺӽֵ,HuangHeJieDao,210105008,81055,12126,53300,36878,81802,51327,10017,47714,99041,49898,103198
Žֵ,SanDongQiaoJieDao,210105012,62246,7312,37017,25633,50531,34413,5067,32589,67002,37608,74625
ɽֵ,HuaShanJieDao,210105013,58018,6304,33950,25007,48914,33422,5411,32988,66410,35783,69733
Ȫֵ,ShouQuanJieDao,210105014,19969,2278,11877,8309,17295,11228,2071,11030,22258,12441,24318
ֵ,TaWanJieDao,210105015,64380,10250,41069,29199,63173,40402,6217,38584,78986,39778,80847
ֵ,MingLianJieDao,210105017,67694,9599,42384,31974,60806,42205,7510,41978,84183,42419,84803
ֵֽ,XinLeJieDao,210105019,80140,12655,51377,26899,71886,41606,8473,38774,80380,49891,101268
ֵ,SheLiTaJieDao,210105020,52160,7313,31062,22049,48616,29844,6197,28664,58508,34608,65670
ֵ,BeiTaJieDao,210105021,48912,7041,30813,24298,22291,29598,5034,29082,58680,30174,60987
궫ֵ,LingDongJieDao,210105022,64779,5393,39753,26348,21353,31764,8472,32776,64540,38891,78644
ֵ,KunMingHuJieDao,210106001,32852,2800,18320,14133,7876,15680,2992,16910,32590,20324,38644
˴ֵ,GongRenCunJieDao,210106003,78779,15963,51167,39339,81707,51035,7473,50694,101729,51048,102215
·ֵ,QiLuJieDao,210106005,46486,8445,29492,23679,45409,29384,4504,29515,58899,29943,59435
�ֵ,QiGongJieDao,210106007,33338,5813,20024,16289,30745,19413,2255,19921,39334,21382,41406
ƹֵ,DuGongJieDao,210106013,48734,4660,28812,23741,27996,28583,5267,28212,56795,29849,58661
˻ֵ,XingHuaJieDao,210106015,35195,4972,22557,16890,32775,21452,3846,20666,42118,21456,44013
˹ֵ,XingGongJieDao,210106018,46712,7025,29938,22466,42347,29528,5349,28120,57648,29148,59086
ֵ,JiHongJieDao,210106019,70101,6621,42815,35499,38404,42419,8553,40970,83389,42460,85275
սֵ,LingKongJieDao,210106020,56004,9107,36120,27195,45651,35822,5702,34273,70095,34693,70813
عֵ,ZhongGongJieDao,210106021,62318,13147,40826,30454,63913,40380,5644,39292,79672,40283,81109
޷۽ֵ,YanFenJieDao,210106022,61898,7974,38371,29680,54829,38171,6402,37525,75696,37903,76274
ֵ,BaoGongJieDao,210106023,54716,9405,34451,25804,56917,33979,5233,33246,67225,34903,69354
˳ֵ,XingShunJieDao,210106024,58166,8646,36402,27070,61337,36028,5306,34911,70939,35716,72118
ͽֵ,GuiHeJieDao,210106025,42301,6796,26857,20487,42469,26558,4173,25738,52296,26413,53270
гֵ,DaQingZhongChaoYouYiJieDao,210106026,14907,1368,9144,6443,11457,8778,2299,8827,17605,9430,18574
Լҽֵ,ZhaiJiaJieDao,210106027,16180,1658,10037,7171,13260,9800,2424,9921,19721,10225,20262
ֵ,XiSanHuanJieDao,210106028,22188,1548,12932,11337,8188,12790,3397,13799,26589,14201,27133
˽ֵ,DaPanJieDao,210106029,23184,2467,14247,10075,22691,14063,3754,14444,28507,15158,29405
վ,ZhangYiZhanZhen,210106101,8118,1125,5129,3660,9363,5093,1274,5192,10285,5388,10517
Žֵ,JieFangJieDao,210111001,37124,6105,24803,18856,29782,23015,3972,22129,45144,22398,47201
ֵ,MinZhuJieDao,210111003,29894,3219,17846,15031,17853,17773,3477,18086,35859,18744,36590
ٺֵ,LinHuJieDao,210111004,60210,5963,36359,29108,40288,35872,7416,36749,72621,37230,73589
˽ֵ,ZhongXingJieDao,210111005,30744,3969,16975,11518,22760,14457,2439,14148,28605,20177,37152
ֵ,HuXiJieDao,210111006,48810,5732,29429,20485,40802,26881,5822,25975,52856,30935,60364
һֵ,BaYiJieDao,210111007,14500,1822,8993,6733,14393,8914,1817,9049,17963,9146,18139
ֵ,HongLingJieDao,210111008,24659,2620,14743,11452,23696,14641,3477,15084,29725,16013,30756
ʢֵ,LinShengJieDao,210111009,24714,3156,14975,11432,24188,14793,3085,15170,29963,15980,30955
ɳӽֵ,ShaHeJieDao,210111010,16187,1790,10030,6689,17120,9999,2322,10131,20130,10269,20299
ʮӽֵ,ShiLiHeJieDao,210111011,11380,1274,6494,4082,11590,6375,1542,6657,13032,7702,14196
ֵ,ChenXiangJieDao,210111012,24098,3457,15320,11790,26070,15294,3462,15589,30883,15697,31017
Ҧǧֵ,YaoQianJieDao,210111013,12980,1897,8176,5937,14161,7842,1664,8019,15861,8365,16541
ٽֵ,WangGangJieDao,210111014,11231,1608,6977,4957,13060,6937,1493,7307,14244,7355,14332
ֵֽ,YongLeJieDao,210111015,10182,1379,6320,4621,11835,6307,1472,6634,12941,6713,13033
󹵽ֵ,DaGouJieDao,210111016,9485,1222,5893,3974,10931,5822,1367,6055,11877,6181,12074
ֵ,BaiQingJieDao,210111017,7498,1223,4739,3716,8858,4718,1029,4974,9692,5011,9750
١ֵ,TongGouJieDao,210111018,7225,731,4483,2603,5377,3226,835,3260,6486,4308,8791
Ӣֵ,YingDaJieDao,210112007,5056,569,3100,2470,4308,3062,797,3207,6269,3322,6422
ֵ,DongHuJieDao,210112009,18179,1831,11234,7856,16669,11091,3135,11348,22439,11911,23145
ֵ,WuSanJieDao,210112010,104718,7182,56273,32807,37799,41450,9999,40728,82178,65626,121899
վֵ,HunHeZhanDongJieDao,210112012,21717,1383,11934,8876,6512,10697,3093,11284,21981,14259,26193
߿ֵ,GaoKanJieDao,210112014,19638,2272,12772,6999,18986,9429,2364,9211,18640,11502,24274
ýֵ,ManTangJieDao,210112015,13035,2023,7869,6348,10264,7700,1850,7675,15375,9039,16908
ӽֵ,ShenJingZiJieDao,210112016,16944,2020,10303,7755,17792,10181,2444,10604,20785,11105,21408
ףҽֵ,ZhuJiaJieDao,210112017,11938,1714,7491,5427,13822,7433,1852,7903,15336,8013,15504
ֵ,BaiTaJieDao,210112018,44114,3049,25699,14975,25836,20875,5743,20773,41648,27207,52906
ɽֵ,TaoXianJieDao,210112019,18611,2004,12006,8481,17723,11252,2871,11087,22339,11480,23486
ֵ,LiXiangJieDao,210112020,10274,1412,6489,4828,11759,6425,1677,6742,13167,6874,13363
Ӫӽֵ,YingChengZiJieDao,210112021,28395,2363,16438,14970,17285,16313,4073,17858,34171,18393,34831
ҽֵ,WangJiaJieDao,210112022,18255,1561,10617,7636,16291,10448,2832,10604,21052,12031,22648
,WangBinGouXiang,210112023,6309,925,3894,2981,6937,3850,889,4061,7911,4229,8123
³ӽֵ,XinChengZiJieDao,210113001,47193,5595,29722,21993,34686,28606,6878,27758,56364,29944,59666
ˮֵ̨,QingShuiTaiJieDao,210113002,10703,3029,7381,6521,11012,7373,1237,7492,14865,7588,14969
ɽֵ,HuiShanJieDao,210113003,32349,1689,16337,7759,11695,9990,2275,10004,19994,19976,36313
ֵ,DaoYiJieDao,210113004,86004,2710,46099,15370,28157,19591,5051,19475,39066,47666,93765
Ѻӽֵ,PuHeJieDao,210113005,7612,1031,4762,3265,8340,4625,1084,4706,9331,4965,9727
ʯֵ̨,HuShiTaiJieDao,210113006,75218,6905,43886,22452,44477,28462,6440,28302,56764,44677,88563
ֵ,CaiLuoJieDao,210113007,12718,1701,7749,5603,12935,7562,1648,7817,15379,8318,16067
ֵ´,WangBinJieDaoBanShiChu,210113008,4696,695,2915,2178,5546,2882,654,3074,5956,3130,6045
¡̨,XingLongTaiXiBoZuZhen,210113102,8244,1078,5069,3414,9072,5042,1183,5265,10307,5436,10505
ˮ̨,QingShuiTaiZhen,210113103,12924,1807,8114,5921,13940,8029,1871,8392,16421,8488,16602
³,XinChengZiXiang,210113201,21102,2546,12788,9628,20948,12769,2773,13512,26281,13633,26421
Ƽ,HuangJiaXiBoZuXiang,210113202,9710,1316,6117,4061,11824,6113,1441,6332,12445,6350,12467
ʯ³,ShiFoSiChaoXianZuXiBoZuXiang,210113203,7493,969,4597,3246,8428,4594,1022,4872,9466,4887,9484
,YinJiaXiang,210113204,9117,1176,5720,4155,10042,5715,1421,5971,11686,5994,11714
,MaGangXiang,210113206,7120,953,4358,3267,7901,4319,928,4567,8886,4643,9001
ũ,QingNianNongChang,210113401,335,44,200,154,373,200,21,200,400,200,400
ǰũ,QianJinNongChang,210113402,1143,225,720,552,1317,720,119,767,1487,767,1487
ũ,YuXinNongChang,210113403,2,3,2,3,1,2,0,3,5,3,5
ֳ,ShenBeiXinQuMaGangLinChang,210113404,23,4,15,13,20,15,1,13,28,13,28
ʾũ,ShenBeiXinQuShiFanNongChang,210113405,33,0,19,13,38,19,5,19,38,19,38
,ShenBeiXinQuZhongChu,210113406,45,9,27,22,18,27,2,29,56,29,56
ӭ·ֵ,YingBinLuJieDao,210114001,79869,7231,42668,31865,45557,38528,7835,39160,77688,52267,94935
ֵ,LingXiJieDao,210114003,72097,11833,45840,37485,29442,45322,7615,44463,89785,45705,91545
ںֵ,YuHongJieDao,210114005,57753,4370,33362,26615,25944,32137,7535,33664,65801,36296,69658
ֵ,BeiLingJieDao,210114007,96077,10128,59814,44544,29231,55601,10800,55465,111066,57191,117005
ɳֵ,ShaLingJieDao,210114009,29264,1835,17019,13147,13619,16431,4587,17357,33788,18667,35686
ֵ,NanYangHuJieDao,210114010,60827,2498,28614,18437,17525,19138,4695,21149,40287,39406,68020
Ƕֵ,ChengDongHuJieDao,210114011,38996,3876,23125,19991,12655,23036,4191,23365,46401,23938,47063
ƽ޽ֵ,PingLuoJieDao,210114012,15846,1778,9878,7029,17134,9833,2408,10076,19909,10154,20032
ҽֵ,MaSanJiaJieDao,210114013,21301,3038,13421,9786,20919,13384,2917,13694,27078,13835,27256
컯ֵ,ZaoHuaJieDao,210114014,28695,2167,17364,11123,14646,13286,3424,13789,27075,16922,34286
˽ֵ,DaXingJieDao,210114015,15662,1782,9449,7022,10148,9199,2021,9302,18501,10016,19465
߻,GaoHuaZhen,210114108,13659,1519,8469,5578,14706,8272,2185,8296,16568,8894,17363
,GuangHuiXiang,210114213,17691,2409,11024,8125,18726,10979,2478,11421,22400,11554,22578
ͶԺ,MaSanJiaLaoDongJiaoYangYuan,210114401,1120,528,906,777,1323,906,135,877,1783,877,1783
ũ,GuangHuiNongChang,210114402,3256,576,2070,1537,3006,2069,336,2096,4165,2098,4168
,LiaoZhongZhen,210122100,88843,9655,56742,43364,83355,55386,14783,55170,110556,56539,113281
ڼҷ,YuJiaFangZhen,210122101,15802,2001,10345,6701,20496,10330,3219,10629,20959,10677,21022
ҷ,ZhuJiaFangZhen,210122102,19158,2721,12377,8457,23696,12347,3521,12957,25304,13023,25400
ӱ,LengZiBaoZhen,210122103,19040,2549,12271,8265,23605,12212,3507,12661,24873,12825,25096
,LiuErBaoZhen,210122104,13502,1730,8596,6040,16542,8590,2246,8850,17440,8882,17478
,CiYuTuoZhen,210122105,40887,3950,25748,18519,41064,25714,7729,26724,52438,26818,52566
,XinMinTunZhen,210122106,12082,1490,7531,5584,14139,7492,2183,7863,15355,8224,15755
�,ManDouHuZhen,210122107,13186,1865,8511,6113,16352,8508,2493,8995,17503,9033,17544
ʿ,YangShiGangZhen,210122108,11037,1204,6862,4809,13162,6837,1912,7241,14078,7291,14153
Фկ,XiaoZhaiMenZhen,210122109,17688,2225,11360,8313,20993,11358,3257,11751,23109,11810,23170
̲,ChangTanZhen,210122110,12981,2098,8394,6540,16539,8394,2266,8951,17345,8951,17345
ķ̨,SiFangTaiZhen,210122111,12499,1583,8111,5928,15514,8100,2446,8406,16506,8417,16528
ǽ,ChengJiaoZhen,210122112,10079,1483,6541,4631,11435,6530,1717,6699,13229,6738,13279
䷿,LiuJianFangZhen,210122113,16225,2124,10267,7247,19219,10142,2712,10535,20677,10794,21061
ʿ,YangShiBaoZhen,210122114,10816,1445,6905,4940,11963,6774,1910,7007,13781,7266,14171
˼ұ,PanJiaBaoZhen,210122115,10515,1436,6713,5133,12577,6713,1865,7101,13814,7103,13816
Ϲ,LaoGuanTuoZhen,210122116,8951,1168,5735,4206,10920,5731,1548,5915,11646,5932,11667
ϴ,LaoDaFangXiang,210122117,9448,1593,6192,4443,11933,6186,1739,6553,12739,6588,12780
ڸ,DaHeiGangZiXiang,210122118,8459,1340,5584,4095,10591,5579,1672,5845,11424,5887,11471
ţ,NiuXinTuoXiang,210122119,12668,1835,8376,5679,16078,8359,2547,8608,16967,8674,17050
ķ̨ũ,SiFangTaiNongChang,210122401,1122,157,734,527,1377,734,169,713,1447,714,1448
ӽֵ,BeiSanJiaZiJieDao,210123001,13732,1711,7535,4753,14226,7527,2264,7650,15177,10172,17707
ƽ,KangPingZhen,210123100,58355,6398,37266,26134,60465,35267,8886,34433,69700,36373,73639
С,XiaoChengZiZhen,210123101,12747,1545,8472,5069,16332,8468,2735,8548,17016,8555,17027
ǿ,ZhangQiangZhen,210123102,16902,2081,10894,6929,21451,10887,3282,11312,22199,11371,22265
,FangJiaTunZhen,210123103,13623,1665,8590,5292,16727,8578,2258,8897,17475,8956,17546
,DongGuanTunZhen,210123104,20127,2397,12932,8653,20854,12922,3437,12979,25901,13029,25961
¹,HaoGuanTunZhen,210123105,13618,1613,8860,5823,17408,8856,2609,8958,17814,8980,17840
ţ,ErNiuSuoKouZhen,210123106,14633,1795,9413,5887,18543,9406,2736,9715,19121,9751,19164
ļ,BeiSiJiaZiXiang,210123203,11804,1454,7648,4536,14611,7644,2314,7906,15550,7924,15572
,LiangJiaZiXiang,210123204,9321,1178,6156,3764,11710,6148,1977,6278,12426,6320,12476
ѱ,HaiZhouWoBaoXiang,210123206,9987,1253,6566,4130,12817,6563,2042,6696,13259,6716,13282
ɳ̨ɹ,ShaJinTaiMengGuZuManZuXiang,210123208,12256,1477,7804,5199,15501,7804,2242,8170,15974,8171,15975
ɹ,LiuShuTunMengGuZu,210123209,11164,1451,7185,4235,14185,7185,1936,7363,14548,7366,14551
ɹ,XiGuanTunMengGuZuManZuXiang,210123210,11384,1336,7308,4282,14260,7308,2194,7591,14899,7606,14914
ɹ,DongShengManZuMengGuZuXiang,210123211,13463,1729,8603,4948,16858,8593,2290,8748,17341,8879,17482
̨,SanTaiZiXuMuChang,210123404,1108,154,710,558,1280,710,156,708,1418,708,1418
,FaKuZhen,210124100,49166,6202,31323,23137,50917,30427,7054,30291,60718,31099,62422
¼,DaGuJiaZiZhen,210124101,15012,2164,9555,6349,18841,9545,2573,10154,19699,10194,19749
洬,SanMianChuanZhen,210124102,14798,1907,9235,5787,18680,9232,2517,9962,19194,9987,19222
ˮ,XiuShuiHeZiZhen,210124103,21815,2674,14019,8620,27585,13998,4457,14849,28847,14927,28946
Ҷį̈,YeMaoTaiZhen,210124104,16089,1931,10156,6430,19975,10151,3040,10860,21011,10904,21060
˱,DengShiBuZiZhen,210124105,11422,1578,7239,4810,14047,7238,1857,7603,14841,7618,14857
ؼҹ,BaiJiaGouZhen,210124106,16947,2158,10753,7016,20705,10751,2965,11310,22061,11317,22070
ҷ,DingJiaFangZhen,210124107,13843,1926,8777,6064,17458,8767,2345,9293,18060,9337,18114
ϼ,MengJiaZhen,210124108,13453,1545,8438,5197,16003,8429,2434,8919,17348,8994,17432
ʮ䷿,ShiJianFangZhen,210124109,22748,2815,13951,8637,24229,13603,3637,14140,27743,15249,29200
뱴,FengBeiBaoZhen,210124110,11512,1378,7236,4552,14261,7219,1954,7571,14790,7608,14844
ţ,YiNiuBuZiZhen,210124111,15466,2306,9918,6308,19602,9868,2692,10475,20343,10546,20464
ȶ,CiEnSiXiang,210124201,13416,1801,8586,5201,16686,8581,2400,8998,17579,9031,17617
ƽ,HePingXiang,210124203,6641,819,4264,2698,8191,4253,1276,4458,8711,4472,8736
̨,WuTaiZiXiang,210124207,9225,1104,5776,3693,11385,5771,1575,6114,11885,6128,11904
ļɹ,SiJiaZiMengGuZuXiang,210124208,11369,1424,7195,4317,14123,7194,1963,7561,14755,7561,14756
˫̨,ShuangTaiZiXiang,210124209,11869,1539,7472,4963,14534,7447,2022,7883,15330,7958,15430
ţʯ,WoNiuShiXiang,210124210,13931,2269,9108,5702,17849,9097,2548,9557,18654,9640,18748
,BaoJiaTunXiang,210124211,18202,2289,11620,7310,23166,11618,3525,12345,23963,12396,24016
ǽֵ,DongChengJieDao,210181001,25399,2992,16202,12444,22394,16080,4065,16044,32124,16254,32456
ɱֵ,LiaoBinJieDao,210181002,37560,4090,24325,17822,36784,21979,5852,21694,43673,23177,47502
ǽֵ,XiChengJieDao,210181003,20383,2597,13212,10221,21731,13192,3172,12908,26100,12940,26152
ֵ,XinLiuJieDao,210181004,26538,3105,17524,12262,24411,15518,3751,15543,31061,15870,33394
³ǽֵ,XinChengJieDao,210181005,10095,1151,6342,4037,12277,6342,1634,6536,12878,6538,12880
,DaHongQiZhen,210181101,17930,2437,11534,7482,22255,11531,3053,11840,23371,11886,23420
ɽ,LiangShanZhen,210181102,17912,2330,11316,7751,21877,11316,3244,12133,23449,12170,23486
,GongZhuTunZhen,210181103,28005,3269,18048,11345,35821,18043,5575,18729,36772,18801,36849
¡,XingLongZhen,210181104,20751,2815,12592,8728,23339,12168,3027,12780,24948,14001,26593
ǰ,QianDangBaoZhen,210181105,16922,2071,10613,7718,19537,10589,2780,11082,21671,11160,21773
,DaMinTunZhen,210181106,27863,3482,17760,11553,33086,17715,4583,17955,35670,18168,35928
,DaLiuTunZhen,210181107,20386,2695,13218,8834,25441,13198,3865,13673,26871,13728,26946
¡,XingLongBaoZhen,210181108,21310,2730,13313,9798,23654,13224,3592,14007,27231,14319,27632
̨,HuTaiZhen,210181109,25685,2397,16030,11444,25171,15842,4663,16122,31964,16715,32745
ţ,FaHaNiuZhen,210181110,21824,2455,13703,9981,25269,13689,3808,14321,28010,14384,28087
ӹ,LiuHeGouZhen,210181111,17664,2149,11216,8037,21459,11211,3164,11718,22929,11761,22977
̨,GaoTaiZiXiang,210181202,9799,1256,6174,4170,11715,6167,1661,6530,12697,6542,12716
̨,JinWuTaiZiXiang,210181204,12146,1572,7790,5457,15157,7782,2174,8065,15847,8102,15892
,HongQiXiang,210181205,8756,1214,5703,3589,11069,5694,1658,5899,11593,5925,11628
¬,LuJiaTunXiang,210181206,9580,1304,6185,4125,11762,6177,1850,6536,12713,6549,12734
Ҧ,YaoBaoXiang,210181207,12075,1402,7590,4782,15056,7585,2276,8116,15701,8163,15753
,ZhouTuoZiXiang,210181208,10166,1501,6555,4321,12720,6550,1742,6830,13380,6854,13409
ڼѱ,YuJiaWoBaoXiang,210181209,8708,1162,5792,3575,11194,5786,1698,5770,11556,5776,11568
ũ,XinNongXiang,210181210,8738,1090,5558,3926,10857,5543,1673,5911,11454,5943,11501
ɽ,DongSheShanZiXiang,210181211,17369,2038,11063,7236,21759,11062,3229,11552,22614,11573,22636
ռ,TaoJiaTunXiang,210181212,8413,940,5332,3388,10084,5327,1409,5379,10706,5430,10762
޼ҷ,LuoJiaFangXiang,210181213,18740,2513,11935,8268,23136,11933,3171,12453,24386,12489,24424
,SanDaoGangZiXiang,210181214,16481,2180,10368,7183,20407,10358,2590,10839,21197,10883,21251
ż,ZhangJiaTunXiang,210181216,11142,1465,7159,4719,13631,7145,2062,7481,14626,7510,14669
㳡ֵ,HaiJunGuangChangJieDao,210202001,49745,8035,32507,23073,41569,31340,5433,29113,60453,30706,63213
ֵֽ,GuiLinJieDao,210202003,22684,4479,16501,10016,21041,14042,2843,12303,26345,13505,30006
·ֵ,RenMinLuJieDao,210202005,16909,2340,10792,7295,10589,8793,1228,7766,16559,9685,20477
Žֵ,QingNiWaQiaoJieDao,210202008,12629,2186,8366,6156,9297,7364,1056,6552,13916,7505,15871
ֵ,KunMingJieDao,210202009,21423,4260,14798,10311,20953,13822,2374,12539,26361,13259,28057
Ӣֵ,KuiYingJieDao,210202010,45577,8647,30539,22611,43626,29660,4953,27807,57467,28638,59177
Դֵ,TaoYuanJieDao,210202011,47617,9238,32571,23028,48321,32054,5660,29474,61528,29944,62515
ϻֵ̲,LaoHuTanJieDao,210202012,46844,7942,30993,22122,36517,30330,5425,28296,58626,29218,60211
¯ֵ,XiangLuJiaoJieDao,210203001,41985,6243,23598,18327,29855,23110,3890,22262,45372,28520,52118
վֵ,ZhanBeiJieDao,210203002,37015,4596,20280,16065,21604,19346,3192,19134,38480,24523,44803
½ֵ,RiXinJieDao,210203004,23469,4574,15854,12371,21283,14858,2802,13920,28778,14991,30845
ֵ,BeiJingJieDao,210203005,31219,4294,19333,14523,22330,18562,3030,17087,35649,19210,38543
һ·ֵ,BaYiLuJieDao,210203010,45837,8226,30446,22949,41442,29460,4896,27743,57203,28513,58959
㳡ֵ,RenMinGuangChangJieDao,210203011,23331,4432,15581,11714,20645,14923,2679,14120,29043,14861,30442
ƽֵ,BaiYunJieDao,210203013,38102,8057,25741,19318,33392,24726,3873,22996,47722,24291,50032
ɽ԰ֵ,ZhongShanGongYuanJieDao,210204002,43212,6548,29151,21275,40916,28483,6317,26136,54619,26926,56077
ɽ·ֵ,BaiShanLuJieDao,210204004,22882,4567,15254,12231,24116,15105,2218,14205,29310,14413,29667
˹ֵ,XingGongJieDao,210204005,61125,10541,36983,29400,54780,35233,4962,33417,68650,39645,76628
ֵ,ChunLiuJieDao,210204006,71404,12799,46706,36727,60497,45619,6862,43031,88650,44359,91065
ֵ,MaLanJieDao,210204008,76073,10016,49937,31504,51671,39772,6551,38471,78243,42703,92640
ɳӿڽֵ,NanShaHeKouJieDao,210204009,65791,10171,44110,33778,58037,43689,10050,41297,84986,41902,86012
ʯֵ,HeiShiJiaoJieDao,210204010,80259,10217,51023,28256,51700,35723,6448,33493,69216,45901,96924
ҽֵ,LiJiaJieDao,210204011,84443,11149,54171,40160,67740,53852,11024,51966,105818,52445,106616
Ǻֵ,XingHaiWanJieDao,210204017,44832,7650,29110,22552,36114,28530,5029,26945,55475,28401,57511
ˮӽֵ,ZhouShuiZiJieDao,210211001,78475,9327,50432,37460,61635,49332,10990,46886,96218,48360,98792
ɽֵ,JiaoJinShanJieDao,210211002,55710,8931,36001,27859,47532,35635,7514,35008,70643,36154,72155
ʾӽֵ,GanJingZiJieDao,210211004,54639,9113,33910,26692,45242,32742,5722,32857,65599,35564,69474
Ϲֵ,NanGuanLingJieDao,210211006,60960,4894,35533,26467,25913,34369,9195,35102,69471,39516,75049
½ֵ,PaoYaJieDao,210211007,101202,11192,63645,42699,53854,57021,13154,56024,113045,61903,125548
л·ֵ,ZhongHuaLuJieDao,210211008,65568,8860,41273,31083,47737,41064,7569,40043,81107,40724,81997
˻ֵ,XingHuaJieDao,210211009,59071,10853,39107,29733,55185,38819,7225,37392,76211,38042,77149
ֵ,JiChangJieDao,210211010,46078,5447,29195,21625,24105,28102,5361,26680,54782,27691,56886
կӽֵ,XinZhaiZiJieDao,210211014,94866,4823,46661,37237,30479,42629,11751,47011,89640,64779,111440
ֵ,HongQiJieDao,210211015,95078,9646,58273,40133,53244,52537,11055,51701,104238,57506,115779
ˮֵ,LingShuiJieDao,210211016,142889,8592,70535,34214,71692,44019,10116,43360,87379,91062,161597
ֵ,DaLianWanJieDao,210211017,78970,6337,43160,32839,42465,40381,10198,41209,81590,52345,95505
Ȫˮֵ,QuanShuiJieDao,210211018,60217,4048,36207,27799,26873,35840,9443,35797,71637,37501,73708
򱤽ֵ,GeZhenBaoJieDao,210211019,40022,3013,23241,15941,14600,18560,4505,20374,38934,24299,47540
Ӫӽֵ,YingChengZiJieDao,210211020,45117,5152,26575,16545,26220,21836,4706,22292,44128,28400,54975
ȹũ,DaLianHuaQiaoGuoShuNongChang,210211400,3247,640,2046,1620,2397,1948,297,1915,3863,2138,4184
Ƿֵ,DengFengJieDao,210212001,23582,3156,15574,11852,19928,15428,3488,14434,29862,14652,30226
гֵ,ShiChangJieDao,210212002,18295,3208,12372,9432,16414,12130,2539,11464,23594,11670,24042
ʤֵ,DeShengJieDao,210212003,26086,4533,17542,13571,23295,17166,3427,15893,33059,16504,34046
ٽֵ,GuangRongJieDao,210212004,14157,2406,9322,6822,8398,8454,1543,7891,16345,8784,18106
ˮʦӪֵ,ShuiShiYingJieDao,210212005,28386,3116,17213,13162,18352,17022,4035,17730,34752,18324,35537
ֵ,LongWangTangJieDao,210212006,13212,1309,7498,5694,6466,6874,1704,7083,13957,8727,16225
ɽֵ,TieShanJieDao,210212007,22689,3021,13550,10771,14904,13301,2903,14079,27380,15063,28613
˫ֵ,ShuangDaoWanJieDao,210212009,11413,1690,7004,5342,8351,6884,1448,7094,13978,7547,14551
�ֵ,SanJianBaoJieDao,210212010,15825,2172,9804,7483,11794,9676,2243,10039,19715,10436,20240
ǽֵ,ChangChengJieDao,210212011,10772,1799,6818,5128,8771,6569,1253,6676,13245,7006,13824
ͷֵ,LongTouJieDao,210212012,26451,1596,17461,5458,10823,6625,1374,6960,13585,11960,29421
ֵ,BeiHaiJieDao,210212013,5563,918,3414,2679,4728,3337,685,3519,6856,3752,7166
˳ÿ,LvShunJingJiKaiFaQu,210212400,45062,2349,22316,9360,14307,11728,2553,12071,23799,27648,49964
ţ,DaLianNaiNiuChang,210212401,2144,489,1376,1250,1955,1338,179,1356,2694,1436,2812
ӵֵ,YongZhengJieDao,210213001,33079,3136,19923,13730,19739,17670,4442,17591,35261,20734,40657
ֵ,YouYiJieDao,210213002,32904,3936,21224,16006,23561,20751,4769,19912,40663,20385,41609
ֵ,GuangMingJieDao,210213003,45857,4941,30337,20185,34692,26791,6423,26010,52801,26884,57221
ӽֵ,MaQiaoZiJieDao,210213004,169636,5895,106066,44326,54888,53429,14604,50920,104349,84069,190135
ൺֵ,HaiQingDaoJieDao,210213005,59751,2841,35095,21961,21333,28173,8426,28402,56575,35923,71018
ɽֵ,DaGuShanJieDao,210213006,33665,2734,20072,16528,16436,19742,5087,19923,39665,21414,41486
гֵ,ZhongChangJieDao,210213007,25242,3619,16166,13304,21342,16089,3168,15773,31862,15863,32029
վǰֵ,ZhanQianJieDao,210213008,57003,5410,34655,27729,30222,32346,7678,33338,65684,35436,70091
Ƚֵ,XianJinJieDao,210213009,50991,5487,32223,24339,33355,31422,7892,31147,62569,32147,64370
ҹֵ,DongJiaGouJieDao,210213011,18786,2216,10791,8079,12861,10150,2318,10324,20474,12529,23320
ʯֵ̲,JinShiTanJieDao,210213012,27471,2043,16898,9288,13142,11472,3032,11587,23059,15648,32546
ֵ,WanLiJieDao,210213013,97344,4173,55505,33320,34070,40518,12285,41832,82350,58297,113802
ʮﱤֵ,ErShiLiPuJieDao,210213014,23919,3549,14671,11429,22248,13997,2747,14445,28442,15544,30215
ʮﱤֵ,SanShiLiPuJieDao,210213015,43708,6540,27613,22573,41737,26682,5292,27034,53716,27927,55540
׵ֵ,LiangJiaDianJieDao,210213016,20263,3745,12905,10646,21603,12808,2280,13101,25909,13383,26288
ɳӽֵ,DengShaHeJieDao,210213017,28813,4654,18408,13913,30167,18036,3458,17996,36032,18517,36925
ʯӽֵ,ShiHeJieDao,210213018,25771,3463,16169,12037,20500,15336,3283,15556,30892,16348,32517
κҽֵ,DaWeiJiaJieDao,210213019,20821,2991,12473,9038,18306,11826,2116,11810,23636,13455,25928
ֵ,XingShuJieDao,210213020,21114,3595,13552,10923,22087,13428,2616,13485,26913,13773,27325
߶ɽֵ,QiDingShanJieDao,210213021,15932,2574,9798,7274,15115,9269,1463,9467,18736,10171,19969
ҽֵ,HuaJiaJieDao,210213022,15407,2849,9730,7895,16170,9616,1556,9884,19500,10082,19812
Ӧֵ,XiangYingJieDao,210213023,11785,2076,7414,5767,12678,7318,1209,7507,14825,7656,15070
ҽֵ,DaLiJiaJieDao,210213024,14410,1963,9058,6647,12534,8918,1747,8835,17753,9062,18120
ʤֵ,DeShengJieDao,210213025,13344,1938,8043,5860,10546,7137,1498,7328,14465,8737,16780
ɽ,DaChangShanDaoZhen,210224100,23026,2931,14509,11026,21291,14350,3760,14505,28855,15208,29717
ӵ,ZhangZiDaoZhen,210224101,10435,1517,6851,5287,10008,6792,1856,6735,13527,6957,13808
Сɽ,XiaoChangShanXiang,210224201,12524,1362,7495,5437,9904,7299,2185,7657,14956,8576,16071
¹,GuangLuXiang,210224202,9221,1454,5931,4265,9037,5850,1774,6138,11988,6518,12449
,HaiYangXiang,210224203,4581,544,2865,2028,3696,2794,781,2794,5588,3041,5906
»ֵ´,XinHuaJieDaoBanShiChu,210281001,40733,7293,25646,21039,45843,25449,4748,26083,51532,27128,52774
ֵ´,WenLanJieDaoBanShiChu,210281002,58464,7481,37243,29376,57814,37174,8021,36645,73819,36723,73966
붫ֵ´,LingDongJieDaoBanShiChu,210281003,13880,1545,8355,4441,8682,5867,1156,5852,11719,8226,16581
ýֵ´,GongJiJieDaoBanShiChu,210281004,39456,5392,23289,18623,40880,23205,4642,22411,45616,26201,49490
ֵ´,TieDongJieDaoBanShiChu,210281005,27706,4641,17420,14669,29564,17383,2797,17680,35063,17724,35144
ףֵ´,ZhuHuaJieDaoBanShiChu,210281006,25801,3879,16258,11213,21890,16237,3444,16783,33020,16866,33124
ڵֵ´,GangDianJieDaoBanShiChu,210281007,23678,3015,14409,10096,19524,14157,3220,14783,28940,15504,29913
ֵ̫´,TaiYangJieDaoBanShiChu,210281008,19681,3395,12554,8721,22082,12196,2947,12942,25138,13469,26023
˵ֵ´,ChangXingDaoJieDaoBanShiChu,210281009,55835,4390,22763,16287,32751,20714,5697,22608,43322,43159,65922
ֵ´,JiuLongJieDaoBanShiChu,210281010,19670,3396,12651,9252,22874,12511,3009,13010,25521,13424,26075
�ֵ´,JiaoLiuDaoJieDaoBanShiChu,210281011,10797,2142,7253,4696,12625,7207,1743,7309,14516,7429,14682
ݳ,FuZhouChengZhen,210281101,39055,5500,25199,18051,44314,25160,6415,25675,50835,25771,50970
,FuZhouWanZhen,210281102,22217,4676,14546,11621,27232,14487,2505,14592,29079,14852,29398
,SongShuZhen,210281103,17744,4097,11814,9659,22655,11805,1904,11897,23702,11931,23745
,DeLiSiZhen,210281105,14621,2937,9385,7309,17818,9366,1838,9951,19317,10011,19396
,WanJiaLingZhen,210281106,18418,2921,11444,7300,23327,11439,2297,12188,23627,12192,23636
,XuTunZhen,210281107,20486,3794,13134,9610,25838,13129,2947,14077,27206,14093,27227
,YongNingZhen,210281108,23320,3946,15017,10539,29488,15013,3805,15877,30890,16054,31071
л,XieTunZhen,210281109,16934,3106,11197,8030,20458,11183,2417,11233,22416,11260,22457
̨,PaoTaiZhen,210281110,35250,5596,22518,15918,37531,21073,4743,21569,42642,23071,45589
ϻ,LaoHuTunZhen,210281112,18998,2519,13029,7736,19580,10667,2574,10996,21663,11062,24091
غ,HongYanHeZhen,210281113,11978,1929,7637,5144,13958,7567,1804,7638,15205,8074,15711
,LiGuanZhen,210281115,17875,3375,11497,8807,22392,11495,2491,12215,23710,12244,23741
ԡ,XianYuWanZhen,210281116,7505,1439,4861,3639,9580,4855,971,5035,9890,5054,9915
,ZhaoTunXiang,210281201,24641,3763,15844,11294,30392,15754,4251,16709,32463,16811,32655
,TuChengXiang,210281203,15196,2426,9829,6166,19533,9829,2450,10243,20072,10243,20072
ֵ,YanDianXiang,210281204,17168,2966,11360,7738,22456,11347,3172,11921,23268,11946,23306
,XiYangXiang,210281205,17571,3325,11608,8375,22678,11595,2731,11969,23564,12019,23627
ɽ,TuoShanXiang,210281206,13293,2633,8894,6719,16638,8883,2147,9131,18014,9179,18073
̨,SanTaiManZuXiang,210281208,17058,2739,11097,7043,20844,11084,2442,11085,22169,11142,22239
,PaoYaXiang,210281210,10508,2255,6934,5861,12972,6929,1440,7250,14179,7269,14203
,YangJiaManZuXiang,210281212,12947,2593,8499,6355,16185,8458,1841,8803,17261,8882,17381
ٽֵ,FengRongJieDao,210282001,91159,13073,59599,46316,95581,58620,13783,57386,116006,58416,118015
ֵ,TieXiJieDao,210282002,33113,4411,20559,15261,30124,19939,4433,20776,40715,21398,41957
̫ƽֵ,TaiPingJieDao,210282003,34507,4148,21296,15345,31031,20475,4931,20662,41137,22290,43586
ɽֵ,NanShanJieDao,210282004,14744,1807,9114,6361,12118,8618,1949,8757,17375,9386,18500
Ƥ,PiKouZhen,210282101,60642,9608,39651,27702,67880,38021,8572,37740,75761,39171,78822
̹,ChengZiTanZhen,210282102,46164,8073,29692,21265,57996,29476,5917,30262,59738,30462,60154
,DaLiuJiaZhen,210282104,9176,1931,6092,4804,10692,6013,1213,6017,12030,6228,12320
,YangShuFangZhen,210282105,23272,3247,14833,10659,22222,14299,3319,14501,28800,15005,29838
˫,ShuangTaZhen,210282106,22979,3560,14717,9958,29224,14714,3541,15359,30073,15363,30080
,AnBoZhen,210282107,26895,4582,17320,11810,34213,17036,3735,17592,34628,17892,35212
ƽ,SiPingZhen,210282108,17539,2779,10987,6648,22405,10987,2182,11510,22497,11513,22500
ɳ,ShaBaoZhen,210282109,19695,3393,12692,8099,25309,12691,2798,13187,25878,13194,25886
,WaWoZhen,210282110,14967,2626,9413,6392,18095,9368,1853,9815,19183,10033,19446
Ԫ̨,YuanTaiZhen,210282111,29811,4747,19003,13024,35448,18986,4246,19720,38706,19801,38804
̷,DaTanZhen,210282113,16001,3171,10547,7656,20720,10547,2481,11106,21653,11106,21653
к,JiaHeMiaoZhen,210282114,19321,3836,12653,8968,24042,12630,2639,13056,25686,13143,25796
ɽ,LianShanZhen,210282116,17606,3053,11538,8133,21519,11145,2806,11523,22668,11927,23465
̨,XingTaiZhen,210282117,31647,5883,20433,15414,40824,20381,4593,21609,41990,21690,42123
ī,MoPanXiang,210282206,13527,2732,8801,6539,17574,8800,1799,9242,18042,9257,18058
ͬ,TongYiXiang,210282208,13885,2556,8897,6144,17749,8894,1829,9351,18245,9373,18270
ּ,LeJiaManZuXiang,210282209,12782,2342,8167,5686,16193,8156,1621,8529,16685,8578,16745
ǹؽֵ,ChengGuanJieDao,210283001,50954,6448,33319,24429,46678,33184,7907,31670,64854,31990,65309
»ֵ,XinHuaJieDao,210283002,55827,5758,35446,23772,46718,32624,8369,31830,64454,34508,69954
˴ֵ,XingDaJieDao,210283003,32922,4240,21070,14709,28379,20363,4715,19776,40139,20807,41877
ʢֵ,ChangShengJieDao,210283004,10399,1772,6746,4654,11850,6738,1586,7001,13739,7011,13757
ֵ,MingYangJieDao,210283005,42435,6952,27262,18450,51579,26962,5599,27069,54031,27724,54986
,QingDuiZhen,210283101,36865,5808,24045,15561,43876,23379,5247,23127,46506,23875,47920
,XuLingZhen,210283102,22818,3727,14666,9620,25237,14638,3376,15145,29783,15255,29921
ڵ,HeiDaoZhen,210283104,23589,3920,15113,9589,28058,14889,3013,14999,29888,15409,30522
ӷ,LiZiFangZhen,210283105,35535,6530,23357,17114,44906,23321,4998,23569,46890,23706,47063
Ӫ,DaYingZhen,210283107,13208,2854,9071,6499,16953,9042,1999,8931,17973,8990,18061
,TaLingManZuZhen,210283108,14852,2721,9690,6691,18906,9683,2227,10069,19752,10110,19800
˶,XianRenDongZhen,210283109,20341,3821,13701,8609,26512,13697,3451,13844,27541,13912,27613
ػɽ,RongHuaShanZhen,210283110,25194,4115,16191,9545,32493,16180,3929,16988,33168,17047,33238
,ChangLingZhen,210283111,20172,3184,12853,7774,25973,12848,2909,13387,26235,13412,26265
ɻɽ,HeHuaShanZhen,210283112,7630,1459,5096,3446,9791,5093,1133,5102,10195,5126,10222
ɽ,ChengShanZhen,210283113,24204,4298,15532,10997,31448,15530,3383,16351,31881,16353,31885
ɽ,GuangMingShanZhen,210283114,38093,6259,24561,15463,47597,24550,5457,25202,49752,25248,49809
֣,DaZhengZhen,210283115,41561,6612,26659,16805,51097,25903,5266,26042,51945,26780,53439
¯,WuLuZhen,210283118,27859,4782,17835,10892,33129,17735,3718,18321,36056,18524,36359
,WangJiaZhen,210283120,4040,457,2413,1552,3616,2363,612,2402,4765,2696,5109
ɽ,AnZiShanXiang,210283204,32665,5368,20997,13870,40824,20824,4272,21147,41971,21308,42305
̫ƽ,TaiPingLingManZuXiang,210283208,15636,2451,9878,5842,19114,9854,2306,10337,20191,10515,20393
ɽ,BuYunShanXiang,210283209,13250,2096,8442,5639,16914,8429,2167,9034,17463,9071,17513
ƻ,GuiYunHuaManZuXiang,210283211,13330,2219,8442,5303,16949,8433,1767,8804,17237,8874,17316
,LanDianXiang,210283214,16590,2630,10520,6906,17212,10342,2129,10475,20817,10829,21349
ʯ,ShiChengXiang,210283216,7061,1194,4751,2828,8440,4733,1081,4525,9258,4585,9336
ֵ´,ChangDianJieDaoBanShiChu,210302001,30907,5488,19647,14574,32844,19594,2699,19267,38861,19447,39094
Žֵ´,JieFangJieDaoBanShiChu,210302002,33962,5823,21729,15723,33409,21336,2998,20644,41980,21054,42783
ɽϽֵ´,ShanNanJieDaoBanShiChu,210302003,34799,5858,22359,17363,35982,22261,3592,21728,43989,21890,44249
԰ֵֽ´,YuanLinJieDaoBanShiChu,210302004,31118,5988,21359,14247,35496,20363,4065,19172,39535,19812,41171
ʤֵ´,ShengLiJieDaoBanShiChu,210302005,26049,4375,17257,10210,30446,16569,3358,15686,32255,16525,33782
վǰֵ´,ZhanQianJieDaoBanShiChu,210302006,12758,1831,8091,5675,12373,7408,1448,7247,14655,7946,16037
ֳǽֵ´,GangChengJieDaoBanShiChu,210302007,23814,3999,15705,11102,25321,15423,2885,14706,30129,14993,30698
ƽֵ´,HePingJieDaoBanShiChu,210302008,30315,5510,19264,12760,31770,18431,3149,17863,36294,19710,38974
¯ֵ´,DuiLuJieDaoBanShiChu,210302009,34675,6664,22271,16146,36444,21853,3111,21170,43023,22179,44450
ֵ´,DongChangDianJieDaoBanShiChu,210302010,37077,5804,24665,14960,33694,19640,2821,19248,38888,21037,45702
Ͻֵ´,HuNanJieDaoBanShiChu,210302011,45835,7676,30286,20733,47148,30176,5670,28760,58936,28895,59181
ֵ´,ChangQingJieDaoBanShiChu,210302012,21194,4238,14147,10238,24005,14108,2123,13356,27464,13408,27555
˽ֵ´,XinXingJieDaoBanShiChu,210302013,35012,2897,20615,13475,15413,19165,4544,18544,37709,21838,42453
ɽ羰ίԱ,YuFoShanFengJingQuGuanLiWeiYuanHui,210302400,19,1,1,0,0,0,0,0,0,19,20
,GaoXinQuDongQu,210302401,37972,2036,18609,8973,19946,12443,3127,11930,24373,24526,43135
ֵ´,QiMingJieDaoBanShiChu,210303001,8369,1483,5241,4287,9273,5223,664,5153,10376,5275,10516
ٽֵ´,FanRongJieDaoBanShiChu,210303002,24657,3122,15410,11670,23265,15387,2786,15013,30400,15155,30565
˼ӽֵ´,BaJiaZiJieDaoBanShiChu,210303003,18550,2735,11267,9178,20672,11267,1517,11401,22668,11535,22802
ʢֵ´,XingShengJieDaoBanShiChu,210303004,22243,3225,13903,10895,20878,13830,2157,13596,27426,13722,27625
ͽֵ´,GongHeJieDaoBanShiChu,210303005,27421,4775,17170,13733,28315,17159,2444,17419,34578,17470,34640
ֵֽ´,YongLeJieDaoBanShiChu,210303006,40926,6582,25270,20442,41130,25259,3689,25706,50965,25927,51197
չٽֵ´,BeiTaoGuanJieDaoBanShiChu,210303007,18147,4058,11819,9610,21458,11819,1531,11911,23730,11917,23736
ϻֵ´,NanHuaJieDaoBanShiChu,210303008,19635,3253,12327,10140,17871,12277,1774,12241,24518,12335,24662
½ֵ´,DaLuJieDaoBanShiChu,210303009,18520,2496,11532,9112,18417,11492,2043,11432,22924,11527,23059
չٽֵ´,XinTaoGuanJieDaoBanShiChu,210303010,17422,2858,11101,8845,17571,11070,1763,10906,21976,10942,22043
,GaoXinQuXiQu,210303401,9006,1072,5562,4377,5534,5461,1091,5449,10910,5607,11169
Ѻýֵ´,YouHaoJieDaoBanShiChu,210304001,49072,7830,31098,23560,49199,30974,5251,30301,61275,31055,62153
˫ɽֵ´,ShuangShanJieDaoBanShiChu,210304004,51307,8898,32540,24832,53720,32347,4803,31708,64055,32468,65008
ɽֵ´,LiShanJieDaoBanShiChu,210304006,46311,7908,29063,22561,44340,28980,4221,29256,58236,29377,58440
ֵ´,ShuGuangJieDaoBanShiChu,210304008,44773,6825,27628,22329,41804,27612,4131,28080,55692,28101,55729
ɽֵ´,LingShanJieDaoBanShiChu,210304009,22158,4450,13843,10999,23570,13840,2132,14056,27896,14897,28740
Ͻֵ´,ShenNanJieDaoBanShiChu,210304013,31634,7467,20921,16005,36889,20867,2692,20606,41473,20872,41793
ֵ´,ShenBeiJieDaoBanShiChu,210304014,50631,8418,30612,24562,55440,30543,3849,32162,62705,32286,62898
ɳӽֵ´,ShaHeJieDaoBanShiChu,210304015,33453,5746,21152,16450,29124,21137,3200,21226,42363,21247,42399
ɳ,ShaHeZhen,210304100,8377,976,5010,3857,6293,5002,1007,5311,10313,5350,10360
ǧɽ羰,QianShanFengJingQu,210304402,7505,1336,4814,3218,7729,4600,978,4676,9276,5005,9819
ɱֵ,JiuBaoJieDao,210311001,13433,2615,8546,6734,15362,8514,1329,8746,17260,8831,17377
ɽֵ,DaGuShanJieDao,210311002,16100,3093,10267,8215,17627,10232,1536,10440,20672,10462,20729
ɽ,DongAnShanZhen,210311101,23929,2792,14819,10255,16420,14478,3454,15032,29510,15356,30175
Ƽҷ,TangJiaFangZhen,210311102,15393,2360,9763,6672,16009,9746,2305,10219,19965,10295,20058
ɽ,DaGuShanZhen,210311103,13640,2049,8540,5836,11424,8440,1821,8836,17276,8970,17510
ǧɽ,QianShanZhen,210311104,15587,2692,9539,7284,15238,9508,1642,9855,19363,10382,19921
ɽ,QiDaShanZhen,210311105,21434,3609,13553,10894,20048,13542,2350,13793,27335,13840,27393
,DaDaoWanZhen,210311106,36107,3686,22432,16419,26489,21928,5049,21868,43796,22410,44842
Զ,NingYuanZhen,210311107,45701,4142,27272,20589,30603,27203,7196,29184,56387,29767,57039
,TangGangZiZhen,210311108,11447,1901,7234,5202,12139,7211,1584,7550,14761,7698,14932
幤ҵ԰ίԱ,DaDaoWanGongYeYuanQuGuanLiWeiYuanHui,210311403,5400,1,3750,2,7,3,70,6,9,1721,5471
,TangGangZiMuChang,210311405,0,0,0,0,0,0,0,0,0,0,0
̨,TaiAnZhen,210321100,67145,8119,42815,31649,67775,42155,10981,42653,84808,43430,86245
,XiFoZhen,210321101,20362,2353,13200,7785,25630,13193,4145,13590,26783,13660,26860
¿,XinKaiHeZhen,210321102,19711,2744,12891,8767,25327,12882,3612,13108,25990,13176,26067
ɳ,HuangShaTuoZhen,210321103,30614,4101,19736,12953,39629,19715,6222,21092,40807,21201,40937
,GaoLiFangZhen,210321104,26837,3272,17279,11410,34221,17256,5525,18307,35563,18355,35634
ɣ,SangLinZhen,210321105,16613,2166,10966,7013,20866,10960,3284,11040,22000,11097,22063
,FuJiaZhen,210321106,11359,1549,7342,4824,14433,7342,2050,7614,14956,7616,14958
ţ,DaNiuZhen,210321107,17301,2335,11120,7080,22361,11116,3328,11795,22911,11844,22964
̨ؾ²̨,TaiAnXianJiuCaiTaiZhen,210321109,9966,1257,6505,4370,12902,6493,2267,6945,13438,6985,13490
̨,XinTaiZhen,210321110,12113,1507,8056,4805,15764,8056,2501,8065,16121,8065,16121
,HuanDongZhen,210321111,10215,1389,6635,4494,12728,6631,2072,6987,13618,7041,13676
»ũ,XinHuaNongChang,210321400,4007,484,2556,1558,5165,2555,746,2673,5228,2681,5237
ũ,HongJiaNongMuChang,210321401,3583,495,2354,1490,4620,2347,694,2395,4742,2418,4772
ƽֳ,XiPingLinChang,210321402,2646,381,1749,1204,3314,1748,491,1757,3505,1769,3518
,XiuYanZhen,210323100,105948,13820,69941,41152,123938,64504,19625,64230,128734,69452,139393
,SanJiaZiZhen,210323101,10896,1643,7052,4658,13533,7046,2296,7735,14781,7783,14835
ʯ,ShiMiaoZiZhen,210323102,11552,1524,7309,4644,14421,7308,2301,8046,15354,8068,15377
ƻ,HuangHuaDianZhen,210323103,17603,2142,11245,6261,21622,11232,3425,11876,23108,11925,23170
Ӫ,DaYingZiZhen,210323104,15575,2129,10024,5991,19927,10021,2969,10622,20643,10649,20673
ӹ,SuZiGouZhen,210323105,9378,1254,6146,3493,12003,6142,1914,6380,12522,6400,12546
ƫ,PianLingZhen,210323106,19820,2188,13060,7773,23534,13058,5086,13959,27017,14034,27094
ﱮ,HaDaBeiZhen,210323107,20300,2621,13309,7247,25460,13293,4894,14469,27762,14506,27815
µ,XinDianZhen,210323108,15570,2036,10415,6005,19590,10415,3593,10755,21170,10784,21199
,YangHeZhen,210323109,11882,1805,7788,4471,15423,7787,2236,8118,15905,8135,15923
ұ,YangJiaBaoZhen,210323111,8851,1349,5772,3525,11081,5769,1742,6140,11909,6170,11942
,TangGouZhen,210323112,9004,1537,5967,4046,11952,5963,1942,6443,12406,6516,12483
ʯҤ,ShiHuiYaoZhen,210323113,14175,2153,9471,5327,18170,9459,3567,10304,19763,10424,19895
ǰӪ,QianYingZiZhen,210323114,13481,2165,9107,5518,16984,9104,3026,9558,18662,9565,18672
̶,LongTanZhen,210323115,11018,1721,7258,4515,14356,7254,2334,7794,15048,7815,15073
ţ,MuNiuXiang,210323201,10671,1531,6832,4201,13286,6826,2324,7651,14477,7694,14526
²˹,JiuCaiGouXiang,210323202,7653,1164,5053,3221,10008,5052,1729,5474,10526,5493,10546
,DaFangShenXiang,210323204,8846,1335,5748,3643,11031,5747,1914,6320,12067,6347,12095
,ZhaoYangXiang,210323205,9491,1507,6245,4022,12528,6242,2032,6750,12992,6785,13030
Ӫ,HongQiYingZiXiang,210323206,9905,1533,6590,4021,12418,6586,1989,6820,13406,6837,13427
빵,LingGouXiang,210323211,5757,953,3801,2574,7452,3792,1044,3917,7709,3953,7754
Ӻ,ShaoZiHeXiang,210323212,5703,1087,3792,2646,7704,3786,1123,4101,7887,4121,7913
ݽֵ´,HaiZhouJieDaoBanShiChu,210381001,147576,16590,91646,73217,154077,91305,20975,93135,184440,93495,185141
˺ֵ´,XingHaiJieDaoBanShiChu,210381002,76327,8093,46589,34189,78743,46520,12381,47650,94170,50212,96801
ýֵ´,XiangTangJieDaoBanShiChu,210381003,30278,2997,18837,12766,25895,18509,5443,19205,37714,19881,38718
Ľֵ´,DongSiJieDaoBanShiChu,210381004,21542,2474,14155,8306,26076,14094,4572,14192,28286,14433,28588
ɽ,GuShanZhen,210381101,15383,2536,9955,6054,20186,9946,3142,11070,21016,11106,21061
�,ChaGouZhen,210381102,15720,2610,10311,6985,20560,10311,3285,11264,21575,11304,21615
,JieWenZhen,210381103,16245,2422,10834,6716,21290,10681,3780,11500,22181,11613,22447
ľ,XiMuZhen,210381104,26648,3447,17676,9902,32316,16811,5648,17230,34041,18067,35743
,MaFengZhen,210381105,23040,3077,15051,9251,29478,15044,5126,16145,31189,16192,31243
¥,PaiLouZhen,210381107,25823,3129,16916,10266,28441,16833,5331,17269,34102,17367,34283
,BaLiZhen,210381108,31860,3954,20527,12566,36826,20495,5719,20906,41401,21006,41533
ë,MaoQiZhen,210381109,15336,2220,9807,6606,16406,9692,2881,10401,20093,10630,20437
Ӣ,YingLuoZhen,210381110,34376,4351,22136,13177,41799,21710,6784,22600,44310,23375,45511
,GanWangZhen,210381111,34253,4238,22121,13442,39877,21840,6973,22913,44753,23343,45464
,XiLiuZhen,210381112,57461,4135,35560,21984,42097,33969,11039,35111,69080,37075,72635
С,ZhongXiaoZhen,210381113,17635,2265,11412,7009,21214,11304,3892,12175,23479,12380,23792
ʯ,WangShiZhen,210381114,32425,4466,21293,13023,37519,21283,6570,22110,43393,22168,43461
̨,NanTaiZhen,210381115,46752,5372,29539,19135,47381,28307,9218,30272,58579,31803,61342
Ȫ,GanQuanZhen,210381116,19696,2651,12962,8315,24144,12941,3693,13020,25961,13078,26040
,DaTunZhen,210381117,27117,3463,17442,11161,27959,17393,4518,17590,34983,17656,35098
,TengAoZhen,210381118,82336,8920,50510,35850,87807,49736,13986,52943,102679,54732,105242
ׯ,GengZhuangZhen,210381121,33133,4470,21509,13519,41192,21437,6196,22030,43467,22290,43799
ţׯ,NiuZhuangZhen,210381123,35621,4607,22876,14582,44137,22441,6294,23185,45626,23646,46522
,XiSiZhen,210381124,20490,2462,13024,7990,26445,13006,4258,14150,27156,14186,27210
̨,WangTaiZhen,210381125,17173,2427,11108,7681,21653,11036,3417,11816,22852,11909,23017
,WenXiangZhen,210381126,35715,3783,23065,13280,44753,23058,6814,23211,46269,23247,46312
,GaoTuoZhen,210381127,13936,1616,8773,5309,16944,8726,2586,9291,18017,9365,18138
Ǿÿ,HaiChengJingJiKaiFaQu,210381400,40750,4252,26034,16496,35621,24483,7682,25211,49694,26650,52684
վǰֵ,ZhanQianJieDao,210402001,37490,6617,24719,18447,42186,24596,4083,23254,47850,23471,48190
԰ֵ,DongGongYuanJieDao,210402003,25004,4575,16611,12347,29202,16547,2813,15726,32273,15781,32392
ֵ,FuMinJieDao,210402005,31829,4270,19576,15100,33495,19477,2627,18880,38357,19150,38726
¸ֵ,XinFuJieDao,210402007,27245,3391,16929,12737,30182,16877,2597,16249,33126,16304,33233
ֵֽ,YuLinJieDao,210402009,8247,1221,5100,3896,8764,5048,851,5098,10146,5219,10319
ֵ̨,YongAnTaiJieDao,210402011,28181,5872,19994,13239,37615,19989,4919,18919,38908,18978,38972
ǧֵ,QianJinJieDao,210402013,19369,2703,12055,8951,21758,12022,1817,11613,23635,11834,23889
ֵ,NanYangJieDao,210402015,21603,2809,13608,10122,23069,13536,2498,13255,26791,13302,26910
޽ֵ,DongZhouJieDao,210403002,51064,9008,31869,23811,58572,31028,4712,30414,61442,32915,64784
ŵֵ,ZhangDianJieDao,210403003,2433,307,1325,1230,2419,1310,94,1376,2686,1509,2834
ֵ,DaLianJieDao,210403004,19365,2891,11702,9048,22325,11698,1595,12131,23829,12149,23851
ֵ,LongFengJieDao,210403005,33738,5799,20886,18310,38944,20869,2466,21080,41949,21117,42003
ͽֵ,XinTunJieDao,210403006,27918,5437,17232,13908,30946,17029,1676,17428,34457,17799,35031
½ֵ,WanXinJieDao,210403007,20199,3424,12668,10866,22978,12658,1314,12258,24916,12269,24937
ϻֵ̨,LaoHuTaiJieDao,210403008,19839,3704,12439,10984,22891,12405,1439,12521,24926,12543,24982
ƽɽֵ,PingShanJieDao,210403009,11685,2375,7366,6510,14537,7349,846,7507,14856,7540,14906
ϻ԰ֵ,NanHuaYuanJieDao,210403010,6997,1417,4494,4086,8344,4488,536,4448,8936,4456,8950
ɽֵ,LiuShanJieDao,210403011,17912,3612,11392,10166,19489,11360,1508,11596,22956,11640,23032
µֵ,ZhangDangJieDao,210403012,18757,3717,12292,9851,20787,12274,2046,12161,24435,12228,24520
ֵ,FuDongJieDao,210403013,4818,1199,3196,2638,6185,3151,484,3177,6328,3305,6501
ǧ,QianJinXiang,210403201,11637,1428,7134,5165,12096,7131,1689,7595,14726,7620,14754
,NianPanXiang,210403202,7947,905,4553,3447,7653,4521,1012,4872,9393,5311,9864
ͽֵ,TianTunJieDao,210404001,7109,1373,4479,3673,7446,4479,693,4682,9161,4696,9175
ũֵ,GongNongJieDao,210404002,22453,3822,13961,11291,24510,13959,2087,14400,28359,14401,28362
ֵ,JianSheJieDao,210404003,51629,5280,27529,15556,40217,20690,3447,20687,41377,32827,60356
ƽֵ,HePingJieDao,210404004,39195,5948,24089,17926,40924,23941,4547,23163,47104,25601,49690
ֵ,GuangMingJieDao,210404005,15968,3101,10512,8040,18878,10473,1810,10312,20785,10367,20879
ͽֵ,PuTunJieDao,210404006,33663,4730,20486,16020,37839,20435,2685,20473,40908,20592,41078
ֵ,YanWuJieDao,210404007,3957,740,2461,2230,3679,2434,365,2587,5021,2601,5062
ͽֵ,WuLaoTunJieDao,210404008,18893,3575,11761,10339,18740,11761,1453,12160,23921,12160,23921
ųӽֵ,GuChengZiJieDao,210404009,17754,3215,11189,9746,18127,11188,1387,11162,22350,11167,22356
ֵ,XinMinJieDao,210404010,25885,5004,16836,13234,28471,16806,2632,16633,33439,16685,33521
ʯֵ,LiShiJieDao,210404011,61310,5801,35957,25335,48159,32545,6811,32672,65217,37965,73922
,TaYuZhen,210404101,12893,1606,7913,5743,13414,7900,1693,8194,16094,8279,16192
Ӷֵ,HeDongJieDao,210411001,34928,4038,19813,14064,28196,18651,4020,18079,36730,23173,42986
ֵ,ChangChunJieDao,210411002,58373,7145,37403,26764,48916,35481,7252,34611,70092,35367,72770
𲼽ֵ,GeBuJieDao,210411003,54518,8973,34390,28220,55134,34324,4605,33615,67939,33706,68096
ֵ,JiangJunBaoJieDao,210411004,81434,13127,51806,38821,87094,51578,7819,50126,101704,50574,102380
»ֵ,XinHuaJieDao,210411005,43535,7041,29028,21542,46498,28867,6467,27621,56488,28015,57043
˳ǽֵ,FuShunChengJieDao,210411007,51331,9003,33448,25585,50425,33144,5319,31836,64980,32205,65653
ǰ,QianDianZhen,210411102,20432,2699,12556,10167,13683,12493,2441,12897,25390,13016,25572
ӱ,HeBeiXiang,210411201,19028,2411,11595,8832,16310,11509,2526,12255,23764,12370,23965
Ԫ,HuiYuanXiang,210411205,11326,1477,6995,4921,12485,6967,1652,7350,14317,7460,14455
ʯ,ShiWenZhen,210421101,17329,1929,10890,7259,18683,10186,2718,10497,20683,11086,21976
,HouAnZhen,210421102,12201,1494,7507,5270,14707,7450,1974,8018,15468,8162,15669
µ,ZhangDangZhen,210421103,17288,2469,10584,8159,18203,10492,2208,11253,21745,11381,21965
,HaDaZhen,210421104,14400,1878,8990,6228,17663,8984,2183,9447,18431,9471,18461
Ȧ,MaQuanZiXiang,210421204,3618,437,2292,1683,4423,2282,643,2378,4660,2406,4698
,ShangMaXiang,210421205,13350,1793,8285,5939,16174,8269,2095,8909,17178,8953,17238
ȱ,JiuBingXiang,210421207,14045,1661,8721,6074,16979,8697,2508,9400,18097,9493,18214
Ͽ,XiaHeXiang,210421209,5824,793,3694,2651,7235,3691,1056,3965,7656,3979,7673
,HaiLangXiang,210421211,8352,1178,5124,3892,9711,5121,1159,5540,10661,5565,10689
,LaGuManZuXiang,210421212,11375,1448,7102,5309,13428,7096,1830,7533,14629,7551,14653
ɽ,LanShanXiang,210421215,3971,505,2463,1682,4664,2460,613,2612,5072,2626,5089
ͼ,TangTuManZuXiang,210421216,4727,710,3012,2087,5874,3007,826,3214,6221,3251,6263
±,XinBinZhen,210422100,50912,5524,31777,23275,54236,30676,6902,30370,61046,31561,63338
,WangQingMenZhen,210422101,9188,833,5494,3947,9839,5491,1341,5853,11344,5868,11362
,YongLingZhen,210422102,26404,3026,16663,11615,30989,16618,4281,16885,33503,17048,33711
ƽɽ,PingDingShanZhen,210422103,11983,1154,7415,4487,14482,7415,2026,7744,15159,7748,15163
ƽ,DaSiPingZhen,210422104,12443,1281,7821,5202,14696,7805,2235,8031,15836,8138,15959
έ,WeiZiYuZhen,210422105,10490,1079,6519,4224,12305,6506,1858,6864,13370,6908,13427
ľ,MuQiZhen,210422106,11753,1680,7602,5729,14205,7576,1984,7686,15262,7815,15417
ϼк,ShangJiaHeZhen,210422108,11062,1477,6910,4968,13586,6904,1839,7422,14326,7468,14378
ľ,NanZaMuZhen,210422109,15859,1732,9868,7675,15855,9798,2568,10103,19901,10291,20159
,HongShengXiang,210422202,5296,521,3142,2160,5503,3139,703,3342,6481,3378,6520
ˮ,XiangShuiHeZiXiang,210422203,5034,558,3126,2232,5846,3123,811,3265,6388,3277,6403
,HongMiaoZiXiang,210422204,9378,918,5646,3930,10736,5644,1440,6072,11716,6090,11736
ƽ,BeiSiPingXiang,210422205,5822,561,3670,2385,7022,3669,1096,3800,7469,3809,7479
,YuShuXiang,210422207,8730,971,5414,3491,10511,5414,1550,5837,11251,5837,11251
¼к,XiaJiaHeXiang,210422208,6060,713,3759,2560,7426,3759,1042,4045,7804,4056,7815
ԭ,QingYuanZhen,210423100,73153,8398,46225,35413,74058,45844,10650,45615,91459,45976,92201
͸ɽ,HongTouShanZhen,210423101,20202,2895,12719,9683,23316,12669,2550,12848,25517,12928,25647
,CaoShiZhen,210423103,10204,1067,6299,4306,12232,6292,1855,6789,13081,6827,13126
Ӣ,YingEMenZhen,210423104,10791,1208,6813,4706,13173,6811,1860,7016,13827,7046,13859
Ͽǰ,NanKouQianZhen,210423105,14936,2090,9394,7398,18544,9388,2552,10150,19538,10184,19578
ɽ,NanShanChengZhen,210423106,19088,1895,11902,7842,23197,11879,3266,12299,24178,12347,24249
,WanDianZiZhen,210423107,10433,1228,6523,4678,12720,6516,1688,6806,13322,6826,13349
¼,DaGuJiaZhen,210423108,13063,1177,7954,5093,15550,7952,2092,8339,16291,8378,16332
ļұ,XiaJiaBaoZhen,210423109,19769,2048,12243,8334,24910,12231,3617,13133,25364,13191,25434
,TuKouZiXiang,210423203,9959,895,6063,3975,11768,6049,1669,6418,12467,6460,12523
,BeiSanJiaXiang,210423204,9252,1118,5757,4104,11003,5754,1539,6117,11871,6152,11909
ұ,AoJiaBaoXiang,210423206,6568,808,4152,2555,8155,4142,1143,4301,8443,4367,8519
պ,DaSuHeXiang,210423207,5633,742,3568,2441,7032,3568,1014,3786,7354,3821,7389
˵,GouNaiDianXiang,210423208,4870,543,2888,2014,5660,2871,842,3134,6005,3367,6255
ϵؽֵ,NanDiJieDao,210502001,38081,4416,22897,16272,34735,22350,3849,22506,44856,23449,46346
˽ֵ,GongRenJieDao,210502002,36535,4766,22391,16705,32078,22038,4101,22129,44167,23011,45402
ƽɽֵ,PingShanJieDao,210502003,41174,6473,26599,18877,45735,26436,5216,25962,52398,26264,52863
ֵ,DongMingJieDao,210502004,34169,5953,22298,15552,38152,21718,4144,20899,42617,21968,44266
޶ֵ,CuiDongJieDao,210502005,43051,6245,27430,19934,49720,27267,5132,26671,53938,26998,54428
վǰֵ,ZhanQianJieDao,210502007,12980,1908,8306,5991,13164,8027,1429,7649,15676,8011,16317
ǧֵ,QianJinJieDao,210502008,33816,5421,20992,16933,31922,20927,3120,21057,41984,21365,42357
ֵ̨´,BeiTaiJieDaoBanShiChu,210502010,23769,2477,13776,11163,20644,13629,3344,14055,27684,15814,29590
ͷֵ´,QiaoTouJieDaoBanShiChu,210502011,13472,2374,8447,6238,15212,8400,1715,8687,17087,9114,17561
Ӷֵ,HeDongJieDao,210503001,36151,5196,21790,16998,32491,21566,3398,21150,42716,22955,44745
ֵ,HeXiJieDao,210503003,15908,3143,10084,8600,17481,10082,1172,10122,20204,10139,20223
ͽֵ,CaiTunJieDao,210503005,32922,5191,20711,15958,31643,20130,3205,20180,40310,20607,41318
ֵ,ShuJingJieDao,210503006,16934,3259,10691,9453,17487,10613,1494,10745,21358,10996,21687
ʱֵ,CaiBeiJieDao,210503007,21899,3569,13761,11603,18810,13761,2026,13728,27489,13733,27494
ֵ´,DongFengJieDaoBanShiChu,210503009,9280,1389,5550,4246,8113,5498,1067,5629,11127,6186,11736
ʯӽֵ´,ShiQiaoZiJieDaoBanShiChu,210503010,32981,2564,16150,7594,19976,10649,2464,10589,21238,21859,38009
կ,HuoLianZhaiZhen,210503101,9958,1728,5787,4597,9879,5652,1090,5824,11476,6989,12776
ͷɽ,WaiTouShanZhen,210503102,20228,2418,11128,7930,19143,10522,2041,10428,20950,13559,24687
կ,ZhangQiZhaiXiang,210503201,7923,1045,4839,3043,9226,4784,1028,4993,9777,5157,9996
ɽֵ,JinShanJieDao,210504001,54851,8041,35527,24818,49767,35062,7557,34120,69182,34922,70449
ؽֵ,BeiDiJieDao,210504002,35499,5615,23045,15723,38037,21732,4655,20668,42400,22724,45769
ֵ,GaoYuJieDao,210504004,32059,3681,19335,14318,19715,18200,3400,17814,36014,19805,39140
ɽֵ,MingShanJieDao,210504005,80850,7782,48911,32493,72799,47640,9644,46004,93644,49365,98276
˽ֵ,DongXingJieDao,210504007,39264,7258,25110,19663,35045,24904,3747,24078,48982,25159,50269
ֵ,XinMingJieDao,210504008,35431,4691,22279,15838,25574,21198,3879,20508,41706,21722,44001
ţֵ̨,NiuXinTaiJieDao,210504009,13459,2030,8398,6580,14858,8393,1693,8709,17102,8784,17182
ֵ,WoLongJieDao,210504010,19299,3252,12162,8623,18607,12070,2534,12500,24570,12923,25085
̨,GaoTaiZiZhen,210504101,15213,2058,9419,6542,15155,9316,2134,9703,19019,9986,19405
Ϸҽֵ,NanFenJieDao,210505001,22884,3688,14593,12235,25602,14359,2561,14241,28600,14540,29133
ɽֵ,TieShanJieDao,210505002,13107,2021,8271,6491,15551,8271,1176,8009,16280,8033,16304
ҽֵ,GuoJiaJieDao,210505003,10019,1474,5979,4016,9057,5528,996,5737,11265,6510,12489
,XiaMaTangZhen,210505101,10279,1552,6346,3833,11891,6013,1308,6300,12313,6793,13139
˼ɽ,SiShanLingManZuXiang,210505202,9456,1208,5797,3659,11096,5713,1188,5942,11655,6055,11852
ֵ,GuanYinGeJieDao,210521001,75170,7020,46731,33689,74881,45285,11312,44975,90260,46771,93502
С,XiaoShiZhen,210521100,24529,2981,14848,9723,26760,14835,3224,15794,30629,15886,30734
ݺ,CaoHeZhangZhen,210521101,8518,1084,5260,2998,10060,5212,1225,5426,10638,5567,10827
ݺӳ,CaoHeChengZhen,210521102,9379,1377,5884,3902,11309,5870,1389,6217,12087,6261,12145
ݺӿ,CaoHeKouZhen,210521103,18069,2660,11011,7852,20277,10838,2072,11128,21966,11790,22801
ɽ,LianShanGuanZhen,210521104,10054,1678,6270,4210,12339,6263,1389,6739,13002,6851,13121
ӳ,QingHeChengZhen,210521106,9135,1114,5584,3519,10842,5569,1413,6009,11578,6078,11662
ʦ,TianShiFuZhen,210521109,21992,3002,13362,9606,23831,13314,2813,13891,27205,14445,27807
ϵ,NanDianZhen,210521110,10611,1219,6489,4585,11843,6461,1585,6894,13355,6926,13415
,JianChangZhen,210521111,20584,2023,12598,7373,23308,12498,3514,13386,25884,13523,26121
߹,GaoGuanZhen,210521112,16845,2320,10179,6473,18925,10034,2543,10765,20799,11529,21708
Ӫ,DongYingFangXiang,210521202,10093,921,5919,3231,10546,5310,1361,5916,11226,6456,12375
Գǽֵ´,BaGuaChengJieDaoBanShiChu,210522001,51795,5122,32407,22712,49572,32060,7294,31148,63208,31804,64211
,HuanRenZhen,210522100,39873,3349,23123,13437,39819,21663,4984,22183,43846,25083,48206
ֱ,PuLeBaoZhen,210522101,11831,1087,6331,3906,12875,6233,1389,6816,13049,7976,14307
,ErPengDianZiZhen,210522102,18366,2329,11300,7493,22206,11285,2185,11542,22827,11580,22880
ɳ,ShaJianZiZhen,210522103,13694,1553,8229,4931,16823,8229,1811,8829,17058,8829,17058
,WuLiDianZiZhen,210522104,8768,1131,5151,2865,10730,5148,963,5702,10850,5711,10862
,BaLiDianZiZhen,210522108,13874,1377,8491,5312,16805,8461,2054,8715,17176,8814,17305
,HuaLaiZhen,210522110,39123,3711,22855,12670,44576,22661,5165,23592,46253,25144,47999
ų,GuChengZhen,210522111,21639,1925,11971,7057,23976,11864,2339,12402,24266,13932,25903
źӳ,YaHeChaoXianZuXiang,210522201,16389,1388,9119,5664,17727,9032,2118,9245,18277,10776,19895
,XiangYangXiang,210522202,7829,837,4410,2713,8831,4343,1161,4624,8967,5417,9827
ڹ,HeiGouXiang,210522206,11180,1019,5934,3659,11614,5833,1270,6189,12022,7535,13469
,BeiDianZiXiang,210522208,5871,472,3475,2076,6456,3351,761,3490,6841,3629,7104
ڽֵ,LiuDaoKouJieDao,210602001,25343,4207,16250,11276,21731,16124,2485,15070,31194,15785,32035
ߵֵ,QiDaoJieDao,210602002,32629,5570,20851,16064,31770,20679,3030,20120,40799,20378,41229
˵ֵ,BaDaoJieDao,210602003,19677,3526,12812,9688,19754,12742,1897,12209,24951,12288,25100
ŵֵ,JiuDaoJieDao,210602004,16839,2686,10370,8419,15273,10318,1443,10474,20792,10598,20968
ýֵ,GuangJiJieDao,210602005,19126,3178,12365,9346,17480,12175,1602,11389,23564,11541,23906
˶ֵ,XingDongJieDao,210602006,27789,3883,18006,13406,21172,17922,3223,16812,34734,16889,34895
ɽ,JinShanZhen,210602101,31400,3101,19259,11003,24391,14966,3271,15251,30217,18513,37772
ͷŽֵ,TouDaoQiaoJieDao,210603001,39765,6479,23616,17460,38706,22853,3663,21438,44291,26291,49907
վǰֵ,ZhanQianJieDao,210603002,25346,4835,17430,12400,26863,16993,3127,15529,32522,15878,33308
ٽֵ,LinJiangJieDao,210603003,44435,7066,28728,21161,42764,28417,4867,27313,55730,27640,56368
ֵ,LiuDaoGouJieDao,210603004,31497,5742,20751,15518,29756,20519,3167,19418,39937,19655,40406
ñɽֵ,MaoKuiShanJieDao,210603005,36726,5173,22995,15596,30809,21398,4517,20559,41957,23421,46416
άֵ,XianWeiJieDao,210603006,33039,6544,22057,16006,32407,21393,3268,20381,41774,20794,42851
ֵ,YongChangJieDao,210603007,34248,5530,22121,15274,33569,21069,3867,20056,41125,21524,43645
԰ֵ,HuaYuanJieDao,210603008,27400,4194,16767,12805,25294,16520,2729,16921,33441,17556,34323
ֵ,JiangHaiJieDao,210603009,10044,1046,5818,3841,9219,5673,1381,5754,11427,6653,12471
ǽֵ´,XiChengJieDaoBanShiChu,210603010,27312,4278,16746,11040,22219,15158,2910,15099,30257,17754,34500
ͷ,LangTouZhen,210603101,29747,3122,17498,10009,22267,13950,3003,13799,27749,18374,35872
,AnMinZhen,210603102,9505,1186,5985,3916,9645,5964,1390,5994,11958,6096,12081
,TangChiZhen,210603103,19098,2290,11891,7436,19993,11867,2807,12041,23908,12304,24195
Ѽֵ̽,YaLuJiangJieDao,210604001,29399,4076,19357,12916,23529,16434,3216,16320,32754,17334,36691
ֵ,JinKuangJieDao,210604003,3448,644,2243,1861,3633,2243,410,2254,4497,2259,4502
ֵ,ZhenZhuJieDao,210604004,18776,2580,12081,9098,12248,11311,1956,10767,22078,11231,23312
̫ƽֵ,TaiPingWanJieDao,210604005,8525,1349,5316,3881,9631,5116,974,5218,10334,5532,10848
ͬ,TongXingZhen,210604102,15529,1998,9180,6671,12774,9070,1959,9481,18551,10306,19486
,WuLongBeiZhen,210604104,22508,3992,14616,10985,23971,13361,2477,13596,26957,14361,28977
¥,LouFangZhen,210604105,12273,1734,7749,5111,14001,7698,1819,7963,15661,8077,15826
,JiuLianChengZhen,210604106,20782,2630,12988,9091,21438,12914,3035,13206,26120,13459,26447
ɽ,TangShanChengZhen,210604107,13347,2060,8259,5994,15519,8214,1832,8668,16882,8980,17239
,KuanDianZhen,210624100,74245,9037,45860,32181,69485,44122,11028,42717,86839,48450,94310
ˮ,GuanShuiZhen,210624101,23143,2637,13622,7995,26483,13592,4028,14114,27706,16186,29808
,PengHaiZhen,210624102,9864,1168,5842,3675,10641,5819,1797,6029,11848,6987,12829
ʯ,HongShiZhen,210624103,13910,1782,8808,5287,17775,8789,2542,9355,18144,9426,18234
ë,MaoDianZiZhen,210624104,11149,1411,6409,4001,12456,6322,1829,6664,12986,7980,14389
,ChangDianZhen,210624105,19662,2733,12450,7766,23508,12338,3616,12605,24943,13561,26011
,YongDianZhen,210624106,16966,2281,10822,6411,20642,10779,2805,11114,21893,11230,22052
̫ƽ,TaiPingShaoZhen,210624108,12748,1809,8204,4977,16236,8196,2417,8704,16900,8770,16974
ɽ,QingShanGouZhen,210624109,8227,1024,4902,3350,9676,4828,1536,5130,9958,5885,10787
ţë,NiuMaoWuZhen,210624110,10354,1207,6431,3995,12687,6412,1833,6719,13131,6963,13394
ͷ,DaChuanTouZhen,210624111,8165,955,4685,2743,8956,4618,1411,4967,9585,5846,10531
ɽ,QingYiShanZhen,210624112,9151,1238,5337,3321,9807,5223,1567,5444,10667,6619,11956
ľ,YangMuChuanZhen,210624113,8316,1267,5044,3376,9615,4980,1469,5160,10140,6008,11052
ɽ,HuShanZhen,210624114,8564,1259,5501,3618,10497,5488,1415,5615,11103,5737,11238
,ZhenJiangZhen,210624115,7967,1031,5106,2968,9806,5096,1458,5286,10382,5350,10456
Զ,BuDaYuanZhen,210624116,11750,1490,7332,4343,14829,7321,2020,7898,15219,7928,15260
,DaXiChaZhen,210624117,8320,1183,5422,3548,10627,5413,1652,5683,11096,5733,11155
˺Ӵ,BaHeChuanZhen,210624118,7687,855,4230,2632,8175,4141,1299,4427,8568,5611,9841
˫ɽ,ShuangShanZiZhen,210624119,9562,1174,5999,3362,11838,5964,1757,6317,12281,6494,12493
ʯ,ShiHuGouXiang,210624201,20507,2622,12732,7920,19630,12589,3349,13166,25755,13746,26478
¥,GuLouZiXiang,210624206,6102,875,3994,2565,7224,3959,1118,4044,8003,4101,8095
¶ӳ,XiaLuHeChaoXianZuXiang,210624212,7941,1102,4999,3170,9958,4955,1327,5309,10264,5371,10370
󶫽ֵ,DaDongJieDao,210681001,75746,7381,46312,32604,58700,43639,10711,41982,85621,47526,93838
˽ֵ,XinXingJieDao,210681002,42861,3305,26170,18546,28194,25402,7150,25118,50520,27146,53316
³ǽֵ,XinChengJieDao,210681003,27859,2580,16591,12260,22236,16522,4290,17599,34121,18138,34729
ɽ,GuShanZhen,210681101,50665,7401,32191,20878,59556,30578,6542,30117,60695,32417,64608
ǰ,QianYangZhen,210681104,50433,5475,31703,20831,55179,30914,7963,31109,62023,32168,63871
,ChangAnZhen,210681105,8786,1481,5710,4050,10588,5704,1421,5884,11588,5978,11688
ʮֽ,ShiZiJieZhen,210681106,21519,2833,13791,8329,25068,13701,3326,13728,27429,13887,27678
ɽ,ChangShanZhen,210681107,34320,4562,20756,13336,39858,20740,5022,21371,42111,23148,43904
,BeiJingZiZhen,210681108,26396,3311,16003,10255,30338,15893,3751,15886,31779,17455,33458
Ȧ,YiQuanZhen,210681109,25675,3363,16266,10369,30332,16253,3653,16307,32560,16425,32691
,HuangTuKanZhen,210681110,18250,2560,11723,7233,21532,11715,2679,11689,23404,11766,23489
ҵ,MaJiaDianZhen,210681113,19731,3025,12803,8938,24731,12798,3243,13161,25959,13196,25999
,LongWangMiaoZhen,210681114,13829,1717,8659,5761,16854,8654,2138,9016,17670,9025,17684
С,XiaoDianZiZhen,210681115,17251,2674,11286,7361,21722,11276,2839,11430,22706,11478,22764
,PuSaMiaoZhen,210681117,18904,2606,11611,7218,22119,11554,2676,11589,23143,12575,24186
ڹ,HeiGouZhen,210681118,9890,1570,6272,3981,12464,6245,1481,6634,12879,6669,12941
ũ,XinNongZhen,210681119,11174,1921,7155,4628,14071,7151,1524,7387,14538,7464,14619
¡,HeLongManZuXiang,210681206,14201,2014,9103,6009,17592,9092,2196,9261,18353,9308,18411
ʾũ,ShiFanNongChang,210681401,363,54,225,177,333,225,35,227,452,227,452
ũ,HuangTuKanNongChang,210681402,518,52,303,240,551,302,59,325,627,326,629
ũ,HaiYangHongNongChang,210681403,317,41,182,149,311,179,37,196,375,213,395
¡ũ,XingLongNongChang,210681404,621,65,381,280,661,380,84,388,768,389,770
ũ,WuSiNongChang,210681405,4364,404,2718,1727,4396,2713,587,2623,5336,2637,5355
˳ǽֵ,FengHuangChengJieDao,210682001,103415,12942,67113,42473,102415,62103,14044,59688,121791,63288,130401
ɽֵ,FengShanJieDao,210682002,41499,5176,26223,18212,41909,25959,6098,26030,51989,26550,52773
ݺӽֵ,CaoHeJieDao,210682003,12272,1597,7783,4957,13766,7670,2019,7931,15601,8105,15888
ɽ,BaoShanZhen,210682101,13441,1992,8641,5951,17125,8634,2515,9286,17920,9307,17948
,BaiQiZhen,210682102,7942,1259,5227,3713,9836,5225,1398,5342,10567,5372,10599
ɳկ,ShaLiZhaiZhen,210682103,8338,1403,5451,3639,11062,5447,1495,5754,11201,5785,11236
,HongQiZhen,210682104,13319,1983,8487,5556,16833,8482,2278,9069,17551,9093,17580
,LanQiZhen,210682105,11641,1754,7459,4757,14745,7450,1853,7737,15187,7789,15248
,BianMenZhen,210682107,16020,2564,10368,7593,19517,10321,2808,10869,21190,11024,21392
,DongTangZhen,210682110,14658,2284,9572,6402,18842,9572,2584,9954,19526,9954,19526
ʯ,ShiChengZhen,210682111,13593,2002,8570,5653,17081,8570,2236,9240,17810,9261,17831
,DaXingZhen,210682112,5928,884,3875,2710,7540,3875,1183,4108,7983,4120,7995
,AiYangZhen,210682113,24980,2762,16016,10417,28762,15995,5115,16752,32747,16841,32857
,SaiMaZhen,210682114,23029,2465,14915,9670,26753,14892,5044,15469,30361,15623,30538
ɽ,DiXiongShanZhen,210682115,10338,1602,6656,4433,13002,6643,1817,7042,13685,7101,13757
ɽ,JiGuanShanZhen,210682116,14806,2482,9445,6774,17932,9411,2501,9953,19364,10344,19789
Һ,LiuJiaHeZhen,210682117,14779,2290,9550,6553,17971,9493,2618,9807,19300,10137,19687
ͨԶ,TongYuanBaoZhen,210682118,23618,2652,14671,9599,23611,13262,3245,13373,26635,14844,29515
,SiMenZiZhen,210682119,9604,1348,6234,4099,12192,6225,1929,6572,12797,6647,12881
,QingChengZiZhen,210682120,19488,3494,13057,10682,24448,13048,3457,13257,26305,13382,26439
ɹ,DaBaoMengGuZuXiang,210682200,15382,2081,9839,6249,19097,9838,2590,10209,20047,10214,20053
찲ֵ,TianAnJieDao,210702001,22442,3371,14987,10963,21800,14946,3257,14009,28955,14083,29070
ʯͽֵ,ShiYouJieDao,210702002,34783,5914,22502,17861,40828,22434,4056,21873,44307,22251,44753
ֵֽ,BeiJieJieDao,210702003,19972,2394,13254,9125,21500,13077,2967,11989,25066,12079,25333
ҵֵ,JingYeJieDao,210702004,46337,5188,26096,16388,35925,20786,4352,20190,40976,29781,55877
ֵ,BaoAnJieDao,210702005,30230,4606,19871,13935,32612,19340,3789,18448,37788,18754,38625
Ͻֵֽ,NanJieJieDao,210702006,12417,1518,7984,5914,10886,7907,1586,7422,15329,7537,15521
ֵ,RaoYangJieDao,210702007,21701,3277,14050,10511,20721,13827,2250,12870,26697,13178,27228
վǰֵ,ZhanQianJieDao,210702008,31332,5770,20858,15205,30585,19740,2942,18039,37779,19186,40044
ʿӢֵ,ShiYingJieDao,210702009,9301,650,5614,3564,6414,4845,1197,4883,9728,5534,11148
ֵ,ZhengDaJieDao,210703001,22516,3672,14952,11167,23347,14435,2473,13510,27945,13709,28661
ʯӽֵ,ShiQiaoZiJieDao,210703002,24105,4545,16701,11701,24128,15700,3109,14665,30365,15058,31759
ֵ,LongJiangJieDao,210703003,28429,5212,19154,14725,29281,18931,3111,17446,36377,17598,36752
񻨽ֵ,LiuHuaJieDao,210703004,35659,5183,23277,17815,36291,23087,4414,21833,44920,21979,45256
½ֵ,TieXinJieDao,210703005,12333,2180,7548,6500,10637,7516,1347,7384,14900,8312,15860
谲ֵ,LingAnJieDao,210703006,29583,4650,19859,14982,31226,19605,4015,18096,37701,18389,38248
԰ֵ,JuYuanJieDao,210703007,38330,5906,24854,19681,40590,24785,4317,23629,48414,23699,48553
ֵ,KangNingJieDao,210703008,27199,5440,17735,13479,28608,17551,2729,17220,34771,17633,35368
ֵ,JinTieJieDao,210703009,48208,7693,32228,18647,51744,30015,7199,27981,57996,30872,63100
ҽֵ,MaJiaJieDao,210703010,29446,3548,18937,10614,23545,14270,2875,14058,28328,16932,35869
ٹɽֵ,BaiGuJieDao,210703011,22047,2999,14215,9748,19460,12775,2564,12869,25644,13395,27610
ݱɽũܹ˾,JinZhouBeiShanNongGongShangZongGongSi,210703402,2026,298,1298,886,2187,1298,246,1272,2570,1272,2570
̫ͽֵ,TaiHeJieDao,210711001,14149,1591,8888,7301,11293,8701,1991,8627,17328,8843,17731
¡ֵ,XingLongJieDao,210711002,7958,1539,5264,4239,9535,5264,880,5113,10377,5113,10377
ӽֵ,TangHeZiJieDao,210711003,15008,3501,10099,8385,18186,9981,1637,9765,19746,10047,20146
ֵ,LingXiJieDao,210711004,22965,2445,11941,7840,13419,10031,2416,10063,20094,15885,27826
Ѧֵ,DaXueJieDao,210711007,14742,2052,9086,6427,15872,8747,2089,9048,17795,9797,18883
ҽֵ,WangJiaJieDao,210711070,20058,1847,12804,7668,15868,10923,2798,10981,21904,11899,24703
Žֵ,TianQiaoJieDao,210711071,11852,1173,7002,5093,10786,6859,1637,7006,13865,7660,14662
ɽֵ,XingShanJieDao,210711072,10910,1558,7067,4569,13178,7060,1723,7070,14130,7124,14191
Ͻֵ,LingNanJieDao,210711080,69119,4012,45773,21655,37932,29178,7948,28163,57341,35306,81079
﹬,NiangNiangGongZhen,210711170,19714,2897,12890,8284,24119,12882,3172,12858,25740,12893,25783
ɽ,SongShanZhen,210711180,27043,3832,17688,12413,33180,17681,4859,17980,35661,18046,35734
Ů,NvErHeXiang,210711202,15191,1909,9732,6746,17584,9718,2395,9729,19447,9763,19495
,ZhongTunXiang,210711203,12537,1264,7717,5327,10235,7683,2091,7872,15555,8175,15892
Ӫ,YingPanXiang,210711204,8394,977,5199,3611,6869,5077,1298,5227,10304,5470,10669
,XinMinXiang,210711205,34367,3362,21281,14675,30772,20931,5508,21311,42242,21956,43237
йũ,JinZhouShiGuoShuNongChang,210711480,11303,1361,7147,4944,11213,7116,1522,6994,14110,7039,14186
ɽ,HeiShanZhen,210726100,80688,10997,52103,39914,81131,50433,11203,49157,99590,50785,102888
ɽ,FangShanZhen,210726101,22855,3017,14864,9330,28287,14851,3652,14571,29422,14660,29524
׳,BaiChangMenZhen,210726102,12198,1510,7831,4670,15232,7824,2296,8138,15962,8173,16004
,ChangXingZhen,210726103,17058,2348,10970,7108,20790,10962,2693,11092,22054,11129,22099
,JiangTunZhen,210726104,16021,2165,10389,6515,20468,10389,2851,10619,21008,10648,21037
,LiJiaZhen,210726105,17980,2646,12094,7528,22824,12088,3356,11852,23940,11888,23982
,RaoYangHeZhen,210726106,18945,2605,12266,7345,23889,12263,3265,12499,24762,12549,24815
,BanLaMenZhen,210726107,14248,1954,9381,5326,18184,9373,2674,9449,18822,9495,18876
,WuLiangDianZhen,210726108,18224,2260,11801,6514,22982,11798,3017,11660,23458,11700,23501
,HuJiaZhen,210726109,17479,2355,11369,7078,21731,11367,2995,11412,22779,11460,22829
,XinLiTunZhen,210726110,22692,3139,14520,10316,26922,14505,3028,14299,28804,14339,28859
˵,BaDaoHaoZhen,210726111,31798,4810,20027,14096,39063,20024,4153,20703,40727,20734,40761
ɽ,DaHuShanZhen,210726112,34017,5631,21934,16332,38771,21204,3943,20964,42168,21657,43591
ļ,SiJiaZiZhen,210726113,15601,1995,10035,5972,19709,10030,2609,10136,20166,10170,20205
,XinXingZhen,210726114,10981,1521,7266,4724,13907,7265,2240,7455,14720,7476,14742
̫,TaiHeZhen,210726116,18648,2512,11990,7389,22528,11986,2917,12056,24042,12087,24077
Ӣ,YingChengZiXiang,210726201,15378,2088,9882,6175,19316,9878,2571,10116,19994,10155,20037
,ZhenAnXiang,210726208,26954,3390,17083,10558,30737,17039,3930,17055,34094,17191,34274
μ,DuanJiaXiang,210726209,18937,2581,12200,7660,22702,12197,2802,12083,24280,12120,24320
,DaXingXiang,210726210,7449,951,4840,3008,9532,4833,1334,4865,9698,4894,9734
Ѧ,XueTunXiang,210726212,14066,1819,9018,5281,17510,9017,2197,9020,18037,9064,18082
ʡС,LiaoNingShengJinZhouShiXiaoDongZhongChuChang,210726400,23670,3314,15506,9338,30169,15490,3864,15243,30733,15342,30848
,YiZhouZhen,210727100,40236,5465,25819,18724,41918,24358,5467,24062,48420,25349,51168
̨,LiuLongTaiZhen,210727101,5586,828,3534,2160,6861,3532,881,3740,7272,3761,7295
,QiLiHeZhen,210727102,22831,3548,14934,9782,29117,14931,3834,15240,30171,15279,30213
,DaYuShuBaoZhen,210727103,22086,3134,14085,8886,28425,14062,4122,15164,29226,15257,29342
ԻӪ,ShaoHuYingZiZhen,210727104,18705,1967,11767,6796,23330,11762,3582,12367,24129,12487,24254
ŵ,JiuDaoLingZhen,210727105,25072,3040,15915,9540,31422,15903,4559,16421,32324,16756,32671
̨,GaoTaiZiZhen,210727106,17567,1969,11499,6670,22093,11496,3445,11461,22957,11482,22981
,WaZiYuZhen,210727108,18410,2485,11778,6927,23552,11775,3532,12585,24360,12649,24427
ǹ,ChengGuanManZuXiang,210727201,32161,4390,20807,14030,22480,20318,5054,20363,40681,20798,41605
ͷ,TouDaoHeManZuXiang,210727202,10195,1513,6386,3777,13022,6386,1417,6739,13125,6739,13125
ز,DiCangSiManZuXiang,210727203,5200,904,3330,2183,6738,3329,787,3539,6868,3561,6891
,LiuLongGouManZuXiang,210727204,7516,1498,4920,3286,9966,4919,1185,5235,10154,5279,10199
󶨱,DaDingBaoManZuXiang,210727205,5601,1072,3568,2269,7283,3568,781,3871,7439,3886,7454
ǰ,QianYangXiang,210727206,17332,2101,10267,6623,18998,10115,2681,10524,20639,11847,22114
,BaiMiaoZiXiang,210727207,14606,2077,9182,6011,18686,9182,2380,9879,19061,9881,19063
,JuLiangTunManZuXiang,210727208,14954,2042,9769,5488,18321,9741,2450,9564,19305,9677,19446
żұ,ZhangJiaBaoXiang,210727209,17544,2537,11427,7559,22945,11246,3556,11973,23219,12210,23637
ͷ̨,TouTaiManZuXiang,210727215,8237,1103,5256,3308,10208,5254,1377,5444,10698,5461,10717
ӽֵ,DaLingHeJieDao,210781001,68272,8602,43875,33542,72791,43295,10544,42906,86201,43543,87418
ǽֵ,JinChengJieDao,210781002,26642,4545,16721,13667,29582,16575,3310,16619,33194,17776,34497
ʯɽ,ShiShanZhen,210781101,24237,3265,14010,9497,27708,13355,3409,13884,27239,16901,30911
,YuJiZhen,210781102,15543,2493,10192,7338,19498,10190,2487,10300,20490,10331,20523
˫,ShuangYangZhen,210781103,19753,2799,12685,8346,23159,12654,3400,13140,25794,13267,25952
༪,BanJiTaZhen,210781104,12514,1848,8222,5322,15554,8219,2366,8439,16658,8506,16728
̨,ShenJiaTaiZhen,210781105,15567,2449,10228,6197,19078,10227,2852,10613,20840,10640,20868
̨,SanTaiZiZhen,210781106,28966,4102,18272,12306,36766,18269,5210,18664,36933,20006,38278
,YouWeiManZuZhen,210781107,12943,1845,8363,5045,15796,8363,2008,8401,16764,8433,16796
ּ,YanJiaZhen,210781108,9786,1352,6282,3969,11954,6278,1621,6437,12715,6477,12759
ׯ,XinZhuangZiZhen,210781109,22727,3284,14646,8515,26729,13960,3460,14270,28230,14825,29471
,CuiYanZhen,210781112,11581,1794,7692,4656,14913,7680,2051,7704,15384,7734,15426
,AnTunZhen,210781113,8335,928,5287,3206,9311,5204,1498,5333,10537,5474,10761
ҵ,DaYeXiang,210781202,16259,2422,10633,7157,19926,10621,2671,10687,21308,10719,21352
ǧ,XiBaQianXiang,210781204,7123,888,4648,3198,8666,4643,1258,4603,9246,4621,9269
ҵ,JianYeXiang,210781205,20677,2706,13325,7928,25690,13322,3384,13417,26739,13442,26767
µ¥,WenDiLouManZuXiang,210781210,13795,1962,8925,5766,16608,8922,2385,9194,18116,9217,18142
ʯ,BanShiGouXiang,210781212,8404,1315,5506,4009,10825,5504,1526,5737,11241,5739,11245
̨,BaiTaiZiXiang,210781214,21456,3281,14061,9259,26649,14041,3445,14073,28114,14121,28182
л,XieTunXiang,210781217,11623,1701,7633,4793,13904,7633,1923,7603,15236,7614,15247
ʡԭֳ,LiaoNingShengJinChengYuanZhongChang,210781401,3375,565,2167,1858,3896,2167,362,2135,4302,2135,4302
ũ,DaYouNongChang,210781405,10278,1195,5975,3809,11280,5944,1712,6110,12054,7210,13185
ֵ´,BeiZhenJieDaoBanShiChu,210782004,38047,5313,25238,17792,36201,23447,5793,22172,45619,23915,49153
ֵ´,GuanYinGeJieDaoBanShiChu,210782005,2149,316,1364,782,2601,1364,290,1391,2755,1391,2755
,DaShiZhen,210782101,8688,1216,5422,3234,11130,5420,1425,5896,11316,5907,11329
ޱ,LuoLuoBaoZhen,210782102,16768,2645,10740,6554,21044,10731,2367,10992,21723,11040,21780
˵,ChangXingDianZhen,210782103,16472,2191,10921,6271,21421,10911,3253,10960,21871,10995,21916
,ZhengAnZhen,210782104,19874,2506,12766,6995,25751,12753,3703,13260,26013,13317,26083
,LvYangZhen,210782105,22613,3178,14684,8779,28658,14682,4045,15135,29817,15152,29836
а,ZhongAnZhen,210782106,57277,7478,36394,21777,72377,36386,9019,37290,73676,37380,73774
,LiaoTunZhen,210782107,26226,3930,17168,11119,33396,17159,4615,17554,34713,17603,34771
,ZhaoTunZhen,210782109,20253,2713,13041,7965,25467,13030,3243,13109,26139,13168,26209
,QingDuiZiZhen,210782110,16234,2317,10554,6999,19888,10553,2905,10868,21421,10902,21456
ɽ,GaoShanZiZhen,210782111,15161,2115,9647,6314,19207,9644,2302,9900,19544,9931,19578
,GouBangZiZhen,210782112,49161,6381,31262,21403,51465,30070,7447,29978,60048,31727,62989
,FuTunXiang,210782201,14586,2407,9292,6289,17485,9291,2100,9766,19057,9801,19093
,BaoJiaXiang,210782203,9547,1425,6051,3779,12290,6051,1633,6554,12605,6554,12605
,DaTunXiang,210782206,11974,1634,7676,4327,15238,7672,1864,7778,15450,7796,15472
,WuJiaXiang,210782208,8457,1252,5490,3321,10862,5490,1489,5700,11190,5708,11198
,LiuJiaXiang,210782209,8408,1138,5484,3435,10561,5483,1466,5513,10996,5528,11012
,GuangNingXiang,210782211,27877,3949,17945,11503,31221,17938,4417,18120,36058,18298,36243
ʡ,LiaoNingShengBeiZhenShiXuNiDiQu,210782402,4033,541,1117,1005,1839,1117,195,1108,2225,3652,4769
ũ,XinLiNongChang,210782403,2236,267,1440,831,2794,1440,374,1437,2877,1437,2877
ؽֵ,BaTianDiJieDao,210802001,31231,5437,21007,15904,34280,20881,4170,19619,40500,19831,40838
ֵ,JianFengJieDao,210802002,64079,8696,40699,27953,53292,35738,6547,34731,70469,38623,79322
ֵ,JianSheJieDao,210802003,36410,5466,23450,17750,35893,23271,4603,22223,45494,23029,46479
Ծֵ,YueJinJieDao,210802004,37473,5324,24121,18166,35763,23793,4279,22687,46480,22955,47076
ֵ,DongFengJieDao,210802005,54928,8403,34823,27709,51167,34476,6466,34081,68557,34974,69797
˽ֵ,XinXingJieDao,210802006,14327,2723,9077,7656,15299,8957,1246,9014,17971,9219,18296
½ֵ,XinJianJieDao,210802007,7547,955,1770,1680,3053,1768,324,1882,3650,7056,8826
ʤֵ,ShengLiJieDao,210803001,19048,3069,12338,9748,14353,12313,2063,11801,24114,11842,24180
廪ֵ,QingHuaJieDao,210803002,17597,2994,11312,9078,17058,11290,1952,11203,22493,11231,22543
�ֵ,BinHaiJieDao,210803003,24745,3409,14658,11094,21897,14298,2524,14214,28512,16020,30678
ʤֵ,DeShengJieDao,210803004,12277,1927,7430,5807,10613,7166,1158,7058,14224,7932,15362
̨ӽֵ,WuTaiZiJieDao,210803005,33624,5572,21864,16289,30543,21569,3907,20724,42293,21239,43103
нֵ,YuShiJieDao,210803006,20906,3456,13083,11234,20047,12973,1981,13029,26002,13260,26343
ӱֵ,HeBeiJieDao,210803007,2092,325,1276,1154,1470,1275,247,1334,2609,1388,2664
캣ֵ,HongHaiJieDao,210804001,41936,3568,23530,16888,34594,22531,6157,22788,45319,28131,51661
ǽֵ,HaiXingJieDao,210804002,110386,7240,66511,48907,96026,65527,19015,67509,133036,70130,136641
ֵ,WangHaiJieDao,210804003,6543,585,3616,2211,5807,3502,1018,3668,7170,4530,8146
ֵ,HaiDongJieDao,210804004,44598,2813,26823,19284,27075,26532,7699,27320,53852,28287,55110
,XiongYueZhen,210804100,78186,9590,47609,31057,80285,41951,9701,44211,86162,49868,97477
«,LuTunZhen,210804101,45496,4909,28490,18279,48443,28409,7657,29380,57789,29572,58062
,HongQiManZuZhen,210804102,18455,2142,11720,7579,19850,11681,3393,12213,23894,12270,23990
ϱֵ߽,LaoBianJieDao,210811001,24036,2222,14970,10731,19023,14499,3789,14456,28955,15077,30047
Ƕֵ,ChengDongJieDao,210811002,1318,113,774,548,1195,773,164,820,1593,821,1595
غֵ,YanHaiJieDao,210811003,3764,606,2335,1786,3220,2335,445,2480,4815,2480,4815
·,LuNanZhen,210811101,40050,4144,23611,16347,28366,23361,5173,24080,47441,25756,49367
,LiuShuZhen,210811102,14614,2184,9171,6052,15806,9132,2164,9630,18762,9791,18962
߳,BianChengZhen,210811103,16668,1779,9972,7108,13905,9948,2221,10267,20215,10696,20668
¥ֵ,GuLouJieDao,210881001,39892,6656,25696,23563,42522,25608,5412,26205,51813,26264,51960
ǽֵ,XiChengJieDao,210881002,44902,5145,27130,23739,46021,26632,4983,27321,53953,27900,55030
ǽֵ,DongChengJieDao,210881003,43853,5848,27469,18017,36612,27341,6457,28482,55823,28689,56158
ֵ̫,TaiYangShengJieDao,210881004,32513,4023,20477,12032,28869,19556,5076,20196,39752,21135,41612
ɽֵ,TuanShanJieDao,210881005,19439,2431,12628,7360,23472,12598,3631,12737,25335,12873,25501
�ֵ,XiHaiJieDao,210881006,16891,2090,10689,7584,18167,10652,2650,10910,21562,10942,21631
¢ؽֵ,JiuLongDiJieDao,210881007,21701,2555,13334,8367,23712,13304,3862,13993,27297,14784,28118
ݽֵ,GuiZhouJieDao,210881008,22951,3048,14701,8115,27169,14699,3904,15196,29895,15202,29903
,GaoTunZhen,210881102,13752,2161,8876,5344,17278,8869,2515,9519,18388,9552,18428
ɳ,ShaGangZhen,210881105,15744,2208,9969,5945,18244,9922,2619,10487,20409,10602,20571
կ,JiuZhaiZhen,210881109,28826,4050,17821,11947,33622,17820,4391,19429,37249,19446,37267
,WanFuZhen,210881110,28787,4286,17954,10275,34425,17914,4210,18974,36888,19329,37283
Ȫ,WoLongQuanZhen,210881111,13728,2046,8517,4786,17443,8511,1946,9203,17714,9203,17720
ʯ,QingShiLingZhen,210881112,20328,2622,12775,7316,24855,12770,3137,13241,26011,13312,26087
ůȪ,NuanQuanZhen,210881113,10558,1709,6720,4153,12938,6713,1575,7093,13806,7122,13842
ʽ,BangShiBaoZhen,210881116,16573,2476,10576,6552,20858,10570,2966,11387,21957,11439,22015
ŵ,TuanDianZhen,210881117,8319,1353,5350,3310,9703,5332,1302,5604,10936,5624,10974
˫̨,ShuangTaiZhen,210881118,14291,2090,8910,5536,15267,8869,2193,9500,18369,9664,18574
,YangYunZhen,210881119,18972,2962,12141,6969,24008,12136,3211,12980,25116,13004,25145
,XuTunZhen,210881120,14684,1891,9293,5327,16660,9275,2566,9647,18922,9848,19141
ʲֽ,ShenZiJieZhen,210881121,20537,3137,12925,8190,25865,12922,3170,13882,26804,13919,26844
󶴹,KuangDongGouZhen,210881122,16558,2982,10736,6447,20912,10731,2471,11234,21965,11275,22011
,ChenTunZhen,210881123,16084,2406,10283,6362,18534,10283,2830,11030,21313,11037,21320
,LiangTunZhen,210881124,20024,3076,12750,7069,24760,12741,3195,13475,26216,13545,26295
Сʯ,XiaoShiPengXiang,210881216,7411,1192,4311,2652,8171,4227,1048,4498,8725,5340,9651
԰,GuoYuanXiang,210881217,896,161,571,428,750,571,129,615,1186,615,1186
̨,ErTaiXiang,210881218,5453,1032,3530,2183,6403,3530,843,3798,7328,3798,7328
ʯŽֵ,ShiQiaoJieDao,210882001,52505,5253,32371,24377,40962,31535,7561,31793,63328,32948,65319
໨ֵ,QingHuaJieDao,210882002,29848,3294,18297,13102,21826,17101,4137,17487,34588,18982,37279
Žֵ,JinQiaoJieDao,210882003,30433,3585,18572,12664,24393,18478,4662,19689,38167,20108,38680
ֵֶ,GangDouJieDao,210882004,91053,8441,56057,40503,69368,54943,13963,55913,110856,57400,113457
¥ֵ,NanLouJieDao,210882005,46332,6502,28859,21486,49927,28745,6636,30305,59050,30611,59470
ˮԴ,ShuiYuanZhen,210882101,30177,3505,18617,12112,33257,18610,4220,19231,37841,19285,37902
,GouYanZhen,210882102,24949,2579,15445,9423,30297,15441,4238,16288,31729,16321,31766
ʯ,ShiFoZhen,210882103,15022,1690,9571,5918,18579,9553,2773,9869,19422,9914,19485
߿,GaoKanZhen,210882104,34223,4281,21518,15160,42274,21507,5761,22709,44216,22747,44265
,QiKouZhen,210882105,37348,4210,23612,14787,47665,23580,7299,25142,48722,25245,48857
ׯ,HuZhuangZhen,210882106,22211,3064,13912,9167,25997,13852,3628,14794,28646,14991,28903
,GuanTunZhen,210882107,23425,3339,14650,10429,24742,14633,3855,15884,30517,15969,30619
,BoLuoPuZhen,210882112,21127,2766,13261,8680,24605,13236,3610,14103,27339,14242,27503
,YongAnZhen,210882113,19253,2493,12096,7753,22121,12096,3162,12805,24901,12812,24908
,TangChiZhen,210882114,27422,4069,17517,11251,33845,17505,5248,19180,36685,19222,36739
һ,JianYiZhen,210882115,11354,1914,7324,4550,14261,7309,2066,7994,15303,8010,15334
,HuangTuLingZhen,210882116,19514,3161,12379,7653,24610,12379,3217,13511,25890,13513,25892
ܼ,ZhouJiaZhen,210882117,13879,2393,8735,5953,16863,8662,2241,9733,18395,9778,18513
˽ֵ,XinXingJieDao,210902002,19164,2997,12613,9774,17920,12563,2384,11876,24439,11932,24545
ƽֵ,HePingJieDao,210902003,13658,1852,8908,6633,13965,8842,1959,8415,17257,8561,17469
ɽֵ,XiShanJieDao,210902004,31463,4786,20893,15470,31292,20589,4032,19023,39612,19388,40281
ӱֵ,HeBeiJieDao,210902005,36040,5737,24301,16769,32893,21596,4057,20228,41824,21533,45834
վǰֵ,ZhanQianJieDao,210902006,20784,2988,13789,10396,21640,13735,2939,12819,26554,12922,26711
½ֵ,XiFuXinJieDao,210902007,19696,3381,12616,10338,20175,12525,1807,12148,24673,12268,24884
ֵ,WuLongJieDao,210902008,19200,3244,12205,10361,20128,12196,1907,12072,24268,12146,24351
ƽ�ֵ,PingAnXiBuJieDao,210902009,23702,4076,15406,12889,25212,15382,2560,14916,30298,14932,30338
˴ֵ,GongRenCunJieDao,210902010,8038,1436,5126,4651,8522,5124,856,5045,10169,5204,10330
ֵ,DongLiangJieDao,210902011,5085,1043,3416,3366,5961,3412,692,3401,6813,3404,6820
ҵ,HanJiaDianZhen,210902101,15075,2168,9471,7295,16111,9447,1951,9643,19090,9723,19194
¡ֵ,XingLongJieDao,210903001,15731,2940,10391,8308,14088,10099,1558,9673,19772,9838,20229
˽ֵ,ZhongXingJieDao,210903002,9070,1736,6109,4913,8908,6091,1053,5720,11811,5750,11859
ֵ,YiMinJieDao,210903003,9103,1873,6007,5123,9751,5999,808,5767,11766,5777,11784
·ֵ,XinFaJieDao,210903004,8840,1818,5828,4991,8933,5823,895,5715,11538,5725,11553
Ӫ,ChangYingZiZhen,210903101,20873,2616,13169,10443,21342,13154,2902,13157,26311,13222,26391
ֵ,HongShuJieDao,210904001,39356,6825,25990,20632,40708,25816,4468,24432,50248,24659,50649
úֵ,MeiHaiJieDao,210904002,23626,3922,15287,11941,25384,15277,2461,14713,29990,14722,30009
ߵ½ֵ,GaoDeJieDao,210904003,21967,3362,13729,11381,21746,13561,2095,13039,26600,13695,27424
ֵ,SunJiaWanJieDao,210904004,15649,2921,9895,8765,18360,9855,1380,9970,19825,10055,19950
Ͻֵ,ChengNanJieDao,210904005,15766,3201,10227,8764,17491,10132,1540,10124,20256,10280,20507
ˮȪ,ShuiQuanZhen,210904101,13862,1902,8484,6883,13240,8385,1741,8755,17140,9021,17505
ӽֵ,QingHeJieDao,210905001,15612,2358,10324,8110,16431,10300,2357,9990,20290,10003,20327
ֵ̨,LiuTaiJieDao,210905002,4663,882,3084,2759,5679,3084,524,2985,6069,2985,6069
ѽֵ,AiYouJieDao,210905003,4106,547,2588,2230,4496,2586,580,2569,5155,2645,5233
±ֵ,XinBeiJieDao,210905004,3561,528,2341,2047,3686,2341,552,2291,4632,2300,4641
,HeXiZhen,210905101,11359,1537,7287,5360,9903,7286,1784,7358,14644,7393,14680
,WuLongBaZhen,210905102,7549,887,4859,3266,8492,4859,1365,4942,9801,4942,9801
Էֵ,XiYuanJieDao,210911001,25326,2273,15543,10287,17192,14241,3333,13837,28078,15389,30932
Էֵ,BeiYuanJieDao,210911002,17681,2185,11191,8548,16401,11073,2223,10600,21673,10898,22089
Էֵ,DongYuanJieDao,210911003,18694,2498,11598,8637,16747,11353,2404,10631,21984,11998,23596
ѧԷֵ,XueYuanJieDao,210911004,38679,4391,21982,13347,29122,18414,4236,17279,35693,25324,47306
Էֵ,ZhongYuanJieDao,210911005,33207,4861,21762,16554,29449,21685,4011,20224,41909,20317,42079
ֵ,HuaDongJieDao,210911006,11401,1368,7296,5253,9359,7254,1685,7104,14358,7158,14454
ĺ,SiHeZhen,210911102,25350,2539,14672,8941,19297,12642,2943,12946,25588,16160,30832
ֵ´,ChengQuJieDaoBanShiChu,210921001,51541,5547,32770,20717,42686,27933,6406,26923,54856,30724,63494
,FuXinZhen,210921100,23573,2357,14811,9099,27756,14781,4415,15380,30161,15534,30345
,DongLiangZhen,210921102,19051,2161,12034,7959,20887,12027,3223,12353,24380,12401,24435
,FoSiZhen,210921103,8213,990,5265,3634,10450,5265,1642,5541,10806,5580,10845
ͼ,YiMaTuZhen,210921104,19511,2127,12518,8016,22159,12513,3594,12693,25206,12714,25232
,JiuMiaoZhen,210921105,18196,1887,11671,7229,23335,11671,3812,12215,23886,12224,23895
񻶳,WuHuanChiZhen,210921106,19625,2011,12550,7567,24961,12550,4059,13145,25695,13145,25695
,JianSheZhen,210921107,18510,1836,11827,6989,23207,11823,3848,12343,24166,12367,24194
,DaBaZhen,210921108,16434,1935,10510,6643,19994,10510,2714,10573,21083,10573,21083
,PaoZiZhen,210921109,21294,2501,13447,8532,26508,13445,3476,13746,27191,13824,27271
ʮ,ShiJiaZiZhen,210921110,15689,1774,9951,6224,19153,9945,2811,10295,20240,10323,20274
,WangFuZhen,210921111,17084,1908,10916,7133,20524,10887,3279,11290,22177,11355,22271
,YuSiZhen,210921112,11243,1172,7381,4683,14272,7375,2492,7495,14870,7526,14907
,FuRongZhen,210921113,14560,1681,9266,6042,18072,9265,2729,9679,18944,9704,18970
,XinMinZhen,210921114,11913,1436,7588,4940,14563,7584,2164,7911,15495,7925,15513
˵,FuXingDiZhen,210921115,12105,1158,7708,4779,15057,7694,2504,7926,15620,8059,15767
ƽ,PingAnDiZhen,210921116,13901,1284,8793,5362,17373,8768,3049,9359,18127,9441,18234
ɳ,ShaLaZhen,210921117,11889,1280,7492,4847,14226,7483,2130,7800,15283,7807,15299
̱,DaGuBenZhen,210921118,16508,1789,10518,6285,21001,10513,3267,11033,21546,11046,21564
,DaWuJiaZiZhen,210921119,13073,1328,8414,5151,16635,8399,2717,8634,17033,8704,17118
,DaBanZhen,210921120,8792,1027,5433,3631,10256,5405,1500,5678,11083,5886,11319
֩ɽ,ZhiZhuShanXiang,210921201,14043,1687,9187,6028,17601,9186,3026,9558,18744,9569,18756
Է﹵,WoFengGouXiang,210921203,9165,1083,5927,3860,11473,5927,1784,6086,12013,6105,12032
˼,BaJiaZiXiang,210921204,8948,989,5739,3519,11328,5739,1817,6011,11750,6015,11754
ﻧ,HaDaHuShaoXiang,210921205,9313,1070,6010,3651,12046,6006,1942,6292,12298,6315,12325
Ӫ,TaYingZiXiang,210921207,8616,843,5419,3518,10723,5419,1710,5739,11158,5750,11169
Ӫ,ZhaLanYingZiXiang,210921208,11130,1205,7145,4385,14046,7130,2259,7424,14554,7449,14594
,ZhaoShuGouXiang,210921210,12125,1277,7674,4622,15221,7673,2412,8134,15807,8140,15814
,CangTuXiang,210921211,9108,1096,5922,3652,11407,5922,1805,6076,11998,6087,12009
Ϻ,LaoHeTuXiang,210921214,13626,1584,8712,5323,17105,8711,2533,9012,17723,9031,17743
߼,QiJiaZiXiang,210921215,9322,1100,5926,4057,11740,5923,1800,6284,12207,6296,12222
ñ,HongMaoZiXiang,210921217,10323,1119,6581,4059,12994,6548,2017,6796,13344,6878,13459
϶̨,ZiDouTaiXiang,210921218,8381,1064,5438,3446,10691,5435,1733,5728,11163,5740,11178
ʯ,HuaShiGeXiang,210921219,8973,1118,5971,3880,11775,5971,2151,6262,12233,6271,12242
̫ƽ,TaiPingXiang,210921220,7676,816,5058,3521,9805,5058,1744,5175,10233,5178,10236
,GuoHuaXiang,210921222,7215,968,4579,3211,8868,4578,1247,4841,9419,4851,9430
ũ´,PaoZiNongChangBanShiChu,210921401,1796,201,1174,710,2207,1174,286,1109,2283,1109,2283
,ZhangWuZhen,210922100,56968,7860,36400,26583,59072,34650,7482,34162,68812,35910,72310
,HaErTaoZhen,210922101,16017,1824,10269,6633,19928,10263,3121,10660,20923,10693,20962
¹̨,ZhangGuTaiZhen,210922102,9324,983,6046,3996,11040,6044,1798,6047,12091,6059,12105
,WuFengZhen,210922103,13359,1839,8579,5810,16181,8566,2246,8842,17408,8865,17444
,FengJiaZhen,210922104,11000,1275,7227,4902,13960,7227,2278,7309,14536,7326,14553
,HouXinQiuZhen,210922105,14106,1642,9225,5893,17699,9224,2894,9393,18617,9417,18642
,DongLiuJiaZiZhen,210922106,10774,1370,6946,4831,13500,6945,2019,7208,14153,7217,14163
,AErXiangZhen,210922107,4167,426,2717,1832,4733,2717,843,2708,5425,2719,5436
έӹɹ,WeiZiGouMengGuZuXiang,210922201,11617,1387,7453,4806,14396,7452,2157,7686,15138,7708,15161
ɹ,ErDaoHeZiMengGuZuXiang,210922202,8800,1066,5512,3763,10845,5512,1447,5779,11291,5801,11313
ɹ,XiLiuJiaZiMengGuZuManZuXiang,210922203,11592,1494,7597,5044,14444,7594,2200,7667,15261,7689,15286
,LiangJiaZiXiang,210922204,10958,1514,7110,4760,13712,7110,2024,7377,14487,7386,14496
˫,ShuangMiaoXiang,210922205,8691,1127,5714,3984,11028,5714,1757,5846,11560,5861,11575
ƽ,PingAnXiang,210922206,8312,1099,5451,3736,10552,5449,1607,5547,10996,5567,11018
ú,ManTangHongXiang,210922207,8623,1012,5576,3573,10719,5517,1750,5661,11178,5809,11385
ı,SiBuZiXiang,210922208,9297,1080,6085,4007,11959,6081,2002,6281,12362,6294,12379
,FengTianXiang,210922209,7250,810,4692,3427,8976,4691,1472,4832,9523,4840,9532
,DaDeXiang,210922210,6404,736,4181,2887,8099,4179,1327,4267,8446,4286,8467
ɹ,DaLengMengGuZuXiang,210922211,12138,1325,7960,5193,15385,7956,2579,8060,16016,8082,16042
ǰ˵,QianFuXingDiXiang,210922212,5678,677,3712,2512,7149,3705,1133,3749,7454,3776,7488
¡,XingLongBaoXiang,210922213,10617,1305,6931,4732,13395,6931,2086,7076,14007,7077,14008
¡ɽ,XingLongShanXiang,210922214,6963,894,4359,3015,7468,4313,1157,4394,8707,4655,9014
ļ,DaSiJiaZiXiang,210922215,7373,1036,4854,3202,9409,4849,1461,4999,9848,5016,9870
ĺϳ,SiHeChengXiang,210922216,8315,939,5412,3756,10342,5412,1809,5636,11048,5651,11063
ǻֵ´,XingHuoJieDaoBanShiChu,211002001,11733,1784,7855,5799,10680,7655,1750,7253,14908,7412,15267
ʤֵ´,ShengLiJieDaoBanShiChu,211002002,22051,3615,14438,10792,20026,14425,2660,13819,28244,13888,28326
Ծֵ´,YueJinJieDaoBanShiChu,211002003,43612,5101,28152,17644,33996,24088,5316,22595,46683,25877,54029
·ֵ´,WeiGuoLuJieDaoBanShiChu,211002005,40626,6031,26949,20335,34827,26688,5566,25027,51715,25274,52223
վǰֵ´,ZhanQianJieDaoBanShiChu,211002006,20329,3165,12934,9558,18191,12748,2441,12305,25053,13001,25935
ֵ´,TieXiJieDaoBanShiChu,211002009,38859,5263,24508,19662,28526,22586,4450,22591,45177,24064,48572
ʥֵ´,WuShengJieDaoBanShiChu,211003001,11964,1737,7941,5758,11694,7836,1661,7299,15135,7421,15362
ʥֵ´,WenShengJieDaoBanShiChu,211003002,25838,3047,16647,12138,22375,16440,3645,15600,32040,15883,32530
ƽֵ´,XiangPingJieDaoBanShiChu,211003003,21521,2774,13944,9969,20476,13895,2936,13202,27097,13287,27231
ֵ´,QingYangJieDaoBanShiChu,211003004,32336,7572,21854,16397,38876,21757,3566,21419,43176,21620,43474
Žֵ´,NanMenJieDaoBanShiChu,211003005,17696,3104,12198,8867,17006,12127,2811,11361,23488,11413,23611
˽ֵ´,DongXingJieDaoBanShiChu,211003007,40524,5961,25877,19449,35185,25507,4721,25023,50530,25329,51206
ũֵ´,GongNongJieDaoBanShiChu,211004001,26948,3340,15558,11025,22554,13852,2706,13557,27409,17436,32994
⻪ֵ´,GuangHuaJieDaoBanShiChu,211004002,20116,2578,12877,9936,20942,12856,2659,12424,25280,12476,25353
´ֵ´,XinCunJieDaoBanShiChu,211004003,14338,993,8701,6624,12854,8501,2018,8223,16724,8648,17349
ֵ´,ChangZhengJieDaoBanShiChu,211004004,12756,2401,8589,7372,12925,8567,1661,8048,16615,8229,16818
,ShuGuangZhen,211004101,26324,3023,16259,12888,19977,16223,4052,16936,33159,17140,33399
,LanJiaZhen,211004102,13151,1475,8180,5958,13077,8160,2195,8588,16748,8641,16821
ռҽֵ´,SuJiaJieDaoBanShiChu,211005001,12960,2344,8139,7017,13705,8139,1284,8449,16588,8449,16588
ɽֵ´,TuanShanJieDaoBanShiChu,211005002,20546,2999,13173,10404,20362,13160,2539,12831,25991,12911,26084
ƽֵ´,AnPingJieDaoBanShiChu,211005003,16297,1672,10284,7949,13922,10265,2554,10187,20452,10239,20523
,TangHeZhen,211005101,12561,1731,7143,5280,11375,7030,1709,7407,14437,8858,16001
ƽ,AnPingXiang,211005201,8884,1427,5620,4549,7171,5600,1278,5911,11511,5969,11589
»ֵ´,XinHuaJieDaoBanShiChu,211011001,44162,4851,26131,18525,36455,24261,6243,23785,48046,29125,55256
ˮֵ̨´,WangShuiTaiJieDaoBanShiChu,211011002,14239,2012,8808,6694,11975,8758,1678,8936,17694,9121,17929
,QiJiaZhen,211011101,21420,2416,13312,9266,19379,13251,3363,13636,26887,13887,27199
,DongJingLingXiang,211011202,21178,2412,11731,7932,18228,11354,2856,11785,23139,14715,26446
,DongNingWeiXiang,211011204,8681,1075,5604,3840,7442,5595,1266,5399,10994,5418,11022
ɽ,ShouShanZhen,211021100,78417,8144,48655,37806,71986,46558,12375,47210,93768,50281,98936
,LiuErBaoZhen,211021101,53134,6574,33801,23546,57452,33196,9124,34427,67623,35031,68832
С,XiaoTunZhen,211021102,32911,4901,20724,14834,38174,20507,4966,21560,42067,22054,42778
С,XiaoBeiHeZhen,211021103,34947,4507,21815,15116,43774,21813,5894,23486,45299,23533,45348
,HuangNiWaZhen,211021104,27688,3607,17094,9823,33905,16416,4069,17498,33914,18270,35364
ɳ,ShaLingZhen,211021105,33502,4158,21357,11683,40016,21336,5269,21532,42868,21572,42929
կ,TangMaZhaiZhen,211021106,30154,3855,19045,11262,37739,19035,5317,20211,39246,20281,39326
¼,MuJiaZhen,211021107,25952,3461,16363,10435,29996,16336,4065,17018,33354,17115,33478
,LiuHaoZhen,211021108,17455,2473,11156,8045,22010,11153,3090,11847,23000,11862,23018
,HeLanZhen,211021110,15960,2787,10194,6580,19977,10191,2644,11171,21362,11197,21391
¡,LongChangZhen,211021111,9626,1510,6150,3646,11866,6141,1761,6717,12858,6747,12897
˻,BaHuiZhen,211021112,12022,2036,7666,4831,15191,7656,2218,8563,16219,8610,16276
,HanLingZhen,211021113,15416,1944,9617,5435,17734,9607,2733,10137,19744,10476,20093
¡,XingLongZhen,211021114,19924,2450,12501,8357,21337,12501,3143,13014,25515,13016,25517
´,XiaDaHeXiang,211021201,5873,1408,3935,2932,7304,3917,958,4239,8156,4304,8239
,JiDongYuManZuXiang,211021202,13691,2244,8815,5509,17627,8804,2864,9905,18709,9984,18799
ˮ,TianShuiManZuXiang,211021206,15275,2370,9525,5951,18669,9505,2643,10685,20190,10763,20288
ֵ̨´,YanTaiJieDaoBanShiChu,211081001,59332,5060,37119,26798,46617,35815,10085,36218,72033,37358,74477
Žֵ´,WanBaoQiaoJieDaoBanShiChu,211081002,29933,3244,19099,12372,19814,18394,5033,18523,36917,19111,38210
ųӽֵ´,GuChengZiJieDaoBanShiChu,211081003,16088,1913,10421,6257,19609,10414,2802,10372,20786,10382,20803
١,TongErBaoZhen,211081101,33022,3401,20055,14074,34354,19516,5530,21168,40684,21898,41953
,HuaZiZhen,211081102,38342,4651,22270,16333,37502,22148,6052,23853,46001,26775,49045
̨,ZhangTaiZiZhen,211081103,13121,1671,8428,5419,15199,8422,2071,8373,16795,8435,16863
Ҥ,XiDaYaoZhen,211081104,17493,2100,11182,7491,19203,11171,3610,11871,23042,12021,23203
򵩱,ShenDanBaoZhen,211081105,23919,3014,15095,9326,29294,14995,4101,15779,30774,15939,31034
,XiMaFengZhen,211081106,26181,3068,16357,10284,30701,16302,4191,16659,32961,17083,33440
կ,LiuTiaoZhaiZhen,211081107,25844,3265,16111,11051,31281,16083,4484,17071,33154,17482,33593
,LiuHeZiZhen,211081108,13621,1637,8688,5373,16006,8636,2469,8843,17479,9039,17727
޴̨,LuoDaTaiZhen,211081109,21089,2487,13449,8708,24234,13402,3886,13832,27234,14013,27462
,WangJiaZhen,211081110,17848,2142,11078,7723,21906,11076,2936,11825,22901,11848,22926
,DaHeNanZhen,211081111,15347,1898,9880,6553,18086,9871,2549,9878,19749,9914,19794
,WuXingZhen,211081114,30413,3497,19131,11936,38227,19113,5326,20024,39137,20105,39236
ɽ,JiGuanShanXiang,211081205,4854,613,3040,2384,5180,3024,889,3242,6266,3316,6356
ֵ,DongFengJieDao,211102001,11805,1114,7562,5177,7013,7436,1786,6993,14429,7143,14705
ʤֵ,ShengLiJieDao,211102002,38937,3615,24723,16438,28251,24022,6426,23189,47211,24255,48978
ֵ,JianSheJieDao,211102003,19714,1680,12264,8369,14105,11816,3100,11778,23594,12230,24494
ֵ,HongQiJieDao,211102004,28520,3005,17915,12668,19282,17337,4547,17447,34784,18157,36072
ɺӽֵ,LiaoHeJieDao,211102005,27019,2870,16950,12274,19425,16698,4258,16217,32915,17197,34147
ʯͽֵ,ShiYouJieDao,211102006,181,8,103,99,142,103,27,97,200,113,216
ֵ,HuaGongJieDao,211102007,18330,2287,11604,8455,18655,11561,2391,11005,22566,11404,23008
ֵ,TieDongJieDao,211102008,11198,960,6832,4734,5642,6832,1864,7190,14022,7190,14022
˫ʢֵ,ShuangShengJieDao,211102009,9949,1008,6299,4441,8025,6295,1785,6411,12706,6443,12742
˽ֵ,ZhenXingJieDao,211103001,69193,7615,45255,33078,76099,44439,12414,42915,87354,43967,89222
¡ֵ,XingLongJieDao,211103002,63226,5379,38307,27566,52196,36303,8844,35045,71348,39142,77449
ֵ,BoHaiJieDao,211103003,29741,3312,18789,14683,30854,18599,4124,17814,36413,18388,37177
¹ֵ,XinGongJieDao,211103004,13932,2005,8971,6714,12426,8610,2000,8342,16952,8966,17937
¥ֵ,YuLouJieDao,211103005,9460,1529,5969,5113,10280,5963,705,5709,11672,5725,11694
ֵ,YouYiJieDao,211103006,8979,574,4798,3376,8165,4388,900,4290,8678,5655,10453
ֵ,ShuGuangJieDao,211103007,12335,1094,7362,5900,12340,7298,1821,7314,14612,7888,15250
ϲֵ,HuanXiJieDao,211103008,10008,680,6144,4783,10904,6022,1668,5906,11928,6212,12356
ƽֵ,PingAnJieDao,211103009,10702,1242,6791,5398,12246,6759,1351,6290,13049,6504,13295
ֵ,XinShengJieDao,211103010,10180,1425,3879,3176,11160,3852,892,3637,7489,8618,12497
ֵ,HongCunJieDao,211103011,3116,533,2015,1674,3567,1929,373,1890,3819,2007,4022
ֵ,GaoShengJieDao,211103012,6048,380,3552,2915,6542,3488,883,3562,7050,3759,7311
ɽֵ,ShenCaiJieDao,211103013,11530,717,6926,5274,12586,6781,1712,6589,13370,7033,13959
ɽֵ,JinCaiJieDao,211103014,8003,178,4465,3385,8109,4238,1407,4341,8579,5123,9588
Ĳɽֵ,CiCaiJieDao,211103015,5097,333,3030,2446,5056,2924,660,2873,5797,3060,6090
½ֵ,ChuangXinJieDao,211103016,37382,3329,24162,16667,29085,22445,5976,21172,43617,22525,46687
ʢֵ,XingShengJieDao,211103017,25650,1527,15178,9985,18427,13859,4228,13705,27564,16227,31405
˺ֵ,XingHaiJieDao,211103018,42058,2500,24689,17808,19833,24346,7130,25428,49774,26999,51688
,DaWaZhen,211121100,61425,5923,38522,26718,64289,38466,9221,37902,76368,38047,76569
ׯ̨,TianZhuangTaiZhen,211121101,23599,2969,14689,10952,27369,14687,3070,14944,29631,14949,29638
繵,ErJieGouZhen,211121102,21414,1869,13425,8466,24629,13414,3554,13372,26786,13412,26837
,DongFengZhen,211121103,17432,1833,11079,6325,21331,11073,3088,11238,22311,11274,22353
¿,XinKaiZhen,211121104,16334,1838,10284,7362,19572,10278,2636,10461,20739,10524,20808
,TianJiaZhen,211121105,42150,2842,26037,18289,29338,25430,7855,25901,51331,26810,52847
ˮ,QingShuiZhen,211121106,19290,1956,12049,7649,23063,12038,3112,12263,24301,12309,24358
,XinXingZhen,211121107,17361,1956,10971,8146,20145,10941,2995,11292,22233,11341,22312
,XiAnZhen,211121108,19251,2168,12187,7905,24054,12183,3352,12561,24744,12584,24771
,XinLiZhen,211121109,19116,1960,12031,8079,22430,12023,3349,12351,24374,12394,24425
,RongXingZhen,211121110,18473,2011,11444,8527,21147,11435,2552,11522,22957,11592,23036
,WangJiaZhen,211121111,11339,1200,7172,4761,12760,7165,1906,7215,14380,7273,14445
Ƽ,TangJiaZhen,211121112,30434,2980,18998,12615,36615,18955,5029,19412,38367,19445,38443
ƽ,PingAnZhen,211121113,15175,1816,9580,6012,17745,9573,2234,9624,19197,9645,19225
Ȧ,ZhaoQuanHeZhen,211121114,7580,660,4663,3024,8883,4663,1210,4787,9450,4787,9450
ɱ�,LiaoBinKaiFaQu,211121400,1390,5,213,27,0,27,1,21,48,1183,1396
ɳ,ShaLingZhen,211122101,30085,3595,19349,11884,36726,19323,5524,19730,39053,19855,39204
,GaoShengZhen,211122102,22723,2883,14754,9417,27080,14734,4046,14809,29543,14898,29652
,HuJiaZhen,211122103,19620,2534,12684,8088,24251,12675,3453,12859,25534,12923,25607
ʯ,ShiXinZhen,211122104,10200,1632,6600,4642,12615,6593,1522,6735,13328,6754,13354
,DongGuoZhen,211122105,13990,1632,8904,6058,15150,8827,2229,8722,17549,8947,17851
Ȧ,YangJuanZiZhen,211122106,12838,1879,8361,5874,15799,8357,2039,8370,16727,8395,16756
ų,GuChengZiZhen,211122107,14568,1689,9232,5859,17853,9219,2527,9521,18740,9552,18784
ǽ,BaQiangZiZhen,211122108,14494,1599,9385,5972,17777,9374,2632,9308,18682,9340,18725
̫ƽ,TaiPingZhen,211122109,23793,2441,14814,9626,25949,14774,4304,15054,29828,15724,30538
¼,ChenJiaXiang,211122110,17014,2133,11151,7329,19951,11151,3087,11059,22210,11083,22234
ˮ,TianShuiXiang,211122111,10158,1312,6482,4367,11586,6463,1722,6594,13057,6710,13192
,WuJiaXiang,211122205,8835,964,5589,3851,9985,5570,1532,5709,11279,5742,11331
½,LuJiaXiang,211122206,9412,1041,6243,4289,10761,6206,1869,5996,12202,6079,12322
,DaHuangXiang,211122208,11402,1634,7530,4496,14360,7527,1991,7467,14994,7497,15027
ɽֳ,PanShanXianLinChang,211122400,431,51,279,192,296,279,57,260,539,260,539
ֵ´,HongQiJieDaoBanShiChu,211202001,34592,5233,22436,16990,34584,22131,4165,21164,43295,21554,43990
˽ֵ,GongRenJieDao,211202002,42568,6155,27190,19826,46566,26931,4692,26080,53011,26225,53415
ֵ,TieXiJieDao,211202003,37235,4927,22991,17126,38272,22937,4168,23079,46016,23339,46330
ͭӽֵ,TongZhongJieDao,211202004,32784,3798,20859,15708,31276,20791,4630,20297,41088,20353,41212
ӽֵ,ChaiHeJieDao,211202005,43126,4586,27187,19808,41095,27086,5918,26342,53428,26443,53630
붫ֵ,LingDongJieDao,211202006,15929,2518,9080,5962,11903,7462,1282,7222,14684,10649,19729
ɺֵ,LiaoHaiJieDao,211202007,34281,3487,21349,15404,37212,21308,4487,20804,42112,20906,42255
ɽ,LongShanXiang,211202201,19958,2188,12389,8444,16503,11950,2896,12189,24139,12653,25042
뾭ÿ,TieLingJingJiKaiFaQu,211202401,29748,2966,18655,13357,23448,18273,4759,18413,36686,18818,37473
ֵ,HongQiJieDao,211204001,22188,2874,14078,10290,22713,13664,3094,13732,27396,14078,28156
ֵ,XiangYangJieDao,211204002,14175,2097,8622,6522,13856,8526,1761,8268,16794,9411,18033
,ZhangXiangZhen,211204101,14167,1494,8635,5622,15435,8618,2272,9228,17846,9298,17933
ľ,YangMuLinZiZhen,211204102,14059,1557,8789,5565,16610,8752,2327,9018,17770,9154,17943
,NieJiaManZuXiang,211204203,5932,839,3879,2579,7748,3879,1161,4053,7932,4053,7932
̨,XinTaiZiZhen,211221101,25030,3241,15730,11823,27574,15683,3931,16295,31978,16472,32202
,AJiZhen,211221102,18695,2338,11760,7914,23438,11758,3166,12426,24184,12439,24199
ƽ,PingDingBaoZhen,211221103,13113,1511,8039,5308,16116,8039,1952,8505,16544,8537,16576
,DaDianZiZhen,211221104,15800,2411,9816,7082,20236,9775,2642,10882,20657,11037,20853
,FanHeZhen,211221105,52254,4381,31828,18067,50304,25844,6994,26483,52327,31801,63629
,YaoBaoZhen,211221106,16719,2040,10224,7327,18237,10158,2603,10823,20981,11138,21362
,ZhenXiBaoZhen,211221107,19530,2326,12138,8234,22705,12126,3213,12869,24995,12931,25069
ţ,CaiNiuZhen,211221108,22687,2712,14030,9149,27973,14027,3691,14963,28990,15060,29090
ǧ,LiQianHuZhen,211221109,26160,3331,16435,11031,33431,16424,4877,17865,34289,17933,34368
˫,ShuangJingZiXiang,211221203,16791,1868,10605,6777,20518,10605,2892,10945,21550,10946,21551
ܹ,XiongGuanTunXiang,211221204,12069,1733,7580,5384,14344,7560,2030,8198,15758,8252,15832
,HengDaoHeZiManZuXiang,211221206,8678,1274,5487,3895,10917,5478,1623,5968,11446,6088,11575
ɽ,JiGuanShanXiang,211221208,7057,1209,4504,3471,9216,4503,1253,5009,9512,5015,9519
կ,BaiQiZhaiManZuXiang,211221209,7433,1042,4822,3300,9770,4822,1613,5265,10087,5266,10088
,ZhongChuChang,211221401,2498,338,1492,1259,2682,1492,296,1594,3086,1640,3132
,XiFengZhen,211223100,56544,6824,35647,27780,61773,34912,7892,34964,69876,35613,71260
ƽ,PingGangZhen,211223101,11831,1080,7381,4853,14551,7381,2016,7543,14924,7546,14927
۬ҵ,GaoJiaDianZhen,211223102,19549,1909,12213,7744,24647,12213,3476,12719,24932,12721,24934
Ȫ,LiangQuanZhen,211223103,9803,910,6091,3870,12246,6091,1766,6384,12475,6388,12479
,ZhenXingZhen,211223104,10421,1042,6543,3939,13012,6543,1922,6842,13385,6842,13385
,AnMinZhen,211223105,12335,1185,7609,5123,14694,7603,2211,8081,15684,8122,15731
,TianDeZhen,211223106,14942,1437,9222,5395,18383,9222,2516,9673,18895,9673,18895
ľ,FangMuZhen,211223107,14289,1553,8963,5798,17989,8963,2557,9436,18399,9436,18399
Ȼ,TaoRanXiang,211223201,7446,782,4618,3081,8980,4614,1269,4852,9466,4879,9497
,BaiYuXiang,211223203,10437,1004,6520,4037,13218,6520,1872,6791,13311,6793,13313
,DeXingManZuXiang,211223204,6330,626,3855,2376,7805,3855,1028,4129,7984,4129,7984
,DiaoYuXiang,211223205,6233,706,3980,2544,8008,3980,1192,4151,8131,4151,8131
,MingDeManZuXiang,211223206,6869,737,4294,2607,8609,4294,1089,4401,8695,4401,8695
ƽ,ChengPingManZuXiang,211223209,8100,877,5136,2926,10303,5136,1521,5362,10498,5362,10498
¡,HeLongManZuXiang,211223211,10389,1020,6529,3989,13047,6519,1946,6750,13269,6826,13355
Ӫ,YingChangManZuXiang,211223212,6024,556,3676,2446,7419,3676,1073,3977,7653,3977,7653
,JinXingManZuXiang,211223213,9418,811,5814,3544,11830,5814,1770,6185,11999,6185,11999
,GengKeXiang,211223214,7445,718,4638,2845,9305,4636,1337,4846,9482,4862,9500
ͼ,ChangTuZhen,211224100,93438,11137,58243,42855,103296,55958,12400,56149,112107,58732,116975
ϳ,LaoChengZhen,211224101,26135,4120,16997,13322,31800,16997,4250,17506,34503,17508,34505
,BaMianChengZhen,211224102,44191,4854,28385,18022,51448,27491,7505,27413,54904,28165,56550
,SanJiangKouZhen,211224103,19621,2234,13179,8194,23062,13179,4489,13163,26342,13165,26344
,JinJiaZhen,211224104,18358,2445,12131,7339,23481,12129,3602,12205,24334,12274,24405
,BaoLiZhen,211224105,28683,3327,18840,11129,35990,18836,6353,19409,38245,19523,38363
Ȫͷ,QuanTouZhen,211224106,12493,1660,8107,5733,14904,8107,2297,8343,16450,8343,16450
˫,ShuangMiaoZiZhen,211224107,11456,1605,7617,5529,13510,7617,2161,7605,15222,7605,15222
,LiangZhongQiaoZhen,211224108,22120,2625,14274,9294,27613,14272,4334,14741,29013,14805,29079
ٺ,MaZhongHeZhen,211224109,12549,1504,8217,5614,15179,8216,2510,8343,16559,8346,16563
ëҵ,MaoJiaDianZhen,211224110,23973,2901,15531,10244,29502,15505,4559,15790,31295,15902,31433
ƽ,LaoSiPingZhen,211224111,12924,1311,8272,5362,15004,8263,2663,8614,16877,8626,16898
,DaWaZhen,211224112,17650,2060,11374,7128,22129,11374,3377,11688,23062,11713,23087
ͷ,TouDaoZhen,211224113,13248,1633,9069,5876,17113,9069,3152,8964,18033,8964,18033
y,CiLuShuZhen,211224114,14644,1665,9493,5773,18684,9489,2846,9611,19100,9662,19155
,FuJiaZhen,211224115,19914,2025,13030,7628,24704,13029,4489,13379,26408,13398,26428
ĺ,SiHeZhen,211224117,11700,1596,8000,5147,15210,7999,2524,7796,15795,7820,15820
,ZhaoYangZhen,211224118,13116,1521,8577,5384,16791,8577,2708,8768,17345,8768,17345
,GuYuShuZhen,211224119,22532,2551,15223,8940,29090,15223,5918,15778,31001,15778,31001
߼,QiJiaZiZhen,211224120,11370,1334,7671,4578,14371,7670,2717,7732,15402,7750,15421
,DongGaZhen,211224121,12277,1521,8178,5208,15520,8178,2627,8203,16381,8247,16425
,SiMianChengZhen,211224122,14157,1682,9308,6126,17759,9308,2979,9510,18818,9510,18818
ǰ˫,QianShuangJingZhen,211224123,16366,1857,10870,6416,20852,10870,3756,11109,21979,11109,21979
ͨ,TongJiangKouZhen,211224124,18671,2214,11902,7552,23291,11902,3479,12462,24364,12462,24364
ļ,DaSiJiaZiZhen,211224125,14598,2032,9702,6064,18673,9684,2956,9732,19416,9884,19586
ҵ,QuJiaDianZhen,211224126,20260,2210,13302,7961,25626,13298,4675,13809,27107,13843,27145
,DaXingXiang,211224204,10504,1303,6938,4394,13258,6938,2179,7048,13986,7048,13986
ʮ˼,ShiBaJiaZiXiang,211224205,11753,1443,7627,4933,14628,7623,2269,7813,15436,7838,15465
Ҥ,HouYaoXiang,211224209,10413,1342,6910,4284,13220,6908,2181,7005,13913,7026,13936
,ChangFaXiang,211224211,8881,1076,5951,3399,11200,5951,2004,6008,11959,6010,11961
̫ƽ,TaiPingXiang,211224212,9872,1223,6478,4285,12531,6478,2147,6763,13241,6764,13242
¶̨,XiaErTaiXiang,211224213,10130,1291,6620,4788,12783,6620,2102,6903,13523,6903,13523
ƽ,PingAnBaoXiang,211224216,11805,1394,7698,4763,14512,7695,2391,7860,15555,7892,15590
ũ,SanJiangKouNongChang,211224401,1946,287,1339,942,1655,1339,404,1293,2632,1298,2637
ũ,BaoLiNongChang,211224402,4427,565,2936,1696,5520,2935,886,2931,5866,2942,5878
ũ,XinXiangNongChang,211224403,2757,338,1817,1174,3092,1815,512,1790,3605,1790,3607
ֳ,FuJiaLinChang,211224404,4614,510,3017,1780,5547,3017,1052,3159,6176,3159,6176
ţ�,MangNiuMaChang,211224405,615,103,408,310,754,408,101,411,819,411,819
ũ,LiangJiaZiNongChang,211224406,10173,1495,6835,4444,13214,6834,2042,6854,13688,6875,13710
أֵֽ,WuShuJieJieDao,211281001,83992,9105,51576,38929,99601,51525,10565,51824,103349,52086,103662
ɽֵ,DiaoBingShanJieDao,211281002,45143,5000,27799,20935,42797,27425,5870,27946,55371,28214,56013
,XiaoMingZhen,211281102,17958,2647,11370,8481,20339,11362,2442,11653,23015,11677,23047
,DaMingZhen,211281103,22891,3685,14575,10688,27718,14575,2968,14913,29488,14969,29544
,XiaoNanZhen,211281105,23199,2956,14082,10260,26284,14043,3010,14934,28977,15083,29165
³ǽֵ,XinChengJieDao,211282001,154141,18592,93698,79461,137915,92208,18916,95726,187934,97951,191649
ϳǽֵ,LaoChengJieDao,211282002,19150,2406,11752,8945,21429,11367,2634,11912,23279,12438,24190
˿ֵ,XingKaiJieDao,211282003,22204,2144,13911,9217,24678,13906,3647,14063,27969,14084,27995
Զ,WeiYuanBaoZhen,211282102,16466,1821,10578,6217,20887,10578,3204,10913,21491,10913,21491
Ʊ,QingYunBaoZhen,211282103,17171,1923,10831,7482,20134,10726,2860,11017,21743,11123,21954
й,ZhongGuZhen,211282104,18468,2098,11613,7607,21211,11608,3222,12049,23657,12175,23788
˿,BaKeShuZhen,211282105,17594,2035,11198,7414,22460,11193,3199,11629,22822,11630,22828
,JinGouZiZhen,211282106,18443,1792,11469,7115,22843,11469,3227,11993,23462,11993,23462
˱,BaBaoZhen,211282107,21234,2289,13415,8706,25194,13415,3517,13625,27040,13625,27040
ҵ,YeMinZhen,211282108,14708,1515,9185,5514,17842,9185,2439,9477,18662,9477,18662
,LianHuaZhen,211282109,9460,1181,5960,4121,11958,5960,1608,6289,12249,6289,12249
ɽ,KaoShanZhen,211282110,12798,1858,8239,5643,16474,8238,2599,9007,17245,9016,17255
Ƕ,ChengDongXiang,211282201,11328,1225,7313,4692,14256,7312,2218,7458,14770,7458,14771
կ,MaJiaZhaiXiang,211282207,7688,1045,5026,3305,10159,5024,1729,5436,10460,5436,10462
Ϸʵ,ShangFeiDiManZuXiang,211282210,7158,792,4472,2804,9051,4472,1376,4853,9325,4854,9326
·ʵ,XiaFeiDiManZuXiang,211282211,10250,1280,6381,3941,13369,6381,1984,7133,13514,7133,13514
կ,HuangQiZhaiManZuXiang,211282212,9891,1324,6152,3993,12780,6152,2009,7072,13224,7072,13224
ɽ,SongShanBaoXiang,211282213,13106,1773,8248,5382,16927,8248,2405,9032,17280,9036,17284
̨,LiJiaTaiXiang,211282216,11295,1361,7340,4965,14519,7333,2324,7630,14963,7640,14980
ַ,LinFengManZuXiang,211282217,4746,629,3158,2398,6231,3157,976,3190,6347,3193,6351
,SanJiaZiXiang,211282406,10380,1084,6430,4215,12595,6409,1685,6693,13102,6719,13149
ֵ,NanTaJieDao,211302001,19626,2804,13070,9089,19825,12667,2937,12055,24722,12297,25367
ֵ,BeiTaJieDao,211302002,16748,2051,11573,7049,12004,9230,2167,8805,18035,9393,20966
ǰֵ,QianJinJieDao,211302003,30295,3358,20025,14362,25580,19698,5705,19148,38846,19333,39358
ӽֵ,LingHeJieDao,211302004,17458,2099,11183,8383,17057,11111,2964,11007,22118,11338,22521
ֵ,GuangMingJieDao,211302005,28465,4254,19172,13595,30839,18760,4688,17952,36712,18235,37407
ֵ,LingFengJieDao,211302006,16503,1057,10158,4699,11049,7088,2637,7005,14093,10039,20197
ɽֵ,LongShanJieDao,211302007,39781,3759,24854,15605,33685,21564,5604,21346,42910,24290,49144
վϽֵ,ZhanNanJieDao,211302008,36593,3366,23377,16330,30250,22699,6976,22481,45180,23558,46935
ֵ,HongQiJieDao,211302009,34444,3826,22673,16512,28299,22378,6742,22084,44462,22339,45012
౱ֵ,YanBeiJieDao,211302010,38384,4383,25291,18035,29396,25010,7134,24427,49437,24610,49901
һ,TaoHuaTuZhen,211302100,12978,1795,8417,5542,16521,8415,2460,8783,17198,8816,17233
,TaLaGaoZhen,211302101,14325,1862,9436,5912,17137,9422,3003,9716,19138,9754,19190
Ӫ,ChangBaoYingZiXiang,211302205,3991,597,2663,1818,4875,2649,865,2752,5401,2790,5453
,SunJiaWanXiang,211302206,11118,1675,7507,4579,14343,7503,2608,7891,15394,7894,15401
ֵ,XiangYangJieDao,211303001,6182,942,3938,2500,7087,3261,829,3160,6421,4015,7953
ɽֵ,BanLaShanJieDao,211303002,578,133,394,316,632,394,67,384,778,384,778
ɽֵ,MaShanJieDao,211303003,1834,499,1300,1122,1916,1280,194,1208,2488,1227,2527
»ֵ,XinHuaJieDao,211303004,15559,1589,9958,7239,10264,9662,2954,9675,19337,10144,20102
ֵ,HaiLongJieDao,211303005,15077,1253,9787,6661,10942,9764,3416,9835,19599,9959,19746
Ȫֵ,KaiFaQuLongQuanJieDao,211303070,26924,2469,17098,10824,21670,16368,5629,16839,33207,17924,35022
ߵȪ,QiDaoQuanZiZhen,211303101,13597,1547,8786,5553,14899,8784,2825,9183,17967,9183,17969
Ӫ,XiDaYingZiZhen,211303102,21785,2199,12445,7600,23571,12044,4305,12426,24470,15844,28289
ٶ,ZhaoDouBaZhen,211303103,14958,1858,9959,5985,19327,9934,3293,10127,20061,10150,20109
ƽ,DaPingFangZhen,211303105,17147,2381,11041,7022,21888,11036,3247,11679,22715,11734,22775
,BianZhangZiXiang,211303201,12662,1863,8441,5522,15418,8436,2649,8716,17152,8733,17174
,LianHeXiang,211303203,13412,2266,9095,6600,17637,9091,2980,9521,18612,9563,18658
޳,BoLuoChiZhen,211321102,12289,1777,8274,5598,16300,8273,2863,8644,16917,8655,16929
ľͷ,MuTouChengZiZhen,211321103,17810,2516,12134,7771,24053,12131,4512,12669,24800,12704,24838
ʮ,ErShiJiaZiZhen,211321104,22744,3112,15055,9496,30354,15052,5294,16060,31112,16095,31150
ɽ,YangShanZhen,211321105,21685,3735,15748,9911,30321,15716,6138,15775,31491,15810,31558
,LiuJiaZiZhen,211321106,15407,2390,10629,6627,21155,10624,4171,11332,21956,11339,21968
߷,WaFangZiZhen,211321107,15029,1942,10145,6194,19057,10140,3738,10541,20681,10564,20709
,DaMiaoZhen,211321108,12112,1585,8306,5311,15770,8302,3306,8640,16942,8697,17003
,LiuChengZhen,211321109,34224,3536,22521,13375,38413,21105,7479,21280,42385,22718,45239
˫,NanShuangMiaoXiang,211321204,19080,2809,13165,7247,26056,13165,4674,13398,26563,13398,26563
ɽ,GuShanZiXiang,211321206,12209,1881,8287,5526,15866,8267,2836,8539,16806,8639,16926
,XiWuJiaZiXiang,211321211,6471,1128,4616,3243,9083,4615,1703,4680,9295,4686,9302
,BeiGouMenZiXiang,211321212,3852,675,2760,2069,5185,2740,939,2669,5409,2706,5466
,YangShuWanXiang,211321213,5223,878,3534,2516,6980,3532,1187,3730,7262,3754,7288
,DongDaDaoXiang,211321214,7758,1288,5394,3737,10528,5393,1958,5601,10994,5610,11004
˶ɹ,WuLanHeShuoMengGuZuXiang,211321215,5588,942,4029,2822,7640,4028,1434,3913,7941,3935,7964
̨,TaiZiXiang,211321216,11457,1764,7831,5596,15273,7830,2883,8261,16091,8273,16104
ʤ,ShengLiXiang,211321218,20962,3261,15140,9644,29448,15131,6230,15295,30426,15313,30453
,DongDaTunXiang,211321220,9968,1473,6847,4270,13620,6835,2476,7049,13884,7070,13917
ɹ,SongLingMenMengGuZuXiang,211321221,6481,987,4412,3026,8539,4411,1546,4563,8974,4602,9014
Ӫ,GenDeYingZiXiang,211321222,10635,1823,7414,4575,14535,7405,2947,7979,15384,7991,15405
Ӫ,XiYingZiXiang,211321224,6083,1025,4456,2870,8435,4451,1735,4290,8741,4387,8843
ߵ,QiDaoLingXiang,211321225,14500,2538,10500,7093,20417,10497,3883,10414,20911,10421,20921
ļ,BeiSiJiaZiXiang,211321228,15726,2289,10862,6330,21886,10861,4527,11664,22525,11680,22542
Ӫ,WangYingZiXiang,211321230,7084,1263,4979,3153,9827,4976,1964,5328,10304,5332,10311
ţӪ,HeiNiuYingZiXiang,211321231,10427,1543,7301,4383,14556,7300,2922,7579,14879,7591,14892
־,ShangZhiXiang,211321232,6822,1149,4832,2847,9421,4824,1936,5069,9893,5075,9907
Ӫ,ChangZaiYingZiXiang,211321233,9988,1456,6987,4085,13955,6981,2945,7391,14372,7402,14389
Ӫؼּҵũ,GuoYingZhaoYangXianJiaJiaDianNongChang,211321400,4476,702,3197,2531,6008,3185,991,2961,6146,2972,6169
Ҷٽֵ,YeBaiShouJieDao,211322001,23363,2283,15262,10993,21649,15147,4811,15015,30162,15195,30457
ɽֵ,HongShanJieDao,211322002,34076,2867,20995,13163,29504,18172,5513,18053,36225,21461,42456
Ͻֵ,TieNanJieDao,211322003,14325,2248,9292,7275,15998,9288,2120,9381,18669,9401,18693
ٽֵ,WanShouJieDao,211322004,27851,2619,17284,10727,24702,15845,5233,16273,32118,18419,35703
ɽֵ,FuShanJieDao,211322005,12814,1330,8488,5418,14542,8477,3158,8775,17252,8814,17302
µ,ZhuLuKeZhen,211322101,13343,2226,9586,6601,17906,9582,3221,9184,18766,9204,18790
ƽ,JianPingZhen,211322102,13604,1720,9130,6488,17456,9129,3023,9196,18325,9217,18347
ˮ,HeiShuiZhen,211322103,15204,1580,9756,5974,18950,9755,3221,10242,19997,10249,20005
,KaLaQinZhen,211322104,12309,1918,8348,6107,16184,8332,2794,8501,16833,8673,17021
ʮ,BeiErShiJiaZiZhen,211322105,8614,914,5557,4068,10652,5557,1632,5593,11150,5603,11160
ɳ,ShaHaiZhen,211322106,19213,2446,12540,8366,24937,12540,4146,13248,25788,13265,25805
,HaLaDaoKouZhen,211322108,9168,993,6069,4172,11793,6069,2186,6278,12347,6278,12347
,YuShuLinZiZhen,211322109,19223,2877,13411,9910,25357,13391,4472,13069,26460,13161,26572
Ϲٵ,LaoGuanDiZhen,211322110,6145,814,4154,2710,8149,4154,1446,4251,8405,4251,8405
,ShenJingZhen,211322111,10541,1274,6873,5025,13289,6852,2284,7134,13986,7226,14099
,KuiDeSuZhen,211322112,11771,1494,7867,5333,15404,7864,2656,8039,15903,8054,15921
С,XiaoTangZhen,211322113,11961,1440,7896,5202,15550,7888,2642,8067,15955,8147,16043
�,MaChangZhen,211322114,9339,1113,6065,4229,11962,6064,1970,6345,12409,6357,12422
¡,ChangLongZhen,211322115,10022,1211,6522,4060,13047,6518,2299,7001,13519,7010,13532
żӪ,ZhangJiaYingZiZhen,211322117,9043,1167,6117,4262,11832,6103,1915,5994,12097,6008,12125
ɽ,QingFengShanZhen,211322118,8955,1095,5731,3870,10800,5715,2075,6055,11770,6394,12125
,QingSongLingXiang,211322205,5131,980,3674,2862,6940,3674,1064,3497,7171,3501,7175
,YangShuLingXiang,211322206,5340,767,3510,2622,6935,3508,1045,3617,7125,3642,7152
޸,LuoFuGouXiang,211322209,6385,815,4261,3138,8433,4253,1383,4317,8570,4322,8583
չӪ,ShaoGuoYingZiXiang,211322211,5016,571,3352,2172,6428,3352,1220,3455,6807,3455,6807
̫ƽׯ,TaiPingZhuangXiang,211322213,11645,1325,7617,4912,15183,7612,2640,7955,15567,7993,15610
ɽ,BaiShanXiang,211322214,8439,1010,5606,3721,10996,5606,1818,5654,11260,5661,11267
ɹ,SanJiaMengGuZuXiang,211322218,18777,2241,12163,7329,24340,12028,3847,12508,24536,12702,24865
ɹ,YiChengGongXiang,211322220,4680,525,3003,2039,6033,3002,974,3169,6171,3176,6179
˼ҹӪũ,BaJiaGuoYingNongChang,211322400,6884,770,4388,2791,8889,4388,1402,4668,9056,4668,9056
ˮӪũ,ReShuiGuoYingXuMuNongChang,211322401,7084,757,4452,2885,8913,4452,1572,4943,9395,4961,9413
,DaChengZiZhen,211324100,63668,6322,41986,28635,57781,38139,13255,36935,75074,41259,83245
ϹӪ,NanGongYingZiZhen,211324101,16289,2391,10823,6771,21214,10809,3286,11106,21915,11143,21966
ɽ,ShanJuZiZhen,211324102,10198,1673,7308,5089,13798,7307,2566,7124,14431,7129,14437
,NanShaoZhen,211324103,7605,1114,5181,3405,9538,5175,1579,5096,10271,5117,10298
Ӫ,GongYingZiZhen,211324104,9116,1423,6148,4664,11101,6145,1992,6354,12499,6383,12531
,BaiTaZiZhen,211324105,15287,2459,10577,7484,20624,10572,3658,10818,21390,10827,21404
,ZhongSanJiaZhen,211324106,10320,1243,6637,4544,12089,6613,2235,6966,13579,7161,13798
ү,LaoYeMiaoZhen,211324107,13120,1955,8693,5781,17031,8675,2860,9108,17783,9242,17935
Ӫ,LiuGuanYingZiZhen,211324108,6853,1320,4690,3380,8948,4663,1338,4719,9382,4821,9511
ƽ,PingFangZiZhen,211324109,16307,2444,10716,7013,21107,10700,3325,11240,21940,11360,22076
ʮ±,ShiErDeBaoZhen,211324110,11007,1616,7435,4791,14555,7433,2579,7765,15198,7767,15202
,YouZhangZiXiang,211324204,5483,954,4018,2749,7646,4018,1584,3997,8015,4003,8021
,DongShaoXiang,211324205,9347,1402,6398,4154,12120,6394,1991,6334,12728,6342,12740
ǹ,YangJiaoGouXiang,211324206,8889,1775,6406,4608,12191,6401,1908,6163,12564,6166,12572
ݳ,CaoChangXiang,211324207,4576,746,3095,2196,5917,3089,905,3112,6201,3132,6227
Ӫ,KunDouYingZiXiang,211324210,6369,978,4330,2965,8397,4329,1421,4433,8762,4438,8768
Ӫ,DaYingZiXiang,211324211,5099,914,3475,2418,6807,3475,1100,3622,7097,3638,7113
¡ׯ,XingLongZhuangXiang,211324212,9726,1558,6646,4820,12278,6641,1988,6554,13195,6626,13272
,GanZhaoXiang,211324213,7833,1352,5550,3815,10386,5540,1797,5399,10939,5432,10982
Ի,WoHuGouXiang,211324214,5097,1062,3441,2741,6746,3440,911,3627,7067,3629,7070
ˮȪ,ShuiQuanXiang,211324215,9787,1546,6585,4384,12564,6579,1974,6677,13256,6722,13307
Ӫٴũ,GuoYingGuanDaHaiNongChang,211324400,1696,296,1183,871,2183,1181,338,1132,2313,1147,2330
ұ칤ҵ԰,YeJinZhuZaoGongYeYuanQu,211324401,11792,1324,7461,5548,13296,7380,2498,7558,14938,8153,15614
ǹؽֵ,ChengGuanJieDao,211381001,12271,1171,7605,5278,7666,6310,1369,6150,12460,7206,14811
ɽֵ,NanShanJieDao,211381002,35173,4729,22696,17346,33835,21191,4642,20600,41791,21848,44544
ɽֵ,GuanShanJieDao,211381003,12599,2719,8431,8113,14497,8412,1310,8169,16581,8197,16628
űֵ,QiaoBeiJieDao,211381004,3120,456,1971,1664,2232,1970,447,2034,4004,2052,4023
ֵ,SanBaoJieDao,211381005,6768,1529,4542,4150,7781,4530,750,4491,9021,4505,9047
ֵ̨,TaiJiJieDao,211381006,12078,2371,7949,7369,14262,7948,1292,7792,15740,7792,15741
˫ӽֵ,ShuangHeJieDao,211381008,16959,2916,11122,9367,16910,11122,2194,10946,22068,10947,22069
Ӫ,XiGuanYingZhen,211381101,17193,2328,11283,7992,21657,11276,3442,11628,22904,11680,22963
,DaBanZhen,211381102,4719,882,3082,2269,5395,3080,727,3242,6322,3246,6328
԰,ShangYuanZhen,211381103,9948,1808,6711,4533,12655,6697,1825,6783,13480,6870,13581
,BaoGuoLaoZhen,211381104,14959,2184,9849,6916,18052,9828,2856,10010,19838,10150,19999
ڳ,HeiChengZiZhen,211381105,12792,1768,8335,5400,14109,8334,2319,8523,16857,8544,16879
䷿,WuJianFangZhen,211381107,25080,3288,16248,11228,24063,16182,4274,16227,32409,16394,32642
̨,TaiJiZhen,211381108,12612,1820,8169,5609,11047,8125,1896,8111,16236,8159,16328
,ChangGaoXiang,211381201,7656,1128,4941,3198,9683,4941,1355,5177,10118,5198,10139
Ӫ,ChangHeYingXiang,211381202,6124,1052,4069,2757,7995,4069,1115,4213,8282,4222,8291
С,XiaoTaZiXiang,211381203,6042,1215,4194,2954,7989,4194,1138,4189,8383,4201,8395
Ӫɹ,MaYouYingMengGuZuXiang,211381204,11134,1526,7376,4756,14310,7374,2330,7547,14921,7614,14990
ɹӪ,MengGuYingXiang,211381205,9585,1625,6357,4859,11829,6355,1763,6597,12952,6616,12973
Ȫ,QuanJuYongXiang,211381206,8651,1392,5814,3846,11115,5806,1653,5859,11665,5882,11696
,DaSanJiaXiang,211381207,11102,1530,7264,5652,13324,7261,2034,7373,14634,7402,14666
Ӫ,DongGuanYingXiang,211381208,14005,1882,9327,6594,17459,9281,3051,9297,18578,9611,18938
̶,LongTanXiang,211381210,12115,1590,8007,5768,14754,7953,2680,8033,15986,8378,16385
,HaErNaoXiang,211381212,10935,1789,7405,5173,14456,7403,2219,7534,14937,7538,14943
ϰ˼,NanBaJiaZiXiang,211381213,5564,996,3705,2687,6989,3704,909,3750,7454,3764,7469
¼Ӫ,ZhangJiYingXiang,211381214,6402,1131,4281,3140,8224,4280,1160,4405,8685,4412,8693
Ӫ,SanBaoYingXiang,211381215,3996,910,2657,2247,5348,2657,708,2950,5607,2957,5614
ͼӪ,BaTuYingXiang,211381216,8045,1571,5498,3960,10937,5497,1791,5902,11399,5909,11407
̨Ӫ,TaiJiYingXiang,211381218,8348,1080,5585,3597,10704,5585,1785,5619,11204,5628,11213
,BeiTaXiang,211381219,9015,1097,6025,4348,11346,6019,2103,6125,12144,6190,12215
¦ҵ,LouJiaDianXiang,211381220,9790,1280,6355,4515,11940,6319,2016,6461,12780,6731,13086
ļ,BeiSiJiaXiang,211381221,6740,931,4366,3309,8730,4362,1325,4586,8948,4630,8996
ˮɹ,LiangShuiHeMengGuZuXiang,211381223,4497,714,2897,2076,4976,2895,679,2943,5838,2993,5890
,SanBaoXiang,211381228,13265,1994,8550,6821,14355,8546,2017,8707,17253,8726,17276
˳¹Ӫũ,XingShunDeGuoYingNongChang,211381400,2272,311,1502,913,2898,1502,449,1530,3032,1530,3032
¸ÿ,XiaFuJingJiKaiFaQu,211381470,2787,445,1814,1412,3062,1809,474,1857,3666,1892,3706
ɽر,DaHeiShanTeBieXingZhengGuanLiQu,211381471,430,60,276,181,504,272,78,275,547,292,568
ǽֵ,DongChengJieDao,211382001,18319,2011,12066,8150,15704,11894,4372,12288,24182,12636,24702
ֵֽ,BeiJieJieDao,211382002,28065,2658,18142,11992,21726,17503,5798,17590,35093,18379,36521
Ͻֵֽ,NanJieJieDao,211382003,50266,3965,22542,15509,33589,21697,6657,21595,43292,38346,60888
豱ֵ,LingBeiJieDao,211382004,23267,2694,14581,10967,21802,14430,3831,14464,28894,15211,29792
ˮֵ,ReShuiTangJieDao,211382006,1678,210,1147,826,2187,1147,424,1165,2312,1165,2312
Դֵ,XingYuanJieDao,211382007,7014,1036,4752,3324,8432,4741,1624,4882,9623,4922,9674
ɽֵ,HongShanJieDao,211382008,6335,799,4343,2611,7842,4341,1737,4497,8838,4528,8871
ǹؽֵ,ChengGuanJieDao,211382009,20678,1928,13072,7698,18060,11729,4164,12250,23979,13698,26770
Ԫ,WanYuanDianZhen,211382101,8654,1137,5827,3679,11246,5826,2142,6083,11909,6106,11933
,SongZhangZiZhen,211382102,19057,2563,12838,8714,25160,12829,4671,13435,26264,13453,26291
ʮ,SanShiJiaZiZhen,211382103,24769,3182,16616,11410,32214,16616,5964,17254,33870,17299,33915
,YangZhangZiZhen,211382104,3331,410,2140,1676,3948,2127,622,2106,4233,2223,4363
,DaoErDengZhen,211382105,16322,2130,10680,6848,20802,10674,3350,11106,21780,11122,21802
,SongLingZiZhen,211382106,13353,2102,9429,6007,17877,9426,3574,9575,19001,9600,19029
ĹӪ,SiGuanYingZiZhen,211382107,13949,1924,9462,6124,18217,9456,3581,9973,19429,9992,19454
,GouMenZiZhen,211382108,17861,2491,12467,7577,23841,12467,4986,12869,25336,12871,25338
С,XiaoChengZiZhen,211382110,11758,1526,7785,5099,15174,7784,2817,8303,16087,8316,16101
ĺϵ,SiHeDangZhen,211382111,21915,2897,14782,9009,29115,14778,5782,15770,30548,15812,30594
,WuLanBaiZhen,211382113,6988,1096,4765,3155,9278,4764,1594,4910,9674,4913,9678
,DaiWangZhangZiXiang,211382204,7200,1013,4909,3436,9551,4909,1748,5045,9954,5052,9961
,LiuZhangZiXiang,211382205,6297,1110,4404,2928,8426,4401,1420,4420,8821,4423,8827
ǰ,QianJinXiang,211382206,4239,764,3045,1975,5741,3045,998,2951,5996,2956,6001
ӱ,DaHeBeiXiang,211382207,11336,1900,7651,4931,15226,7651,2717,8302,15953,8302,15953
,SanDaoHeZiXiang,211382208,10641,1705,7582,5312,14443,7582,2647,7394,14976,7411,14993
ţӪ,NiuYingZiXiang,211382209,11037,1599,7649,4858,15291,7646,3195,8168,15814,8182,15831
¯,BeiLuXiang,211382210,10060,1540,6954,4828,13381,6954,2419,7060,14014,7065,14019
߷,WaFangDianXiang,211382211,8688,1289,5886,4089,11440,5882,2103,6180,12062,6194,12080
,SanJiaZiXiang,211382217,22118,2920,15309,8967,29944,15305,6342,16050,31355,16071,31380
ү,FoYeDongXiang,211382219,7244,1180,5318,3708,10087,5317,2062,5159,10476,5168,10486
ӿ,HeKanZiXiang,211382220,9162,1272,6427,4089,12411,6427,2667,6664,13091,6674,13101
ɽֵ,LianShanJieDao,211402001,29087,3265,18953,14541,16141,18886,4640,17978,36864,18039,36992
վǰֵ,ZhanQianJieDao,211402002,19047,2417,12500,9831,18113,12396,2873,11778,24174,11837,24337
ֵ,BoHaiJieDao,211402003,30383,3834,20327,14694,30051,20229,5223,19065,39294,19113,39440
˹ֵ,XingGongJieDao,211402004,34577,3765,22057,16224,27491,21124,4583,20511,41635,20868,42925
ʯͽֵ,ShiYouJieDao,211402005,15339,3051,10624,8697,16466,10614,2102,9741,20355,9868,20492
ֵ,HuaGongJieDao,211402006,39916,6855,26702,20724,42876,26616,5542,25514,52130,25611,52313
ֵ,HuaJiJieDao,211402007,20708,3165,13403,10377,19890,13281,3013,12690,25971,13483,26886
ˮֵ,ShuiNiJieDao,211402008,12094,1843,7986,6001,11994,7748,1650,7341,15089,7601,15587
�ֵ,JinJiaoJieDao,211402011,23508,2093,14981,10720,17933,14981,4148,14768,29749,14768,29749
,HongLuoXianZhen,211402102,22781,2944,14793,9867,28051,14779,4390,15157,29936,15322,30115
,GaoQiaoZhen,211402103,19248,2447,12342,8641,22287,12332,3174,12487,24819,12527,24869
,GangTunZhen,211402104,23342,2935,15901,9566,29996,15880,5422,15751,31631,15798,31699
¶,SiErBaoZhen,211402105,20159,2379,12954,8710,21864,12950,3907,13459,26409,13491,26445
̨ɹ,XinTaiMenMengGuZuZhen,211402106,12614,2256,8587,5660,16373,8583,2832,9071,17654,9115,17702
,JinXingZhen,211402107,21439,2852,13842,9549,25805,13830,3750,14150,27980,14199,28041
̨,TaiJiTunZhen,211402108,12154,1768,7854,5532,15334,7854,2119,8182,16036,8187,16041
ɳӪ,ShaHeYingXiang,211402201,14636,2020,9371,6473,17189,9370,2676,9936,19306,9961,19332
Ӫ,GuZhuYingZiXiang,211402202,3193,591,2274,1648,4323,2274,833,2343,4617,2343,4617
ʯ,BaiMaShiXiang,211402203,4183,855,2807,2036,5469,2807,807,3038,5845,3038,5845
ɽ,ShanShenMiaoZiXiang,211402205,8954,1564,5826,4269,12097,5826,1784,6476,12302,6476,12302
ɽ,TaShanXiang,211402206,17860,2732,11566,8023,22102,11554,2843,11835,23389,11869,23435
๫,ZhangXiangGongTunXiang,211402209,10693,1417,6921,4240,13556,6917,1912,7077,13994,7101,14022
,YangJiaoXiang,211402210,6942,1083,4502,3135,7824,4502,1240,4763,9265,4763,9265
,DaXingXiang,211402212,15988,2299,10402,7059,19979,10397,2771,10626,21023,10656,21058
Ӿü�,YangJiaZhangZiJingJiJiShuKaiFaQu,211402400,23777,4731,15987,14352,29653,15956,3169,15628,31584,15690,31677
«ֵ,HuLuDaoJieDao,211403001,9796,498,2874,2289,3478,2660,821,2965,5625,8241,11115
ֵ,DongJieDao,211403002,14938,1397,9387,7543,11016,9387,2602,9522,18909,9550,18937
ֵ,XiJieDao,211403003,25162,2964,16346,13387,23273,16289,4435,16119,32408,16215,32561
½ֵ,WangHaiSiJieDao,211403004,13330,2123,8266,6897,12360,8129,1842,8091,16220,9029,17295
ֵ,LongWanJieDao,211403005,16172,2405,10814,8250,15697,10599,2906,9991,20590,10669,21483
�ֵ,BinHaiJieDao,211403006,18549,1258,11106,6831,12113,9307,2786,8379,17686,11487,22593
˫ֵ,ShuangLongJieDao,211403007,29377,3454,17431,13632,25497,17384,4424,17074,34458,19824,37255
ʽֵ,YuHuangJieDao,211403008,32948,2320,21308,15401,22126,20944,6503,20052,40996,20463,41771
ֵ,LianWanJieDao,211403009,13231,1039,8156,5810,9384,8089,2512,8009,16098,8626,16782
۽ֵ,BeiGangJieDao,211403010,10890,1291,7013,4988,8875,6985,1914,6984,13969,7082,14095
˫,ShuangShuXiang,211403201,7528,889,4845,3510,7259,4831,1442,4941,9772,5014,9859
«ÿ,HuLuDaoJingJiKaiFaQu,211403400,194,1,23,0,1,0,0,0,0,172,195
«ר԰,HuLuDaoShiZhuanLiJiShuYuanQu,211403401,111,1,16,0,0,0,0,0,0,96,112
Լͽֵ,ZhaoJiaTunJieDao,211404001,4686,1126,3157,2796,5985,3157,531,3183,6340,3186,6343
ɳͽֵ,ShaGuoTunJieDao,211404002,3212,988,2323,2319,4446,2322,463,2336,4658,2340,4663
Ƥֵ,QiuPiGouJieDao,211404003,3339,891,2350,2048,4090,2348,470,2327,4675,2350,4700
έӹֵ,WeiZiGouJieDao,211404005,1841,396,1272,1151,1981,1272,271,1236,2508,1236,2508
ӽֵ,SanJiaZiJieDao,211404006,4300,766,2915,2732,5299,2914,726,2877,5791,2877,5792
Сӽֵ,XiaoLingHeJieDao,211404007,1671,349,1083,1012,1835,1082,194,1123,2205,1131,2214
ֵ,JiuLongJieDao,211404008,23027,3367,15388,11473,21784,15104,3998,14763,29867,15004,30392
Ҥ,GangYaoLingZhen,211404101,13386,1625,9106,5405,16754,9090,3515,9408,18498,9420,18526
ů,NuanChiTangZhen,211404102,14069,1833,9596,5744,17013,9594,3408,9668,19262,9714,19310
ɳ,ShaGuoTunXiang,211404201,10115,1389,6849,4625,11755,6847,2326,6950,13797,6981,13830
,HuangTuKanXiang,211404203,9374,1442,6112,4432,11125,6106,1660,6341,12447,6364,12476
ڽˮ,WuJinTangShuiKu,211404400,176,17,100,75,0,100,22,115,215,115,215
,SuiZhongZhen,211421100,60471,6875,38614,21809,60273,29368,9714,28790,58158,38446,77060
,XiDianZiZhen,211421101,16090,2227,10576,6910,20223,10573,3568,11293,21866,11309,21885
,KuanBangManZuZhen,211421102,17276,2474,11171,6787,23039,11168,3940,12462,23630,12519,23690
,DaiWangMiaoManZuZhen,211421103,20101,3131,12949,8041,26306,12946,3927,14188,27134,14210,27159
,WanJiaZhen,211421104,16282,1988,10839,6197,20549,10076,3574,10286,20362,11005,21844
ǰ,QianSuoZhen,211421105,17823,2069,11508,8513,19780,11489,3871,12113,23602,12255,23763
,GaoLingZhen,211421106,18796,2301,12306,7883,24037,12305,3885,12672,24977,12676,24982
ǰ,QianWeiZhen,211421107,16430,2280,10579,6863,21249,10564,3154,11240,21804,11285,21864
ĵ,HuangDiManZuZhen,211421108,17554,2508,11699,7420,23111,11694,3969,12293,23987,12332,24031
ɽ,TaShanTunZhen,211421109,21897,2916,14466,9423,27605,14466,4959,15282,29748,15306,29772
̨,GaoTaiZhen,211421113,19176,2701,12453,7819,24512,12451,4245,13633,26084,13669,26122
,WangBaoZhen,211421114,13133,1894,8647,6197,16801,8644,2496,8847,17491,8876,17523
ɳ,ShaHeZhen,211421115,22502,3006,14664,9540,28566,14650,5070,15879,30529,15914,30578
Сׯ,XiaoZhuangZiZhen,211421116,24219,3209,15906,9970,31418,15906,5304,16773,32679,16826,32732
ƽ,XiPingPoManZuXiang,211421201,11743,1771,7700,4773,15658,7699,2788,8601,16300,8602,16302
,GeJiaManZuXiang,211421202,8007,1303,5365,3257,10928,5365,1722,5667,11032,5667,11032
ߵ,GaoDianZiManZuXiang,211421204,13399,1761,8533,5056,17575,8523,2745,9349,17872,9372,17905
,FanJiaManZuXiang,211421206,9661,1679,6397,4047,13089,6358,2174,7030,13388,7117,13514
ˮ,MingShuiManZuXiang,211421207,9485,1289,5824,3749,12127,5824,1520,6464,12288,6470,12294
ӹ,QiuZiGouXiang,211421208,6951,1037,4629,3009,9207,4629,1517,4875,9504,4876,9505
ӱ,JiaBeiYanXiang,211421210,11995,1758,7849,5172,16192,7848,2782,8663,16511,8686,16535
,YongAnBaoXiang,211421211,4029,849,2661,2041,5467,2660,723,2930,5590,2940,5601
ұ,LiJiaBaoXiang,211421212,14610,1993,9359,5628,18823,9359,2823,10066,19425,10067,19426
,WangHuManZuXiang,211421214,14339,2003,9451,6138,18450,9449,2714,9576,19025,9605,19056
ǽ,ChengJiaoXiang,211421217,24490,2695,15943,11365,14780,15252,4684,15365,30617,15926,31869
̨ɽũ,DaTaiShanGuoShuNongChang,211421400,4728,666,3111,2096,5632,3111,892,3175,6286,3175,6286
ǰũ,QianSuoGuoShuNongChang,211421401,3100,831,2132,1984,3933,2128,359,2141,4269,2158,4290
,JianChangZhen,211422100,48793,4053,31200,18860,43337,28212,10346,29130,57342,31992,63192
˼,BaJiaZiZhen,211422101,8637,1569,5915,4155,11259,5906,1942,6192,12098,6233,12148
ﶴ,LaMaDongZhen,211422102,15445,2064,10694,6536,20862,10691,3905,10663,21354,10720,21414
ҩ,YaoWangMiaoZhen,211422103,18165,2997,12016,7474,24084,12011,4085,13151,25162,13231,25247
,TangShenMiaoZhen,211422104,19743,2383,12979,7445,26423,12961,4830,13939,26900,13977,26956
,LingLongTaZhen,211422105,11961,1911,8857,5361,16799,8827,3768,8706,17533,8783,17640
,DaTunZhen,211422106,11311,1905,7788,4587,15411,7783,2829,8223,16006,8257,16045
ţţӪ,NiuWangNiuYingZiXiang,211422201,27486,3595,18304,10131,31761,18281,6665,19400,37681,19442,37746
Ӫ,SuZhuYingZiXiang,211422203,14831,1962,9781,5304,19787,9781,3640,10648,20429,10652,20433
ʯ,ShiFoXiang,211422204,9636,1397,6763,4052,12755,6756,2725,6962,13718,6995,13758
Ӫ,WangBaoYingZiXiang,211422206,10594,1397,7350,4524,14504,7350,2849,7490,14840,7490,14840
ϴ,LaoDaZhangZiXiang,211422207,12724,2175,9529,5790,18573,9529,4152,9522,19051,9522,19051
Ҫ·,YaoLuGouXiang,211422208,12499,1998,8804,5233,17601,8779,3493,9112,17891,9186,17990
κ,WeiJiaLingXiang,211422209,5839,939,4084,2578,8081,4084,1464,4158,8242,4158,8242
,XiJianChangXiang,211422210,7764,1453,5888,4115,10877,5885,2078,5405,11290,5407,11295
ͷӪ,TouDaoYingZiXiang,211422211,7533,1141,5085,3229,10385,5077,1913,5494,10571,5502,10587
¿,XinKaiLingXiang,211422212,9775,1638,6700,4127,13545,6654,2332,6936,13590,7045,13745
,HeZhangZiXiang,211422213,3436,623,2365,1426,4790,2361,890,2572,4933,2584,4949
,YangMaDianZiXiang,211422214,10426,1535,6801,4151,14188,6801,2403,7563,14364,7563,14364
з,HeShangFangZiXiang,211422215,17838,2440,11836,6688,24204,11835,4258,12671,24506,12700,24536
,YangShuWanZiXiang,211422218,9622,1590,6523,3951,13029,6523,2152,6834,13357,6841,13364
ɽ,HeiShanKeXiang,211422219,9724,1562,6885,4099,13458,6831,2599,6903,13734,7000,13885
׼ҵ,LeiJiaDianXiang,211422220,10176,1831,7268,4525,14330,7183,2836,7298,14481,7575,14843
СӪ,XiaoDeYingZiXiang,211422222,10847,1725,7291,4212,14732,7288,2648,7929,15217,7929,15220
ɹ,ErDaoWanZiMengGuZuXiang,211422223,14974,2240,10194,5996,20528,10191,3820,10820,21011,10840,21034
ʲ,BaShenHanXiang,211422224,17083,2318,11432,6053,23119,11427,4443,12406,23833,12412,23844
,NiangNiangMiaoXiang,211422225,7976,1135,5359,3098,10794,5359,1981,5733,11092,5733,11092
,GuZhangZiXiang,211422226,8987,1286,6423,3829,12509,6423,2804,6646,13069,6654,13077
ųǽֵ,GuChengJieDao,211481001,16626,3031,10863,8401,16839,10858,2568,11243,22101,11362,22225
Զֵ,NingYuanJieDao,211481002,23890,2983,15395,11446,20471,15378,4153,15601,30979,15631,31026
Ƕֵ,ChengDongJieDao,211481003,17617,2208,11608,8068,15514,11603,3190,11380,22983,11407,23015
Ȫֵ,WenQuanJieDao,211481004,44449,5309,27478,19521,44605,26302,6802,25127,51429,29082,56560
ֵ̨,DiaoYuTaiJieDao,211481005,11513,1162,7309,4891,8649,6693,1745,6565,13258,7111,14420
ɽֵ,HuaShanJieDao,211481006,8455,1563,5617,4325,10988,5617,1547,5948,11565,5948,11565
ļͽֵ,SiJiaTunJieDao,211481007,17055,669,9787,2458,6763,4056,1232,3981,8037,9169,18956
ׯ,CaoZhuangZhen,211481101,27833,3283,18316,11173,32552,18314,5158,17825,36139,17958,36274
ɳ,ShaHouSuoManZuZhen,211481103,27594,3680,18583,11746,34702,18574,6070,18707,37281,18761,37344
ׯ,DongXinZhuangManZuZhen,211481104,25181,3375,16846,10979,28897,16837,5620,17319,34156,17330,34176
,GuoJiaManZuZhen,211481105,6191,1103,4140,2643,8215,4140,1383,4533,8673,4537,8677
,YangAnManZuXiang,211481201,15752,2010,10432,6817,18736,10426,3203,10524,20950,10533,20965
Ԫ̨,YuanTaiZiManZuXiang,211481203,13796,1851,9152,5703,16487,9145,2820,9286,18431,9315,18467
,BaiTaManZuXiang,211481204,8182,1209,5416,3496,9797,5414,1782,5751,11165,5757,11173
,WangHaiManZuXiang,211481206,14450,1851,9541,5554,18555,9537,3058,9792,19329,9818,19359
̨,LiuTaiZiManZuXiang,211481207,9805,1413,6532,4037,12760,6520,2093,6706,13226,6779,13311
կ,DaZhaiManZuXiang,211481208,16553,2164,10823,6523,21715,10823,3748,11642,22465,11642,22465
ϴɽ,NanDaShanManZuXiang,211481209,14709,2147,9909,5846,19909,9909,3328,10275,20184,10275,20184
Χ,WeiPingManZuXiang,211481210,8628,1435,5732,3714,11808,5731,2100,6422,12153,6431,12163
߼,GaoJiaLingManZuXiang,211481211,10662,1643,7111,4155,13907,7108,2639,7793,14901,7833,14944
,JianChangManZuXiang,211481212,8231,1297,5398,3226,10853,5384,2050,6052,11436,6180,11578
,SanDaoGouManZuXiang,211481213,12569,2036,8189,4831,16923,8189,2758,9174,17363,9174,17363
,HongYaZiManZuXiang,211481214,20042,2602,13631,7876,27058,13617,5318,14325,27942,14331,27962
,JiuMenManZuXiang,211481215,7040,976,4609,2862,8662,4607,1580,4980,9587,4987,9596
ҩ,YaoWangManZuXiang,211481216,10943,1791,7349,4247,14418,7349,2664,8042,15391,8049,15398
,HaiBinManZuXiang,211481218,10678,1402,7236,4435,13748,7229,2386,7209,14438,7230,14466
ջ,JuHuaDaoXiang,211481219,1951,228,1258,878,2373,1253,365,1282,2535,1286,2544
ֵ´,NanLingJieDaoBanShiChu,220102001,59628,4964,34697,15686,40315,20954,4382,20135,41089,34277,68974
ǿֵ´,ZiQiangJieDaoBanShiChu,220102002,26715,3740,17520,11709,21599,15815,2694,14463,30278,15629,33149
񿵽ֵ´,MinKangJieDaoBanShiChu,220102003,27683,3458,17377,12722,24449,16603,3059,16101,32704,16823,34200
´ֵ´,XinChunJieDaoBanShiChu,220102004,33582,3832,21324,15593,25151,20979,4203,19796,40775,20293,41617
ֵͨ´,ChangTongJieDaoBanShiChu,220102005,32684,3992,20183,14833,29361,19935,3562,19736,39671,20055,40238
ȫֵ´,QuanAnJieDaoBanShiChu,220102006,39409,4664,25027,17783,34337,24500,4606,23135,47635,23652,48679
ֵ´,ShuGuangJieDaoBanShiChu,220102007,31166,6208,20918,15587,29314,20262,3376,19242,39504,19832,40750
ֵ´,YongJiJieDaoBanShiChu,220102008,35717,4366,22285,16155,26772,21338,4073,20852,42190,21871,44156
Դֵ´,TaoYuanJieDaoBanShiChu,220102009,32491,3628,20420,15240,26820,20278,3864,19374,39652,19563,39983
ǽֵ´,HongChengJieDaoBanShiChu,220102010,56983,5762,36163,24166,36388,32930,7342,32516,65446,33924,70087
ֵ´,MingZhuJieDaoBanShiChu,220102011,40634,3723,26275,14779,23781,21713,5574,20872,42585,23656,49931
ԣֵ´,FuYuJieDaoBanShiChu,220102012,5840,300,3519,2337,3627,3518,1063,3675,7193,3684,7203
ٺӽֵ´(ü�),LinHeJieDaoBanShiChu(ChangChunJingJiJiShuKaiFaQu)GuoJia,220102070,88571,6426,52369,34043,32494,47236,11454,46146,93382,54082,106451
˽ֵ´̶ξÿ�,YongXingJieDaoBanShiChuJingYueTanLvYouJingJiKaiFaQu,220102071,55004,2144,28170,7464,34463,10336,2331,10330,20666,31309,59479
½ֵ´̶ξÿ�,JingYueJieDaoBanShiChuJingYueTanLvYouJingJiKaiFaQu,220102072,100430,5085,65825,26159,49136,35452,9079,35929,71381,48769,114594
򣨾̶ξÿ�ʡ,XinLiChengZhenJingYueTanLvYouJingJiKaiFaQuShengJi,220102170,18323,1689,11390,7267,19360,11366,2913,11509,22875,11535,22925
º򣨾̶ξÿ�ʡ,XinHuZhenJingYueTanLvYouJingJiKaiFaQuShengJi,220102171,14277,1689,9035,5673,17469,9031,2534,9433,18464,9465,18500
̶򣨾̶ξÿ�ʡ,YuTanZhenJingYueTanLvYouJingJiKaiFaQuShengJi,220102172,17658,1645,10104,5209,15635,7492,2031,7709,15201,11230,21334
Ҹ,XingFuXiang,220102200,11649,726,7200,4884,8635,7177,2334,7404,14581,7509,14709
·ֵ´,XinFaJieDaoBanShiChu,220103001,21791,2700,13675,10029,22891,13530,2306,12954,26484,13122,26797
վǰֵ´,ZhanQianJieDaoBanShiChu,220103002,51657,4955,24489,18249,38038,23347,3760,22943,46290,35883,60372
Ϲֵ´,NanGuangJieDaoBanShiChu,220103003,19516,2296,11515,9275,19859,11284,1767,11892,23176,12064,23579
ֵ´,DongGuangJieDaoBanShiChu,220103004,12094,902,6700,4398,6064,5967,1339,5882,11849,7635,14335
ȺӢֵ´,QunYingJieDaoBanShiChu,220103005,32865,4311,20777,14955,24201,19562,4166,19532,39094,20565,41342
ҵֵ´,XingYeJieDaoBanShiChu,220103006,58363,6122,36995,26265,36513,36778,8816,36065,72843,36306,73301
ֵ´,KaiXuanJieDaoBanShiChu,220103007,32814,3285,19908,12147,24554,16259,3407,16248,32507,19598,39506
ɽֵ´,TuanShanJieDaoBanShiChu,220103008,25471,2193,15407,11686,18673,15371,3883,16066,31437,16140,31547
Ӱֵ´,LiuYingJieDaoBanShiChu,220103009,64308,5204,39595,29676,30266,39385,9905,39458,78843,39822,79417
,LanJiaZhen,220103100,53163,3918,32468,23568,42226,32172,10447,33647,65819,35060,67528
ɳ򣨵»У,MiShaZiZhenDeHuiShi,220103101,48224,5136,30592,18332,59368,30542,9469,32098,62640,32237,62829
򣨵»У,WanBaoZhenDeHuiShi,220103102,22099,2233,13835,7215,27893,13833,3998,14468,28301,14495,28330
¡ɽ򣨳ü��Ҽ,XingLongShanZhenChangChunJingJiJiShuKaiFaQuGuoJiaJi,220103170,35420,3110,20517,13451,29915,19547,5416,19780,39327,23429,43946
¡ũأ,HeLongZhenNongAnXian,220103171,53950,4953,33951,18763,61267,33716,9686,34490,68206,34638,68589
ܽ磨¼ҵ�Ҽ,FenJinXiangChangChunGaoXinJiShuChanYeKaiFaQuGuoJiaJi,220103200,14799,1540,9584,6288,17136,9578,2874,9550,19128,9629,19213
ǰֵ´,QianJinJieDaoBanShiChu,220104001,53106,5731,32313,23024,34063,29681,6124,30243,59924,32648,64961
ֵֽ´,GuiLinJieDaoBanShiChu,220104002,55965,7913,35555,19478,55669,29659,4975,27846,57505,33298,68853
Ϻֵ´,NanHuJieDaoBanShiChu,220104003,73590,8921,42767,26435,56424,35651,7609,34819,70470,47353,90120
ֵ´,YongChangJieDaoBanShiChu,220104004,38070,6763,25433,15898,35748,21854,4209,20630,42484,23609,49042
ֵ´,ChongQingJieDaoBanShiChu,220104005,45433,4582,26301,11301,45869,19400,3883,18453,37853,27597,53898
ͽֵ´,QingHeJieDaoBanShiChu,220104006,60330,7159,34259,22054,48855,30373,4810,29231,59604,38040,72299
ֵ´,HongQiJieDaoBanShiChu,220104007,80703,11477,50473,35438,69253,46863,7635,45776,92639,49342,99815
ֵ´,HuXiJieDaoBanShiChu,220104008,89002,10627,49763,29356,82194,42019,7920,43354,85373,57786,107549
ֵ´,FuFengJieDaoBanShiChu,220104009,20617,2119,12866,8993,16618,12345,3510,12692,25037,13380,26246
Ƚֵ´¿,GuiGuJieDaoBanShiChuGaoXinKaiFaQu,220104070,13368,931,8031,5355,11070,7809,2393,7806,15615,8661,16692
ɽ,LeShanZhen,220104100,19789,2013,12263,8120,23998,12238,3742,13217,25455,13281,25544
,YongChunZhen,220104101,12930,1390,8110,5600,13450,8079,2337,8440,16519,8547,16657
˫磨¿,ShuangDeXiangGaoXinKaiFaQu,220104270,123259,4179,65706,27217,60529,35010,8075,35285,70295,69807,135513
ʢֵ´,DongShengJieDaoBanShiChu,220105001,60137,6242,37148,28332,57722,36939,7862,36818,73757,37093,74241
ֵֽ´,JiLinJieDaoBanShiChu,220105002,28088,3156,17761,12888,24309,17694,3928,17291,34985,17411,35172
ٹֵ´,RongGuangJieDaoBanShiChu,220105003,65492,6821,39499,28603,44942,37566,8098,37271,74837,40912,80411
վֵ´,DongZhanJieDaoBanShiChu,220105004,35573,5433,22491,16836,32426,22479,4308,22786,45265,22823,45314
Զֵ´,YuanDaJieDaoBanShiChu,220105005,43495,2253,27794,13912,22555,18260,4918,19226,37486,22872,50666
ﱤֵ´,BaLiBaoJieDaoBanShiChu,220105006,25724,2889,15731,12927,25961,15726,3379,16252,31978,16261,31992
㳡ֵ´ü�,DongFangGuangChangJieDaoBanShiChuChangChunJingJiJiShuKaiFaQu,220105070,76456,4552,46804,27543,36662,37814,10331,38132,75946,44535,91339
Ӣ,YingJunZhen,220105100,42965,3340,26072,17860,36191,25163,7048,26042,51205,27281,53353
Ȱũɽ,QuanNongShanZhen,220105101,12895,1534,8242,5459,15261,8167,2338,8459,16626,8525,16767
Ȫ,QuanYanZhen,220105102,3070,397,1981,1304,3759,1971,573,2043,4014,2059,4040
,LongJiaZhen,220105170,39544,3753,25359,13302,46234,25342,7056,24930,50272,24994,50353
׺,KaLunHuZhen,220105171,38705,3494,24258,12879,41521,23074,6753,22845,45919,24694,48952
,DongHuZhen,220105172,21033,1916,13533,8493,20604,13479,4471,13681,27160,13887,27420
ļ,SiJiaXiang,220105200,7664,1011,4794,3231,9325,4783,1245,5080,9863,5126,9920
ֵ´,ZhengYangJieDaoBanShiChu,220106001,79533,9426,49830,36783,63354,48588,11407,48872,97460,50536,100366
ֵ´,PuYangJieDaoBanShiChu,220106002,69666,8674,43675,31062,58928,40189,7485,40174,80363,42150,85825
ǽֵ´,ChunChengJieDaoBanShiChu,220106003,41492,4108,24704,17307,23177,23492,4947,23400,46892,25843,50547
ֵ´,TieXiJieDaoBanShiChu,220106004,32841,5639,20654,15134,30971,20161,3318,20190,40351,21144,41798
ֵ´,QingNianJieDaoBanShiChu,220106005,47936,5799,30691,20965,30005,29131,7451,29092,58223,30495,61186
԰ֵ´,LinYuanJieDaoBanShiChu,220106010,52710,4041,31432,22338,30143,29664,7477,30257,59921,32796,64228
ͬĽֵ´,TongXinJieDaoBanShiChu,220106011,94721,6085,54145,36989,24622,51078,14131,52173,103251,60792,114937
ֵ̽´ҵ�ʡ,JinChengJieDaoBanShiChuChangChunQiCheChanYeKaiFaQuSheng,220106070,71665,11256,45814,35095,70411,45209,8777,44774,89983,45884,91698
ֵ´ҵ�ʡ,DongFengJieDaoBanShiChuChangChunQiCheChanYeKaiFaQuSheng,220106071,72301,9714,44789,30774,52409,39599,7183,38673,78272,44409,89198
,HeXinZhen,220106100,14113,1545,8988,6075,14359,8970,2635,9239,18209,9305,18293
,XiXinZhen,220106101,14429,1141,8800,5977,11732,8625,2639,8987,17612,9409,18209
,ChengXiZhen,220106102,35411,2544,21393,14221,21013,20328,5648,21230,41558,22210,43603
ҵʡ,ChangChunQiCheChanYeKaiFaQuShengJiTeShuXiangZhen,220106170,21836,1735,13495,9064,22729,13420,4292,13957,27377,14368,27863
԰ÿ,LvYuanJingJiKaiFaQu,220106400,2207,222,1356,882,1731,1335,371,1375,2710,1444,2800
ɽֵ´,YunShanJieDaoBanShiChu,220112001,74315,6202,46011,28646,63494,39707,10770,39565,79272,45276,91287
ƽֵ´,PingHuJieDaoBanShiChu,220112002,26922,2446,16824,9511,30689,16735,4203,16699,33434,16747,33571
ֵ´,SheLingJieDaoBanShiChu,220112003,39726,3676,25308,12769,38553,20069,5766,20882,40951,23860,49168
ɽӽֵ´,ShanHeJieDaoBanShiChu,220112004,38975,3768,23951,15135,44763,23922,6200,24843,48765,24992,48943
,QiJiaZhen,220112100,36771,4071,23226,13582,45554,23198,6181,23629,46827,23797,47023
̫ƽ,TaiPingZhen,220112101,39206,3965,24174,14369,47064,24168,6649,25628,49796,25646,49820
¹,LuXiangZhen,220112102,34328,3549,21396,13295,42156,21371,6321,22693,44064,22802,44198
˫Ӫ磨÷¹ҵÿ�ʡ,ShuangYingXiangMeiHuaLuChanYeJingJiKaiFaQuShengJi,220112270,10208,1335,7138,4073,11329,7138,2250,6651,13789,6655,13793
ũ,NongAnZhen,220122100,179611,18095,110037,74544,201980,106183,27518,112268,218451,115187,225224
Ȫ,FuLongQuanZhen,220122101,41205,4460,25707,14287,51560,25653,6956,26893,52546,26914,52621
,HaLaHaiZhen,220122102,54735,5811,33857,19185,67854,33843,9036,35682,69525,35725,69582
ɽ,KaoShanZhen,220122103,21174,2267,13203,7408,26723,13203,3670,13908,27111,13908,27111
,KaiAnZhen,220122104,43010,4330,26325,14937,52947,26325,7001,28016,54341,28016,54341
չ,ShaoGuoZhen,220122105,20841,2181,13246,6861,26006,13241,4028,13758,26999,13804,27050
߼ҵ,GaoJiaDianZhen,220122106,21945,2183,13774,7331,27497,13771,4010,14350,28121,14364,28138
,HuaJiaZhen,220122107,29733,3112,18764,9470,37151,18763,5038,19119,37882,19119,37883
ʢ,SanShengYuZhen,220122108,27595,2818,17187,9013,33847,17180,4628,17849,35029,17854,35041
ͼ,BaJiLeiZhen,220122109,36697,4212,23046,13367,45639,22941,6187,23988,46929,24050,47096
,SanGangZhen,220122110,23652,2486,14837,7921,28704,14837,4122,15423,30260,15423,30260
ǰ,QianGangXiang,220122200,35835,3732,22304,11733,45372,22300,6101,23358,45658,23364,45668
,LongWangXiang,220122201,20661,2302,13264,7132,25294,13242,3751,13427,26669,13450,26714
˳,WanShunXiang,220122203,25683,2939,16222,9234,32176,16040,4483,16757,32797,16883,33105
,YangShuLinXiang,220122204,27870,2578,17498,8964,33983,17498,4860,17810,35308,17810,35308
,YongAnXiang,220122205,22142,2110,13959,6419,27636,13937,3746,13993,27930,14039,27998
ɽ,QingShanKouXiang,220122206,22297,2429,14151,7372,28402,14144,4198,14735,28879,14773,28924
Ȧ,HuangYuQuanXiang,220122207,24576,2427,15526,6970,31002,15526,4474,15951,31477,15951,31477
ũ,XinNongXiang,220122208,26416,2678,16693,8046,33422,16693,5036,17432,34125,17437,34130
,WanJinTaXiang,220122209,25974,2572,16611,8172,33640,16609,5172,17099,33708,17107,33718
С,XiaoChengZiXiang,220122210,21584,2455,13426,8021,26740,13423,3545,14146,27569,14158,27584
иũ,WaZhongGaoNongChang,220122400,1321,245,888,747,1735,888,220,898,1786,898,1786
ֵ̨´,JiuTaiJieDaoBanShiChu,220181001,103716,12054,66542,49458,89864,64202,15601,63069,127271,64829,131371
Ӫǽֵ´,YingChengJieDaoBanShiChu,220181002,21938,3400,13526,9649,23282,12226,1916,12124,24350,13728,27254
Žֵ´,JiuJiaoJieDaoBanShiChu,220181003,26586,2410,16500,9601,26045,16315,4110,16413,32728,16606,33106
ʯ,MuShiHeZhen,220181100,39375,4271,25425,13455,49812,25416,7942,26095,51511,26163,51588
ӽ,ChengZiJieZhen,220181101,36676,3969,23160,12852,46195,23146,7098,24526,47672,24583,47743
ľ,QiTaMuZhen,220181102,31009,2978,19514,10040,37606,19496,5803,20218,39714,20276,39790
Ϻ,ShangHeWanZhen,220181103,34950,3468,22148,11726,43191,22141,6697,22957,45098,22967,45115
Ӫ,XiYingChengZhen,220181104,15675,1672,9647,5836,18361,9616,2784,10405,20021,10484,20131
,TuMenLingZhen,220181105,18173,2021,11321,6726,20592,11263,3140,11613,22876,12013,23334
έӹ,WeiZiGouZhen,220181106,37639,3957,23553,13041,46288,23544,7011,24986,48530,25054,48607
¡,XingLongZhen,220181107,27813,2921,17826,9145,34001,17807,4931,17780,35587,17839,35665
ͼ,JiJiaZhen,220181108,24927,2564,15835,8383,30711,15826,4593,16216,32042,16249,32084
,BoNiHeZhen,220181109,22563,2393,14148,8240,27675,14133,4079,14824,28957,14887,29035
һ,HuJiaHuiZuXiang,220181200,15243,1581,9763,5292,19249,9758,3162,10159,19917,10223,19986
ç,MangKaManZuXiang,220181201,21121,2020,12986,7194,25987,12981,3720,13839,26820,13875,26861
ֵ´,HuaChangJieDaoBanShiChu,220182001,45602,3597,28298,17348,29270,24347,6553,24438,48785,27454,55752
ֵ´,ZhengYangJieDaoBanShiChu,220182002,44515,4121,27697,21406,37393,26368,6860,26810,53178,27799,55496
Ӣֵ´,PeiYingJieDaoBanShiChu,220182003,26994,2493,17223,11973,20495,17207,4918,17152,34359,17182,34405
ǽֵ´,ChengJiaoJieDaoBanShiChu,220182004,35336,3482,22717,16426,41866,22529,6211,22222,44751,22312,45029
,WuKeShuZhen,220182100,48180,4597,29990,19067,54898,29905,8980,31666,61571,31767,61757
,GongPengZhen,220182101,45082,4493,28578,17340,54931,27649,8572,28816,56465,29569,58147
ɼ,MinJiaZhen,220182102,27194,2635,16808,10918,33327,16805,4762,17749,34554,17783,34591
,DaPoZhen,220182103,24409,2451,15720,8366,30888,15641,5331,16371,32012,16471,32191
,HeiLinZhen,220182104,35224,3456,22672,11687,44691,22658,7124,23085,45743,23132,45804
,TuQiaoZhen,220182105,46780,4665,29902,16275,58918,29896,9443,30925,60821,30986,60888
,XinLiZhen,220182106,38528,3733,24177,14142,47304,23980,6905,24763,48743,24989,49166
,DaLingZhen,220182107,42329,4242,26869,16332,52027,26855,7805,27428,54283,27507,54376
ڼ,YuJiaZhen,220182108,39885,3784,25650,13293,50089,25644,7648,25628,51272,25667,51317
,SiHeZhen,220182109,22301,2466,14361,8699,27735,14353,4296,14669,29022,14702,29063
˺,BaHaoZhen,220182110,38935,3640,25241,12789,48581,25238,7705,25004,50242,25039,50280
,LiuJiaZhen,220182111,23822,2237,14877,7263,28977,14868,4511,15658,30526,15693,30570
ˮ,XiuShuiZhen,220182112,36927,3478,23482,13165,45964,23469,7096,23967,47436,24019,47501
,BaoShouZhen,220182113,28218,2714,17973,10015,35612,17967,5476,18404,36371,18435,36408
ׯ,XinZhuangZhen,220182114,29811,2865,19078,10044,37048,19076,5447,19027,38103,19045,38123
,YuMinXiang,220182200,23460,2316,14455,9442,29024,14455,3681,14987,29442,15002,29457
,HongXingXiang,220182201,23579,2353,14843,9230,29196,14842,4497,15563,30405,15586,30429
̫,TaiAnXiang,220182202,22809,2330,14312,8686,28187,14312,4029,14853,29165,14856,29168
ȷ,XianFengXiang,220182203,22013,2116,13857,7787,26974,13857,4027,14285,28142,14299,28156
ɽ,QingShanXiang,220182204,22565,2157,14246,6843,28312,14235,4121,14578,28813,14597,28843
Ӻͳ,YanHeChaoXianZuXiang,220182205,1550,205,943,933,339,934,96,891,1825,908,1851
,EnYuXiang,220182206,23924,2447,15086,8739,29980,15080,4282,15539,30619,15567,30653
Ƿ,ChengFaXiang,220182207,35958,3404,22375,12657,44585,22373,6181,23126,45499,23168,45543
,HuanChengXiang,220182208,51444,4890,32238,17754,62801,31129,9270,32125,63254,33366,65604
ʤֵ´,ShengLiJieDaoBanShiChu,220183001,48548,5188,30855,25122,32748,29716,7716,29916,59632,30597,61452
ֵ´,JianSheJieDaoBanShiChu,220183002,69080,5942,43120,32155,49558,40970,10956,41119,82089,42858,85978
ݷֵ´,HuiFaJieDaoBanShiChu,220183003,32832,2850,20307,12461,30983,19875,5564,20701,40576,20939,41246
ļҵֵ´,XiaJiaDianJieDaoBanShiChu,220183004,18859,2123,12140,6576,24018,12128,3939,12733,24861,12781,24921
,DaQingZuiZhen,220183100,25138,2643,16016,8394,31482,16015,4994,16757,32772,16759,32775
,GuoJiaZhen,220183101,28367,2999,18118,10086,35382,18113,5674,18891,37004,18922,37040
ɻ,SongHuaJiangZhen,220183102,26813,2620,17018,8360,34012,17014,5126,17505,34519,17541,34559
ҹ,DaJiaGouZhen,220183103,23388,2666,14718,7940,29274,14700,3983,15271,29971,15319,30037
,DaFangShenZhen,220183104,42856,4680,27575,14437,54859,27569,8765,28700,56269,28726,56301
·,ChaLuKouZhen,220183105,38393,3352,23941,12562,48122,23936,7412,25197,49133,25216,49157
,ZhuChengZiZhen,220183106,20634,2240,13128,7513,24948,12843,3832,13378,26221,13578,26706
,BuHaiZhen,220183107,31771,3248,19887,11151,39084,19877,5760,20809,40686,20892,40779
̨,TianTaiZhen,220183108,27244,2533,17082,9018,33612,17063,5158,17795,34858,17853,34935
԰,CaiYuanZiZhen,220183109,29510,2881,18738,9958,37341,18738,5605,19253,37991,19258,37996
̫ͬ,TongTaiXiang,220183200,38526,4145,24394,12911,49053,24389,7300,25561,49950,25577,49971
߸,BianGangXiang,220183201,29661,2742,18943,9733,37211,18943,5923,19383,38326,19383,38326
̨,WuTaiXiang,220183202,23566,2611,14967,7826,29303,14934,4525,15677,30611,15735,30702
,ZhaoYangXiang,220183203,27580,2631,17321,8869,34136,17315,5277,18141,35456,18167,35488
˻ֵ´,XingHuaJieDaoBanShiChu,220202001,34046,4300,21395,16080,27450,21140,4172,20444,41584,21123,42518
ֵ´,WenMiaoJieDaoBanShiChu,220202002,19026,2841,12284,8122,16210,11239,2053,10322,21561,11636,23920
ӽֵ´,DongJuZiJieDaoBanShiChu,220202003,53403,7267,34041,24669,47484,33883,6323,32846,66729,32952,66993
µغŽֵ´,XinDiHaoJieDaoBanShiChu,220202004,36072,4370,22061,15271,34401,21941,4322,20845,42786,22703,44764
Ӱֵ´,YanAnJieDaoBanShiChu,220202005,36087,4926,23274,16701,31463,23000,4286,21775,44775,22025,45299
վǰֵ´,ZhanQianJieDaoBanShiChu,220202006,17701,2256,11085,8071,17464,11026,1842,10572,21598,10714,21799
ֵ´,MinZhuJieDaoBanShiChu,220202007,36925,5276,22753,15354,33455,21565,3622,21337,42902,23070,45823
ֵ´,LianHuaJieDaoBanShiChu,220202008,27840,3412,17646,12963,24360,17330,3543,16935,34265,17149,34795
ֵͨ´,TongJiangJieDaoBanShiChu,220202009,40413,5483,25536,18179,34128,25047,4699,24667,49714,25059,50595
ֵ´,HaDaWanJieDaoBanShiChu,220202010,26149,3670,16149,12675,23355,16040,2733,16279,32319,16403,32552
½ֵ´,XinJianJieDaoBanShiChu,220202011,9927,1546,6131,4391,7776,6122,1097,6047,12169,6439,12570
ӽֵ´,YanJiangJieDaoBanShiChu,220202012,31324,6434,19688,13924,29206,19024,3166,18749,37773,21236,40924
˫ֵ´,ShuangJiJieDaoBanShiChu,220202013,9503,1937,5957,4059,10100,5395,927,5243,10638,6410,12367
վֵ´(־ü�),JiuZhanJieDaoBanShiChu(JiLinJingJiJiShuKaiFaQuGuoJia),220202070,51699,4634,30263,18570,45357,24251,5279,24193,48444,31349,61612
ֶóʾֵ,JiLinDongShiShangMaoJingJiShiFanQuTeShuJieDao,220202071,53,35,14,58,0,9,0,51,60,74,88
µ,GuDianZiZhen,220202100,15269,1571,9438,6194,15579,9420,2194,9558,18978,9596,19034
Ƥ,HuaPiChangZhen,220202101,31034,3221,19643,11781,36033,19629,4946,19534,39163,19558,39201
,ZuoJiaZhen,220202102,19214,2455,11963,8226,21431,11494,2935,12183,23677,12641,24604
,LiangJiaZiManZuXiang,220202200,11682,1210,7242,4414,14310,7232,2175,7798,15030,7825,15067
峯,TuChengZiManZuChaoXianZuXiang,220202201,14835,1470,9026,5729,16419,9023,2025,9262,18285,9304,18330
Ҹù,XingFuJingJiGuanLiQu,220202401,523,45,310,217,255,310,65,323,633,323,633
ֹ幤ҵ,JiLinHaDaWanGongYeKaiFaQu,220202402,4506,291,2678,1940,2398,2629,675,2709,5338,2794,5472
ֵ´,LongHuaJieDaoBanShiChu,220203001,30306,5684,20077,14199,33134,19780,3531,18978,38758,19444,39521
̶ֵ´,XiangTanJieDaoBanShiChu,220203002,32931,4881,21396,15685,27989,21250,4362,20610,41860,20778,42174
ֵ´,TieDongJieDaoBanShiChu,220203003,39225,4495,21742,12857,31578,17777,3227,17046,34823,25205,46947
ؽֵ´,PaoZiYanJieDaoBanShiChu,220203004,8283,865,4879,4212,8173,4859,913,5109,9968,5182,10061
̶ֵ´,LongTanJieDaoBanShiChu,220203005,16846,2653,10583,8213,15558,10510,1626,10475,20985,10542,21125
¼ֵֽ´,XinJiLinJieDaoBanShiChu,220203006,19047,2344,11727,8575,15679,10619,1622,10614,21233,11286,23013
ɽǰֵ´,ShanQianJieDaoBanShiChu,220203007,24903,3166,13367,8822,22608,11418,1709,11721,23139,16411,29778
°ֵ´,XinAnJieDaoBanShiChu,220203008,33599,5130,21320,15530,34982,20876,3671,20361,41237,21080,42400
ֵ´,ZunYiJieDaoBanShiChu,220203009,22348,4445,14690,10513,23976,14401,2136,13910,28311,14239,28929
ֵ´,YuShuJieDaoBanShiChu,220203010,15580,2259,9639,7308,14757,9577,1456,9310,18887,9656,19295
ɽֵ´,KaoShanJieDaoBanShiChu,220203011,2494,359,1504,1310,2483,1484,196,1509,2993,1545,3049
ǽֵ´,DongChengJieDaoBanShiChu,220203012,5465,453,3169,2344,2863,3134,735,3349,6483,3484,6653
е½ֵ´,ChengDeJieDaoBanShiChu,220203013,10918,1630,6824,5095,9829,6807,1160,6855,13662,6884,13708
,WuLaJieZhen,220203100,46759,4702,28633,18681,54401,28612,6848,29519,58131,29676,58309
Ҥ,GangYaoZhen,220203101,27504,3337,17175,13212,32219,17155,4266,17856,35011,17932,35107
ܷ,JiangMiFengZhen,220203102,30852,3349,18921,12329,34638,18829,4501,19606,38435,19781,38702
,DaKouQinZhen,220203103,14982,1829,9403,6720,17790,9397,2444,9821,19218,9852,19255
,JiangBeiXiang,220203200,18054,1746,11096,7248,16998,11071,2244,10850,21921,10948,22044
,JinZhuXiang,220203201,22680,1777,11976,7506,21447,11663,2823,11388,23051,15304,27280
ʤֵ´,DeShengJieDaoBanShiChu,220204001,25166,3639,16557,11350,24462,16065,3117,14894,30959,15365,31922
Ͼֵ´,NanJingJieDaoBanShiChu,220204002,23649,3319,15380,11103,24152,15267,2948,14381,29648,14536,29916
󶫽ֵ´,DaDongJieDaoBanShiChu,220204003,17074,3127,11728,8064,19270,11346,2360,10627,21973,10833,22561
ൺֵ´,QingDaoJieDaoBanShiChu,220204004,32759,4774,21405,14811,35174,21180,3994,19967,41147,20122,41527
ֵ´,XiangYangJieDaoBanShiChu,220204005,30732,4733,20235,14459,31749,19249,3248,18220,37469,18478,38713
ֵ´,BeiJiJieDaoBanShiChu,220204006,26238,3550,16668,12142,24295,16184,2680,15583,31767,15800,32468
ºͽֵ´,ZhiHeJieDaoBanShiChu,220204007,19660,2728,12134,8804,19737,11844,1915,11703,23547,12169,24303
·ֵ´,ChangChunLuJieDaoBanShiChu,220204008,32528,2482,14942,8280,26084,10395,1961,10490,20885,22029,36971
ٽֵ´,LinJiangJieDaoBanShiChu,220204009,24526,4000,16061,11648,21168,15972,2791,15154,31126,15256,31317
ɽֵ´,BeiShanJieDaoBanShiChu,220204010,36835,4067,21712,15704,34278,21454,4478,20645,42099,23668,45380
ֵ´,HuangQiJieDaoBanShiChu,220204011,32739,4273,20860,14673,28114,20562,3995,19887,40449,20147,41007
,DaSuiHeZhen,220204100,20130,2114,12286,8786,23705,12273,3100,13027,25300,13058,25344
ѵվ,SouDengZhanZhen,220204101,36524,3549,22381,13775,42508,22360,5809,23439,45799,23501,45882
Խ,YueBeiZhen,220204102,17828,1513,10865,6898,17892,10811,2743,11070,21881,11219,22084
ϲ,HuanXiXiang,220204200,18057,1745,10780,7467,15566,10660,2792,11531,22191,11814,22594
̩ɽֵ´,TaiShanJieDaoBanShiChu,220211001,26772,3420,15462,9404,18019,13173,2611,12638,25811,17341,32803
Ͻֵ´,JiangNanJieDaoBanShiChu,220211002,36382,5207,23602,17218,30048,23238,4987,22452,45690,22974,46576
ʯֵ´,ShiJingJieDaoBanShiChu,220211003,6078,1194,3997,3312,6356,3969,624,3814,7783,3899,7896
طֵ´,YanFengJieDaoBanShiChu,220211004,5573,763,3540,2521,4654,3454,726,3342,6796,3522,7062
ֵ´,FengManJieDaoBanShiChu,220211005,7316,1701,4813,4139,7865,4795,679,4563,9358,4883,9696
¿ֵ´,GaoXinKaiFaQuJieDaoBanShiChu,220211070,71174,7511,46870,27097,60975,38045,8577,36891,74936,40392,87262
ֵ´,HongQiJieDaoBanShiChu,220211071,14634,1589,9020,6132,13280,8968,2071,9154,18122,9274,18294
,WangQiZhen,220211100,12226,1300,7470,5069,14295,7454,1823,7844,15298,7879,15349
,JiangNanXiang,220211200,33151,2474,20442,10264,23383,14313,3474,14809,29122,18657,39099
ǰ,QianErDaoXiang,220211201,13563,1492,8185,5568,13817,7927,2021,8493,16420,8891,17076
Сɽ,XiaoBaiShanXiang,220211270,12378,1466,7651,5296,12411,7615,1865,7929,15544,8058,15709
ǰ,KouQianZhen,220221100,80885,10178,51320,35342,84221,50144,11264,49853,99997,51007,102327
˫,ShuangHeZhen,220221101,20403,2095,12293,8520,20836,12275,2628,12772,25047,12833,25126
,XiYangZhen,220221102,25370,2711,15109,9371,29408,15086,3404,16161,31247,16376,31485
,BeiDaHuZhen,220221103,29451,2782,17683,10641,31887,17621,4292,18718,36339,18842,36525
һϪ,YiLaXiZhen,220221104,43760,4440,26710,16117,51674,26697,6655,28063,54760,28145,54855
·,ChaLuHeZhen,220221170,38132,4004,23194,15268,40114,23065,5406,24076,47141,24348,47542
,WanChangZhen,220221171,38743,3227,22870,11979,45322,21172,4892,21633,42805,23992,46862
ÿ,YongJiJingJiKaiFaQuTeShuXiangZhen,220221172,9714,688,5616,3249,6600,4405,975,4547,8952,5761,11377
,JinJiaXiang,220221200,17565,1874,10662,6754,21199,10610,2496,11027,21637,11273,21935
,HuangYuXiang,220221201,13377,1242,7873,4864,16032,7868,1833,8552,16420,8579,16452
ֵ´,MinZhuJieDaoBanShiChu,220281001,41796,4725,26706,19251,34762,25953,6095,25317,51270,25910,52616
ֵ´,ChangAnJieDaoBanShiChu,220281002,34943,4695,22865,16748,31665,22761,4797,21425,44186,21570,44435
Ͻֵ´,HeNanJieDaoBanShiChu,220281003,24434,2621,15243,9669,26431,15206,3768,15504,30710,15580,30823
ɽֵ´,NaiZiShanJieDaoBanShiChu,220281004,6360,1529,4083,3653,7878,4060,572,4310,8370,4378,8461
ֵ´,LaFaJieDaoBanShiChu,220281005,15940,1746,9950,6294,19264,9929,2561,10254,20183,10297,20247
ӱֵ´,HeBeiJieDaoBanShiChu,220281006,16958,2369,10700,7792,11954,10397,2015,10041,20438,10642,21342
ũֵ´,XinNongJieDaoBanShiChu,220281007,11925,1311,7556,4635,14353,7555,2161,7824,15379,7841,15397
վ,XinZhanZhen,220281100,27819,3458,17171,12349,32764,17151,4084,18145,35296,18190,35361
,TianGangZhen,220281101,24560,2530,15049,10260,27663,15033,4003,16002,31035,16044,31093
ʯɽ,BaiShiShanZhen,220281102,31545,4601,20315,14625,38760,20299,4838,20642,40941,20669,40984
Ư,PiaoHeZhen,220281103,28467,2518,17733,10815,34528,17528,5465,18294,35822,18717,36450
ɵ,HuangSongDianZhen,220281104,15585,2144,9507,6762,18737,9503,2309,10502,20005,10531,20038
챱,TianBeiZhen,220281105,18806,1974,11433,6987,22089,11424,2785,12069,23493,12132,23565
ɽ,SongJiangZhen,220281106,15723,1442,9453,6150,19274,9445,2546,10220,19665,10258,19711
,QingLingZhen,220281107,12640,1731,7811,5510,15330,7802,2059,8578,16380,8619,16430
ֳ,WuLinChaoXianZuXiang,220281200,12217,1410,7479,5155,12877,7479,1773,7921,15400,7921,15400
ǰ,QianJinXiang,220281201,11437,1167,7175,4987,13457,7174,2269,7693,14867,7698,14873
ֵ´,MingHuaJieDaoBanShiChu,220282001,35094,3116,22166,15223,27817,20862,5391,20450,41312,21435,43601
ֵ´,YongJiJieDaoBanShiChu,220282002,27467,2598,16782,8647,29298,12025,4075,12278,24303,17358,34140
ʤֵ´,ShengLiJieDaoBanShiChu,220282003,20535,2030,12838,8237,23560,11002,3133,10948,21950,12860,25698
»ֵ´,XinHuaJieDaoBanShiChu,220282004,17628,1919,11335,6624,16464,8867,2939,8717,17584,11151,22486
½ֵ´,QiXinJieDaoBanShiChu,220282005,19943,2252,12753,8607,18690,10789,2920,10524,21313,12362,25115
Ƥ,JiaPiGouZhen,220282100,22378,1971,12763,10024,20569,12630,3314,13690,26320,14900,27663
,ErDaoDianZiZhen,220282101,17222,1983,10965,7589,20922,10961,3135,11347,22308,11375,22340
ʯ,HongShiLaZiZhen,220282102,41315,5295,25804,20962,48993,25785,6118,26865,52650,26924,52728
˵,BaDaoHeZiZhen,220282103,29026,2626,17838,11325,35512,17827,4854,18628,36455,18668,36506
ɽ,ChangShanZhen,220282104,15869,1488,9709,5626,19709,9298,2841,9862,19160,10489,20198
뽼,HuaJiaoXiang,220282200,36275,3655,22654,13016,44155,22590,6442,23711,46301,23718,46372
,HengDaoHeZiXiang,220282201,16673,1551,10238,6418,20471,10236,3010,10975,21211,10996,21234
ɳ,JinShaXiang,220282202,16958,1538,10759,6364,20718,10749,3400,11107,21856,11137,21896
,HuaShuLinZiXiang,220282203,10447,932,6788,4134,13334,6786,2421,6967,13753,7012,13800
,GongJiXiang,220282204,24136,2292,15201,9476,28997,15193,4638,15818,31011,15865,31066
ǽֵ´,BeiChengJieDaoBanShiChu,220283001,43251,5232,27478,21611,41334,27385,6564,27500,54885,27569,55047
ϳǽֵ´,NanChengJieDaoBanShiChu,220283002,21968,2672,13098,12101,15065,13077,2750,14266,27343,14292,27390
ǽֵ´,HuanChengJieDaoBanShiChu,220283003,34152,3328,20868,14558,36163,20855,5062,21619,42474,21674,42542
ֵ´,JiShuJieDaoBanShiChu,220283004,73673,11958,46422,37353,87304,46246,8681,47616,93862,47890,94312
ֵ´,TieDongJieDaoBanShiChu,220283005,21493,2013,13030,10604,16682,12101,2866,12602,24703,13342,26372
,FaTeZhen,220283100,28240,2972,17698,10411,34661,17695,4967,18452,36147,18481,36179
,BaiQiZhen,220283101,28796,3341,18210,11418,35312,18193,4646,18533,36726,18573,36783
Ϫ,XiHeZhen,220283102,22486,2315,14155,8394,27553,14128,4043,14644,28772,14689,28844
,ZhaoYangZhen,220283103,17003,1646,10654,7160,20763,10654,2978,10973,21627,10973,21627
С,XiaoChengZhen,220283104,16828,1716,10461,7014,19805,10460,2803,10881,21341,10886,21347
Ӫ,ShangYingZhen,220283105,15886,2300,9967,7797,19060,9956,2169,10370,20326,10388,20355
ˮ,ShuiQuLiuZhen,220283106,27423,3120,17218,10470,33087,17213,4222,17542,34755,17547,34765
ƽ,PingAnZhen,220283107,31772,2861,19385,12122,34915,19362,4401,19594,38956,19649,39034
,JinMaZhen,220283108,12998,1099,8141,5051,15441,8138,2455,8385,16523,8411,16552
ԭ,KaiYuanZhen,220283109,22465,1854,13852,8025,27069,13834,4218,14628,28462,14685,28537
,LianHuaXiang,220283200,11700,1323,7577,3969,14999,7570,2325,7757,15327,7771,15348
ɽ,LiangJiaShanXiang,220283201,14878,1526,9347,5409,18469,9347,2651,9708,19055,9708,19055
°,XinAnXiang,220283202,16185,1694,10008,6580,19532,10006,2644,10512,20518,10515,20523
,QiLiXiang,220283203,21714,2083,13460,7787,25968,13458,3453,13778,27236,13790,27250
,TianDeXiang,220283204,26092,2558,16585,9291,33067,16574,5190,17205,33779,17255,33840
ֵ´,FuAnJieDaoBanShiChu,220284001,15138,1339,9044,5902,14200,8778,2145,9215,17993,9578,18622
ֵ´,DongNingJieDaoBanShiChu,220284002,51382,6176,33561,25882,52545,33319,8693,32380,65699,32690,66251
Ͻֵ´,HeNanJieDaoBanShiChu,220284003,24742,2877,15556,11589,16582,15043,3438,14974,30017,15501,31057
ʯÿʡֵ,PanShiJingJiKaiFaQuShengJiTeShuJieDao,220284070,14061,1376,8490,5965,9403,7455,1736,7699,15154,8683,17173
Ͳɽ,YanTongShanZhen,220284100,52896,5634,32462,23239,60098,32112,7943,33452,65564,34011,66473
,HongQiLingZhen,220284101,25565,3186,15975,11326,26369,15472,3587,15679,31151,16363,32338
,MingChengZhen,220284102,31340,3108,18841,13893,34366,18799,4417,19630,38429,20024,38865
ʯ,ShiZuiZhen,220284103,22165,2538,13587,9911,25348,13581,3185,14273,27854,14301,27888
,YiMaZhen,220284104,9532,1054,5891,3960,11431,5891,1654,6329,12220,6349,12240
ţ,NiuXinZhen,220284105,18117,1712,11165,7001,21756,11162,3204,11801,22963,11868,23033
,HuLanZhen,220284106,19106,1730,11784,7413,22442,11775,3551,12559,24334,12603,24387
,JiChangZhen,220284107,29468,2907,17834,12539,34081,17831,4554,19047,36878,19095,36929
ɽ,SongShanZhen,220284108,10765,1002,6544,4177,13099,6544,1890,7104,13648,7113,13657
ʯ,HeiShiZhen,220284109,16530,1595,10348,6666,18882,10341,3049,10781,21122,10826,21174
ɽ,ZhaoYangShanZhen,220284110,17466,1713,10673,6412,20586,10667,2649,11118,21785,11155,21828
̫,FuTaiZhen,220284111,14892,1207,9030,5684,17545,9027,2518,9568,18595,9587,18617
ȡ,QuChaiHeZhen,220284112,12470,1406,7541,5277,14006,7539,1738,8041,15580,8073,15614
ɽ,BaoShanXiang,220284200,15375,1482,9571,6209,18267,9554,2776,10011,19565,10062,19633
˽ֵ´,RenXingJieDaoBanShiChu,220302001,31250,3987,19665,15518,30085,19516,3800,19112,38628,19372,39037
Ӣ۽ֵ´,YingXiongJieDaoBanShiChu,220302002,51950,4937,35128,14867,48710,21936,4377,21327,43263,26136,61264
վǰֵ´,ZhanQianJieDaoBanShiChu,220302003,29013,3294,17369,13383,32413,17337,2849,17718,35055,17787,35156
ֵ´,BeiGouJieDaoBanShiChu,220302004,26757,3573,16684,13968,25459,16649,3311,16916,33565,16957,33641
ֱֵ´,DiZhiJieDaoBanShiChu,220302005,42820,6116,28156,21575,49259,27842,6624,26868,54710,27404,55560
ƽ,PingXiXiang,220302200,40952,3651,25658,15239,44433,23263,6476,24329,47592,25421,51079
¼�,HongZuiGaoXinJiShuKaiFaQu,220302400,2433,162,1484,1083,1,1484,409,1519,3003,1520,3004
ƽֵ´,PingDongJieDaoBanShiChu,220303001,25731,4053,16397,12491,24334,16388,3003,16385,32773,16390,32787
гֵ´,BeiShiChangJieDaoBanShiChu,220303002,14960,1818,9554,7508,11709,9529,2084,9254,18783,9308,18862
·ֵ´,QiMaLuJieDaoBanShiChu,220303003,28886,2870,17592,12904,29107,17450,3943,17927,35377,18107,35699
·ֵ´,SiMaLuJieDaoBanShiChu,220303004,27487,2944,16979,14428,24436,16930,3429,16822,33752,16881,33860
Žֵ´,JieFangJieDaoBanShiChu,220303005,10913,1385,6802,5596,8640,6784,1484,6946,13730,6980,13782
Žֵ´,BeiMenJieDaoBanShiChu,220303006,28064,3671,16988,12749,34000,16722,3250,17447,34169,17997,34985
ӽֵ´,HuangTuKengJieDaoBanShiChu,220303007,17192,2140,10572,8740,16088,10557,2037,10755,21312,10797,21369
ƽϽֵ´,PingNanJieDaoBanShiChu,220303008,18750,2622,11042,8283,18389,11039,2019,11548,22587,12349,23391
ɽ,ShanMenZhen,220303100,21673,1959,13167,7838,18453,11381,3207,11959,23340,13672,26839
ʯ,ShiLingZhen,220303101,25226,2967,15845,11441,28062,15816,4260,16517,32333,16608,32453
Ҷ,YeHeManZuZhen,220303102,18287,2121,11863,7904,23154,11853,3733,12233,24086,12278,24141
ƽÿʡ,SiPingJingJiKaiFaQuShengJiTeShuXiangZhen,220303170,12504,818,7287,4583,7699,6093,1666,6181,12274,7701,14988
Ƕ,ChengDongXiang,220303200,17194,1806,10684,7253,15263,10684,2728,11043,21727,11044,21728
,LiShuZhen,220322100,119919,10524,69813,41099,125331,56999,16633,58350,115349,77263,147076
ҵ,GuoJiaDianZhen,220322101,52171,6799,32358,24394,61832,31931,6983,33318,65249,33595,65953
̨,YuShuTaiZhen,220322102,29215,3023,18653,11342,36607,18648,6263,19798,38446,19848,38501
¼ƽɺũѹ,GuJiaZiZhenSiPingLiaoHeNongKenGuanLiQu,220322103,37279,3285,23504,14887,41861,23481,7692,24686,48167,24752,48256
С,XiaoChengZiZhen,220322104,33241,3384,21091,12585,41689,20802,6589,21725,42527,22123,43214
,LaMaDianZhen,220322105,23627,2314,14953,8223,28377,14949,4261,15216,30165,15249,30202
̼,CaiJiaZhen,220322106,21602,1916,13673,7754,26565,13670,4423,14237,27907,14268,27941
ҹ,LiuJiaGuanZiZhen,220322107,20651,2019,13150,7400,26522,13145,4178,13660,26805,13698,26848
ʮұ,ShiJiaBaoZhen,220322108,23705,2279,14970,9437,28598,14943,4673,15616,30559,15687,30657
ϼ,MengJiaLingZhen,220322109,13962,1326,8835,4992,17085,8475,2756,8828,17303,9209,18044
,WanFaZhen,220322110,29823,2872,18519,11294,37144,18519,5980,20156,38675,20156,38675
,DongHeZhen,220322111,21927,1964,14061,7385,27601,14051,4264,14068,28119,14094,28155
,ShenYangZhen,220322112,15226,1384,9798,5188,19067,9788,3335,10098,19886,10147,19945
ֺ,LinHaiZhen,220322113,22495,2086,14319,8045,28495,14312,5086,15303,29615,15348,29667
С,XiaoKuanZhen,220322114,16687,1543,10384,5718,21400,10382,3383,11212,21594,11229,21613
ɽ,BaiShanXiang,220322200,21720,2054,13907,7427,27520,13897,4172,14003,27900,14039,27946
Ȫ,QuanYanLingXiang,220322201,16113,1502,10222,5867,20601,10219,3547,10923,21142,10940,21162
ʤ,ShengLiXiang,220322202,16648,1603,10673,5686,21416,10668,3586,11144,21812,11164,21837
Ŀ,SiKeShuXiang,220322203,20579,2068,13109,7099,25241,13098,3929,13428,26526,13467,26576
˫,ShuangHeXiang,220322204,19745,1855,12731,6548,25342,12729,4051,12894,25623,12920,25651
ɽ,JinShanXiang,220322205,15762,1457,9945,5615,20250,9938,3487,10745,20683,10761,20706
Ӫũƽɺũѹ,GuoYingLiShuNongChangSiPingLiaoHeNongKenGuanLiQu,220322400,18703,1989,11800,6766,23700,11800,3313,12204,24004,12205,24005
ͨ,YiTongZhen,220323100,98579,9064,60760,39595,111494,59307,15102,60812,120119,61985,122745
,ErDaoZhen,220323101,15706,1367,9630,5839,18873,9625,2747,10160,19785,10190,19820
,YiDanZhen,220323102,22702,2269,14324,8309,27680,14221,4106,14583,28804,14753,29077
�,MaAnZhen,220323103,22502,2002,14103,7902,27991,14100,4170,14551,28651,14571,28674
̨,JingTaiZhen,220323104,27088,2884,17039,10230,33126,17038,5059,17949,34987,17992,35031
ɽ,KaoShanZhen,220323105,22352,2120,14070,8540,26616,14043,4207,14597,28640,14609,28679
ɽ,DaGuShanZhen,220323106,32198,2848,19928,11777,39952,19922,5563,20635,40557,20681,40609
Сɽ,XiaoGuShanZhen,220323107,22959,2014,14538,8153,27317,14535,4206,14622,29157,14641,29179
Ӫ,YingChengZiZhen,220323108,29776,2384,18131,10749,34891,18123,5237,19226,37349,19266,37397
έ,XiWeiZhen,220323109,12855,1098,7989,4511,15887,7983,2306,8259,16242,8270,16259
Դ,HeYuanZhen,220323110,15000,1302,9174,5362,18066,9171,2678,9795,18966,9806,18980
,HuangLingZiZhen,220323111,12571,1167,8070,4639,16071,8070,2641,8309,16379,8309,16379
,XinXingXiang,220323200,13182,1313,8316,4694,15560,8314,2213,8370,16684,8392,16708
Ī,MoLiQingXiang,220323201,12230,1097,7617,4450,15102,7551,2249,7884,15435,7959,15576
,SanDaoXiang,220323202,15739,1488,9941,5923,19705,9937,2905,10173,20110,10191,20132
Ͻֵ´,HeNanJieDaoBanShiChu,220381001,15947,1772,9803,8064,16966,9752,2034,9900,19652,9950,19753
ӱֵ´,HeBeiJieDaoBanShiChu,220381002,16340,1504,10008,8103,19144,10004,2141,9974,19978,9977,19985
ֵ´,DongSanJieDaoBanShiChu,220381003,27189,2629,14189,11447,28958,14150,2809,14514,28664,18438,32627
붫ֵ´,LingDongJieDaoBanShiChu,220381004,36544,4678,22395,16720,28977,20765,3999,21180,41945,22826,45221
ֵ´,TieBeiJieDaoBanShiChu,220381005,29615,3652,18070,13553,25016,16987,3356,17361,34348,18553,36623
ֵ´,LingXiJieDaoBanShiChu,220381006,22797,2352,13818,9509,26467,12497,2791,12556,25053,14122,27940
ӽֵ´,LiuFangZiJieDaoBanShiChu,220381007,28232,3005,17867,10337,33546,17760,4421,17706,35466,17791,35658
ӽֵ´,NanWaiZiJieDaoBanShiChu,220381008,24169,2280,15565,8843,29195,15551,4258,15111,30662,15142,30707
ֵ´,HuanLingJieDaoBanShiChu,220381009,16207,1466,10168,5956,18478,10144,2561,10022,20166,10066,20234
έӹֵ´,WeiZiGouJieDaoBanShiChu,220381010,10702,1056,6515,4431,9389,6515,1486,6729,13244,6729,13244
ʮ,ErShiJiaZiZhen,220381100,19124,1742,11813,6954,23413,11812,2842,11887,23699,11895,23708
,HeiLinZiZhen,220381101,45331,4492,28945,14188,56828,28945,7688,28566,57511,28566,57511
ռ,TaoJiaTunZhen,220381102,24815,2707,15736,8488,29967,15729,3940,15688,31417,15726,31462
,FanJiaTunZhen,220381103,72304,9153,45747,34530,84645,45445,10551,45876,91321,46261,92008
ˮ,XiangShuiZhen,220381104,30606,2934,18938,10105,37744,18938,4796,19398,38336,19398,38336
,DaLingZhen,220381105,28374,2937,18056,9271,35913,18056,5146,18401,36457,18401,36457
,HuaiDeZhen,220381106,80057,7985,50371,26049,97739,49537,13192,50197,99734,50863,101234
˫Ǳ,ShuangChengBaoZhen,220381107,58361,6702,35466,18493,72444,35465,7567,37163,72628,37164,72630
˫,ShuangLongZhen,220381108,18766,1893,11784,6161,21736,11783,3059,11914,23697,11934,23718
,YangDaChengZiZhen,220381109,40809,4149,25395,12740,47921,25131,6250,25559,50690,25813,51208
ë,MaoChengZiZhen,220381110,18638,1641,11595,5939,23823,11594,3625,12286,23880,12309,23904
,BoLiChengZiZhen,220381111,23504,2002,14622,7658,29003,14622,4197,15059,29681,15081,29703
,ZhaoYangPoZhen,220381112,24506,2366,15441,7937,30522,15441,4097,15446,30887,15528,30969
,DaYuShuZhen,220381113,20213,2130,12711,6882,24931,12708,3439,13051,25759,13071,25782
ؼ,QinJiaTunZhen,220381114,38753,3844,24153,13773,47539,24143,6190,24574,48717,24634,48787
,BaWuZhen,220381115,25216,2298,15737,7840,31909,15737,4477,16254,31991,16254,31991
ʮ,ShiWuZhen,220381116,18242,1752,11396,6202,22838,11390,3211,11776,23166,11809,23205
ɣ̨,SangShuTaiZhen,220381117,18168,1751,11356,6029,23253,11355,3367,11929,23284,11930,23286
ɽ,LongShanXiang,220381200,10989,1164,7221,3792,13869,7221,2343,7249,14470,7275,14496
,YongFaXiang,220381201,16967,1701,10932,5476,21624,10931,3332,11053,21984,11068,22000
ʡԭֳַ,ShengYuanZhongFanZhiChang,220381400,2742,356,1718,1185,3329,1718,379,1759,3477,1759,3477
ƽũԺ,SiPingNongKeYuan,220381401,94,14,54,56,95,54,11,65,119,65,119
�,GongZhuLingShiZhongZhuChang,220381402,621,52,361,314,740,361,78,390,751,390,751
ʮũ,ShiWuNongChang,220381403,1959,177,1203,652,2427,1201,292,1222,2423,1225,2428
ʮţ,ShiWuZhongNiuChang,220381404,313,40,213,131,403,213,51,191,404,191,404
ҵũ,ChuangYeNongChang,220381405,741,35,446,224,908,446,136,466,912,466,912
¹,GongZhuLingShiLuChang,220381406,216,13,116,74,214,116,11,124,240,124,240
;ÿ,FanJiaTunJingJiKaiFaQu,220381407,172,20,105,88,194,105,26,113,218,113,218
֣ͽֵ´,ZhengJiaTunJieDaoBanShiChu,220382001,28146,3307,17520,13986,34778,17513,3577,17408,34921,17510,35030
ֵ´,LiaoXiJieDaoBanShiChu,220382002,17499,1945,10386,9224,19166,10240,2522,11312,21552,11580,21966
Ͻֵ´,LiaoNanJieDaoBanShiChu,220382003,24685,2474,14569,12643,29381,14266,3018,15433,29699,15608,30177
ɱֵ´,LiaoBeiJieDaoBanShiChu,220382004,19945,1796,12012,9250,22128,11645,2516,11910,23555,12245,24257
ɶֵ´,LiaoDongJieDaoBanShiChu,220382005,10125,891,6421,4230,12418,6421,2010,6605,13026,6605,13026
ֵ´,HongQiJieDaoBanShiChu,220382006,8607,669,5613,2881,11000,5603,1973,5596,11199,5636,11249
ï,MaoLinZhen,220382100,33278,2896,21033,13153,39916,21033,6650,21791,42824,21791,42824
˫ɽ,ShuangShanZhen,220382101,26571,2258,16760,10031,31971,16758,5455,17519,34277,17524,34284
Ի,WoHuZhen,220382102,21917,1819,14235,8509,27068,13868,4663,13899,27767,14164,28399
,FuXianZhen,220382103,21970,1988,13694,8097,27836,13689,4121,14369,28058,14385,28079
,WangBenZhen,220382104,17591,1777,11334,6340,22731,11333,3738,11741,23074,11772,23106
ɽ,BoLiShanZhen,220382105,6381,603,4049,2472,7988,4048,1183,4100,8148,4118,8167
¡,XingLongZhen,220382106,10790,1001,6857,4009,13720,6853,2205,7058,13911,7139,13996
,DongMingZhen,220382107,14340,1300,9199,5048,18350,9199,3136,9555,18754,9577,18776
ľ,NaMuXiang,220382200,15313,1333,9710,5647,18573,9707,3026,9938,19645,9962,19672
,LiuTiaoXiang,220382201,13077,1151,8405,4729,16719,8404,3007,8818,17222,8830,17235
,XinLiXiang,220382202,12006,1223,7824,4322,15820,7820,2808,8193,16013,8213,16037
,YongJiaXiang,220382203,8929,870,5731,3424,11111,5731,1847,5872,11603,5915,11646
˫ũƽɺũѹ,ShuangLiaoNongChangSiPingLiaoHeNongKenGuanLiQu,220382400,9127,865,5841,4061,10982,5841,1734,5884,11725,5885,11726
˫򳡣ƽɺũѹ,ShuangLiaoZhongYangChangSiPingLiaoHeNongKenGuanLiQu,220382401,8656,843,5432,3708,10587,5431,1550,5611,11042,5617,11049
˫ɾÿ,ShuangLiaoJingJiKaiFaQu,220382402,16,0,9,8,19,9,3,10,19,10,19
Ͽֵ´,NanKangJieDaoBanShiChu,220402001,28318,3537,18181,13464,26833,18006,3770,17282,35288,17444,35625
ٽֵ´,BeiShouJieDaoBanShiChu,220402002,25560,3157,16371,12289,21267,16235,3356,15571,31806,15702,32073
ֵ´,DongJiJieDaoBanShiChu,220402003,24734,2843,16075,10361,26431,16031,3817,15215,31246,15319,31394
ֵ´,XiNingJieDaoBanShiChu,220402004,14417,1760,9141,6956,10586,9086,1801,8783,17869,8837,17978
վǰֵ´,ZhanQianJieDaoBanShiChu,220402005,13428,2247,8351,6740,14668,8351,1145,8469,16820,8469,16820
˽ֵ´,XinXingJieDaoBanShiChu,220402006,24646,2329,15438,11096,21981,15302,3718,14810,30112,15255,30693
ֵ´,FuZhenJieDaoBanShiChu,220402007,16670,2226,10511,7787,18539,10501,1957,10335,20836,10342,20853
ֵ´,XiangYangJieDaoBanShiChu,220402008,31571,4033,19830,15353,26135,19332,3754,19155,38487,19528,39358
ԴӪÿֵ,LiaoYuanMinYingJingJiKaiFaQuTeShuJieDao,220402070,10425,1082,6408,4112,10365,6402,1497,6579,12981,6596,13004
ɽ,ShouShanZhen,220402100,28105,2435,17493,10097,31212,16987,4726,17671,34658,17773,35266
ũ,GongNongXiang,220402200,17008,1604,10390,6518,18045,10351,2602,10706,21057,10824,21214
ɳǽֵ´,XianChengJieDaoBanShiChu,220403001,37360,4572,21556,17069,34159,19959,3123,20298,40257,23499,45055
ֵ̫´,TaiAnJieDaoBanShiChu,220403002,31575,4520,18896,16211,27881,18841,2486,19667,38508,19685,38581
ɽֵ´,DongShanJieDaoBanShiChu,220403003,27298,4886,17123,14472,32655,17098,2598,17568,34666,17659,34782
ҽֵ´,AnJiaJieDaoBanShiChu,220403004,4815,824,2942,2541,5376,2942,417,3114,6056,3114,6056
ȷֵ´,XianFengJieDaoBanShiChu,220403005,8113,1393,5005,4318,9480,4999,630,5124,10123,5131,10136
ֵ´,FuGuoJieDaoBanShiChu,220403006,5989,981,3670,3220,6529,3670,530,3830,7500,3830,7500
,DengTaZhen,220403100,28737,3201,17332,11964,32598,17309,3930,18446,35755,18536,35868
,DongFengZhen,220421100,75698,7670,47722,34695,83354,46296,11837,45775,92071,47483,95205
,DaYangZhen,220421101,27286,2631,16889,10131,32933,16865,4757,17641,34506,17785,34674
,HengDaoHeZhen,220421102,23436,2175,13858,8664,27102,13728,3826,14600,28328,15579,29437
ǵ,NaDanBoZhen,220421103,12168,1126,7753,4789,14796,7748,2618,8126,15874,8159,15912
ʯ,HouShiZhen,220421104,10125,1050,6463,4040,12497,6462,2015,6696,13158,6727,13190
ľ,YangMuLinZhen,220421105,11644,1104,7298,4382,14501,7281,2318,7712,14993,7768,15066
Сƽ,XiaoSiPingZhen,220421106,16111,1594,9995,6211,20060,9987,2988,10665,20652,10698,20693
ƺ,HuangHeZhen,220421107,16550,1580,10524,6249,20483,10522,3287,10864,21386,10893,21417
,LaLaHeZhen,220421108,10066,1020,6239,3856,11840,6201,1798,6519,12720,6645,12884
ɳ,ShaHeZhen,220421109,9571,915,6024,3862,11915,6016,1908,6340,12356,6370,12394
ͻ,NanTunJiZhen,220421110,18480,1745,11329,6636,22687,11320,3162,12018,23338,12058,23387
,DaXingZhen,220421111,8454,877,5361,3540,10324,5360,1672,5629,10989,5642,11003
峯,SanHeManZuChaoXianZuXiang,220421200,18147,1824,11278,7142,21675,11256,3346,11982,23238,12039,23317
ɽ,ErLongShanXiang,220421201,20439,2034,12869,7746,25552,12862,4026,13570,26432,13630,26499
Ȫ,BaiQuanZhen,220422100,44102,3848,27306,18738,48307,25870,6776,25990,51860,27420,54726
μ,WeiJinZhen,220422101,26130,2279,15448,10387,30111,14992,3808,16317,31309,16769,32217
ʯ,AnShiZhen,220422102,25131,2218,15235,9459,30083,15228,4036,16111,31339,16150,31385
ɺԴ,LiaoHeYuanZhen,220422103,30828,3007,18467,11848,37436,18428,4787,19995,38423,20155,38622
Ȫ̫,QuanTaiZhen,220422104,14690,1482,8952,6031,17281,8948,2144,9324,18272,9364,18316
,JianAnZhen,220422105,24018,2132,14736,9935,29233,14727,4120,15496,30223,15534,30270
ˡ,AnShuZhen,220422106,22744,2151,14026,9053,27631,14016,3789,14602,28618,14658,28684
ƽ,PingGangZhen,220422107,19976,2415,12136,8865,24165,12117,2577,12724,24841,12832,24968
ƶ,YunDingZhen,220422108,15466,1473,9580,6123,18332,9575,2410,9748,19323,9769,19349
,LingYunXiang,220422200,15874,1384,9493,6374,19542,9470,2828,10504,19974,10593,20086
ɽ,JiaShanXiang,220422201,12020,1098,7317,4643,14591,7314,2025,7799,15113,7826,15143
,ZuMinXiang,220422202,15713,1371,9508,6022,18997,9500,2600,10143,19643,10176,19684
,JinZhouXiang,220422203,12197,1156,7490,4839,14797,7488,2102,7957,15445,7965,15455
ֵ´,DongChangJieDaoBanShiChu,220502001,22796,2796,14266,9515,24868,14062,2719,13866,27928,14045,28311
ֵ´,MinZhuJieDaoBanShiChu,220502002,28428,3302,17670,12432,30902,17555,3464,17259,34814,17524,35194
վֵ´,LaoZhanJieDaoBanShiChu,220502003,37191,4711,23473,14687,36469,19244,3276,19018,38262,21705,45178
Žֵ´,TuanJieJieDaoBanShiChu,220502004,45608,5508,28537,19681,47405,28475,5900,28385,56860,28479,57016
վֵ´,XinZhanJieDaoBanShiChu,220502005,44942,5368,28208,19271,45028,26741,5572,27043,53784,27674,55882
ֵ´,GuangMingJieDaoBanShiChu,220502006,41400,5270,26207,18982,40153,25961,5116,25337,51298,25579,51786
Ȫֵ´,LongQuanJieDaoBanShiChu,220502007,27247,3540,16893,12450,24657,16746,3597,16263,33009,17491,34384
,JinChangZhen,220502100,14021,1692,8779,5735,15005,8745,2167,9036,17781,9101,17880
ͨÿ,TongHuaJingJiKaiFaQuTeShuXiangZhen,220502120,10421,1181,6420,4774,10745,6388,1376,6489,12877,6558,12978
ͨ,HuanTongXiang,220502200,12504,1402,7496,5111,9301,7475,1509,7773,15248,7919,15415
,JiangDongXiang,220502201,4859,695,2922,2211,5546,2912,493,3085,5997,3125,6047
԰ֵ´,TaoYuanJieDaoBanShiChu,220503001,30924,3900,19577,14327,33876,19561,4382,19559,39120,19629,39206
ֵͨ´,DongTongHuaJieDaoBanShiChu,220503002,32932,3899,20471,14383,34890,19713,4286,19677,39390,20646,41117
Ѽ԰,YaYuanZhen,220503100,15282,1889,9331,7077,17532,9329,1910,9735,19064,9750,19081
,TieChangZhen,220503101,14795,2456,9150,7796,17808,9146,1293,9356,18502,9394,18544
,WuDaoJiangZhen,220503102,14720,2051,8940,8008,15842,8903,1504,9283,18186,9335,18275
,ErDaoJiangXiang,220503200,8385,1119,5057,3968,7335,5050,904,5314,10364,5351,10408
ï,KuaiDaMaoZhen,220521100,64434,5372,39420,30303,66978,38060,9370,38281,76341,39756,79176
,ErMiZhen,220521101,19547,2083,9922,6935,17747,9694,2358,10107,19801,14066,23988
,GuoSongZhen,220521102,15794,1571,9206,5999,14347,7473,1805,7915,15388,9964,19170
ʯ,ShiHuZhen,220521103,2897,387,1851,1246,3436,1850,453,1868,3718,1886,3737
,DaAnZhen,220521104,7301,722,4431,2763,7762,4213,1257,4435,8648,4849,9280
⻪,GuangHuaZhen,220521105,7608,869,4707,3184,9123,4695,1175,4872,9567,4945,9652
,XingLinZhen,220521106,4704,525,2899,1901,5524,2878,791,3038,5916,3121,6020
Ӣ,YingEBuZhen,220521107,7022,656,4191,2834,7878,4187,974,4442,8629,4461,8652
,SanKeYuShuZhen,220521108,8717,813,5333,3418,10170,5331,1440,5611,10942,5637,10970
,JiangDianZhen,220521109,11545,1122,6895,4617,13381,6881,1519,7264,14145,7291,14186
ͨξÿίԱᣨ,TongHuaJuXinJingJiKaiFaQuGuanLiWeiYuanHuiTeShuXiangZhen,220521120,8817,836,4961,3627,7705,4865,1050,5141,10006,5742,10703
,FuJiangXiang,220521200,5181,465,3220,2116,6032,3220,1020,3436,6656,3446,6666
,SiPengXiang,220521201,6378,638,3893,2338,7552,3878,1023,4104,7982,4146,8039
,DongLaiXiang,220521202,3990,542,2471,1649,4694,2429,631,2626,5055,2692,5163
ȪԴ峯,DaQuanYuanManZuChaoXianZuXiang,220521203,20157,1556,10661,6774,20778,10584,2585,11284,21868,13637,24298
𶷳,JinDouChaoXianZuManZuXiang,220521204,5073,433,3020,1891,5114,3013,646,3094,6107,3132,6152
´,DongBaoXinCun,220521401,1041,89,647,467,1052,619,158,620,1239,641,1288
,ZhaoYangZhen,220523100,104956,10979,65428,46883,115871,63288,16187,64461,127749,66694,132122
,HuiNanZhen,220523101,30716,3680,19515,12282,38217,19506,5355,20201,39707,20236,39751
,YangZiShaoZhen,220523102,23695,2283,14730,9967,28554,14718,4082,15281,29999,15330,30060
ɼɸ,ShanSongGangZhen,220523103,19197,2268,11886,9100,23301,11869,3069,12620,24489,12648,24534
ʯ,ShiDaoHeZhen,220523104,14779,1631,9325,6088,18182,9311,2743,9717,19028,9828,19153
Է,HuiFaChengZhen,220523105,18744,1664,11451,7133,21340,11437,3002,11933,23370,11959,23410
,FuMinZhen,220523106,15678,1585,10014,6320,18514,9935,3451,10109,20044,10700,20714
,JinChuanZhen,220523107,10221,1280,6657,4239,12570,6485,2250,6839,13324,7094,13751
,TuanLinZhen,220523108,12277,1046,7723,4828,14783,7715,2234,7793,15508,7834,15557
,QingYangZhen,220523109,11888,1149,7448,4718,14272,7446,2054,7635,15081,7643,15091
¥ֳ,LouJieChaoXianZuXiang,220523200,19808,1751,12605,7298,23933,12596,3627,12554,25150,12581,25186
,LiuHeZhen,220524100,90386,8651,55574,35975,101994,54174,12938,55029,109203,56401,111975
Դֳ,SanYuanPuChaoXianZuZhen,220524101,25462,2463,15392,10341,29093,15365,3424,15904,31269,15957,31349
,WuDaoGouZhen,220524102,16503,1560,9869,6383,19561,9860,2322,10491,20351,10516,20385
,TuoYaoLingZhen,220524103,11306,1029,6743,4161,13269,6741,1693,7269,14010,7285,14028
ɽ,GuShanZiZhen,220524104,21843,1861,13314,7397,26148,13309,3349,13711,27020,13739,27053
ʥˮ,ShengShuiHeZiZhen,220524105,23308,1595,14005,7673,28267,13993,4009,14884,28877,14907,28912
ͨɽ,LuoTongShanZhen,220524106,11443,915,6847,3688,13817,6840,1847,7324,14164,7358,14205
,AnKouZhen,220524107,15163,1355,9241,5545,17980,9241,2431,9707,18948,9708,18949
,XiangYangZhen,220524108,14119,1124,8504,4863,17050,8502,2349,9078,17580,9088,17592
ʯ,HongShiZhen,220524109,10172,839,6153,3689,12076,6134,1600,6426,12560,6458,12611
ˮ,LiangShuiHeZiZhen,220524110,13225,1096,8097,4718,15743,8093,2289,8494,16587,8513,16610
ͨ,HengTongZhen,220524111,10858,674,6393,3494,13067,6393,1755,6884,13277,6894,13287
,LiuNanXiang,220524200,10194,946,6069,3568,12038,6067,1551,6606,12673,6622,12691
ʱҵ,ShiJiaDianXiang,220524201,10228,854,6172,3584,12067,6159,1709,6591,12750,6619,12791
ҵ곯,JiangJiaDianChaoXianZuXiang,220524202,9365,867,5635,3336,9827,5635,1166,5762,11397,5763,11398
»ֵ´,XinHuaJieDaoBanShiChu,220581001,58113,4940,33642,25265,57307,33640,6613,36014,69654,36024,69666
ֵ´,GuangMingJieDaoBanShiChu,220581002,13504,1392,8684,6134,11488,8215,2004,8006,16221,8216,16900
ƽֵ´÷ӿоó׿,HePingJieDaoBanShiChuMeiHeKouShiJingJiMaoYiKaiFaQu,220581070,48790,6464,30572,19931,54429,30564,6396,31065,61629,31078,61650
Žֵ´÷ӿоó׿,JieFangJieDaoBanShiChuMeiHeKouShiJingJiMaoYiKaiFaQu,220581071,52516,3498,30717,19628,58643,30125,8309,31053,61178,33606,64323
ֵ´÷ӿоó׿,FuMinJieDaoBanShiChuMeiHeKouShiJingJiMaoYiKaiFaQu,220581072,23022,1838,14016,9575,19694,13257,3263,13685,26942,14107,28123
ɽ,ShanChengZhen,220581100,37054,3830,22815,14892,40235,22810,5341,23375,46185,23410,46225
÷,HongMeiZhen,220581101,49199,4613,28797,21472,57206,28797,5382,30346,59143,30397,59194
,HaiLongZhen,220581102,29499,3798,18293,12852,35467,18288,4271,19252,37540,19275,37568
º,XinHeZhen,220581103,16344,1600,10096,6367,20148,10091,2826,10648,20739,10674,20770
,ShuGuangZhen,220581104,10719,1029,6672,3905,12507,6662,1773,6787,13449,6849,13521
к,ZhongHeZhen,220581105,11240,953,6940,4141,11327,6909,1710,6910,13819,6963,13903
ɽͷ,HeiShanTouZhen,220581106,10310,950,6331,3820,11612,6311,1544,6459,12770,6473,12804
ˮ,ShuiDaoZhen,220581107,7680,604,4743,2663,8664,4742,1501,5039,9781,5042,9785
,JinHuaZhen,220581108,7788,713,4812,3008,9225,4811,1386,5055,9866,5075,9887
һӪ,YiZuoYingZhen,220581109,8139,774,5036,3013,10061,5032,1428,5270,10302,5305,10341
Ӫ,KangDaYingZhen,220581110,8015,803,5078,3098,9449,5077,1600,5301,10378,5340,10418
ţĶ,NiuXinDingZhen,220581111,20961,1854,12879,8211,25030,12867,3613,13505,26372,13549,26428
,XingLingXiang,220581200,19927,1519,12144,6311,24196,12142,3363,12631,24773,12665,24809
¯,LiLuXiang,220581201,9946,811,6147,3412,11895,6147,1667,6277,12424,6277,12424
,WanLongXiang,220581202,18035,1649,10979,6263,21206,10971,2736,11415,22386,11441,22420
˫,ShuangXingXiang,220581203,10072,1014,6368,3816,12417,6361,1926,6610,12971,6644,13012
˻,XingHuaXiang,220581204,7888,730,4966,3025,9376,4956,1524,5144,10100,5176,10142
С峯,XiaoYangManZuChaoXianZuXiang,220581205,11149,948,6751,3942,11950,6746,1700,7013,13759,7046,13797
,JiLeXiang,220581206,5551,545,3468,2125,5998,3467,948,3574,7041,3576,7044
Žֵ´,TuanJieJieDaoBanShiChu,220582001,23290,2544,14514,10534,22906,13988,3396,13434,27422,14716,29230
ֵ´,LiMingJieDaoBanShiChu,220582002,18371,2122,11865,9631,10820,11794,2776,11350,23144,11404,23269
ͨʤֵ´,TongShengJieDaoBanShiChu,220582003,12149,1438,7421,6372,10943,7383,1587,7684,15067,7753,15174
ʯ,QingShiZhen,220582100,6594,773,3814,2845,7290,3757,896,3949,7706,4449,8263
,YuLinZhen,220582101,8555,1083,5299,3625,10364,5209,1267,5474,10683,5606,10905
,HuaDianZhen,220582102,9887,1068,6128,4681,11901,6115,1593,6394,12509,6420,12548
ͷ,TouDaoZhen,220582103,20283,2271,12501,9197,23401,12484,3392,13265,25749,13445,25946
,QingHeZhen,220582104,18930,1832,11889,9002,21493,11869,3172,11969,23838,12045,23934
̨,TaiShangZhen,220582105,11524,1274,7097,5367,13783,7075,1817,7458,14533,7518,14615
Դ,CaiYuanZhen,220582106,13214,1525,8062,4963,16269,8057,1903,8558,16615,8580,16642
·,DaLuZhen,220582107,6973,744,4231,2711,8367,4222,1052,4488,8710,4538,8769
̫,TaiWangZhen,220582108,21037,2546,13074,10108,22376,13037,2771,13201,26238,13280,26354
,MaXianXiang,220582200,7718,896,4665,3540,8627,4656,1023,4941,9597,4972,9637
ˮ,LiangShuiChaoXianZuXiang,220582201,5629,637,3394,2304,6255,3386,726,3581,6967,3598,6992
½ֵ´,XinJianJieDaoBanShiChu,220602001,41635,4471,26057,19794,31246,25700,6411,25069,50769,26460,52517
ֵͨ´,TongGouJieDaoBanShiChu,220602002,18235,3108,11387,9826,21349,11311,1980,11766,23077,11936,23323
˽ֵ´,DongXingJieDaoBanShiChu,220602003,52199,5311,32748,24844,46071,31511,6958,30913,62424,31720,64468
ֵ´,HongQiJieDaoBanShiChu,220602004,44226,5343,28288,23628,46854,27875,6359,27389,55264,27640,55928
Ͻֵ´,ChengNanJieDaoBanShiChu,220602005,32834,3329,20262,14524,23884,19842,4752,19767,39609,20653,40915
ֵ´,JiangBeiJieDaoBanShiChu,220602006,24369,2564,15176,11781,11386,15059,3486,14976,30035,15243,30419
ӿڽֵ´,HeKouJieDaoBanShiChu,220602007,20237,2048,12442,10238,17865,12433,3119,12901,25334,12962,25404
ʯֵ´,BanShiJieDaoBanShiChu,220602008,8154,1204,4837,3799,7986,4819,923,5151,9970,5444,10281
ߵ,QiDaoJiangZhen,220602100,19657,2292,11452,8341,16346,11383,2160,12381,23764,12657,24109
,LiuDaoJiangZhen,220602101,18936,2252,11200,9268,19128,11108,2583,12115,23223,12571,23771
,HongTuYaZhen,220602102,8086,1181,5151,3682,9760,5146,1342,5409,10555,5458,10609
,SanDaoGouZhen,220602103,2347,252,1402,1052,2389,1389,380,1457,2846,1577,2979
ұӽֵ´,SunJiaBuZiJieDaoBanShiChu,220605001,28847,3503,17094,15994,28593,16732,3183,17643,34375,18439,35533
Դֵ´,JiangYuanJieDaoBanShiChu,220605002,14097,1479,8799,7198,9461,8739,2302,8864,17603,9079,17878
ֵ´,ZhengChaJieDaoBanShiChu,220605003,20450,3200,12751,10845,22876,12649,2243,13017,25666,13142,25893
ǽֵ´,ChengQiangJieDaoBanShiChu,220605004,30824,5277,19775,17812,35333,19754,3711,19886,39640,20037,39812
幵,WanGouZhen,220605102,33820,6528,21723,19503,41374,21634,4160,22636,44270,22785,44508
,SongShuZhen,220605103,24350,4061,15238,12446,29769,15234,2929,16063,31297,16102,31340
,ZhaZiZhen,220605104,13290,2121,7986,7007,13791,7969,1583,8876,16845,9008,16994
ʯ,ShiRenZhen,220605105,26789,3241,16044,12420,30202,16035,3021,16983,33018,17007,33051
,DaYangChaZhen,220605106,2507,515,1626,1384,2916,1623,366,1745,3368,1762,3388
ʯ,DaShiRenZhen,220605107,4511,693,2795,2060,5114,2790,692,3078,5868,3101,5896
,FuSongZhen,220621100,46290,5226,29639,22614,53139,29189,7978,28921,58110,29855,59494
ɽ,SongJiangHeZhen,220621101,42479,6523,27128,22479,49765,26926,5984,27497,54423,27858,54986
Ȫ,QuanYangZhen,220621102,26057,5554,17426,15356,33389,17392,3495,17637,35029,17680,35106
¶ˮ,LuShuiHeZhen,220621103,29692,4469,18914,15324,35463,18903,4236,19455,38358,19483,38397
,XianRenQiaoZhen,220621104,10754,1578,6737,5167,13053,6717,1498,7062,13779,7093,13830
,WanLiangZhen,220621105,15975,1474,10499,7672,20114,10476,4050,10845,21321,11000,21499
,XinTunZiZhen,220621106,4419,670,2929,2312,5724,2927,909,3053,5980,3069,5998
,DongGangZhen,220621107,7404,848,3206,2529,5380,3020,737,3318,6338,5783,8989
,ManJiangZhen,220621108,1579,225,947,821,1722,946,203,1019,1965,1060,2007
,BeiGangZhen,220621109,8334,1101,5591,4146,10431,5590,1971,5795,11385,5815,11406
˲,XingCanZhen,220621110,10284,1181,6514,4466,12813,6510,1946,6879,13389,6897,13411
ɽί,ChangBaiShanBaoHuKaiFaQuGuanWeiHuiChiXiQuTeShuXiangZhen,220621120,11392,1780,7299,5753,13192,7153,1726,7341,14494,7599,14898
ɽί,ChangBaiShanBaoHuKaiFaQuGuanWeiHuiChiNanQuTeShuXiangZhen,220621121,1623,155,1008,792,1655,997,276,991,1988,1046,2054
¡,XingLongXiang,220621200,6687,870,4088,2880,8035,4033,1234,4362,8395,4703,8791
ˮ,ChouShuiXiang,220621201,2661,318,1646,1030,3375,1642,488,1790,3432,1821,3467
ؽ,YanJiangXiang,220621202,2705,397,1804,1381,3316,1804,525,1823,3627,1823,3627
,JingYuZhen,220622100,46766,4555,28824,22454,50498,28431,7296,29216,57647,29793,58617
,SanDaoHuZhen,220622101,9924,1241,5935,4734,10872,5774,1409,6148,11922,6639,12574
Ȫ,LongQuanZhen,220622102,5587,538,3397,2484,6620,3366,1133,3672,7038,3861,7258
Ƕ,NaErHongZhen,220622103,5723,576,3472,2767,6435,3461,948,3679,7140,3775,7247
԰,HuaYuanKouZhen,220622104,13084,1634,7725,5518,13604,7679,2256,8276,15955,9249,16974
ɽ,JingShanZhen,220622105,10798,1512,6807,5700,13268,6805,1665,7141,13946,7168,13975
,ChiSongXiang,220622200,3558,350,2287,1610,4282,2273,782,2380,4653,2403,4690
ɽ,MengJiangXiang,220622201,8123,881,4918,3835,8824,4876,1292,5219,10095,5378,10296
,ChangBaiZhen,220623100,25227,2913,16094,13486,28892,15972,3910,15676,31648,15956,32050
˵,BaDaoGouZhen,220623101,6236,817,3922,3122,7774,3913,1048,4155,8068,4179,8101
ʮĵ,ShiSiDaoGouZhen,220623102,3056,477,1965,1653,3785,1963,507,2071,4034,2075,4040
¹,MaLuGouZhen,220623103,6741,830,4112,3432,6887,4095,1017,4432,8527,4476,8588
Ȫɽ,BaoQuanShanZhen,220623104,3859,451,2475,2080,4189,2467,746,2561,5028,2581,5056
·,XinFangZiZhen,220623105,4781,574,2843,2360,5522,2827,670,3081,5908,3182,6025
,JinHuaXiang,220623200,1516,254,951,885,1860,950,228,1044,1994,1047,1998
ʮ,ShiErDaoGouXiang,220623201,5166,707,3224,3027,5930,3213,819,3414,6627,3468,6692
ֵ´,JianGuoJieDaoBanShiChu,220681001,30282,3275,19595,15702,30174,19523,4885,18781,38304,18847,38442
нֵ´,XinShiJieDaoBanShiChu,220681002,10366,1245,6482,5406,9302,6463,1445,6508,12971,6574,13056
¡ֵ´,XingLongJieDaoBanShiChu,220681003,20579,2623,13267,11070,18616,13224,2934,12784,26008,12869,26136
ֵ´,DaHuJieDaoBanShiChu,220681004,9066,1163,5454,4721,9507,5435,981,5645,11080,5756,11210
ɭֵ´,SenGongJieDaoBanShiChu,220681005,16773,2887,10727,9520,19373,10571,1830,10640,21211,10763,21490
ӽֵ´,DaLiZiJieDaoBanShiChu,220681006,6565,1295,4199,3735,7573,4147,689,4146,8293,4350,8549
,HuaShuZhen,220681100,12249,2156,7729,6665,15027,7701,1546,8076,15777,8222,15951
,LiuDaoGouZhen,220681101,10298,1391,6561,4947,12467,6541,1956,6921,13462,7084,13645
έɳ,WeiShaHeZhen,220681102,2762,448,1689,1475,3089,1686,326,1822,3508,1847,3536
ɽ,HuaShanZhen,220681103,4349,754,2756,2182,5038,2748,688,3002,5750,3035,5791
֦,NaoZhiZhen,220681104,3750,581,2411,1723,4448,2407,579,2477,4884,2499,4910
ĵ,SiDaoGouZhen,220681105,5575,730,3529,2703,6802,3520,1004,3760,7280,3780,7309
Ϻ,MaYiHeXiang,220681200,3819,562,2360,1845,4622,2356,564,2553,4909,2585,4945
Žֵ´,TuanJieJieDaoBanShiChu,220702001,13790,1237,8782,6175,7482,8734,2412,8592,17326,8657,17439
Ļֵ´,WenHuaJieDaoBanShiChu,220702002,22754,1452,14529,9401,16508,13974,4504,13688,27662,14181,28710
ֵ´,MinZhuJieDaoBanShiChu,220702003,18443,1521,11856,8149,8183,11444,3725,11562,23006,11833,23689
ٽֵ´,LinJiangJieDaoBanShiChu,220702004,15338,1454,9503,6523,12216,8935,2560,9128,18063,9849,19352
ֵ´,XinQuJieDaoBanShiChu,220702005,8645,601,5351,3483,2660,5303,1645,5468,10771,5540,10891
ǰֵ´,QianJinJieDaoBanShiChu,220702006,25278,2248,16030,11149,21582,15644,4331,15492,31136,15827,31857
ƽֵ´,HePingJieDaoBanShiChu,220702007,18971,1503,11368,8102,14443,10771,2466,10967,21738,11572,22940
ũֵ´,GongNongJieDaoBanShiChu,220702008,8088,882,5027,3632,6838,4939,1164,4814,9753,5107,10134
ؽֵ´,YanJiangJieDaoBanShiChu,220702009,24980,1516,14982,11238,8820,14768,4192,14803,29571,15706,30688
ֵ´,TieXiJieDaoBanShiChu,220702010,23811,1473,14472,10328,14720,14424,3787,14462,28886,14599,29071
ٽֵ´,FanRongJieDaoBanShiChu,220702011,23045,1986,14623,10795,17134,14471,3830,14136,28607,14238,28861
ֵ´,JianSheJieDaoBanShiChu,220702012,24236,1770,14867,11369,10903,13957,3736,13916,27873,14875,29742
ʯֵ´,ShiHuaJieDaoBanShiChu,220702013,10603,883,6612,5009,8057,6611,1730,6597,13208,6604,13216
ګֵ´,BoDouNeJieDaoBanShiChu,220702014,14503,731,8604,4440,6612,6365,1890,6473,12838,8520,17124
ֵ´,ChangNingJieDaoBanShiChu,220702015,15923,1220,9752,7286,16138,9745,2412,9789,19534,9803,19555
�ֵ´,BinJiangJieDaoBanShiChu,220702016,29655,2272,18567,12339,30153,17991,4790,17540,35531,18150,36717
ֵ´,JingHuJieDaoBanShiChu,220702017,19098,1532,12187,8526,13588,11863,3249,11599,23462,11692,23879
,DaWaZhen,220702100,44382,5221,28459,14615,55848,28447,7355,28416,56863,28499,56958
,ShanYouZhen,220702101,17807,1531,11268,6670,21534,11268,3290,11356,22624,11360,22628
ëվ,MaoDouZhanZhen,220702102,20087,1940,12716,7314,24546,12713,3717,13028,25741,13028,25744
³,XinChengXiang,220702200,27696,2118,17007,10947,27795,16994,3898,16617,33611,16705,33712
ԭ,XingYuanXiang,220702201,38571,2381,23772,16058,20697,23706,7068,24043,47749,24248,48020
,BoDouXiang,220702202,21856,2265,13946,8409,26284,13936,3884,14030,27966,14059,28005
ũ,HuaQiaoNongChang,220702400,3103,354,1972,1293,3129,1774,427,1747,3521,1912,3884
ǰ˹,QianGuoErLuoSiZhen,220721100,82513,5650,52985,35406,63939,50438,16581,49370,99808,51759,104744
ɽ,ChangShanZhen,220721101,40163,3648,24747,18397,40336,24656,6431,25414,50070,25495,50242
ո,HaiBoRiGeZhen,220721102,19725,1459,12270,7015,22160,12224,3778,12602,24826,12692,24962
ͼ,WuLanTuGaZhen,220721103,22716,1694,14238,8104,26257,14212,4630,14709,28921,14802,29040
ɻ,ChaGanHuaZhen,220721104,16603,1137,10240,6355,18627,10234,3326,10812,21046,10826,21066
վ,WangFuZhanZhen,220721105,24445,1977,15118,9007,27153,15113,4338,15620,30733,15642,30760
,BaLangZhen,220721106,25257,2398,15555,9245,30040,15541,4063,16108,31649,16163,31718
ë,HaLaMaoDouZhen,220721107,16874,1518,10712,6501,21088,10712,3286,10964,21676,10966,21678
,BaoDianXiang,220721200,10661,858,6585,4127,12774,6582,1978,6895,13477,6912,13497
ƽ,PingFengXiang,220721201,20874,1646,13364,7185,25145,13359,4328,13469,26828,13484,26848
ɹŰ,MengGuAiLiXiang,220721202,22768,1911,14207,8898,26322,14198,3943,14360,28558,14415,28622
,DaLiBaXiang,220721203,8996,619,5501,3167,10119,5494,1561,5619,11113,5675,11176
,JiLaTuXiang,220721204,17053,1319,10838,6288,20338,10837,3169,10694,21531,10703,21541
,BaiYiLaGaXiang,220721205,19561,1370,12510,6786,22883,12493,4049,12440,24933,12470,24980
Ȫ,HongQuanXiang,220721206,15840,1154,9833,5603,19272,9832,3104,10256,20088,10265,20098
,ERuXiang,220721207,15589,1247,9577,5427,18993,9577,3024,10283,19860,10283,19860
׺̫,TaoHaoTaiXiang,220721208,11402,901,7309,4384,13516,7309,2312,7293,14602,7306,14615
,ChangLongXiang,220721209,16228,1239,10156,6412,18461,10146,3131,10415,20561,10442,20598
,WuLanTaLaXiang,220721210,16032,1208,10167,6123,19812,10165,3373,10430,20595,10446,20613
,DongSanJiaZiXiang,220721211,11501,790,7100,4183,14009,7096,2186,7370,14466,7377,14477
â,HaoTeMangHaXiang,220721212,12599,912,7849,4319,15546,7849,2498,8154,16003,8160,16009
,WuLanAoDouXiang,220721213,8979,624,5472,3306,10751,5469,1651,5778,11247,5782,11254
ũ,HongQiNongChang,220721400,7468,866,4862,3035,9108,4860,1234,4703,9563,4706,9568
ũ,HongGuangNongChang,220721401,5542,646,3526,2515,6353,3520,909,3532,7052,3571,7097
,HongXingMuChang,220721402,2223,261,1387,988,2548,1371,348,1392,2763,1445,2832
ɻ,ChaGanHuaZhongChuChang,220721403,2308,244,1533,1113,2673,1525,559,1557,3082,1578,3111
ũ,LianHuaPaoNongChang,220721404,1402,94,863,599,1418,863,230,863,1726,863,1726
ͼֳ,WuLanGaTuLinChang,220721405,114,3,71,41,128,71,19,65,136,65,136
ɻֳ,ChaGanHuaLinChang,220721406,577,62,374,262,267,374,94,359,733,359,733
ֳ,WangFuLinChang,220721407,234,35,156,101,274,156,35,148,304,148,304
ũ,BaLangNongChang,220721408,674,52,419,274,752,419,123,429,848,430,849
ɺ泡,ChaGanHuYuChang,220721409,762,84,447,364,910,447,98,497,944,497,944
ҵֳ,HanJiaDianLinChang,220721410,202,15,126,78,156,126,40,131,257,131,257
ɽ緱ֳ,ChangShanYuReYuMiaoFanZhiChang,220721411,210,25,134,100,180,134,41,142,276,142,276
泡,KuLiYuChang,220721412,221,39,142,118,231,142,20,138,280,138,280
ëֳ,HaLaMaoDouLiangZhongChang,220721413,760,76,457,326,772,457,115,494,951,494,951
ëֳ,HaLaMaoDouLinChang,220721414,141,17,87,71,125,87,18,87,174,89,176
泡,XinMiaoPaoYuChang,220721415,2,0,0,0,2,0,0,0,0,2,2
,ChangLingZhen,220722100,99785,8269,62298,41470,105660,58814,16936,59800,118614,62692,124990
̫ƽ,TaiPingChuanZhen,220722101,27773,2590,16993,12821,32783,16938,4306,17623,34561,17676,34669
ޱ,JuBaoZhen,220722102,25726,2263,16073,8606,32450,16073,5117,17023,33096,17033,33106
̫ƽɽ,TaiPingShanZhen,220722103,21187,1750,13419,6976,26273,13419,4083,13597,27016,13601,27020
ǰߺ,QianQiHaoZhen,220722104,27276,2035,16609,9283,33575,16606,4696,17376,33982,17398,34007
°,XinAnZhen,220722105,32964,2500,20422,11139,41315,20391,6539,21538,41929,21581,42003
ɽ,SanQingShanZhen,220722106,26822,2232,16994,9138,33947,16992,5527,17556,34548,17587,34581
,DaXingZhen,220722107,25841,1946,15806,9143,31991,15794,4642,16577,32371,16623,32429
,BeiZhengZhen,220722108,11422,873,6994,3943,14053,6992,1943,7233,14225,7244,14238
ˮ,LiuShuiZhen,220722109,25268,1612,15985,8301,31782,15984,5418,16285,32269,16313,32298
,YongJiuZhen,220722110,15659,1444,9903,5292,19818,9902,2923,10120,20022,10123,20026
ʢ,LiFaShengZhen,220722111,13727,1062,8490,4564,17222,8485,2655,8942,17427,8954,17444
̫ƽũҵ԰,TaiPingChuanZhenNongYeYuanQuTeShuXiangZhen,220722120,5794,510,3609,2239,7143,3609,960,3652,7261,3655,7264
ҵ԰,BeiZhengZhenMuYeYuanQuTeShuXiangZhen,220722121,2964,188,1752,1058,3449,1751,438,1838,3589,1838,3590
˫ҵ԰,ShuangLongGongYeYuanQuTeShuXiangZhen,220722122,2129,127,1293,723,2563,1293,409,1372,2665,1372,2665
뾭ÿ,ChangLingJingJiKaiFaQuTeShuXiangZhen,220722123,8936,622,5379,3041,10300,5366,1369,5536,10902,5548,10927
,JiTiXiang,220722200,14216,938,8959,4724,17581,8957,3046,9231,18188,9241,18200
,GuangMingXiang,220722201,15586,1056,9754,5184,19683,9754,3297,10185,19939,10185,19939
ر,SanXianBaoXiang,220722202,16659,1341,10354,5362,20694,10352,3157,10792,21144,10803,21157
,HaiQingXiang,220722203,9413,719,5810,3182,11874,5808,1832,6144,11952,6154,11964
ǰ,QianJinXiang,220722204,15692,1152,9861,4894,19582,9861,2985,9963,19824,9968,19829
,DongLingXiang,220722205,12211,892,7598,3859,15095,7593,2270,7766,15359,7775,15373
,YaoTuoZiXiang,220722206,13432,936,8135,4419,16864,8134,2606,8821,16955,8839,16974
ʮ,BaShiBaXiang,220722207,9988,826,6167,3543,12178,6162,1799,6440,12602,6446,12613
,SanTuanXiang,220722208,11310,877,6740,3978,14006,6740,1890,7334,14074,7337,14077
ʮ,SanShiHaoXiang,220722209,11138,918,6786,4187,13240,6786,1689,6953,13739,6959,13745
�,ChangLingZhongMaChang,220722400,224,18,139,74,278,139,43,146,285,146,285
̫ƽеֳ,TaiPingChuanJiXieLinChang,220722405,913,95,552,427,1130,552,123,579,1131,579,1131
Żеֳ,SanTuanJiXieLinChang,220722406,390,42,248,146,492,248,66,250,498,250,498
еֳ,DongLingJiXieLinChang,220722407,229,26,140,103,269,140,30,145,285,145,285
ʮĺ,ShiSiHaoZhongChuChang,220722408,416,35,267,187,529,267,78,262,529,262,529
ַ,LiangZhongFanYuChang,220722409,585,48,347,223,724,347,91,377,724,377,724
ǰߺŻеֳ,QianQiHaoJiXieLinChang,220722410,484,61,300,217,611,300,80,325,625,325,625
Ǭ,QianAnZhen,220723100,75836,6214,46716,34583,82655,46099,11923,46779,92878,47257,93973
,DaBuSuZhen,220723101,22593,1900,13741,9544,26607,13733,3285,14001,27734,14037,27778
ˮ,ShuiZiZhen,220723102,18753,1542,11258,7726,22348,11256,2559,11550,22806,11596,22854
,RangZiZhen,220723103,18166,1292,10881,6548,21801,10881,2745,11322,22203,11322,22203
,SuoZiZhen,220723104,21257,1484,12951,7942,25604,12943,3413,13191,26134,13203,26154
,AnZiZhen,220723105,15603,1011,9844,6750,18524,9842,3144,9889,19731,9914,19758
,YuZiXiang,220723200,16901,1268,10070,6645,20203,10062,2229,10305,20367,10328,20398
,DaoZiXiang,220723201,16635,1494,10396,5992,19844,10389,2470,10179,20568,10203,20599
,YanZiXiang,220723202,12837,871,7995,4598,15472,7995,2115,7816,15811,7828,15823
,ZanZiXiang,220723203,16990,1218,10342,6491,20083,10335,2544,10383,20718,10410,20752
Ӫֳ,GuoYingLinChang,220723400,716,64,423,382,862,423,88,445,868,445,868
,TengZiZhongChuChang,220723401,1422,114,858,618,1558,858,186,864,1722,864,1722
,DaXiaXuMuChang,220723402,4850,404,3163,2233,5785,3163,953,3044,6207,3044,6207
Ǭ¹,QianAnLuChang,220723403,1122,60,642,441,1329,642,148,688,1330,688,1330
ַ,LaiZiLiangZhongFanYuJiDi,220723404,737,66,433,306,812,433,50,420,853,420,853
,DiZiZhongChuChang,220723405,132,17,92,50,166,92,17,74,166,74,166
,SanChaHeZhen,220724100,88320,7668,55128,35638,87929,52971,16444,54968,107939,57304,112432
,ChangChunLingZhen,220724101,40172,3864,25470,14443,48961,25455,6374,24867,50322,24940,50410
վ,WuJiaZhanZhen,220724102,32981,3406,20931,12794,41913,20914,6345,21783,42697,21801,42732
,TaoLaiZhaoZhen,220724103,38387,3786,23756,13608,47080,23731,6803,25152,48883,25220,48976
̼ҹ,CaiJiaGouZhen,220724104,27294,2725,17555,10164,34287,17497,5615,18051,35548,18079,35634
,GongPengZiZhen,220724105,32108,2771,20554,11524,38704,20547,6945,21237,41784,21270,41824
,SanJingZiZhen,220724106,34129,3112,21590,12203,41068,21538,6677,22226,43764,22328,43918
ʢ,ZengShengZhen,220724107,25996,2039,16673,9151,31858,16608,5922,17205,33813,17284,33957
,XinWanFaZhen,220724108,25737,2388,16528,9082,32485,16519,5556,17127,33646,17153,33681
,DaLinZiZhen,220724109,19765,1750,12626,7325,24088,12620,4185,13053,25673,13074,25700
Դ,XinYuanZhen,220724110,12571,1114,7880,4362,15929,7878,2540,8335,16213,8345,16225
ʤ,DeShengZhen,220724111,34628,2873,21268,12240,42668,21266,6059,22287,43553,22292,43560
ɹ,SanJunManZuMengGuZuXiBoZuXiang,220724200,32409,3119,20393,11450,39882,20387,5900,20991,41378,21035,41428
ƽ,YongPingXiang,220724201,22499,1802,14346,8230,27556,14346,4596,14541,28887,14551,28897
,SheLiXiang,220724202,14201,1321,9097,5309,17983,9094,3047,9449,18543,9472,18569
վ,XinZhanXiang,220724203,18420,1606,11662,6709,22592,11660,4055,12404,24064,12419,24081
,GengXinXiang,220724204,19809,1469,12558,6766,24571,12550,4180,12879,25429,12900,25458
Ф,XiaoJiaXiang,220724206,36709,3468,23245,13371,46675,23242,7388,24288,47530,24320,47565
ҵũ,YiJiaDianNongChang,220724400,2569,343,1676,1089,3383,1676,495,1731,3407,1731,3407
ֹ,LaLinGuanQuGuanLiJu,220724401,426,18,261,169,382,261,89,272,533,272,533
ֵ´,HaiMingJieDaoBanShiChu,220802001,26253,3486,16030,12464,23902,15769,3296,15401,31170,17005,33035
ֵ´,ChangQingJieDaoBanShiChu,220802002,36824,4061,24228,18126,43833,24013,5980,22409,46422,22637,46865
ֵ´,RuiGuangJieDaoBanShiChu,220802003,18947,1774,11607,8015,11137,9575,2004,9539,19114,11118,22725
ʽֵ´,MingRenJieDaoBanShiChu,220802004,21419,2570,13773,10709,19284,13613,3299,13370,26983,13515,27288
ֵ´,TieDongJieDaoBanShiChu,220802005,10617,1521,6402,5450,8366,6375,1175,6524,12899,6911,13313
Ͻֵ´,ChengNanJieDaoBanShiChu,220802006,11879,1440,7200,5932,9098,7190,1406,7474,14664,7525,14725
ֵ´,XinLiJieDaoBanShiChu,220802007,12441,1365,7700,5896,6748,7695,1752,7836,15531,7858,15558
Ҹֵ´,XingFuJieDaoBanShiChu,220802008,42858,4534,27790,20845,36110,27083,6763,25748,52831,26365,54155
»ֵ´,XinHuaJieDaoBanShiChu,220802009,26791,4314,17566,13829,25107,17459,3271,16692,34151,16810,34376
ƽֵ´,BaoPingJieDaoBanShiChu,220802010,23916,1340,15355,6634,14224,8033,1698,7850,15883,11599,26954
׳Ǿÿʡֵ,BaiChengJingJiKaiFaQuShengJiTeShuJieDao,220802070,1535,102,898,620,1590,898,248,977,1875,987,1885
ƽ,PingAnZhen,220802100,13016,1365,8326,5922,15703,8326,2397,8426,16752,8452,16778
ɽ,QingShanZhen,220802101,9867,1009,6161,4127,11635,6156,1662,6348,12504,6377,12538
ֺ,LinHaiZhen,220802102,11412,838,7189,4406,13345,7174,2404,7452,14626,7465,14654
䬺,TaoHeZhen,220802103,9351,890,5847,3791,11503,5846,1735,6117,11963,6129,11976
ƽ̨,PingTaiZhen,220802104,12304,1270,7842,5875,13293,7833,2067,7775,15608,7799,15641
,DaoBaoZhen,220802105,9644,932,5839,4262,10724,5829,1493,6176,12005,6230,12069
򣨲ɺξÿ�ʡ,LingXiaZhenChaGanHaoTeLvYouJingJiKaiFaQuShengJi,220802170,15816,1686,10044,6871,18472,10043,2812,10260,20303,10270,20314
,DongFengXiang,220802200,25174,2062,14610,10626,20631,14606,3142,15713,30319,15768,30378
,SanHeXiang,220802201,15444,1352,9361,6435,16368,9360,2588,9996,19356,10023,19384
ʤ,DongShengXiang,220802202,14954,1433,9485,6320,18407,9468,3064,9914,19382,9966,19451
,JinXiangXiang,220802203,11078,947,7145,4273,13675,7138,2451,7307,14445,7331,14476
˳ɹ,DeShunMengGuZuXiang,220802204,14186,1305,8981,5838,17746,8979,2851,9353,18332,9361,18342
Ӫ÷չ,MinYingJingJiFaZhanQuTeShuXiangZhen,220802210,3183,258,2004,1376,3027,2004,664,2101,4105,2101,4105
׳йҵ԰,BaiChengShiGongYeYuanQu,220802401,436,23,270,176,246,270,83,272,542,272,542
,ZhenNanZhongYangChang,220802402,6431,758,4069,2947,6400,4069,1053,4173,8242,4173,8242
׳,BaiChengMuChang,220802403,1754,285,1128,1022,1906,1128,248,1159,2287,1159,2287
䬶ũ,TaoErHeNongChang,220802404,2145,89,1262,837,340,1255,374,1331,2586,1346,2608
ũ,BaoMinNongChang,220802405,2035,212,1273,932,2455,1273,344,1318,2591,1318,2591
ֳ,DaoBaoLinChang,220802406,149,9,87,60,155,87,21,92,179,92,179
,ZhenLaiZhen,220821100,96999,8824,55684,44943,111558,55158,13394,55088,110246,63533,119217
̹;,TanTuZhen,220821101,16542,1703,10210,7626,19856,10207,2540,10538,20745,10575,20785
,DongPingZhen,220821102,8534,902,5167,4381,10288,5165,1178,5433,10598,5447,10614
,DaTunZhen,220821103,17800,1305,10817,8861,20537,10805,3290,11498,22303,11578,22395
ؽ,YanJiangZhen,220821104,6061,559,3626,2918,7122,3623,870,3847,7470,3864,7490
,WuKeShuZhen,220821105,13110,1348,8120,6553,15465,8117,2177,8492,16609,8515,16635
,HeiYuPaoZhen,220821106,13785,1358,8328,6270,16618,8328,2022,8819,17147,8837,17165
ɹ,HaTuQiMengGuZuXiang,220821200,3390,325,2069,1686,4025,2065,539,2145,4210,2185,4254
ĪĪɹ,MoMoGeMengGuZuXiang,220821201,9847,863,6035,4181,11976,6033,1605,6254,12287,6280,12315
ƽ,JianPingXiang,220821202,20530,2049,12597,9157,25200,12590,3294,13246,25836,13276,25873
ʲ,GaShenGenXiang,220821203,17258,1537,10721,7735,21371,10719,3249,11287,22006,11323,22044
ķũ,SiFangTuoZiNongChang,220821400,9495,1870,6193,5905,10205,6190,1139,6286,12476,6311,12504
׺,BaiYinTaoHaiMuChang,220821401,652,69,401,392,736,401,95,407,808,415,816
ַ,LiangZhongFanYuChang,220821402,477,45,283,257,541,283,55,294,577,294,577
ɽ�,JiuLongShanMaChang,220821403,1038,51,636,428,1047,636,192,635,1271,645,1281
ĪĪֳ,MoMoGeLinChang,220821404,228,20,146,116,224,146,38,140,286,140,286
ֳ,DaGangLinChang,220821405,1377,97,845,623,1033,845,228,857,1702,857,1702
Ӫ泡,GuoYingYuChang,220821406,388,42,248,182,477,247,49,230,477,231,479
ũ,DaoBaoNongChang,220821407,1489,180,910,690,1652,909,200,955,1864,959,1869
ͨ,KaiTongZhen,220822100,89344,9083,55292,45764,99679,54301,13611,55919,110220,56746,112038
հ,ZhanYuZhen,220822101,24004,2237,15343,11448,30351,15337,4640,15520,30857,15538,30881
˫,ShuangGangZhen,220822102,8702,681,5295,3658,10556,5295,1418,5496,10791,5506,10801
¡ɽ,XingLongShanZhen,220822103,14962,1133,8937,5912,18452,8936,2604,9724,18660,9762,18699
,BianZhaoZhen,220822104,12283,986,7762,5230,15447,7762,2342,7839,15601,7849,15611
,HongXingZhen,220822105,10294,946,6413,4536,12318,6413,1779,6606,13019,6606,13019
»,XinHuaZhen,220822106,17352,1388,10850,7569,21390,10848,3442,11321,22169,11332,22182
,WuLanHuaZhen,220822107,14229,1047,8858,5629,17745,8858,2756,9155,18013,9174,18032
·,XinFaXiang,220822200,7667,565,4737,2771,9784,4735,1659,5145,9880,5154,9891
,XinXingXiang,220822201,7568,549,4666,3036,9390,4666,1305,4756,9422,4756,9422
ɹ,XiangHaiMengGuZuXiang,220822202,18153,1438,11413,7720,22171,11413,3637,11808,23221,11815,23228
¶ɹ,BaoLaWenDouMengGuZuXiang,220822203,3302,268,2040,1342,4096,2038,702,2225,4263,2232,4272
Ž,TuanJieXiang,220822204,10839,822,6813,4282,13713,6802,2226,7060,13862,7074,13887
ʮ,ShiHuaDaoXiang,220822205,10702,801,6532,4345,13006,6531,1849,6811,13342,6820,13352
,BaMianXiang,220822206,11466,961,7016,4710,13905,7013,1791,7192,14205,7202,14218
չ,SuGongTuoXiang,220822207,9381,706,5868,4020,11529,5868,1684,5894,11762,5903,11771
ܾͨÿ,TongYuJingJiKaiFaQu,220822400,36,7,25,20,43,25,4,22,47,22,47
ţ,SanJiaZiZhongNiuChang,220822401,678,72,427,305,785,425,120,438,863,443,870
,LiangJingZiXuMuChang,220822402,1497,101,924,628,1702,924,303,977,1901,977,1901
˫¹,ShuangGangLuChang,220822403,1120,150,703,547,1085,703,161,728,1431,728,1431
ͬ,TongFaMuChang,220822404,5768,463,3730,2397,6975,3730,1210,3711,7441,3711,7441
»ţ,XinHuaNiuChang,220822405,374,53,250,187,374,250,61,238,488,238,488
Žֵ´,TuanJieJieDaoBanShiChu,220881001,23556,2767,14923,12508,25513,14921,3578,14892,29813,14978,29901
Ľֵ´,FuWenJieDaoBanShiChu,220881002,10586,1198,6298,6515,9956,6190,1227,6546,12736,6713,13011
ֵ´,GuangMingJieDaoBanShiChu,220881003,29903,3302,18982,15109,27272,17953,4088,17515,35468,18311,37293
¡ֵ´,XingLongJieDaoBanShiChu,220881004,10657,1672,6854,6645,12382,6852,1260,6728,13580,6735,13589
ֵ´,YongKangJieDaoBanShiChu,220881005,15384,1817,9466,9172,15127,9466,2067,9791,19257,9802,19268
ֵͨ´,TongDaJieDaoBanShiChu,220881006,13960,1386,8479,7099,12552,8433,1884,8694,17127,8751,17230
䬸ֵ´,TaoFuJieDaoBanShiChu,220881007,13996,1312,8154,6705,13864,8148,1777,8897,17045,8931,17085
ֵ´,XiangYangJieDaoBanShiChu,220881008,11409,971,7005,4771,13025,7004,1816,7186,14190,7191,14196
߷,WaFangZhen,220881100,15606,1486,9809,7526,18991,9809,2867,10150,19959,10150,19959
,WanBaoZhen,220881101,30060,3505,18534,16179,36999,18534,4309,19306,37840,19340,37874
ˮ,HeiShuiZhen,220881102,15838,1320,9843,6838,18199,9840,2687,9866,19706,10002,19845
ǽ,NaJinZhen,220881103,12717,1264,8071,6040,15550,8062,2222,8115,16177,8132,16203
,AnDingZhen,220881104,15119,1286,9471,6157,18250,9471,2877,9803,19274,9811,19282
ɹ,HuLiTuMengGuZuXiang,220881200,5815,593,3690,2868,7289,3690,1144,3862,7552,3862,7552
,WanBaoXiang,220881201,5777,583,3696,2766,7222,3692,1135,3781,7473,3799,7495
۱,JuBaoXiang,220881202,7706,704,4780,3450,9076,4771,1392,4994,9765,5022,9802
,DongShengXiang,220881203,9933,1101,6272,5214,12324,6262,1797,6537,12799,6559,12831
Ұ,YeMaXiang,220881204,7281,705,4605,3126,8944,4605,1363,4744,9349,4744,9349
ï,YongMaoXiang,220881205,11338,1061,7253,5334,13325,7251,2270,7376,14627,7416,14669
,JiaoLiuHeXiang,220881206,14133,1185,9015,6048,17370,9015,2766,9044,18059,9069,18084
ͨ,DaTongXiang,220881207,13249,1138,8232,5902,15771,8231,2597,8752,16983,8752,16984
˳,FuShunXiang,220881208,25702,2502,16652,12033,31586,16652,5694,17238,33890,17246,33898
,ErLongXiang,220881209,13130,1120,7995,5423,15776,7995,2156,8405,16400,8411,16406
ͳɹ,HuHeCheLiMengGuZuXiang,220881210,6014,459,3705,2682,7095,3704,1136,3896,7600,3904,7609
,DongFangHongXuMuChang,220881400,856,64,501,394,842,500,124,541,1041,543,1044
ïֳ,YongMaoLinChang,220881401,277,25,168,145,238,168,36,170,338,170,338
ԭֳ,ShiYuanZhongChang,220881402,1073,73,658,461,1181,658,179,667,1325,667,1325
ֵ´,HuiYangJieDaoBanShiChu,220882001,19567,2669,12098,8858,20902,12078,2564,12632,24710,12702,24800
ٽֵ´,LinJiangJieDaoBanShiChu,220882002,16867,2015,10565,8682,15171,10188,2412,10318,20506,10729,21294
ֵ´,ChangHongJieDaoBanShiChu,220882003,28372,3097,16810,14179,26831,16784,3255,17868,34652,17914,34724
�ֵ´,JinHuaJieDaoBanShiChu,220882004,27354,2978,17150,12610,27759,17134,4205,17368,34502,17387,34537
ֵ´,AnBeiJieDaoBanShiChu,220882005,12883,1891,8106,6262,14486,8104,1554,8222,16326,8222,16328
,YueLiangPaoZhen,220882100,11184,1157,6975,4785,13605,6974,1794,7159,14133,7160,14135
,AnGuangZhen,220882101,31659,3449,18876,15732,34620,18869,3869,20076,38945,20101,38977
,FengShouZhen,220882102,7081,727,4293,3018,8425,4292,959,4467,8759,4474,8767
ƽ,XinPingAnZhen,220882103,8837,930,5318,3711,10767,5318,1320,5769,11087,5769,11087
,LiangJiaZiZhen,220882104,18652,1841,11195,7896,22386,11189,2602,11877,23066,11900,23095
,SheLiZhen,220882105,17549,1707,11068,7806,21283,11068,3307,11495,22563,11495,22563
,DaGangZiZhen,220882106,7689,744,4591,3505,9011,4570,1083,4864,9434,4925,9516
,ChaGanZhen,220882107,8106,859,5093,3775,9787,5087,1525,5385,10472,5397,10490
,LongZhaoZhen,220882108,13554,1384,8125,5164,16475,8121,1924,8725,16846,8737,16862
̫ɽ,TaiShanZhen,220882109,16932,1657,10518,7007,20530,10512,2770,10828,21340,10841,21359
չ,ShaoGuoZhen,220882110,14180,1562,8713,6334,17141,8710,2187,9144,17854,9216,17929
ʤ,LeShengZhen,220882111,18461,1771,11045,7367,22413,11045,2651,11828,22873,11838,22883
Ŀ,SiKeShuXiang,220882200,15395,1705,9533,6421,17912,9478,2235,9724,19202,9802,19335
,LianHeXiang,220882201,13094,1058,8165,4947,15845,8160,2271,8243,16403,8258,16423
,DaLaiXiang,220882202,10095,824,5760,4411,8025,5760,1078,6237,11997,6237,11997
,HongGangZiXiang,220882203,6318,630,3898,2774,7614,3896,946,3972,7868,3996,7894
,HaiTuoXiang,220882204,12677,1385,7650,5354,15189,7649,1666,8061,15710,8078,15728
°ɹ,XinAiLiMengGuZuXiang,220882205,4424,400,2700,1800,5220,2699,661,2772,5471,2785,5485
󰲾ÿʡ,DaAnJingJiKaiFaQuShengJi,220882400,50,4,33,25,60,33,11,32,65,32,65
»泡,XinHuangYuChang,220882401,563,28,308,227,628,307,58,338,645,341,649
ũ,DongFangHongNongChang,220882402,1015,84,637,416,1201,637,146,608,1245,608,1245
ֳ,SheLiLinChang,220882403,155,7,94,69,134,93,28,92,185,96,190
䷿ˮ,WuJianFangShuiKu,220882404,74,14,50,39,84,50,9,47,97,47,97
ֳ,DaGangZiLinChang,220882405,320,28,201,159,323,201,33,180,381,180,381
ˮɽ,FengShuiShanMuChang,220882406,325,49,211,179,418,211,44,207,418,207,418
�,DongFengMaChang,220882407,188,25,114,99,225,114,24,123,237,123,237
ַ,LiangZhongFanYuChang,220882408,342,42,211,168,296,211,55,228,439,228,439
�,DaAnMaChang,220882409,499,43,306,234,596,306,54,290,596,290,596
�,AnGuangZhuChang,220882410,204,21,116,93,246,116,21,130,246,130,246
,HongQiSiYangChang,220882411,203,23,123,96,174,122,20,123,245,123,246
ѧֵ´,JinXueJieDaoBanShiChu,222401001,72841,6412,44967,33340,44056,42120,10359,41238,83358,44645,89612
ɽֵ´,BeiShanJieDaoBanShiChu,222401002,59655,6186,37140,28407,40625,35373,7337,34190,69563,36038,73178
˽ֵ´,XinXingJieDaoBanShiChu,222401003,46294,4794,26990,17445,27646,24023,4588,23101,47124,28686,55676
԰ֵ´,GongYuanJieDaoBanShiChu,222401004,64813,5540,40539,24064,44170,29796,6144,28649,58445,35958,76497
Ͻֵ´,HeNanJieDaoBanShiChu,222401005,71319,8873,44950,35340,47655,43841,9482,42536,86377,44724,89674
ֵ´,JianGongJieDaoBanShiChu,222401006,58403,6901,36949,30691,33714,36776,8039,35842,72618,36394,73343
СӪ,XiaoYingZhen,222401100,23914,3183,14820,11516,6344,14013,3482,14827,28840,15759,30579
,YiLanZhen,222401101,24522,3205,15129,11330,16255,14706,3236,14974,29680,15834,30963
,SanDaoWanZhen,222401102,5276,647,3210,2464,5522,3132,696,3203,6335,3409,6619
,ZhaoYangChuanZhen,222401105,29035,4617,18166,13993,25795,17976,3166,18362,36338,18652,36818
Ͻֵ´,XiangShangJieDaoBanShiChu,222402001,23456,2896,14197,10637,22960,14031,2272,13794,27825,14427,28624
»ֵ´,XinHuaJieDaoBanShiChu,222402002,23420,3258,14438,9712,25174,14333,1832,13984,28317,14072,28510
¹ֵ´,YueGongJieDaoBanShiChu,222402003,19641,2754,11952,8509,20495,11912,1676,12069,23981,12119,24071
,YueQingZhen,222402100,6854,1148,4110,3113,5891,4023,407,4114,8137,4299,8409
ʯ,ShiXianZhen,222402101,18303,3063,11363,8725,20326,11334,1404,11346,22680,11407,22770
,ChangAnZhen,222402102,8069,1242,4829,3601,9289,4780,779,5095,9875,5261,10090
ˮ,LiangShuiZhen,222402103,9861,1355,5786,4535,9594,5747,744,6069,11816,6174,11960
ͼҵ,TuMenShiLinYeJu,222402400,17,1,9,7,12,9,0,9,18,9,18
ֵ´,BoHaiJieDaoBanShiChu,222403001,41942,4791,26686,20827,36965,26608,6054,26020,52628,26101,52787
ʤֵ´,ShengLiJieDaoBanShiChu,222403002,58335,4987,36425,27147,49178,34878,8393,33856,68734,35290,71715
ֵ´,MinZhuJieDaoBanShiChu,222403003,31591,3497,20170,14440,27498,19691,4426,18993,38684,19344,39514
ֵ´,DanJiangJieDaoBanShiChu,222403004,32762,5249,19937,15694,35841,19820,3138,19798,39618,21212,41149
ʯͷ,DaShiTouZhen,222403100,34947,5365,21997,16841,42772,21980,4450,22657,44637,22765,44762
,HuangNiHeZhen,222403101,31736,5082,20411,15658,36756,20405,4565,20954,41359,20972,41383
ٵ,GuanDiZhen,222403102,26754,2939,16813,11782,30571,16370,4924,17399,33769,17804,34617
ɳ,ShaHeYanZhen,222403103,11419,1445,7353,5064,13525,7353,1899,7410,14763,7410,14763
湵,QiuLiGouZhen,222403104,7058,880,4365,3315,8336,4365,1173,4740,9105,4746,9111
,EMuZhen,222403105,9417,920,5706,3975,10650,5694,1579,6172,11866,6210,11916
,XianRuZhen,222403106,9677,1326,5868,4560,11560,5848,1417,6438,12286,6552,12420
Ѳ,DaPuChaiHeZhen,222403107,6943,682,4276,3003,8175,4274,1233,4582,8856,4582,8858
,YanMingHuZhen,222403108,7660,748,4860,3361,9267,4860,1657,5205,10065,5205,10065
Դ,JiangYuanZhen,222403109,7125,813,4429,3261,8306,4429,1277,4784,9213,4786,9215
,JiangNanZhen,222403110,15611,1867,9812,6762,17152,9735,2680,10262,19997,10346,20158
,DaQiaoXiang,222403200,5426,622,3525,2359,6405,3522,978,3496,7018,3501,7026
ʯ,HeiShiXiang,222403201,9255,862,5832,3506,10601,5832,1620,5902,11734,5905,11737
๵,QingGouZiXiang,222403202,4644,413,2902,1748,4966,2891,786,2924,5815,2941,5843
,HanZhangXiang,222403203,8646,977,5352,3877,10260,5342,1521,5766,11108,5792,11144
ʯ,HongShiXiang,222403204,5951,796,3691,2900,6846,3691,961,4017,7708,4017,7708
ҵ޹˾,DanFengLinYeYouXianGongSi,222403400,3034,815,1897,1966,3729,1897,228,2178,4075,2180,4077
ҵ,HuangNiHeLinYeJu,222403401,4270,952,2665,2634,4023,2664,386,2932,5596,2943,5608
ʯͷҵ޹˾,DaShiTouLinYeYouXianGongSi,222403402,3707,853,2275,2319,4606,2275,323,2579,4854,2608,4883
ػҵ,DunHuaShiLinYeJu,222403403,2110,318,1278,1168,2250,1278,206,1356,2634,1356,2634
¹,AoDongLuChang,222403404,175,17,94,81,190,94,12,110,204,110,204
ʯ¹,HongShiLuChang,222403406,136,24,87,81,166,87,7,80,167,80,167
ͽֵ´,JingHeJieDaoBanShiChu,222404001,52920,4605,32433,23260,41615,32208,7954,31721,63929,33046,65479
°ֵ´,XinAnJieDaoBanShiChu,222404002,35071,2638,21163,15067,22330,20279,4535,19730,40009,21081,42244
Ͻֵ´,HeNanJieDaoBanShiChu,222404003,28822,2624,16842,12173,23610,16692,3457,17159,33851,18061,34903
ֵ´,JinHaiJieDaoBanShiChu,222404060,7181,408,4233,2909,2665,3764,816,3926,7690,4172,8405
,ChunHuaZhen,222404100,8249,875,4604,3706,7327,4578,766,5083,9661,5286,9890
,JingXinZhen,222404101,4070,681,2329,2144,3492,2327,263,2677,5004,2685,5014
ʯ,BanShiZhen,222404102,6386,557,3446,2542,3971,3422,605,3668,7090,4102,7548
Ӣ,YingAnZhen,222404103,29608,3286,17474,13332,19558,17427,3241,18532,35959,18661,36135
�,MaChuanZiXiang,222404200,5203,645,2985,2369,3344,2959,453,3196,6155,3316,6301
,YangPaoManZuXiang,222404201,3480,334,1789,1473,2857,1777,315,1965,3742,2340,4129
,SanJiaZiManZuXiang,222404202,6958,796,3793,3021,5215,3777,581,3973,7750,4542,8335
ܽ,MiJiangXiang,222404203,1697,239,900,790,1160,900,82,916,1816,1118,2018
,HaDaMenXiang,222404204,9474,891,5337,4310,6537,5325,726,5718,11043,5754,11091
ҵ,HuiChunLinYeJu,222404400,238,23,145,113,252,145,24,140,285,140,285
ֵ´,AnMinJieDaoBanShiChu,222405001,35314,5232,22290,17804,31668,22157,3844,21502,43659,22100,44390
Žֵ´,LongMenJieDaoBanShiChu,222405002,37001,5311,23057,17299,29898,22039,3785,21837,43876,23040,46097
ɽ,KaiShanTunZhen,222405100,15273,2419,9209,7964,12230,9191,919,9361,18552,9402,18611
ͷ,LaoTouGouZhen,222405102,22900,4656,13932,12640,21136,13885,1322,14797,28682,14946,28878
,SanHeZhen,222405103,3142,529,1804,1684,2111,1793,103,1952,3745,1970,3774
ʢӿ,DongShengYongZhen,222405104,11066,1898,6681,5572,9706,6650,682,6909,13559,6965,13646
,ZhiXinZhen,222405105,11383,1676,6616,5794,9235,6583,791,7111,13694,7234,13850
,DeXinXiang,222405200,4495,709,2656,2255,4642,2638,352,2878,5516,2900,5556
׽,BaiJinXiang,222405201,1450,237,743,867,1267,741,37,921,1662,981,1724
չũ,LongJingDaSuGuoShuNongChang,222405401,590,93,353,317,462,353,25,355,708,355,708
۽ֵ´,MinHuiJieDaoBanShiChu,222406001,10069,1132,6361,4829,10059,6245,1398,6173,12418,6238,12599
ֵ´,GuangMingJieDaoBanShiChu,222406002,27436,3975,16963,14087,27152,16961,3001,17445,34406,17449,34412
Ļֵ´,WenHuaJieDaoBanShiChu,222406003,23662,2952,14798,11303,20573,14725,2911,14402,29127,14727,29525
˼,BaJiaZiZhen,222406100,17815,2886,10825,8796,17990,10824,1289,11164,21988,11165,21990
,FuDongZhen,222406101,8871,1266,5071,4880,8369,5071,676,5740,10811,5742,10813
ͷ,TouDaoZhen,222406102,21461,3245,13102,10180,23840,13068,2032,13572,26640,13636,26738
,XiChengZhen,222406103,7909,1176,4710,3729,7516,4705,621,4986,9691,4996,9706
ƺ,NanPingZhen,222406104,4948,563,2177,2204,2800,2046,259,2419,4465,3593,5770
,DongChengZhen,222406105,7454,1125,4349,3451,7156,4349,384,4614,8963,4614,8963
,ChongShanZhen,222406106,1829,199,993,1022,1323,986,147,1161,2147,1182,2175
,LongChengZhen,222406107,17614,2348,10535,8256,16417,10456,1605,10884,21340,11032,21567
ҵ,HeLongLinYeJu,222406400,1730,233,886,1029,1131,881,54,1049,1930,1131,2017
˼ҵ,BaJiaZiLinYeJu,222406401,2129,392,1258,1209,1357,1257,190,1413,2670,1453,2711
ҵ,HeLongShiLinYeJu,222406402,497,29,204,222,230,191,20,240,431,342,546
ɽίԱ,NanShanSheQuGongZuoWeiYuanHui,222424003,9298,926,5806,4583,6978,5767,1312,5633,11400,5730,11536
ίԱ,DaMingSheQuGongZuoWeiYuanHui,222424004,8390,731,5020,4030,6286,5019,1085,5184,10203,5186,10206
ίԱ,DaChuanSheQuGongZuoWeiYuanHui,222424005,9014,680,5439,3840,6324,5145,1149,5250,10395,5404,10843
ҸίԱ,XingFuSheQuGongZuoWeiYuanHui,222424006,8058,860,5091,3861,5889,5082,1168,4980,10062,4995,10086
ίԱ,XinMinSheQuGongZuoWeiYuanHui,222424007,6243,753,3909,3250,3318,3714,645,3577,7291,3732,7641
»ίԱ,XinHuaSheQuGongZuoWeiYuanHui,222424008,7522,969,4679,4077,5578,4629,852,4628,9257,4664,9343
ίԱ,DongZhenSheQuGongZuoWeiYuanHui,222424009,4675,506,2666,1892,2820,2522,323,2682,5204,2838,5504
ίԱ,JiangBeiSheQuGongZuoWeiYuanHui,222424010,7148,824,4373,3606,4740,4318,843,4334,8652,4442,8815
,WangQingZhen,222424100,10400,1399,6306,5716,7282,6192,840,6219,12411,6333,12639
˹,DaXingGouZhen,222424101,20928,2619,12393,10199,21016,12375,2208,13307,25682,13362,25755
,TianQiaoLingZhen,222424102,9037,1006,5427,4213,7629,5424,1118,5728,11152,5734,11161
ӹ,LuoZiGouZhen,222424103,18224,1838,10803,7152,20014,10760,2608,11470,22230,11867,22670
ٲݹ,BaiCaoGouZhen,222424104,11429,1481,6588,5555,10166,6554,1011,7131,13685,7333,13921
,ChunYangZhen,222424105,12646,1303,7652,6448,12030,7643,1849,8115,15758,8146,15798
,FuXingZhen,222424106,5351,602,3181,2447,5478,3177,773,3523,6700,3545,6726
,DongGuangZhen,222424107,9382,1248,5535,4443,9210,5535,920,6015,11550,6015,11550
,JiGuanXiang,222424200,7018,732,4239,2935,8091,4239,1029,4540,8779,4540,8779
ҵ,WangQingLinYeJu,222424400,16337,3261,10493,9439,15236,10477,1600,10645,21122,10705,21198
ҵ,TianQiaoLingLinYeJu,222424401,13026,3061,8976,7973,15048,8968,1420,8478,17446,8531,17507
˹ҵ,DaXingGouLinYeJu,222424402,7008,1590,4692,4372,8940,4691,729,4612,9303,4635,9327
˹ũ,BaRenGouNongChang,222424404,927,109,550,481,911,550,117,603,1153,603,1153
ӹũ,LuoZiGouNongChang,222424407,1723,145,1094,713,1773,1094,239,1012,2106,1013,2107
ũ,FuXingNongChang,222424408,890,171,565,452,960,565,85,581,1146,581,1146
ֵ´,WengShengJieDaoBanShiChu,222426001,27727,2868,17166,11907,31433,16786,3618,16401,33187,17047,34213
ֵ´,JiuLongJieDaoBanShiChu,222426002,23763,2825,14975,9583,27071,14254,2940,13858,28112,14553,29528
,MingYueZhen,222426100,11342,1553,6917,4877,11407,6883,1441,7383,14266,7419,14336
ɽ,SongJiangZhen,222426101,24673,2719,15397,10347,30533,15349,4537,16346,31695,16532,31929
׺,ErDaoBaiHeZhen,222426102,3800,405,2297,1657,4039,2296,586,2491,4787,2494,4791
,LiangJiangZhen,222426103,10596,1036,6553,4230,13132,6518,1756,6706,13224,6835,13388
ʯ,ShiMenZhen,222426104,6974,1036,4171,3293,4655,4167,511,4337,8504,4350,8521
,WanBaoZhen,222426105,7964,795,4979,3245,9749,4979,1584,5335,10314,5364,10343
,LiangBingZhen,222426106,6826,1023,4181,2753,8377,4178,844,4503,8681,4512,8693
ɽίر,ChangBaiShanBaoHuKaiFaQuGuanWeiHuiChiBeiQuTeShuXiangZhen,222426120,36821,3666,21201,15302,36789,20652,4779,20855,41507,24065,45266
º,XinHeXiang,222426200,5683,684,3366,2413,5673,3346,811,3638,6984,3812,7178
,YongQingXiang,222426201,7993,870,4996,3380,9513,4992,1485,5349,10341,5352,10348
׺ҵ,BaiHeLinYeJu,222426400,1735,340,1113,992,2086,1110,212,1153,2263,1174,2287
ͼҵ޹˾,AnTuLinYeYouXianGongSi,222426401,1348,252,849,717,1323,848,142,858,1706,893,1742
ͼҵ,AnTuXianLinYeJu,222426402,445,40,270,196,459,267,62,273,540,277,547
,HaiGouJinKuang,222426403,2259,341,1393,1159,2345,1390,277,1438,2828,1484,2877
ֵ´,ZhaoLinJieDaoBanShiChu,230102001,24778,3944,16160,9470,23048,14603,2001,13405,28008,14563,30723
·ֵ´,XinYangLuJieDaoBanShiChu,230102002,25538,3952,16094,11086,25746,15955,2040,15305,31260,15436,31530
˳ֵ´,FuShunJieDaoBanShiChu,230102003,31546,4477,19630,13961,30451,19462,2573,18757,38219,18966,38596
ֵֽ´,GongLeJieDaoBanShiChu,230102004,66161,7512,40956,26731,53938,36559,6487,35256,71815,39204,80160
»ֵ´,XinHuaJieDaoBanShiChu,230102005,44370,4122,22256,16420,44265,21807,3533,21705,43512,29769,52025
·ֵ´,ChengXiangLuJieDaoBanShiChu,230102006,27496,3193,15496,10463,23232,13086,2416,13549,26635,17609,33105
ũֵ´,GongNongJieDaoBanShiChu,230102007,28068,2917,15171,10967,19964,14966,2331,15548,30514,18145,33316
־ֵ´,ShangZhiJieDaoBanShiChu,230102008,12437,1557,7390,5554,9006,6921,828,6907,13828,7432,14822
˹ֵֽ´,SiDaLinJieDaoBanShiChu,230102009,19646,3675,13140,8371,20024,11900,2314,11380,23280,12495,25635
ֵͨ´,TongJiangJieDaoBanShiChu,230102010,21138,3503,13548,7578,16467,10608,1199,9849,20457,12292,25840
γֵ´,JingWeiJieDaoBanShiChu,230102011,33244,5518,21499,13973,33656,19530,3244,18603,38133,20507,42006
ֵ̽´,GongChengJieDaoBanShiChu,230102012,29631,5862,19237,13468,29855,18654,2401,17586,36240,18657,37894
ֵ´,AnJingJieDaoBanShiChu,230102013,42378,7531,27186,18677,43196,26645,3588,25600,52245,26311,53497
ͽֵ´,AnHeJieDaoBanShiChu,230102014,24820,3796,15853,10030,22696,15713,2331,14871,30584,15094,30947
ӽֵ´,ZhengYangHeJieDaoBanShiChu,230102015,60305,9727,37891,26464,54104,37178,4859,36016,73194,37000,74891
ֵ´,JianGuoJieDaoBanShiChu,230102016,50348,5907,30404,23080,45812,29724,4629,29514,59238,30480,60884
ֵ´,KangAnJieDaoBanShiChu,230102017,33066,3913,20988,15558,29348,20843,4198,20022,40865,20189,41177
ֵ´,AiJianJieDaoBanShiChu,230102018,8185,893,5179,4546,5140,5166,839,4731,9897,4738,9917
̫ƽ,TaiPingZhen,230102101,28295,2390,16888,10035,28554,16502,4345,16836,33338,18142,35030
·,XinFaZhen,230102102,64206,3154,35215,22754,40895,30419,8441,31399,61818,40586,75801
ũ,XinNongZhen,230102103,25261,2015,14104,7178,20864,11175,2968,11563,22738,16140,30244
,YuShuZhen,230102104,22188,1258,11318,5784,14629,9333,2222,9356,18689,14350,25668
Ⱥ,QunLiXiang,230102200,31770,2516,17922,13306,17657,16268,3450,16812,33080,19814,37736
ּҸũ,YanJiaGangNongChang,230102500,1844,273,1123,975,2239,1123,201,1195,2318,1195,2318
԰ֵ´,HuaYuanJieDaoBanShiChu,230103001,41920,4338,18635,11624,34190,15042,2891,14620,29662,30514,49149
ܶ·ֵ´,FenDouLuJieDaoBanShiChu,230103002,85405,9217,50749,25523,74039,34692,5572,32677,67369,49445,100194
½ֵ´,GeXinJieDaoBanShiChu,230103003,39913,5314,23619,13999,28994,19467,2939,18138,37605,24547,48166
Ļֵ´,WenHuaJieDaoBanShiChu,230103004,33994,4294,20634,15640,30356,20116,3384,19693,39809,21038,41672
ɽֵ´,DaChengJieDaoBanShiChu,230103005,50301,5104,28685,17625,38791,24135,4821,23103,47238,31541,60226
«ҽֵ´,LuJiaJieDaoBanShiChu,230103006,75085,9629,45453,32186,60657,42687,6984,42018,84705,46245,91698
нֵ´,RongShiJieDaoBanShiChu,230103007,93065,10348,56887,31016,85497,47424,12544,45942,93366,59070,115957
ԭֵ´,LiaoYuanJieDaoBanShiChu,230103009,67480,7879,38356,23850,57252,32566,6435,30106,62672,43438,81794
ɻֵ´,SongHuaJiangJieDaoBanShiChu,230103010,41921,5831,24451,15125,34771,21335,3669,20830,42165,26970,51421
ֵ߽´,QuXianJieDaoBanShiChu,230103011,27431,2907,15353,8642,16481,11344,2008,10749,22093,16993,32346
ֵͨ´,TongDaJieDaoBanShiChu,230103012,33627,4866,21300,16176,31848,20966,3619,20391,41357,20812,42112
ֵ´,QiZhengJieDaoBanShiChu,230103013,42816,5865,27984,18180,40318,24799,4863,23696,48495,25560,53544
·ֵ´,HeXingLuJieDaoBanShiChu,230103015,109181,11341,68562,38728,83442,52274,11122,50979,103253,63082,131644
ֵ´,HaXiJieDaoBanShiChu,230103016,80067,5234,42565,19102,36908,22273,4503,22241,44514,47239,89804
·ֵ´,BaoJianLuJieDaoBanShiChu,230103017,70993,7111,43581,25638,47098,32776,7184,31541,64317,41707,85288
ȷ·ֵ´,XianFengLuJieDaoBanShiChu,230103018,64681,6279,37664,25547,47904,34499,6584,33481,67980,39880,77544
´ֵ´,XinChunJieDaoBanShiChu,230103019,66699,5816,41211,30046,49145,39697,10931,38042,77739,42235,83446
Ծֵ´,YueJinJieDaoBanShiChu,230103020,29347,1764,16935,8756,10458,10132,1973,10539,20671,16149,33084
,WangGangZhen,230103101,44642,3359,26581,18247,31517,24912,6157,25146,50058,27577,54158
,HongQiManZuXiang,230103201,17228,1228,10360,5869,15901,9259,2154,9308,18567,10250,20610
ֵ´,JingYuJieDaoBanShiChu,230104001,23077,2903,14440,11024,20460,14438,2246,13780,28218,13786,28226
̫Žֵ´,TaiGuJieDaoBanShiChu,230104002,28192,3699,17347,13364,29655,17247,2552,16948,34195,17096,34443
ֵ´,DongLaiJieDaoBanShiChu,230104003,14455,1788,8944,6968,13145,8901,1437,8660,17561,8736,17680
�ֵ´,BinJiangJieDaoBanShiChu,230104004,28839,3713,17689,13794,25456,17605,2805,17510,35115,17668,35357
ֵ´,RenLiJieDaoBanShiChu,230104005,17199,2106,10355,7568,15589,10053,1477,9906,19959,10427,20782
нֵ´,NanShiJieDaoBanShiChu,230104006,9497,1100,5942,4406,7978,5916,1101,5697,11613,5756,11698
ֵ´,ChongJianJieDaoBanShiChu,230104007,15638,1471,9529,7422,8511,9491,1833,9365,18856,9413,18942
񽭽ֵ´,ZhenJiangJieDaoBanShiChu,230104008,9755,1194,5506,3981,6756,5002,628,5011,10013,6071,11577
ԭֵ´,DongYuanJieDaoBanShiChu,230104009,17953,2445,11026,8343,14460,10815,1604,10500,21315,10976,22002
˽ֵ´,DaXingJieDaoBanShiChu,230104010,26713,4097,16954,12766,21776,16645,2527,15832,32477,16383,33337
ʤֵ´,ShengLiJieDaoBanShiChu,230104011,14848,1856,8852,7926,13047,8847,1125,8967,17814,8977,17829
ֵ´,NanMaJieDaoBanShiChu,230104012,39584,5080,25244,16975,31956,21964,3748,21359,43323,23168,48412
ǿֵ´,MinQiangJieDaoBanShiChu,230104021,27298,1593,12452,5738,13101,8442,1634,8005,16447,18073,30525
зֵ´,DaYouFangJieDaoBanShiChu,230104022,57417,6780,36118,25335,46945,35057,7185,33560,68617,35264,71382
ֱ·ֵ´,NanZhiLuJieDaoBanShiChu,230104023,79033,10130,49782,37819,60752,49405,9791,48647,98052,49172,98954
ֵ´,HuaGongJieDaoBanShiChu,230104024,21030,1785,11293,9609,13619,10910,1816,12087,22997,13338,24631
ͷֵ´,HuoCheTouJieDaoBanShiChu,230104025,35796,4939,22060,16420,27446,21920,3498,21735,43655,22173,44233
һֵ´,XinYiJieDaoBanShiChu,230104026,44445,5126,25412,20555,31084,24681,4318,26293,50974,28477,53889
ֵֽ´,SanKeShuDaJieJieDaoBanShiChu,230104027,30807,3566,18652,13904,27235,18139,3102,18182,36321,18823,37475
ˮ·ֵ´,ShuiNiLuJieDaoBanShiChu,230104028,7020,1209,4397,3564,6516,4385,563,4342,8727,4395,8792
̫ƽֵֽ´,TaiPingDaJieJieDaoBanShiChu,230104029,26844,2571,15707,11455,21478,15408,2983,15497,30905,16691,32398
軪ֵ´,LiHuaJieDaoBanShiChu,230104030,30294,3168,18449,14314,23552,18254,3500,18023,36277,18513,36962
ֵֽ´,XinLeJieDaoBanShiChu,230104031,9811,1150,5996,4698,9099,5894,875,5693,11587,5840,11836
Դ,YongYuanZhen,230104102,30922,2735,19173,11780,34841,19164,5035,19504,38668,19519,38692
Դ,JuYuanZhen,230104109,26545,2135,14713,8832,30834,14629,3583,14633,29262,17550,32263
Ž,TuanJieZhen,230104111,43280,3102,25139,17187,34171,24527,6404,25299,49826,27647,52786
,MinZhuXiang,230104200,25510,1967,15656,9707,23684,15585,3840,15516,31101,15661,31317
ũ,QingNianNongChang,230104500,1,0,0,1,1,0,0,1,1,1,1
˽ֵ´,XingJianJieDaoBanShiChu,230108001,23997,3238,15100,11404,20271,14808,3090,14541,29349,15225,30325
ֵ´,BaoGuoJieDaoBanShiChu,230108002,18881,2594,11387,8453,17685,11018,1988,10699,21717,12076,23463
˽ֵ´,LianMengJieDaoBanShiChu,230108003,25775,5573,15899,13417,24556,15391,2667,15595,30986,18116,34015
Эֵ´,YouXieJieDaoBanShiChu,230108004,21620,4111,14096,11064,21911,13914,2570,13582,27496,14205,28301
½ֵ´,XinJiangJieDaoBanShiChu,230108005,21393,4096,13788,11130,18730,13645,2290,13370,27015,13991,27779
ΰֵ´,XinWeiJieDaoBanShiChu,230108006,12583,2929,8371,6971,12522,8358,1331,8418,16776,8472,16843
ƽ,PingFangZhen,230108101,12206,868,7371,5200,9895,7320,1966,7436,14756,7669,15040
ƽ,PingXinZhen,230108102,11888,927,7244,5559,11246,7211,1672,7091,14302,7243,14487
ֵ´,SanDianJieDaoBanShiChu,230109001,2995,525,2035,1559,529,1776,340,1672,3448,1825,3860
̫�ֵ´,TaiYangDaoJieDaoBanShiChu,230109002,381,46,201,106,126,119,12,140,259,238,439
ֵֽ´,SongPuJieDaoBanShiChu,230109003,62802,3653,29622,16438,33854,19258,4414,19592,38850,41247,70869
򱦽ֵ´,WanBaoJieDaoBanShiChu,230109004,20207,1976,12668,10413,22086,12608,3408,12795,25403,12923,25591
ɱֵ´,SongBeiJieDaoBanShiChu,230109005,64209,4098,38927,18797,30284,25224,6436,25207,50431,35816,74743
ɽ,DuiQingShanZhen,230109101,23030,2435,14729,8641,27307,14587,4402,14705,29292,15138,29867
ҵ,LeYeZhen,230109102,24128,2422,15547,9222,28224,15434,4929,15749,31183,15932,31479
㷻ֵֽ´,XiangFangDaJieJieDaoBanShiChu,230110001,32896,4572,21308,15196,29762,20978,4352,19954,40932,20512,41820
ֵ´,AnBuJieDaoBanShiChu,230110002,24909,3005,15902,11538,20682,15613,3343,14975,30588,15355,31257
ֵͨ´,TongTianJieDaoBanShiChu,230110003,31869,3759,18416,13036,24744,16695,3093,16351,33046,20305,38721
㷻ֵ´,XinXiangFangJieDaoBanShiChu,230110004,13686,1711,8416,6591,8459,8267,1762,8507,16774,8743,17159
ֵ´,TieDongJieDaoBanShiChu,230110005,52023,3569,31038,11127,27269,13590,2382,13949,27539,26936,57974
³ɽֵ´,XinChengJieDaoBanShiChu,230110006,37799,5571,22890,16229,35206,21851,3988,21717,43568,24468,47358
ֵ´,HongQiJieDaoBanShiChu,230110007,46897,7111,30094,21800,44352,29768,5296,28798,58566,29210,59304
˳ֵ´,LiuShunJieDaoBanShiChu,230110008,42895,6214,27892,20272,41171,26571,4578,25213,51784,25795,53687
ֵ´,JianZhuJieDaoBanShiChu,230110009,32091,2625,18539,13490,16305,14097,2416,14943,29040,18593,37132
ƽ·ֵ´,HaPingLuJieDaoBanShiChu,230110010,21941,3093,13963,10469,16440,13327,2569,12805,26132,13640,27603
ֵֽ´,AnLeJieDaoBanShiChu,230110011,17009,3084,10538,7719,15969,9931,1511,9742,19673,11066,21604
·ֵ´,JianKangLuJieDaoBanShiChu,230110012,21688,4158,14346,11047,18846,14201,2481,13675,27876,13981,28327
·ֵ´,DaQingLuJieDaoBanShiChu,230110013,39024,5958,25072,19283,35571,24995,4848,24408,49403,24758,49830
ֵ´,JinXiangJieDaoBanShiChu,230110014,30465,6485,19692,15086,28959,19450,2761,19168,38618,20019,39711
ֵͨ´,TongXiangJieDaoBanShiChu,230110015,20822,3350,13276,10511,15901,13249,2393,13208,26457,13289,26565
ƽ·ֵ´,HePingLuJieDaoBanShiChu,230110016,31221,4567,20199,14907,29451,20040,4274,19012,39052,19863,40062
·ֵ´,MinShengLuJieDaoBanShiChu,230110017,18026,3537,11724,8739,16757,11630,1916,11407,23037,11755,23479
ֵ´,WenZhengJieDaoBanShiChu,230110018,46991,3537,27175,9455,32024,12087,2141,11716,23803,25494,52669
׽ֵ´,WangZhaoJieDaoBanShiChu,230110019,10550,1791,7218,4943,8499,6562,1463,6117,12679,6586,13804
ֵ´,LiMingJieDaoBanShiChu,230110020,63084,5338,36808,28170,36396,36598,8434,37558,74156,40048,76856
ɸ,ChengGaoZiZhen,230110101,20843,1992,12468,8605,18039,12349,2399,12485,24834,12766,25234
Ҹ,XingFuZhen,230110102,34979,2101,20610,13745,18984,20304,5645,21714,42018,22115,42725
,ZhaoYangZhen,230110103,42811,2241,23718,11098,25889,15581,3721,15844,31425,25055,48773
,XiangYangXiang,230110201,11807,1059,7307,4002,12411,7081,1888,7195,14276,7447,14754
ӽֵ´,LanHeJieDaoBanShiChu,230111001,63517,5758,38936,35697,56684,38515,10001,40032,78547,40340,79276
ֵ´,HuLanJieDaoBanShiChu,230111002,56533,5264,35710,26645,44376,30728,7785,31758,62486,33872,69582
·ֵ´,JianSheLuJieDaoBanShiChu,230111003,28840,2437,15602,12318,26412,15554,4347,15694,31248,20022,35624
ֵ´,LiMinJieDaoBanShiChu,230111004,59671,2130,40459,11736,20323,17152,4905,16984,34136,26247,66706
ѧԺ·ֵ´,XueYuanLuJieDaoBanShiChu,230111005,88215,1164,47007,8851,13093,10425,2517,10757,21182,44889,91896
ֵ´,YaoBuJieDaoBanShiChu,230111006,17769,1671,11073,7601,20922,11068,3249,11608,22676,11616,22689
ֵ´,KangJinJieDaoBanShiChu,230111007,60685,6225,37731,25246,70647,37622,9533,38590,76212,38712,76443
˫ֵ´,ShuangJingJieDaoBanShiChu,230111008,20601,1602,12432,7663,22816,12424,3331,13074,25498,13102,25534
,ShenJiaZhen,230111104,18973,1809,11875,6926,22619,11848,3091,11969,23817,11998,23873
,ErBaZhen,230111105,19427,1661,11661,6690,22476,11630,2873,12118,23748,12300,23961
ʯ,ShiRenZhen,230111106,21473,1826,13522,8223,25648,13522,3719,13496,27018,13496,27018
׿,BaiKuiZhen,230111107,24031,2038,14636,8946,28510,14388,3615,14688,29076,15048,29684
̨,FangTaiZhen,230111109,22502,1959,13919,8263,27108,13916,3635,14176,28092,14177,28096
,LianHuaZhen,230111110,20075,1695,12591,7517,24106,12591,3401,12580,25171,12580,25171
,DaYongZhen,230111111,21379,1825,13311,7429,25599,13237,3564,13372,26609,13457,26768
,ChangLingZhen,230111113,20248,1720,12811,7039,23547,12804,3397,12543,25347,12554,25365
,YangLinXiang,230111201,22031,1909,13583,7999,26067,13583,3859,14215,27798,14216,27799
�,XuBuXiang,230111203,20157,1883,12646,7734,24432,12467,3455,12634,25101,12849,25495
ϼ,MengJiaXiang,230111205,26731,2157,16486,9781,32091,16482,4666,17052,33534,17068,33554
ǽֵ´,JinChengJieDaoBanShiChu,230112001,58362,5167,35698,25329,46660,34545,8412,34255,68800,36243,71941
𶼽ֵ´,JinDouJieDaoBanShiChu,230112002,71811,6826,43047,33289,70933,38304,9003,38455,76759,44593,87640
ͨǽֵ´,TongChengJieDaoBanShiChu,230112003,18744,2281,11736,8664,11367,11644,2512,11717,23361,11801,23537
Ӷֵ´,HeDongJieDaoBanShiChu,230112004,18709,3190,12043,8846,20489,12028,2024,11839,23867,11880,23923
ʲӽֵ´,AShenHeJieDaoBanShiChu,230112005,38272,2553,21694,13864,38370,21267,4845,21964,43231,23976,45670
Ȫֵ´,YuQuanJieDaoBanShiChu,230112006,23674,3338,14745,11545,28036,14745,2910,15162,29907,15177,29922
ֵ´,XinLiJieDaoBanShiChu,230112007,29296,2408,18279,10294,33384,17858,4439,17495,35353,17864,36143
˫ֵ´,ShuangFengJieDaoBanShiChu,230112008,21431,1920,14181,6822,19278,10841,2928,11088,21929,12098,26279
ֵ´,SheLiJieDaoBanShiChu,230112009,28768,2720,17417,11576,32633,16211,3848,16689,32900,17919,35336
ͼ,FeiKeTuZhen,230112103,18601,1644,11521,6753,21689,11289,3136,11639,22928,11860,23381
ǹ,YaGouZhen,230112104,11265,1135,6920,4648,11953,6918,1794,7270,14188,7274,14194
,JiaoJieZhen,230112105,14546,1367,8863,6208,16495,8855,2121,9136,17991,9171,18034
С,XiaoLingZhen,230112106,19623,2035,11875,8348,22003,11387,2712,11906,23293,12495,24370
ƽɽ,PingShanZhen,230112107,19026,1927,11795,7602,22059,11795,2990,12148,23943,12148,23943
ɷɽ,SongFengShanZhen,230112108,9339,725,5461,3565,10257,5427,1280,5768,11195,5883,11344
,HongXingZhen,230112109,12288,1067,7331,4518,13344,7291,1715,7444,14735,7739,15070
,YangShuXiang,230112202,22842,2119,14150,8545,27564,14141,3946,14728,28869,14757,28907
ϵ,LiaoDianManZuXiang,230112205,33021,3295,20247,13175,39415,20231,5053,21058,41289,21122,41369
,DaLingXiang,230112207,12716,1095,7721,4890,14796,7504,2042,7902,15406,8132,15853
,YiLanZhen,230123100,71050,8733,45059,38532,73276,44842,10884,45255,90097,45608,90667
,DaLianHeZhen,230123101,47350,4598,29607,22328,53610,29479,8403,30496,59975,30744,60351
,JiangWanZhen,230123102,23759,1902,14719,9082,29623,14675,4745,15630,30305,15687,30406
,SanDaoGangZhen,230123103,32974,2604,20887,12665,41182,20875,7125,21783,42658,21816,42703
̨,DaoTaiQiaoZhen,230123104,33092,2607,20774,13492,41185,20738,7163,21924,42662,22088,42862
,HongKeLiZhen,230123105,17270,1611,10901,7479,21390,10900,3325,11304,22204,11305,22206
ɽ,TuanShanZiXiang,230123200,22495,2080,14224,9446,27905,14220,4574,14906,29126,14925,29149
޹,YuGongXiang,230123201,27979,2575,17882,10998,35927,17872,5940,18606,36478,18612,36494
ӭ,YingLanChaoXianZuXiang,230123202,19202,1837,11846,7710,22383,11841,3123,12283,24124,12316,24162
ҵ,YiLanXianLinYeJu,230123400,2377,343,1451,1162,2047,1451,309,1575,3026,1578,3029
ũ,YiLanNongChang,230123500,2165,409,1426,1138,2427,1423,313,1455,2878,1461,2887
ɻũ,SongHuaJiangNongChang,230123501,2592,430,1677,1448,2699,1677,381,1726,3403,1726,3403
,FangZhengZhen,230124100,49927,4275,30832,24241,41158,30324,7878,30442,60766,31248,62080
ᷢ,HuiFaZhen,230124101,21481,1532,13179,8097,23455,13178,3926,13744,26922,13760,26939
,DaLuoMiZhen,230124102,12183,1045,7164,5317,10941,7164,1627,7691,14855,7691,14855
,TianMenXiang,230124200,15682,1116,9533,6012,16676,9533,2837,10093,19626,10102,19635
,SongNanXiang,230124201,9307,645,5793,3559,9673,5784,1805,5961,11745,5964,11757
,DeShanXiang,230124202,11104,879,6683,4424,10611,6630,1802,7011,13641,7102,13785
,BaoXingXiang,230124204,12904,938,7869,4994,13223,7868,2234,8199,16067,8207,16076
ͨ,YiHanTongXiang,230124205,6873,494,4234,2564,7112,4166,1214,4304,8470,4347,8581
ҵ,FangZhengLinYeJu,230124400,21757,3274,14066,11251,26716,14064,3194,14147,28211,14159,28225
ɳũ,ShaHeNongChang,230124500,1465,163,959,702,1479,936,292,930,1866,961,1920
,BinZhouZhen,230125100,99246,9167,62131,44253,103835,60984,16304,61638,122622,62586,124717
,JuRenZhen,230125101,16894,1430,10466,6475,19788,10465,3025,10871,21336,10883,21349
,BinXiZhen,230125102,30915,2590,19051,12436,30571,19024,5463,19887,38911,19917,38968
Ƿ,TangFangZhen,230125103,27882,2566,17389,11054,34793,17389,5172,18219,35608,18231,35620
,BinAnZhen,230125104,23040,2168,14715,10093,28247,14704,4494,14962,29666,14987,29702
µ,XinDianZhen,230125105,18589,1698,11640,7835,22643,11635,3242,11866,23501,11889,23529
ʤ,ShengLiZhen,230125106,22604,1923,14058,9314,27986,14048,4363,14811,28859,14832,28890
Զ,NingYuanZhen,230125107,30631,2628,19143,11748,38170,19123,6249,20281,39404,20365,39508
ڶ,BaiDuZhen,230125109,10795,864,6726,4543,12973,6726,2167,7099,13825,7100,13826
ƽ,PingFangZhen,230125110,15883,1639,9762,7261,18929,9760,2544,10298,20058,10304,20066
,ManJingZhen,230125111,19938,1904,12559,7730,25164,12550,3641,12890,25440,12924,25483
,ChangAnZhen,230125112,26554,2240,16599,10334,33101,16597,4995,17155,33752,17190,33789
,YongHeXiang,230125201,10196,948,6312,3934,12389,6308,1844,6664,12972,6676,12988
,NiaoHeXiang,230125203,23710,2132,14686,9484,29380,14662,4346,15431,30093,15502,30188
,MinHeXiang,230125204,16254,1512,10124,6502,20358,10096,3070,10651,20747,10712,20836
,JingJianXiang,230125205,15974,1361,9888,5797,19934,9875,2857,10272,20147,10304,20192
,SanBaoXiang,230125210,21703,1832,13476,8580,26716,13470,4144,14176,27646,14203,27679
ɽֳ,JiuLongShanZuoCanYuZhongChang,230125500,62,19,42,45,81,42,2,41,83,41,83
ũũҵְҵѧԺ,NongKenNongYeZhiYeXueYuan,230125579,3850,1,1607,77,0,69,7,61,130,2251,3858
,BaYanZhen,230126100,71741,6675,44757,29696,75581,43355,11407,43470,86825,45066,89823
¡,XingLongZhen,230126101,52741,4532,32739,20962,59904,31964,8736,32845,64809,33270,66009
,XiJiZhen,230126102,22714,1881,14413,9479,27112,14375,4486,14532,28907,14668,29081
,WaXingZhen,230126103,21062,1637,13020,7471,25949,12992,4087,13617,26609,13766,26786
Ȫ,LongQuanZhen,230126104,20572,1681,12499,7333,24958,12495,3400,13129,25624,13154,25653
,BaYanGangZhen,230126105,15641,1173,9568,5649,18968,9565,2533,9777,19342,9779,19347
,LongMiaoZhen,230126106,21744,1916,13395,8064,26565,13395,3858,14118,27513,14123,27518
,WanFaZhen,230126107,22813,2062,13951,8126,27601,13945,3952,14811,28756,14876,28827
,TianZengZhen,230126108,28031,2426,17401,9946,34704,17401,5045,18101,35502,18101,35502
ɽ,HeiShanZhen,230126110,15520,1048,9471,5538,19061,9467,2934,10024,19491,10031,19502
ɻ,SongHuaJiangXiang,230126200,21834,1732,13440,8561,26489,13429,3798,13900,27329,13924,27364
,FuJiangXiang,230126202,15561,1030,9384,5234,18346,9384,2365,9566,18950,9572,18956
ɽ,HuaShanXiang,230126204,18466,1374,11366,7132,22583,11366,3383,11857,23223,11857,23223
,FengLeXiang,230126205,23039,1978,14634,9174,28183,14627,4405,14772,29399,14788,29422
,DeXiangXiang,230126209,28358,2121,17635,9013,34507,17635,4932,17776,35411,17776,35411
,HongGuangXiang,230126210,28501,2422,17434,10456,34884,17431,4860,18329,35760,18349,35783
ɽ,ShanHouXiang,230126212,21973,1686,13755,7058,27140,13755,4010,13914,27669,13914,27669
,ZhenDongXiang,230126214,10777,710,6717,3626,13285,6717,2173,6943,13660,6943,13660
¡ҵ,XingLongLinYeJu,230126400,8815,1265,5541,4150,10564,5476,939,5358,10834,5478,11019
ľ,MuLanZhen,230127100,51916,5590,31927,26067,53335,31788,7702,32926,64714,33281,65208
,DongXingZhen,230127101,33886,2595,20262,13412,39262,20184,5207,21366,41550,21426,41688
,DaGuiZhen,230127102,25993,1947,15767,9342,32041,15764,4615,16784,32548,16788,32555
,LiDongZhen,230127103,13409,854,8067,4732,15912,8067,2202,8398,16465,8398,16465
,LiuHeZhen,230127104,33638,2789,20253,12069,41100,20089,5187,21250,41339,21361,41614
,XinMinZhen,230127105,22654,1557,13986,7514,27730,13986,4220,14445,28431,14445,28431
,JianGuoXiang,230127200,16560,1209,9839,6273,19986,9827,2585,10505,20332,10515,20354
,JiXingXiang,230127203,20187,1344,12233,6769,24950,12227,3450,12734,24961,12748,24981
¡ҵְ´,XingLongLinYeJuBanShiChu,230127400,5114,714,3136,2649,5556,3136,561,3245,6381,3253,6389
ͨ,TongHeZhen,230128100,59208,6263,37216,25275,72894,36963,9627,37611,74574,37882,75098
ѻ,WuYaPaoZhen,230128101,9513,1122,6076,4494,11717,6076,1754,6313,12389,6313,12389
,QingHeZhen,230128102,13305,1133,8330,5378,14614,8330,2430,8537,16867,8538,16868
Ũ,NongHeZhen,230128103,15536,1029,9840,6655,19240,9840,3621,10346,20186,10346,20186
ɽ,FengShanZhen,230128104,8887,735,5496,3792,10141,5496,1758,5884,11380,5884,11380
˳,XiangShunZhen,230128105,14494,1045,9080,5992,18127,9071,3437,9819,18890,9896,18976
վ,SanZhanXiang,230128201,7144,567,4356,3013,8813,4356,1388,4743,9099,4743,9099
,FuLinXiang,230128202,12243,916,7668,5303,15334,7652,2739,8168,15820,8230,15898
ҵ,QingHeLinYeJu,230128400,16305,2008,10151,8379,19150,10134,2294,10448,20582,10456,20607
¡ҵְ´,XingLongLinYeJuBanShiChu,230128401,5256,890,3329,2941,6114,3324,542,3338,6662,3359,6688
ֺũ,ChaLinHeNongChang,230128500,2805,266,1716,1275,3355,1716,390,1745,3461,1745,3461
,YanShouZhen,230129100,65255,5814,39548,28699,68720,38762,9432,40160,78922,40953,80501
,LiuTuanZhen,230129101,17594,1306,10561,6898,21007,10558,3064,11388,21946,11403,21964
к,ZhongHeZhen,230129102,11703,1015,6951,4748,13578,6938,1880,7623,14561,7647,14598
,JiaXinZhen,230129103,19373,1442,11722,6582,23522,11722,3224,12316,24038,12317,24039
Ӻ,YanHeZhen,230129104,16769,1440,10162,6968,19190,10159,2875,10865,21024,10922,21084
ɽ,AnShanXiang,230129204,14976,1039,8971,5759,18520,8971,2706,9750,18721,9750,18721
ɽ,ShouShanXiang,230129205,11501,944,6742,4871,13572,6741,1881,7563,14304,7584,14326
,YuHeXiang,230129206,17225,1450,10357,6983,19966,10350,2941,11241,21591,11259,21616
ന,QingChuanXiang,230129209,13426,1033,8007,5463,16615,8007,2516,8967,16974,8968,16975
̫ƽ,TaiPingChuan,230129400,841,77,533,343,999,482,142,490,972,527,1060
ũ,QingYangNongChang,230129500,6071,578,3708,2763,6894,3708,922,3863,7571,3863,7571
˫нֵί,ShuangChengShiJieDaoGuanWeiHui,230182001,150989,12463,83996,61837,163898,71223,14256,77766,148989,93712,177708
˫,ShuangChengZhen,230182100,33103,2553,19876,12486,36636,19864,5045,20550,40414,20825,40701
,LanLengZhen,230182101,30816,2870,19073,11008,37600,19060,5358,19931,38991,19971,39044
ܼ,ZhouJiaZhen,230182102,27335,2197,16702,10907,30127,16571,4264,17012,33583,17094,33796
,WuJiaZhen,230182103,30964,2487,18674,11286,37076,18673,4444,19218,37891,19221,37895
,HanDianZhen,230182104,30473,2337,18909,10044,38037,18902,5983,19849,38751,19884,38793
,DanChengZhen,230182105,15642,1463,10078,5897,19097,10078,3305,10332,20410,10332,20410
,DongGuanZhen,230182106,18600,1623,11235,6770,22485,11235,2741,11716,22951,11729,22964
ũ,NongFengManZuXiBoZuZhen,230182107,16829,1567,10087,7042,20562,10087,2431,10740,20827,10740,20827
ɽ,XingShanZhen,230182108,22518,2082,14155,8083,28082,14155,4243,14688,28843,14688,28843
,ZhaoYangXiang,230182200,40263,3315,24551,14327,49355,24545,7272,26258,50803,26299,50850
,JinChengXiang,230182201,17535,1767,11106,6336,22136,11106,3355,11539,22645,11551,22657
,QingLingManZuXiang,230182203,16054,1407,9819,6126,19268,9816,2377,10010,19826,10019,19838
,LianXingManZuXiang,230182204,15574,1418,9559,5856,18610,9559,2539,9972,19531,9972,19531
Ҹ,XingFuManZuXiang,230182205,14630,1179,8907,5317,17433,8901,2335,9220,18121,9237,18144
,XinXingManZuXiang,230182206,17210,1382,10495,6519,20352,10495,2844,10931,21426,10941,21436
,GongZhengManZuXiang,230182207,17209,1480,10524,6307,21225,10518,2994,11118,21636,11159,21683
ʤ,YongShengXiang,230182208,13717,1209,8471,4894,16509,8461,2437,8873,17334,8892,17363
ٽ,LinJiangXiang,230182209,14550,1401,8822,5965,17156,8761,2394,9276,18037,9523,18345
ˮȪ,ShuiQuanXiang,230182210,18459,1566,11342,6440,22697,11340,3072,11737,23077,11755,23097
Ⱥ,LeQunManZuXiang,230182211,16875,1349,10432,5810,20438,10432,3028,10813,21245,10820,21252
Ž,TuanJieManZuXiang,230182213,26550,2629,16461,9210,32828,16435,4601,17220,33655,17319,33780
¡,WanLongXiang,230182214,29632,2776,18816,10553,37437,18816,5739,19306,38122,19331,38147
ϣ,XiQinManZuXiang,230182216,15073,1264,9242,5467,18088,9233,2795,9740,18973,9890,19132
ͬ,TongXinManZuXiang,230182217,15326,1151,9494,5590,18874,9485,2921,9895,19380,9904,19398
־,ShangZhiZhen,230183100,105667,8892,63993,42834,121456,62438,16447,64614,127052,67013,131006
һ,YiMianPoZhen,230183101,27466,3072,16373,12685,33241,16356,3548,17650,34006,17713,34086
έ,WeiHeZhen,230183102,35745,3597,22329,14192,44451,22277,7023,24015,46292,24036,46365
ǲ,YaBuLiZhen,230183103,36503,3735,22329,14792,45581,22329,6308,24175,46504,24217,46546
ñɽ,MaoErShanZhen,230183104,21372,2024,12874,8816,25294,12872,3161,13671,26543,13683,26557
,LiangHeZhen,230183105,20148,1638,12322,7598,23354,12321,3925,13379,25700,13389,25711
,QingYangZhen,230183106,16606,1293,10029,6313,20194,10027,3060,10914,20941,10930,20959
ʯͷ,ShiTouHeZiZhen,230183107,12409,1367,7619,5280,15292,7619,2092,8249,15868,8249,15868
Ԫ,YuanBaoZhen,230183108,18418,1326,11199,6541,22377,11193,3363,11892,23085,11908,23107
,HeiLongGongZhen,230183109,16954,990,9383,6070,19993,9383,2252,10813,20196,10813,20196
,ChangShouXiang,230183202,22821,1882,13691,8159,27556,13689,3468,14444,28133,14480,28171
ڼ,WuJiMiXiang,230183204,18800,1545,11295,7268,22726,11292,3020,12065,23357,12070,23365
,YuChiXiang,230183206,6680,627,3903,3082,6594,3903,895,4299,8202,4299,8202
ɽ,ZhenZhuShanXiang,230183207,11657,1170,7166,5080,13624,7166,1949,7610,14776,7610,14776
Ͻֻ,LaoJieJiXiang,230183208,13552,1124,8256,5020,16273,8256,2568,8985,17241,8988,17244
,MaYanXiang,230183209,16212,1409,10030,5951,19438,10010,2741,10302,20312,10332,20362
Ӷ,HeDongXiang,230183211,9717,922,5741,3575,8250,5741,1271,6169,11910,6169,11910
έҵ,WeiHeLinYeJu,230183400,28092,4968,18199,15023,33988,18157,3708,18526,36683,18569,36768
ǲҵ,YaBuLiLinYeJu,230183401,26062,4557,17060,13329,31583,17050,3568,17120,34170,17127,34187
峣,WuChangZhen,230184100,143473,13827,85699,62047,162590,85027,17805,88719,173746,89406,175105
,LaLinManZuZhen,230184101,34704,3554,21617,13387,40887,21574,4939,21398,42972,21580,43197
ɽ,ShanHeZhen,230184102,50602,5319,31215,19592,53510,30774,7056,31327,62101,31762,62977
Сɽ,XiaoShanZiZhen,230184103,26405,2113,16332,9544,30796,16316,5001,17158,33474,17187,33519
,AnJiaZhen,230184104,21682,1964,13517,8219,26208,13505,3839,13919,27424,13968,27485
ţ,NiuJiaManZuZhen,230184105,31763,2814,19762,11483,37829,19725,5355,20121,39846,20170,39932
ż,DuJiaZhen,230184106,22106,2197,13851,7636,26492,13851,3877,14329,28180,14329,28180
,BeiYinHeZhen,230184107,16592,1872,10415,5827,19747,10359,2888,10823,21182,10937,21352
,ChongHeZhen,230184108,21274,1680,13228,7557,26015,13228,4424,14150,27378,14150,27378
ɳ,ShaHeZiZhen,230184109,23759,1716,14885,8604,29600,14885,4992,15582,30467,15582,30467
,XiangYangZhen,230184110,27310,2174,16667,9901,32652,16667,4517,17316,33983,17334,34001
ʢ,XingShengXiang,230184200,19594,1659,12125,6909,24503,12112,3762,12864,24976,12890,25015
־,ZhiGuangXiang,230184201,19373,1401,11993,7069,23624,11993,3851,12632,24625,12632,24625
,WeiGuoXiang,230184202,10530,1284,6691,4251,13120,6685,2103,7174,13859,7226,13917
,ChangBaoXiang,230184203,13008,1606,8154,4724,15877,8146,2301,8724,16870,8761,16915
,MinYiXiang,230184206,18009,1388,11161,6111,21953,11161,3512,11748,22909,11748,22909
ɽ,LongFengShanXiang,230184207,31761,2453,19629,10892,36577,19623,5461,20037,39660,20046,39675
,HongQiManZuXiang,230184209,29278,2396,18275,9574,35551,18274,5351,18749,37023,18750,37025
˼,BaJiaZiXiang,230184210,20358,2101,13161,6560,25149,13161,3956,13254,26415,13254,26415
ֳ,MinYueChaoXianZuXiang,230184211,6721,874,4232,2960,5396,4231,913,4272,8503,4276,8508
Ӫ,YingChengZiManZuXiang,230184212,15479,1464,9844,5653,18616,9844,2986,10085,19929,10085,19929
ɽ,ChangShanXiang,230184214,33974,2613,20746,11278,40764,20746,5596,21437,42183,21437,42183
¡,XingLongXiang,230184215,29575,2420,18585,9668,36244,18584,5291,18700,37284,18701,37286
,ErHeXiang,230184216,15024,1575,9286,5680,18149,9276,2623,9889,19165,9936,19222
ɽҵ,ShanHeTunLinYeJu,230184400,18234,3536,11947,10304,22055,11920,2237,12034,23954,12060,24007
ֵ´,WuLongJieDaoBanShiChu,230202001,47047,8344,30752,21415,54797,29648,5375,28297,57945,30014,60766
ֵ´,HuBinJieDaoBanShiChu,230202002,31313,5441,19784,14616,37399,19164,2689,19032,38196,19659,39443
ֵ´,JiangAnJieDaoBanShiChu,230202003,40899,6784,25524,20880,48177,25330,3539,25357,50687,25698,51222
ֵ´,ZhengYangJieDaoBanShiChu,230202004,43390,5026,26326,19607,46531,26236,3810,25575,51811,25900,52226
ʺֵ´,CaiHongJieDaoBanShiChu,230202005,48381,5626,29642,22233,50786,29340,5282,28821,58161,29647,59289
Ϻֵ´,NanHangJieDaoBanShiChu,230202006,52192,5544,30900,21400,40235,26933,4715,26801,53734,31551,62451
ɳֱϽ,LongShaQuZhenZhiXia,230202198,23795,2186,14477,9724,17912,14444,3609,14972,29416,15113,29590
лֵ´,ZhongHuaJieDaoBanShiChu,230203002,23543,2691,14848,10694,25381,14674,3092,14261,28935,14478,29326
Žֵ´,XiDaQiaoJieDaoBanShiChu,230203004,31624,3496,19836,14901,32794,19732,4372,19492,39224,19656,39492
ֵ´,BuKuiJieDaoBanShiChu,230203005,29602,3717,17392,12710,33424,17086,3233,16750,33836,19160,36552
ֵ´,JianSheJieDaoBanShiChu,230203006,41441,4488,25302,19258,43252,24847,4840,24946,49793,25467,50769
Ļֵ´,WenHuaJieDaoBanShiChu,230203007,91769,10708,57703,33148,85279,43699,8911,42687,86386,53685,111388
ֱϽ,JianHuaQuZhenZhiXia,230203198,21365,1223,13070,6715,12115,9332,2464,9817,19149,11982,25052
վǰֵ´,ZhanQianJieDaoBanShiChu,230204001,39008,7441,23521,17451,45068,22843,3223,23387,46230,26151,49672
ֵֽ´,NanPuJieDaoBanShiChu,230204002,27085,3122,14586,11003,24669,13784,2099,14539,28323,17720,32306
ֵͨ´,TongDongJieDaoBanShiChu,230204003,37574,6793,23408,16948,42601,23396,3544,24285,47681,24503,47911
ٽֵ´,GuangRongJieDaoBanShiChu,230204004,35661,5393,21509,14987,40986,20816,3251,20417,41233,22796,44305
ֵ´,LongHuaJieDaoBanShiChu,230204005,48162,7057,28866,18771,49358,26165,4195,25730,51895,30548,59414
լֵ´,BeiJuZhaiJieDaoBanShiChu,230204006,28966,3794,17327,12765,31503,17268,2334,17370,34638,17767,35094
ֵ´,DongHuJieDaoBanShiChu,230204008,22746,4290,14096,10562,24392,13360,1884,13216,26576,14824,28920
,ZhaLongXiang,230204200,21356,1646,12904,8985,22945,12904,3268,13366,26270,13366,26270
,QiQiHaErZhongChuChang,230204500,6566,666,3878,3266,5869,3864,827,4143,8007,4181,8059
˽ֵ´,XinXingJieDaoBanShiChu,230205001,12067,1597,7510,6019,13587,7319,1580,7332,14651,7734,15244
½ֵ´,XinJianJieDaoBanShiChu,230205002,6611,1172,4234,3844,7764,4222,781,4318,8540,4330,8564
ֵֻ´,LinJiJieDaoBanShiChu,230205005,2091,402,1301,1084,2379,1301,217,1409,2710,1409,2710
ֵ´,DaoBeiJieDaoBanShiChu,230205006,7212,1467,4600,4207,8327,4588,633,4664,9252,4712,9312
ˮʦӪ,ShuiShiYingManZuZhen,230205100,9022,769,5579,3657,9035,5578,1513,5721,11299,5725,11304
,YuShuTunZhen,230205101,26385,2836,15894,11913,28969,15847,3754,16221,32068,17081,32975
찶ֵ´,HongAnJieDaoBanShiChu,230206001,44522,6197,28129,21726,52381,27969,5201,27648,55617,27791,55920
ؽֵ´,YanJiangJieDaoBanShiChu,230206003,27281,4082,17071,13986,32993,16972,2917,16874,33846,17209,34280
ֵ´,DianLiJieDaoBanShiChu,230206004,10216,1551,6318,5285,11336,6235,914,6156,12391,6363,12681
Ҹֵ´,XingFuJieDaoBanShiChu,230206005,21776,4088,13314,10859,25561,13161,1898,13153,26314,14448,27762
챦ʯֵ´,HongBaoShiJieDaoBanShiChu,230206006,15131,2672,9568,7911,18579,9539,1590,9767,19306,9825,19393
˽ֵ´,BeiXingJieDaoBanShiChu,230206007,22977,3855,14598,12261,25527,14590,2454,14658,29248,14688,29286
ֵ´,TieBeiJieDaoBanShiChu,230206008,29988,5831,18732,15470,35519,18556,2318,19002,37558,19405,38137
ƽֵ´,HePingJieDaoBanShiChu,230206009,2204,306,1326,1134,2140,1326,203,1387,2713,1387,2713
,ChangQingXiang,230206200,18183,1468,11161,7671,19601,11161,2828,11318,22479,11318,22479
ŶߴӶ,DuErMenQinDaWoErZu,230206202,10692,811,6583,4280,12136,6560,2005,6888,13448,6925,13508
ֵ´,DongAnJieDaoBanShiChu,230207001,7419,1973,5071,4534,9711,5071,605,4917,9988,4926,9997
ǿֵ´,FuQiangJieDaoBanShiChu,230207002,15872,2125,10047,8580,18350,10023,1811,9680,19703,9761,19808
Ծֵ´,YueJinJieDaoBanShiChu,230207003,13778,1572,8246,7557,15455,8234,1407,8489,16723,8511,16757
ٽֵ´,FanRongJieDaoBanShiChu,230207004,9804,1891,6323,5681,12217,6276,841,6159,12435,6213,12536
ɽֱ,NianZiShanQuZhenZhi,230207198,10181,1004,6405,4912,12212,6404,1868,6640,13044,6648,13053
÷˹ֵ´,MeiLiSiJieDaoBanShiChu,230208001,9265,991,5849,4548,8801,5662,1426,5674,11336,5833,11682
Ŷ,YaErSaiZhen,230208101,15286,1363,9588,7041,16842,9550,2814,9768,19318,9875,19463
ţ´Ӷ,WoNiuTuDaWoErZuZhen,230208102,9542,679,5961,4338,10815,5959,1984,6239,12198,6244,12205
,DaHuDianZhen,230208103,27689,2311,17514,11875,33386,17505,5289,17768,35273,17775,35289
,GongHeZhen,230208104,15086,1254,9503,6388,18356,9500,3024,9848,19348,9861,19364
ç´Ӷ,MangGeTuDaWoErZuXiang,230208200,5619,418,3488,2584,6708,3488,1128,3677,7165,3677,7165
÷˹,MeiLiSiXiang,230208201,32654,2696,20205,14039,38859,20205,5951,21094,41299,21096,41301
ũ,HaLaHaiNongChang,230208501,3726,486,2367,1887,3784,2356,530,2343,4699,2375,4742
,LongJiangZhen,230221100,109250,10059,69017,51165,127754,68615,19828,69474,138089,70120,139137
,JingXingZhen,230221101,46831,4202,29691,20421,58759,29641,9879,31080,60721,31221,60912
,LongXingZhen,230221102,34575,3124,21794,13798,43520,21779,7193,23047,44826,23098,44892
ɽȪ,ShanQuanZhen,230221103,42267,3696,26666,17211,53459,26666,8965,28261,54927,28262,54928
߿,QiKeShuZhen,230221104,37270,3302,22745,14194,45812,22745,6320,24137,46882,24147,46892
ɽ,BaiShanXiang,230221200,19453,1845,12772,8870,24922,12769,4560,13082,25851,13086,25858
ڸ,HeiGangXiang,230221201,17575,1721,10798,7709,21528,10795,3143,11570,22365,11641,22439
,GuangHouXiang,230221202,13944,1619,9256,5974,17821,9043,3247,9322,18365,9554,18810
,HuaMinXiang,230221203,20290,1901,12779,8520,25238,12775,4339,13710,26485,13751,26530
,HaLaHaiXiang,230221204,15304,1329,9618,6449,19209,9617,3206,10217,19834,10221,19839
ɽ,XingShanXiang,230221211,31355,2588,19708,13312,39281,19707,6514,20744,40451,20749,40457
ͷվ,TouZhanXiang,230221214,21526,1815,13960,9113,27295,13957,5162,14538,28495,14543,28503
³,LuHeXiang,230221215,19348,1826,12172,7607,24191,12170,3614,12600,24770,12616,24788
ߺ,JiQinHeXiang,230221217,14539,1165,9085,6035,18254,9084,3075,9683,18767,9694,18779
,YiAnZhen,230223100,71667,6964,42193,30313,50113,40594,10352,40663,81257,46790,88983
,YiLongZhen,230223101,35204,3048,22679,13919,44057,22665,6963,22486,45151,22536,45215
˫,ShuangYangZhen,230223102,17136,1666,10367,6449,21450,10309,2894,11233,21542,11329,21696
,SanXingZhen,230223103,21418,1959,13482,7414,26546,13476,3885,13701,27177,13780,27262
,ZhongXinZhen,230223104,34553,3187,21939,12572,43424,21933,6548,22232,44165,22349,44288
,FuRaoXiang,230223200,21719,1835,13246,7929,26445,13246,3652,13960,27206,13960,27206
,JieFangXiang,230223201,15734,1346,9731,5528,19463,9731,2847,10196,19927,10196,19927
,YangChunXiang,230223202,19129,1710,11973,7178,23540,11973,3260,12126,24099,12126,24099
·,XinFaXiang,230223203,16321,1520,9932,6209,20028,9872,2715,10283,20155,10624,20556
̫,TaiDongXiang,230223204,16207,1343,9865,6722,19845,9865,2686,10371,20236,10371,20236
,ShangYouXiang,230223205,16513,1471,10580,6529,20154,10580,2961,10332,20912,10365,20945
,HongXingXiang,230223206,17692,1421,10926,6234,21553,10926,2937,11124,22050,11124,22050
ȷ,XianFengXiang,230223207,21651,1838,13584,7475,27062,13584,3831,13728,27312,13736,27320
,XinTunXiang,230223208,21056,1877,13212,7450,25904,13212,3647,13368,26580,13368,26580
,XinXingXiang,230223210,31977,2715,20517,12533,40092,20517,6323,20498,41015,20498,41015
ũ,YiAnNongChang,230223500,2107,379,1263,1201,2589,1263,171,1394,2657,1394,2657
̩,TaiLaiZhen,230224100,67241,6932,38349,29621,76879,37498,8522,37879,75377,44346,82695
ƽ,PingYangZhen,230224101,17011,1561,10744,6817,20996,10741,2958,10765,21506,10786,21530
,TangChiZhen,230224102,14329,1007,8821,5207,16602,8821,2588,9102,17923,9103,17924
ɹ,JiangQiaoMengGuZuZhen,230224103,14522,1408,9175,5973,17547,9137,2513,9232,18369,9268,18443
ӳ,TaZiChengZhen,230224104,11985,1075,7709,5061,14539,7708,2390,7738,15446,7741,15450
,DaXingZhen,230224105,23879,1770,14902,9922,28627,14897,4795,15525,30422,15542,30444
ƽ,HePingZhen,230224106,25827,2299,16574,10286,31555,16574,5311,16862,33436,16863,33437
,KeLiZhen,230224107,33810,3014,21648,13202,41739,21639,6648,21741,43380,21824,43472
ʤɹ,ShengLiMengGuZuXiang,230224200,13130,1234,8173,5309,15894,8173,2306,8497,16670,8497,16670
ɹ,NingJiangMengGuZuXiang,230224209,12004,1123,7577,5228,14849,7576,2126,7674,15250,7676,15253
,XuNiDiQu,230224480,3088,585,1851,1828,3293,1851,366,2188,4039,2188,4039
̩ũ,TaiLaiNongChang,230224500,2157,274,1342,1091,1604,1342,239,1328,2670,1328,2670
,GanNanZhen,230225100,66245,6150,41367,30957,78149,40641,11217,41496,82137,42245,83612
,YinHeZhen,230225101,11304,971,7292,5248,13838,7280,2544,7499,14779,7527,14819
ƽ,PingYangZhen,230225102,11867,812,7481,4983,14471,7475,2468,7632,15107,7666,15147
,DongYangZhen,230225103,23108,1707,14527,9009,28452,14527,4427,14715,29242,14715,29242
ޱ,JuBaoZhen,230225104,14769,1024,9058,6024,18279,9058,2839,9574,18632,9574,18632
ɽ,ChangShanXiang,230225201,21390,1591,13506,8239,26731,13506,4208,13666,27172,13683,27189
,ZhongXingXiang,230225202,28133,2413,17326,10970,34992,17222,5160,18287,35509,18380,35706
¡,XingLongXiang,230225203,17599,1359,11460,7121,22108,11455,4110,11554,23009,11608,23068
ɽ,BaoShanXiang,230225204,35017,2619,22235,13740,44297,22229,7618,22969,45198,23019,45254
,ChaHaYangXiang,230225206,12510,853,7825,4752,15279,7825,2653,8191,16016,8191,16016
ũ,ChaHaYangNongChang,230225500,46460,6612,29658,24483,56552,29568,6977,30201,59769,30391,60049
˫ũ,BeiJingShiShuangHeNongChang,230225580,11428,1555,7212,5911,10882,7203,1658,7420,14623,7429,14641
ԣ,FuYuZhen,230227100,66492,7354,41449,33743,70349,40566,8910,40532,81098,41307,82756
·,FuLuZhen,230227101,22601,1750,14464,9020,28459,14453,5026,14810,29263,14913,29377
,FuHaiZhen,230227102,14978,1289,9336,6446,18313,9332,2629,9537,18869,9560,18896
,ErDaoWanZhen,230227103,16211,1637,10243,6714,19752,10067,3091,10261,20328,10696,20939
,LongAnQiaoZhen,230227104,10979,939,6889,4885,13098,6888,2187,7210,14098,7216,14105
,FanRongXiang,230227200,13347,1177,8575,5807,16728,8572,2765,8695,17267,8714,17289
,ShaoWenXiang,230227201,11809,1043,7627,4970,15014,7627,2507,7732,15359,7732,15359
Һ,ZhongHouXiang,230227202,10174,909,6459,4218,12827,6457,2034,6635,13092,6658,13117
,YouYiXiang,230227203,19445,1622,12340,8333,23644,12340,4227,12945,25285,12954,25294
,TaHaXiang,230227204,18017,1340,9997,7009,18711,9991,2957,10470,20461,12317,22314
ԣ,FuYuMuChang,230227500,8173,828,4938,4339,9134,4936,1178,5237,10173,5241,10179
,FanRongZhongChuChang,230227501,5555,445,3304,2208,6604,3295,912,3587,6882,3608,6912
ɽ,KeShanZhen,230229100,54944,6441,35084,27654,56739,34182,8956,34373,68555,35257,70341
,BeiXingZhen,230229101,17619,1654,11118,6930,22308,11118,3444,11599,22717,11599,22717
,XiChengZhen,230229102,17551,1671,11643,6880,22384,11643,4014,11570,23213,11593,23236
ų,GuChengZhen,230229103,20673,2036,13034,8115,25718,13034,3509,13184,26218,13184,26218
,BeiLianZhen,230229104,14187,1426,9505,6016,18146,9505,3035,9141,18646,9143,18648
,XiHeZhen,230229105,17050,1623,11157,6610,21660,11157,3562,11078,22235,11078,22235
,HeNanXiang,230229200,20085,1739,12785,6932,25398,12785,3816,12855,25640,12855,25640
˫,ShuangHeXiang,230229201,24319,2289,14899,9426,30193,14899,3985,15626,30525,15694,30593
ӱ,HeBeiXiang,230229203,18933,1888,12250,7469,24062,12250,3835,12403,24653,12406,24656
ű,GuBeiXiang,230229204,14292,1356,9342,5694,18026,9342,3042,9348,18690,9348,18690
,XiLianXiang,230229205,15198,1314,10028,6088,19042,10028,3031,9515,19543,9515,19543
չ,FaZhanXiang,230229206,13449,1360,8935,5557,17296,8934,2917,8790,17724,8791,17726
,XiJianXiang,230229207,12869,1212,8769,5159,16616,8769,2991,8303,17072,8303,17072
,XiangHuaXiang,230229208,19762,2017,13040,8261,25135,13040,4300,13034,26074,13039,26079
,ShuGuangXiang,230229210,14547,1342,9429,6036,18294,9427,2880,9312,18739,9340,18769
ɽũ,KeShanNongChang,230229500,16350,2860,10555,8510,20583,10471,1802,10378,20849,10457,21012
˶,KeDongZhen,230230100,50185,4316,32581,24084,43526,31882,10181,31517,63399,32101,64682
Ȫ,BaoQuanZhen,230230101,37662,3065,24490,16491,46854,24485,7438,23624,48109,23675,48165
Ǭ,QianFengZhen,230230102,20433,1666,14210,9601,26415,14209,5178,13063,27272,13067,27277
,YuGangZhen,230230103,28523,2352,18678,12388,36288,18677,6242,18432,37109,18439,37117
,JinChengXiang,230230200,18433,1577,11986,7309,22748,11950,3688,11438,23388,11712,23698
,RunJinXiang,230230202,25499,1842,16660,9887,31979,16660,5325,16003,32663,16006,32666
ʢ,ChangShengXiang,230230204,18587,1517,12755,7558,24297,12752,4907,12254,25006,12256,25011
ҵũ,JianYeNongChang,230230585,4424,539,2840,2226,5097,2813,706,2536,5349,2829,5669
Ȫ,BaiQuanZhen,230231100,68271,7293,43283,32748,72383,42231,11308,42832,85063,43589,86872
,SanDaoZhen,230231101,39120,2882,24198,12502,47479,24177,6838,24602,48779,24642,48840
ũ,XingNongZhen,230231102,31331,2597,19490,11512,38751,19457,5541,19861,39318,19979,39469
,ChangChunZhen,230231103,29451,2569,18257,10790,36617,18240,4894,18619,36859,18657,36914
Ȫ,LongQuanZhen,230231104,29500,2443,17679,10469,35435,17665,4817,19011,36676,19081,36760
,GuoFuZhen,230231105,20638,1504,13181,7431,24832,13175,4316,13239,26414,13277,26458
ǿ,FuQiangZhen,230231106,20201,1597,12373,6870,24501,12373,3293,12718,25091,12718,25091
,XinShengXiang,230231200,22835,1778,14230,7041,28294,14220,4359,14695,28915,14742,28972
˹,XingGuoXiang,230231201,14782,1134,9201,5460,17931,9201,2490,9205,18406,9205,18406
,ShangShengXiang,230231203,17277,1360,10778,6432,21574,10770,3293,11120,21890,11152,21930
˻,XingHuaXiang,230231204,20181,1635,12620,7793,24982,12614,3560,12722,25336,12756,25376
,DaZhongXiang,230231206,16617,1325,10362,5749,20667,10362,3107,10687,21049,10687,21049
,FengChanXiang,230231209,29294,2289,17794,10136,35610,17794,4589,18373,36167,18378,36172
,YongQinXiang,230231210,16686,1396,10075,5978,20290,10067,2536,10509,20576,10543,20618
ũ,AiNongXiang,230231212,22957,1819,14196,7360,28068,14196,3830,14410,28606,14410,28606
ʱ,ShiZhongXiang,230231214,14842,1301,8944,5441,18002,8944,2090,9289,18233,9289,18233
ֵͤ´,YuTingJieDaoBanShiChu,230281001,53486,5075,35793,27678,46064,35018,11165,32951,67969,33933,69726
ֵͨ´,TongJiangJieDaoBanShiChu,230281002,55611,5532,35335,27896,50322,34389,10132,34206,68595,35940,71275
,LaHaZhen,230281101,25846,3332,16520,12864,28845,15913,3255,15394,31307,15913,32433
ǳ,ErKeQianZhen,230281102,36796,3244,24042,14787,47015,23845,7993,23762,47607,23991,48033
ѧ,XueTianZhen,230281103,29667,2877,20113,12928,37923,19979,6799,19047,39026,19230,39343
,LongHeZhen,230281104,32656,3304,21492,13764,42525,21454,7588,21860,43314,22056,43548
ګ,NeNanZhen,230281105,23243,2530,15638,9930,29369,15585,5280,15314,30899,15415,31053
,LiuHeZhen,230281106,21829,1984,14275,9246,27197,14271,4338,13844,28115,13876,28151
,ChangFaZhen,230281107,15089,1542,9792,6491,19133,9727,3175,9926,19653,10014,19806
ͨ,TongNanZhen,230281108,25572,2518,17591,10873,33554,17465,6308,16640,34105,16807,34398
ͬ,TongYiZhen,230281109,21311,2181,14070,8553,27165,14065,4382,13757,27822,13804,27874
ž,JiuJingZhen,230281110,21028,2296,14203,8814,27115,14203,4557,13638,27841,13678,27881
,LaoLaiZhen,230281111,34230,3596,23074,14614,44125,23052,7470,22163,45215,22222,45296
׹,KongGuoXiang,230281201,24480,2724,16226,10453,31933,16187,5509,16457,32644,16487,32713
ʢ,HeShengXiang,230281207,15866,1582,10594,6631,20098,10587,3466,10278,20865,10320,20914
ͬ,TongXinXiang,230281208,19029,2142,12613,8323,24405,12611,3900,12443,25054,12458,25071
¿,XingWangEWenKeZuXiang,230281210,19022,1901,12173,8413,23829,12173,3797,12546,24719,12547,24720
ʡ,HeiLongJiangShengXuNiDiQu,230281480,2977,417,1839,1666,3145,1839,263,1811,3650,1818,3657
ֵ´,XiangYangJieDaoBanShiChu,230302001,39048,5872,25025,19736,38121,24962,5379,24980,49942,25274,50299
ɽֵ´,NanShanJieDaoBanShiChu,230302002,49132,5589,30286,20226,46148,26394,5816,25371,51765,30251,60537
½ֵ´,LiXinJieDaoBanShiChu,230302003,7108,1071,4188,3558,6733,4132,766,4459,8591,4757,8945
ֵ´,DongFengJieDaoBanShiChu,230302004,50985,5397,30974,22758,55511,30745,5886,31136,61881,31294,62268
·ֵ´,HongJunLuJieDaoBanShiChu,230302005,36214,3350,20910,14436,33038,19603,4021,19375,38978,22675,43585
ֵ´,XiJiXiJieDaoBanShiChu,230302006,23937,3707,15005,11664,26114,14667,2793,15233,29900,15432,30437
ɽֵ´,XiShanJieDaoBanShiChu,230302007,50184,5412,30459,22985,52968,29700,6481,29835,59535,31618,62077
,HongXingXiang,230302200,18743,1872,11420,7882,12337,11099,2816,11841,22940,12011,23431
,XiJiaoXiang,230302201,19245,1801,11657,8424,16769,11655,2760,12055,23710,12149,23806
ľֵֽ´,HuaMuLinJieDaoBanShiChu,230303001,918,244,631,602,1168,631,91,622,1253,622,1253
ɽֵ´,DaHengShanJieDaoBanShiChu,230303002,21687,3764,13548,11816,24829,13538,2341,14220,27758,14244,27792
Сɽֵ´,XiaoHengShanJieDaoBanShiChu,230303003,25758,5005,16407,14155,32690,16407,2528,16884,33291,16884,33291
ӽֵ´,ErDaoHeZiJieDaoBanShiChu,230303004,20037,3610,12694,11133,24344,12694,2078,13027,25721,13031,25725
½ֵ´,ZhangXinJieDaoBanShiChu,230303005,10077,1423,6091,5611,11823,6090,964,6372,12462,6373,12464
ֵܶ´,FenDouJieDaoBanShiChu,230303006,15541,2078,9623,8299,17290,9548,1938,9905,19453,9934,19557
ëֵ´,LiuMaoJieDaoBanShiChu,230303007,5080,674,3117,2774,5666,3117,520,3157,6274,3157,6274
,HongQiXiang,230303200,14781,1581,8836,6483,15200,8836,2070,9589,18425,9596,18432
ë,LiuMaoXiang,230303201,12218,1336,7536,5504,14897,7536,1838,7841,15377,7856,15392
˽ֵ´,DongXingJieDaoBanShiChu,230304001,16000,2199,9999,8489,16750,9984,1988,9997,19981,10188,20187
ֵ´,KuangLiJieDaoBanShiChu,230304002,24026,4104,14807,12946,28589,14765,2243,15333,30098,15566,30373
ϴúֵ´,XiMeiJieDaoBanShiChu,230304003,13629,2374,8394,7376,16159,8394,1168,8777,17171,8777,17171
ֵͨ´,DaTongGouJieDaoBanShiChu,230304004,4541,985,2965,2899,5702,2965,439,2996,5961,3000,5965
ε,DiDaoHeXiang,230304200,13050,1570,7651,5735,13295,7618,1677,8152,15770,8646,16297
,LanLingXiang,230304201,10593,1343,6527,4909,12970,6521,1717,7111,13632,7126,13653
ֵ´,JieLiJieDaoBanShiChu,230305001,9519,1326,5993,4783,9817,5973,1428,6265,12238,6280,12273
ֵ´,MuLingJieDaoBanShiChu,230305002,18571,4016,11985,12121,23477,11985,1773,12291,24276,12375,24360
ƽڽֵ´,PingGangJieDaoBanShiChu,230305003,15343,2233,9465,8887,17224,9465,1809,9920,19385,9920,19385
ֵ´,JianChangJieDaoBanShiChu,230305004,5340,969,3321,3090,6000,3317,655,3543,6860,3643,6964
ʯ׽ֵ´,ShiLinJieDaoBanShiChu,230305005,2826,315,1628,1592,3420,1628,279,1792,3420,1792,3420
ֱϽ,LiShuQuZhenZhiXia,230305198,7834,958,4807,3761,8850,4801,1167,5106,9907,5152,9959
Ӻӽֵ´,ChengZiHeJieDaoBanShiChu,230306001,36661,4730,22683,19354,38002,21994,4182,22610,44604,22890,45573
ֵ´,ZhengYangJieDaoBanShiChu,230306002,11759,1621,7195,5705,12448,7175,1386,7485,14660,7571,14766
ֵ´,DongHaiJieDaoBanShiChu,230306003,10395,1426,6353,5428,10284,6336,1298,6612,12948,6766,13119
ֵ´,ChengXiJieDaoBanShiChu,230306004,13221,2323,8162,7342,15125,8160,1402,8767,16927,8784,16946
ӻֵ´,XingHuaJieDaoBanShiChu,230306005,11830,1448,7147,6037,12000,7102,1357,7374,14476,7488,14635
,ChangQingXiang,230306200,9126,1000,5464,3922,8812,5459,1203,5834,11293,5865,11329
,YongFengXiang,230306201,8797,1005,5281,3876,5279,5171,1120,5528,10699,5641,10922
ɽֵ´,MaShanJieDaoBanShiChu,230307001,11781,2157,7708,7186,13430,7661,1525,7701,15362,7755,15463
ɽֱϽ,MaShanQuZhenZhiXia,230307198,11534,1266,7079,4981,12836,7075,1834,7498,14573,7555,14634
,JiDongZhen,230321100,70129,7355,43205,33531,72627,42556,10282,43416,85972,44561,87766
ƽ,PingYangZhen,230321101,16769,1567,10638,6942,20604,10631,3193,10890,21521,10891,21529
,XiangYangZhen,230321102,13604,1394,8539,6169,16403,8534,2424,8870,17404,8883,17422
,HaDaZhen,230321103,14394,1553,8896,6734,12897,8892,2445,9483,18375,9496,18392
,YongAnZhen,230321104,15196,1719,9249,6823,17251,9245,2315,9954,19199,9981,19230
,YongHeZhen,230321105,14482,1326,8873,6181,16478,8870,2674,9513,18383,9609,18482
,DongHaiZhen,230321106,19584,2143,12228,8414,23044,11908,3400,12542,24450,12899,25127
ũ,XingNongZhen,230321107,13736,873,7689,6339,8962,7683,2239,8952,16635,9159,16848
,JiLinXiang,230321200,4700,651,2875,2801,1829,2862,306,2773,5635,2782,5657
,MingDeXiang,230321205,5943,506,3599,2798,5709,3599,896,3740,7339,3746,7345
,XiaLiangZiXiang,230321206,15077,1520,9366,6183,18504,9366,2632,9863,19229,9863,19229
ҵ,LinYeJu,230321400,2870,391,1753,1433,2927,1750,377,1821,3571,1885,3638
һũ,BaWuYiLingNongChang,230321500,10078,1971,6509,5570,10788,6468,1157,6514,12982,6697,13206
,HuLinZhen,230381100,65272,7870,40958,35014,66969,40621,9863,41366,81987,42047,83005
,DongFangHongZhen,230381101,3818,457,2300,2055,4657,2300,529,2504,4804,2504,4804
ӭ,YingChunZhen,230381102,6141,963,3859,3763,4991,3843,922,4145,7988,4167,8026
ͷ,HuTouZhen,230381103,9330,631,5593,4334,8866,5569,1696,6029,11598,6064,11657
,YangGangZhen,230381104,10192,1128,6238,4773,11737,6236,1660,6701,12937,6742,12980
,DongChengZhen,230381105,8601,1030,5300,4248,9974,5300,1353,5684,10984,5684,10984
,BaoDongZhen,230381106,8726,937,5499,4142,9966,5475,1627,5732,11207,5791,11290
,XinLeXiang,230381203,5621,672,3574,2763,7202,3569,1090,3779,7348,3809,7383
ΰ,WeiGuangXiang,230381204,4490,538,2843,2092,5516,2843,844,3029,5872,3029,5872
䱦,ZhenBaoDaoXiang,230381206,3426,213,2020,1540,2811,2020,629,2239,4259,2248,4268
,ABeiXiang,230381207,3258,209,2028,1384,3389,2027,734,2170,4197,2173,4201
ҵ,DongFangHongLinYeJu,230381400,25459,5661,16942,14050,27852,16919,3292,17370,34289,17470,34412
ӭҵ,YingChunLinYeJu,230381401,10362,1999,6816,6364,11308,6805,1389,6906,13711,6934,13750
ũ,BaWuLingNongChang,230381500,13231,2310,8427,7004,11926,8378,1708,8721,17099,8822,17249
ũ,BaWuSiNongChang,230381501,18886,2936,11723,9944,17760,11692,2402,12309,24001,12501,24224
ũ,BaWuLiuNongChang,230381502,17675,2321,10824,8492,14350,10697,2172,11156,21853,11344,22168
ũ,BaWuBaNongChang,230381503,11758,1408,7298,5751,9120,7278,1732,7569,14847,7600,14898
ũ,QingFengNongChang,230381504,11446,1531,7032,6242,10574,7013,1470,7333,14346,7415,14447
ɽũ,YunShanNongChang,230381505,9503,1491,5979,5082,8511,5969,1272,6234,12203,6287,12266
Ľֵ´,ZhongXinJieDaoBanShiChu,230382001,74294,8478,46325,36038,73889,45626,10504,45968,91594,46951,93276
ɽ,MiShanZhen,230382100,15757,1662,9457,6067,16959,8868,2062,9526,18394,10024,19481
ɽ,LianZhuShanZhen,230382101,14070,1581,8613,6318,16432,8613,2164,9193,17806,9202,17815
,DangBiZhen,230382102,7515,713,4746,3055,9403,4746,1440,4922,9668,4922,9668
֪һ,ZhiYiZhen,230382103,7777,713,4731,3201,8895,4731,1309,5068,9799,5068,9799
̨,HeiTaiZhen,230382104,14118,1624,8714,6439,15859,8714,2130,9152,17866,9158,17872
˿,XingKaiZhen,230382105,9258,1053,5738,4340,9174,5737,1516,6079,11816,6089,11827
,PeiDeZhen,230382106,16307,1703,10170,6704,19577,10131,3042,10776,20907,10882,21052
ë,LiuMaoXiang,230382200,6439,595,4018,2579,7980,4018,1188,4204,8222,4204,8222
ľ,YangMuXiang,230382201,14404,1345,9041,5827,17647,9038,2710,9403,18441,9418,18459
˿,XingKaiHuXiang,230382202,8382,813,5166,3234,10276,5166,1375,5403,10569,5404,10570
Ϻ,ChengZiHeXiang,230382203,5124,427,3193,1815,6380,3191,1021,3369,6560,3379,6572
,BaiPaoZiXiang,230382204,11823,1135,7357,5107,14564,7356,2171,7751,15107,7772,15129
˰,ErRenBanXiang,230382206,12026,1121,7369,5106,14405,7369,2124,7902,15271,7902,15271
̫ƽ,TaiPingXiang,230382208,8930,941,5767,3801,10853,5767,1862,5965,11732,5966,11733
ƽ,HePingXiang,230382210,13328,1309,8026,5764,13230,7987,1880,8367,16354,8491,16517
Դ,FuYuanXiang,230382212,12590,1301,7994,5186,15311,7994,2597,8449,16443,8494,16488
ҵ,LinYeJu,230382400,1205,168,728,611,1067,728,140,785,1513,785,1513
ˮ,QingNianShuiKu,230382480,281,43,160,135,218,160,20,184,344,184,344
ú̿ҵ,MeiTanGongYeJu,230382481,684,18,320,256,218,313,83,360,673,465,785
ÿί,JingJiKaiFaQuGuanLiWei,230382482,18,0,13,5,1,6,1,4,10,6,19
ĵ־־ֱ,MuDanJiangFenJuJuZhi,230382501,9855,1742,6536,5860,9646,6359,1212,6138,12497,6273,12809
ũ,BaWuWuNongChang,230382502,9647,1978,6392,5349,11328,6383,1098,6321,12704,6331,12723
ũ,BaWuQiNongChang,230382503,12033,2201,7603,5654,13190,7142,1405,7361,14503,8036,15639
һһũ,BaWuYiYiNongChang,230382504,12386,2325,8058,7089,12921,8057,1657,8302,16359,8310,16368
˿ũ,XingKaiHuNongChang,230382505,14155,1833,8646,6913,9221,8628,1998,9236,17864,9340,17986
ĵ־ֱӪ,MuDanJiangFenJuBeiDaYing,230382506,5012,979,3291,2712,2949,3238,567,3216,6454,3267,6558
ĵ־˫ũ,MuDanJiangFenJuShuangFengNongChang,230382507,184,15,103,84,119,103,15,111,214,111,214
ˮֳ޹˾,ShuiChanYangZhiYouXianGongSi,230382580,988,194,612,522,990,612,111,664,1276,681,1293
,ZhongChuChang,230382581,543,65,304,258,490,304,34,338,642,338,642
ˮֳ,ShuiTianLiangZhongChang,230382582,147,13,76,96,148,76,14,98,174,98,174
ֳ,ShiLiangZhongChang,230382583,284,37,176,140,323,176,37,182,358,182,358
Уҵ˾,XiaoBanQiYeGongSi,230382584,67,5,42,33,87,42,15,45,87,45,87
ɽ޹,FengMiShanLiangKuYouXianGong,230382585,157,19,95,90,135,95,12,93,188,93,188
ɽֵ´,BeiShanJieDaoBanShiChu,230402001,10075,1589,6298,5116,10055,6298,1074,6440,12738,6440,12738
ֵ´,HongJunJieDaoBanShiChu,230402002,27855,4429,17836,13447,32894,17799,3105,17503,35302,17553,35389
ֵ´,GuangMingJieDaoBanShiChu,230402003,18845,2991,12287,9324,21711,12255,2355,11845,24100,11904,24191
ʤֵ´,ShengLiJieDaoBanShiChu,230402004,14548,2053,9177,6197,13623,9135,1825,9186,18321,9249,18426
ֵ´,NanYiJieDaoBanShiChu,230402005,16037,2304,9825,6338,15724,9821,1831,10297,20118,10347,20172
Žֵ´,YuCaiJieDaoBanShiChu,230403001,24153,2661,14991,11771,25634,14973,3096,14712,29685,14919,29910
ֵ´,HongQiJieDaoBanShiChu,230403002,16431,1874,9851,8372,14509,9842,1962,10082,19924,10416,20267
Ͻֵ´,XinNanJieDaoBanShiChu,230403003,19688,2270,11964,9917,22593,11957,2383,12366,24323,12377,24341
ֵ´,HuBinJieDaoBanShiChu,230403004,9951,1576,6289,5223,11152,6289,1024,6259,12548,6262,12551
Žֵ´,JieFangJieDaoBanShiChu,230403005,19301,2135,12077,9418,22652,12074,2742,12098,24172,12101,24178
Žֵ´,TuanJieJieDaoBanShiChu,230403006,23075,2408,14624,11511,25930,14571,3340,14138,28709,14199,28823
ֵ´,TieXiJieDaoBanShiChu,230404001,18321,2025,11505,9030,19505,11434,2690,11440,22874,11531,23036
ֵ´,TieDongJieDaoBanShiChu,230404002,12322,1742,7735,6122,13550,7731,1483,7804,15535,7812,15547
Žֵ´,LiuHaoJieDaoBanShiChu,230404003,12342,1559,7550,5991,13336,7549,1515,7856,15405,7866,15416
½ֵ´,DaLuJieDaoBanShiChu,230404004,13037,1391,7884,6392,13507,7882,1686,8200,16082,8230,16114
ֵ´,FuLiJieDaoBanShiChu,230404005,11339,1637,6916,5498,13399,6889,1311,7365,14254,7371,14287
´ɽֵ´,LuLinShanJieDaoBanShiChu,230404006,27189,4149,17039,13808,30792,17007,3309,17496,34503,17608,34647
˰·ֵ´,XingAnLuJieDaoBanShiChu,230405001,18458,2175,11460,9006,20236,11458,2641,11804,23262,11814,23274
˽·ֵ´,XingJianLuJieDaoBanShiChu,230405002,11353,1562,7023,5921,12816,7008,1445,7307,14315,7337,14360
˳·ֵ´,XingChangLuJieDaoBanShiChu,230405003,8059,1187,5034,4104,9592,5028,1024,5230,10258,5236,10270
·ֵ´,JunDeLuJieDaoBanShiChu,230405004,19416,1718,11451,8684,21123,11427,2387,12053,23480,12070,23521
Ӷ·ֵ´,HeDongLuJieDaoBanShiChu,230405005,2388,354,1388,1197,2638,1388,229,1582,2970,1583,2971
˴ֵ´,GongRenCunJieDaoBanShiChu,230406001,15644,2696,9776,6753,18181,9760,1752,10274,20034,10316,20092
һֵ´,XinYiJieDaoBanShiChu,230406002,12416,1896,7632,5817,13288,7616,1454,8061,15677,8134,15766
ֵֽ´,SanJieJieDaoBanShiChu,230406003,8047,1397,4929,3782,9563,4926,741,5252,10178,5256,10185
ɽֵ´,DongShanJieDaoBanShiChu,230406004,16102,2458,9959,6577,19414,9936,1746,10308,20244,10347,20306
˽ֵ´,HeXingJieDaoBanShiChu,230406005,13818,1894,8429,6439,14567,8419,1636,8889,17308,8919,17348
ֵ´,GuangYuJieDaoBanShiChu,230406006,9201,1191,5554,4379,15,5545,1115,5743,11288,5953,11507
»,XinHuaZhen,230406100,14771,1782,9004,6280,17394,8995,2238,9706,18701,9787,18791
,HongQiXiang,230406200,8950,899,5463,3756,8641,5463,1292,5678,11141,5678,11141
԰,ShuYuanXiang,230406201,11287,1309,6636,4217,11080,6636,1525,7485,14121,7485,14121
,DongFangHongXiang,230406202,11418,1310,7381,4304,12310,6565,1875,7139,13704,7222,14603
׸ҵ,HeGangShiLinYeJu,230406400,1587,247,939,884,1661,938,134,1027,1965,1029,1968
»ũ,XinHuaNongChang,230406500,14791,2478,9646,7603,15500,9578,2142,9680,19258,9765,19411
뱱ֵ´,LingBeiJieDaoBanShiChu,230407001,9682,1250,5784,4991,8507,5784,1229,6374,12158,6377,12161
Ͻֵ´,LingNanJieDaoBanShiChu,230407002,7974,1446,5104,4375,7658,5095,982,5291,10386,5298,10402
ֵ´,GouBeiJieDaoBanShiChu,230407003,9540,1523,6033,5067,10110,6033,1112,6142,12175,6142,12175
Ͻֵ´,GouNanJieDaoBanShiChu,230407004,8027,1032,5048,3923,7975,5048,1006,5017,10065,5017,10065
,FengXiangZhen,230421100,34207,3829,22247,16075,29968,21995,6106,21338,43333,21895,44142
ױ,HeBeiZhen,230421101,8119,789,4889,4031,7772,4889,1270,5289,10178,5289,10178
ɽ,MingShanZhen,230421102,2776,358,1663,1399,3022,1663,359,1830,3493,1830,3493
Ž,TuanJieZhen,230421103,12281,916,7646,5061,14784,7562,2259,7689,15251,7810,15456
,ZhaoXingZhen,230421104,7354,697,4691,3565,9206,4691,1348,4703,9394,4708,9399
,DongMingChaoXianZuXiang,230421200,3010,299,1715,1504,2580,1715,264,1858,3573,1858,3573
̫ƽ,TaiPingGouXiang,230421203,1507,143,905,696,1638,905,253,998,1903,998,1903
ɽ,HuanShanXiang,230421204,2476,169,1203,743,1734,1050,296,1163,2213,1738,2941
ܱҵ,LuoBeiXianLinYeJu,230421400,822,118,471,461,707,463,60,504,967,529,1000
ױҵ,HeBeiLinYeJu,230421401,16418,2528,10483,9020,18761,10440,2229,10636,21076,10692,21175
ũ,JiangBinNongChang,230421501,10468,2060,6893,6024,13397,6814,1354,6893,13707,6989,13882
ũ,JunChuanNongChang,230421502,12326,1843,7915,6584,14043,7838,1815,7934,15772,8069,15984
ɽũ,MingShanNongChang,230421503,8236,1395,5054,4544,9052,5008,956,5126,10134,5533,10587
Ӿũ,YanJunNongChang,230421504,5996,943,3774,3032,6805,3752,802,3878,7630,3967,7741
ũ,GongQingNongChang,230421505,10229,1831,6682,5893,11783,6679,1442,6805,13484,6820,13502
Ȫũ,BaoQuanLingNongChang,230421506,34554,5414,22187,16447,33312,20722,4236,20506,41228,22017,44204
ܱũҵ,LuoBeiXianNongYeJu,230421580,778,73,483,358,748,482,120,487,969,488,971
,SuiBinZhen,230422100,37719,3418,23526,16913,40652,22052,6219,22339,44391,23830,47356
綫,SuiDongZhen,230422101,12870,873,7779,5779,15404,7779,2343,8307,16086,8307,16086
,ZhongRenZhen,230422102,15358,1189,9668,5983,18927,8988,3144,9285,18273,10023,19691
,LianShengXiang,230422200,9725,779,6079,4152,12068,6075,1928,6341,12416,6353,12432
,BeiGangXiang,230422201,8315,605,5227,3174,10276,4705,1580,5032,9737,5273,10500
ǿ,FuQiangXiang,230422202,3664,287,2298,1674,4463,2298,704,2357,4655,2357,4655
ɽ,BeiShanXiang,230422203,3323,268,2064,1510,4026,2064,680,2207,4271,2207,4271
,FuXingXiang,230422204,3311,253,2085,1465,3966,2085,722,2195,4280,2201,4286
¸,XinFuXiang,230422205,2054,153,1256,922,2337,1256,442,1393,2649,1393,2649
ֳ,SuiBinXiLinChang,230422400,68,8,40,32,74,40,6,42,82,42,82
Ӫ˱߷ֳ,GuoYingZhongXingBianFangLinChang,230422401,82,6,44,30,89,44,13,57,101,57,101
ֳ,ZhongRenZhenLiangZhongChang,230422480,110,8,73,52,140,73,22,67,140,67,140
綫,SuiDongZhenZhongChuChang,230422481,358,26,210,165,451,210,79,253,463,253,463
ţũ,ErJiuNongChang,230422500,14734,2945,9690,8321,16830,9666,1997,9948,19614,9986,19676
ũ,SuiBinNongChang,230422501,15391,1978,9156,6357,17513,7837,1705,8077,15914,9918,19074
ũ,PuYangNongChang,230422503,9923,1307,6272,4454,9484,5670,1371,5729,11399,6329,12601
·ֵ´,ErMaLuJieDaoBanShiChu,230502001,28109,3591,18446,13551,31324,18142,4416,17405,35547,17670,36116
·ֵ´,BaMaLuJieDaoBanShiChu,230502002,51275,6895,33066,26064,54962,32949,7264,32262,65211,32368,65434
վֵ´,ZhongXinZhanJieDaoBanShiChu,230502003,26694,4093,16775,13733,28627,16373,3181,16609,32982,17193,33968
ֵ´,FuAnJieDaoBanShiChu,230502004,17948,2568,11312,9592,20608,11311,2217,11420,22731,11421,22733
Ҥؽֵ´,YaoDiJieDaoBanShiChu,230502005,4359,575,2688,2408,3830,2688,593,2839,5527,2839,5527
ֵ´,ChangAnJieDaoBanShiChu,230502006,8235,1193,5061,4179,8762,5061,961,5328,10389,5328,10389
ֵ´,TieXiJieDaoBanShiChu,230502007,47050,5319,28430,23880,45413,27940,5171,28224,56164,29110,57540
,AnBangXiang,230502200,16052,1440,9502,7167,14460,9457,2169,10091,19548,10159,19661
ɽֵ´,ZhongShanJieDaoBanShiChu,230503001,6427,968,4077,3398,7019,4056,842,4098,8154,4160,8237
ɽֵ´,BeiShanJieDaoBanShiChu,230503002,6514,1062,3975,3553,7773,3975,683,4284,8259,4284,8259
ɽֵ´,NanShanJieDaoBanShiChu,230503003,9838,1551,6070,5417,11281,6057,1118,6391,12448,6437,12507
ɽֵ´,DongShanJieDaoBanShiChu,230503004,2142,459,1366,1237,2405,1366,203,1438,2804,1438,2804
Ľֵ´,ZhongXinJieDaoBanShiChu,230503005,5263,859,3293,2933,5734,3284,525,3349,6633,3354,6647
ɽֵ´,XiShanJieDaoBanShiChu,230503006,4122,491,2076,1747,3525,2002,365,2199,4201,2902,4978
ʤ,ChangShengXiang,230503200,2604,305,1539,1079,2978,1538,352,1690,3228,1722,3261
붫ɽι,LingDongQuQingShanLvYouGong,230503400,313,76,202,171,198,174,32,202,376,219,421
붫붫Ӫ,LingDongQuLingDongJingYingSuo,230503401,1956,469,1223,1228,1671,1214,193,1340,2554,1395,2618
·ֵ´,ZhenXingZhongLuJieDaoBanShiChu,230505001,14765,2128,9222,8300,13533,9219,1949,9597,18816,9620,18842
˶·ֵ´,ZhenXingDongLuJieDaoBanShiChu,230505002,8340,1502,5257,4532,9208,5257,1061,5638,10895,5646,10903
ͽֵ´,JiXianJieDaoBanShiChu,230505004,11024,963,6390,5653,10558,6385,1389,6905,13290,6986,13376
ٽֵ´,DongRongJieDaoBanShiChu,230505005,6697,235,3737,3151,4466,3732,943,4120,7852,4138,7875
̫,TaiBaoZhen,230505101,8955,950,5652,4354,9673,5637,1732,5947,11584,5985,11637
ֵ´,HongQiJieDaoBanShiChu,230506001,11633,1845,7378,5633,13856,7351,1428,7492,14843,7528,14906
Ծֵ´,YueJinJieDaoBanShiChu,230506002,13886,2113,8641,8276,16103,8638,1718,9038,17676,9076,17717
ֵ´,DongBaoWeiJieDaoBanShiChu,230506003,6440,494,3680,2955,6587,3680,690,3944,7624,3944,7624
ǽֵ´,QiXingJieDaoBanShiChu,230506004,24195,3263,14664,12383,27886,14626,2497,15153,29779,15291,29955
˫ֵ´,ShuangYangJieDaoBanShiChu,230506005,10919,1161,6430,5913,12363,6425,1248,6685,13110,6898,13328
°ֵ´,XinAnJieDaoBanShiChu,230506006,13725,1206,7986,6525,14854,7978,1467,8256,16234,8412,16398
糧ֵ´,DianChangJieDaoBanShiChu,230506007,4006,419,2489,2042,4233,2489,491,2427,4916,2427,4916
,QiXingZhen,230506101,1809,228,1122,870,1388,1115,299,1204,2319,1214,2336
˫ѼɽҵֱɽӪ,ShuangYaShanLinYeJuBaoShanJingYingSuo,230506401,644,160,451,412,765,451,90,443,894,443,894
˫ѼɽҵִҶֳ,ShuangYaShanLinYeJuDaYeGouLinChang,230506402,541,161,376,362,651,376,57,383,759,383,759
˫Ѽɽũ,ShuangYaShanNongChang,230506500,10724,1908,6928,5894,11368,6903,1414,7076,13979,7118,14046
¡־־ֱ,HongXingLongFenJuJuZhi,230506600,6869,893,4177,2972,8386,4177,826,4411,8588,4411,8588
,FuLiZhen,230521100,88021,8148,55162,39393,82267,53917,14365,54204,108121,55372,110534
,JiXianZhen,230521101,24063,2225,14878,11419,27369,14872,4073,15437,30309,15483,30361
,ShengChangZhen,230521102,17762,1563,10983,7258,20833,10983,3159,11491,22474,11501,22484
,FengLeZhen,230521103,18016,1729,11275,7680,22323,11273,3330,11767,23040,11800,23075
̫ƽ,TaiPingZhen,230521104,14513,1418,8949,6448,17875,8937,2426,9387,18324,9408,18357
,YaoTunXiang,230521201,14915,1226,9241,6161,17827,9227,2744,9485,18712,9644,18885
˰,XingAnXiang,230521202,16266,1506,10256,6349,19756,10238,2921,10379,20617,10437,20693
,YongAnXiang,230521204,20302,1936,12656,9315,24661,12653,3527,13062,25715,13109,25765
̫ƽֳ,TaiPingLinChang,230521401,149,13,87,89,131,87,10,85,172,85,172
ֳ,FengLeLinChang,230521402,187,28,105,97,181,105,10,120,225,120,225
ֳ,QiXingLinChang,230521403,225,33,133,103,246,133,25,150,283,150,283
ɽֳ,JunShanLinChang,230521404,190,22,99,88,221,99,24,136,235,137,236
ֳ,AiLinLinChang,230521405,176,32,118,84,191,118,20,110,228,110,228
ֳ,YaoTunLinChang,230521406,39,1,22,18,37,22,8,26,48,26,48
ƽú,ShengPingMeiKuang,230521407,1702,72,1023,777,943,1023,295,1037,2060,1046,2069
ʡ,HeiLongJiangShengXuNiDiQu,230521480,5053,912,3206,2842,5432,3205,540,3294,6499,3299,6505
һũ,ErJiuYiNongChang,230521500,14843,1775,9325,7657,14495,9303,2178,9424,18727,9471,18796
ֳ,LiangZhongChang,230521581,345,46,218,170,409,218,42,215,433,215,433
,ZhongChuChang,230521582,356,39,208,156,408,207,43,222,429,230,438
ʾ,GuoShuShiFanChang,230521583,202,81,149,101,188,121,20,122,243,154,303
,YouYiZhen,230522100,24290,3449,15648,12779,23748,15194,3384,15013,30207,15475,31123
¡,XingLongZhen,230522101,8516,1188,5221,4338,8451,5206,1014,5482,10688,5497,10718
ɽ,LongShanZhen,230522102,2665,300,1589,1351,2434,1581,260,1625,3206,1636,3225
,FengGangZhen,230522103,5066,674,3073,2515,6205,3071,585,3250,6321,3252,6325
ʢ,XingShengXiang,230522200,3800,590,2332,1964,4327,2332,357,2415,4747,2415,4747
,DongJianXiang,230522201,3741,647,2400,1997,4345,2400,464,2452,4852,2452,4852
,QingFengXiang,230522202,3679,673,2363,1959,4346,2356,361,2333,4689,2350,4713
,JianSheXiang,230522203,4633,802,2910,2608,5160,2909,542,3067,5976,3067,5977
,YouLinXiang,230522204,5256,541,3224,2488,6088,3221,766,3334,6555,3339,6563
,XinZhenXiang,230522205,3062,322,1722,1130,3264,1374,315,1599,2973,1977,3699
ɸ,ChengFuChaoXianZuManZuXiang,230522206,4211,704,2679,2034,5089,2617,436,2607,5224,2672,5351
¡־־ֱ,HongXingLongFenJuJuZhi,230522501,18095,2312,12080,9203,15485,11703,3090,11113,22816,11417,23497
,BaoQingZhen,230523100,98006,7902,61074,42062,99739,59703,16782,60258,119961,61616,122690
,QiXingPaoZhen,230523101,40328,3639,25515,16688,49186,25497,7875,26169,51666,26327,51842
ԭ,QingYuanZhen,230523102,19322,1632,12180,8232,24254,12175,4061,12805,24980,12835,25015
,JiaXinZiZhen,230523103,14546,1206,8975,5611,17339,8971,2461,9206,18177,9238,18213
ͷ,LongTouZhen,230523104,8665,875,5313,3830,9506,5309,1444,5665,10974,5671,10984
С,XiaoChengZiZhen,230523105,10816,779,6538,4490,11229,6532,1975,6996,13528,7032,13570
,ZhaoYangXiang,230523202,11901,1065,7480,5115,14067,7480,2194,7679,15159,7680,15160
ɽ,WanJinShanXiang,230523203,12683,1082,7865,4895,15143,7855,2164,8041,15896,8064,15929
ɽ,JianShanZiXiang,230523204,12071,1000,7725,4974,14982,7724,2515,7860,15584,7861,15586
Ǻ,QiXingHeXiang,230523209,9527,847,6109,4146,12033,6109,2104,6369,12478,6369,12478
˫ѼɽҵξӪ,ShuangYaShanLinYeJuShangYouJingYingSuo,230523400,869,101,432,376,547,411,80,413,824,618,1050
˫ѼɽҵȪӪ,ShuangYaShanLinYeJuNanWengQuanJingYingSuo,230523401,1124,158,711,610,985,711,226,793,1504,797,1508
˫Ѽɽҵһֳ,ShuangYaShanLinYeJuQiYiLinChang,230523402,505,81,291,261,442,291,60,319,610,355,646
˫ѼɽҵǺֳ,ShuangYaShanLinYeJuQiXingHeLinChang,230523403,410,72,264,254,447,264,47,265,529,265,529
˫Ѽɽҵֳֺ,ShuangYaShanLinYeJuHongQiLinChang,230523404,543,78,356,306,641,356,96,361,717,361,717
˫Ѽɽҵֳ,ShuangYaShanLinYeJuSanChaHeLinChang,230523405,755,164,494,463,992,494,112,537,1031,537,1031
˫Ѽɽҵֳ,ShuangYaShanLinYeJuQingLongLinChang,230523406,284,13,162,134,237,162,34,169,331,169,331
˫ѼɽҵֱʯӪ,ShuangYaShanLinYeJuBaoShiJingYingSuo,230523407,668,64,378,322,671,378,83,437,815,437,815
ũ,WuJiuQiNongChang,230523500,20443,3365,13057,11047,24271,13015,2693,13374,26389,13444,26501
ũ,BaWuErNongChang,230523501,30058,6292,19680,16584,34392,19599,3788,19899,39498,20458,40138
ũ,BaWuSanNongChang,230523502,24337,4922,16009,12953,24544,15904,3122,16236,32140,16372,32381
ĺ,RaoHeZhen,230524100,24709,2408,15564,11737,23497,15377,4057,15163,30540,15610,31174
СѺ,XiaoJiaHeZhen,230524101,8795,713,5316,4028,9401,5316,1482,5674,10990,5674,10990
,XiFengZhen,230524102,7151,609,4543,3262,7812,4539,1504,4693,9232,4721,9264
ֶ,WuLinDongZhen,230524103,824,111,501,397,931,501,141,575,1076,575,1076
,XiLinZiXiang,230524200,3584,322,2246,1637,4018,2246,754,2411,4657,2414,4660
,SiPaiXiang,230524201,1065,85,646,482,1168,646,214,718,1364,718,1364
Ѻ,DaJiaHeXiang,230524203,2810,328,1787,1318,3085,1784,555,1905,3689,1906,3693
ɽ,ShanLiXiang,230524204,4584,309,2911,1971,5510,2911,1058,3038,5949,3040,5951
ͨ,DaTongHeXiang,230524207,3192,281,1932,1412,3406,1932,517,2051,3983,2058,3990
СѺֳ,XiaoJiaHeLinChang,230524400,123,8,70,57,48,70,23,75,145,84,154
ɽֳ,WeiShanLinChang,230524401,300,18,173,147,208,173,42,187,360,187,360
ֳ,XiFengLinChang,230524402,299,37,164,154,297,164,29,201,365,201,365
ֳ,DaYaKeLinChang,230524403,343,66,221,200,217,221,53,241,462,241,462
ʯֳ,ShiChangLinChang,230524404,987,222,617,540,1023,617,117,709,1326,709,1326
ɽֳ,BaoMaShanLinChang,230524405,432,52,285,240,336,285,91,290,575,290,575
ֳ,DaDaiLinChang,230524406,687,103,414,350,576,414,70,446,860,446,860
ֳ,YongXingLinChang,230524407,575,86,381,295,513,381,121,401,782,401,782
Դֳ,QiYuanLinChang,230524408,493,58,297,230,453,297,78,332,629,332,629
ֳֶ,WuLinDongLinChang,230524410,1759,143,1074,759,1559,1074,279,1107,2181,1107,2181
ĺũ,RaoHeNongChang,230524500,9494,1079,5797,4422,9642,5788,1191,5882,11670,5967,11764
ũ,HongQiLingNongChang,230524501,7351,1079,4610,3578,7407,4595,954,4722,9317,4774,9384
ũ,BaWuJiuNongChang,230524502,16899,1752,10273,7282,15633,10244,2423,10715,20959,10801,21074
ʤũ,ShengLiNongChang,230524503,11682,1277,7156,5415,10622,6960,1718,7284,14244,7521,14677
ũ,HongWeiNongChang,230524504,10421,684,6295,4697,7527,6253,1772,6525,12778,6582,12877
ͼֵ´,SaErTuJieDaoBanShiChu,230602001,15959,951,9040,6741,2419,8768,2810,9410,18178,10680,19720
˽ֵ´,TieRenJieDaoBanShiChu,230602005,29686,3166,18296,12942,19458,17679,3928,17081,34760,18484,36780
ֵ´,YouYiJieDaoBanShiChu,230602006,6660,591,3939,2763,2178,3636,1002,3570,7206,4314,8253
ǿֵ´,FuQiangJieDaoBanShiChu,230602007,14325,2291,9243,6275,9070,8231,1706,7961,16192,9079,18322
ӵֵ´,YongJunJieDaoBanShiChu,230602008,16257,1877,9944,6699,13313,8715,1962,8602,17317,10152,20096
սֵ´,HuiZhanJieDaoBanShiChu,230602009,31317,2500,19520,13336,12536,17854,4856,17500,35354,19153,38673
ֵ´,HuoJuJieDaoBanShiChu,230602010,14778,1011,7456,4751,8979,6292,1531,6190,12482,9864,17320
ֵ´,DongFengJieDaoBanShiChu,230602011,63958,5528,39217,24983,51112,35896,8924,33778,69674,39193,78410
ֵ´,DongAnJieDaoBanShiChu,230602012,72991,5640,45739,29629,77514,44844,12603,43565,88409,45495,91234
ֵ´,LongFengJieDaoBanShiChu,230603001,42087,5578,27842,20326,44025,27065,6370,25589,52654,26193,54035
˻ֵ´,XingHuaJieDaoBanShiChu,230603002,35164,3236,21144,15895,38166,20843,4242,20483,41326,21498,42642
ͽֵ´,WoLiTunJieDaoBanShiChu,230603007,13562,2111,8826,7185,12757,8788,1786,8348,17136,8633,17459
ֵ´,DongGuangJieDaoBanShiChu,230603008,24982,2412,14591,10999,18558,14182,3161,13702,27884,15964,30555
ֵ´,SanYongJieDaoBanShiChu,230603009,23842,1001,13978,10459,8254,13866,4179,13898,27764,15044,29022
ֵ´,KaiFaQuLiMingJieDaoBanShiChu,230603010,104956,5013,61195,31508,69549,44845,13895,42943,87788,62669,123864
,LongFengZhen,230603100,44554,2696,26686,19551,25895,26490,7577,27465,53955,28141,54827
ڽֵ´,LongGangJieDaoBanShiChu,230604001,68981,7087,43678,31393,68150,42083,10144,40750,82833,42534,86212
˽ֵ´,YinLangJieDaoBanShiChu,230604002,44793,3272,27547,20209,42261,27355,6170,26366,53721,26688,54235
ֵܶ´,FenDouJieDaoBanShiChu,230604004,69154,7560,43996,26720,62507,36488,9251,35312,71800,41969,85965
½ֵ´,QingXinJieDaoBanShiChu,230604005,24007,3099,13904,10373,21676,13111,2492,12666,25777,15694,29598
ֵ´,XiBinJieDaoBanShiChu,230604007,91342,6282,56414,39058,76954,52252,13905,51816,104068,55115,111529
˷ֵ´,ChengFengJieDaoBanShiChu,230604009,78631,7375,50529,35635,83305,49018,14201,47813,96831,49678,100207
,LaMaDianZhen,230604101,67769,4083,40341,30355,41424,39779,11428,40857,80636,42939,83280
,HongJiMuChang,230604580,3662,407,2185,1769,1397,2142,525,2268,4410,2409,4594
ǻ,XingHuoMuChang,230604581,1239,124,781,617,591,781,206,788,1569,788,1569
,YinLangMuChang,230604582,6102,438,3308,2623,1574,3236,805,3476,6712,4037,7345
ڽֵ´,HongGangJieDaoBanShiChu,230605001,31640,3063,19380,14089,27481,18446,4098,17835,36281,19421,38801
˰ֵ´,BaBaiShangJieDaoBanShiChu,230605004,31593,2918,18774,13376,29943,18102,3741,17743,35845,19478,38252
Ͻֵ´,XingNanJieDaoBanShiChu,230605005,12949,1181,7891,5649,13771,7630,1541,7328,14958,7780,15671
Žֵ´,JieFangJieDaoBanShiChu,230605006,22989,2341,13739,9468,10961,12632,2733,12216,24848,14324,28063
ҵֵ´,ChuangYeJieDaoBanShiChu,230605007,6788,723,4253,3176,6252,4221,845,4034,8255,4103,8356
,XingShuGangZhen,230605100,30165,2086,18276,12364,23921,18128,5272,18684,36812,19247,37523
̬ҵ԰,HongGangQuTieRenShengTaiGongYeYuanQu,230605480,2200,39,717,261,2,275,54,300,575,1576,2293
Ϲҵ԰,DaQingQingNanGongYeYuanQu,230605481,551,3,149,56,0,56,9,61,117,414,563
Ͻֵ´,QingPuJieDaoBanShiChu,230606001,9199,351,5177,4302,9596,5116,920,5166,10282,5293,10470
ƽֵ´,GaoPingJieDaoBanShiChu,230606002,7709,374,4686,3421,7774,4644,1178,4489,9133,4575,9261
Դֵ´,LinYuanJieDaoBanShiChu,230606004,12767,1405,8026,5872,11684,7360,1571,7127,14487,7717,15743
־ֵ´,LiZhiJieDaoBanShiChu,230606005,1182,95,705,493,584,705,170,740,1445,742,1447
»ֵ´,XinHuaJieDaoBanShiChu,230606006,3882,506,2495,2073,3859,2495,493,2386,4881,2386,4881
ֵͬ´,DaTongJieDaoBanShiChu,230606007,15483,1364,9850,6268,12588,9038,2485,8590,17628,9482,19332
ͬ,DaTongZhen,230606100,23900,2020,15425,9051,26599,14933,4452,14477,29410,14947,30372
̨,GaoTaiZiZhen,230606101,19652,1434,12228,7240,21245,12199,3744,12350,24549,12602,24830
̫,TaiYangShengZhen,230606102,9762,766,6126,3739,10503,6120,1937,6331,12451,6339,12465
Դ,LinYuanZhen,230606103,12447,1016,7721,5421,13141,7665,2209,7887,15552,7951,15672
ף,ZhuSanXiang,230606200,18104,1592,11310,6754,21693,11258,3358,11590,22848,11744,23054
ɽͷ,LaoShanTouXiang,230606203,13742,1081,8613,5235,15179,8613,2583,8786,17399,8793,17406
˾,BaJingZiXiang,230606205,19975,1512,12568,7420,21761,12554,3731,12581,25135,12650,25218
˫,ShuangYuShuXiang,230606206,11339,975,7049,4315,12679,7026,2054,7202,14228,7319,14368
ƽ,HePingMuChang,230606500,8190,680,5019,3394,8366,5006,1168,4984,9990,5019,10038
,ZhaoZhouZhen,230621100,91059,8086,56644,40120,90971,55269,14864,55970,111239,57365,114009
,YongLeZhen,230621101,15634,1433,9807,5942,19328,9806,2926,10186,19992,10186,19993
,FengLeZhen,230621102,14678,1415,8982,6033,17468,8967,2288,9349,18316,9399,18381
,ZhaoYangGouZhen,230621103,22917,1892,14129,8523,26594,14116,4187,14817,28933,14867,28996
˳,XingChengZhen,230621104,32917,2765,20462,12335,39895,20460,5960,21179,41639,21180,41642
,ErJingZhen,230621105,28873,2488,17812,10472,35432,17804,5183,18683,36487,18732,36544
˫,ShuangFaXiang,230621202,15505,1387,9587,5400,18757,9583,2644,9940,19523,9949,19536
й,TuoGuXiang,230621203,17483,1607,10917,6469,20855,10917,2935,11108,22025,11108,22025
,ZhaoYangXiang,230621205,15004,1392,9484,5432,18103,9484,2738,9650,19134,9650,19134
ʤ,YongShengXiang,230621206,14075,1251,8671,4749,17246,8671,2432,9087,17758,9087,17758
,YuShuXiang,230621208,15187,1403,9535,5641,18498,9535,2807,9862,19397,9862,19397
¸,XinFuXiang,230621211,21514,1917,13671,7559,26590,13659,4110,13807,27466,13870,27541
԰ֳ,LeYuanLiangZhongChang,230621580,716,44,422,282,781,422,107,445,867,445,867
,WeiXingZhongChuChang,230621581,1334,154,784,605,1565,784,152,856,1640,856,1640
Դ,ZhaoYuanZhen,230622100,73920,7420,46946,35879,82444,45589,12165,45678,91267,46559,93505
վ,SanZhanZhen,230622101,18588,1701,12075,6344,22804,12034,3566,11688,23722,11780,23855
վ,ErZhanZhen,230622102,23360,2122,14947,9342,28551,14942,4623,15158,30100,15158,30105
ï,MaoXingZhen,230622103,13981,1134,8757,5263,16206,8757,2441,8793,17550,8799,17556
,GuLongZhen,230622104,20030,1684,12394,7315,24521,12394,3578,12898,25292,12898,25292
վ,XinZhanZhen,230622105,30554,2531,19113,12095,35556,19069,5393,19222,38291,19365,38478
ͷ̨,TouTaiZhen,230622106,14456,1255,9138,5454,17468,9131,3023,9543,18674,9596,18734
ǡ,GuQiaZhen,230622107,18309,1804,11551,7564,21902,11539,3397,11875,23414,11959,23510
,FuXingXiang,230622200,14414,1284,9117,5149,17363,9117,2666,9247,18364,9247,18364
̨,BoHeTaiXiang,230622201,12136,1101,7740,4422,14953,7740,2382,7879,15619,7879,15619
ƽ,HePingXiang,230622203,9976,843,6119,3880,12005,6119,1705,6403,12522,6405,12524
,ChaoDengXiang,230622207,10827,1013,6827,4109,13407,6827,1948,6958,13785,6961,13788
,MinYiXiang,230622208,12050,1120,7675,4352,15021,7673,2241,7703,15376,7736,15411
˳,YiShunXiang,230622210,11609,929,7110,4465,13949,7110,1968,7394,14504,7396,14506
Ƶ,HaoDeXiang,230622211,5563,524,3471,2054,6568,3471,952,3561,7032,3568,7039
,DaXingXiang,230622212,9181,805,5826,3316,10892,5821,1685,5838,11659,5845,11671
Դũ,ZhaoYuanNongChang,230622500,3048,348,1905,1404,2805,1901,432,1918,3819,1923,3828
,ZhongChuChang,230622581,1009,85,603,380,1121,603,120,603,1206,611,1214
ַ,XinLiLiangZhongFanYuChang,230622583,1159,95,698,442,1402,698,172,728,1426,728,1426
ɽֳ,LiDouShanLiangZhongChang,230622584,325,25,205,132,385,205,65,210,415,210,415
ʾ,GuoShuShiFanChang,230622586,39,10,27,19,47,27,6,28,55,28,55
ʾ,JingJiZuoWuShiFanChang,230622587,549,25,331,190,627,331,64,307,638,307,638
ï˺ˮֳ,MaoXingHuShuiChanYangZhiChang,230622588,1051,101,628,546,1130,628,143,665,1293,667,1295
ֵ,LinDianZhen,230623100,54778,5276,34827,26545,57307,34391,9528,34272,68663,34755,69582
,HongQiZhen,230623101,15936,1296,10078,7099,19350,10078,3237,10391,20469,10391,20469
԰,HuaYuanZhen,230623102,25450,1953,16075,11408,30892,16057,5245,16462,32519,16573,32648
,DongXingXiang,230623200,19787,1674,12260,8252,24221,12260,3596,12797,25057,12797,25057
ΰ,HongWeiXiang,230623201,13431,1295,8487,6199,16469,8466,2395,8528,16994,8634,17121
,SanHeXiang,230623202,20938,1625,13048,8718,25402,13048,3960,13475,26523,13475,26523
ĺ,SiHeXiang,230623204,17645,1430,11014,7277,21544,11014,3179,11237,22251,11240,22254
,LiMingXiang,230623205,20752,1768,12852,9153,25554,12852,3722,13387,26239,13390,26242
ֵسֳ,LinDianXianZhangQingLinChang,230623400,313,35,182,148,159,182,26,192,374,192,374
,JuLangMuChang,230623500,1929,217,1267,920,2209,1261,339,1216,2477,1218,2485
Ӫέ,GuoYingWeiChang,230623580,787,57,480,336,802,480,93,457,937,457,937
,XinXingXuMuChang,230623581,714,71,430,294,696,425,101,449,874,456,886
̩,TaiKangZhen,230624100,52798,5487,33739,24993,57930,32527,8304,31698,64225,32850,66589
Ī,HuJiTuMoZhen,230624101,8377,642,5243,3417,9537,5235,1569,5303,10538,5345,10588
Ͳ,YanTongTunZhen,230624102,16317,1550,10114,6893,19207,10095,2989,10451,20546,10742,20856
,TaLaHaZhen,230624103,15477,1299,9704,6332,18446,9690,3076,10063,19753,10148,19852
һ,YiXinXiang,230624200,15917,1425,9825,7050,18062,9815,2757,10160,19975,10274,20099
˶̨,KeErTaiXiang,230624201,11448,991,7219,4839,13837,7217,2125,7292,14509,7345,14564
ŵ,BaiYinNuoLeXiang,230624202,11671,1294,7480,5305,14207,7434,2241,7656,15090,7726,15206
,AoLinXiBoXiang,230624203,12279,872,7664,5437,14679,7660,2637,8111,15771,8124,15788
,BaYanChaGanXiang,230624204,12377,978,7668,5151,15077,7667,2457,8139,15806,8144,15812
,YaoXinXiang,230624205,15517,1321,9700,6228,19277,9700,2895,10033,19733,10033,19733
,JiangWanXiang,230624206,5640,331,3513,2296,6495,3511,1150,3607,7118,3608,7121
ɫԭ,LvSeCaoYuanMuChang,230624500,3755,523,2446,1906,4120,2441,612,2424,4865,2444,4890
ɽ,DaShanZhongYangChang,230624501,2102,233,1339,965,2431,1339,405,1398,2737,1401,2740
սֵ´,XuRiJieDaoBanShiChu,230702001,28808,4595,18301,14945,32239,17851,2718,17535,35386,17820,36121
ֵ´,HongShengJieDaoBanShiChu,230702004,37602,5287,23688,18398,44738,23521,4534,22154,45675,23735,47423
ǰֵ´,QianJinJieDaoBanShiChu,230702006,39066,4147,25048,16563,38109,21922,5100,20937,42859,23265,48313
ֵ´,ZhaoYangJieDaoBanShiChu,230702007,6892,1118,4841,3907,7406,4756,908,3927,8683,4077,8918
ֵ´,DongShengJieDaoBanShiChu,230702008,4124,542,2493,1907,3707,2481,513,2622,5103,2686,5179
ˮֵ´,XiShuiJieDaoBanShiChu,230703002,16828,3061,10658,8670,20776,10649,1419,10636,21285,10650,21308
Ͻֵ´,LianHeJieDaoBanShiChu,230703004,24706,3978,16001,12486,28901,15926,2752,15365,31291,15435,31436
ֵ´,DongShengJieDaoBanShiChu,230703005,16585,2915,10509,8435,18379,10172,1310,9924,20096,10301,20810
,ChenMingZhen,230703101,8012,988,4796,3989,9395,4796,810,5013,9809,5014,9810
,HaoLiangHeZhen,230703102,12206,1913,7658,6447,13560,7646,1520,7869,15515,7981,15639
ӭ,YingChunXiang,230703200,4063,584,2439,2019,4476,2437,428,2618,5055,2636,5075
ֳ,SanChaHeLinChang,230703400,499,101,305,266,586,305,45,340,645,340,645
ĺӪֳ,SiHeYingLinChang,230703401,462,55,269,248,501,269,47,295,564,295,564
Ӻֳ,LiangZiHeLinChang,230703402,382,52,236,231,437,236,40,238,474,238,474
ʯͷֳ,ShiTouHeLinChang,230703403,607,107,381,319,759,381,54,387,768,387,768
ʯӪ,YanShiJingYingSuo,230703405,494,97,313,270,437,313,37,315,628,315,628
ܶӪ,FenDouJingYingSuo,230703406,547,153,344,376,724,344,39,395,739,395,739
Ӫ,HuaYangJingYingSuo,230703407,638,110,406,335,749,406,60,402,808,402,808
ӾӪ,HaoLiangHeJingYingSuo,230703408,806,123,512,414,960,512,88,505,1017,505,1017
̫ƽӪ,TaiPingJingYingSuo,230703409,401,87,258,234,430,258,35,265,523,265,523
ϲ�Ӫ,NanChaJingYingSuo,230703410,462,95,268,253,415,259,28,256,515,317,585
뾭Ӫ,WeiLingJingYingSuo,230703411,183,53,127,106,220,127,17,126,253,126,253
ྭӪ,SongQingJingYingSuo,230703413,1768,399,1148,1037,1536,1148,110,1129,2277,1129,2277
Ӫ,LiuShuJingYingSuo,230703414,473,126,311,267,588,311,38,326,637,326,637
ӻʳ,HaoLiangHeHuaFeiChang,230703579,3586,581,2318,1913,3872,2205,430,2133,4338,2279,4597
Ѻýֵ´,YouHaoJieDaoBanShiChu,230704001,15577,2137,9808,7115,13945,8985,1653,8775,17760,9559,19367
˫Ӻӽֵ´,ShuangZiHeJieDaoBanShiChu,230704003,10527,2154,6865,5891,12794,6849,1105,6889,13738,6921,13786
ֵֽ´,TieLinJieDaoBanShiChu,230704004,12417,2611,8152,7407,14746,8143,1276,8121,16264,8152,16304
ϾӪ,SanHeJingYingSuo,230704400,521,140,369,305,654,369,53,343,712,345,714
԰ֳ,SongYuanLinChang,230704401,168,25,97,99,159,97,7,103,200,103,200
ľӪ,ZhongXinJingYingSuo,230704402,332,63,209,188,310,209,28,214,423,214,423
ྭӪ,YongQingJingYingSuo,230704403,102,27,70,67,111,70,8,67,137,67,137
ƾӪ,BiYunJingYingSuo,230704404,333,66,204,186,407,204,28,223,427,223,427
꾭Ӫ,YouYiJingYingSuo,230704405,391,50,220,194,414,220,38,242,462,259,479
Ӫ,QingYangJingYingSuo,230704406,189,55,130,113,228,130,18,132,262,132,262
ֳ,LingFengLinChang,230704407,138,20,85,64,146,85,4,77,162,77,162
ֳܶ,FenDouLinChang,230704408,58,1,26,32,40,26,3,36,62,36,62
ֳ,DongKaLinChang,230704409,93,15,53,49,109,53,8,63,116,63,116
צֳ,JiZhuaHeLinChang,230704410,85,13,47,45,88,47,4,55,102,55,102
Դֳ,LvYuanLinChang,230704411,75,4,37,36,66,37,4,46,83,46,83
㴨Ӫ,GuangChuanJingYingSuo,230704412,223,50,148,141,261,148,24,149,297,149,297
Ӫ,ZhaoYangJingYingSuo,230704413,454,78,272,248,460,272,40,298,570,300,572
ֵֽ´,XiLinJieDaoBanShiChu,230705001,21585,2521,12902,11010,24964,12658,2384,13308,25966,13588,26490
˽ֵ´,XinXingJieDaoBanShiChu,230705003,17243,1813,10383,8893,20514,10339,2182,10758,21097,10855,21238
ֵ̦´,TaiQingJieDaoBanShiChu,230705005,4088,627,2409,2044,4729,2407,298,2596,5003,2604,5013
ֵ´,XiangYangJieDaoBanShiChu,230706001,13233,1888,8352,6628,15838,8349,1363,8091,16440,8132,16484
ֵ´,ShuGuangJieDaoBanShiChu,230706002,18044,2682,11321,8949,21250,11289,1882,11208,22497,11287,22608
žӪ,JieFangJingYingSuo,230706400,629,140,404,359,759,404,50,415,819,415,819
ֳ,KunLunQiLinChang,230706401,630,85,304,284,544,291,35,284,575,446,750
Դֳ,KaiYuanHeLinChang,230706402,208,37,126,101,240,126,12,131,257,131,257
ôӾӪ,MeHeJingYingSuo,230706403,1612,267,1012,813,1945,1009,172,1031,2040,1039,2051
澭Ӫ,ChongFengJingYingSuo,230706404,488,86,310,265,570,307,42,302,609,306,616
ͺӾӪ,CuiLuanHeJingYingSuo,230706405,280,76,201,196,357,201,29,184,385,184,385
ӾӪ,FuYuHeJingYingSuo,230706406,341,74,223,202,427,223,26,218,441,218,441
ɽӾӪ,JianShanHeJingYingSuo,230706407,441,76,281,244,540,281,32,268,549,268,549
ֵ´,XinQingJieDaoBanShiChu,230707001,15781,2348,10016,7766,17486,9872,1815,9679,19551,9928,19944
˰ֵ´,XingAnJieDaoBanShiChu,230707003,13219,2151,8426,7116,14885,8426,1443,8387,16813,8387,16813
־Ӫ,HongLinJingYingSuo,230707400,394,94,269,215,507,269,48,267,536,267,536
ֳ,SongLinLinChang,230707401,325,78,223,189,418,223,37,217,440,217,440
Ȫֳ,QuanLinLinChang,230707402,281,35,157,140,298,157,34,192,349,193,350
ˮԴֳ,ShuiYuanLinChang,230707404,811,124,488,408,939,488,85,532,1020,532,1020
Цɽֳ,XiaoShanLinChang,230707405,379,85,258,207,485,258,56,262,520,262,520
ֳ,TangLinLinChang,230707406,770,147,519,364,899,517,103,498,1015,501,1020
־Ӫ,HuaLinJingYingSuo,230707407,266,60,179,138,341,179,30,177,356,177,356
ֳ,QingLinLinChang,230707408,302,48,189,154,347,189,20,181,370,181,370
Դֳ,JieYuanLinChang,230707409,256,43,158,142,298,158,31,172,330,172,330
ֳ,BeiGouLinChang,230707410,126,21,73,71,125,73,12,86,159,86,159
Ϲֳ,NanGouLinChang,230707411,150,8,78,76,102,78,10,90,168,90,168
¾Ӫ,WuLaGaJingYingSuo,230707412,227,45,142,126,227,142,19,149,291,149,291
ֳ,LiuShuHeLinChang,230707413,309,23,165,150,276,165,30,197,362,197,362
Ӱֳ,BeiYingLinChang,230707414,298,54,200,144,362,200,30,182,382,182,382
Ϫֵ´,MeiXiJieDaoBanShiChu,230708001,24069,4931,14966,12309,30891,14966,2247,16280,31246,16281,31247
ֳ,DaXiLinLinChang,230708400,3401,559,2082,1676,4149,2082,311,2189,4271,2189,4271
⾭Ӫ,WuDaoKuJingYingSuo,230708401,654,101,375,372,762,375,34,414,789,414,789
뾭Ӫ,HuanLingJingYingSuo,230708402,452,104,262,273,530,262,19,312,574,313,575
ɽӪ,DuiQingShanJingYingSuo,230708403,651,114,396,384,783,396,46,415,811,415,811
Ⱥ;Ӫ,QunLuanJingYingSuo,230708404,300,40,186,160,355,186,26,180,366,180,366
¾Ӫ,LanXinJingYingSuo,230708405,303,72,194,185,386,194,23,204,398,204,398
˳ֳ,ShunLiHeLinChang,230708406,248,36,149,135,292,149,15,150,299,150,299
뾭Ӫ,SongLingJingYingSuo,230708407,303,37,161,144,355,161,23,202,363,202,363
ɽֳ,QingShanKouLinChang,230708408,258,22,135,125,281,135,11,156,291,156,291
ɳֳ,JinShaHeLinChang,230708409,190,14,98,95,194,98,14,120,218,120,218
ƤǼֳ,HuaPiQiangZiLinChang,230708410,186,33,116,110,230,116,19,122,238,122,238
ֳֿ̲,BiCangKuLinChang,230708411,153,12,78,74,157,78,3,90,168,90,168
Ӫ,SanGuLiuJingYingSuo,230708412,489,61,278,264,574,278,44,316,594,316,594
ֳ,WoLongHeLinChang,230708413,312,56,202,176,388,200,32,197,397,198,400
ֵܶ´,FenDouJieDaoBanShiChu,230709002,19871,2928,12192,9726,24142,12187,1937,12393,24580,12544,24736
ɽֵ´,JinShanJieDaoBanShiChu,230709003,4935,845,3053,2476,6112,3053,461,3187,6240,3188,6241
ɽֳ,BaiShanLinChang,230709401,1139,181,659,584,1371,659,75,735,1394,736,1395
ֳ,FengLingLinChang,230709402,418,84,276,220,505,276,41,267,543,267,543
ֳ,FengLinLinChang,230709403,695,128,444,385,849,444,64,443,887,443,887
ṵӪ,FengGouJingYingSuo,230709404,531,98,325,257,672,325,44,348,673,348,673
ïֳ,FengMaoLinChang,230709405,714,162,453,427,928,453,61,484,937,484,937
ɽӪ,HengShanJingYingSuo,230709406,712,65,419,361,855,419,82,440,859,440,859
ֳ,FengLiLinChang,230709407,710,177,483,430,904,483,62,466,949,466,949
ؾӪ,DaKunLunJingYingSuo,230709408,656,105,417,363,779,417,72,416,833,416,833
Сֳ,XiaoKunLunLinChang,230709409,810,124,493,433,912,493,83,524,1017,524,1017
־Ӫ,YuLinJingYingSuo,230709410,126,15,73,69,128,73,7,75,148,75,148
Ӫֵ´,WuYingJieDaoBanShiChu,230710001,20984,3661,13525,12034,25900,13512,2396,13491,27003,13516,27041
ǽֵ´,WuXingJieDaoBanShiChu,230710011,2587,455,1594,1547,2559,1594,246,1691,3285,1694,3288
䱱ֳ,CuiBeiLinChang,230710400,761,111,375,411,701,360,19,425,785,516,891
ǰֳ,QianFengLinChang,230710401,412,63,238,203,500,238,35,272,510,272,510
ᾭӪ,YongFengJingYingSuo,230710402,167,30,96,105,198,96,3,104,200,104,200
ƽԭӪ,PingYuanJingYingSuo,230710403,306,54,200,168,382,200,45,205,405,205,405
ᾭӪ,LiFengJingYingSuo,230710404,286,30,163,154,336,163,24,177,340,177,340
ӾӪ,YangShuHeJingYingSuo,230710405,391,59,205,210,425,205,29,236,441,274,479
ƽɽӪ,PingShanJingYingSuo,230710406,226,70,157,143,296,157,20,159,316,159,316
־Ӫ,LiLinJingYingSuo,230710407,386,84,261,218,489,261,48,257,518,257,518
ӽֵ´,WuMaHeJieDaoBanShiChu,230711001,19723,2609,12255,10236,21578,12250,2251,12322,24572,12328,24583
ֳ,YiMinLinChang,230711400,1795,343,1141,972,1445,1141,154,1146,2287,1151,2292
Ӫ,YiDongJingYingSuo,230711401,424,91,255,265,468,255,19,279,534,279,534
ũ,DongFangHongNongChang,230711402,62,15,43,33,51,43,6,40,83,40,83
뾭Ӫ,CuiLingJingYingSuo,230711403,529,121,331,300,628,331,28,347,678,347,678
ӱӪ,HeBeiJingYingSuo,230711404,219,24,129,105,135,129,18,132,261,132,261
ɽֳ,QingShanLinChang,230711405,390,104,252,271,471,252,25,267,519,267,519
羭Ӫ,YuMiaoJingYingSuo,230711406,699,113,406,345,820,406,46,452,858,452,858
ȫӪ,AnQuanJingYingSuo,230711407,214,50,139,135,251,139,12,137,276,137,276
ྭӪ,YiQingJingYingSuo,230711408,167,38,105,106,162,105,12,104,209,112,217
ǰӪ,QianJinJingYingSuo,230711409,109,26,70,66,132,70,2,67,137,67,137
ֳ,XiLingLinChang,230711410,302,66,192,159,321,191,16,187,378,192,384
־Ӫ,YiLinJingYingSuo,230711411,497,71,239,219,311,226,26,238,464,355,594
Ͻֵ´,HeNanJieDaoBanShiChu,230712001,12747,1912,8163,6624,15204,8134,1579,8035,16169,8075,16238
ӱֵ´,HeBeiJieDaoBanShiChu,230712002,8550,1434,5330,4542,10638,5325,951,5579,10904,5605,10935
ֳ,RiXinLinChang,230712400,208,43,132,123,268,132,22,141,273,141,273
ʯֳ,ShiLinLinChang,230712401,157,33,92,94,185,92,5,103,195,103,195
ֳ,DongShengLinChang,230712402,96,12,59,58,116,59,10,59,118,59,118
ɽֳ,ErLongShanLinChang,230712403,88,16,47,68,105,47,3,60,107,60,107
߷ֳ,GaoFengLinChang,230712404,243,50,152,126,309,152,21,162,314,162,314
ֳ,ErQingHeLinChang,230712405,306,57,189,180,374,189,32,206,395,206,395
ػɽֳ,ShouHuShanLinChang,230712406,310,34,183,160,291,183,35,196,379,196,379
Ȫʯֳ,QuanShiLinChang,230712407,170,30,102,105,203,102,9,107,209,107,209
ֳ,JunLingLinChang,230712408,214,7,111,93,221,111,7,117,228,117,228
־Ӫ,YuLinJingYingSuo,230712409,274,50,173,147,232,173,28,179,352,179,352
ŽᾭӪ,TuanJieJingYingSuo,230712410,338,31,215,167,338,215,55,209,424,209,424
ĥʯɽӪ,MoShiShanJingYingSuo,230712411,296,16,166,145,262,166,43,189,355,189,355
粷,ZhongXinMiaoBu,230712412,58,18,38,46,70,38,3,41,79,41,79
־Ӫ,KeLinJingYingSuo,230712413,295,24,163,162,375,163,59,215,378,215,378
ֵ,DaiLingJieDao,230713001,22794,3771,14479,12760,27559,14456,2131,14159,28615,14217,28696
നֳ,DaQingChuanLinChang,230713400,871,213,581,591,1049,581,54,557,1138,557,1138
ֳ,DongFangHongLinChang,230713401,799,129,504,480,997,504,76,500,1004,500,1004
ˮֳ,XiuShuiLinChang,230713402,15,0,8,6,15,8,0,7,15,7,15
ֳ,YongCuiLinChang,230713403,127,37,83,81,154,83,8,89,172,89,172
ֳ,MingYueLinChang,230713404,101,35,67,66,126,67,2,71,138,71,138
ֳ,HongGuangLinChang,230713405,80,16,50,55,96,50,3,49,99,49,99
ɳѼȻ,QiuShaYaZiRanBaoHuQu,230713406,32,2,16,16,37,16,3,21,37,21,37
ֳ,BeiLieLinChang,230713407,188,42,121,119,231,121,13,122,243,122,243
ֳ,NanLieLinChang,230713408,257,55,166,143,339,166,28,174,340,174,340
ֳ,HanYueLinChang,230713409,191,28,122,108,223,122,11,108,230,108,230
ɽֳ,HuanShanLinChang,230713410,122,11,68,67,137,68,11,76,144,76,144
ˮȻ,LiangShuiZiRanBaoHuQu,230713411,3,0,2,1,3,2,0,1,3,1,3
ֵ´,WuYiLingJieDaoBanShiChu,230714001,13272,2121,8485,7305,16190,8485,1639,8539,17024,8547,17032
ֳ,ShangYouLinChang,230714400,309,71,196,188,400,196,30,214,410,214,410
ֳ,MeiFengLinChang,230714401,396,71,247,234,468,247,38,258,505,258,505
ֳ,MeiLinLinChang,230714402,294,30,176,160,335,176,24,172,348,172,348
ֳ,JianXinLinChang,230714403,246,38,143,126,315,143,31,172,315,172,315
ɽֳ,YiShanLinChang,230714404,226,47,134,137,257,134,16,155,289,155,289
ֳֺ,LinHaiLinChang,230714405,325,74,203,206,415,203,30,226,429,226,429
ԴӪ,JuYuanJingYingSuo,230714406,338,54,207,206,415,207,28,213,420,213,420
ֳ,DongKeLinLinChang,230714407,248,48,163,145,288,163,25,158,321,158,321
ֳ,FuMinLinChang,230714408,270,9,145,130,274,145,21,155,300,155,300
ֳ͢,ATingHeLinChang,230714409,137,2,72,69,126,72,11,78,150,78,150
ʤӪ,YongShengJingYingSuo,230714410,179,26,109,94,198,109,25,121,230,121,230
ǰֳ,QianWeiLinChang,230714411,332,32,189,176,303,189,34,209,398,209,398
ǽֵ´,HongXingJieDaoBanShiChu,230715001,14442,2772,9518,9527,18024,9511,1676,9364,18875,9372,18890
ˮӾӪ,QingShuiHeJingYingSuo,230715400,259,71,172,183,336,172,21,179,351,179,351
ǺӾӪ,WuXingHeJingYingSuo,230715401,140,44,109,105,200,109,23,98,207,98,207
ֳ,TangHongLingLinChang,230715402,284,75,180,190,370,180,20,199,379,199,379
ֳ,TangBeiLinChang,230715403,303,91,206,224,406,206,18,206,412,206,412
�ֳ,HuoJiHeLinChang,230715404,172,8,100,90,190,100,16,96,196,96,196
Ӫ,ErYangJingYingSuo,230715405,141,31,87,95,178,87,7,92,179,92,179
ֳ,SanYangLinChang,230715406,147,41,93,118,191,93,5,100,193,100,193
ֳ,TangNanLinChang,230715407,330,103,225,242,471,225,43,251,476,251,476
ྭӪ,GongQingJingYingSuo,230715408,173,35,108,124,225,108,21,121,229,121,229
˹ֳ,KuSiTeLinChang,230715409,143,1,73,76,142,73,12,83,156,83,156
ƤӾӪ,ErPiHeJingYingSuo,230715410,156,7,87,88,153,87,14,90,177,90,177
ɽֵ´,HongShanJieDaoBanShiChu,230716001,12980,2516,8597,6237,15874,8583,1296,8173,16756,8195,16792
ɽֳ,ShanFengLinChang,230716400,1,0,0,1,1,0,0,1,1,1,1
ֳ,YangGuangLinChang,230716401,77,0,41,33,81,41,4,40,81,40,81
·ֳ,XinFengLinChang,230716402,127,7,62,58,109,62,5,57,119,77,139
ֳ,WeiGuoLinChang,230716403,297,71,190,191,366,190,4,182,372,182,372
ɽӪ,ChaShanJingYingSuo,230716404,106,38,76,78,144,76,4,72,148,72,148
ྭӪ,ChangQingJingYingSuo,230716405,275,61,177,164,297,177,22,181,358,181,358
ɽũ,QingShanNongChang,230716406,228,31,139,114,260,139,12,132,271,132,271
ϪˮӪ,XiShuiJingYingSuo,230716407,532,96,291,243,506,279,44,297,576,381,672
εӪ,WeiLanJingYingSuo,230716408,149,47,103,96,182,103,12,105,208,105,208
Ӫ,YongXuJingYingSuo,230716409,104,29,65,68,124,65,2,70,135,70,135
־Ӫ,MeiLinJingYingSuo,230716410,143,36,89,89,176,89,10,100,189,100,189
ɽӪ,HongShanJingYingSuo,230716411,90,35,64,68,122,64,5,66,130,66,130
,ZhaoYangZhen,230722100,20246,2204,12948,10186,20435,12816,3597,12565,25381,13099,26047
,WuYunZhen,230722101,5881,666,3897,2740,6737,3866,1347,3963,7829,3997,7894
,WuLaGaZhen,230722102,3835,359,2183,1997,2317,2166,388,2322,4488,2399,4582
ʤ,ChangShengXiang,230722200,2129,205,1309,950,2391,1309,388,1412,2721,1413,2722
,XiangYangXiang,230722201,4354,357,2666,1857,4805,2659,860,2886,5545,2905,5571
,HuJiaXiang,230722202,1739,127,1103,808,1784,1103,389,1149,2252,1152,2255
,HongGuangXiang,230722203,2096,154,1269,881,2065,1269,370,1350,2619,1351,2620
,BaoXingXiang,230722204,5231,372,3130,2333,5370,3130,972,3438,6568,3445,6575
ɽ,QingShanXiang,230722205,1635,129,978,678,1674,975,265,1046,2021,1051,2029
̫ƽֳ,TaiPingLinChang,230722400,94,21,58,58,67,58,3,60,118,60,118
ֳ,QingHeLinChang,230722402,71,18,44,40,65,44,7,52,96,52,96
ֳ,MaLianLinChang,230722404,168,12,92,81,41,92,9,97,189,97,189
ũ,JiaYinNongChang,230722500,5951,1007,3941,3183,7051,3941,923,3936,7877,3940,7881
,TieLiZhen,230781100,85532,10578,54183,42707,101480,53866,11511,53209,107075,53438,107621
˫,ShuangFengZhen,230781101,38499,4323,24699,18237,45521,24672,6426,24491,49163,24549,49248
ɽ,TaoShanZhen,230781102,41229,5130,25687,19295,49163,25686,5232,25902,51588,25904,51591
,LangXiangZhen,230781104,34934,6143,23277,20593,42908,23224,4378,22108,45332,22178,45455
,NianFengXiang,230781200,10182,937,6285,4438,11079,6285,1491,6325,12610,6325,12610
ũ,GongNongXiang,230781201,8141,673,5084,3544,8473,5083,1346,5076,10159,5076,10160
,WangYangXiang,230781202,10658,876,6946,4428,12496,6946,2074,6655,13601,6662,13608
ҵ,TieLiLinYeJu,230781400,11203,2036,7116,6235,13291,7084,1154,7040,14124,7277,14393
˫ҵ,ShuangFengLinYeJu,230781401,7685,1628,5272,4339,9898,5266,1012,5040,10306,5053,10325
ɽҵ,TaoShanLinYeJu,230781402,8664,1231,5413,4244,10135,5407,1270,5730,11137,5752,11165
ҵ,LangXiangLinYeJu,230781403,10479,2223,6810,6058,13534,6810,1140,7032,13842,7032,13842
ũ,TieLiNongChang,230781500,7513,900,4946,3796,8181,4812,938,4264,9076,4405,9351
ֵֽ´,XiLinJieDaoBanShiChu,230803001,19871,2812,12651,9417,20912,12613,2366,12348,24961,12398,25049
ֵ´,BaoWeiJieDaoBanShiChu,230803002,9283,1023,6002,4195,8884,5893,1357,5582,11475,5661,11663
Ͻֵ´,QiaoNanJieDaoBanShiChu,230803003,18878,2729,12282,8885,19216,12065,2530,11518,23583,11855,24137
ϸڽֵ´,XiNanGangJieDaoBanShiChu,230803004,38863,3009,23036,11217,27209,14136,3571,14335,28471,22407,45443
ֵ´,JianSheJieDaoBanShiChu,230803005,42998,4702,26679,20083,39203,25798,5292,26228,52026,26313,52992
ֵ´,ChangAnJieDaoBanShiChu,230803006,48195,4944,30032,22373,45604,29785,6005,28953,58738,29112,59144
ֱϽ,ZhiXiaDiYu,230803198,12721,936,7441,5725,9218,7436,1770,7958,15394,7986,15427
վǰֵ´,ZhanQianJieDaoBanShiChu,230804001,26293,3930,16600,12145,30447,16206,2794,15936,32142,16417,33017
ֵ´,YongAnJieDaoBanShiChu,230804002,31215,4700,19744,14814,38364,19653,3236,19268,38921,19407,39151
ֵܶ´,FenDouJieDaoBanShiChu,230804003,33307,4524,20717,15188,37703,20315,3763,20223,40538,20877,41594
ϸڽֵ´,NanGangJieDaoBanShiChu,230804004,36734,3899,21686,14672,29543,18955,3496,19491,38446,22443,44129
Ӻӽֵ´,LiangZiHeJieDaoBanShiChu,230804005,149,13,93,89,133,93,6,75,168,75,168
԰ֵ´,TianYuanJieDaoBanShiChu,230804006,10827,1294,6643,4941,12378,6643,1350,6828,13471,6828,13471
ƽֵ´,XiaoYunJieDaoBanShiChu,230805001,21999,3057,13612,10677,25460,13612,2459,13903,27515,13903,27515
Ѷֵ´,JiaDongJieDaoBanShiChu,230805002,14715,1755,8927,6497,16782,8927,1449,8992,17919,8992,17919
ֵֽ´,ZaoZhiJieDaoBanShiChu,230805003,22776,3119,13879,10435,27260,13879,2087,14061,27940,14103,27982
Ͻֵ´,JiaNanJieDaoBanShiChu,230805004,1479,145,824,748,794,824,87,887,1711,887,1711
ֵ´,JianGuoJieDaoBanShiChu,230805005,15221,1964,9409,7611,18205,9409,1771,9547,18956,9547,18956
ɽ,SongJiangXiang,230805200,45821,3495,26282,18950,45178,26271,5347,28314,54585,28381,54663
,JianGuoXiang,230805201,9513,637,5761,3870,11342,5761,1566,5955,11716,5955,11716
ũ,DongFengQuNongKen,230805579,1131,122,617,561,228,617,25,661,1278,661,1278
ֵ´,JiaXiJieDaoBanShiChu,230811001,29381,3871,18079,15948,29510,18062,3354,18503,36565,18527,36606
ֵ´,YouYiJieDaoBanShiChu,230811002,22702,1855,12666,9474,18407,11227,2405,11603,22830,14296,26962
,DaLaiZhen,230811101,15231,1402,9165,5832,17796,9033,2177,9519,18552,9645,18810
,AoQiZhen,230811102,12465,1038,7540,5168,14503,7540,1754,7717,15257,7717,15257
,WangJiangZhen,230811103,17641,1573,11100,7002,20995,11095,3192,11301,22396,11306,22406
,ChangFaZhen,230811104,13775,1152,8433,5424,15937,8177,2162,8280,16457,8656,17089
,LianJiangKouZhen,230811105,22005,1630,12784,8174,16663,10411,2689,10747,21158,13540,26324
,ChangQingXiang,230811200,41957,3598,24475,20272,38214,24440,5335,26010,50450,26415,50890
ؽ,YanJiangXiang,230811201,17876,1169,10580,7288,19290,10579,2831,11271,21850,11296,21876
ľ,XiGeMuXiang,230811202,11634,1042,7002,4715,13387,6974,1690,7303,14277,7364,14366
ƽ,PingAnXiang,230811208,14793,1176,9317,5216,17661,9317,2817,9469,18786,9469,18786
ķ,SiFengXiang,230811210,11762,1004,7129,5066,11887,7063,1651,7194,14257,7288,14417
Ⱥʤ,QunShengXiang,230811211,10555,981,6396,4701,12775,6396,1612,6752,13148,6752,13148
,XuNiDiQu,230811480,13977,1778,7198,5913,15870,6890,1270,6773,13663,9827,17025
ũ,JiaoQuNongKen,230811579,511,69,302,272,515,302,44,322,624,322,624
,TuoYaoZiZhen,230822103,16227,1303,9999,6331,19014,9999,2988,10469,20468,10519,20518
ʯͷ,ShiTouHeZiZhen,230822104,18027,1597,10662,6472,21236,10514,3200,11583,22097,12162,22824
,HuaNanZhen,230822106,113975,10363,71017,50732,120261,69606,19803,71742,141348,73124,144141
ɽ,TuLongShanZhen,230822107,53473,4107,33063,19285,66763,33057,10202,34670,67727,34719,67782
ϼҸ,MengJiaGangZhen,230822108,27289,2518,16952,10601,34166,16912,5304,18072,34984,18159,35111
Ƽ,YanJiaZhen,230822109,22072,2332,13771,8447,27895,13771,3860,14475,28246,14493,28264
ɳ,JinShaXiang,230822205,14310,1304,8922,5242,17772,8922,2448,9140,18062,9140,18062
,LiShuXiang,230822213,26431,2008,16079,9768,32220,16079,4656,17016,33095,17016,33095
,MingYiXiang,230822214,20483,1679,12648,7553,25736,12647,3875,13380,26027,13389,26037
,DaBaLangXiang,230822215,20601,1940,13040,7880,25837,13036,4010,13479,26515,13511,26551
ҵ,HuaNanLinYeJu,230822400,24189,4018,15606,12809,29520,15598,3590,15999,31597,16191,31797
ũ,ShuGuangNongChang,230822500,7843,1400,5033,4389,8812,4992,875,5011,10003,5085,10118
,HuaNanZhongChuChang,230822580,3489,383,2215,1563,4173,2215,526,2179,4394,2183,4398
ͷɽ,HengTouShanZhen,230826101,9414,1069,5872,4186,11326,5866,1639,6220,12086,6250,12122
ռҵ,SuJiaDianZhen,230826103,10610,1065,6668,4659,13071,6661,2017,6978,13639,7024,13692
,YueLaiZhen,230826104,67903,5972,41440,25570,72589,39966,11199,41459,81425,43634,85074
³,XinChengZhen,230826105,18166,1431,11516,6959,22347,11510,3555,11593,23103,11636,23152
,DongHeXiang,230826201,6626,535,4300,3013,7811,4284,1584,4427,8711,4445,8745
,LiFengXiang,230826202,9868,797,6342,4161,12208,6334,2270,6579,12913,6593,12935
ҵ,ChuangYeXiang,230826205,10378,958,6477,4551,12501,6474,1942,6788,13262,6801,13278
ǻ,XingHuoXiang,230826207,2689,411,1591,1421,915,1578,97,1598,3176,1606,3197
,SiMaJiaXiang,230826208,11315,1170,7177,4648,13966,7177,2213,7521,14698,7521,14698
ũ,JiangChuanNongChang,230826500,9936,1293,6256,4702,11596,6233,1470,6417,12650,6443,12699
ɽũ,BaoShanNongChang,230826501,2630,192,1560,1122,2127,1554,413,1667,3221,1675,3235
,XiangLanZhen,230828101,20354,2142,12479,9555,24182,12438,3210,13110,25548,13227,25706
,HeLiZhen,230828102,16834,2026,10407,8232,19351,10356,2337,10712,21068,10790,21197
,ZhuLianZhen,230828103,9872,1167,6387,4469,12239,6386,1800,6445,12831,6452,12839
ԭ,TangYuanZhen,230828104,69655,7625,43313,35758,77432,42747,9984,43204,85951,43951,87264
,TangWangXiang,230828201,8071,870,4809,3398,8031,4803,694,4814,9617,4826,9635
ʤ,ShengLiXiang,230828203,9396,896,5866,3871,11332,5866,1741,6167,12033,6167,12033
,JiXiangXiang,230828208,10994,985,6930,4681,13807,6929,2166,7208,14137,7215,14145
,ZhenXingXiang,230828209,8419,724,5276,3760,10840,5274,1764,5629,10903,5631,10907
̫ƽ,TaiPingChuanXiang,230828210,10794,991,6743,4964,12648,6618,2024,6975,13593,7066,13809
,YongFaXiang,230828211,13139,1284,8283,5868,15820,8267,2461,8586,16853,8601,16884
ҵ,HeLiLinYeJu,230828400,9432,1575,6054,5429,10501,6043,1199,6091,12134,6152,12206
ԭũ,TangYuanNongChang,230828500,3486,688,2312,1951,4184,2293,514,2358,4651,2376,4688
ͩũ,WuTongHeNongChang,230828501,6298,796,3930,3272,6236,3912,828,3951,7863,3992,7922
,XuNiDiQu,230828580,4934,621,2101,1848,5352,2098,421,2046,4144,3875,5976
Զ,FuYuanZhen,230833100,32753,1724,18879,13408,26485,18750,6075,19415,38165,21673,40552
й,HanCongGouZhen,230833101,9746,407,5383,3197,7850,5314,2022,5577,10891,6792,12175
Ũ,NongQiaoZhen,230833102,8248,308,4358,2741,7017,4358,1509,5054,9412,5707,10065
ץ,ZhuaJiZhen,230833103,6759,275,3374,2516,4211,3363,1111,3653,7016,4771,8145
ͨ,TongJiangXiang,230833200,4438,196,2020,1426,2647,2003,662,2199,4202,3276,5296
Ũ,NongJiangXiang,230833201,2807,178,1609,1171,2875,1607,433,1803,3410,1809,3418
,HaiQingXiang,230833202,6502,288,3811,2667,5000,3811,1327,4306,8117,4306,8117
,BieLaHongXiang,230833203,3662,192,2116,1516,2608,2116,521,2259,4375,2259,4375
Ѽ,YaNanXiang,230833204,2907,93,1675,1187,2861,1675,571,1896,3571,1896,3571
ǰũ,QianShaoNongChang,230833500,8641,399,5082,3694,9161,5080,1528,5337,10417,5486,10568
ǰũ,QianFengNongChang,230833501,12151,611,7192,5272,10433,7179,2100,7604,14783,7670,14862
ũ,ErDaoHeNongChang,230833502,4684,226,2630,2227,2987,2597,640,2745,5342,2920,5550
ͬгйί,TongJiangShiChengShiGuanLiWei,230881001,40888,2893,25677,18814,38359,25387,8239,25608,50995,26343,52020
ͬ,TongJiangZhen,230881100,1628,133,1023,748,1967,1023,356,1094,2117,1094,2117
ҵ,LeYeZhen,230881101,6156,600,3999,2857,7799,3999,1417,4159,8158,4174,8173
,SanCunZhen,230881102,6491,554,4214,2867,8230,4214,1592,4411,8625,4423,8637
ٽ,LinJiangZhen,230881103,4261,258,2682,1853,4548,2681,979,2788,5469,2816,5498
,XiangYangXiang,230881201,6117,514,3921,2965,7640,3914,1387,4052,7966,4097,8018
,QingHeXiang,230881203,5450,381,3414,2430,6164,3414,1233,3638,7052,3650,7064
ֽ,JieJinKouXiang,230881204,2618,225,1640,1125,3285,1640,491,1666,3306,1694,3334
˲,BaChaXiang,230881205,2496,121,1565,1082,2650,1565,611,1657,3222,1663,3228
,JinChuanXiang,230881206,2550,114,1555,1109,2873,1555,609,1713,3268,1718,3273
,YinChuanXiang,230881207,1959,92,1199,765,2165,1199,458,1304,2503,1310,2509
ֳֽ,JieJinKouLinChang,230881400,107,9,63,52,68,63,12,65,128,65,128
Ѽֳ,YaBeiLinChang,230881401,28,0,20,11,27,20,10,18,38,18,38
ڵũ,QinDeLiNongChang,230881500,17446,2216,10754,7892,17104,9968,2458,10615,20583,11366,22120
ɽũ,QingLongShanNongChang,230881501,9217,642,5495,4103,8854,5487,1447,5794,11281,5811,11306
ǰũ,QianJinNongChang,230881502,17604,907,9730,8327,16054,9700,2250,10735,20435,11031,20761
ũ,HongHeNongChang,230881503,6926,296,3903,3081,3167,3893,1080,4371,8264,4399,8302
Ѽ̺ũ,YaLvHeNongChang,230881504,5387,264,2982,2425,4447,2982,766,3435,6417,3435,6417
Ũũ,NongJiangNongChang,230881505,5212,235,2959,2276,3902,2959,780,3268,6227,3268,6227
ֳ,LiangZhongChang,230881580,184,9,116,85,232,116,39,116,232,116,232
,XuMuChang,230881581,280,6,181,127,353,181,83,188,369,188,369
֪ũ,ZhiQingNongChang,230881582,17,2,9,9,20,9,1,11,20,11,20
ίԱ,ChengShiSheQuJianSheWeiYuan,230882001,103344,9027,62000,50121,105910,60946,15301,63800,124746,65672,127672
ǹίԱ,ChengGuanSheQuJianSheWeiYuan,230882002,12131,1055,7025,5404,13510,7025,1711,7843,14868,7872,14897
,ChangAnZhen,230882103,12604,1001,7881,5276,15737,7881,2482,8206,16087,8206,16087
ɽ,YanShanZhen,230882106,12410,1050,7831,5045,15396,7831,2582,8211,16042,8211,16042
ͷ,TouLinZhen,230882107,11162,801,7001,4510,13698,6983,2490,7394,14377,7452,14453
¡,XingLongGangZhen,230882108,9110,702,5871,3926,10948,5871,2147,6088,11959,6088,11959
ʤ,HongShengZhen,230882109,9157,709,5974,3737,11108,5971,2307,6173,12144,6199,12173
,XiangYangChuanZhen,230882110,22606,1940,14173,9259,28694,14171,4796,15078,29249,15169,29342
ɽ,ErLongShanZhen,230882111,23534,2028,14932,9480,29178,14932,5182,15812,30744,15812,30744
Ͻֻ,ShangJieJiZhen,230882112,16352,1270,10249,6745,20112,10249,3352,10725,20974,10725,20974
ɽ,JinShanZhen,230882113,23970,1909,14939,10262,29865,14937,4873,15745,30682,15813,30752
,DaYuShuZhen,230882114,20308,1770,12580,8318,25294,12569,3924,13392,25961,13422,26002
ũ,QiXingNongChang,230882501,48516,4342,28742,21397,40784,27279,6643,28464,55743,30759,59501
ũ,DaXingNongChang,230882502,10626,808,6336,4813,10440,6322,1767,6845,13167,6865,13201
ҵũ,ChuangYeNongChang,230882503,10722,883,6562,4962,7943,6544,1761,6764,13308,6804,13366
˻ֵ´,XingHuaJieDaoBanShiChu,230902001,8600,794,5143,4456,7720,5140,1191,5440,10580,5442,10585
³ǽֵ´,XinChengJieDaoBanShiChu,230902002,14488,1070,8248,6938,14703,8246,1728,9031,17277,9038,17286
ֵ´,XinLiJieDaoBanShiChu,230902003,17199,1047,9972,8264,11992,9966,2625,10871,20837,10899,20871
½ֵ´,XinJianJieDaoBanShiChu,230902004,11848,937,6839,5336,10746,6838,1468,7411,14249,7414,14253
ɽֵ´,BeiShanJieDaoBanShiChu,230902005,30413,2583,18640,13458,22962,18003,4689,18326,36329,19045,37685
Ͻֵ´,HeNanJieDaoBanShiChu,230902006,11746,901,6915,5548,9215,6915,1759,7482,14397,7491,14406
ºϽֵ´,XinHeJieDaoBanShiChu,230902007,7202,711,4370,3626,5760,4366,1025,4563,8929,4568,8938
Ҥֵ´,GangYaoGouJieDaoBanShiChu,230902008,12196,870,7158,5819,9022,7145,1810,7659,14804,7718,14876
°ֵ´,XinAnJieDaoBanShiChu,230902009,7870,478,4438,3724,6466,4438,1020,4896,9334,4930,9368
Խֵ´,YueXiuJieDaoBanShiChu,230902010,8764,1067,5455,3883,9758,5371,1391,5637,11008,5767,11222
,HongQiZhen,230902100,19319,1614,11581,8169,19130,11350,3157,12165,23515,12509,24090
,ChangXingXiang,230902200,15390,1364,9629,6008,17966,9629,2864,9978,19607,9989,19618
,ZhongChuChang,230902480,8892,1284,5780,4563,10694,5779,1524,5914,11693,5920,11700
ũ,BeiXingNongChang,230902500,15952,2085,9657,7784,14659,9585,2022,10130,19715,10402,20059
¡ũ,HeiLongJiangHongXingLongNongKen,230902579,1485,98,876,733,1013,873,228,917,1790,935,1811
Ͻֵ´,TaoNanJieDaoBanShiChu,230903001,47286,3362,30093,21760,32219,29655,8630,28809,58464,29185,59278
ұֵ´,TaoBeiJieDaoBanShiChu,230903002,35664,2429,20784,15063,29577,20369,5546,19880,40249,22855,43639
ֵ´,TaoXiJieDaoBanShiChu,230903003,14072,985,8380,6945,12727,8378,2116,8771,17149,8793,17173
˸ڽֵ´,XingGangJieDaoBanShiChu,230903004,7414,580,4270,3409,6516,4258,982,4664,8922,4706,8976
Ҷֵ´,TaoDongJieDaoBanShiChu,230903005,50338,3384,30828,23036,35950,30107,8207,29739,59846,31101,61929
ɽֵ´,TaoShanJieDaoBanShiChu,230903006,7461,544,4372,3410,4467,4329,1164,4752,9081,4797,9169
򱦺,WanBaoHeZhen,230903100,24219,2175,14572,12169,19632,14531,3735,15353,29884,15557,30129
ֵ´,DongFengJieDaoBanShiChu,230904001,17962,1207,10826,8337,16055,10705,2951,11139,21844,11294,22120
ֵ´,XiangYangJieDaoBanShiChu,230904002,5308,418,3056,2590,4878,3056,738,3402,6458,3408,6464
ǿֵ´,FuQiangJieDaoBanShiChu,230904003,11794,524,6645,5850,10363,6643,1688,7346,13989,7361,14006
¸ֵ´,XinFuJieDaoBanShiChu,230904004,13229,973,7971,6564,10747,7965,2173,8396,16361,8404,16375
ֵ´,LongHuJieDaoBanShiChu,230904005,7857,216,4156,3642,2391,4143,1254,4939,9082,5171,9327
Ӻ,QieZiHeZhen,230904100,22070,1723,13085,9950,15597,13042,3463,14078,27120,14171,27256
ΰ,HongWeiZhen,230904101,15481,1165,9626,6677,16278,9603,3518,10291,19894,10538,20164
ɽ,TieShanXiang,230904200,17978,1450,10472,8306,17035,10465,2796,11624,22089,11752,22224
ĺ,ZhongXinHeXiang,230904201,12606,985,7690,5749,11883,7668,2399,8175,15843,8300,15990
ֵ´,XinQiJieDaoBanShiChu,230921001,17889,1824,11112,8720,16129,11067,2805,11225,22292,11406,22518
»ֵ´,XinHuaJieDaoBanShiChu,230921002,13374,1335,8425,6935,10753,8383,1925,8150,16533,8209,16634
Ԫֵ´,YuanMingJieDaoBanShiChu,230921003,10094,882,6290,4914,8044,6281,1535,6196,12477,6221,12511
ֵ´,TieXiJieDaoBanShiChu,230921004,8616,913,5270,4203,7640,5255,1240,5476,10731,5499,10769
ֵ´,ChengXiJieDaoBanShiChu,230921005,29305,3172,18860,14616,23260,18498,4738,17949,36447,18355,37215
,BoLiZhen,230921100,12964,1435,8016,6025,15418,8015,2120,8502,16517,8503,16519
Сվ,XiaoWuZhanZhen,230921101,17953,1807,10989,7772,21229,10979,3168,11825,22804,11939,22928
վ,DaSiZhanZhen,230921102,20204,2045,12571,9196,24656,12559,3703,13317,25876,13381,25952
˫,ShuangHeZhen,230921103,18323,1780,11508,8537,22464,11503,3365,11920,23423,11960,23468
,WoKenZhen,230921104,15397,1703,9702,7437,18945,9696,2538,9934,19630,9936,19638
ɽ,QingShanXiang,230921200,15396,1438,9660,6653,18507,9660,3009,10183,19843,10183,19843
,YongHengXiang,230921202,19980,1965,12549,8691,24530,12513,3696,12894,25407,13092,25641
,QiangKenXiang,230921203,10615,1126,6620,4898,13181,6614,1956,7012,13626,7077,13697
,XingShuChaoXianZuXiang,230921204,14089,1535,8982,6517,17356,8963,2420,9040,18003,9062,18044
˳,JiXingChaoXianZuManZuXiang,230921205,10828,1137,6877,5209,13747,6876,2142,7226,14102,7230,14107
°ֵ´,XinAnJieDaoBanShiChu,231002001,41824,5463,26625,18707,45834,26269,4777,24860,51129,25439,52064
ֵ´,ChangAnJieDaoBanShiChu,231002002,31040,4084,20155,14405,34146,20097,4494,19200,39297,19463,39618
ǽֵ´,QiXingJieDaoBanShiChu,231002003,31402,4626,20119,14159,33356,19851,3468,18769,38620,19377,39496
ǽֵ´,WuXingJieDaoBanShiChu,231002004,18214,3134,12005,8707,18322,11911,2376,11593,23504,11719,23724
¡ֵ´,XingLongJieDaoBanShiChu,231002005,37761,3203,19775,12793,32872,18868,4294,19082,37950,25483,45258
ֵ´,YangMingJieDaoBanShiChu,231003001,35077,4804,22703,16730,33989,22575,5041,22026,44601,22219,44922
ǰֵ´,QianJinJieDaoBanShiChu,231003002,21797,3497,13867,10336,25070,13859,2375,13754,27613,13802,27669
˽ֵ´,XinXingJieDaoBanShiChu,231003003,15910,2084,9714,7512,14372,9624,1895,9924,19548,10175,19889
𽺳ֵ´,HuaLinXiangJiaoChangJieDaoBanShiChu,231003004,13478,2047,8551,5958,15860,8551,1497,8451,17002,8471,17022
,TieLingZhen,231003100,29633,3790,18449,12056,29068,16586,4045,16929,33515,19019,37468
,HuaLinZhen,231003101,9059,1125,5507,3881,9842,5502,1056,5726,11228,5733,11240
ĥʯ,MoDaoShiZhen,231003102,24789,2774,15637,9359,31588,15376,4872,15992,31368,16798,32435
,WuLinZhen,231003103,38839,4588,24299,16466,48311,24296,6142,25256,49552,25270,49569
ֵ´,XiangYangJieDaoBanShiChu,231004001,29832,4015,19102,13797,26562,17520,3466,17172,34692,18211,37313
ƻֵ´,HuangHuaJieDaoBanShiChu,231004002,48441,4814,31258,14191,32535,17976,3227,18059,36035,25224,56482
ֵ´,TieBeiJieDaoBanShiChu,231004003,29785,4559,19112,13478,33012,18203,3327,18030,36233,18559,37671
»ֵ´,XinHuaJieDaoBanShiChu,231004004,20065,2927,12872,9540,20110,12733,2649,12429,25162,12769,25641
ֵ´,DaQingJieDaoBanShiChu,231004005,24904,3375,15378,11137,21484,14608,2639,15324,29932,15540,30918
ƽֵ´,XingPingJieDaoBanShiChu,231004006,26709,2776,17159,7969,24184,10142,1929,10009,20151,14255,31414
ɽֵ´,BeiShanJieDaoBanShiChu,231004007,30101,4886,18949,12803,30061,18023,3196,18114,36137,19234,38183
,BeiAnXiang,231004201,14137,1546,8556,5871,12489,8427,1984,8850,17277,9111,17667
ȷֵ´,XianFengJieDaoBanShiChu,231005001,24230,3178,16006,11390,26558,15848,3560,14872,30720,14962,30968
ֵ´,HuoJuJieDaoBanShiChu,231005002,29101,5587,19351,14467,33494,19050,3318,18271,37321,18655,38006
½ֵ´,LiXinJieDaoBanShiChu,231005003,37242,4559,24367,17441,36401,24268,5733,23048,47316,23167,47534
ĵֵ´,MuDanJieDaoBanShiChu,231005004,7102,1089,4579,3384,7716,4569,800,4399,8968,4412,8991
ֵ´,JiangBinJieDaoBanShiChu,231005005,7661,1910,5232,3945,9102,5096,803,5054,10150,5142,10374
ؽֵ´,YanJiangJieDaoBanShiChu,231005006,42829,5029,27102,19845,41985,27017,6250,26831,53848,27006,54108
´,WenChunZhen,231005100,36249,3768,22498,13788,30835,18819,4219,19434,38253,21738,44236
ϳ,HaiNanChaoXianZuXiang,231005201,12252,1612,7503,6014,10026,7473,1410,7727,15200,7771,15274
,DongNingZhen,231024100,68614,7153,43415,32419,61973,42587,11721,42352,84939,44073,87488
,SanChaKouZhen,231024101,10705,1318,6514,5234,9212,6510,1459,6820,13330,6968,13482
Ǵ,DaDuChuanZhen,231024102,13550,1600,8264,6166,15154,8168,2240,8918,17086,9126,17390
Ϻɽ,LaoHeiShanZhen,231024103,11540,1118,6718,5333,9809,6699,2049,7492,14191,7989,14707
,DaoHeZhen,231024104,11194,1371,7024,5394,13389,7020,2197,7707,14727,7738,14762
,SuiYangZhen,231024105,22161,2386,13632,10024,23490,13376,4079,14180,27556,14994,28626
ҵ,SuiYangLinYeJu,231024400,18322,3311,12011,9573,21260,11902,2628,11968,23870,12250,24261
ֿ,LinKouZhen,231025100,80331,9081,49432,35798,85140,48043,10588,49111,97154,50568,100000
ų,GuChengZhen,231025101,21116,2261,12620,9069,25855,12620,2961,13715,26335,13718,26338
,DiaoLingZhen,231025102,32149,3325,19941,11444,39021,19941,5230,20763,40704,20763,40704
,ZhuJiaZhen,231025104,19458,1966,11758,7659,23537,11748,2843,12443,24191,12509,24267
,LiuShuZhen,231025105,18919,1727,11643,6788,23235,11636,3323,12304,23940,12326,23969
ͨ,SanDaoTongZhen,231025106,18348,1610,10873,6707,21904,10868,2423,11480,22348,11508,22381
צ,LongZhaoZhen,231025107,21383,2474,12990,8446,25523,12938,3455,14093,27031,14322,27312
,LianHuaZhen,231025108,10040,1108,6350,3897,12156,6316,1492,6263,12579,6290,12640
ɽ,KuiShanXiang,231025200,19908,2414,12339,8333,24682,12338,2984,12955,25293,12967,25306
ɽ,QingShanXiang,231025201,22620,2290,13590,10053,26491,13566,3341,14471,28037,14661,28251
,JianTangXiang,231025202,16896,1586,10426,6612,20661,10416,2848,10860,21276,10904,21330
ֿҵ,LinKouLinYeJu,231025400,12468,2385,8118,6595,14689,8063,1605,8255,16318,8340,16458
Һ,SuiFenHeZhen,231081100,79847,4069,48577,34253,43211,47437,14645,48036,95473,49984,98561
,FuNingZhen,231081101,27702,1469,15753,11866,12156,15555,4583,16855,32410,18001,33754
,HaiLinZhen,231083100,115474,12843,71543,51650,128804,70482,16126,71370,141852,72900,144443
͡,ChangTingZhen,231083101,24370,3238,15238,11849,28651,15229,3607,15958,31187,15977,31215
,HengDaoZhen,231083102,13103,1927,7683,5515,15022,7673,1211,8069,15742,8558,16241
ɽ,ShanShiZhen,231083103,16343,2067,10331,5732,14861,10331,2918,10992,21323,10997,21328
,ChaiHeZhen,231083104,19397,2357,12139,8252,19642,11981,2934,12343,24324,12549,24688
,ErDaoZhen,231083105,9627,933,5945,3980,11596,5936,1756,6339,12275,6371,12316
°,XinAnChaoXianZuZhen,231083106,15232,1676,9569,6644,15825,9569,2117,9456,19025,9456,19025
,SanDaoZhen,231083107,7654,767,4738,3327,8815,4733,1208,4852,9585,4891,9629
ĵֹ̹˾ֵ,MuLinGongChengGongSiJieDao,231083400,2994,566,2084,1613,1355,2067,488,1956,4023,1964,4048
ֵֻ´,ChaiHeLinJiChangJieDaoBanShiChu,231083401,1925,361,1249,834,2308,1075,228,1079,2154,1265,2514
ҵ,DaHaiLinLinYeJu,231083402,24763,5237,16400,11552,31991,13427,2748,13248,26675,16348,32748
ҵ,HaiLinLinYeJu,231083403,13251,3202,9283,7060,15261,9004,1857,8794,17798,9027,18310
ҵ,ChaiHeLinYeJu,231083404,39168,7222,25049,20683,48237,24652,4113,24611,49263,25454,50503
ũ,HaiLinNongChang,231083500,5945,806,3257,2525,6353,3171,670,3198,6369,4164,7421
ɽţ,ShanShiZhongNaiNiuChang,231083501,5029,825,3176,2429,6205,3163,576,3171,6334,3254,6430
ֵ´,ChengQuJieDaoBanShiChu,231084001,58276,7023,37460,27882,55910,36535,8593,35359,71894,36432,73892
,NingAnZhen,231084100,22325,2462,14103,9118,25175,13969,3331,13776,27745,14015,28118
,DongJingChengZhen,231084101,34617,3991,21467,15860,39387,21263,4763,21598,42861,21904,43371
,BoHaiZhen,231084102,28737,3320,17993,12313,35172,17916,4201,18177,36093,18265,36258
ʯ,ShiYanZhen,231084103,22958,2556,14581,8160,28669,13264,3774,13529,26793,14707,29288
ɳ,ShaLanZhen,231084104,20519,2017,13101,7047,25761,11105,3966,11267,22372,13401,26502
,HaiLangZhen,231084105,30354,3436,19670,11965,38501,19649,5810,19895,39544,19930,39600
,LanGangZhen,231084106,11755,1127,7391,4600,14248,7388,1874,7363,14751,7365,14756
ϳ,JiangNanChaoXianZuManZuXiang,231084202,24332,2639,15251,10230,26372,15240,3911,15614,30854,15631,30882
,WoLongChaoXianZuXiang,231084206,13886,1289,8647,5608,15862,8616,2161,8680,17296,8689,17336
,MaHeXiang,231084208,13623,1434,8287,5333,16466,8087,2028,8558,16645,8798,17085
,JingBoXiang,231084210,13097,1296,7995,5569,14680,7965,2237,8459,16424,8635,16630
,SanLingXiang,231084211,16346,1919,10562,6874,20546,10558,3018,10713,21271,10721,21283
ҵ,DongJingChengLinYeJu,231084400,27533,5401,18105,14095,33635,17598,3334,17534,35132,18163,36268
ũ,NingAnNongChang,231084500,4801,786,3076,2458,5449,3047,596,3070,6117,3107,6183
ͨ,BaMianTongZhen,231085100,61183,7717,36659,24705,68683,35449,7526,37857,73306,39767,76426
,MuLingZhen,231085101,34124,4897,21710,14585,42687,21611,5265,22172,43783,22576,44286
³,XiaChengZiZhen,231085102,26699,2597,16732,9338,32844,16531,5351,17250,33781,17915,34647
ź,MaQiaoHeZhen,231085103,20647,2029,12431,7439,24360,12349,4140,13039,25388,14385,26816
Դ,XingYuanZhen,231085104,15391,1867,9923,6431,18941,9890,3042,10199,20089,10377,20300
¼,FuLuXiang,231085200,15155,1656,9200,5521,17816,8676,2143,9004,17680,9754,18954
,HeXiXiang,231085201,23415,2329,14411,9671,25713,14284,3781,14999,29283,15114,29525
,GongHeXiang,231085202,7724,687,4615,2543,8746,4615,1377,5173,9788,5173,9788
ͨҵ,BaMianTongLinYeJu,231085400,5311,1344,3294,3285,6049,3294,524,3883,7177,3885,7179
ҵ,MuLingLinYeJu,231085401,19068,3958,12597,9536,24211,12445,2324,12618,25063,12753,25350
԰ֵ´,HuaYuanJieDaoBanShiChu,231102001,53268,4088,33176,22556,51136,28782,7982,27728,56510,32162,65338
˰ֵ´,XingAnJieDaoBanShiChu,231102002,22996,2705,14955,12017,20273,14946,3680,14392,29338,14426,29381
ֵ´,HaiLanJieDaoBanShiChu,231102003,17063,2176,11223,8824,14919,11202,2681,10640,21842,10697,21920
˽ֵ´,XiXingJieDaoBanShiChu,231102004,16417,1897,10348,7899,14361,10308,2192,10123,20431,10158,20506
,XiGangZiZhen,231102101,7898,1110,5077,3625,9698,5077,1234,5165,10242,5165,10242
,AiHuiZhen,231102102,6807,665,4366,2812,8232,4364,1183,4288,8652,4289,8655
,HanDaQiZhen,231102103,13359,402,4836,3846,7056,4354,1090,5104,9458,10015,14851
Ҹ,XingFuXiang,231102200,10166,752,5789,4326,6636,5765,1394,6315,12080,6523,12312
ļ,SiJiaZiXiang,231102201,3299,338,1990,1424,3760,1989,413,2054,4043,2060,4050
,KunHeXiang,231102202,1620,129,1006,732,1881,1004,285,1028,2032,1028,2034
�,ShangMaChangXiang,231102203,2884,269,1663,1294,3155,1649,474,1852,3501,1964,3627
ŵӪ,ZhangDiYingZiXiang,231102204,3427,384,2104,1456,3989,2082,538,2212,4294,2245,4349
ɽ,XiFengShanXiang,231102205,1814,128,1054,777,1911,1053,264,1149,2202,1152,2206
,XinShengXiang,231102206,954,70,534,456,914,532,122,604,1136,612,1146
վ,ErZhanXiang,231102207,2249,214,1361,1078,2364,1361,361,1451,2812,1463,2824
ũ,JinHeNongChang,231102500,5997,1079,3826,3134,6768,3826,796,4046,7872,4046,7872
۽,NenJiangZhen,231121100,110719,10466,70853,49010,115306,61665,20806,61125,122790,71138,141991
,YiLaHaZhen,231121101,16165,1777,10406,7326,20271,10266,3089,10539,20805,10625,21031
˫ɽ,ShuangShanZhen,231121102,7616,806,4632,3530,7408,4622,1128,4897,9519,4918,9550
౦ɽ,DuoBaoShanZhen,231121103,15692,794,9356,6617,12032,9279,3230,9941,19220,10360,19716
,HaiJiangZhen,231121104,25993,2315,16622,11091,32006,16499,4967,16567,33066,16653,33275
ǰ,QianJinZhen,231121105,16317,1407,10192,6716,20023,9902,2895,10063,19965,10427,20619
,ChangFuZhen,231121106,13527,1339,8470,6101,16841,8469,2367,8758,17227,8763,17233
,KeLuoZhen,231121107,12301,802,7529,5309,14366,7523,2417,7922,15445,7991,15520
ٽ,LinJiangXiang,231121202,12650,1073,8148,6144,15396,8148,2665,8240,16388,8240,16388
,LianXingXiang,231121206,11133,1013,7101,5139,13601,6953,2107,7006,13959,7152,14253
,BaiYunXiang,231121207,12458,923,7550,5130,13661,7548,2332,8162,15710,8163,15713
Ϫ,TaXiXiang,231121208,7209,544,4393,3247,7702,4391,1512,4844,9235,4872,9265
,HuoLongMenXiang,231121210,8938,655,5630,3600,9415,5618,2053,5998,11616,6016,11646
,ChangJiangXiang,231121211,5143,394,3091,2362,5654,3051,921,3313,6364,3367,6458
౦ɽͭ,DuoBaoShanTongKuang,231121400,1694,179,1037,925,1546,1035,261,1095,2130,1097,2134
־־ֱ,JiuSanFenJuJuZhi,231121500,20208,2730,13080,10284,17762,12325,2934,12145,24470,12792,25872
ɽũ,HeShanNongChang,231121501,12476,1972,8004,6721,15494,8001,1758,8177,16178,8202,16206
ũ,DaXiJiangNongChang,231121502,8402,1245,5463,4445,10471,5441,1348,5502,10943,5532,10995
ɽũ,JianShanNongChang,231121503,8018,1389,5295,4516,9824,5256,1234,5279,10535,5346,10641
پũ,RongJunNongChang,231121504,6341,1131,4149,3622,7903,4145,820,4143,8288,4143,8292
ũ,HongWuYueNongChang,231121505,6824,1141,4288,3831,8341,4286,842,4499,8785,4519,8807
ũ,QiXingPaoNongChang,231121506,12516,1464,7503,6448,14571,7503,1611,8075,15578,8088,15591
۽ũ,NenJiangNongChang,231121507,7453,913,4678,3892,8364,4677,1125,4808,9485,4813,9491
ɽũ,ShanHeNongChang,231121508,10722,1305,6419,5164,12436,6304,1208,6660,12964,6816,13235
۱ũ,NenBeiNongChang,231121509,9424,1074,5843,5096,11026,5828,1427,6069,11897,6082,11925
ũ,JianBianNongChang,231121510,7129,592,4366,3546,6860,4361,1214,4543,8904,4569,8935
ԭֳַ,MaLingShuYuanZhongFanZhiChang,231121581,605,63,351,330,681,351,69,386,737,386,737
˽ֵ´,QiKeJieDaoBanShiChu,231123001,21826,2232,14150,11319,21417,14084,3830,13464,27548,13738,27888
,QiKeZhen,231123100,8249,840,5290,3682,9159,4992,1484,4978,9970,5283,10573
ѷ,XunHeZhen,231123101,7134,568,4476,3041,7183,4465,1460,4648,9113,4686,9162
ɲ,GanChaZiXiang,231123201,7123,563,4571,3198,8433,4566,1441,4552,9118,4556,9127
,SongShuGouXiang,231123202,4771,387,2942,2057,5296,2942,820,3032,5974,3036,5978
½,CheLuXiang,231123203,5825,495,3762,2556,6909,3759,1114,3660,7419,3672,7434
¶,XinEXiang,231123204,1673,93,1023,806,1543,1023,333,1076,2099,1076,2099
,XinXingXiang,231123205,1166,91,632,588,1261,632,148,773,1405,773,1405
,KeLinXiang,231123206,2866,135,1726,1172,3120,1726,551,1826,3552,1826,3552
ɽ,BaoShanXiang,231123207,3297,202,1925,1404,3032,1912,525,2071,3983,2099,4024
ѷũ,XunKeNongChang,231123500,16253,1687,9697,7856,17284,9666,2229,10362,20028,10472,20169
ֵ´,SunWuChengQuJieDaoBanShiChu,231124001,28544,2676,18089,14797,26920,17956,5219,18023,35979,18350,36439
,SunWuZhen,231124100,8240,626,4915,3854,5914,4904,1373,5299,10203,5324,10239
,ChenQingZhen,231124101,3311,260,2117,1570,3082,2117,679,2133,4250,2133,4250
,XiXingXiang,231124201,6184,359,3714,3003,6324,3714,1111,3940,7654,3940,7654
ؽ,YanJiangManZuXiang,231124202,5758,432,3709,2271,6359,3709,1098,3579,7288,3579,7288
,YaoTunXiang,231124203,5249,442,3338,2658,6158,3338,1018,3371,6709,3371,6709
ţ,WoNiuHeXiang,231124204,2430,183,1456,1091,2068,1454,440,1596,3050,1597,3053
Ⱥɽ,QunShanXiang,231124205,2443,148,1453,1047,2306,1452,436,1570,3022,1574,3027
ܶ,FenDouXiang,231124206,3292,219,2041,1553,3294,2041,742,2203,4244,2212,4253
,HongQiXiang,231124207,2111,130,1261,966,2207,1254,387,1365,2619,1367,2628
ɽ,ZhengYangShanXiang,231124208,4356,300,2572,1908,4960,2572,694,2778,5350,2778,5350
Ϫ,QingXiXiang,231124210,1998,159,1192,892,2135,1191,312,1274,2465,1277,2469
ɫ߽ũ,HongSeBianJiangNongChang,231124500,7337,1007,4668,3283,8645,4111,1118,4221,8332,4794,9462
ֵ´,ZhaoLinJieDaoBanShiChu,231181001,25177,3147,16856,13075,26833,16784,3989,15376,32160,15457,32313
ƽֵ´,HePingJieDaoBanShiChu,231181002,33646,3415,19203,15924,30788,19082,4513,17819,36901,22371,41574
ڽֵ´,BeiGangJieDaoBanShiChu,231181003,14239,1942,9107,7168,13178,8127,1590,7928,16055,8664,17771
컪ֵ´,QingHuaJieDaoBanShiChu,231181004,19600,3801,13620,12442,23844,13608,2433,12100,25708,12214,25834
ֵ´,TieXiJieDaoBanShiChu,231181005,7261,840,4754,4038,6295,4527,927,4107,8634,4274,9028
Ͻֵ´,TieNanJieDaoBanShiChu,231181006,9075,1226,5781,5686,10071,5781,1121,5637,11418,5641,11422
ͨ,TongBeiZhen,231181101,30493,2643,19648,14070,31962,19639,5132,18616,38255,18620,38268
Թ,ZhaoGuangZhen,231181102,20791,2222,13437,9523,24652,13108,3585,12499,25607,13161,26598
,HaiXingZhen,231181103,12799,941,8161,5271,15694,8160,2331,7903,16063,7910,16071
ʯȪ,ShiQuanZhen,231181104,30912,2590,19647,12105,38720,19263,5664,19128,38391,19519,39166
,ErJingZhen,231181105,18402,1475,11694,8357,22523,11691,3547,11718,23409,11730,23424
ǽ,ChengJiaoXiang,231181200,16544,1922,10160,7913,19138,10151,2431,10708,20859,10737,20897
ʤ,DongShengXiang,231181201,12736,1208,7867,5696,15619,7866,2276,8334,16200,8353,16220
,YangJiaXiang,231181203,16236,1180,10123,5285,19944,10110,3039,10325,20435,10332,20455
,ZhuXingXiang,231181207,2461,297,1463,1113,2750,1462,331,1624,3086,1626,3089
ͨҵ,TongBeiLinYeJu,231181400,23756,4441,15608,13789,28430,15576,3123,15590,31166,15712,31320
ˮũ,ChangShuiHeNongChang,231181501,8439,849,5248,3951,9258,5243,1277,5296,10539,5317,10565
Թũ,ZhaoGuangNongChang,231181502,22978,3867,14933,11958,24459,14220,2938,14130,28350,14850,29783
ũ,HongXingNongChang,231181503,7372,1001,4576,3700,7823,4512,1062,4569,9081,4859,9435
ũ,JianSheNongChang,231181504,10355,1439,6508,5354,12227,6508,1417,6703,13211,6703,13211
ɽֵ´,QingShanJieDaoBanShiChu,231182001,43916,4146,25125,20748,40399,24405,6225,24281,48686,29162,54287
,LongZhen,231182101,20053,1822,12376,9035,22597,12372,3382,12868,25240,12881,25257
ƽ,HePingZhen,231182102,15389,1400,9764,7133,19316,9755,2958,9965,19720,9983,19747
,WuDaLianChiZhen,231182103,11029,1009,6967,5128,10695,6844,1808,6712,13556,6879,13846
˫Ȫ,ShuangQuanZhen,231182104,10426,915,6676,4871,12853,6671,2240,6899,13570,6905,13581
·,XinFaXiang,231182201,8279,824,5200,3771,10215,5193,1588,5485,10678,5491,10691
¡,XingLongXiang,231182202,6249,635,3956,2890,7928,3946,1190,4114,8060,4118,8074
,JianSheXiang,231182203,8765,841,5732,4111,11027,5720,1856,5714,11434,5730,11462
̫ƽ,TaiPingXiang,231182205,10561,947,6931,4852,13448,6931,2238,6815,13746,6815,13746
Ž,TuanJieXiang,231182207,12004,1035,7855,4758,15368,7855,2810,7994,15849,7994,15849
˰,XingAnXiang,231182208,2603,211,1666,1137,2760,1666,578,1726,3392,1726,3392
,ZhaoYangXiang,231182210,5364,432,3361,2329,5840,3361,1108,3543,6904,3543,6904
մҵ,ZhanHeLinYeJu,231182417,25828,3281,15945,12736,28523,15906,3386,16457,32363,16550,32495
ίԱ,LianHuaGuanLiWeiYuanHui,231182418,2668,193,1709,1124,2855,1709,593,1745,3454,1745,3454
԰,HuaYuanXuNiDiQu,231182480,1768,343,1145,1013,2204,1128,186,1142,2270,1152,2297
,XuNiDiQu,231182481,2368,349,1481,1283,2774,1478,291,1481,2959,1527,3008
,XuNiDiQu,231182482,5709,856,3670,3343,6965,3664,818,3690,7354,3713,7383
,XuNiDiQu,231182483,3778,794,2456,2300,4684,2443,416,2506,4949,2532,4988
ũ,LongMenNongChang,231182501,5820,396,3404,2820,6362,3398,863,3663,7061,3675,7079
ũ,XiangHeNongChang,231182502,5594,505,3408,2868,6429,3385,783,3449,6834,3474,6882
ũ,LongZhenNongChang,231182503,10934,1333,6742,4933,10781,6712,1479,6893,13605,7004,13746
ɽũ,ErLongShanNongChang,231182504,11164,1818,7162,5945,12373,7145,1469,7259,14404,7289,14451
ũ,YinLongHeNongChang,231182505,8903,911,5343,4406,9782,5328,1176,5603,10931,5647,10990
βɽũ,WeiShanNongChang,231182506,7288,779,4260,3754,8435,4260,849,4656,8916,4656,8916
ɽũ,GeQiuShanNongChang,231182507,6498,759,4013,3567,7147,3920,859,4020,7940,4103,8116
ԭֳ,WuDaLianChiYuanZhongChang,231182508,4500,679,2819,2399,5250,2815,571,2922,5737,2931,5750
´,ZiLaiBanShiChu,231202001,48194,6817,30525,24033,55537,30385,6121,30542,60927,30607,61132
·´,AiLuBanShiChu,231202002,76677,9094,48092,36412,84698,47634,10316,47749,95383,47995,96087
а´,DaYouBanShiChu,231202003,55465,5941,35380,26926,54464,35076,9148,34672,69748,35174,70554
̩´,JiTaiBanShiChu,231202004,43406,4215,27191,16851,38574,21982,4985,22416,44398,25415,52606
˰´,DongXingBanShiChu,231202005,12989,1040,7812,4906,15237,7812,1593,7810,15622,7810,15622
ְ´,BeiLinBanShiChu,231202006,8538,734,5232,3468,7740,5223,1117,5149,10372,5157,10389
ɽ,BaoShanZhen,231202101,28755,2368,17736,11033,34755,17710,4700,17978,35688,18087,35823
ʤ,SuiShengZhen,231202102,18703,1669,11651,6822,23169,11650,3108,11828,23478,11829,23480
�,XiChangFaZhen,231202103,36791,3349,22972,13193,45429,22953,6289,23386,46339,23457,46429
,YongAnZhen,231202104,20840,1831,12922,7996,25474,12905,3318,13013,25918,13067,25989
̫ƽ,TaiPingChuanZhen,231202105,21488,1795,13250,7083,26623,13250,3504,13537,26787,13537,26787
ؼ,QinJiaZhen,231202106,24671,2137,15721,9333,30665,15721,4553,15640,31361,15640,31361
˫,ShuangHeZhen,231202107,18446,1570,11411,6501,22646,11397,3064,11621,23018,11669,23080
,SanHeZhen,231202108,22572,1855,13666,8273,27653,13663,3711,14467,28130,14472,28138
ķ̨,SiFangTaiZhen,231202109,35519,3692,21894,13912,44211,21893,5497,22814,44707,22814,44708
,JinHeZhen,231202110,15785,1310,9728,5463,19398,9728,2733,10100,19828,10100,19828
ά,ZhangWeiZhen,231202111,26842,2500,16576,10745,33099,16575,4264,17027,33602,17030,33606
,DongJinZhen,231202113,23991,2515,14997,8687,28568,14932,3684,14791,29723,15193,30190
,HongQiXiang,231202201,14972,1290,9178,5360,18598,9174,2405,9487,18661,9489,18667
,LianGangXiang,231202202,20421,1766,12875,7402,25291,12870,3613,12920,25790,12925,25800
»,XinHuaXiang,231202203,25491,2107,15800,9727,29765,15248,4074,15720,30968,15872,31672
˸,XingFuXiang,231202204,29609,2575,18409,10232,35909,18407,4758,18531,36938,18533,36942
,DongFuXiang,231202205,26845,2119,16505,9550,32014,16504,4353,16812,33316,16812,33317
,SanJingXiang,231202209,24055,2203,14984,8748,30109,14979,3924,15190,30169,15198,30182
Ӫ,WuYingXiang,231202212,17607,1260,10664,5868,21677,10664,2979,11182,21846,11182,21846
˺,XingHeXiang,231202213,2416,301,1414,1043,2022,1414,162,1465,2879,1465,2879
,WangKuiZhen,231221100,79078,8332,49432,33612,88223,48636,12207,49655,98291,50185,99617
ͨ,TongJiangZhen,231221101,23153,1986,14511,8100,28531,14511,3956,14584,29095,14584,29095
,WeiXingZhen,231221102,29465,3030,18333,9986,36541,18321,4355,18475,36796,18517,36850
,HaiFengZhen,231221103,18993,1816,11659,6785,23789,11659,3134,12283,23942,12284,23943
,LianHuaZhen,231221104,16656,1935,10583,6384,20823,10582,2644,10642,21224,10652,21235
,HuiQiManZuZhen,231221105,18787,1726,11449,6350,22897,11449,2659,11723,23172,11723,23172
ȷ,XianFengZhen,231221106,30217,2935,18803,10650,36968,18752,4739,18989,37741,19088,37891
,DongJiaoXiang,231221201,15507,1469,9701,5431,18990,9699,2364,9638,19337,9639,19340
ɽ,LingShanManZuXiang,231221202,12382,1047,7705,4178,15277,7705,2011,7735,15440,7735,15440
,HouSanXiang,231221203,15190,1269,9302,5440,18603,9302,2364,9519,18821,9521,18823
,HuoJianXiang,231221206,34447,3548,21987,12207,43360,21987,5868,21876,43863,21876,43863
,DengTaXiang,231221207,24459,2371,14826,8922,30168,14826,3639,15643,30469,15643,30469
,DongShengXiang,231221209,10671,970,6796,4075,13119,6796,1714,6559,13355,6559,13355
,GongLiuXiang,231221210,13742,1236,9051,5135,16942,9051,2294,8221,17272,8221,17272
,XiangBaiManZuXiang,231221211,20042,1956,13226,7374,24930,13217,3308,12064,25281,12080,25306
ֳ,BaiSiLinChang,231221400,90,17,55,32,123,55,16,68,123,68,123
,ZhongChuChang,231221580,786,68,481,300,974,481,121,494,975,494,975
һֳ,DiYiLiangZhongChang,231221581,1196,104,701,375,1451,695,151,739,1434,750,1451
ڶֳ,DiErLiangZhongChang,231221582,235,30,158,93,297,158,40,147,305,147,305
,LanXiZhen,231222101,78695,7148,50978,34705,86825,49480,13866,47456,96936,48731,99709
,YuLinZhen,231222102,26531,2431,17554,10188,33584,17554,5304,16712,34266,16712,34266
ٽ,LinJiangZhen,231222103,23811,2309,16123,9222,30684,16120,5030,15018,31138,15027,31150
ƽɽ,PingShanZhen,231222104,20501,1932,13655,8592,26461,13654,4476,13243,26897,13254,26909
,KangRongXiang,231222200,19036,1655,12400,6854,23770,12376,3703,11685,24061,11994,24394
ԭ,LiaoYuanXiang,231222201,12934,1222,8551,4760,16510,8551,2608,8212,16763,8213,16764
,BeiAnXiang,231222202,13767,1278,9401,5317,17741,9401,2964,8608,18009,8608,18009
,ChangJiangXiang,231222203,17162,1507,11485,6451,21728,11483,3398,10576,22059,10582,22067
,LanHeXiang,231222204,19342,1783,12896,7806,24676,12896,3997,12226,25122,12226,25122
,HongXingXiang,231222205,12234,1077,8012,4575,15595,8012,2452,7751,15763,7751,15763
,HongGuangXiang,231222206,18110,1437,12042,6835,23115,12042,3863,11367,23409,11368,23410
,ChangGangXiang,231222207,17807,1588,11892,6733,22710,11892,3471,10974,22866,10974,22866
Զ,YuanDaXiang,231222209,21084,1865,14157,8118,26926,14155,4336,13122,27277,13128,27285
ǻ,XingHuoXiang,231222210,11229,962,7342,4053,14177,7342,2354,7203,14545,7203,14545
ܶ,FenDouXiang,231222211,16441,1364,10714,5892,20738,10714,3361,10452,21166,10452,21166
һԭֳ,DiYiYuanZhongChang,231222580,380,61,218,168,401,218,55,278,496,278,496
ڶԭֳ,DiErYuanZhongChang,231222581,114,4,60,48,123,60,13,71,131,71,131
,RouYongZhongYangChang,231222582,405,31,253,144,503,253,74,257,510,257,510
,QingGangZhen,231223100,91750,7763,54836,37875,98851,52068,11882,54135,106203,56559,111395
к,ZhongHeZhen,231223101,20739,1806,12167,8960,25297,12167,2925,13302,25469,13303,25470
,ZhenXiangZhen,231223102,33018,2823,19388,12757,40181,19365,4474,20800,40165,20927,40315
˻,XingHuaZhen,231223103,23668,2063,14239,8926,29311,14211,3756,15207,29418,15248,29487
,YongFengZhen,231223104,19827,1627,12177,7094,24216,12157,3323,12522,24679,12600,24777
«,LuHeZhen,231223105,18041,1511,10910,6133,22195,10910,2895,11537,22447,11537,22447
Ͷ,LaoDongXiang,231223201,26232,2524,15895,9287,32673,15895,4169,17030,32925,17030,32925
,JianSheXiang,231223202,16981,1536,10512,6440,21410,10512,3103,11108,21620,11108,21620
´,XinCunXiang,231223203,9989,930,6164,4361,12314,6154,1738,6464,12618,6493,12657
ʢ,ChangShengXiang,231223206,16639,1579,10309,5501,20873,10306,2986,10875,21181,10895,21204
,ZhaGangXiang,231223207,25113,2025,15184,8880,30467,15184,3920,15874,31058,15874,31058
,MinZhengXiang,231223208,21295,1796,12766,7368,26076,12765,3053,13378,26143,13378,26144
ʤ,DeShengXiang,231223209,25750,2267,15463,9281,31724,15414,3925,16407,31821,16479,31942
ӭ,YingChunXiang,231223211,16780,1518,10403,5627,20850,10403,2785,10680,21083,10680,21083
,LianFengXiang,231223212,14810,1217,8849,5008,17914,8849,2284,9462,18311,9462,18311
�,QingGangXianZhongMaChang,231223580,1489,161,911,375,1864,911,214,953,1864,953,1864
,QingGangXianZhongYangChang,231223581,477,48,306,141,583,306,65,284,590,284,590
ԭֳ,QingGangXianYuanZhongChang,231223582,927,96,537,332,1017,517,110,539,1056,596,1133
찲,QingAnZhen,231224101,93148,8006,57750,42740,102900,57254,15008,57894,115148,58412,116162
,MinYueZhen,231224102,13910,1305,8365,5091,17472,8365,2269,9119,17484,9119,17484
,DaLuoZhen,231224103,17924,1415,11065,6007,22515,11055,3268,11531,22586,11542,22607
ƽ,PingAnZhen,231224104,14053,1145,8651,5055,17000,8648,2393,8937,17585,8940,17591
,QinLaoZhen,231224105,13642,1163,8281,4866,16037,8260,2206,8632,16892,8730,17011
ʤ,JiuShengZhen,231224106,17529,1621,10814,7084,20960,10814,2849,11185,21999,11185,21999
,JianMinXiang,231224201,15303,1316,9324,5361,19118,9319,2597,9862,19181,9892,19216
ޱɽ,JuBaoShanXiang,231224202,12835,920,7808,4405,15973,7808,2333,8280,16088,8280,16088
ʤ,XinShengXiang,231224204,24978,1950,15054,8828,30981,15054,4332,16206,31260,16206,31260
,FengShouXiang,231224206,21978,1848,13425,8072,27097,13423,3671,14045,27468,14072,27497
չ,FaZhanXiang,231224208,14965,1187,9206,5316,18660,9206,2729,9668,18874,9675,18881
ͬ,TongLeXiang,231224209,14018,1020,8412,4938,17257,8412,2371,8997,17409,8997,17409
¸,ZhiFuXiang,231224210,16740,1346,9965,5603,20425,9965,2538,10659,20624,10659,20624
ʤ,HuanShengXiang,231224211,13914,1123,8612,4640,17422,8612,2507,8932,17544,8932,17544
ֳ,GuoYouLinChangGuanLiJu,231224400,1811,192,1063,822,1972,1061,208,1145,2206,1148,2211
ũ,LiuHeNongChang,231224500,2090,202,1260,1014,1807,1258,286,1318,2576,1318,2578
ˮ,MingShuiZhen,231225100,78737,6806,48057,36059,83987,46996,12581,49170,96166,50067,98124
,XingRenZhen,231225101,13731,1159,8232,4821,16762,8218,2025,8623,16841,8683,16915
,YongXingZhen,231225102,19622,1548,11968,6972,24139,11967,3299,12455,24422,12501,24469
,ChongDeZhen,231225103,18013,1516,10850,6663,22015,10850,2805,11484,22334,11484,22334
ͨ,TongDaZhen,231225104,24153,2351,14549,9287,29615,14549,3331,15286,29835,15286,29835
˫,ShuangXingXiang,231225201,23375,1929,14174,8207,28635,14170,3813,14917,29087,14943,29117
,YongJiuXiang,231225203,13247,1210,7954,4967,16089,7948,2006,8486,16434,8509,16463
,ShuRenXiang,231225204,10984,961,6790,3998,13792,6781,2003,7122,13903,7158,13948
,GuangRongXiang,231225205,13660,949,8170,4922,16846,8167,2395,8810,16977,8834,17004
,FanRongXiang,231225206,11266,924,6804,4088,13616,6799,1878,7245,14044,7264,14068
ͨȪ,TongQuanXiang,231225207,15583,1322,9435,5644,19381,9429,2636,10089,19518,10106,19541
,YuLinXiang,231225208,13641,1185,8248,5272,16871,8241,2180,8736,16977,8758,17006
Ӫֳ,GuoYingLinChang,231225400,323,32,198,147,373,198,41,198,396,198,396
�,XianLianSheMaChang,231225580,79,6,44,26,100,44,15,56,100,56,100
ˮ,MingShuiZhongChuChang,231225581,528,38,316,224,604,316,77,327,643,327,643
,YuLinXuMuChang,231225582,164,12,103,59,214,103,47,120,223,120,223
Ӫһ,GuoYingDiYiLiangZhong,231225583,175,9,92,60,193,92,20,112,204,112,204
Ӫڶ,GuoYingDiErLiangZhong,231225584,170,16,105,63,210,105,24,105,210,105,210
Ӫ,GuoYingDiSanLiangZhong,231225585,84,2,43,27,95,43,9,52,95,52,95
,SuiLengZhen,231226100,55087,5646,34785,30751,57608,34238,8601,34008,68246,34549,69334
ϼ,ShangJiZhen,231226101,21438,1671,13184,8209,25972,13184,3428,13353,26537,13353,26537
ĺ,SiHaiDianZhen,231226102,6961,564,4098,2636,8307,4098,1075,4502,8600,4502,8600
˫,ShuangChaHeZhen,231226103,20022,1912,12370,7737,24881,12370,3431,12995,25365,12995,25365
ɽ,KaoShanXiang,231226200,19120,1663,11620,7190,22937,11620,2957,12120,23740,12120,23740
ͷ,HouTouXiang,231226201,15581,1533,9583,5927,19102,9583,2301,9832,19415,9832,19415
ɽ,ChangShanXiang,231226203,20689,1855,12660,7618,25619,12660,3567,13451,26111,13451,26111
,KeYinHeXiang,231226205,13895,1485,8486,4924,17294,8486,2083,8977,17463,8977,17463
,SuiZhongXiang,231226206,12417,1022,7555,4589,15399,7555,2149,8033,15588,8033,15588
,NiErHeXiang,231226207,20178,1657,12379,7198,25322,12378,3536,12920,25298,12992,25371
ɽ,GeShanXiang,231226210,14595,1291,9136,5019,17408,9136,2376,9125,18261,9126,18262
ɽֳ,GeShanLinChang,231226400,123,22,84,58,109,84,19,80,164,80,164
ĺֳ,SiHaiDianLinChang,231226401,247,37,160,121,308,160,45,169,329,169,329
ֳ̨,SanJiTaiLinChang,231226402,322,47,196,147,392,196,31,204,400,204,400
غֳ,BanJieHeLinChang,231226403,253,24,162,124,242,162,33,148,310,148,310
ҵ,SuiLengLinYeJu,231226404,34283,5572,21140,18496,40271,21136,3656,22368,43504,22371,43511
ũ,SuiLengNongChang,231226500,6155,819,3712,3213,7599,3712,791,4053,7765,4053,7765
�,ZhongMaChang,231226580,575,23,363,210,712,363,115,350,713,350,713
ֳ,LiangZhongChang,231226581,1039,105,666,345,1318,665,177,653,1318,655,1321
ɽ,NaiShanYangChang,231226582,859,55,528,259,1044,528,130,516,1044,516,1044
ֵ´,TieXiJieDaoBanShiChu,231281001,26472,2715,16038,12745,28468,15959,3707,16427,32386,16856,32894
˽ֵ´,XinXingJieDaoBanShiChu,231281002,62971,6912,39826,31290,69749,39731,9575,39473,79204,39632,79458
ֵ´,AnHongJieDaoBanShiChu,231281003,45407,4977,28626,22018,42666,27907,6377,27622,55529,28135,56761
,AnDaZhen,231281100,21981,1827,12618,9346,23755,12617,2503,13689,26306,13693,26311
,RenMinZhen,231281101,19751,2058,12276,7964,24303,12276,3181,12714,24990,12714,24990
ɽ,WanBaoShanZhen,231281103,23171,1798,13825,9658,27571,13825,3707,14851,28676,14851,28676
,ChangDeZhen,231281104,17820,1524,10949,6642,22242,10949,3141,11536,22485,11536,22485
ƽ,ShengPingZhen,231281105,18207,1502,11080,6771,22464,11069,3226,11827,22896,11855,22935
,YangCaoZhen,231281106,24740,2150,15002,9546,30187,15002,3789,15667,30669,15677,30679
ϻ,LaoHuGangZhen,231281107,20912,1739,12967,8204,26339,12967,3815,13499,26466,13499,26466
б,ZhongBenZhen,231281108,10620,1022,6571,4732,12525,6546,1834,6782,13328,6905,13476
̫ƽׯ,TaiPingZhuangZhen,231281109,8713,690,5373,3735,10683,5373,1663,5692,11065,5693,11066
˸,JiXingGangZhen,231281110,22451,1911,13871,8955,27762,13871,4058,14549,28420,14549,28420
ʯɽ,HuoShiShanXiang,231281202,10121,949,6425,4276,12520,6425,1954,6593,13018,6599,13024
,WoLiTunXiang,231281204,17369,1326,10458,7673,20093,10458,2826,11060,21518,11063,21521
,QingKenPaoXiang,231281205,14069,1264,8737,5854,16836,8737,2412,9006,17743,9008,17745
Դ,XianYuanXiang,231281209,11642,772,6899,4401,13690,6898,1956,7469,14367,7471,14370
,AnDaXuMuChang,231281500,1089,128,637,532,956,635,109,677,1312,689,1326
ԭֳ,YuanZhongChang,231281581,119,13,71,50,127,71,19,80,151,80,151
ˮ,HongQiPaoShuiKuGuanLiSuo,231281583,26,0,13,11,29,13,3,16,29,16,29
ˮվ,DongHuShuiKuGuanLiZhan,231281584,36,5,23,17,43,23,2,20,43,20,43
´,ChaoYangQuBanShiChu,231282001,77195,9439,47480,27900,92006,45529,10827,48517,94046,49981,97461
´,DongShengQuBanShiChu,231282002,34029,3677,20155,12114,34141,19489,4343,20835,40324,21894,42049
԰´,XiYuanQuBanShiChu,231282003,68886,5305,40985,27167,70940,39442,10103,40789,80231,43309,84294
´,ZhengYangQuBanShiChu,231282004,37822,3489,23205,15868,42220,23064,6172,24217,47281,24278,47483
ض,ZhaoDongZhen,231282100,28705,2377,17078,10687,34305,17078,4188,18192,35270,18192,35270
,ChangWuZhen,231282101,28624,2463,17730,12018,34318,17724,5034,18378,36102,18391,36121
վ,SongZhanZhen,231282102,27451,2565,16801,10851,33318,16801,4531,17746,34547,17746,34547
վ,WuZhanZhen,231282103,45536,3762,28818,16429,56655,28801,8444,28881,57682,28924,57742
м,ShangJiaZhen,231282104,30500,2595,18388,10666,36905,18383,4611,19274,37657,19318,37706
,JiangJiaZhen,231282105,19085,1624,11684,6848,23393,11684,2965,11990,23674,11990,23674
ľ,LiMuDianZhen,231282106,19818,1628,12355,6451,24522,12349,3399,12487,24836,12490,24845
վ,SiZhanZhen,231282107,22165,1550,13542,7618,27574,13533,4019,14180,27713,14192,27734
,LaoZhouZhen,231282108,30289,2496,18750,10499,37140,18750,5219,19254,38004,19254,38004
,WuLiMingZhen,231282109,25190,2153,15705,8153,31493,15705,4536,16174,31879,16174,31879
,LiMingZhen,231282110,30722,2546,19072,10414,37592,19065,5357,19528,38593,19553,38625
̫ƽ,TaiPingXiang,231282201,16909,1367,10485,6229,20752,10474,3092,10861,21335,10883,21368
,HaiChengXiang,231282203,20387,1579,12506,7477,24364,12506,3370,12829,25335,12830,25336
,XiangYangXiang,231282204,17171,1496,10581,6904,21279,10581,3064,11150,21731,11150,21731
,HongHeXiang,231282205,21833,1806,13444,7130,27014,13443,3766,13930,27373,13961,27405
Ծ,YueJinXiang,231282206,17286,1446,10959,5489,21662,10953,3312,11054,22007,11085,22044
,XiBaLiXiang,231282211,18041,1461,11499,6771,22617,11499,3706,11704,23203,11709,23208
²,DeChangXiang,231282212,23692,1946,14728,8114,29683,14723,4324,15214,29937,15234,29962
,XuanHuaXiang,231282213,17590,1539,10876,6673,21566,10876,2968,11221,22097,11221,22097
,AnMinXiang,231282214,21554,1703,13164,7295,26711,13161,3651,13733,26894,13744,26908
,MingJiuXiang,231282215,18623,1535,11464,6115,22025,11464,3195,11889,23353,11889,23353
ķɽũ,SiFangShanNongChang,231282500,1492,232,951,717,994,942,215,981,1923,988,1939
ֳ,LaoZhouYuZhongChang,231282501,219,30,141,115,223,141,33,141,282,141,282
,HaiLunZhen,231283100,108632,11536,66539,53947,115608,64937,15488,66927,131864,69117,135656
,HaiBeiZhen,231283101,43158,3627,26850,16592,52987,26711,7708,27564,54275,27643,54493
׺,LunHeZhen,231283102,25358,2189,15910,10079,31130,15906,4801,16425,32331,16438,32348
,GongHeZhen,231283103,26306,2318,16251,9660,32315,16247,4293,16665,32912,16666,32917
,HaiXingZhen,231283104,21183,1985,13228,7325,26121,13224,3608,13541,26765,13548,26776
鸻,XiangFuZhen,231283105,20184,1754,12531,7264,24877,12531,3462,12869,25400,12869,25400
,DongFengZhen,231283106,22721,1945,14120,8231,27998,14002,3904,14351,28353,14450,28570
ǰ,QianJinXiang,231283202,29064,2518,17808,9977,35211,17802,4539,18292,36094,18313,36121
,XiangRongXiang,231283203,19052,1519,12047,6994,23836,12045,3706,12225,24270,12230,24277
,ChangFaXiang,231283204,15202,1135,9253,5327,18277,9253,2356,9440,18693,9440,18693
,DongLinXiang,231283205,26790,2498,16276,9809,33188,16274,4199,17210,33484,17211,33487
,HaiNanXiang,231283208,15259,1280,9381,5156,18941,9381,2724,9878,19259,9882,19263
,GongRongXiang,231283209,23521,2013,14395,7836,28712,14395,3629,14768,29163,14768,29163
ҵ,LeYeXiang,231283210,14644,1293,8994,5133,18172,8994,2479,9422,18416,9422,18416
,FuMinXiang,231283211,16405,1431,9904,5594,20280,9904,2598,10530,20434,10530,20434
ɽ,FengShanXiang,231283212,19879,1601,12200,6470,24382,12200,3237,12517,24717,12517,24717
,YongFuXiang,231283213,30859,2582,19602,10172,38356,19602,5547,19382,38984,19386,38988
,BaiXiangXiang,231283215,13369,1168,8188,4919,16282,8188,2162,8511,16699,8511,16699
,LianFaXiang,231283216,18527,1748,11699,6268,23225,11699,3133,11709,23408,11709,23408
,YongHeXiang,231283217,24566,1838,15420,8232,30562,15420,4711,15695,31115,15695,31115
,AiMinXiang,231283218,20121,1578,12554,6960,25141,12554,3775,12920,25474,12920,25474
,ZhaYinHeXiang,231283220,20475,1766,13018,6947,25618,13018,3760,12983,26001,12983,26001
˫¼,ShuangLuXiang,231283221,17872,1463,10978,6394,21688,10974,2986,11331,22305,11343,22321
ֳ˾,LinChangGongSi,231283400,2562,301,1575,1228,2876,1573,323,1610,3183,1611,3186
ˮ,DongFangHongShuiKuDiQu,231283401,1434,121,840,527,1646,840,185,900,1740,900,1740
ũ,HaiLunNongChang,231283500,7849,899,4959,4133,9502,4959,1067,4845,9804,4856,9815
ũ,HongGuangNongChang,231283501,7977,891,5064,4160,9522,5062,1091,4890,9952,4895,9959
ɽֵ,DongShanJieDao,232701010,18320,2594,11763,8325,16561,10464,2359,10223,20687,11510,23273
ֵ,WeiDongJieDao,232701020,17541,2686,11666,9385,20124,11508,2639,10923,22431,11200,22866
ֵ,HongQiJieDao,232701030,21317,2263,12745,9827,22960,12704,3169,12024,24728,14004,26749
ֵ,ChangHongJieDao,232701040,19374,2243,12003,9014,15473,11412,2626,11776,23188,12240,24243
ֵ,ShuGuangJieDao,232701050,13933,1881,8778,6977,13724,8713,1910,8809,17522,8946,17724
ֵ,GuangMingJieDao,232701060,19510,2124,12305,8777,17060,10729,2240,10963,21692,11569,23874
ӱ,JiaBeiXiang,232701070,5243,438,3076,2312,4124,3076,756,3361,6437,3361,6437
,BaiHuaXiang,232701080,6109,446,3687,3091,6908,3677,1109,3904,7581,3977,7664
Ӹҵ,JiaGeDaQiLinYeJu,232701090,1370,72,652,712,376,652,87,873,1525,877,1529
С,XiaoYangQiZhen,232702010,16599,1707,8389,6485,14715,8381,1884,8581,16962,11801,20190
,JinSongZhen,232702020,6640,618,3380,2450,6317,3370,768,3514,6884,4646,8026
Դ,GuYuanZhen,232702030,4178,684,2499,1940,4598,2490,477,2558,5048,2840,5339
,XinLinZhen,232703010,18696,2822,11644,9197,21890,11524,2015,11715,23239,11889,23533
,CuiGangZhen,232703020,5851,728,3625,2903,6806,3625,739,3690,7315,3693,7318
Դ,TaYuanZhen,232703030,4145,526,2456,1965,4724,2443,501,2553,4996,2716,5172
,DaWuSuZhen,232703040,4176,717,2561,2082,5129,2561,405,2731,5292,2737,5298
,TaErGenZhen,232703050,1887,259,1133,960,2197,1129,223,1201,2330,1236,2369
,BiZhouZhen,232703060,3195,482,1972,1676,3886,1968,356,2052,4020,2061,4033
ͼ,HongTuZhen,232703070,2581,255,1506,1299,3007,1506,300,1630,3136,1630,3136
,HuZhongZhen,232704010,21508,2498,12496,10721,24131,12467,2286,12906,25373,13796,26292
ˮ,BiShuiZhen,232704020,7869,979,4641,4277,9255,4641,804,4998,9639,5011,9652
Դ,HuYuanZhen,232704030,6515,689,3870,3365,7541,3870,669,4000,7870,4003,7873
ΰ,HongWeiZhen,232704040,1002,115,596,477,1184,596,105,626,1222,626,1222
,HuMaZhen,232721100,18099,2012,11438,8781,19413,11403,2934,11319,22722,11607,23045
԰,HanJiaYuanZhen,232721101,4143,379,2386,1973,2719,2386,585,2703,5089,2721,5107
,SanKaXiang,232721200,4487,361,2664,2079,4533,2664,763,2947,5611,2947,5611
ɽ,JinShanXiang,232721201,1930,180,1145,1040,2159,1145,309,1274,2419,1274,2419
˻,XingHuaXiang,232721202,1536,127,914,783,1714,914,244,993,1907,993,1907
Ÿ,OuPuXiang,232721203,1177,102,733,583,1390,733,213,758,1491,759,1492
ɶ״,BaiYinNaELunChunZuMinZuXiang,232721204,1700,104,1010,834,1599,1006,290,1082,2088,1084,2094
,BeiJiangXiang,232721205,2526,228,1409,1285,2391,1409,278,1623,3032,1623,3032
԰ҵ,HanJiaYuanLinYeJu,232721400,6061,215,3314,2837,5091,3269,878,3723,6992,3840,7154
,TaHeZhen,232722100,40778,5905,25423,18762,46139,25082,4952,25654,50736,26212,51635
,WaLaGanZhen,232722101,3816,465,2223,1900,4372,2223,414,2454,4677,2472,4695
̹,PanGuZhen,232722102,5287,432,2998,2403,5344,2993,538,3250,6243,3259,6257
ʮվ״,ShiBaZhanELunChunZuMinZuXiang,232722200,4209,327,2487,2220,3853,2478,576,2606,5084,2625,5112
,YiXiKenXiang,232722201,1405,103,841,631,1611,839,203,856,1695,870,1711
⿵,KaiKuKangXiang,232722202,1590,118,880,690,1684,880,136,950,1830,964,1844
ʮվҵ,ShiBaZhanLinYeJu,232722400,17067,1979,9945,8304,17101,9945,2173,11274,21219,11274,21219
ּ,XiLinJiZhen,232723100,32239,2291,18951,13524,32606,18517,4780,19638,38155,20359,39310
ͼǿ,TuQiangZhen,232723101,16406,1786,9682,8769,19198,9682,1864,10374,20056,10374,20056
,JinTaoZhen,232723102,8893,849,5148,3937,10009,5087,1069,5370,10457,5663,10811
˰,XingAnZhen,232723103,854,77,497,416,910,491,132,546,1037,566,1063
,BeiJiXiang,232723200,1742,177,1087,806,1879,1068,280,1088,2156,1112,2199
ּҵ,XiLinJiLinYeJu,232723400,1387,76,780,651,1236,780,171,852,1632,854,1634
ͼǿҵ,TuQiangLinYeJu,232723401,727,62,400,381,735,400,51,440,840,440,840
ľҵ,AMuErLinYeJu,232723402,6288,602,3394,2254,6139,3393,611,4066,7459,4107,7501
Ͼ·ֵ,NanJingDongLuJieDao,310101002,52582,9726,33591,24614,37809,30848,3977,29583,60431,32694,66285
ֵ̲,WaiTanJieDao,310101013,52768,8699,31733,23145,36513,28360,3429,27284,55644,33163,64896
԰·ֵ,BanSongYuanLuJieDao,310101015,70085,12505,46203,31490,46656,43760,7186,40822,84582,43573,89776
СŽֵ,XiaoDongMenJieDao,310101017,60566,8744,37319,26723,39594,35592,5684,34944,70536,37675,74994
ԥ԰ֵ,YuYuanJieDao,310101018,49434,7142,30726,23254,31532,29491,4466,29009,58500,30316,61042
Žֵ,LaoXiMenJieDao,310101019,58162,9196,36904,26431,37844,35172,5540,33800,68972,35994,72898
Žֵ,WuLiQiaoJieDao,310103001,63936,12895,41935,28507,45902,39188,5572,36834,76022,40468,82403
Žֵ,DaPuQiaoJieDao,310103002,45758,8783,30799,21643,29994,29232,4544,26581,55813,28286,59085
·ֵ,HuaiHaiZhongLuJieDao,310103008,45829,8683,29485,21793,33555,27452,3419,26621,54073,28446,57931
·ֵ,RuiJinErLuJieDao,310103009,36809,10147,25798,19135,31363,23884,2404,21590,45474,23562,49360
ƽ·ֵ,TianPingLuJieDao,310104003,44030,11690,31483,23324,38841,29981,4813,26933,56914,29050,60533
·ֵ,HuNanLuJieDao,310104004,26559,7715,18941,14616,22833,18237,2007,16031,34268,17340,36281
б·ֵ,XieTuLuJieDao,310104007,53359,11508,35325,25033,38150,33664,4843,31029,64693,34385,69710
·ֵ,FengLinLuJieDao,310104008,86458,19317,57408,38804,62961,50163,6625,46410,96573,54992,112400
Žֵ,ChangQiaoJieDao,310104010,94055,15446,59100,43563,65919,56445,9371,55055,111500,59772,118872
ֵֽ,TianLinJieDao,310104011,73880,15826,49546,34063,48918,44371,7465,41145,85516,47625,97171
÷·ֵ,HongMeiLuJieDao,310104012,29498,3001,17037,13235,11629,15114,2378,15135,30249,17840,34877
´ֵ,KangJianXinCunJieDao,310104013,78738,14151,51321,35044,55279,44610,7555,42389,86999,49123,100444
һֵ,XuJiaHuiJieDao,310104014,71591,13753,47951,32793,51521,42975,7571,38987,81962,44964,92915
·ֵ,LingYunLuJieDao,310104015,87793,13473,53648,35069,66670,45605,7316,44094,89699,54934,108582
ֵ,LongHuaJieDao,310104016,69798,10028,42142,29894,40033,39426,5943,38664,78090,43627,85769
ֵ,CaoHeJingJieDao,310104017,78270,11967,49212,33527,47702,44606,7680,42367,86973,48705,97917
,HuaJingZhen,310104103,55979,5782,31362,24052,25662,29731,5654,30991,60722,36053,67415
˼�,CaoHeJingXinXingJiShuKaiFaQu,310104501,2155,72,903,0,68,0,17,0,0,1341,2244
·ֵ,HuaYangLuJieDao,310105001,57607,10648,37345,25425,40781,32590,4475,29939,62529,35385,72730
·ֵ,JiangSuLuJieDao,310105002,39370,9211,27329,19908,29281,25579,3302,22623,48202,24554,51883
»·ֵ,XinHuaLuJieDao,310105004,57492,10958,37943,25432,34946,32473,4780,29024,61497,35287,73230
ܼŽֵ,ZhouJiaQiaoJieDao,310105005,43747,7747,29579,20307,27874,27895,5134,24935,52830,27049,56628
ɽ·ֵ,TianShanLuJieDao,310105006,58925,10949,39144,25458,43063,31592,3883,29129,60721,34613,73757
ϼ´ֵ,XianXiaXinCunJieDao,310105008,65636,13735,45972,31786,44897,40286,5293,34834,75120,38692,84664
Žֵ,HongQiaoJieDao,310105009,46670,8633,31256,22197,29031,28217,4248,24899,53116,28295,59551
̼Žֵ,ChengJiaQiaoJieDao,310105010,19505,3009,12240,8365,10783,10861,1973,9829,20690,12247,24487
ֵ,BeiXinJingJieDao,310105011,37319,6464,23861,16706,26997,22242,3082,20974,43216,23004,46865
,XinJingZhen,310105102,118831,16200,71332,47388,79551,64941,11745,61628,126569,75444,146776
·ֵ,JiangNingLuJieDao,310106006,59169,10841,38832,27693,39856,35533,5262,32560,68093,36440,75272
ʯŶ·ֵ,ShiMenErLuJieDao,310106011,26662,5491,17391,12609,19133,16284,2135,14924,31208,16897,34288
Ͼ·ֵ,NanJingXiLuJieDao,310106012,27620,7008,18757,13613,20892,17099,1916,14998,32097,17787,36544
½ֵ,JingAnSiJieDao,310106013,21783,5837,15714,10903,18028,14046,1553,12206,26252,13459,29173
ܼҶɽֵ,CaoJiaDuJieDao,310106014,54306,11248,37277,26432,41909,35768,5957,32194,67962,34234,71511
´ֵ,CaoYangXinCunJieDao,310107005,75759,16237,50401,37272,58573,47444,6271,44521,91965,47866,98267
´ֵ,ChangFengXinCunJieDao,310107014,96807,15632,61022,40511,61472,52249,8481,50268,102517,59898,120920
·ֵ,ChangShouLuJieDao,310107015,103783,15404,65690,47365,55655,60251,9460,56668,116919,62957,128647
Ȫ·ֵ,GanQuanLuJieDao,310107016,87518,18806,57425,43867,71569,56017,6174,53434,109451,55073,112498
ʯȪ·ֵ,ShiQuanLuJieDao,310107017,96098,17081,59803,43081,67714,55054,7038,53555,108609,60414,120217
˴·ֵ,YiChuanLuJieDao,310107020,87785,15463,55950,40988,58567,52094,7937,50374,102468,55235,111185
,ZhenRuZhen,310107101,138733,21671,85502,63588,94791,82452,11993,81620,164072,86895,172397
,ChangZhengZhen,310107102,190527,19505,112325,82217,87780,106056,19893,107083,213139,117600,229925
,TaoPuZhen,310107103,163454,16444,89989,64652,75964,80293,14927,85464,165757,104836,194825
Ŀ·ֵ,TianMuXiLuJieDao,310108001,28472,4038,16886,11760,16591,15326,2239,14838,30164,17863,34749
վֵ,BeiZhanJieDao,310108006,63675,9076,38419,28149,38626,34699,5217,34896,69595,39549,77968
ɽ·ֵ,BaoShanLuJieDao,310108007,64784,10537,39672,29519,42844,37559,5405,37250,74809,41054,80726
·ֵ,GongHeXinLuJieDao,310108012,78117,12706,48933,35271,49854,46630,6807,45163,91793,48697,97630
·ֵ,DaNingLuJieDao,310108013,63013,8603,37390,25133,37490,32658,6094,31294,63952,40320,77710
´ֵ,PengPuXinCunJieDao,310108014,122126,23934,79206,59537,99547,76764,10216,74726,151490,77070,156276
ٷ·ֵ,LinFenLuJieDao,310108015,61262,11660,39035,28443,44979,37413,5157,36016,73429,39044,78079
ƽ·ֵ,ZhiJiangXiLuJieDao,310108016,60005,9499,37018,27306,38979,35095,5129,34699,69794,37615,74633
,PengPuZhen,310108101,124974,15467,74728,50701,73185,69337,12284,67999,137336,77997,152725
ŷ·ֵ,OuYangLuJieDao,310109009,55497,13105,37655,28599,42559,36636,4726,34370,71006,35673,73328
·ֵ,QuYangLuJieDao,310109010,77964,17869,53470,37553,58216,47468,6731,44001,91469,49094,102564
·ֵ,GuangZhongLuJieDao,310109011,97413,17004,62016,46367,63498,58768,8252,56525,115293,60653,122669
·ֵ,JiaXingLuJieDao,310109014,100581,14970,62884,45228,64582,60438,10083,58608,119046,62750,125634
´ֵ,LiangChengXinCunJieDao,310109016,77417,13501,50281,36573,54484,48881,7176,45702,94583,47813,98094
Ĵ·ֵ,SiChuanBeiLuJieDao,310109017,68979,13044,43739,35018,49601,41795,5378,39801,81596,43662,87401
Žֵ,TiLanQiaoJieDao,310109018,91733,15305,54946,48769,62830,54191,6713,54282,108473,58805,113751
ֵ,JiangWanZhenJieDao,310109019,103282,16158,64971,46937,65793,61616,9595,59814,121430,64064,129035
·ֵ,DingHaiLuJieDao,310110001,82583,11598,46735,32322,50097,41968,6299,42248,84216,53745,100480
ƽ·ֵ,PingLiangLuJieDao,310110006,69092,11507,41486,32237,50399,39956,5271,40275,80231,44384,85870
·ֵ,JiangPuLuJieDao,310110008,75506,13221,47695,34790,48599,45884,6655,43711,89595,47687,95382
ƽ·ֵ,SiPingLuJieDao,310110009,73085,14346,45017,30271,60228,37886,5074,35874,73760,47488,92505
ؽ·ֵ,KongJiangLuJieDao,310110012,82567,15888,53871,40563,59590,51642,7158,49656,101298,51742,105613
´ֵ,ChangBaiXinCunJieDao,310110013,55722,10550,34454,23398,43401,30455,3923,29317,59772,35741,70195
Ӽ´ֵ,YanJiXinCunJieDao,310110015,68558,17131,46045,35142,56059,43530,4645,41717,85247,44289,90334
нֵ,YinXingJieDao,310110016,152631,28749,96044,69643,121469,90501,11174,88078,178579,96510,192554
Žֵ,DaQiaoJieDao,310110018,100928,16174,61811,44497,70099,58061,7852,57193,115254,63143,124954
ǳֵ,WuJiaoChangJieDao,310110019,122668,16531,75208,46341,83106,59853,9891,57500,117353,73882,149090
½ǽֵ,XinJiangWanChengJieDao,310110020,23420,1274,11687,7017,7534,9906,2557,9563,19469,15564,27251
ǳ,WuJiaoChangZhen,310110101,145778,18568,88395,61546,86847,81538,14648,79213,160751,90599,178994
·ֵ,JiangChuanLuJieDao,310112001,149097,21312,86528,61121,109380,77648,15582,77394,155042,99463,185991
ֵ,GuMeiJieDao,310112006,117798,14499,74191,50050,47364,69952,16844,68006,137958,74950,149141
ºֵ,XinHongJieDao,310112008,55470,5193,30707,24545,23990,27843,4593,29610,57453,34549,65256
ݷׯ,ShenZhuangZhen,310112101,219995,25533,138782,102347,108640,134001,32406,131462,265463,139152,277934
߱,QiBaoZhen,310112102,231961,24295,139176,105357,101900,130293,27096,130420,260713,144176,283352
,ZhuanQiaoZhen,310112103,159675,11445,90022,64816,48919,79648,18484,82564,162212,99582,189604
,HuaCaoZhen,310112106,167300,8715,90178,81076,38108,85195,17762,95102,180297,103599,193777
,HongQiaoZhen,310112107,136278,16331,85046,60210,55916,76055,13268,70791,146846,80831,165877
÷¤,MeiLongZhen,310112108,288684,24064,165165,133159,92784,154520,31686,160285,314805,179269,344434
,WuJingZhen,310112110,101598,9316,56346,39476,48087,47108,10250,50069,97177,64818,121164
,MaQiaoZhen,310112112,88367,5522,48041,39803,26220,45444,10100,49026,94470,55948,103989
ֽ,PuJiangZhen,310112114,247316,19784,140311,99652,93163,120051,25650,124199,244250,152439,292750
ݷׯҵ,ShenZhuangGongYeQu,310112501,47924,3165,25239,13631,15758,18782,5014,18671,37453,30864,56103
·ֵ,YouYiLuJieDao,310113003,107240,15199,68024,49290,80843,65305,14375,63746,129051,68790,136814
ֵ,WuSongJieDao,310113007,82463,13276,51434,38722,61951,49130,8423,48432,97562,52728,104162
ֵ,ZhangMiaoJieDao,310113008,135346,23810,85615,64558,107080,83684,13128,84248,167932,86669,172284
޵,LuoDianZhen,310113101,98583,9759,53510,41055,46392,49696,9981,52964,102660,64813,118323
,DaChangZhen,310113102,310721,28587,175908,128479,123417,161930,32548,170100,332030,195948,371856
,YangXingZhen,310113103,175116,8106,86081,66251,51482,79924,21342,89612,169536,118483,204564
,YuePuZhen,310113104,113865,10913,63602,50150,59068,61759,14550,65152,126911,75726,139328
,LuoJingZhen,310113106,45467,4618,24452,17732,20818,21101,4244,22598,43699,29877,54329
˴,GuCunZhen,310113109,203104,15628,107871,87921,70363,103410,21453,114657,218067,132314,240185
߾,GaoJingZhen,310113111,104769,12703,62307,45732,55833,59525,10040,59988,119513,65205,127512
,MiaoXingZhen,310113112,76410,5551,41525,32247,26288,38789,7654,40729,79518,48090,89615
,SongNanZhen,310113113,103611,13365,60492,45605,61285,58772,10371,60849,119621,66855,127347
ɽйҵ԰,BaoShanChengShiGongYeYuanQu,310113501,17123,316,7783,6255,1509,6139,1128,7047,13186,10784,18567
³·ֵ,XinChengLuJieDao,310114001,44885,4099,27518,19002,22923,26360,6239,25761,52121,27705,55223
½ֵ,ZhenXinJieDao,310114002,85935,12019,52425,37004,40778,49549,8210,49795,99344,53739,106164
԰ί,JuYuanXinQuGuanWeiHui,310114003,51049,3547,28800,21630,18213,26335,6328,27447,53782,32124,60924
ζֵ,JiaDingZhenJieDao,310114004,63339,10910,42578,30226,46134,38641,7605,35976,74617,39276,81854
,NanXiangZhen,310114102,119769,9001,63436,49802,44121,56599,11075,60021,116620,76409,139845
ͤ,AnTingZhen,310114103,199805,13948,101546,80710,77841,90437,18750,100602,191039,130957,232503
½,MaLuZhen,310114106,150524,9360,79384,65528,41103,69862,12980,75530,145392,93480,172864
,XuXingZhen,310114109,139047,12352,76237,67070,44967,69430,14053,77472,146902,89215,165452
ͤ,HuaTingZhen,310114111,36896,5716,21499,19114,17778,20404,3743,22497,42901,24856,46355
,WaiGangZhen,310114114,68338,5955,36919,32635,25401,34490,6603,38510,73000,43977,80896
,JiangQiaoZhen,310114118,220588,14210,116540,96114,54825,108638,21420,118940,227578,139678,256218
ζҵ,JiaDingGongYeQu,310114501,60486,5077,34841,23971,31151,32523,7370,32963,65486,38092,72933
Ϋ´ֵ,WeiFangXinCunJieDao,310115004,80478,13673,50566,36266,57249,45909,6397,43352,89261,49982,100548
½ֵ,LuJiaZuiJieDao,310115005,91081,13918,55194,37121,58643,48083,7508,44991,93074,57313,112507
ܼҶɽֵ,ZhouJiaDuJieDao,310115007,112428,22143,73905,53328,85453,71195,10097,67403,138598,70763,144668
Žֵ,TangQiaoJieDao,310115008,60681,9526,39139,28015,39625,37125,6709,35126,72251,37777,76916
ϸ´ֵ,ShangGangXinCunJieDao,310115009,80955,17861,53620,38839,67597,51694,6116,48821,100515,51312,104932
ͷ·ֵ,NanMaTouLuJieDao,310115010,84288,14824,54802,39439,59371,52634,8018,49610,102244,52328,107130
´ֵ,HuDongXinCunJieDao,310115011,89233,13346,55568,39716,58622,53741,9452,52809,106550,56463,112031
´ֵ,JinYangXinCunJieDao,310115012,163416,24210,103907,72159,108856,97703,18391,93977,191680,102110,206017
ֵ,YangJingJieDao,310115013,115746,15703,73982,51144,73745,68856,14788,65665,134521,72255,146237
·ֵ,PuXingLuJieDao,310115014,141090,18090,88896,61142,85537,85387,18288,83300,168687,88572,177468
·ֵ,DongMingLuJieDao,310115015,96805,15016,61070,44596,50496,59824,9628,58300,118124,60379,121449
ľֵ,HuaMuJieDao,310115016,179186,18541,105240,73777,93749,99390,23600,94731,194121,116087,221327
۽ֵ,ShenGangJieDao,310115017,19759,116,7215,1076,9948,1167,344,1274,2441,13004,20219
ɳ,ChuanShaXinZhen,310115103,298051,29504,179580,137077,158660,169964,41477,173688,343652,189452,369032
,GaoQiaoZhen,310115104,148242,14606,87237,66918,76254,83722,21638,87135,170857,97249,184486
,BeiCaiZhen,310115105,228885,23906,133377,100386,105035,125265,23756,127473,252738,143170,276547
,HeQingZhen,310115110,108646,9291,63134,46867,44152,55760,14101,59317,115077,68904,132038
,TangZhen,310115114,109734,6283,59272,47054,29148,52527,13250,57575,110102,69995,129267
·,CaoLuZhen,310115117,157024,10469,85728,68419,56708,75645,18519,83532,159177,100284,186012
,JinQiaoZhen,310115120,70027,3699,36742,30769,16224,33765,7811,36535,70300,44795,81537
,GaoXingZhen,310115121,113304,8990,64521,50054,37463,60526,15331,63740,124266,73104,137625
߶,GaoDongZhen,310115123,94124,5743,49353,39901,28192,44568,10685,48932,93500,61199,110552
Ž,ZhangJiangZhen,310115125,139060,10102,77065,68243,53642,71666,16135,78211,149877,88232,165297
,SanLinZhen,310115130,301116,24792,167968,135483,97533,160580,34608,168500,329080,192548,360516
,HuiNanZhen,310115131,173184,17480,104742,75135,103099,97198,23181,96703,193901,109103,213845
,ZhouPuZhen,310115132,119660,13178,71820,51908,63042,66825,14491,66920,133745,75509,147329
³,XinChangZhen,310115133,68077,8142,40164,32232,45629,38315,7964,39323,77638,44019,84183
,DaTuanZhen,310115134,54591,10019,35640,26349,57200,34852,6552,34473,69325,35522,71162
«,LuChaoGangZhen,310115135,22623,2034,11575,9669,12537,11048,2505,11801,22849,15587,27162
,KangQiaoZhen,310115136,148164,10752,84013,55674,51139,70667,15756,73492,144159,90659,174672
ͷ,HangTouZhen,310115137,89394,9303,52540,39000,50220,49051,11363,51193,100244,57520,110060
,LiuZaoZhen,310115138,40650,5070,24676,20021,28687,23942,5293,24651,48593,26337,51013
ף,ZhuQiaoZhen,310115139,82301,11443,51574,39604,66012,49634,11201,50458,100092,53371,104945
,NiChengZhen,310115140,49447,7692,30321,23549,47897,28207,5380,28162,56369,32198,62519
,XuanQiaoZhen,310115141,47483,6127,29153,21744,36792,27553,5957,27504,55057,30414,59567
Ժ,ShuYuanZhen,310115142,45634,8095,29382,23838,39231,28047,5594,28071,56118,29941,59323
,WanXiangZhen,310115143,18731,3372,11906,9594,19934,11699,2243,11471,23170,12440,24346
ϸ,LaoGangZhen,310115144,29302,4656,18176,14482,26517,17738,3450,17954,35692,19232,37408
«ũ,LuChaoGangNongChang,310115401,674,4,95,61,0,64,10,76,140,593,688
ũ,DongHaiNongChang,310115402,471,7,141,139,3,120,30,161,281,367,508
ũ,ZhaoYangNongChang,310115403,779,27,333,331,53,297,56,381,678,529,862
ű˰,WaiGaoQiaoBaoShuiQu,310115501,1314,12,141,59,0,43,23,28,71,1208,1349
ųڼӹ,JinQiaoChuKouJiaGongQu,310115502,5226,19,1900,984,31,909,269,1042,1951,3614,5514
Ž߿Ƽ԰,ZhangJiangGaoKeJiYuanQu,310115503,22867,226,12904,3089,2699,2677,524,2431,5108,10713,23617
ʯֵ,ShiHuaJieDao,310116001,71087,7501,43744,35318,46169,42561,9313,42154,84715,44157,87901
,ZhuJingZhen,310116101,94292,13819,59818,41512,83866,57538,11973,56467,114005,60266,120084
,FengJingZhen,310116102,65214,10621,40194,26742,56623,37256,6642,37353,74609,42283,82477
,ZhangYanZhen,310116103,29076,4838,18740,11795,26068,17500,3143,17300,34800,18317,37057
ͤ,TingLinZhen,310116104,98162,13494,59603,40708,77799,56063,10616,56777,112840,62669,122272
,LvXiangZhen,310116105,41435,7050,26182,16890,37849,24932,4323,25018,49950,26626,52808
,LangXiaZhen,310116107,26307,4789,17068,10263,26584,16049,2562,15710,31759,16590,33658
ɽ,JinShanWeiZhen,310116109,56795,6948,34496,21253,41557,31631,7076,31669,63300,36323,70819
,CaoJingZhen,310116112,32190,4918,19498,12281,27181,18223,3614,18233,36456,21224,40722
ɽ,ShanYangZhen,310116113,68722,5913,40404,28255,37316,38900,10005,39533,78433,44236,84640
ֵ,YueYangJieDao,310117001,88513,11811,57460,38348,56848,54169,12347,51183,105352,55211,112671
ֵ,YongFengJieDao,310117002,76557,6559,44690,32432,29836,42832,10214,44608,87440,48640,93330
ɽֵ,FangSongJieDao,310117003,138523,5918,82459,38662,66732,58099,16997,55988,114087,78979,161438
ɽֵ,ZhongShanJieDao,310117004,82608,6511,47633,29686,30087,39819,9769,39447,79266,51255,98888
,SiJingZhen,310117102,80976,4334,42322,32721,19460,38024,8969,41588,79612,51957,94279
ɽ,SheShanZhen,310117103,62116,6653,35645,26651,29827,32487,6738,33973,66460,39862,75507
,CheDunZhen,310117104,150308,6068,79501,48264,24012,53910,11311,58087,111997,88186,167687
,XinQiaoZhen,310117105,133409,7260,70326,51246,24900,63031,15187,67091,130122,85530,155856
,DongJingZhen,310117106,48823,2596,26582,19560,11245,24221,6442,26663,50884,31279,57861
ͤ,JiuTingZhen,310117107,215680,9041,118775,91807,33766,109899,28389,117391,227290,134335,253110
,MaoGangZhen,310117109,32528,6415,20245,14269,26239,18277,2683,18613,36890,21381,41626
ʯ,ShiHuDangZhen,310117116,35400,5020,20584,17247,18022,19327,3591,20629,39956,23427,44011
,XinBangZhen,310117117,26489,4807,15438,12897,18537,14617,2331,15399,30016,18189,33627
Ҷ,YeXieZhen,310117120,64529,7897,38554,28385,38600,35677,7678,36664,72341,41550,80104
Сɽ,XiaoKunShanZhen,310117121,42537,4930,24571,17211,13757,20318,4139,21308,41626,27035,51606
ɽҵ,SongJiangGongYeQu,310117501,59689,277,31205,3641,641,3495,831,4087,7582,29592,60797
ֵ,XiaYangJieDao,310118001,112773,7698,68197,46172,44468,62755,16850,61613,124368,69124,137321
ӯֵֽ,YingPuJieDao,310118002,97221,8359,55892,37520,39789,51565,13128,49816,101381,62816,118708
㻨Žֵ,XiangHuaQiaoJieDao,310118003,93485,5002,48442,39789,19496,40739,8343,45891,86630,58388,106830
ҽ,ZhuJiaJiaoZhen,310118102,76171,10020,44510,34020,49088,41736,8160,42809,84545,49841,94351
,LianTangZhen,310118103,53671,8885,33598,27049,43712,31844,5929,31929,63773,34887,68485
,JinZeZhen,310118104,53339,9775,33524,26749,48094,30923,4621,31249,62172,34211,67735
,ZhaoXiangZhen,310118105,63685,3901,33016,27622,19297,31240,6823,34585,65825,41393,74409
,XuJingZhen,310118106,111029,5165,57916,46387,25602,52002,11742,56512,108514,70020,127936
,HuaXinZhen,310118107,131209,5998,68610,57315,31263,63037,15996,70828,133865,84593,153203
ع,ZhongGuZhen,310118109,32565,2913,18484,13748,13049,16864,4278,17714,34578,21272,39756
׺,BaiHeZhen,310118110,74612,8222,43789,34268,35403,41138,9454,43280,84418,48499,92288
,NanQiaoZhen,310120101,293825,21748,176809,133680,113691,168253,45612,171309,339562,184376,361185
,FengChengZhen,310120102,142508,15222,83408,71635,71777,79499,19208,85440,164939,93530,176938
ׯ,ZhuangXingZhen,310120104,48976,7448,30005,23928,29392,28063,5964,29347,57410,32383,62388
,JinHuiZhen,310120106,88548,9244,51680,40708,39488,46740,10472,48918,95658,56584,108264
,SiTuanZhen,310120109,50869,7916,32174,27614,37389,31464,6604,32012,63476,33215,65389
,QingCunZhen,310120111,71531,8669,42256,36747,34505,40373,8963,42814,83187,46907,89163
,ZheLinZhen,310120118,49056,7297,29835,24182,26499,28556,6236,30144,58700,32754,62589
,HaiWanZhen,310120123,22955,2769,12401,10452,6957,11408,2733,12538,23946,16056,28457
ϺҵۺϿ,ShangHaiGongYeZongHeKaiFaQu,310120501,48019,2318,27386,18072,12223,23743,7004,24443,48186,29955,57341
ٺ,LinHaiSheQu,310120502,12808,1222,6275,5298,5688,5950,1383,6637,12587,9138,15413
Ϻз,ShangHaiShiFengXianQuHaiWanLvYouQu,310120503,26902,888,13496,5256,3253,5307,1361,5806,11113,15655,29151
ִũҵ԰,FengXianQuXianDaiNongYeYuanQu,310120504,13924,1533,7297,6045,5182,6761,1253,7088,13849,9413,16710
ϺۺϾÿ,ShangHaiHaiGangZongHeJingJiKaiFaQu,310120505,8027,1481,5158,4347,5685,5009,967,4931,9940,5317,10475
,ChengQiaoZhen,310230101,87701,14636,55989,44244,76506,54061,11105,51461,105522,57453,113442
,BaoZhen,310230102,44034,11062,31535,25653,49609,30804,5015,27856,58660,28576,60111
º,XinHeZhen,310230103,30278,9240,22070,19003,34136,21676,3219,19607,41283,20667,42737
,MiaoZhen,310230104,30340,12176,24333,21196,39598,24052,3410,21123,45175,21593,45926
,ShuXinZhen,310230106,29580,8479,20282,17508,31481,19401,2764,17910,37311,20541,40823
,XiangHuaZhen,310230107,18838,5495,13749,12078,23394,13635,1932,12122,25757,12516,26265
,SanXingZhen,310230109,19302,8796,15966,14205,26694,15821,1796,13749,29570,13928,29894
,GangYanZhen,310230113,28457,9344,21540,19340,35792,21071,2940,18500,39571,19201,40741
,ZhongXingZhen,310230114,17809,5408,13174,11969,21842,13014,2057,11686,24700,12100,25274
¼,ChenJiaZhen,310230115,40413,8946,26759,20166,44516,25301,4637,23294,48595,27237,53996
̻,LvHuaZhen,310230116,5386,1111,3564,3106,5229,3544,564,3404,6948,3497,7061
,GangXiZhen,310230118,16381,5444,12207,10425,19875,11968,1591,10812,22780,11209,23416
,JianSheZhen,310230119,19449,6238,13983,12033,22364,13801,1779,12019,25820,13483,27466
º,XinHaiZhen,310230121,7658,2961,5588,5507,5141,5536,1027,5953,11489,6058,11646
ƽ,DongPingZhen,310230122,10664,2913,7386,6662,6249,7338,1535,7532,14870,7726,15112
,ChangXingZhen,310230123,84547,6119,35867,32962,31940,34198,8468,39660,73858,63267,99134
´,XinCunXiang,310230201,6853,1773,4856,4317,6974,4735,955,4484,9219,4725,9581
ɳ,HengShaXiang,310230203,20108,5740,14200,11702,24587,14026,2068,13108,27134,13716,27916
ǰũ,QianWeiNongChang,310230409,1406,39,673,552,56,608,250,741,1349,1022,1695
ƽֳ,DongPingLinChang,310230410,35,0,7,0,0,0,0,0,0,28,35
ʵִũҵ԰,ShangShiXianDaiNongYeYuanQu,310230501,1209,19,673,540,0,617,223,724,1341,778,1451
÷԰´ֵ,MeiYuanXinCunJieDao,320102002,94225,6952,48040,17860,84072,26226,6218,24372,50598,59355,107395
½ֿڽֵ,XinJieKouJieDao,320102003,76216,9679,45365,26617,70312,36949,8011,35209,72158,48541,93906
Žֵ,XuanWuMenJieDao,320102005,32806,5983,20055,13224,27681,17884,3204,16763,34647,21938,41993
Žֵ,HouZaiMenJieDao,320102006,47792,7902,31227,20019,43377,27687,6296,24926,52613,30763,61990
ֵ,SuoJinCunJieDao,320102007,65240,6600,37089,15290,44000,21003,4223,20272,41275,38974,76063
ɽֵ,HongShanJieDao,320102008,73371,5471,40914,31434,39877,36747,9375,39126,75873,47303,88217
Тֵ,XiaoLingWeiJieDao,320102009,95121,9221,53444,25758,76059,34876,8312,33595,68471,59210,112654
ֵ,XuanWuHuJieDao,320102010,57943,5021,33002,19915,34536,26505,6775,26215,52720,36737,69739
ϴֵ,WuLaoCunJieDao,320103001,59778,7797,36018,19773,43219,27740,5306,26027,53767,36863,72881
·ֵ,HongWuLuJieDao,320103004,89669,11707,54853,32824,77330,44031,8009,41569,85600,54532,109385
·ֵ,DaGuangLuJieDao,320103005,61930,9711,38868,25863,48786,35070,6834,33211,68281,39607,78475
·ֵ,RuiJinLuJieDao,320103006,58525,10374,35579,21784,56049,30622,6857,29181,59803,40177,75756
ֵ,YueYaHuJieDao,320103007,55493,7606,34990,23499,36945,32142,7447,31097,63239,35556,70546
⻪·ֵ,GuangHuaLuJieDao,320103008,70060,5618,40226,26787,29724,34952,8407,35610,70562,43859,84085
칬ֵ,ChaoTianGongJieDao,320103009,88603,13340,56015,38781,76596,49863,8890,47695,97558,54818,110833
غֵ,QinHongJieDao,320104001,65688,7768,39114,24199,41847,35131,7876,33886,69017,42218,81332
ֵ,FuZiMiaoJieDao,320104002,58789,8328,36799,23014,39818,31048,6191,29570,60618,36509,73308
컨ֵ,HongHuaJieDao,320104003,96091,6451,49305,32791,31097,39686,9712,42042,81728,62949,112254
˫ֵ,ShuangTangJieDao,320104004,84186,10260,49284,30330,52292,38816,7107,37126,75942,52269,101553
лŽֵ,ZhongHuaMenJieDao,320104005,30823,3659,18103,13387,18728,15625,3026,15818,31443,19405,37508
ֵ,BinHuJieDao,320105001,56923,6016,34757,25384,35442,31555,6352,30821,62376,34534,69291
ɳ޽ֵ,ShaZhouJieDao,320105002,47188,2814,24442,17333,20227,22343,6472,22523,44866,32032,56474
˫բֵ,ShuangZhaJieDao,320105003,16510,782,7653,6153,5164,7326,2268,8298,15624,11907,19560
޽ֵ,JiangXinZhouJieDao,320105004,16726,2038,10208,5398,13811,8958,2101,8451,17409,10657,20865
Ϻֵ,NanHuJieDao,320105005,66911,8970,41478,26303,43725,36233,7148,34880,71113,41551,83029
¡ֵ,XingLongJieDao,320105006,56904,2897,28973,23134,20828,27128,7473,29353,56481,38301,67274
Էֵ,NanYuanJieDao,320105007,90423,8022,54022,34838,53250,49236,12151,49121,98357,56574,110596
·ֵ,NingHaiLuJieDao,320106001,96784,12977,60240,29216,87669,41420,9745,38696,80116,59266,119506
·ֵ,HuaQiaoLuJieDao,320106002,96541,9343,59679,24792,83759,35736,8548,33235,68971,54753,114432
·ֵ,HuNanLuJieDao,320106003,103534,11423,59032,27101,74067,38120,7367,35978,74098,63292,122324
Žֵ,ZhongYangMenJieDao,320106004,121751,16362,73270,41093,94659,57315,11765,54615,111930,76608,149878
ڽŽֵ,YiJiangMenJieDao,320106005,75650,11372,48356,29482,58262,39940,7852,38109,78049,46518,94874
ֵ,JiangDongJieDao,320106006,87611,8403,52449,34835,64441,49186,13796,48270,97456,57361,109810
˽ֵ,FengHuangJieDao,320106007,91707,10381,58933,36676,71132,51678,13162,49409,101087,56317,115250
Ľ¥ֵ,YueJiangLouJieDao,320107001,67188,7891,35858,26778,44795,30676,4762,32073,62749,43983,79841
Ⱥ·ֵ,ReHeNanLuJieDao,320107002,63183,7746,35314,25693,41614,32685,6472,32396,65081,42087,77401
Ļɽֵ,MuFuShanJieDao,320107003,35927,3394,21285,16658,22145,20669,4659,21106,41775,22695,43980
·ֵ,JianNingLuJieDao,320107004,51524,6125,30529,18330,34150,22896,4071,22731,45627,31191,61720
Žֵ,BaoTaQiaoJieDao,320107005,78888,9351,46265,35077,58832,44447,9392,45329,89776,51366,97631
Снֵ,XiaoShiJieDao,320107006,68791,9249,39055,27300,44649,33602,6504,33346,66948,45489,84544
̩ɽֵ,TaiShanJieDao,320111001,135507,12239,77372,50235,99370,67426,17960,69060,136486,88334,165706
ɽֵ,DingShanJieDao,320111002,37549,5053,22097,14485,32224,20073,4480,20399,40472,24985,47082
ؽֵ,YanJiangJieDao,320111003,56417,2462,30826,20204,25211,25259,7450,26784,52043,35503,66329
ֵֽ,JiangPuJieDao,320111004,139837,10588,77879,40663,106340,59035,14466,58627,117662,87012,164891
ֵֽ,QiaoLinJieDao,320111005,33425,4917,21242,14030,39753,21147,4376,21205,42352,21476,42718
Ȫֵ,TangQuanJieDao,320111006,21393,2911,13457,8642,24915,13389,2646,13166,26555,13493,26950
̳ǽֵ,PanChengJieDao,320111007,61583,3024,33755,13945,39335,19854,5208,20327,40181,36060,69815
,YongNingZhen,320111102,35058,5134,22209,13864,40906,22169,4354,22215,44384,22337,44546
ǵ,XingDianZhen,320111104,25552,4134,16008,10542,29906,15745,3098,16147,31892,16776,32784
ʯ,ShiQiaoZhen,320111105,19701,2891,12343,7261,23821,12271,2630,12579,24850,12879,25222
ڽ,WuJiangZhen,320111106,19403,2701,10820,6752,18797,10564,2151,10775,21339,13435,24255
Ңֵ,YaoHuaJieDao,320113001,45980,4156,26699,19037,35668,24902,6077,25066,49968,29514,56213
Ⱥֵ,MaQunJieDao,320113002,51051,3971,27195,16446,21813,21228,4747,20951,42179,32574,59769
Žֵ,MaiGaoQiaoJieDao,320113003,100993,8530,57995,45637,46565,53813,11468,55951,109764,62996,120991
�ֵ,YanZiJiJieDao,320113004,83287,8306,51197,28568,54194,38140,8434,39204,77344,48830,100027
ϼֵ,QiXiaJieDao,320113005,40113,5598,23996,17241,35916,22525,4536,22589,45114,26251,50247
̶ֵ,LongTanJieDao,320113006,18403,3469,11804,8947,20919,11606,2108,11630,23236,12176,23980
ֵֽ,XianLinJieDao,320113007,113498,1102,57883,7101,53810,8951,2687,9043,17994,59404,117287
ֵ,JingAnJieDao,320113008,26201,4010,16717,10742,31607,16614,3173,15963,32577,16667,33384
޽ֵ,BaGuaZhouJieDao,320113009,27136,4310,16564,10574,26450,16181,2953,15826,32007,17835,34399
ڽֵ,XiGangJieDao,320113010,25568,2135,13823,7027,19726,9639,2095,9216,18855,15975,29798
ϼÿ,QiXiaJingJiKaiFaQu,320113401,3265,425,2028,1068,3578,1940,419,1782,3722,2081,4109
Ͼü�,NanJingJingJiJiShuKaiFaQu,320113450,14065,10,7700,0,605,0,16,0,0,6391,14091
Ͻֵ,NingNanJieDao,320114001,40002,2285,19957,11215,20369,16385,5032,16010,32395,27362,47319
Žֵ,SaiHongQiaoJieDao,320114002,57090,3762,29991,21372,27926,26591,6846,28291,54882,37707,67698
껨´ֵ,YuHuaXinCunJieDao,320114003,26724,5238,17677,13093,22393,17240,3542,16918,34158,17827,35504
Žֵ,XiShanQiaoJieDao,320114004,33295,2864,19058,14503,11747,18355,4546,19631,37986,21647,40705
Žֵ,BanQiaoJieDao,320114005,21820,2305,12492,8433,13041,11600,2818,11517,23117,14451,26943
Žֵ,TieXinQiaoJieDao,320114006,90162,6057,48820,28195,26222,36926,8579,37997,74923,55978,104798
÷ɽֵ,MeiShanJieDao,320114007,28145,3448,16763,14013,23549,16431,4238,17420,33851,19068,35831
껨ÿ,YuHuaJingJiKaiFaQu,320114400,14925,1122,7394,4651,8446,6449,1664,6699,13148,10317,17711
³,BanQiaoXinCheng,320114401,11907,1393,6547,4373,8551,6201,1484,6165,12366,8237,14784
ɽֵ,DongShanJieDao,320115001,143113,11721,90261,58930,121721,83800,25856,81705,165505,90429,180690
ֵ,MoLingJieDao,320115002,337363,16818,183346,90665,200678,119342,32371,120005,239347,203206,386552
ɽֵ,TangShanJieDao,320115003,55717,7650,33872,24587,59363,32768,6764,32204,64972,36259,70131
ֵ,ChunHuaJieDao,320115004,44110,7040,27872,17659,49286,27414,5677,27244,54658,28955,56827
»ڽֵ,LuKouJieDao,320115005,69423,8238,39405,23571,62246,31847,8009,31621,63468,46265,85670
ֵ,JiangNingJieDao,320115006,71752,10244,44821,26854,80669,43511,8834,43063,86574,46009,90830
ֵ,GuLiJieDao,320115007,48183,6375,29900,18995,51103,29169,6212,28914,58083,30870,60770
ֵ,HuShuJieDao,320115008,60932,9777,39016,24892,74463,38509,7538,38258,76767,39231,78247
Ϫֵ,HengXiJieDao,320115009,57595,8385,36007,24191,63522,34019,7485,34239,68258,37458,73465
ֵ,QiLinJieDao,320115010,52407,4082,30111,16583,37411,23900,5957,23632,47532,32335,62446
ж׵ֵ,XieJiaDianJieDao,320116001,45202,5667,27089,20699,37070,26468,6744,27078,53546,30524,57613
Žֵ,XiChangMenJieDao,320116002,28535,4087,17304,14398,18704,16553,3421,16846,33399,18739,36043
ɽ˽ֵ,ShanPanJieDao,320116003,48572,7836,31621,24715,47546,31014,6851,30512,61526,31638,63259
ֵ,GeTangJieDao,320116004,70777,5513,40353,25180,47335,36303,9976,36378,72681,45913,86266
«ֵ,ChangLuJieDao,320116005,13943,1458,7014,4221,11604,6530,1449,6629,13159,9836,16850
ݽֵ,XiongZhouJieDao,320116006,105334,12491,66457,41736,104593,63534,15972,62155,125689,67340,133797
ؽֵ,LongChiJieDao,320116007,47595,6049,29740,17811,52326,29219,6849,29259,58478,30753,60493
Žֵ,ChengQiaoJieDao,320116008,36849,4949,23418,11822,42669,22035,5105,22452,44487,23485,46903
ţֵ,JinNiuHuJieDao,320116009,51147,6776,32467,17646,62638,32283,7465,32706,64989,32921,65388
ֵ,HengLiangJieDao,320116010,29528,4210,18705,10799,35228,18526,3759,18393,36919,18792,37497
ұɽ,YeShanZhen,320116101,31712,4376,20122,11260,38403,20113,4378,20243,40356,20344,40466
,DongGouZhen,320116104,19600,3312,12595,7239,23883,12559,2351,12540,25099,12668,25263
,LongPaoZhen,320116105,23881,3552,14777,8494,28319,14721,2903,14716,29437,15559,30336
,YuDaiZhen,320116106,16620,3192,10838,8006,20806,10779,2349,10677,21456,11323,22161
ϲ,GuaBuZhen,320116107,23687,3556,14817,8507,26757,14421,2626,14140,28561,15052,29869
,ZhuZhenZhen,320116110,43701,6731,28495,17278,53935,28361,6206,27792,56153,28143,56638
�,MaJiZhen,320116111,28177,4193,18453,10830,35436,18402,4527,18292,36694,18444,36897
�,MaAnZhen,320116112,36605,4986,23259,13065,40632,22357,5041,22440,44797,23373,46632
,XinHuangZhen,320116113,17765,2908,11632,7025,22061,11542,2581,11312,22854,11622,23254
,YongYangZhen,320124100,113075,10014,67086,43305,98050,61774,17508,62630,124404,73511,140597
,BaiMaZhen,320124101,24033,4743,16144,11780,30049,15827,3651,15599,31426,16283,32427
,DongPingZhen,320124102,26258,4973,16919,11937,30763,16128,3365,16053,32181,17677,34596
,ZheTangZhen,320124103,23811,4245,15194,10918,26478,14119,2898,13827,27946,15760,30954
ʯ,ShiQiuZhen,320124104,31380,5527,20558,12991,39043,20107,5602,20994,41101,21951,42509
,HongLanZhen,320124105,33475,5364,21299,13405,39333,20549,4946,21419,41968,22486,43785
,JingQiaoZhen,320124106,21597,4392,14435,10009,27237,14013,3764,14245,28258,15318,29753
ͷ,HeFengZhen,320124107,32858,6057,21148,13350,40834,20953,4908,22190,43143,22675,43823
ˮ,LiShuiKaiFaQu,320124400,19110,1254,11021,6279,11182,8384,2515,8525,16909,11858,22879
Ϫ,ChunXiZhen,320125100,92144,13185,61353,42952,102350,60270,17329,60084,120354,61305,122658
,YangJiangZhen,320125101,47218,10499,31666,21374,62780,31441,8051,33764,65205,34102,65768
שǽ,ZhuanQiangZhen,320125102,23408,5229,15683,10913,30759,15654,3563,16471,32125,16517,32200
Ű,GuBaiZhen,320125103,27418,5164,17910,11663,32229,17024,3750,17481,34505,18422,36332
,QiQiaoZhen,320125104,16805,3460,11067,7944,21603,11038,2704,11780,22818,11902,22969
̳,GuChengZhen,320125105,31777,5247,18527,12495,36062,18465,4613,19177,37642,23110,41637
,DongBaZhen,320125106,29583,6005,19621,13892,38118,19443,4584,20076,39519,20551,40172
Ϫ,YaXiZhen,320125108,41329,7952,27449,18700,53504,27409,6112,27777,55186,27944,55393
簲½ֵ,ChongAnSiJieDao,320202001,27134,5587,19152,12299,26617,16663,3931,15664,32327,17500,36652
ֵͨ,TongJiangJieDao,320202002,9632,1204,5254,3752,6988,4938,1050,4856,9794,6632,11886
·ֵ,GuangRuiLuJieDao,320202003,29301,3997,18417,13063,20988,17417,4027,17367,34784,18908,37325
սֵ,ShangMaDunJieDao,320202004,27260,4319,17855,12249,20275,16542,3611,15971,32513,17335,35190
ֵ,JiangHaiJieDao,320202005,24492,3662,15738,11863,20367,15266,3027,14900,30166,15443,31181
ֵ,GuangYiJieDao,320202006,64035,5337,35431,25728,28283,33391,7397,35470,68861,41338,76769
ӭŽֵ,YingLongQiaoJieDao,320203001,50970,9519,32936,22690,43562,30341,6229,29056,59397,33782,66718
½ֵ,NanChanSiJieDao,320203002,49936,9090,32443,23298,43191,30486,5901,29428,59914,32484,64927
Žֵ,QingMingQiaoJieDao,320203003,47561,10109,31630,24643,44730,31040,5727,30157,61197,31767,63397
ǽֵ,JinXingJieDao,320203004,51764,7880,33371,24196,45294,32614,7408,32152,64766,33681,67052
ѽֵ,JinKuiJieDao,320203005,17234,2364,10577,6727,8257,9630,1973,9451,19081,10994,21571
ֵ,YangMingJieDao,320203006,76634,8278,45996,31626,44811,41934,9914,43247,85181,48830,94826
ֵ,HuangXiangJieDao,320204001,99471,10667,57455,40635,55774,54437,12478,56187,110624,65161,122616
ɽֵ,ShanBeiJieDao,320204002,76787,8811,46288,34701,53118,45064,10258,46338,91402,49568,95856
ֵֽ,BeiDaJieJieDao,320204003,55759,8177,35320,24967,44563,33339,7096,32247,65586,35712,71032
ɽֵ,HuiShanJieDao,320204004,35543,7468,23848,17671,32698,22964,4379,21763,44727,23542,47390
ֵͤ,DongTingJieDao,320205001,94823,5656,55771,37537,52047,51919,15462,53859,105778,60170,115941
ֵ,AnZhenJieDao,320205002,77012,6633,42321,30897,40794,40743,9550,43912,84655,50874,93195
ֵ,DongBeiTangJieDao,320205003,51246,3972,28396,20707,25415,25994,6126,28676,54670,32948,61344
,YangJianZhen,320205102,41620,6048,26127,15269,38251,24722,5597,24998,49720,27138,53265
,EHuZhen,320205103,48846,6888,30366,20210,42870,29424,6049,29679,59103,31417,61783
,XiBeiZhen,320205105,70607,8654,42563,28067,50856,40667,9301,42028,82695,45999,88562
,DongGangZhen,320205106,92249,11178,56634,34206,70150,50685,10935,51496,102181,57728,114362
ɽ,WuXiXiShanKaiFaQu,320205400,80718,5813,43395,24198,35738,30493,6430,32549,63042,49566,92961
Žֵ,YanQiaoJieDao,320206001,109632,9351,62889,45663,62126,59698,15318,64445,124143,71412,134301
ֵ,ChangAnJieDao,320206002,66944,5538,36390,25746,37829,33017,8659,34718,67735,44751,81141
ǮŽֵ,QianQiaoJieDao,320206003,110673,7320,60918,36135,61749,47765,12337,51196,98961,69412,130330
ǰ޽ֵ,QianZhouJieDao,320206004,51984,5668,30262,22034,38183,29358,7052,31939,61297,34442,64704
ֵ,YuQiJieDao,320206005,54773,5995,32740,22707,40653,31673,7968,33576,65249,35996,68736
,LuoSheZhen,320206102,136543,14447,79868,56390,100657,76989,18899,82233,159222,90021,169889
ɽ,YangShanZhen,320206103,33293,4495,19711,14324,27883,19173,4188,20267,39440,22265,41976
ֵ,HeLieJieDao,320211001,97052,16160,62189,46289,85143,60380,12298,60006,120386,63321,125510
ֵ,RongXiangJieDao,320211002,74086,7783,44733,26881,49689,35476,8866,35814,71290,46002,90735
԰ֵ,LiYuanJieDao,320211003,36657,4203,21910,14993,22681,20988,5108,20864,41852,24058,45968
ֵ,LiHuJieDao,320211004,38697,5382,24296,17029,28849,23622,5276,23263,46885,25059,49355
ׯֵ,HuaZhuangJieDao,320211006,68427,6247,38182,29179,39274,36731,8878,40161,76892,45370,83552
ֵ̫,TaiHuJieDao,320211007,74499,5687,40772,29718,28677,36975,8774,39528,76503,48188,88960
ѩ˽ֵ,XueLangJieDao,320211008,99273,8876,54467,27113,65290,37672,8811,38843,76515,62493,116960
ɽֵ,MaShanJieDao,320211009,31497,3031,18502,11963,23998,17045,4381,17560,34605,20407,38909
ׯֵ,WangZhuangJieDao,320211050,113514,7470,62345,24355,53156,36230,7709,36668,72898,66348,128693
˶Žֵ,ShuoFangJieDao,320211051,70495,6290,39977,23730,43087,32843,7168,33247,66090,43976,83953
Ϫֵ,JiangXiJieDao,320211052,117039,10092,68914,42538,68407,59469,15821,60669,120138,74038,142952
°ֵ,XinAnJieDao,320211053,31345,3529,17393,11565,22815,15772,3381,16121,31893,20862,38255
÷ֵ,MeiCunJieDao,320211054,57380,4072,31970,20297,31324,27067,6559,28616,55683,36041,68011
ɽֵ,HongShanJieDao,320211055,56999,7095,34205,19122,51300,31021,6584,30932,61953,36473,70678
ܤ,HuDaiZhen,320211101,39947,4249,22491,14661,29182,21114,5001,21876,42990,26706,49197
¼¹ҵ԰,WuXiXinJiaPoGongYeYuan,320211450,4155,46,2183,1374,2431,1752,675,1877,3629,2693,4876
¼ҵ,WuXiGaoXinJiShuChanYeKaiFaQu,320211451,276,0,114,0,1,0,1,0,0,163,277
νֵ,ChengJiangJieDao,320281001,256695,26630,160398,107935,214820,151741,41335,149703,301444,164262,324660
۽ֵ,ShenGangJieDao,320281002,45829,5256,26096,16078,38845,23945,5393,25424,49369,30382,56478
ĸ۽ֵ,XiaGangJieDao,320281003,53364,4655,29792,19483,35494,27713,6854,29107,56820,35081,64873
բֵ,NanZhaJieDao,320281004,48416,5765,29089,16463,43557,25262,6587,26512,51774,31679,60768
ֵͤ,YunTingJieDao,320281005,48609,5230,28834,19800,40688,27889,6639,29946,57835,31644,60478
,HuangTuZhen,320281100,59166,7188,35388,22662,51581,33947,7762,35513,69460,38728,74116
,LiGangZhen,320281101,51600,6977,31152,20000,51711,30513,6826,31872,62385,34251,65403
³,YueChengZhen,320281102,35368,5385,21994,14276,36732,21472,4920,22266,43738,23679,45673
,QingYangZhen,320281103,65878,8932,40296,24380,61809,37268,8492,38313,75581,43006,83302
ϼ,XuXiaKeZhen,320281104,103914,14120,63540,41404,97170,60931,13006,63554,124485,67500,131040
ʿ,HuaShiZhen,320281107,104461,11571,63093,43883,82914,60398,13656,64204,124602,66595,129688
ׯ,ZhouZhuangZhen,320281108,106461,12160,65010,42936,94446,63293,16129,67269,130562,69740,134750
,XinQiaoZhen,320281109,31036,2912,19085,12758,21989,17218,4542,18027,35245,19405,38490
,ChangJingZhen,320281110,56173,7849,35390,23018,50512,33256,7138,33785,67041,35770,71160
ɽ,GuShanZhen,320281111,58096,7887,36723,22455,49722,32811,7603,33136,65947,36863,73586
ף,ZhuTangZhen,320281112,69487,7926,43003,25280,54712,36549,8090,37328,73877,42500,85503
ʡ�ÿ,JiangSuShengJiangYinJingJiKaiFa,320281400,78304,7776,43929,23111,62698,35590,9090,36043,71633,51241,95170
˳ǽֵ,YiChengJieDao,320282001,188863,15210,110204,73617,136082,102897,28075,100162,203059,121944,232148
ֵͤ,QiTingJieDao,320282002,41039,5534,24499,17204,31028,22702,4738,23180,45882,26812,51311
ׯֵ,XinZhuangJieDao,320282003,25352,4511,16052,11825,24899,15785,2967,16332,32117,16778,32830
½ֵֽ,XinJieJieDao,320282004,24614,4267,15266,11021,23332,14708,2576,15006,29714,16191,31457
,ZhangZhuZhen,320282100,59268,9480,37701,27236,62266,36738,7246,36391,73129,38293,75994
,XiZhuZhen,320282101,19193,3560,12506,8770,21573,12213,2623,12060,24273,12870,25376
̫,TaiHuaZhen,320282102,18786,3052,12189,8394,19936,11483,2584,11467,22950,12233,24422
,XuSheZhen,320282103,62661,14344,40989,30666,73869,40074,6507,40664,80738,42523,83512
,GuanLinZhen,320282104,61893,10564,39525,28839,57633,38465,9307,39283,77748,42239,81764
,YangXiangZhen,320282105,28934,6780,19995,14686,35310,19932,4036,19497,39429,19755,39750
½,XinJianZhen,320282106,19972,3693,12739,9154,20928,12356,2486,12727,25083,13412,26151
,HeQiaoZhen,320282107,62889,9470,39925,28874,58723,38906,8233,39289,78195,40667,80592
,GaoChengZhen,320282108,48504,8575,30285,22927,44926,29895,6010,31215,61110,32804,63089
ʯ,WanShiZhen,320282109,27342,4037,16115,13463,20248,15867,3461,17243,33110,18725,34840
,ZhouTieZhen,320282110,41995,8440,27187,19246,46768,26739,4979,27022,53761,28227,55414
,FangQiaoZhen,320282111,19246,4134,12578,9022,21654,12485,2166,12696,25181,12968,25546
,DingShuZhen,320282112,156452,20276,97319,69943,133126,94141,22518,96135,190276,101927,199246
,HuFuZhen,320282113,15805,3209,10325,7841,17372,10275,1631,9938,20213,10320,20645
԰,HuanKeYuan,320282400,42039,2822,25188,17025,22476,23435,6594,23179,46614,26267,51455
¥ֵ,HuangLouJieDao,320302001,30007,4432,19942,14174,26524,19728,4770,18916,38644,19267,39209
ƽֵ,FengCaiJieDao,320302002,59707,8273,38313,27451,56134,37918,8733,37547,75465,38400,76713
ýֵ,PiPaJieDao,320302003,22885,2408,14760,9301,17336,14634,4300,14564,29198,14833,29593
¥ֵ,PaiLouJieDao,320302004,17257,1505,10853,7588,10853,10752,3250,10637,21389,11159,22012
ֵͭ,TongPeiJieDao,320302005,40434,4372,24064,16951,30433,23648,5950,23326,46974,26692,50756
ǽֵ,HuanChengJieDao,320302006,64153,8781,42039,29495,58097,41323,10377,40357,81680,41272,83311
ɽŽֵ,JinShanQiaoJieDao,320302051,25643,1475,16137,8793,17331,12431,4480,13142,25573,15461,31598
ֵ,DongHuanJieDao,320302052,19061,2046,12150,7075,19910,11868,3825,11872,23740,12782,24932
ɽֵ,DaiHuangShanJieDao,320302053,8543,1338,5059,3523,8565,4698,900,4614,9312,5722,10781
,DaMiaoZhen,320302151,55509,6222,38353,19284,66420,36383,15448,36448,72831,38826,77179
ɽ,DaiHuangShanZhen,320302152,32732,3812,22089,13587,39423,21971,8227,22331,44302,22682,44771
ǽֵ,PengChengJieDao,320303001,48293,8147,32220,22349,50933,30307,6032,29255,59562,30252,62472
ӷֵ,ZiFangJieDao,320303002,53718,8346,34961,24775,54753,34754,7366,33918,68672,34469,69430
ɽֵ,HuangShanJieDao,320303003,53494,4804,34217,19921,33881,28097,8315,27636,55733,32396,66613
ɽֵ,LuoTuoShanJieDao,320303004,47137,3828,29051,18300,34955,26329,8742,26602,52931,30656,59707
ׯֵ,DaGuoZhuangJieDao,320303005,6951,831,4556,2555,6997,4539,1309,4486,9025,4535,9091
ɽֵ,CuiPingShanJieDao,320303006,8054,936,4508,2741,10208,4497,1495,4410,8907,5977,10485
ֵ,DaLongHuJieDao,320303007,41165,3943,24476,12928,43701,24263,7707,23979,48242,28339,52815
ֵ,PanTangJieDao,320303008,11088,1411,7362,4013,13779,7198,2281,7212,14410,7418,14780
ׯֵ,PangZhuangJieDao,320304001,21176,2426,13694,8437,25198,13687,4233,14127,27814,14141,27835
𻨽ֵ,HuoHuaJieDao,320304002,19805,2044,12705,7410,19594,12669,3893,12926,25595,13037,25742
ֵ,LiGuoJieDao,320304003,4116,462,2524,1916,4794,2522,637,2686,5208,2691,5215
԰ֵ,TaoYuanJieDao,320304004,8502,1018,5696,3539,10182,5696,1890,5712,11408,5714,11410
Ӽֵ,SanHeJianJieDao,320304005,5815,782,3063,2340,6103,3052,810,3201,6253,4344,7407
ǽֵ,ChaChengJieDao,320304006,2311,182,1339,1098,2145,1339,354,1495,2834,1508,2847
尲ֵ,YiAnJieDao,320304007,15,0,3,5,5,2,4,3,5,16,19
żֵ,ZhangJiJieDao,320304008,4119,384,1983,1649,3628,1983,582,2041,4024,3102,5085
糧ֵ,DianChangJieDao,320304009,2149,93,623,423,354,541,176,603,1144,1795,2418
˫¥ֵ,ZhangShuangLouJieDao,320304010,4851,210,2033,1730,4964,2015,564,2225,4240,3592,5625
ֵ,JiuLiJieDao,320304011,28936,2190,17074,7355,22490,12804,4523,12562,25366,18575,35649
ʰͽֵ,ShiTunJieDao,320304012,10300,1119,6648,3891,11890,6640,2357,7105,13745,7128,13776
ɽֵ,SuShanJieDao,320304013,13248,1327,8654,5212,13727,8644,2958,8825,17469,8879,17533
Ͽֵ,LaoKuangJieDao,320305001,23850,2812,15822,11253,25746,15612,5176,15788,31400,16016,31838
Žֵ,XiaQiaoJieDao,320305002,18343,2433,11585,8293,17213,11536,2680,11671,23207,11871,23456
,JiaWangZhen,320305101,36538,5309,23893,14122,41053,22324,7158,22796,45120,25112,49005
ɽȪ,QingShanQuanZhen,320305102,32475,4874,21788,14466,41780,21715,6965,22436,44151,22526,44314
,DaWuZhen,320305103,57461,6883,38630,23366,72235,38398,14223,39323,77721,39937,78567
ׯ,ZiZhuangZhen,320305104,37187,5900,25347,17610,50377,25339,8976,26712,52051,26716,52063
ɽ,TaShanZhen,320305105,40244,7093,28694,17633,56274,28688,11825,30438,59126,30468,59162
,BianTangZhen,320305106,32465,5173,22565,12827,44320,22555,8622,23664,46219,23695,46260
ׯ,JiangZhuangZhen,320305107,22487,3455,15347,9662,30197,15344,5969,16512,31856,16564,31911
¹ׯԭֳ,LuZhuangLiangMianYuanZhongChang,320305401,266,38,153,70,350,116,46,119,235,197,350
ҵ԰ί,GongYeYuanQuGuanWeiHui,320305402,10077,1199,6800,4007,12397,6732,2510,6845,13577,6986,13786
ֵ,WangLingJieDao,320311001,45156,8316,30304,22568,48270,30181,5575,28632,58813,28743,59047
﹵ֵ,QiLiGouJieDao,320311002,6553,533,3958,2526,4143,3888,1275,4103,7991,4403,8361
ֵ,YongAnJieDao,320311003,58203,10445,38998,28325,61468,38791,8182,37300,76091,37832,76830
ֵ,HuBinJieDao,320311004,38450,4904,25146,17478,33715,25007,6423,24470,49477,24631,49777
ׯֵ,DuanZhuangJieDao,320311005,41221,4874,26354,17783,36409,24918,6235,24755,49673,25976,52330
ɽֵ,ZhaiShanJieDao,320311006,53078,4118,28723,13091,40060,18577,5011,17896,36473,33484,62207
ɽֵ,KuiShanJieDao,320311007,27200,4309,18416,12931,19692,17834,4595,17222,35056,17688,36104
ƽֵ,HePingJieDao,320311008,72622,9567,47650,33579,73804,47259,12392,46383,93642,46931,94581
ɽֵ,JinShanJieDao,320311009,32251,940,12686,3224,21635,4992,1736,4925,9917,22241,34927
̩ɽֵ,TaiShanJieDao,320311010,53873,4642,29634,17841,37760,24995,7014,24851,49846,35895,65529
ͭɽ,TongShanZhen,320312101,98128,5201,61913,28165,52584,40034,14491,40693,80727,55907,117820
,HeQiaoZhen,320312102,22477,5248,19520,14086,34107,19505,7393,15563,35068,15598,35118
Ƽ,HuangJiZhen,320312103,30030,5832,22767,16128,41311,22767,7176,20271,43038,20271,43038
,MaPoZhen,320312104,23704,4557,19693,12371,32515,19693,7097,15662,35355,15665,35358
֣,ZhengJiZhen,320312105,31718,4308,21090,12071,38340,20036,6995,20175,40211,21931,43021
,LiuXinZhen,320312106,47892,6485,32459,19602,60127,32349,10881,32382,64731,32799,65258
,LiuJiZhen,320312107,38440,6107,28070,17534,51158,27993,10238,26593,54586,26715,54785
,DaPengZhen,320312108,36948,5436,27689,16647,47581,26999,9835,23715,50714,24530,52219
,HanWangZhen,320312109,33872,4891,23704,15413,42423,23558,8442,23247,46805,23501,47205
,SanBaoZhen,320312110,29789,4726,20132,14173,36833,20106,6576,20836,40942,20959,41091
,TangZhangZhen,320312111,38122,5589,26317,17073,47100,25267,9274,25419,50686,26668,52985
ż,ZhangJiZhen,320312112,41812,7090,31369,19717,57116,30840,13027,29857,60697,30560,61929
,FangCunZhen,320312113,35432,6576,28417,17300,50450,28343,12027,25489,53832,25618,54035
ׯ,YiZhuangZhen,320312114,23507,4516,17553,10943,32034,17469,6945,17295,34764,17415,34968
,DanJiZhen,320312115,33190,7162,25388,16480,46895,25376,10265,25091,50467,25229,50617
,LiGuoZhen,320312116,39618,5445,26490,17161,47123,26283,9897,27315,53598,28470,54960
ׯ,XuZhuangZhen,320312117,37019,6410,28029,17611,53353,28012,12670,28048,56060,28070,56099
,DaXuZhen,320312118,45575,7656,32705,20177,60409,31376,13332,32157,63533,33858,66563
é,MaoCunZhen,320312119,41556,5519,29421,17451,52171,28823,10574,27593,56416,28228,57649
Ȫ,LiuQuanZhen,320312120,35380,5916,25941,16902,45508,25937,10361,25696,51633,25716,51657
Ӫغũ,GuoYingYanHuNongChang,320312401,7330,1114,5114,3324,9701,5109,1745,5060,10169,5075,10189
,FengChengZhen,320321101,121235,13260,77997,55251,126653,75226,27355,80153,155379,83853,161850
,ShouXianZhen,320321102,51764,9309,37053,23670,72105,36833,14957,37387,74220,38977,76030
˳,ShunHeZhen,320321103,32823,5705,23868,13851,45014,22909,8802,22522,45431,23462,47330
,ChangDianZhen,320321104,34465,6118,24744,15728,47688,24721,9189,24982,49703,25028,49772
,HuanKouZhen,320321105,52580,9247,39484,25308,72330,38200,15931,37077,75277,38274,77758
ʦկ,ShiZhaiZhen,320321106,42031,8288,31849,20583,60518,31831,12637,31032,62863,31107,62956
ɽ,HuaShanZhen,320321107,49727,7852,35364,23196,66368,34242,13702,34695,68937,35917,71281
կ,LiangZhaiZhen,320321108,39258,5979,26657,17878,53444,26295,9505,27631,53926,28085,54742
¥,FanLouZhen,320321109,42520,7727,31415,21057,60471,31411,12612,31421,62832,31444,62859
¥,SunLouZhen,320321110,32786,5265,23000,15395,43751,22990,8890,23849,46839,23941,46941
¥,SongLouZhen,320321111,57334,8496,39157,22770,75810,38027,13933,39394,77421,40606,79763
ɳ,DaShaHeZhen,320321112,36478,5522,24965,15430,49690,24916,9426,26384,51300,26461,51426
,WangGouZhen,320321113,44832,9832,34590,22885,65054,33960,12476,31984,65944,32550,67140
ׯ,ZhaoZhuangZhen,320321114,36041,6743,26636,16889,52167,26622,10409,26515,53137,26557,53193
ɳֳ,DaShaHeLinChang,320321401,381,51,241,148,145,174,58,221,395,249,490
,LongGuZhen,320322101,43090,5425,30127,16712,54710,29816,10571,28164,57980,28959,59086
,YangTunZhen,320322102,40005,5022,26131,15757,50441,26034,8390,27138,53172,27286,53417
,DaTunZhen,320322103,48467,5742,31566,18228,52371,30117,9944,30846,60963,32587,64153
,PeiChengZhen,320322104,150219,14041,94720,57072,167536,89560,31103,94932,184492,100643,195363
կ,HuZhaiZhen,320322105,22967,3731,16561,9550,31151,16153,5533,14990,31143,15670,32231
κ,WeiMiaoZhen,320322106,37652,5272,26419,14638,50366,25291,8896,24310,49601,25401,51820
,WuDuanZhen,320322107,29910,4405,21827,12052,41265,21816,7488,19973,41789,19976,41803
ׯ,ZhangZhuangZhen,320322108,51268,8665,38491,23609,71764,37808,14181,33496,71304,35623,74114
կ,ZhangZhaiZhen,320322109,52860,8170,39056,22988,70803,37722,13403,34280,72002,35377,74433
,JingAnZhen,320322110,41102,6782,28880,17113,55906,27732,9941,26762,54494,28945,57825
ӿ,HeKouZhen,320322111,32422,5629,24410,15458,45795,24387,9230,22598,46985,22871,47281
ɽ,QiShanZhen,320322112,36054,6161,26607,16526,49938,26382,9535,24537,50919,25143,51750
¹¥,LuLouZhen,320322113,44118,7054,31678,19101,61014,30895,12532,30640,61535,32026,63704
կ,ZhuZhaiZhen,320322114,40732,6107,27972,16511,54791,27794,10069,28674,56468,28936,56908
,AnGuoZhen,320322115,58247,8154,40873,22139,80067,40565,15780,40768,81333,41308,82181
úŴú磨ţ˾,ZhongMeiJiTuanDaTunMeiDianJiTuanGongSi,320322401,44723,3724,22265,16244,50692,22004,5251,23242,45246,31433,53698
³,PeiXianXinChengQu,320322402,15584,1921,10243,5359,19008,9901,3134,10115,20016,10396,20639
غũί,PeiXianHuXiNongChangGuanLiWei,320322403,11341,1495,7418,4376,15177,7414,2588,8003,15417,8006,15424
ÿ,JingJiKaiFaQu,320322404,35330,4066,21964,10710,39567,18356,6709,19249,37605,24141,46105
,SuiChengZhen,320324101,172454,17878,112788,66860,170510,106828,42210,111407,218235,119754,232542
,WangJiZhen,320324102,37240,6994,27512,18227,51059,26545,10344,25749,52294,27066,54578
˫,ShuangGouZhen,320324103,30114,5704,23737,14937,43620,23240,9879,21336,44576,21960,45697
ɽ,LanShanZhen,320324104,35765,7087,27849,17712,54364,27807,12590,27494,55301,27593,55442
,LiJiZhen,320324105,26676,5232,20762,13191,34767,19659,7783,17441,37100,18929,39691
԰,TaoYuanZhen,320324106,33330,7449,27446,18181,51864,27357,12082,25236,52593,25415,52861
ɽ,GuanShanZhen,320324107,33484,7257,27132,17303,49431,27115,10345,23842,50957,23954,51086
,GaoZuoZhen,320324108,30712,5641,21751,14124,41284,21723,7066,21585,43308,21668,43419
ɳ,ShaJiZhen,320324109,32367,5670,23080,13817,45600,23067,8659,23566,46633,23616,46696
,LingChengZhen,320324110,34798,7266,27884,16789,52081,27562,11777,25675,53237,25957,53841
,QiuJiZhen,320324111,50047,10352,39177,23939,74879,39156,15944,36995,76151,37166,76343
,GuPiZhen,320324112,31386,6982,25334,16550,47433,25175,10380,23276,48451,23414,48748
Ҧ,YaoJiZhen,320324113,43166,9592,33982,22029,64525,33961,13139,31819,65780,31915,65897
κ,WeiJiZhen,320324114,29997,8052,25124,17116,46665,24971,10020,22833,47804,22945,48069
,LiangJiZhen,320324115,33806,7563,26809,17484,50068,26791,10679,25130,51921,25239,52048
찲,QingAnZhen,320324116,31347,7185,24825,16286,47361,24815,9702,23375,48190,23409,48234
ÿ,JingJiKaiFaQu,320324401,17809,2263,11861,6426,19336,11157,4051,11518,22675,12262,24123
°,XinAnZhen,320381101,138923,14306,91549,58279,169216,90863,33170,93974,184837,94850,186399
Ҥ,WaYaoZhen,320381102,26096,3637,18098,10264,34245,17118,7347,17979,35097,18982,37080
ͷ,GangTouZhen,320381103,26296,4460,20558,12559,38344,20514,9243,19372,39886,19441,39999
Ƶ,TangDianZhen,320381104,31953,4748,23010,13838,42640,22987,10127,23764,46751,23818,46828
Ϲ,HeGouZhen,320381105,29088,5040,22427,12641,43197,22421,10619,22301,44722,22320,44747
,CaoQiaoZhen,320381106,46203,7397,32566,19941,61821,32483,11643,32306,64789,32677,65243
Ҥ,YaoWanZhen,320381107,41627,7332,29911,18755,58473,29753,11709,30598,60351,30757,60668
,QiPanZhen,320381108,44099,8259,33409,22604,64334,33373,14061,32879,66252,33010,66419
ɽ,MaLingShanZhen,320381109,37452,5502,25882,14166,47032,24752,9757,25637,50389,26829,52711
µ,XinDianZhen,320381110,30616,5115,22110,12265,42700,21198,8678,21240,42438,22299,44409
۵,ShaoDianZhen,320381111,22484,4048,16160,9257,31562,16149,5916,16181,32330,16288,32448
,BeiGouZhen,320381112,37103,3641,24875,13576,45693,24874,9374,25242,50116,25243,50118
ʱ,ShiJiZhen,320381113,26377,4818,21098,13609,38763,21097,10457,20530,41627,20554,41652
,GaoLiuZhen,320381114,32969,4868,23283,14559,45190,23171,10648,25117,48288,25202,48485
,AHuZhen,320381115,37276,5779,27433,14859,52724,27425,12243,27856,55281,27865,55298
˫,ShuangTangZhen,320381116,19741,3349,15423,9871,27221,15391,7868,15358,30749,15535,30958
ÿ,JingJiKaiFaQu,320381401,11858,1316,8361,4823,15505,8361,3731,8540,16901,8544,16905
ʹҵ԰,XiYiGongYeYuanQu,320381402,184,18,130,68,261,130,59,131,261,131,261
˺,YunHeZhen,320382101,178082,16707,118102,68435,212456,111794,46604,117609,229403,123291,241393
,PiChengZhen,320382102,44411,6674,31647,17270,63879,31615,13500,32900,64515,32938,64585
ٺ,GuanHuZhen,320382103,65542,9274,48278,25450,95880,48002,22889,49195,97197,49427,97705
Ļ,SiHuZhen,320382104,27519,4415,19877,11364,40094,19816,8496,20420,40236,20553,40430
ɽ,SuYangShanZhen,320382105,44281,6743,31914,18115,64916,31877,14309,33392,65269,33419,65333
弯,BaYiJiZhen,320382106,45219,7973,32813,19492,63408,32101,12638,32190,64291,33017,65830
ɽ,TuShanZhen,320382107,29225,5348,21082,12390,41911,20840,8280,21460,42300,21771,42853
ׯ,NianZhuangZhen,320382108,55327,8176,39309,19862,79528,37062,17114,38313,75375,41308,80617
,GangShangZhen,320382109,34453,4529,25303,14089,50318,25084,12132,25460,50544,25811,51114
ׯ,ZouZhuangZhen,320382110,29674,4634,22752,12073,44988,22711,11153,22649,45360,22709,45461
ռ,ZhanChengZhen,320382111,26134,4648,18880,11703,37778,18712,7382,18958,37670,19284,38164
º,XinHeZhen,320382112,32734,6275,24280,14094,48378,24250,9703,24394,48644,24432,48712
·,BaLuZhen,320382113,27294,4700,19208,11238,38260,19176,6900,19656,38832,19686,38894
ڳ,PaoCheZhen,320382114,40282,6370,27873,17408,54356,27797,9431,27963,55760,28210,56083
,TieFuZhen,320382115,57961,9110,43252,23614,85693,42438,20618,43391,85829,44437,87689
,ChaHeZhen,320382116,19321,3521,15294,9142,29855,15264,7252,14738,30002,14800,30094
,DaiWeiZhen,320382117,31255,4487,21700,12037,44184,21678,8746,22761,44439,22788,44488
¥,ChenLouZhen,320382118,32430,5051,24257,14111,46659,24251,10846,24066,48317,24070,48327
¥,XingLouZhen,320382119,33650,4814,24038,12822,49291,23839,11189,25259,49098,25615,49653
ׯ,DaiZhuangZhen,320382120,27730,4674,20906,11303,42125,20886,10006,21456,42342,21504,42410
ɽ,CheFuShanZhen,320382121,30870,4843,22444,13279,44577,21902,10131,22773,44675,23400,45844
Ӳ,YanZiBuZhen,320382122,17249,3076,12534,7931,24848,12461,5389,13067,25528,13180,25714
Զ,ZhaoDunZhen,320382123,53413,8195,37698,19888,76002,37552,15083,38847,76399,38993,76691
,YiTangZhen,320382124,18902,3552,14026,8902,27175,13981,5548,13859,27840,13976,28002
ũ,PiChengNongChang,320382401,315,48,239,104,458,239,95,219,458,219,458
¥ũ,ZhangLouNongChang,320382402,32,4,16,17,37,16,1,21,37,21,37
ݾÿ,JiangSuPiZhouJingJiKaiFaQu,320382403,980,130,705,407,1457,705,347,752,1457,752,1457
ׯֵ,DiaoZhuangJieDao,320402001,32548,1615,18748,13508,9538,15011,3681,16817,31828,19096,37844
ֵ,QingLongJieDao,320402002,43767,3424,25286,16413,22752,22539,6289,23847,46386,28194,53480
ɽֵ,ChaShanJieDao,320402003,85466,11891,54594,40962,67126,53592,12203,53462,107054,54966,109560
÷ֵ,HongMeiJieDao,320402004,128827,14101,79975,54677,92951,74069,18761,73281,147350,81714,161689
ֵ,TianNingJieDao,320402005,61973,11087,41609,29059,55700,39381,9502,37810,77191,40953,82562
ֵ,LanLingJieDao,320402006,54140,7140,34276,25470,35241,32521,7379,32521,65042,34383,68659
ǽֵ,WuXingJieDao,320404001,132753,13435,79115,55732,86172,73479,18346,72856,146335,85419,164534
ֵ,YongHongJieDao,320404002,107276,12786,68880,43245,78317,59435,13898,56782,116217,65080,133960
۽ֵ,BeiGangJieDao,320404003,34714,2872,19700,12286,20329,17223,4531,17068,34291,22417,42117
ֵֽ,XiLinJieDao,320404004,19607,1813,11506,7549,11970,10849,3184,10958,21807,13098,24604
ϴֵֽ,NanDaJieJieDao,320404005,40210,5971,27066,18852,32660,25748,5990,23637,49385,25105,52171
ɻؽֵ,HeHuaChiJieDao,320404006,42651,7336,27897,17471,42548,23759,5111,22582,46341,27201,55098
բֵ,XinZhaJieDao,320404007,27516,2407,15156,10357,14749,13788,3355,14220,28008,18122,33278
ֵ߽,QiShuYanJieDao,320405001,35743,6269,22110,16508,34152,20961,4593,21299,42260,24495,46605
ֵ߽,DingYanJieDao,320405002,22925,2502,13774,10592,12718,13534,3514,14658,28192,15167,28941
ºǽֵ,LuChengJieDao,320405003,24069,2126,14142,9486,13635,12600,3443,13534,26134,15496,29638
Ӻֵ,HeHaiJieDao,320411001,59122,3622,33366,18559,32449,25011,7441,24901,49912,36819,70185
ֵ,SanJingJieDao,320411002,59344,3726,33966,24068,30679,30880,8827,31994,62874,37931,71897
ֵ,LongHuTangJieDao,320411003,33973,1882,17977,10813,15461,14039,3845,14661,28700,21723,39700
,ChunJiangZhen,320411100,111479,13736,67511,43768,101487,65132,15743,66838,131970,73447,140958
Ϻ,MengHeZhen,320411101,70578,9525,44692,29912,68408,43656,10946,44129,87785,46357,91049
,XinQiaoZhen,320411102,28803,2378,17242,10591,16317,14191,3696,15023,29214,17635,34877
Ѧ,XueJiaZhen,320411103,45973,4233,26384,17300,31103,24615,6366,25386,50001,30188,56572
Ϫ,LuoXiZhen,320411104,37252,5213,22698,15155,36023,22131,4967,22391,44522,24734,47432
,XiXiaShuZhen,320411105,34533,5069,21765,14581,34342,20803,4872,21172,41975,22709,44474
,HuTangZhen,320412100,213358,15268,126250,82339,119515,108799,32053,112507,221306,134429,260679
ţ,NiuTangZhen,320412102,71031,5253,41565,29327,33699,38276,11271,41605,79881,45990,87555
,LuoYangZhen,320412103,63157,7201,38643,26231,47305,36723,9921,38476,75199,41636,80279
ң,YaoGuanZhen,320412104,81085,6625,45763,33368,38567,43555,12355,47900,91455,54302,100065
,HengLinZhen,320412105,71201,6755,43047,31797,42414,41171,12396,44195,85366,47305,90352
ɽ,HengShanQiaoZhen,320412106,71166,8113,43815,30164,51835,41171,11301,42913,84084,46765,90580
֣½,ZhengLuZhen,320412109,87344,11407,54311,37092,75208,52470,13232,54410,106880,57672,111983
ѩ,XueYanZhen,320412110,73784,10532,45349,31889,67468,43915,10389,45521,89436,49356,94705
ǰ,QianHuangZhen,320412113,63610,9354,39752,27720,55287,38355,8616,39445,77800,41828,81580
,LiJiaZhen,320412114,66031,6859,38720,27425,41358,35894,9182,38216,74110,43352,82072
,ZouQuZhen,320412116,78165,7552,46697,34216,48575,45021,11813,47362,92383,50833,97530
,JiaZeZhen,320412119,55703,9753,36669,26557,59197,36130,8147,35737,71867,36934,73603
,HuangLiZhen,320412120,54712,8545,35109,24358,52781,34068,8744,34902,68970,36892,72001
ţ,BenNiuZhen,320412122,50848,6693,31525,20367,45674,29830,6387,30048,59878,32403,63928
ÿ,WuJinJingJiKaiFaQu,320412400,31550,2924,18355,11863,19944,15808,4159,16703,32511,20278,38633
,GaoXinQu,320412411,119226,8962,70206,43073,58649,56751,15301,59494,116245,73283,143489
,LiChengZhen,320481100,230944,24611,142385,94893,218152,138539,39253,134296,272835,152423,294808
ܤͷ,DaiTouZhen,320481101,19640,3719,13055,8808,22666,12593,2866,12353,24946,13170,26225
ϻ,ShangHuangZhen,320481102,17433,3433,11742,8284,20228,11695,2514,11455,23150,11638,23380
,DaiBuZhen,320481103,35805,6707,23632,15539,40758,22102,4346,21419,43521,23226,46858
Ŀ,TianMuHuZhen,320481106,47260,7894,31679,21442,55687,31423,7693,30404,61827,31168,62847
,BieQiaoZhen,320481107,38489,8811,28271,20149,49082,28163,6103,24726,52889,25132,53403
,ShangXingZhen,320481109,46025,9258,31854,24083,57242,31443,8090,30195,61638,31519,63373
,ZhuZeZhen,320481111,38804,7660,26703,18637,47529,26351,6340,25258,51609,26101,52804
϶,NanDuZhen,320481114,42344,9117,30378,21797,52649,29691,6889,26642,56333,27972,58350
,SheZhuZhen,320481116,46915,8431,32347,22608,57934,31914,8047,30378,62292,31046,63393
,XuNiDiQu,320481400,1790,723,1149,1138,2635,1131,147,1241,2372,1511,2660
,XuNiDiQu,320481401,920,419,631,650,1294,628,82,701,1329,790,1421
,JinChengZhen,320482100,158350,21528,103916,75406,148136,100699,23805,96223,196922,99767,203683
,RuLinZhen,320482104,21269,4732,14383,11537,24202,14055,3022,14233,28288,14640,29023
Ң,YaoTangZhen,320482105,40237,8227,27413,21246,42675,27138,6135,26689,53827,27186,54599
ֱϪ,ZhiXiZhen,320482106,33191,8303,24225,19414,38046,23402,4231,20720,44122,21500,45725
,ZhuLinZhen,320482108,23563,5475,16336,13462,25015,16243,3060,15367,31610,15762,32098
Ѧ,XueBuZhen,320482109,43405,9114,29572,24555,46459,29254,5900,28123,57377,28847,58419
ָǰ,ZhiQianZhen,320482112,22903,5604,16424,12692,26547,15508,3045,14185,29693,15128,31552
,KaiFaQu,320482400,78546,6856,50025,32468,50669,43705,11490,42661,86366,46867,96892
˫ֵ,ShuangTaJieDao,320502001,32978,7762,22722,14706,31161,19327,3612,18011,37338,21630,44352
Žֵ,NanMenJieDao,320502002,36340,8075,25499,16978,32372,22008,4134,20741,42749,23050,48549
㽭ֵ,XuJiangJieDao,320502003,42274,6293,27066,18958,31310,25322,5324,24645,49967,26825,53891
Žֵ,WuMenQiaoJieDao,320502004,64669,11337,42600,30183,58096,40943,8019,39754,80697,41425,84025
Žֵ,FengMenJieDao,320502005,61721,6938,36711,24147,41167,30517,6066,30368,60885,38014,74725
½ֵ,YouXinJieDao,320502006,71579,6285,43931,30955,44752,42583,11640,42795,85378,45573,89504
ǰֵ,GuanQianJieDao,320503001,26974,6415,18342,13482,22020,16694,2697,15907,32601,17744,36086
ƽ·ֵ,PingJiangLuJieDao,320503002,26718,6870,18501,14118,25277,17774,2891,17051,34825,17978,36479
սֵ,SuJinJieDao,320503003,18522,2127,11515,7776,11665,11078,2676,10898,21976,11810,23325
¦Žֵ,LouMenJieDao,320503004,60232,8557,37216,25897,40556,33801,6915,33583,67384,38488,75704
Ǳֵ,ChengBeiJieDao,320503005,37612,2132,21449,16713,12753,20762,5979,22483,43245,24274,45723
һֵ,TaoHuaWuJieDao,320503006,38481,8676,25752,19726,32603,24274,4239,23804,48078,25644,51396
¦,LouFengZhen,320503150,249136,21882,145385,77355,146761,110373,24729,108744,219117,150362,295747
Ψͤ,WeiTingZhen,320503152,157434,8742,85532,40048,62765,53899,12515,55391,109290,93159,178691
ʤ,ShengPuZhen,320503153,53918,3608,29104,16917,26261,22786,5213,23538,46324,33635,62739
ݹҵ԰ֱ,SuZhouGongYeYuanQuZhiShuZhen,320503199,134480,4466,80849,34328,73786,49857,19231,47306,97163,77328,158177
ʯ·ֵ,ShiLuJieDao,320504001,26322,5884,18105,12358,22952,16181,2953,15231,31412,17054,35159
ֵ,CaiXiangJieDao,320504002,51022,8943,33549,22720,42253,29831,5862,28564,58395,32278,65827
԰ֵ,LiuYuanJieDao,320504003,62781,7921,39397,27330,41368,35076,7567,35224,70300,38872,78269
ֵ,HuQiuJieDao,320504004,53757,5723,33052,25356,24868,30446,7129,31225,61671,33557,66609
ֵ,BaiYangWanJieDao,320504005,36503,2568,20724,15290,15476,19766,5895,21716,41482,24242,44966
ֵ,HengTangJieDao,320505001,57162,2297,33259,14796,16857,19473,5793,20730,40203,31993,65252
ʨɽֵ,ShiShanJieDao,320505002,104721,6099,61400,33067,59595,45255,13086,43668,88923,62506,123906
Žֵ,FengQiaoJieDao,320505003,109735,6599,63702,28447,50036,41749,10447,41041,82790,63079,126781
ֵ,ZhenHuJieDao,320505004,15264,2809,10633,6192,18276,10334,2419,9512,19846,9859,20492
,HuShuGuanZhen,320505100,46521,4919,27861,18970,32771,26967,6650,27872,54839,30229,58090
ͨ,TongAnZhen,320505101,44278,5756,27992,14791,42456,25786,6129,25080,50866,28171,56163
,DongZhuZhen,320505102,25477,4113,16658,9955,28089,16376,3740,15921,32297,16672,33330
ؾÿ,GaoXinQuHuShuGuanJingJiKai,320505400,67234,5732,38375,23398,38862,33817,8366,34433,68250,42957,81332
ݿƼ,SuZhouKeJiCheng,320505407,6510,59,1841,860,2399,714,156,995,1709,4884,6725
Žֵ,ChangQiaoJieDao,320506001,53943,2870,29356,26292,16688,27649,6062,31041,58690,33519,62875
ԽϪֵ,YueXiJieDao,320506003,71312,3406,42953,12637,31905,19793,5079,19678,39471,36844,79797
ֵ,GuoXiangJieDao,320506004,83864,5417,47404,29182,38299,40680,9733,42288,82968,51610,99014
ֵ,HengJingJieDao,320506005,31403,4168,19211,9488,27906,16762,3691,16355,33117,20051,39262
ɽֵ,XiangShanJieDao,320506006,18829,2712,11623,5969,17467,10267,2398,9899,20166,12316,23939
Էֵ,SuYuanJieDao,320506007,40165,4983,25693,17081,23360,23810,6303,22734,46544,25758,51451
ֵ,LongXiJieDao,320506008,36369,3020,23252,15292,21403,22498,6191,21561,44059,22328,45580
Ͻֵ,ChengNanJieDao,320506009,93094,2898,51853,24019,25194,32139,9135,32583,64722,53274,105127
fֱ,LuZhiZhen,320506100,115121,8989,65919,35807,57870,49773,11112,50495,100268,69303,135222
ľ,MuDuZhen,320506103,206077,10629,112864,44146,74268,65862,18104,64903,130765,121946,234810
,XuKouZhen,320506104,67506,4391,39334,15774,27801,25081,6859,25252,50333,39422,78756
ɽ,DongShanZhen,320506107,39842,7142,26428,15731,48400,25697,4889,24438,50135,25445,51873
⸣,GuangFuZhen,320506108,39219,6175,24428,12370,40118,21769,4765,20957,42726,25731,50159
ͥ,JinTingZhen,320506109,29460,6193,19995,14395,37185,19807,3429,18635,38442,19087,39082
ٺ,LinHuZhen,320506110,43937,5991,27706,13029,37111,22626,5354,21921,44547,27576,55282
ɽ羰,QiongLongShanFengJingQu,320506403,3674,678,2482,1195,4507,2383,539,2274,4657,2409,4891
Ԫͽֵ,YuanHeJieDao,320507001,133046,8215,76567,51529,66559,70287,19148,72902,143189,83842,160409
̫ƽֵ,TaiPingJieDao,320507002,46734,3951,25000,15044,26227,21193,4949,21956,43149,30634,55634
Žֵ,HuangQiaoJieDao,320507003,50756,3272,28554,19103,24027,25571,6279,26658,52229,31753,60307
Žֵ,BeiQiaoJieDao,320507004,48209,5144,27894,18926,33888,26242,5817,26941,53183,31276,59170
ͤ,WangTingZhen,320507100,45436,4778,26904,15198,32756,23578,5497,23436,47014,28807,55711
ܤ,HuangDaiZhen,320507102,88440,7086,50325,26760,51227,40178,10484,40495,80673,55685,106010
μ,WeiTangZhen,320507105,53357,3953,30536,19603,29452,26954,6275,27641,54595,33049,63585
κ,YangChengHuZhen,320507109,44502,5317,27036,12811,31604,19739,3567,19465,39204,26350,53386
,KaiFaQu,320507400,53299,3868,30052,17054,25637,24014,6020,24531,48545,33135,63187
κ̬,YangChengHuShengTaiXiuXianLvYou,320507401,12206,2050,7691,4290,12021,6869,1292,6845,13714,7857,15548
ɽ,YuShanZhen,320581100,466344,47509,282504,177715,337440,240596,59146,238413,479009,290495,572999
÷,MeiLiZhen,320581101,75511,13956,50248,27867,73027,45302,8804,43681,88983,48023,98271
,HaiYuZhen,320581102,87196,14800,56612,30827,81712,50044,10424,48985,99029,55808,112420
Ϫ,BiXiZhen,320581103,93508,18693,62587,35697,93949,57383,10569,55979,113362,60183,122770
,GuLiZhen,320581104,94547,12300,58556,35697,68898,51657,10412,52504,104161,58703,117259
ɳ,ShaJiaBangZhen,320581105,45191,6534,27723,13534,35812,21785,3982,21334,43119,27984,55707
֧,ZhiTangZhen,320581106,59945,12669,40539,21031,64634,36302,6513,34676,70978,38588,79127
,DongBangZhen,320581107,40552,10134,28506,15837,46582,27196,4905,25995,53191,27085,55591
ׯ,XinZhuangZhen,320581110,76084,11060,47660,28427,68280,43560,8525,42912,86472,48009,95669
к,ShangHuZhen,320581111,90389,12263,55009,28990,71069,44286,8542,43826,88112,56185,111194
ɽֳ,YuShanLinChang,320581400,6911,901,4160,2250,4403,3593,739,3540,7133,4391,8551
쾭ÿ,ChangShuJingJiKaiFaQu,320581401,6199,26,1691,1225,116,786,229,1392,2178,4763,6454
춫Ͽ,ChangShuDongNanKaiFaQu,320581402,11605,9,5509,201,44,188,6,206,394,6111,11620
ɽкζ,ChangShuYuShanShangHuLvYouDu,320581403,29521,3468,17807,9184,18557,14359,3036,14164,28523,18218,36025
ճװǹ,JiangSuChangShuFuZhuangChengGuanLi,320581404,23115,1224,12884,9641,7136,12095,2457,12737,24832,13912,26796
,YangSheZhen,320582100,340080,30763,206050,109096,247785,166248,48418,163174,329422,213211,419261
,TangQiaoZhen,320582101,134627,13394,84901,38183,84715,60644,15408,59804,120448,78528,163429
,JinGangZhen,320582102,175330,21097,106926,63666,157809,96510,21559,97483,193993,111060,217986
,JinFengZhen,320582103,109185,17128,66692,46118,100446,63851,13055,64168,128019,72676,139368
,LeYuZhen,320582104,62184,12570,41022,28146,72810,40068,7022,39108,79176,40754,81776
,FengHuangZhen,320582105,82633,9959,50831,22151,59516,35680,9079,35218,70898,50840,101671
Ϸ,NanFengZhen,320582106,41471,7442,25342,17259,40399,23707,4529,23518,47225,28100,53442
,DaXinZhen,320582107,40232,5197,23998,11188,32713,18150,4666,17881,36031,26097,50095
żҸִũҵʾ,ZhangJiaGangShiXianDaiNongYeShi,320582400,14742,3267,9981,6643,17881,9859,1725,9580,19439,9753,19734
ɽ,YuShanZhen,320583100,402898,20486,221403,130784,165896,169538,44405,170811,340349,246386,467789
ͳ,BaChengZhen,320583101,85654,8882,49583,27073,50516,39632,8626,40078,79710,53579,103162
,ZhouShiZhen,320583102,122468,6661,68497,47366,46710,60676,15400,62208,122884,76032,144529
½,LuJiaZhen,320583103,78545,4539,41772,28396,27983,35047,7477,36923,71970,48789,90561
,HuaQiaoZhen,320583104,94429,5656,44806,18899,30341,25874,4884,25874,51748,60163,104969
ɽ,DianShanHuZhen,320583105,43256,4099,23811,15293,21320,18692,2712,19098,37790,26256,50067
,ZhangPuZhen,320583106,115150,9328,64387,29055,53912,41062,9342,41138,82200,69433,133820
ׯ,ZhouZhuangZhen,320583107,23096,3286,14579,7558,19197,11111,2217,10998,22109,14020,28599
ǧ,QianDengZhen,320583108,79291,7492,43778,24289,43310,33297,6157,33488,66785,49162,92940
Ϫ,JinXiZhen,320583109,41993,6715,25096,13629,33913,19140,2754,18990,38130,26366,51462
,KaiFaQu,320583400,333826,13935,180708,88167,105864,115799,29201,117630,233429,196254,376962
,SongLingZhen,320584100,117808,12152,72415,46443,85436,64662,16387,63183,127845,73932,146347
ͬ,TongLiZhen,320584101,39763,6673,24671,14956,36523,22114,4019,21863,43977,25784,50455
ƽ,PingWangZhen,320584104,72854,12508,46502,28735,75747,43551,7989,42460,86011,46849,93351
ʢ,ShengZeZhen,320584105,201338,18452,118864,81740,121094,106479,24012,110867,217346,124938,243802
,HengShanZhen,320584106,43491,6179,27743,15924,39408,25835,5829,25481,51316,27756,55499
߶,QiDouZhen,320584107,59490,9306,38299,22768,54932,36682,9204,37138,73820,39701,78000
,ZhenZeZhen,320584108,70839,10510,44029,25556,62314,39205,8677,39775,78980,45997,90026
Դ,TaoYuanZhen,320584109,56685,11518,37675,21601,61563,34443,7006,34015,68458,37534,75209
ں,FenHuZhen,320584110,156053,22509,96041,62786,126248,85504,17128,86126,171630,99649,195690
ÿ,JingJiKaiFaQu,320584400,225226,5577,124641,30518,44511,44392,11287,43837,88229,117449,242090
˿г,DongFangSiChouShiChang,320584401,3020,34,1507,1238,0,1303,357,1309,2612,1904,3411
,ChengXiangZhen,320585100,94005,10365,58688,38059,67374,54249,13985,53164,107413,59667,118355
ɳϪ,ShaXiZhen,320585101,92764,16202,60307,34227,78004,54423,11380,53208,107631,60039,120346
䯺,LiuHeZhen,320585102,52814,8555,32499,23056,41209,30721,5383,30721,61442,34253,66752
,FuQiaoZhen,320585103,78560,14362,47980,31005,61196,45417,9361,46409,91826,54303,102283
,HuangJingZhen,320585104,48591,10365,32695,18121,44489,29927,5812,29365,59292,32073,64768
˫,ShuangFengZhen,320585105,39765,5814,23682,12799,30442,20776,3667,20615,41391,25564,49246
½,LuDuZhen,320585106,38913,2632,20862,10992,13044,14157,4246,15089,29246,24929,45791
ÿ,JingJiKaiFaQu,320585400,94552,8115,56566,35580,59484,50538,12826,50748,101286,58927,115493
,GangQu,320585401,5007,1019,3231,1695,4779,3133,646,3039,6172,3441,6672
ƽ³,KeJiaoXinCheng,320585403,18224,1965,10580,5374,11649,8343,1959,8276,16619,11568,22148
Ƕֵ,ChengDongJieDao,320602001,63297,9387,42287,28627,60834,41635,10052,39681,81316,40449,82736
ƽŽֵ,HePingQiaoJieDao,320602002,50555,7466,33595,22841,46433,32833,7278,31056,63889,31704,65299
θ۽ֵ,RenGangJieDao,320602003,64893,7030,39259,28491,46101,37101,8858,37237,74338,41522,80781
³Žֵ,XinChengQiaoJieDao,320602004,39362,6334,27468,16922,35733,23257,5000,21282,44539,23228,50696
Žֵ,HongQiaoJieDao,320602005,64199,10563,41068,28176,58787,38318,8458,35557,73875,42152,83220
ѧֵ,XueTianJieDao,320602006,58057,4107,36733,16036,38788,22877,5926,22018,44895,31357,68090
ֵ,ZhongXiuJieDao,320602007,41306,2793,24591,15298,19484,19019,4535,19605,38624,24043,48634
ķֵ,WenFengJieDao,320602008,59548,5375,35596,24584,35633,32309,8286,32601,64910,37613,73209
ɽֵ,GuanYinShanJieDao,320602009,55139,7180,34916,22056,46814,32032,7223,31504,63536,34626,69542
ɽֵ,LangShanZhenJieDao,320602010,54915,4728,32014,16096,36662,21846,5095,21855,43701,32724,64738
˽ֵ,ZhongXingJieDao,320602050,31872,2599,19330,9924,18804,13561,3305,13255,26816,18446,37776
¿ֵ,XinKaiJieDao,320602051,42581,3669,21875,12767,28533,17584,4386,17838,35422,28761,50636
нֵ,ZhuXingJieDao,320602052,25234,4610,16988,14419,26221,16898,3960,16718,33616,16816,33804
Сֵ,XiaoHaiJieDao,320602053,28587,4549,18785,13990,28918,16782,3566,16448,33230,17917,36702
ʡӪͨũ,JiangSuShengGuoYingNanTongNongChang,320602450,16952,2839,9039,6428,14016,8361,2075,8264,16625,12827,21866
ͨиֳ,NanTongShiFuMinGangLiangZhongChang,320602451,1008,8,320,13,9,19,72,21,40,768,1088
ͨи,NanTongShiFuMinGangZhongChuChang,320602452,198,6,97,101,0,90,28,124,214,135,232
˽ֵ,YongXingJieDao,320611001,46299,4095,26979,16985,25868,23605,6169,24225,47830,29584,56563
բֵ,TangZhaZhenJieDao,320611002,46317,6513,28475,19676,33671,26509,5571,26972,53481,29926,58401
ֵ,TianShengGangZhenJieDao,320611003,33936,7616,22002,15420,30219,20897,3370,20652,41549,22920,44922
ֵ,QinZaoJieDao,320611004,41185,3846,24297,10657,21788,16143,3424,15741,31884,24158,48455
Žֵ,ChenQiaoJieDao,320611005,21128,5040,14540,8527,25784,14196,2710,13387,27583,14338,28878
Ҹֵ,XingFuJieDao,320611006,21760,4635,14581,9052,22482,13990,2712,13563,27553,14526,29107
ɳ,JinShaZhen,320612100,94213,18520,70333,47379,111042,67332,16195,55757,123089,58595,128928
ͤ,XiTingZhen,320612101,27794,8265,22006,14909,36005,21573,3772,17178,38751,17825,39831
,ErJiaZhen,320612102,45565,13274,37376,26579,60961,36678,8389,28855,65533,29852,67228
,DongSheZhen,320612103,30053,9954,26314,19128,42169,26149,5919,19315,45464,19612,45926
,SanYuZhen,320612104,54031,19799,49364,38673,78062,48720,9965,33679,82399,34431,83795
ʮ,ShiZongZhen,320612107,20097,6651,16992,12764,27370,16780,2867,12420,29200,12623,29615
ﰶ,QiAnZhen,320612108,25714,9919,22233,16430,36824,22180,3305,16601,38781,16705,38938
,WuJiaZhen,320612109,17849,5581,15006,10547,24437,14867,2957,11158,26025,11381,26387
ʯ,ShiGangZhen,320612110,43497,13400,32899,22697,58597,32390,4923,28319,60709,28921,61820
İ,SiAnZhen,320612111,25652,7707,19492,12608,33148,19171,3437,16818,35989,17304,36796
,LiuQiaoZhen,320612112,48681,14761,37250,23959,63784,36301,6404,31346,67647,32596,69846
ƽ,PingChaoZhen,320612114,53424,12294,39254,24068,62737,38030,8280,32837,70867,34744,73998
ƽ,PingDongZhen,320612115,29942,7985,22316,13636,35753,21720,4273,18541,40261,19884,42200
,WuJieZhen,320612116,30219,5836,18933,11884,30113,18314,4214,16023,34337,21336,40269
,XingRenZhen,320612117,33567,7505,23450,14394,38894,22670,4393,21172,43842,22015,45465
˶,XingDongZhen,320612118,23536,5332,17041,10260,27310,15904,3255,13957,29861,15082,32123
֥ɽ,ZhangZhiShanZhen,320612119,37383,8339,26622,19274,43755,25261,5306,22865,48126,24406,51028
,ChuanJiangZhen,320612120,74157,11720,49625,31181,67578,43245,9668,40263,83508,45920,95545
ȷ,XianFengZhen,320612121,39334,7815,27238,16835,45120,26048,5402,24186,50234,25313,52551
ͨп,TongZhouShiKaiFaQu,320612400,57381,8003,37954,25816,62201,36885,9523,33107,69992,36953,74907
ũ,HuanBenNongChang,320612401,1193,221,761,623,1406,733,128,701,1434,781,1542
,HaiAnZhen,320621100,149050,25371,102588,68825,165209,99087,23934,91012,190099,95767,198355
Ƕ,ChengDongZhen,320621101,71636,15248,52125,29629,80310,48852,10305,40953,89805,45064,97189
,QuTangZhen,320621102,64115,17969,49117,33063,82387,47725,8740,39973,87698,41707,90824
,LiBaoZhen,320621103,53576,13090,39815,24242,69184,39185,7668,33769,72954,34519,74334
ϰӸ,LaoBaGangZhen,320621104,12291,3477,9634,6226,16299,9576,1774,7737,17313,7908,17542
б,JiaoXieZhen,320621105,27729,7651,21780,14530,37463,21734,3990,17445,39179,17590,39370
,XiChangZhen,320621106,28330,8223,22370,13422,38303,22259,4122,18052,40311,18305,40675
,DaGongZhen,320621107,41372,10997,30292,19351,54426,29860,5153,26510,56370,27230,57522
ׯ,SunZhuangZhen,320621108,19394,6300,15809,11008,26824,15772,2964,12697,28469,12849,28658
,YaZhouZhen,320621109,33661,10908,26962,18854,47418,26918,5191,22665,49583,22798,49760
,HuJiZhen,320621110,24334,7459,18818,13201,32042,18707,3275,15962,34669,16250,35068
׵,BaiDianZhen,320621111,19202,5280,14132,10252,25573,14058,2473,12580,26638,12823,26955
Ī,NanMoZhen,320621112,34078,9676,25887,17904,45293,25444,4573,21704,47148,22440,48327
ͷ,DunTouZhen,320621113,42841,11202,31042,21433,56885,30913,5310,28029,58942,28311,59353
ũ,HaiAnXianNongChang,320621400,1704,501,1271,899,2205,1268,200,1130,2398,1134,2405
޲,BingChaZhen,320623100,34486,10393,26842,18269,43616,25443,4361,20765,46208,22398,49240
,YangKouZhen,320623101,51126,14495,36393,23816,67939,35574,5560,33210,68784,34788,71181
,JuZhen,320623102,25459,7047,17939,11467,33232,17358,2638,16283,33641,17205,35144
ɳ,ChangShaZhen,320623103,25962,6774,18137,12879,33266,18055,2725,16923,34978,17324,35461
ԥ,DaYuZhen,320623104,56742,17855,46044,33407,78173,45606,8064,35938,81544,36617,82661
,JueGangZhen,320623105,166181,33720,114489,75860,191845,108581,23011,102107,210688,108423,222912
,MaTangZhen,320623107,56093,14955,39687,25549,72199,38893,6426,36748,75641,37787,77474
,FengLiZhen,320623108,57816,15400,40839,25915,75867,40133,6483,38099,78232,38860,79699
ܲ,CaoBuZhen,320623109,30902,8955,22760,16386,41131,22584,3612,20359,42943,20709,43469
,ChaHeZhen,320623110,55253,15435,40441,25735,72907,39371,7053,36367,75738,37300,77741
˫,ShuangDianZhen,320623111,49363,13673,36521,21069,65393,35016,6692,31681,66697,33207,69728
µ,XinDianZhen,320623112,24808,7968,18232,12905,34053,18104,2733,17097,35201,17277,35509
ӿ,HeKouZhen,320623113,41823,11914,30630,20227,55631,30477,4966,27764,58241,28073,58703
Ԭׯ,YuanZhuangZhen,320623114,38931,10579,28664,17547,53052,28558,5148,25769,54327,25994,54658
綫غÿ,RuDongYanHaiJingJiKaiFaQu,320623401,818,15,255,76,0,79,13,85,164,591,846
綫ڸ۾ÿ,RuDongYangKouGangJingJiKaiFaQu,320623402,1407,20,52,0,0,0,2,0,0,1377,1429
綫Ƽ԰,RuDongDongAnKeJiYuanQu,320623403,123,5,4,0,0,0,0,0,0,124,128
,HuiLongZhen,320681100,171304,24198,117601,86797,187316,111715,28999,99540,211255,106900,224501
,BeiXinZhen,320681101,41578,12447,34148,28901,53856,33328,5919,24202,57530,25796,59944
Ƽ,HuiPingZhen,320681102,56890,15020,41884,34915,72636,40357,7045,33759,74116,37071,78955
,YinYangZhen,320681103,52314,14077,36647,28780,61206,35015,5935,28923,63938,35679,72326
,DongHaiZhen,320681104,35860,12175,29344,25312,49478,28318,4788,22281,50599,23479,52823
,JinHaiZhen,320681105,36595,10908,28087,25016,47169,26830,4730,22132,48962,24146,52233
,NanYangZhen,320681106,58089,18159,46420,40046,78472,44849,7771,35629,80478,37599,84019
,HaiFuZhen,320681107,29873,9772,24538,20633,39388,23374,3965,17571,40945,19072,43610
,HeZuoZhen,320681108,36944,11021,30013,25379,47767,29576,5289,22754,52330,23241,53254
,WangBaoZhen,320681109,47850,15650,40468,32896,66426,39747,7340,29375,69122,30372,70840
ĸ,LvSiGangZhen,320681110,97683,26653,75518,57308,127400,70505,16529,58263,128768,65347,140865
¡,QiLongXiang,320681200,3119,380,1793,1983,2068,1787,460,2101,3888,2166,3959
�ÿ,QiDongJingJiKaiFaQu,320681400,28488,3513,18156,12440,21727,15482,3195,13887,29369,17040,35196
,RuChengZhen,320682100,138262,24494,95440,56088,166846,91816,22222,86970,178786,89538,184978
,ChaiWanZhen,320682101,31563,8833,23453,13993,43085,23405,4537,21276,44681,21480,44933
ѩ,XueAnZhen,320682102,19759,6273,16195,9847,27979,16165,3037,12814,28979,12874,29069
,DongChenZhen,320682103,27674,8155,21758,12627,38490,21728,4278,18213,39941,18349,40107
,DingYanZhen,320682104,33113,8989,25414,14565,44360,24738,4953,21078,45816,21641,47055
,BaiPuZhen,320682105,51576,13646,39422,23283,67163,37583,7269,31677,69260,33069,72491
,LinZiZhen,320682106,27060,7898,20775,12003,37925,20701,4257,18335,39036,18440,39215
ԭ,XiaYuanZhen,320682107,38373,9423,28385,16004,52226,28225,6394,25577,53802,25805,54190
Ż,JiuHuaZhen,320682108,40708,11012,32831,19696,55030,31662,7316,25407,57069,26205,59036
԰,GuoYuanZhen,320682109,34000,8095,25295,15906,45986,25192,6315,22956,48148,23115,48410
ʯׯ,ShiZhuangZhen,320682110,38695,8928,28508,16537,52054,27835,7531,25708,53543,26646,55154
,ChangJiangZhen,320682111,61856,11007,38922,22383,71582,37798,8792,36900,74698,42733,81655
Ҥ,WuYaoZhen,320682112,37721,9091,28803,16771,52655,28729,7979,25920,54649,25988,54791
,JiangAnZhen,320682113,50860,12603,38708,24469,70691,37962,10869,34755,72717,35624,74332
,GaoMingZhen,320682114,29228,7741,22814,14741,41370,22724,6251,20242,42966,20406,43220
,ChangQingZhen,320682115,27710,6917,21297,12857,39027,20774,5749,18394,39168,19079,40376
ᾭ,BanJingZhen,320682116,48957,12816,37054,22982,66726,36096,7974,31601,67697,32693,69747
ĥͷ,MoTouZhen,320682117,49876,11591,36725,21572,67791,36280,9143,33315,69595,33885,70610
԰,TaoYuanZhen,320682118,28897,7345,21234,12185,39808,21172,4829,19734,40906,19837,41071
Ԭ,YuanQiaoZhen,320682119,30892,8040,22478,13507,40317,21873,4183,19872,41745,20637,43115
оÿ,RuGaoShiJingJiKaiFaQu,320682400,54385,9450,36730,22332,64340,36122,8587,34776,70898,35692,72422
ͨԭֳ,NanTongShiLiangMianYuanZhongChang,320682402,682,336,572,490,853,571,71,507,1078,517,1089
,HaiMenZhen,320684100,110137,15399,75505,52288,119540,68749,19188,61777,130526,69219,144724
첹,TianBuZhen,320684102,22736,4779,15702,11104,24323,14300,2796,13350,27650,14609,30311
,SanHeZhen,320684103,21077,5535,15776,12848,24831,15366,2881,13138,28504,13717,29493
ʤ,DeShengZhen,320684104,27835,8081,21388,16361,35317,21157,3823,17906,39063,18351,39739
,SanChangZhen,320684105,52597,12891,39085,29809,62143,37490,6925,31615,69105,33328,72413
,ChangLeZhen,320684106,25730,8807,22002,17693,34503,21639,3956,15836,37475,16491,38493
,QiLinZhen,320684107,18385,5333,14576,10868,22993,13792,2679,10896,24688,11821,26397
,YueLaiZhen,320684108,27149,8867,23137,18406,36134,22513,4221,16421,38934,17100,40237
,WanNianZhen,320684109,14577,5004,12923,9846,20538,12787,2563,9029,21816,9221,22144
,SanYangZhen,320684110,16177,5077,13564,10413,21692,13467,2537,10058,23525,10227,23791
ļ,SiJiaZhen,320684111,30378,9132,25123,18550,40093,24208,5433,18773,42981,19820,44943
¡,HuoLongZhen,320684112,16687,4884,14138,9724,23240,14087,3397,10675,24762,10830,24968
ණ,YuDongZhen,320684113,15162,4989,13502,9729,21173,13402,2868,9309,22711,9517,23019
,ZhengYuZhen,320684114,19706,5707,16511,11534,27393,16209,3793,12196,28405,12695,29206
,BaoChangZhen,320684115,30389,8217,25202,17292,40302,24090,5710,17896,41986,19114,44316
,LiuHaoZhen,320684116,25640,9068,22778,17840,36572,22638,4820,16513,39151,16750,39528
,WangHaoZhen,320684119,13045,4394,12016,8634,19231,11805,2951,8090,19895,8374,20390
ѫ,ShuXunZhen,320684120,16330,5802,15538,11025,23773,15125,3772,9854,24979,10366,25904
,HaiYongXiang,320684200,3010,681,2067,1841,3300,2037,483,1858,3895,2107,4174
оü�,HaiMenShiJingJiJiShuKaiFaQu,320684400,57655,5237,36962,25185,45954,32526,10023,29796,62322,35953,72915
ʡӪɳũ,JiangSuShengGuoYingJiangXinShaNongChang,320684413,4316,1050,2903,2557,4685,2870,505,2853,5723,2968,5871
ٽίԱ,HaiMenShiLinJiangXinQuGuanLiWeiYuanHui,320684414,17566,5038,13919,11101,21832,13543,2687,10304,23847,11372,25291
б,HaiMenShiBinHaiXinQuGuanLi,320684415,18237,5081,15227,11019,24037,14941,3603,10784,25725,11694,26921
Źҵ԰ί,HaiMenGongYeYuanQuGuanLiWei,320684416,42318,5697,26691,12813,32087,19007,4395,17552,36559,25719,52410
湵ֵ,XuGouJieDao,320703001,70614,5635,42127,29689,63061,41154,12819,42189,83343,46941,89068
ƽֵ,LianYunJieDao,320703003,20363,3337,12894,9718,18199,12802,3163,13265,26067,13969,26863
ɽֵ,YunShanJieDao,320703004,10810,902,6557,3952,7511,6139,2065,6664,12803,7220,13777
Žֵ,BanQiaoJieDao,320703005,9336,1494,5762,4382,9480,5693,1393,5975,11668,6461,12223
ֵ,LianDaoJieDao,320703006,2808,374,1748,1214,2927,1744,377,1755,3499,1811,3559
ƽֵ,ZhongYunJieDao,320703050,28339,2204,17172,9481,23266,15791,5229,16852,32643,18600,35772
ֵ,HouZuiJieDao,320703051,19110,2779,11744,7754,15191,10588,2535,10739,21327,12680,24424
,ZhaoYangZhen,320703150,14327,1821,9119,5044,16638,9077,2737,9622,18699,9766,18885
޳,SuChengXiang,320703201,4061,403,2025,1206,3340,1903,468,2005,3908,2907,4932
߹,GaoGongDaoXiang,320703202,2046,298,1207,875,2018,1189,245,1279,2468,1382,2589
ǰ,QianSanDaoXiang,320703203,0,3,2,3,3,2,0,1,3,1,3
Ƹۼ,LianYunGangJianChang,320703400,1,1,0,2,1,0,0,2,2,2,2
ũ,DongXinNongChang,320703401,25608,3602,16681,10826,32884,16658,5741,18243,34901,18270,34951
γ,QingKouYanChang,320703450,2736,558,1867,1322,3534,1867,576,2003,3870,2003,3870
ֵֶ,PuDongJieDao,320705001,49406,4527,29956,19094,34243,25559,8610,25971,51530,32587,62543
ֵ,PuXiJieDao,320705002,46142,4859,28556,18128,35595,25601,7225,26558,52159,29670,58226
¶ֵ,XinDongJieDao,320705003,88084,6065,50738,26197,64211,38582,13201,39646,78228,56612,107350
Ͻֵ,XinNanJieDao,320705004,65730,5121,37362,23206,46364,34724,11942,34940,69664,45431,82793
·Ͻֵ,LuNanJieDao,320705005,49896,4157,27718,15145,34348,21385,6780,21149,42534,33115,60833
ºֵ,XinHaiJieDao,320705006,47621,4960,29286,19600,38198,28823,8596,28609,57432,31891,61177
ϳ,NanChengZhen,320705100,5043,682,3466,2063,5221,3462,1271,3514,6976,3530,6996
,PuNanZhen,320705101,34731,4265,23463,13286,46929,23452,9778,25275,48727,25311,48774
̨,YunTaiXiang,320705200,20803,2319,13677,7482,25442,13655,5481,14834,28489,14926,28603
ɽ,HuaGuoShanXiang,320705201,26665,1788,16596,5405,17488,8867,2984,9313,18180,14841,31437
̨ũ,YunTaiNongChang,320705400,3536,551,2413,1546,4094,2406,884,2533,4939,2558,4971
ֳ̨,NanYunTaiLinChang,320705401,3059,380,2067,1169,3237,2041,780,2129,4170,2152,4219
ڲũ,GangBuNongChang,320705402,15151,2236,10244,6261,20708,10234,4477,11601,21835,11620,21864
־ÿ,XinPuJingJiKaiFaQu,320705403,5428,652,3700,1921,7228,3695,1514,3812,7507,3894,7594
ݽֵ,HaiZhouJieDao,320706001,14830,2227,10197,6735,14751,10097,3209,9848,19945,10069,20266
Ҹ·ֵ,XingFuLuJieDao,320706002,14528,1584,9409,6028,12134,9071,2728,9021,18092,9431,18840
ֵ,QuYangJieDao,320706003,24722,2326,15762,9782,16750,15645,4933,15740,31385,16219,31981
Žֵ,HongMenJieDao,320706004,13264,1353,8508,5535,10114,8380,2721,8666,17046,8830,17338
°,XinBaZhen,320706100,19700,2621,13114,7356,24850,13112,4525,13709,26821,13732,26846
,JinPingZhen,320706101,20639,3198,13796,8111,24771,13583,4370,14092,27675,14411,28207
,BanPuZhen,320706102,41356,4743,27875,15366,51799,26695,11022,27880,54575,29246,57121
,NingHaiXiang,320706200,17835,1864,11891,6013,22613,11882,4650,12390,24272,12458,24349
ݾÿ,HaiZhouJingJiKaiFaQu,320706400,4796,445,2908,1537,4325,2506,857,2691,5197,3190,6098
,QingKouZhen,320721100,132217,13345,84737,51598,158825,79776,33069,86630,166406,93894,178631
,ZheWangZhen,320721101,33733,4688,23107,16309,44771,22737,9253,23571,46308,24567,47674
ʯ,ShiQiaoZhen,320721102,35316,5993,27547,18840,50725,27547,11884,25623,53170,25646,53193
ɽ,JinShanZhen,320721103,26009,4377,21514,13847,37801,21184,9299,17576,38760,18171,39685
,HeiLinZhen,320721104,23470,3875,18041,11418,33987,18038,7674,16973,35011,16978,35019
ׯ,LiZhuangZhen,320721105,21602,3247,16463,10341,28512,15659,6932,14418,30077,15318,31781
ͷ,HaiTouZhen,320721106,48997,7333,36603,22857,68714,36195,15089,34204,70399,34816,71419
ɽ,TaShanZhen,320721107,30320,5365,24339,16040,44368,24321,9600,20857,45178,20946,45285
,GanMaZhen,320721108,49606,7305,35487,21720,66173,34379,13664,33790,68169,35088,70575
ׯ,BanZhuangZhen,320721109,30291,5173,23383,16077,44304,23357,9940,21945,45302,22021,45404
ͷ,ChengTouZhen,320721110,30231,4008,21655,13269,39386,20264,8771,19119,39383,21355,43010
ź,MenHeZhen,320721111,19867,3206,15599,10425,28993,15599,6705,14178,29777,14179,29778
,ChengXiZhen,320721112,22946,3702,17833,11277,32948,17822,7285,16076,33898,16100,33933
,HuanDunZhen,320721113,19874,3564,16052,10756,29027,16051,6901,14286,30337,14287,30339
ׯ,SongZhuangZhen,320721114,22169,3048,16230,9704,27176,15231,5789,14112,29343,14776,31006
ɳ,ShaHeZhen,320721115,66604,10119,48470,31240,94205,48427,20045,48240,96667,48298,96768
,DunShangZhen,320721116,20841,3242,15756,10309,29708,15744,6453,14712,30456,14780,30536
,LuoYangZhen,320721117,21224,3095,15203,10200,29072,15153,5880,14946,30099,14996,30199
ɳ԰ճ,ShaHeZiYuanYiChang,320721400,1652,258,1197,691,2297,1197,471,1184,2381,1184,2381
ţɽ,NiuShanZhen,320722100,110752,10292,72149,42360,121233,69572,28467,73187,142759,77362,149511
,BaiTaBuZhen,320722101,36037,4912,24395,14195,46518,23433,9282,24618,48051,25836,50231
ƴ,HuangChuanZhen,320722103,36696,5699,26949,15249,50894,26868,10726,26085,52953,26172,53121
ʯ,ShiLiangHeZhen,320722104,23116,3696,17611,10043,33298,17608,7538,16730,34338,16739,34350
,QingHuZhen,320722105,29679,5007,23479,13669,44095,23437,10636,21843,45280,21843,45322
ʯ,ShiLiuZhen,320722106,45783,5482,31610,14000,52137,29441,11782,28983,58424,31437,63047
Ȫ,WenQuanZhen,320722107,8881,1350,7116,3941,12678,7068,3523,6571,13639,6638,13754
˫,ShuangDianZhen,320722108,28125,4202,21300,11711,40942,21198,10076,20987,42185,21103,42403
,TaoLinZhen,320722109,39250,5913,28710,16582,56497,28674,12296,28705,57379,28749,57459
ׯ,HongZhuangZhen,320722110,16102,2757,12273,7107,23326,12271,5371,11930,24201,11957,24230
,AnFengZhen,320722111,37427,6280,28467,15724,52985,27933,11910,26626,54559,27150,55617
ɽ,FangShanZhen,320722112,41313,6885,30932,16808,58170,30473,12679,29497,59970,29945,60877
ƽ,PingMingZhen,320722113,40878,6465,29387,15606,58186,29341,12397,30244,59585,30353,59740
շ,TuoFengXiang,320722200,33498,5245,23931,14447,43346,23928,9501,24231,48159,24313,48244
ϳ,NanChenXiang,320722201,9824,1657,7965,4399,14438,7965,3699,7215,15180,7215,15180
ṵ,HengGouXiang,320722202,18032,2827,13946,8526,26213,13944,6540,13442,27386,13453,27399
,LiNianXiang,320722203,20400,2810,15815,9623,30001,15756,7969,15201,30957,15364,31179
ɽ,ShanZuoKouXiang,320722204,21243,3591,16172,9070,30775,16166,7186,15825,31991,15848,32020
ʯ,ShiHuXiang,320722205,16457,2697,12540,6448,23819,12540,5374,11988,24528,11988,24528
,QuYangXiang,320722206,19827,3310,15100,8806,27338,15096,6188,14201,29297,14225,29325
,ZhangWanXiang,320722207,16442,2666,12681,7378,23333,12554,4989,11246,23800,11416,24097
նÿ,JiangSuDongHaiJingJiKaiFaQu,320722401,8211,688,5954,2158,7240,4528,2135,4782,9310,5080,11034
ɽ,YiShanZhen,320723100,100371,11369,65841,39206,121908,64476,25495,68135,132611,71394,137235
,YangJiZhen,320723102,32499,4386,23257,13818,45361,23245,10615,24238,47483,24243,47500
β,YanWeiGangZhen,320723103,7163,773,4591,2938,8927,4590,1450,4787,9377,4795,9386
ͬ,TongXingZhen,320723104,19495,2567,13812,7226,26988,13794,5943,14166,27960,14193,28005
Ķ,SiDuiZhen,320723105,16008,2330,11366,6841,21579,11164,5186,11953,23117,12158,23524
׷,WeiFengZhen,320723106,26222,3122,18475,9808,34728,18459,7992,18791,37250,18861,37336
,LongJuZhen,320723107,22435,3778,16683,9054,32654,16665,7606,17072,33737,17136,33819
«,YiLuXiang,320723201,22519,2753,15564,8267,30260,15519,6436,16077,31596,16144,31708
³,LuHeXiang,320723202,14480,2588,10992,6454,21021,10946,4743,10721,21667,10819,21811
ͼ,TuHeXiang,320723203,27458,3903,20698,11869,37614,20695,9550,20183,40878,20213,40911
ʱ,YiBeiXiang,320723204,19233,3124,15220,8979,28005,15209,7866,14953,30162,15003,30223
³,XiaCheXiang,320723205,26913,3453,19573,11069,37495,19542,8517,19247,38789,19310,38883
,BaiXianXiang,320723206,24048,2974,17081,8990,33218,17074,7648,17562,34636,17589,34670
,DongWangJiXiang,320723207,38597,4439,27206,14347,51754,27197,12320,28118,55315,28150,55356
ׯ,ShiZhuangXiang,320723208,32522,3733,22042,11908,37772,21113,9151,21992,43105,23364,45406
С,XiaoYiXiang,320723209,34453,4351,24068,13127,45690,24025,9972,24628,48653,24708,48776
,MuWeiXiang,320723210,18286,2721,13207,7340,25421,13015,5848,13257,26272,13648,26855
,DouGouXiang,320723211,27973,4834,20799,11399,41261,20645,9975,21766,42411,21983,42782
ϸ,NanGangXiang,320723212,22412,3367,16360,9252,32047,16347,7325,16710,33057,16744,33104
ͼũ,WuTuHeNongChang,320723401,3043,493,1938,1551,3000,1938,463,2061,3999,2061,3999
γ,GuanXiYanChang,320723402,4911,853,3063,2498,5900,3063,605,3306,6369,3306,6369
ƾÿ,GuanYunJingJiKaiFaQu,320723403,1373,72,750,299,2,516,199,562,1078,894,1644
ٸ۲ҵ,GuanYunLinGangChanYeQu,320723404,3243,13,634,0,0,0,0,0,0,2622,3256
°,XinAnZhen,320724100,145629,12882,92853,57444,154740,90206,36339,97791,187997,101997,194850
ѹ,DuiGouGangZhen,320724101,27771,2935,17544,10164,32898,17016,7426,17660,34676,20588,38132
ï,ChangMaoZhen,320724102,24002,2812,17185,8791,32803,17178,7983,17572,34750,17612,34797
¼,BeiChenJiZhen,320724103,18434,2618,13781,7735,27213,13689,6714,13832,27521,13985,27766
ŵ,ZhangDianZhen,320724104,18609,2609,13090,7745,26021,13072,6021,14122,27194,14149,27239
,SanKouZhen,320724105,30122,4254,22721,12885,40552,22711,10871,22461,45172,22526,45247
ׯ,MengXingZhuangZhen,320724106,25455,4333,20178,12785,37041,20171,9595,19145,39316,19205,39383
,TangGouZhen,320724107,13900,2147,10259,6752,19941,10254,4315,10082,20336,10103,20362
»,BaiLuZhen,320724108,30468,4487,23202,13252,43234,23153,10631,22241,45394,22384,45586
,WuDuiXiang,320724200,17756,3393,14649,9669,26404,14648,7187,13682,28330,13687,28336
¥,TianLouXiang,320724201,12674,2509,10132,6875,18728,10108,5377,10379,20487,10428,20560
,LiJiXiang,320724204,34218,4682,24770,13544,47952,24483,11632,25308,49791,25762,50532
¼,XinJiXiang,320724206,15117,2663,12109,7747,22513,12109,5622,11293,23402,11293,23402
԰,HuaYuanXiang,320724207,17836,2743,12994,7685,24179,12828,5525,12925,25753,13110,26104
ǰֵ´,FuQianJieDaoBanShiChu,320802001,58082,5607,35936,21992,41282,31165,10040,31600,62765,37793,73729
ֵ´,ChangXiJieDaoBanShiChu,320802002,25313,3401,16813,10651,26720,15810,4773,15642,31452,16674,33487
ֵ´,HuaiHaiJieDaoBanShiChu,320802003,70728,5758,42962,26097,54730,36819,10692,37832,74651,44216,87178
ֵ´,ChangDongJieDaoBanShiChu,320802004,12869,1631,7684,5023,13860,7359,1974,7336,14695,8790,16474
ֵ´,LiuShuWanJieDaoBanShiChu,320802005,51492,4439,32498,20868,43975,31172,9862,31721,62893,33295,65793
ˮɿڽֵ´,ShuiDuKouJieDaoBanShiChu,320802006,18592,1776,10590,6555,13617,10211,2909,10241,20452,12687,23277
غֵ´,BaiLuHuJieDaoBanShiChu,320802007,10642,759,6292,3341,8707,5619,1926,5659,11278,7035,13327
ֵ´,DongHuJieDaoBanShiChu,320802050,33266,1995,19207,9789,22198,15739,5814,16725,32464,21868,41075
¸۽ֵ´,XinGangJieDaoBanShiChu,320802051,6597,685,4233,2405,6791,4214,1210,4221,8435,4259,8492
·ֵ´,GuangZhouLuJieDaoBanShiChu,320802052,16856,1723,10417,5098,19225,9774,3086,10252,20026,11248,21665
ö·ֵ´,MeiChengLuJieDaoBanShiChu,320802053,66561,2141,35205,7559,22968,14166,4379,14000,28166,37876,73081
´,ZhangMaBanShiChu,320802054,2345,328,1513,902,2966,1505,382,1521,3026,1542,3055
,BoChiXiang,320802350,4564,466,2844,1442,4454,2830,911,2914,5744,3097,5941
,XuYangXiang,320802351,40282,2149,20274,7673,24731,13052,4382,14201,27253,26539,46813
�,NanMaChangXiang,320802352,12255,1513,8022,4460,15910,8012,2857,8575,16587,8603,16625
,HuaiChengZhen,320803100,171011,19646,109025,65531,191864,103737,29427,103374,207111,111059,220084
ƽ,PingQiaoZhen,320803101,20737,3683,14393,8960,27354,14390,3992,13974,28364,14019,28412
Ϻ,ShangHeZhen,320803102,14287,2895,10475,6268,19670,10377,3280,9809,20186,9987,20462
,MaDianZhen,320803103,17120,2984,11964,7033,22858,11837,3801,11764,23601,11941,23905
,ZhuQiaoZhen,320803104,22258,4237,16369,10255,31429,16368,5722,15825,32193,15848,32217
Ϫ,XiHeZhen,320803105,14455,2993,10603,7131,20274,10603,3299,10144,20747,10144,20747
ʩ,ShiHeZhen,320803106,24585,4135,17323,10013,33661,17273,5658,16881,34154,17055,34378
,CheQiaoZhen,320803107,32480,5601,22949,13425,42486,22033,7100,21182,43215,22232,45181
,JingKouZhen,320803108,21462,4303,16189,9511,30466,14912,5943,13943,28855,15519,31708
,LiuJunZhen,320803109,26719,5776,20238,12627,39136,19767,7337,19063,38830,19594,39832
,BoLiZhen,320803110,24107,4193,17387,10922,33873,17387,6459,17372,34759,17372,34759
,ChouQiaoZhen,320803111,22130,3657,15872,9065,31179,15511,5998,15537,31048,15913,31785
,FuXingZhen,320803112,19183,3195,14430,8351,26795,14414,5798,13698,28112,13746,28176
,SuZuiZhen,320803113,20984,3559,15076,8811,29514,15076,6028,15495,30571,15495,30571
չ,QinGongZhen,320803114,21679,3174,15189,8520,27951,14581,5586,14553,29134,15250,30439
˳,ShunHeZhen,320803115,26694,3673,18704,9929,36459,18704,7642,19305,38009,19305,38009
,JiQiaoZhen,320803116,19925,3098,14121,8185,27380,14047,5375,13981,28028,14277,28398
ϯ,XiQiaoZhen,320803117,14231,1759,9505,5242,18757,9496,3515,9982,19478,10000,19505
ּ,LinJiZhen,320803118,12313,2323,8645,5173,16466,8608,2657,8587,17195,8648,17293
բ,NanZhaZhen,320803119,15833,3273,11777,7409,21749,11777,3249,10578,22355,10578,22355
,FanJiZhen,320803120,19414,2771,12756,6870,22403,12029,3440,11708,23737,12869,25625
,JianHuaiXiang,320803200,18618,3482,12914,8115,25023,12880,3795,12862,25742,12981,25895
,JiaoLingXiang,320803201,16689,2790,12193,6716,23369,12117,5160,12376,24493,12446,24639
μ,SongJiXiang,320803202,21993,3393,16158,9112,30956,16008,6977,15963,31971,16205,32363
Ƕ,ChengDongXiang,320803203,45358,4122,28336,14246,41684,25769,8612,26317,52086,29756,58092
,SanBaoXiang,320803204,18884,3030,13391,7164,25383,13391,4119,12616,26007,12642,26033
ũ,BaiMaHuNongChang,320803400,10109,2174,7158,4049,13565,6546,1837,6444,12990,6962,14120
Ӫ,WangYingZhen,320804100,162234,13093,105951,56421,138896,90864,31711,91856,182720,101087,207038
Լ,ZhaoJiZhen,320804101,19051,3879,14784,8637,27377,14779,5932,14074,28853,14078,28862
,WuChengZhen,320804102,13813,3523,11482,7081,21167,11479,4665,10467,21946,10519,22001
ϳ¼,NanChenJiZhen,320804103,29197,5878,22054,13253,41888,22038,8305,21300,43338,21326,43380
ͷ,MaTouZhen,320804104,16902,2535,11076,5801,22387,11039,3460,11798,22837,11821,22897
,WangXingZhen,320804105,19947,3272,14314,8096,27195,14314,5807,14712,29026,14712,29026
޻ׯ,MianHuaZhuangZhen,320804106,26014,4002,18479,9962,32516,17840,6952,17805,35645,18489,36968
,DingJiZhen,320804107,20561,3065,14203,7742,26366,14173,4960,14214,28387,14383,28586
,WuLiZhen,320804108,14978,2807,11281,6916,20813,11279,4533,11021,22300,11037,22318
,XuLiuZhen,320804109,16763,3729,13825,8254,25441,13759,6315,12797,26556,12982,26807
湵,YuGouZhen,320804110,32212,5092,23582,12909,43536,23544,9627,23197,46741,23349,46931
⼯,WuJiZhen,320804111,15702,3263,12451,7828,23088,12450,5272,11775,24225,11786,24237
μ,XiSongJiZhen,320804112,20703,4953,18293,11042,33310,18275,8987,16289,34564,16350,34643
,SanShuZhen,320804113,22460,4138,16368,9404,31061,16339,6352,16559,32898,16582,32950
,HanQiaoXiang,320804200,13897,3138,11415,6449,20874,11414,4824,10431,21845,10444,21859
¶,XinDuXiang,320804201,18467,2549,12505,6976,23458,12429,4448,12844,25273,12959,25464
ż,LaoZhangJiXiang,320804202,15724,2753,11584,6574,22274,11584,4625,11517,23101,11518,23102
,LingQiaoXiang,320804203,17776,3017,12850,7098,23831,12844,5031,12967,25811,12974,25824
Ԭ,YuanJiXiang,320804204,19054,2466,12811,6387,24023,12811,4260,12969,25780,12969,25780
ׯ,LiuLaoZhuangXiang,320804205,14634,2660,10864,5877,20115,10859,4081,10494,21353,10511,21375
կ,GuZhaiXiang,320804206,10565,2060,8518,4677,15960,8518,3525,7632,16150,7632,16150
ҵ԰ίԱ,GongYeYuanGuanLiWeiYuanHui,320804400,18035,1627,11718,5994,18320,11023,3887,11142,22165,11831,23549
彭ֵ´,QingJiangJieDaoBanShiChu,320811001,22329,3405,15326,9775,25835,15163,4377,14581,29744,14785,30111
¥ֵ´,PuLouJieDaoBanShiChu,320811002,24534,3164,15867,10878,25154,15594,4100,15150,30744,15931,31798
բڽֵ´,ZhaKouJieDaoBanShiChu,320811003,32570,3792,20537,13933,29755,19716,5087,19311,39027,20912,41449
尲ֵ´,QingAnJieDaoBanShiChu,320811004,62076,6996,39798,25296,54357,39140,10544,39095,78235,39818,79616
ƽ,HePingZhen,320811100,22085,2709,14678,7371,29317,14670,5045,15107,29777,15161,29839
,WuDunZhen,320811101,15727,1712,10162,5608,20134,10149,3537,10723,20872,10814,20976
κ,YanHeZhen,320811102,14768,2029,9930,4885,19079,9372,3441,9503,18875,10308,20238
,ChengNanXiang,320811200,24169,2453,15831,7806,29579,15788,4839,15109,30897,15630,31461
,HuangMaXiang,320811201,21500,2770,14156,7058,27918,14149,4413,14496,28645,14527,28683
·´,NingLianLuBanShiChu,320811450,11886,1756,8372,4322,16132,8372,2851,8121,16493,8121,16493
,LianChengZhen,320826100,86644,8130,57508,32790,87030,54641,22025,55480,110121,59291,116799
߹,GaoGouZhen,320826101,37218,4828,26537,14192,47607,26514,9636,25078,51592,25145,51682
Ƽ,TangJiZhen,320826102,15177,2658,11854,6577,21442,11606,5032,10630,22236,11013,22867
̲,BaoTanZhen,320826103,15055,2272,10932,5653,21034,10894,4312,10613,21507,10707,21639
,DaDongZhen,320826104,15830,2666,11600,6545,21865,11600,4443,11339,22939,11339,22939
,WuGangZhen,320826105,17025,2730,12605,7506,24183,12605,5019,12169,24774,12169,24774
,LiangChaZhen,320826106,19109,3558,14759,8956,27520,14656,6263,14067,28723,14171,28930
ʯ,ShiHuZhen,320826107,8725,1566,6714,3757,12663,6074,2629,5502,11576,6206,12920
,ZhuMaZhen,320826108,23138,2611,15674,8493,23234,15207,6146,15689,30896,16221,31895
,ChaMiaoZhen,320826109,21034,3904,17338,9670,29988,17337,7835,15435,32772,15435,32773
,DongHuJiZhen,320826110,13338,2774,10943,6540,20142,10942,4729,9898,20840,9898,20841
ϼ,NanJiZhen,320826111,13436,2628,10495,6413,19355,10494,4436,10004,20498,10005,20500
,YiXingZhen,320826112,12416,1880,9049,4970,16913,9049,3403,8650,17699,8650,17699
ɼ,ChengJiZhen,320826113,11764,2111,9426,5164,17375,9426,4442,8890,18316,8891,18317
Ҥ,HongYaoZhen,320826114,16005,2974,12824,7409,22962,12804,5578,11661,24465,11733,24557
ʦ,ChenShiZhen,320826115,14583,2553,11528,6538,21142,11528,4771,10379,21907,10379,21907
ǰ,QianJinZhen,320826116,13132,2499,10978,5928,18733,10973,4934,9566,20539,9587,20565
켯,XuJiXiang,320826200,17921,3469,14388,8614,26504,14377,6503,13467,27844,13505,27893
Ӫ,HuangYingXiang,320826201,15589,3140,12360,7440,23021,12360,5260,11629,23989,11629,23989
ڰ´,YangKouBanShiChu,320826400,13854,2677,11415,6653,20324,11407,5094,10132,21539,10210,21625
ɰ´,FangDuBanShiChu,320826401,11336,2170,9393,5463,17129,9393,4452,8565,17958,8565,17958
»´,NanLuBanShiChu,320826402,11292,2046,9119,5429,16844,9119,4081,8300,17419,8300,17419
Сҵ԰ί,XiaoLiJiGongYeYuanQuGuanWei,320826403,22888,2967,15951,7950,28007,15105,6272,14874,29979,16176,32127
´,HeWangBanShiChu,320826404,11848,1746,8739,4377,16050,8739,3550,8405,17144,8405,17144
ʱ´,ShiMaBanShiChu,320826405,15415,2386,11627,6287,21775,11607,4804,10933,22540,10978,22605
´,BeiJiBanShiChu,320826406,11164,1789,8444,4875,15641,8428,3454,7934,16362,7963,16407
Ҷհ´,HuiDunBanShiChu,320826407,14182,1980,10350,5402,19586,10350,4247,10059,20409,10059,20409
װ´,YuWeiBanShiChu,320826408,8892,1991,7710,4699,14415,7700,3867,7026,14726,7040,14750
ǳ´,QianJiBanShiChu,320826409,17002,2873,13400,6969,23783,13384,5995,12435,25819,12470,25870
ҵ԰ί,JiChangChanYeYuanQuGuanWeiHui,320826410,18674,3034,14132,7550,26332,14132,5714,13289,27421,13290,27422
ũҵί,MaDuoNongYeKaiFaQuGuanWei,320826411,12252,2452,9809,6267,18615,9809,4548,9443,19252,9443,19252
ÿ,JingJiKaiFaQu,320826412,33050,2251,21584,10302,26692,18891,8012,18991,37882,21729,43313
,GaoLiangJianZhen,320829100,96922,10747,65157,41097,96282,64002,20429,61702,125704,62941,128098
,JiangBaZhen,320829101,3869,1126,3052,2387,5308,3033,700,2629,5662,2643,5695
ʺ,RenHeZhen,320829102,12648,2866,9475,6485,17852,9449,2818,8788,18237,8857,18332
,ChaHeZhen,320829103,18008,4025,13467,9373,24976,13416,3630,12044,25460,12196,25663
˳,XiShunHeZhen,320829104,5272,841,3632,2304,7088,3632,1137,3618,7250,3618,7250
ɽ,LaoZiShanZhen,320829105,10308,1719,7233,4669,14267,7214,2582,7333,14547,7376,14609
,SanHeZhen,320829106,11469,2033,8229,5165,15544,8218,2428,7667,15885,7701,15930
,ZhuBaZhen,320829107,18547,2969,12832,7348,24354,12742,3826,12346,25088,12510,25342
Ƽ,HuangJiZhen,320829108,10398,2153,7617,5120,13515,7610,2137,7064,14674,7071,14688
,WanJiZhen,320829109,16232,2748,11430,6527,22425,11311,3590,10852,22163,11140,22570
˫,DongShuangGouZhen,320829110,19499,3594,14019,8181,27169,14011,4464,13531,27542,13538,27557
,GongHeZhen,320829111,14004,2673,9836,6417,18614,9806,2558,9330,19136,9399,19235
󾭼ÿ,HongZeJingJiKaiFaQu,320829400,1481,4,732,411,0,191,5,333,524,758,1490
,XuChengZhen,320830100,110539,10392,70920,37114,99696,60101,20434,59580,119681,70445,141365
,MaBaZhen,320830101,49306,5996,32684,18695,58341,30450,10101,30484,60934,32719,65403
̲,GuanTanZhen,320830102,22925,3573,16402,8514,31169,16392,5697,15764,32156,15793,32195
,JiuPuZhen,320830103,19910,3410,13761,8109,26573,13542,3914,13278,26820,13473,27234
,GuiWuZhen,320830104,19431,3382,13632,7774,26671,13565,4759,13806,27371,13940,27572
,GuanZhenZhen,320830105,15223,2998,11902,6230,22220,11842,5155,11312,23154,11474,23376
,HeQiaoZhen,320830106,18919,3325,13810,7843,26870,13731,5402,13685,27416,13836,27646
,BaoJiZhen,320830107,24488,4737,20154,11351,37217,20154,10074,19145,39299,19145,39299
ƻ,HuangHuaTangZhen,320830108,20331,3234,14272,7950,27174,14272,4345,13632,27904,13638,27910
,MingZuLingZhen,320830109,18529,3106,14053,6929,27086,14053,6156,13738,27791,13738,27791
,TieFoZhen,320830110,17655,3419,14273,6932,26530,14230,6928,13603,27833,13729,28002
,HuaiHeZhen,320830111,17098,2683,11779,6631,22102,11465,4108,11394,22859,12110,23889
,ChouJiZhen,320830112,14072,2889,10383,6431,19930,10330,3641,10103,20433,10219,20602
,GuanYinSiZhen,320830113,17419,3132,12279,7007,23525,12256,3558,11740,23996,11830,24109
ά,WeiQiaoXiang,320830200,15703,2238,10761,5930,20303,10733,3417,10558,21291,10597,21358
µ,MuDianXiang,320830201,15122,2459,10364,5785,20183,10344,3225,10332,20676,10442,20806
,WangDianXiang,320830202,17523,3226,12751,7473,23874,12705,4776,12666,25371,12774,25525
ɣ,GuSangXiang,320830203,15028,2172,10165,5625,18730,10150,3258,10192,20342,10293,20458
¡,XingLongXiang,320830204,14597,3037,11526,6115,22049,11503,5258,11331,22834,11366,22892
ũ,SanHeNongChang,320830400,6377,1197,4382,2992,8219,4373,1047,4225,8598,4239,8621
,HuaiHuaJiTuan,320830401,1990,348,1357,1066,2091,1334,368,1294,2628,1349,2706
,LiChengZhen,320831100,97547,8543,62903,42959,83103,60192,17880,57538,117730,61067,123970
,JinNanZhen,320831101,18570,5364,13702,9892,24990,13658,2186,12348,26006,12418,26120
,MinQiaoZhen,320831102,13045,3623,9699,6963,17588,9617,1644,8445,18062,8613,18312
,TaJiZhen,320831103,13805,3818,10238,7387,18786,10181,1840,9139,19320,9225,19463
,YinJiZhen,320831104,11990,2874,8364,5862,15801,8309,1523,7930,16239,8023,16387
Ϳ,TuGouZhen,320831105,12299,2975,8750,6582,16265,8727,1715,8091,16818,8239,16989
ǰ,QianFengZhen,320831106,15337,3049,10379,7148,19843,10359,2031,10001,20360,10038,20417
,LvLiangZhen,320831107,10447,2407,7373,5364,13847,7370,1586,7066,14436,7067,14440
,ChenQiaoZhen,320831108,12644,3065,8920,6708,16695,8882,1841,8510,17392,8630,17550
,JinBeiZhen,320831109,13009,2667,8801,5656,16816,8779,1733,8538,17317,8608,17409
¥,DaiLouZhen,320831110,13609,2356,8938,5442,16982,8847,1937,8728,17575,8964,17902
Ӧũ,BaoYingHuNongChang,320831400,3682,1105,2642,2255,4924,2642,350,2485,5127,2495,5137
ũ,FuXingWeiNongChang,320831401,514,107,353,311,581,350,91,347,697,359,712
ԭֳ,LiangMianYuanZhongChang,320831402,839,131,561,332,1036,561,116,525,1086,525,1086
ÿ,JinHuJingJiKaiFaQu,320831403,4740,266,2395,1665,2209,1905,351,2083,3988,2962,5357
ǽֵ,WuXingJieDao,320902001,33713,2881,20853,14598,28825,20429,5951,21328,41757,21692,42545
ķֵ,WenFengJieDao,320902002,73868,9219,48057,32426,77220,46498,13436,46556,93054,48466,96523
ȷֵ,XianFengJieDao,320902003,37655,4647,24394,15930,35532,23301,6386,23496,46797,24294,48688
عֵ,YuLongJieDao,320902004,69182,7745,43925,30516,75596,43427,12717,44602,88029,45719,89644
ƺֵ,HuangHaiJieDao,320902006,35576,2480,22657,15085,30600,22095,7755,22394,44489,23154,45811
ֵ,XinYangJieDao,320902007,37655,3579,23626,15310,36294,23109,6777,23692,46801,24385,48011
ֵ,DaYangJieDao,320902008,56598,3274,34064,19087,41292,26468,8104,27161,53629,33912,67976
,NanYangZhen,320902100,25663,2620,14840,7171,21697,11803,3583,12312,24115,17026,31866
,QingDunZhen,320902101,34517,5874,22803,15297,44118,22798,6489,24054,46852,24077,46880
,XinXingZhen,320902102,27500,3973,18017,10744,31892,17377,5420,18087,35464,18876,36893
,YongFengZhen,320902103,20186,3925,13398,8962,26384,13396,3377,14085,27481,14090,27488
,BianCangZhen,320902104,23397,4272,15362,10459,30370,15355,3745,16035,31390,16052,31414
,WuYouZhen,320902105,25576,3607,15911,9365,27108,14731,3693,15149,29880,16965,32876
,BuFengZhen,320902106,40485,6548,26081,16744,50698,25940,6227,27001,52941,27179,53260
ζ,YanDongZhen,320902107,32855,5780,22089,14285,42929,22075,5717,22215,44290,22263,44352
Ƽ,HuangJianZhen,320902108,19531,3729,13210,9186,24619,13194,2887,12897,26091,12937,26147
ͤ,TingHuXinQu,320902400,34341,1675,17686,7237,19948,11932,4005,12435,24367,22335,40021
п,ShiKaiFaQu,320902401,59661,5269,37306,19506,50493,30694,10268,32327,63021,37892,75198
ҵ԰,HuanBaoChanYeYuan,320902402,14054,2257,9380,5375,18293,9380,2610,9539,18919,9541,18921
¶ֵ,XinDouJieDao,320903001,51208,3412,33348,17374,34855,25194,8791,25928,51122,30063,63411
ׯֵ,ZhangZhuangJieDao,320903002,25618,2512,16186,8421,26132,13851,5247,14472,28323,17191,33377
ݺ,DaZongHuZhen,320903100,15436,3483,10701,7585,20943,10647,2817,10943,21590,11035,21736
,BeiLongGangZhen,320903101,18752,3508,12640,8300,24828,12481,3257,12706,25187,12877,25517
¥,LouWangZhen,320903102,21943,4989,15025,12068,29026,14934,3233,14948,29882,15140,30165
ѧ,XueFuZhen,320903103,16498,3841,12069,9201,20594,11373,3027,10397,21770,11297,23366
,YiFengZhen,320903104,25109,4741,16912,11074,33096,16413,4614,16776,33189,17552,34464
ׯ,ShangZhuangZhen,320903105,19166,4394,13195,9459,25872,11925,3411,12152,24077,13776,26971
,GeWuZhen,320903106,11497,3426,9034,7020,17000,9034,2744,8633,17667,8633,17667
,BeiJiangZhen,320903107,15673,4045,11430,8682,21636,11404,3177,11392,22796,11465,22895
,QinNanZhen,320903108,51385,10229,34323,23097,67111,32116,8327,33117,65233,35618,69941
,LongGangZhen,320903109,55643,8931,35304,22542,65945,32464,8387,34031,66495,37657,72961
˻,PanHuangZhen,320903110,58478,4159,36225,22553,38891,33882,12162,35638,69520,38574,74799
,GuoMengZhen,320903111,31469,5299,20669,12490,41576,20429,6381,22138,42567,22480,43149
,DaGangZhen,320903112,55624,10620,37342,23637,73602,35832,10494,37512,73344,39396,76738
ί,XinQuGuanWeiHui,320903400,27310,2648,17327,7654,21926,12647,3940,13234,25881,16571,33898
,XiQu,320903401,29976,4900,19607,11559,37778,19437,5391,20159,39596,20660,40267
ˮ,XiangShuiZhen,320921100,69596,5945,46168,27239,68740,44656,18166,45614,90270,47539,93707
¼Ҹ,ChenJiaGangZhen,320921101,42873,4892,26474,15860,49654,26074,11097,27186,53260,32388,58862
С,XiaoJianZhen,320921102,40346,4767,27691,14931,51210,26147,11402,26691,52838,28824,56515
,HuangWeiZhen,320921103,18785,2942,13474,7120,25041,13332,5486,13320,26652,13739,27213
,DaYouZhen,320921104,14411,2163,10361,6469,18487,10354,4315,10522,20876,10528,20889
˫,ShuangGangZhen,320921105,16268,2534,11832,6631,22216,11627,5509,12071,23698,12479,24311
Ϻ,NanHeZhen,320921106,30343,4371,21403,12525,40089,21399,9221,22509,43908,22532,43935
˺,YunHeZhen,320921107,23482,2957,15968,9471,29718,15645,6602,16435,32080,17073,33041
ż,ZhangJiXiang,320921108,19902,2887,13735,8506,26064,13580,5395,14122,27702,14449,28184
,LiuTaoXiang,320921109,17305,2551,12581,7537,24058,12581,5350,12625,25206,12625,25206
,QiTaoXiang,320921110,13226,2416,9433,6312,19214,9310,4244,9684,18994,10453,19886
,LaoSheXiang,320921111,20336,2451,14123,7422,25841,13914,6055,14491,28405,14719,28842
ؿ,XianKaiFaQu,320921400,18165,1658,12438,6568,20221,12433,5410,12777,25210,12795,25233
ʡƺũ,ShengShuHuangHaiNongChang,320921401,9714,2033,6941,5143,12423,6912,2380,7150,14062,7186,14127
ʡණγ,ShengShuGuanDongYanChang,320921402,7719,1075,4929,3581,8809,4891,1135,4892,9783,5000,9929
,DongKanZhen,320922100,181650,18371,121406,77351,212349,120190,44719,122217,242407,123334,244740
Ѵ,WuXunZhen,320922101,50607,7491,34576,19665,65710,33966,11630,34284,68250,35152,69728
,CaiQiaoZhen,320922102,31973,4981,22757,13178,44087,22288,8932,22550,44838,23129,45886
,ZhengHongZhen,320922103,59446,9763,41615,25943,79026,41436,14547,41895,83331,42141,83756
ͨ,TongYuZhen,320922104,21201,3367,15188,9753,28657,15168,5575,14928,30096,14955,30143
,JiePaiZhen,320922105,38461,5825,27234,16318,53974,27233,11769,28814,56047,28821,56055
˾,BaJuZhen,320922106,24240,4264,17662,11425,33495,17659,7241,18046,35705,18083,35745
̲,BaTanZhen,320922107,40244,6440,28821,18280,54558,28574,11290,29020,57594,29153,57974
�,BinHaiGangZhen,320922108,43733,6795,30895,19108,62551,30869,13120,32689,63558,32753,63648
,BinHuaiZhen,320922109,36834,4985,25747,14937,49729,25744,10383,26422,52166,26455,52202
쳡,TianChangXiang,320922200,24367,3568,17707,9981,33639,17613,7363,17369,34982,17591,35298
,DaTaoXiang,320922201,21560,3443,15430,8715,29419,15196,6116,15207,30403,15689,31119
,ChenTaoXiang,320922202,34466,5698,24910,15241,49633,24910,10453,25706,50616,25707,50617
,ZhenDongXiang,320922203,29432,4659,20333,13081,40688,20323,7723,21470,41793,21481,41814
,FanJiXiang,320922204,18026,2529,13005,7269,25610,13005,5672,13222,26227,13222,26227
ũ,BinHuaiNongChang,320922400,5141,859,3381,2426,6361,3369,948,3549,6918,3567,6948
̲γ,XinTanYanChang,320922401,4155,552,2566,1697,4627,2415,628,2552,4967,2769,5335
ҵ԰,KaiFaQuGongYeYuan,320922402,8210,733,5526,2661,9582,5116,2073,4982,10098,5490,11016
غҵ԰,KaiFaQuYanHaiGongYeYuan,320922403,8151,196,2872,1924,2684,2225,617,2438,4663,6092,8964
,FuChengZhen,320923100,139951,16130,92989,59364,158188,90838,30760,91261,182099,93852,186841
,GouDunZhen,320923101,37767,7020,25468,16426,49589,25325,6509,25577,50902,25828,51296
,ChenLiangZhen,320923102,24441,5098,16930,11246,32878,16378,4524,16259,32637,17133,34063
,SanZaoZhen,320923103,31032,5048,20644,12938,40541,20168,6912,21551,41719,22348,42992
򣨰ҵ԰,GuoShuZhenAoYangGongYeYuan,320923104,25843,3823,17150,10659,33969,17011,5662,17827,34838,18178,35328
¹,XinGouZhen,320923105,29027,5726,19789,12966,37908,19692,5881,20592,40284,20845,40634
¼,ChenJiZhen,320923106,29955,5006,20498,12489,39853,19666,6716,20194,39860,21179,41677
կ,YangZhaiZhen,320923107,27390,4922,19247,12164,38030,18296,6982,18688,36984,20047,39294
«,LuPuZhen,320923108,25321,4384,17596,9968,34519,17160,6238,17654,34814,18347,35943
,BanHuZhen,320923109,24705,4865,17895,10988,33518,17410,5665,16646,34056,17340,35235
,DongGouZhen,320923110,65218,12461,44122,28422,85774,41867,12402,43146,85013,45959,90081
,YiLinZhen,320923111,49604,8699,35076,23429,63222,34569,11161,33737,68306,34388,69464
ź,GuHeZhen,320923112,27955,5427,20205,12200,39977,19357,7831,19923,39280,21008,41213
,LuoQiaoZhen,320923113,27692,5865,20203,13091,39419,19640,6933,19614,39254,20287,40490
,KaiFaQu,320923400,32100,4328,21817,12269,39771,21278,6388,20862,42140,20999,42816
ɳί,JinShaHuKaiFaGuanWeiHui,320923401,11920,2020,8121,4875,15665,8121,2157,7976,16097,7976,16097
ϵ,HeDeZhen,320924100,149700,16703,97789,69808,169282,95026,29474,92312,187338,98088,195877
ٺ,LinHaiZhen,320924101,45761,6370,30305,19831,57429,30177,8967,30514,60691,30793,61098
ǧ,QianQiuZhen,320924102,36990,5819,24761,17533,47404,24694,6819,24762,49456,24867,49628
ͨ,TongYangZhen,320924103,22754,4469,15704,11740,30096,15617,4446,15779,31396,15965,31669
,SiMingZhen,320924104,22307,4204,15420,10845,30196,15404,4371,15412,30816,15462,30882
,FuYuZhen,320924105,24630,4747,17345,12128,33006,17114,5409,17126,34240,17441,34786
,HaiHeZhen,320924106,30732,5860,21745,15504,41550,21623,6308,20932,42555,21155,42900
,ChenYangZhen,320924107,28770,4821,19261,12651,35994,17719,5145,17678,35397,19475,38736
ͨ,HaiTongZhen,320924108,23697,3237,14968,10042,25888,13624,3283,13507,27131,15249,30217
,XingQiaoZhen,320924109,32310,6304,22521,16630,41838,22470,5431,21432,43902,21524,44045
̮,XinTanZhen,320924110,32120,5754,21780,16032,42297,21751,6034,22091,43842,22128,43908
,ChangDangZhen,320924111,25007,5410,17857,12748,33196,17652,4643,16781,34433,17203,35060
,PanWanZhen,320924112,25891,4808,17632,11700,33432,17545,4287,17199,34744,17354,34986
ӹ,TeYongZhen,320924113,27987,5199,18861,12567,35952,18402,4974,18672,37074,19299,38160
,YangMaZhen,320924114,20536,3488,13667,9658,26122,13651,3363,13636,27287,13720,27387
ɳ,HuangShaGangZhen,320924117,25196,2699,15273,9999,26970,13876,4095,14267,28143,16717,31990
,OuGengZhen,320924118,20471,3577,13772,9640,25209,13766,3338,13607,27373,13614,27386
ؾÿ,XianJingJiKaiFaQu,320924400,53417,4375,35117,23045,42439,34144,12214,33557,67701,34889,70006
ũ,HuaiHaiNongChang,320924401,4350,1394,3194,2779,5854,3181,540,3082,6263,3090,6284
ٺũ,LinHaiNongChang,320924402,3786,747,2581,2217,4114,2581,569,2503,5084,2521,5102
ũ,XinYangNongChang,320924403,4811,1130,3369,2682,5067,3189,619,2990,6179,3191,6560
γ,YanChang,320924404,3043,491,1655,1647,2116,1624,295,1974,3598,2174,3829
ũҵÿ,NongYeJingJiKaiFaQu,320924405,5468,260,2837,2063,3949,2716,849,2926,5642,3740,6577
,JinHuZhen,320925100,181479,17880,116954,70593,194730,109170,40688,112705,221875,123093,240047
,JianYangZhen,320925101,37255,6697,23903,16110,46369,22366,5892,23635,46001,25941,49844
,JiuLongKouZhen,320925102,17214,4093,12356,9927,23337,12325,3720,12606,24931,12671,25027
,HengJiZhen,320925103,17745,3719,12247,8393,23639,12072,3512,12362,24434,12729,24976
յ,YanDanZhen,320925104,18027,4053,12175,9783,23662,12169,3011,12891,25060,12916,25091
غ,YanHeZhen,320925105,20137,5456,14476,10598,27792,13812,3376,13340,27152,14493,28969
«,LuGouZhen,320925106,23858,5836,16871,12217,31611,15535,4172,15089,30624,16995,33866
,QingFengZhen,320925107,37761,7340,25483,19360,48803,25448,6409,25979,51427,26027,51510
ϸ,ShangGangZhen,320925108,58719,9206,40014,27999,71133,38502,11220,36868,75370,39131,79145
Զ,GangDongZhen,320925109,20707,4554,14519,10487,27420,14497,3277,13981,28478,14019,28538
߿,CaoYanKouZhen,320925110,20768,4313,14768,11155,27700,14731,4269,14467,29198,14582,29350
,GangXiZhen,320925111,17357,4609,12833,10120,23374,12820,2912,12003,24823,12045,24878
ׯ,ZhongZhuangZhen,320925112,21349,4936,14742,11339,27418,14639,3095,14496,29135,14638,29380
,BaoTaZhen,320925113,13764,3467,9576,7229,18327,9113,2135,8968,18081,9790,19366
,GaoZuoZhen,320925114,23304,5246,15663,11214,31072,15456,3577,15829,31285,16464,32127
,KaiFaQu,320925400,15265,1526,9395,6609,10364,9270,2859,10009,19279,10255,19650
ڶ,QinDongZhen,320981100,26618,6326,18304,13032,33171,17724,3719,17106,34830,18359,36663
ʱ,ShiYanZhen,320981101,38773,10419,29243,21099,51180,28690,5956,25219,53909,25905,55148
,WuLieZhen,320981106,49011,12559,34492,25057,65388,33929,8296,34626,68555,35374,69866
,LiangDuoZhen,320981107,49009,13071,35768,24955,66207,35414,7492,33171,68585,33804,69572
,AnFengZhen,320981108,31752,8193,23723,17221,40728,23125,4659,20091,43216,20881,44604
,NanShenZaoZhen,320981109,27809,8549,21975,17139,38893,21835,4245,18304,40139,18628,40603
,FuAnZhen,320981110,51598,15569,42023,30095,71586,41117,8485,32371,73488,33629,75652
,TangYangZhen,320981112,30314,7897,22831,16577,39042,22276,4162,18867,41143,19542,42373
½,XinJieZhen,320981113,26467,6389,18942,14986,34052,18672,3224,16737,35409,17138,36080
,XuHeZhen,320981114,30261,8287,22030,16838,40333,21965,3747,20057,42022,20265,42295
,SanCangZhen,320981115,48029,11095,33297,25572,60147,32462,5771,30493,62955,31598,64895
ͷ,TouZaoZhen,320981118,48480,11399,34140,25785,63687,34043,6966,32499,66542,32705,66845
,JiangGangZhen,320981121,32584,6481,21361,15794,38938,21118,3598,20563,41681,21302,42663
̨,DongTaiZhen,320981122,195154,36483,133397,89936,236919,129589,31236,124076,253665,129476,262873
Ӫ²ũ,GuoYingXinCaoNongChang,320981400,11274,2850,8028,6213,14767,7896,1453,7390,15286,7549,15577
Ӫũ,GuoYingJiangGangNongChang,320981401,4509,963,2953,2033,5254,2762,512,2572,5334,3031,5984
,KaiFaQu,320981409,14141,1926,8779,5900,13606,8459,2008,8219,16678,9296,18075
غ,YanHaiJingJiQu,320981410,524,12,114,205,0,83,2,185,268,424,538
,DaZhongZhen,320982100,143873,17347,94895,66836,154948,91870,26162,88630,180500,92487,187382
,CaoYanZhen,320982101,24705,5912,17615,13663,32435,17591,3895,16840,34431,16897,34512
׾,BaiJuZhen,320982102,24842,5832,17603,13645,32135,17564,3692,16655,34219,16763,34366
ׯ,LiuZhuangZhen,320982103,28077,6039,19317,14150,36088,18769,4406,18439,37208,19205,38522
,XiTuanZhen,320982104,22441,4710,15057,11424,27984,14934,2873,14801,29735,14967,30024
С,XiaoHaiZhen,320982105,26547,6099,18489,14561,34127,18438,3487,17546,35984,17644,36133
,DaQiaoZhen,320982106,21357,5010,14747,11846,27703,14677,2692,14216,28893,14312,29059
,CaoMiaoZhen,320982107,18918,3762,12633,9942,23793,12623,2317,12322,24945,12364,24997
ӯ,WanYingZhen,320982108,32834,6957,22320,17051,41985,22286,4241,21648,43934,21712,44032
,NanYangZhen,320982109,27901,5331,18411,14103,32236,17323,3025,16749,34072,17846,36257
ԣ,YuHuaZhen,320982110,27492,5070,18230,14166,32635,18182,3468,17699,35881,17800,36030
·,XinFengZhen,320982111,54220,9912,36315,27617,64750,35471,7349,34318,69789,35166,71481
,SanLongZhen,320982112,33804,6529,23463,17100,42425,23431,5150,21963,45394,22020,45483
ǿ,FangQiangZhen,320982113,17437,3830,12747,9343,22558,12595,2865,11119,23714,11385,24132
ũ,DaZhongNongChang,320982400,4510,543,1770,1985,3470,1754,200,1968,3722,3483,5253
ǿũ,FangQiangNongChang,320982401,3413,499,1666,1410,2936,1666,309,1617,3283,2555,4221
ͷũ,DongBaTouNongChang,320982402,787,157,538,473,970,531,126,519,1050,532,1070
ᾭÿί,DaFengJingJiKaiFaQuGuanWei,320982404,1336,33,608,261,5,309,77,322,631,838,1446
۾ί,DaFengGangJingJiQuGuanWeiHui,320982405,10730,472,4130,4019,0,3745,697,4815,8560,7769,11899
Ϻũ,ShangHaiNongChang,320982406,4048,1086,2189,2339,3572,2126,367,2370,4496,3312,5501
ũ,HaiFengNongChang,320982407,2076,92,980,1017,78,899,210,1118,2017,1398,2378
ũ,ChuanDongNongChang,320982408,1942,433,888,1006,23,769,109,931,1700,1596,2484
ؽֵ,DongGuanJieDao,321002001,31060,8097,22027,16656,37740,21262,3678,20312,41574,20808,42835
ӽֵ,WenHeJieDao,321002002,27269,5412,19555,12662,28296,17852,4342,16711,34563,17468,37023
ķֵ,WenFengJieDao,321002003,44526,5464,27743,18705,32308,27061,7215,27280,54341,29462,57205
ֵ,QuJiangJieDao,321002004,97392,11505,59990,39452,82733,57230,14057,57496,114726,62964,122954
ͷ,WanTouZhen,321002100,22434,3137,13955,7809,20377,12690,3110,12875,25565,14726,28681
,TangWangXiang,321002200,19015,1630,11327,7513,11919,11041,3146,11588,22629,12464,23791
ҵ԰,ChanYeYuan,321002400,23648,2118,12935,7360,16597,11318,2788,11558,22876,15619,28554
Ͻֵ,HanShangJieDao,321003001,59024,4087,37350,23246,39110,35701,11415,35155,70856,37176,74526
ֵ,JiangWangJieDao,321003002,15225,1797,9470,5118,12168,9049,2257,9098,18147,9809,19279
ӽֵ,ChaHeJieDao,321003003,50235,2689,28396,9010,26271,14295,3540,14350,28645,28068,56464
ʢֵ,XinShengJieDao,321003004,27895,1571,16803,7145,17411,11834,3597,11550,23384,16260,33063
,GongDaoZhen,321003100,25777,4681,17263,10044,30031,16786,3508,16206,32992,16703,33966
,FangXiangZhen,321003101,33250,5919,21486,12384,41044,21467,4592,22169,43636,22275,43761
,HuaiSiZhen,321003102,36889,5357,23785,13676,43529,23671,5753,23962,47633,24214,47999
,GuaZhouZhen,321003103,31160,4859,19903,11231,32624,18506,4150,17717,36223,20266,40169
,HangJiZhen,321003104,32300,4498,20472,11004,33011,19077,4407,18976,38053,20733,41205
,LiDianZhen,321003105,36136,5345,20014,11538,33462,18529,3484,18070,36599,24951,44965
ɳͷ,ShaTouZhen,321003106,28586,4967,18817,11096,31616,18552,3824,18329,36881,18560,37377
ͷ,TouQiaoZhen,321003107,30676,6334,20683,13428,35585,20130,3410,19215,39345,19737,40420
,YangShouZhen,321003108,15910,2713,10347,5900,19024,10344,2307,10561,20905,10583,20930
̩,TaiAnZhen,321003109,13871,2936,9724,6060,15921,9515,2059,8722,18237,9142,18866
,YangMiaoZhen,321003110,17320,2372,10977,5708,19327,10723,2646,10544,21267,11361,22338
�ҵ԰,HanJiangGongYeYuan,321003401,1546,3,865,197,12,184,32,210,394,716,1581
˫Žֵ,ShuangQiaoJieDao,321011001,66818,6700,42621,23007,54015,33473,8660,32139,65612,39557,82178
÷ֵ,MeiLingJieDao,321011002,39903,6311,26428,18296,38718,25048,6100,24301,49349,25886,52314
ֵ,ShouXiHuJieDao,321011003,15483,2099,9998,6245,11198,9555,2260,9236,18791,9844,19842
Ȫֵ,GanQuanJieDao,321011004,23805,3010,15066,7738,27562,14661,3679,15075,29736,15428,30494
ӽֵ,YangZiJinJieDao,321011050,42486,2656,24206,12002,23197,18559,5878,18450,37009,26814,51020
Ļֵ,WenHuiJieDao,321011051,41378,4456,26517,16155,35666,23245,6277,23053,46298,25594,52111
,XiHuZhen,321011100,31899,2794,19153,10959,23634,17710,4646,17865,35575,20186,39339
ʩ,ShiQiaoZhen,321011150,35065,3701,20459,9962,28065,16651,3930,16276,32927,22237,42696
,BaLiZhen,321011151,21551,2061,13074,4877,15422,8261,1964,8043,16304,12502,25576
ϯ,PuXiZhen,321011152,15089,4132,11479,8386,20353,11417,2857,10454,21871,10599,22078
ƽɽ,PingShanXiang,321011200,15463,1367,9487,4954,9941,7638,1937,7635,15273,9280,18767
Ǳ,ChengBeiXiang,321011202,30146,3305,18927,11585,21689,18271,4745,18167,36438,19269,38196
,AnYiZhen,321023100,188047,24098,126538,81867,194022,123273,36398,118018,241291,122005,248543
ˮ,FanShuiZhen,321023101,44475,9551,33614,22004,57183,32627,8465,27519,60146,28877,62491
ļ,XiaJiZhen,321023102,32133,7977,23772,17524,43491,23691,5043,21225,44916,21381,45153
,LiuBaoZhen,321023103,25593,6604,19218,14075,35091,19103,4392,17121,36224,17371,36589
,SheYangHuZhen,321023104,43561,9440,31023,21954,59381,30937,9211,30779,61716,31189,62212
,GuangYangHuZhen,321023105,15333,3812,11268,8045,21515,11251,3220,11031,22282,11097,22365
³,LuDuoZhen,321023106,14578,3823,11921,8266,20101,11282,3382,9158,20440,9862,21783
Сׯ,XiaoGuanZhuangZhen,321023107,14373,3630,11617,7901,19489,11544,3221,9431,20975,9607,21224
ֱ,WangZhiGangZhen,321023108,30961,6351,23028,15134,41784,22796,7160,20954,43750,21444,44472
ܵ,CaoDianZhen,321023109,29638,7434,23487,15789,39914,22925,7237,19984,42909,20822,44309
�,XiAnFengZhen,321023110,18497,3765,13342,7669,25563,13269,4325,13057,26326,13245,26587
ɽ,ShanYangZhen,321023111,29280,6427,20986,13165,37658,20911,4734,19220,40131,19455,40441
,HuangChengZhen,321023112,14190,3230,10932,6743,19369,10912,2944,9375,20287,9432,20364
,JingHeZhen,321023113,29927,6361,21592,13893,37951,21560,5335,19879,41439,20031,41623
ί,KaiFaQuGuanWeiHui,321023400,10802,1201,7141,3983,9836,7033,2266,6898,13931,7128,14269
,ZhenZhouZhen,321081100,144373,16277,93662,64061,145605,90297,24833,87489,177786,91821,185483
ɽ,QingShanZhen,321081101,22612,3342,14769,9289,26649,14755,2973,14143,28898,14158,28927
¼,XinJiZhen,321081103,31217,5187,20554,11941,38368,20116,4497,19701,39817,20347,40901
³,XinChengZhen,321081104,33846,5428,21848,13219,38917,21716,4189,21319,43035,21615,43463
�,MaJiZhen,321081105,21579,3434,13764,8183,25743,13653,2731,13626,27279,13980,27744
,LiuJiZhen,321081106,35508,5517,22660,12868,43635,22542,5125,23186,45728,23490,46150
¼,ChenJiZhen,321081107,27630,4466,17933,10719,33725,17451,3544,17215,34666,17707,35640
,DaYiZhen,321081108,34157,5649,22107,13293,41390,21885,4904,22379,44264,22603,44710
л,XieJiXiang,321081200,19659,3289,12770,7976,23577,12731,2452,12545,25276,12630,25400
,YueTangXiang,321081201,20260,3451,12952,8117,25171,12905,2365,13033,25938,13124,26076
ʮװ´,ShiErWeiBanShiChu,321081408,29587,3317,12632,7465,18710,10767,2266,10634,21401,22538,35170
ͭɽ´,TongShanBanShiChu,321081409,19027,3113,11961,7211,22782,11942,2217,12099,24041,12396,24357
,GaoYouZhen,321084100,125241,16381,83726,50945,125046,78529,20854,74640,153169,78750,162476
,LongQiuZhen,321084101,23383,4594,15959,9562,29944,15851,3378,15215,31066,15396,31355
,MaPengZhen,321084102,10817,2322,7775,4926,14191,7759,1716,7018,14777,7080,14855
,CheLuoZhen,321084103,21743,4713,15312,9288,27706,15132,3002,13872,29004,14146,29458
,BaQiaoZhen,321084104,12208,3204,9484,6399,16571,9294,2035,7745,17039,7963,17447
,HanLiuZhen,321084105,17422,4139,12832,8161,22503,12406,2603,10785,23191,11332,24164
ׯ,TangZhuangZhen,321084106,19253,4911,13606,9772,25741,13559,2629,13016,26575,13187,26793
ж,XieJiaZhen,321084107,36636,8045,25924,16022,47283,25866,5077,23664,49530,23834,49758
,SanDuoZhen,321084108,36987,7362,25138,15790,45903,24133,5124,23173,47306,24335,49473
ʶ,GanDuoZhen,321084109,20947,5213,14799,10276,28217,14747,3395,14629,29376,14756,29555
˾ͽ,SiTuZhen,321084110,12066,2777,8561,5956,15457,8550,1809,8042,16592,8091,16652
,HengJingZhen,321084111,11279,2882,8077,6035,15362,8065,1775,7791,15856,7859,15936
,JieShouZhen,321084112,21537,4276,15901,10115,27101,15552,3604,13137,28689,13516,29417
ɽ,ZhouShanZhen,321084113,13952,3581,10732,7220,19429,10703,2412,9125,19828,9213,19945
,ZhouXiangZhen,321084114,16974,4301,12762,8542,23042,12658,2787,11084,23742,11300,24062
,LinZeZhen,321084115,31084,7510,23411,15732,41630,22934,5660,20318,43252,20843,44254
,SongQiaoZhen,321084116,19217,3261,12944,7528,22746,12539,2744,11870,24409,12278,25222
,GuoJiZhen,321084117,17446,2906,11513,6630,21701,11502,2741,11546,23048,11580,23093
ɽ,TianShanZhen,321084118,15338,2449,10202,5679,18351,10083,2282,9686,19769,9867,20069
,LingTangHuiZuXiang,321084200,16582,3127,11083,6740,20627,10913,2192,10528,21441,10818,21901
Ͼ,ChengNanJingJiXinQu,321084401,11782,2053,7868,4364,13100,7734,1698,7513,15247,7665,15533
ÿ,JingJiKaiFaQu,321084406,41334,5200,27162,15431,40664,25987,6733,25233,51220,26105,53267
Ů,XianNvZhen,321088100,219770,26758,144421,90104,223675,137310,36901,131247,268557,139008,283429
С,XiaoJiZhen,321088101,59264,14156,42600,26272,79341,42518,8341,38966,81484,39161,81761
,WuJianZhen,321088103,26413,6041,18897,12553,34872,18874,4072,17551,36425,17629,36526
,FanChuanZhen,321088106,38244,9926,28727,18722,52284,28723,5620,25050,53773,25063,53790
,ZhenWuZhen,321088108,33345,7985,24290,16781,42465,23999,5226,21083,45082,22266,46556
,YiLingZhen,321088109,34955,6441,24240,14957,41530,23479,5382,21466,44945,22538,46778
,DingGouZhen,321088110,40458,8617,29222,17935,52664,29188,6164,25932,55120,26017,55239
,GuoCunZhen,321088112,52247,11961,38595,22562,69918,36862,9674,33283,70145,35287,73882
۲,ShaoBoZhen,321088114,56887,11913,40193,26263,71224,39782,8926,36654,76436,37533,77726
,DingHuoZhen,321088116,28110,7040,20606,14198,36287,20511,3628,17788,38299,18172,38778
,DaQiaoZhen,321088118,95218,19307,65247,40484,115284,63154,14441,57354,120508,63719,128966
,WuQiaoZhen,321088119,28361,6665,21907,14148,38681,21890,5594,18643,40533,18713,40620
ͷ,PuTouZhen,321088120,30512,6478,21509,12747,40131,21464,5331,20722,42186,20812,42321
·ֵ,ZhengDongLuJieDao,321102001,46907,4232,26265,15653,31912,21160,5038,21414,42574,29912,56177
·ֵ,JianKangLuJieDao,321102002,67833,10291,41551,28135,60100,38949,8324,38558,77507,44897,86448
пڽֵ,DaShiKouJieDao,321102003,50676,7506,32043,20695,43357,29246,6188,28347,57593,32327,64370
¥ֵ,SiPaiLouJieDao,321102004,44010,5804,27757,19752,38616,27456,6175,27213,54669,28232,55989
îֵ,DingMaoJieDao,321102050,42871,3043,24775,16079,22082,23637,7200,23784,47421,28339,53114
۽ֵ,DaGangJieDao,321102051,53711,5097,29964,18931,42847,27381,7269,27353,54734,36113,66077
ɽ,XiangShanZhen,321102100,72008,4271,38698,19002,39855,25975,6302,26853,52828,43883,82581
ɱ,JianBiZhen,321102101,32106,3885,17034,11597,23771,15503,3195,15747,31250,22152,39186
Ҧ,YaoQiaoZhen,321102150,34439,6076,22112,14631,37872,21532,4188,21091,42623,22591,44703
·,DaLuZhen,321102151,21536,3934,13811,9745,24132,13441,2566,13070,26511,14225,28036
,DingGangZhen,321102152,17938,2063,8828,5352,14562,8010,1645,7774,15784,12818,21646
ڹҵ԰,JingKouGongYeYuanQu,321102400,1782,162,897,505,1112,758,167,750,1508,1214,2111
ũ,GongQingTuanNongChang,321102401,1092,232,583,419,664,531,114,538,1069,855,1438
·ֵ,BaoTaLuJieDao,321111001,58567,7672,36474,25194,44880,35075,8172,35126,70201,37937,74411
ƽ·ֵ,HePingLuJieDao,321111002,42946,5508,26838,18131,39236,26325,6272,26411,52736,27888,54726
ɽֵ,JinShanJieDao,321111003,37889,7294,24173,20084,38612,23711,3974,24120,47831,24984,49157
ֵ,QiLiDianJieDao,321111004,47489,3835,25763,15997,26046,22480,5741,22923,45403,31302,57065
,JiangQiaoZhen,321111100,18429,2117,10693,7393,13383,10237,2254,10635,20872,12107,22800
Ӫ÷չί,MinYingJingJiFaZhanGuanLiWei,321111400,8904,832,5103,3546,3452,4980,1213,5283,10263,5846,10949
ҵ԰ίԱ,GongYeYuanQuGuanLiWeiYuanHui,321111401,11410,1228,6259,3340,8619,5713,1210,5450,11163,7589,13848
ɽί,NanShanGuanWeiHui,321111450,11009,1121,6415,4425,6121,5958,1453,6513,12471,7168,13583
,GaoQiaoZhen,321112100,14861,3010,9820,6511,17062,9663,1572,9239,18902,9623,19443
,XinFengZhen,321112101,41289,5728,26440,15819,46341,26031,5734,25680,51711,26311,52751
,GuYangZhen,321112102,23617,3107,14978,8714,24245,14299,3097,13923,28222,14843,29821
ϵ,ShangDangZhen,321112103,40507,5905,25904,14400,45735,24694,4942,24071,48765,25450,51354
,BaoYanZhen,321112104,17284,3103,11331,7188,21109,11241,2199,11131,22372,11255,22586
,GaoZiZhen,321112105,33551,5006,20969,12754,36553,20623,4359,20225,40848,21947,42916
ҵ,ShiYeZhen,321112106,9017,1700,6272,3734,11352,6207,1426,5748,11955,5871,12143
̬ũҵ԰,JiangXinZhouShengTaiNongYeYuanQu,321112401,5403,1146,3534,2345,6479,3520,503,3444,6964,3518,7052
ٱԴ,RongBingYanZiYuanQu,321112402,15369,2677,9805,5810,18446,9592,1760,9572,19164,10001,19806
ͽ³ǹί,DanTuXinChengGuanWeiHui,321112403,36385,3248,20892,12792,25703,19474,4840,19637,39111,23581,44473
˾ͽ,SiTuZhen,321181100,48166,7018,30565,19974,44194,29770,6475,29788,59558,31094,61659
,YanLingZhen,321181101,52207,8795,33457,20774,58552,32309,5583,31701,64010,33128,66585
,ErLingZhen,321181102,35468,6514,23008,15634,40610,21884,3876,21506,43390,22850,45858
,DaoShuZhen,321181103,37580,6660,24396,16180,43400,24263,4765,24445,48708,24609,49005
,HuangTangZhen,321181104,42827,6851,27602,18747,43252,26661,5818,26882,53543,27894,55496
,LvChengZhen,321181105,41517,6574,26684,16669,46781,25799,5243,25682,51481,26650,53334
,LingKouZhen,321181106,33879,5430,21585,13876,39378,21315,4109,21277,42592,21833,43418
,FangXianZhen,321181107,40312,6069,25523,16469,45434,24756,4976,24607,49363,25834,51357
,JiePaiZhen,321181108,43483,2564,24739,17755,20266,23873,7520,26237,50110,28828,53567
,XinQiaoZhen,321181109,28487,2921,17238,10927,20732,16526,4029,16668,33194,18199,35437
,HouXiangZhen,321181110,41805,3615,24917,17283,26754,24103,6549,25461,49564,27052,51969
,PiChengZhen,321181111,22691,2804,13874,9124,19693,13582,3075,13968,27550,14696,28570
,YunYangZhen,321181112,147766,18842,96228,62259,143838,93064,23129,89415,182479,93509,189737
ü�,JingJiJiShuKaiFaQu,321181400,141484,13577,84565,56127,101384,77857,19609,80302,158159,90105,174670
é,SanMaoZhen,321182100,124184,11867,75361,44668,105025,69070,18287,67652,136722,78977,154338
°,XinBaZhen,321182101,42134,6675,27112,16790,42236,26255,5373,25758,52013,27070,54182
ͷ,YouFangZhen,321182102,32802,6561,21262,13650,37189,20931,3300,20642,41573,21401,42663
,BaQiaoZhen,321182103,26839,4841,16751,10652,28269,16198,2778,15409,31607,17707,34458
,XiLaiQiaoZhen,321182104,14592,2317,8606,5204,15410,8342,1780,8225,16567,10083,18689
ÿ,JingJiKaiFaQu,321182400,23655,4387,15084,9054,24799,14266,2605,13739,28005,15563,30647
칫,SheQuGongZuoBanGongShi,321183001,95426,7686,60528,39661,74650,54218,15216,51679,105897,57800,118328
,HuaYangZhen,321183100,40596,5409,26072,16170,43057,25642,5950,25278,50920,25883,51955
÷,HuangMeiZhen,321183101,32283,5765,20687,13052,39338,19919,3685,19698,39617,21046,41733
,XiaShuZhen,321183102,31825,4439,19681,11788,31427,16712,3525,16335,33047,20108,39789
,BaiTuZhen,321183103,30807,5269,19691,12335,35909,19167,3152,18737,37904,19537,39228
߳,BianChengZhen,321183104,26824,4801,17018,11276,29982,16674,2861,16149,32823,17468,34486
éɽ,MaoShanZhen,321183105,16820,3677,11816,8934,20507,11772,2459,10983,22755,11140,22956
,HouBaiZhen,321183106,40253,6892,26299,17045,49311,26143,5262,25806,51949,26108,52407
ׯ,GuoZhuangZhen,321183107,40799,6600,25882,17284,49445,25542,5107,25867,51409,26624,52506
,TianWangZhen,321183108,35958,5958,23680,15854,44758,23568,5481,23458,47026,23717,47397
,BaoHuaZhen,321183109,18303,2575,11126,7437,19862,10601,2084,10489,21090,11836,22962
,KaiFaQu,321183400,36458,2015,19023,9866,16392,14318,3841,14206,28524,23291,42314
,XuNiDiQu,321183416,3701,103,100,117,84,99,2,110,209,3706,3806
ʡһܽ,JiangSuShengDiYiShaoNianGuanJiao,321183417,1847,79,177,112,180,102,5,108,210,1754,1931
ʡ,JiangSuShengXuNiDiQu,321183418,3071,68,104,121,238,103,15,115,218,3050,3154
ʡ,JiangSuShengXuNiDiQu,321183419,1236,47,39,42,99,35,11,39,74,1255,1294
ʡ,JiangSuShengXuNiDiQu,321183420,1576,3,1579,0,0,0,0,0,0,0,1579
éɽί,MaoShanGuanWeiHui,321183429,21035,3731,14175,9175,25669,14069,3025,13449,27518,13616,27791
ɽί,ChiShanHuGuanWeiHui,321183430,9376,1508,6010,4116,11531,5995,1206,5924,11919,6080,12090
Ƕֵ,ChengDongJieDao,321202001,84465,8530,52463,25297,56089,37968,9063,36414,74382,49595,102058
ֵ,ChengXiJieDao,321202002,57586,8721,37656,26463,50061,37201,8153,36118,73319,36804,74460
Ͻֵ,ChengNanJieDao,321202003,30610,2865,19946,12772,24875,19456,6056,18836,38292,19585,39531
нֵ,ChengZhongJieDao,321202004,38853,8255,27680,19343,40314,26187,6235,24073,50260,25663,53343
Ǳֵ,ChengBeiJieDao,321202005,29226,5515,19840,14808,28652,19590,4222,18788,38378,19123,38963
̩·ֵ,JingTaiLuJieDao,321202007,48691,5707,31606,14980,40705,25542,6732,25818,51360,29524,61130
ũҵֵ,NongYeKaiFaQuJieDao,321202050,4590,538,2694,1843,4416,2472,523,2499,4971,2957,5651
·ֵ,FengHuangLuJieDao,321202051,29947,4457,18648,11540,29313,18392,5040,18644,37036,20796,39444
ֵ,SiXiangJieDao,321202052,26503,4943,17532,10048,31652,17048,4427,17212,34260,18341,35873
ֵ,MingZhuJieDao,321202053,34892,3975,21339,11970,25639,20211,5609,20437,40648,23137,44476
,JiuLongZhen,321202100,24612,3596,15542,9055,24402,14816,3653,15067,29883,16319,31861
,GangYangZhen,321202101,16296,3132,10765,6680,20109,10692,2257,10684,21376,10920,21685
ճ,SuChenZhen,321202102,29471,6001,20600,12821,35676,20481,5506,20101,40582,20378,40978
Ǳ԰,ChengBeiWuLiuYuanQu,321202401,4054,637,2508,1527,3801,2430,512,2448,4878,2695,5203
ڰֵ,KouAnJieDao,321203001,58562,8813,38437,23561,60252,37106,9298,35479,72585,38236,76673
ֵ̽,DiaoPuJieDao,321203002,18624,3207,12716,7823,19591,12304,2823,11409,23713,11938,24654
ׯֵ,XuZhuangJieDao,321203003,25849,5620,18182,11355,31069,17463,4193,16347,33810,17480,35662
ؽֵ,YanJiangJieDao,321203050,8758,1419,5618,3168,9642,5496,1315,5443,10939,5874,11492
,YongAnZhouZhen,321203100,27000,3756,14884,9949,24240,14524,3229,14391,28915,19101,33985
,BaiMaZhen,321203101,13553,3187,9653,6516,17192,9617,2554,9472,19089,9641,19294
ׯ,HuZhuangZhen,321203103,23565,6666,18647,13570,33655,18618,5127,16617,35235,16711,35358
,DaSiZhen,321203104,16634,4338,12397,8154,22911,12319,3434,11862,24181,12009,24406
Ұ,YeXuZhen,321203150,16530,3328,10789,6517,18109,10418,2425,9943,20361,11494,22283
Ҥ,DaiYaoZhen,321281100,40472,8394,27159,18795,53246,27022,7105,28588,55610,28812,55971
ϳ,HeChenZhen,321281101,32374,7669,22540,15676,44529,22525,5824,23249,45774,23327,45867
,YongFengZhen,321281102,24929,6074,17814,12195,35193,16382,5243,16678,33060,18432,36246
¶,XinDuoZhen,321281103,11152,3669,8864,7396,16042,8820,2408,8274,17094,8365,17229
,AnFengZhen,321281104,37795,7368,25761,18490,47643,24946,6488,24749,49695,25890,51651
,HaiNanZhen,321281105,13011,3907,9985,8208,18853,9944,3010,9844,19788,9943,19928
,DiaoYuZhen,321281106,18909,5227,14009,11321,26955,13883,4222,14226,28109,14349,28358
,DaZouZhen,321281107,11461,2985,8302,6311,15990,8202,2255,8277,16479,8399,16701
ɳ,ShaGouZhen,321281108,15408,3049,10116,6644,19875,9891,2372,10384,20275,10713,20829
б,ZhongBaoZhen,321281109,12478,3839,9385,7687,18007,9368,2725,9569,18937,9657,19042
,LiZhongZhen,321281110,13737,3884,10013,7862,20164,10013,2930,10537,20550,10538,20551
,XiJiaoZhen,321281111,15020,3719,10551,7947,20437,10547,2681,10863,21410,10869,21420
ٳ,LinChengZhen,321281112,30155,6519,20719,13731,40781,20697,5818,21666,42363,21773,42492
,DuoTianZhen,321281113,38652,6299,25345,15509,44560,25324,7155,26730,52054,26761,52106
,ZhuHongZhen,321281114,16299,4404,11831,8653,23126,11819,3074,11872,23691,11946,23777
,ShenLunZhen,321281115,11175,3520,8370,6469,16424,8354,2068,8381,16735,8393,16763
,DaDuoZhen,321281116,25405,4799,16620,11583,31861,16037,4367,17205,33242,17951,34571
ݶ,DiDuoZhen,321281117,24455,5610,16771,11392,32752,16760,4423,17658,34418,17717,34488
ׯ,TaoZhuangZhen,321281118,21417,5653,15248,11193,29733,15161,4060,15787,30948,15882,31130
,ChangRongZhen,321281119,21936,4099,14524,9783,29381,14429,4067,15522,29951,15578,30102
éɽ,MaoShanZhen,321281120,19141,4047,12667,8150,25404,12593,2881,13184,25777,13402,26069
ׯ,ZhouZhuangZhen,321281121,31860,8538,23178,17122,42984,22750,4856,21289,44039,22076,45254
±,ChenBaoZhen,321281122,23149,5759,16788,11930,32114,16636,4175,16054,32690,16295,33083
,DaiNanZhen,321281123,94491,12690,54752,35121,85627,49200,11545,52683,101883,63974,118726
Ź,ZhangGuoZhen,321281124,37780,8320,25032,18586,45729,24609,5950,26093,50702,27018,52050
,ZhaoYangZhen,321281125,142246,17160,88098,58549,127174,80007,21211,80014,160021,92519,180617
Ӫ,DaYingZhen,321281126,17398,3801,12002,8389,23291,11994,2883,12010,24004,12080,24082
,XiaWeiZhen,321281127,11693,2660,8198,5943,16276,8179,2379,8511,16690,8534,16732
Ƕ,ChengDongZhen,321281128,15478,3310,10585,7424,20903,10555,3206,11311,21866,11409,21994
,LaoWeiXiang,321281200,11553,3579,8879,7032,16435,8864,2427,8479,17343,8680,17559
ܷ,ZhouFenXiang,321281201,10617,2838,8085,5780,15409,8065,2360,7702,15767,7730,15815
׹,GangGuXiang,321281202,10043,2094,7097,4771,13957,7039,2062,7031,14070,7102,14199
,XiBaoXiang,321281203,17414,3104,11333,7868,22399,11314,3204,12360,23674,12389,23722
ֺ,LinHuXiang,321281204,15029,3919,10875,8048,21448,10827,3408,11362,22189,11481,22356
,KaiFaQu,321281400,16649,2952,10755,7232,17774,10606,2467,10921,21527,11313,22068
ǽֵ,JingChengJieDaoBan,321282001,118539,14277,77631,49119,108813,76260,20091,73274,149534,75276,152907
,XinQiaoZhen,321282101,38951,7324,25971,16527,47622,25697,6412,25736,51433,26716,52687
,DongXingZhen,321282102,24318,4400,16018,9766,28207,15743,3611,15520,31263,16311,32329
б,XieQiaoZhen,321282103,34574,6608,22642,14005,41249,22256,4268,21787,44043,22808,45450
,XiLaiZhen,321282104,31810,6838,21867,13768,39806,21760,4618,20918,42678,21399,43266
,JiShiZhen,321282105,30650,7374,21324,13753,38787,21142,3781,20276,41418,20481,41805
ɽ,GuShanZhen,321282106,25360,6416,17200,11772,31493,17073,2623,16904,33977,17199,34399
,ShengCiZhen,321282108,31502,7925,21582,14926,39655,21350,3513,20984,42334,21358,42940
,MaQiaoZhen,321282109,24112,6140,16449,11026,30191,16329,2458,16019,32348,16261,32710
ϰ´,ChengNanBanShiChu,321282401,58607,5525,36806,21398,45850,34618,9769,33899,68517,37095,73901
¸԰,XinGangYuanQu,321282402,32901,3791,16001,8948,25126,14324,3052,14347,28671,23743,39744
Ǳ԰,ChengBeiYuanQu,321282403,14555,2517,9342,6066,14021,9129,1812,8868,17997,9542,18884
԰,JiangYinYuanQu,321282404,35480,3681,17822,10113,26808,16188,3684,16500,32688,25023,42845
³,BinJiangXinCheng,321282406,23863,3064,14882,8473,22053,14431,3566,13915,28346,15611,30493
,HuangQiaoZhen,321283100,119430,26081,88309,61195,151888,87386,23443,79460,166846,80645,168954
ֽ,FenJieZhen,321283101,35355,8426,26475,17593,48850,26433,7290,24549,50982,24596,51071
Ϫ,GuXiZhen,321283102,35085,9092,26534,17930,47528,26142,6208,23435,49577,23851,50385
Ԫ,YuanZhuZhen,321283104,19949,5488,15608,11312,28116,15568,4618,14341,29909,14447,30055
ɺ,ShanHuZhen,321283105,27837,7229,21670,14685,39079,21607,6211,19523,41130,19607,41277
,GuangLingZhen,321283106,31068,7873,22757,15527,42514,22624,5395,21404,44028,21579,44336
ϼ,QuXiaZhen,321283108,16242,4724,12099,9082,22193,12041,2444,11215,23256,11311,23410
,ZhangQiaoZhen,321283109,31370,8623,22842,16758,41085,22680,4427,21262,43942,21578,44420
ʧ,HeShiZhen,321283112,30825,8265,23016,16385,41569,22832,5624,20983,43815,21698,44714
½,XinJieZhen,321283113,39012,8701,27083,18113,53351,27049,7597,28139,55188,28227,55310
Ҧ,YaoWangZhen,321283114,35215,7376,24118,16142,44670,24026,5401,23702,47728,23874,47992
,XuanBaoZhen,321283115,17418,4610,13465,9141,23567,13380,3158,11578,24958,11721,25186
̩,TaiXingZhen,321283118,184415,20663,121797,76066,195585,116775,37299,115039,231814,120580,242377
,BinJiangZhen,321283123,67244,13873,45210,28860,82752,44382,9264,42773,87155,45171,90381
,HongQiaoZhen,321283124,52816,10576,35173,22068,63948,34156,6854,32869,67025,35073,70246
˼,GenSiXiang,321283200,31584,7064,22002,14361,41711,21972,5159,21760,43732,21805,43807
,JiangYanZhen,321284100,127101,18195,87175,56382,132531,85084,24272,79002,164086,82393,169568
,QinTongZhen,321284101,23991,5142,16233,11417,27868,15408,3189,15102,30510,16089,32322
,JiangDuoZhen,321284102,26668,7816,21231,14737,36991,20698,5125,17997,38695,18378,39609
˸,GuGaoZhen,321284103,17207,4599,12946,8572,23352,12891,3371,12118,25009,12231,25177
,DaLunZhen,321284104,21035,6978,17168,12697,29597,17135,3570,14293,31428,14415,31583
ŵ,ZhangDianZhen,321284105,45776,11677,33816,21802,62556,33488,8781,31933,65421,32418,66234
,LiangXuZhen,321284107,31451,8572,23477,15754,41922,23403,5176,21467,44870,21722,45199
ͷ,QiaoTouZhen,321284109,15658,4206,11458,8125,21250,11393,2420,10656,22049,10826,22284
Ϫ,YuXiZhen,321284110,21890,6448,16290,12235,29468,16267,3541,15479,31746,15589,31879
,BaiMiZhen,321284111,28788,7816,20963,14159,37818,20756,3985,19330,40086,19626,40589
¦ׯ,LouZhuangZhen,321284112,32200,8439,22867,15276,41758,22397,3881,21043,43440,21653,44520
,ShenGaoZhen,321284113,24965,6158,17176,12366,29832,17094,3018,16340,33434,16965,34141
̩,XingTaiZhen,321284114,16614,3675,11195,8628,20300,11013,2571,11263,22276,11665,22860
,YuDuoZhen,321284115,27763,7649,19948,14784,37791,19892,4017,19245,39137,19481,39429
,HuaGangZhen,321284116,27529,6671,19176,13485,34946,19105,3520,18362,37467,18544,37720
,KaiFaQu,321284400,33822,6081,22785,13772,37760,22312,5628,21830,44142,22746,45531
Ҹֵ,XingFuJieDao,321302001,52014,6969,34125,21697,56389,32143,9499,32111,64254,34357,68482
ֵ,XiangLiJieDao,321302002,50740,5629,33295,18565,49639,30708,10221,30568,61276,33295,66590
ӱֵ,HeBinJieDao,321302003,19331,1796,11879,7292,19843,11446,3425,11888,23334,12673,24552
ųǽֵ,GuChengJieDao,321302004,30073,1937,18188,12501,25457,17783,6342,18411,36194,20164,38352
ƺӽֵ,HuangHeJieDaoBan,321302050,35362,2753,23086,14522,27358,22986,8930,23734,46720,23959,47045
ųֵ,GuChuJieDaoBan,321302051,16258,1834,9967,4715,17977,8413,3153,8968,17381,11278,21245
˫ׯ,ShuangZhuangZhen,321302100,34069,3990,21965,12446,33239,20986,7073,21924,42910,23167,45132
,GengCheZhen,321302101,23949,3450,15905,9120,31040,15881,5786,17150,33031,17280,33185
,BuZiZhen,321302102,30996,5083,22003,12352,41544,21962,7823,21838,43800,21899,43902
,LongHeZhen,321302103,27365,4584,20012,11420,38712,20001,7917,19783,39784,19854,39866
,YangBeiZhen,321302104,22200,3834,16206,9055,30704,16114,6131,15688,31802,15959,32165
ּ,CangJiZhen,321302105,21819,4320,17450,10471,32873,17434,8375,17025,34459,17064,34514
,YangHeZhen,321302106,48209,4951,30732,15908,52312,27394,11087,28515,55909,33515,64247
,ZhongYangZhen,321302107,25824,4602,20191,11707,38920,20107,9884,19969,40076,20119,40310
֣¥,ZhengLouZhen,321302108,20055,4490,16302,10164,31657,16275,7588,15774,32049,15831,32133
¼,ChenJiZhen,321302109,24013,4369,17819,10215,36625,17811,8808,19334,37145,19371,37190
,LuoWeiXiang,321302201,22184,4105,16768,9666,32110,16724,7086,16504,33228,16607,33375
ϲ,NanCaiXiang,321302202,22738,4271,16702,10038,31847,16656,6522,16620,33276,16829,33531
԰,TuYuanXiang,321302203,19392,3148,15311,8209,28418,15311,7681,14910,30221,14910,30221
,SanKeShuXiang,321302350,21906,3474,15207,8592,28785,15175,5209,15254,30429,15382,30589
˳,ShunHeZhen,321311100,91706,8321,57193,30700,86483,52528,17771,54282,106810,60605,117798
,XiaoDianZhen,321311101,50047,6123,34498,14708,52484,26676,10220,27545,54221,31892,66390
̼,CaiJiZhen,321311102,26705,4693,18544,10531,36053,18520,6016,18737,37257,18870,37414
ټ,WangGuanJiZhen,321311103,31192,5412,21122,11520,41751,20678,6317,21241,41919,21799,42921
,ZaoHeZhen,321311104,30262,5074,20341,11710,40507,20338,6580,21462,41800,21575,41916
,YangHuaZhen,321311105,15197,3541,12312,7534,22832,12247,4704,11036,23283,11130,23442
,DaXingZhen,321311106,31028,4999,22207,11696,40939,21646,7303,20448,42094,21123,43330
,DingZuiZhen,321311107,18796,3464,14056,7708,26881,14050,5043,13210,27260,13247,27303
,LaiLongZhen,321311108,23839,3697,17243,9249,32402,16796,7003,16709,33505,17296,34539
ƶ,HuangDunZhen,321311109,18167,3020,12334,6410,24478,12197,3774,12444,24641,12627,24961
½,LuJiZhen,321311110,26671,4525,18219,10098,35616,18172,5763,18576,36748,18740,36959
,GuanMiaoZhen,321311111,22916,3848,16590,8820,31692,16363,6249,16156,32519,16423,33013
,ShiLingZhen,321311112,17048,3059,12440,7453,24067,12416,5019,12623,25039,12686,25126
ׯ,XinZhuangZhen,321311113,13036,2397,9284,5405,17863,9255,3143,9202,18457,9292,18576
ͷ,JingTouXiang,321311200,12474,1893,8542,4720,16730,8535,3205,9022,17557,9030,17572
ܼ,CaoJiXiang,321311201,20752,3460,14096,7758,27630,14070,4760,14647,28717,14876,28972
,BaoAnXiang,321311202,11943,2232,8934,5343,16900,8923,3312,8515,17438,8553,17487
ɽֳ,ZhangShanLinChang,321311400,2326,387,1660,995,3116,1658,627,1677,3335,1680,3340
,ShuChengZhen,321322100,317033,27879,202284,110092,308735,183507,64871,190854,374361,207499,409783
¤,LongJiZhen,321322101,13072,2362,9969,5707,18689,9849,4277,9518,19367,9742,19711
,HuJiZhen,321322102,31968,4606,23029,11277,42466,22809,9002,22130,44939,22547,45576
Ǯ,QianJiZhen,321322103,16306,2981,12708,7005,23008,12584,4940,11347,23931,11519,24227
,TangGouZhen,321322104,22406,3801,16904,8962,31700,16793,6672,15738,32531,15975,32879
�,MaChangZhen,321322105,37304,5577,27129,13856,51055,26960,10400,26025,52985,26152,53281
,YiTaoZhen,321322106,37496,5571,27537,14908,53978,27519,12086,27563,55082,27616,55153
ͷ,MiaoTouZhen,321322107,28475,4480,20187,11026,38190,19878,7264,19754,39632,20032,40219
ɽ,HanShanZhen,321322108,20165,3724,15307,8302,29630,14865,6392,14118,28983,14974,30281
,HuaChongZhen,321322109,29864,4391,21214,11178,39501,20599,8357,21045,41644,21398,42612
ɣ,SangXuZhen,321322110,31853,4671,22310,11772,42611,22208,9122,23190,45398,23336,45646
,YueLaiZhen,321322111,26551,3955,19339,10010,37791,19133,8437,19289,38422,19604,38943
,LiuJiZhen,321322112,19572,3594,14903,8227,27622,14899,5896,14148,29047,14159,29062
,LiHengZhen,321322114,18767,3555,14300,8487,27351,14125,6036,13743,27868,14058,28358
,ZhaXiaZhen,321322115,35520,4686,24447,13224,46928,24266,9692,24935,49201,25451,49898
ռ,YanJiZhen,321322116,31475,4923,22265,11890,43663,22265,9113,23245,45510,23246,45511
,TongYangZhen,321322117,27919,4678,20624,11518,40353,20619,8892,20860,41479,20865,41489
,LongMiaoZhen,321322118,29404,4108,20381,11068,40012,20379,8105,21201,41580,21236,41617
,GaoXuZhen,321322119,18356,3165,13217,7735,25367,13189,5142,13416,26605,13446,26663
,GengWeiZhen,321322120,19189,3316,14318,8165,27766,14307,6118,14289,28596,14305,28623
,TangJianZhen,321322122,20331,3485,14838,7894,28330,14602,5483,14023,28625,14461,29299
º,XinHeZhen,321322124,25467,3745,18023,9325,34812,18014,7000,18156,36170,18189,36212
͹,XianGuanZhen,321322125,34435,4654,23414,11870,46266,23405,9002,24645,48050,24677,48091
⼯,WuJiZhen,321322126,23928,3557,17127,8771,33892,17046,7210,17434,34480,17568,34695
,HuDongZhen,321322127,21623,3449,15346,8962,29116,15332,6030,15724,31056,15756,31102
,QingYiHuZhen,321322128,23232,3435,15883,8560,30678,15850,5948,16636,32486,16732,32615
,BeiDingJiXiang,321322200,13435,2353,10699,5858,19809,10690,4636,9708,20398,9725,20424
ܼ,ZhouJiXiang,321322201,13328,2469,10445,5689,19349,10415,4167,9476,19891,9519,19964
С,DongXiaoDianXiang,321322202,17735,2777,13046,7105,24640,13043,5415,12843,25886,12881,25927
,ZhangWeiXiang,321322203,11385,2425,9192,5710,17459,9180,4115,8721,17901,8733,17925
,MaoWeiXiang,321322204,22193,3695,16606,9165,31680,16605,7026,16278,32883,16308,32914
,XiWeiXiang,321322205,13455,2518,10320,5989,19411,10319,4558,10182,20501,10211,20531
ƥ,WanPiXiang,321322206,21303,3098,15217,8221,28974,15216,6183,15365,30581,15367,30584
ٶ,GuanDunXiang,321322207,16298,2679,11906,6704,23345,11901,5030,12069,23970,12101,24007
ũ,QingYiHuNongChang,321322400,4940,993,3507,2424,6635,3495,1328,3719,7214,3754,7261
,ZhongXingZhen,321323100,202467,22720,131867,72848,241831,125075,47965,131679,256754,141285,273152
԰,AiYuanZhen,321323101,32263,4760,23331,12693,46830,23316,10458,24113,47429,24150,47481
,WangJiZhen,321323102,38584,7114,29421,16518,57556,29032,13200,29113,58145,29477,58898
,PeiWeiZhen,321323103,33554,6427,24477,14583,48014,24434,10087,25500,49934,25591,50068
Ԭ,XinYuanZhen,321323104,26896,4573,19316,10443,37978,19308,7408,19500,38808,19561,38877
,LiKouZhen,321323105,20770,5328,16606,10904,33153,16472,7561,16619,33091,17053,33659
ٺ,LinHeZhen,321323106,27591,4321,19988,10702,39427,19786,8812,20398,40184,20736,40724
,ChuanChengZhen,321323107,19658,3323,15063,8237,29325,15012,6991,14772,29784,14909,29972
ż,ZhangJiaWeiZhen,321323108,21423,3634,15978,8560,31243,15968,7294,16352,32320,16373,32351
߶,GaoDuZhen,321323109,18408,3646,14005,8063,27887,14000,6561,14602,28602,14610,28615
¬,LuJiZhen,321323110,23514,4036,17212,8832,34412,17203,7625,17921,35124,17963,35175
ׯ,ZhuangWeiXiang,321323200,21797,3804,17255,8332,31916,17171,7891,16024,33195,16237,33492
,LiRenXiang,321323201,17873,3283,14202,8033,27912,14202,7141,14095,28297,14095,28297
ׯ,SanZhuangXiang,321323202,23256,3801,17157,9222,34130,17157,7976,17875,35032,17876,35033
,NanLiuJiXiang,321323203,21620,3624,15933,8329,31935,15930,7252,16561,32491,16563,32496
˼,BaJiXiang,321323204,12992,2440,9942,5639,19333,9939,4588,10049,19988,10078,20020
޻ԭֳ,MianHuaYuanZhongChang,321323400,3025,433,1993,1201,3327,1968,628,2077,4045,2093,4086
ũ,SiYangNongChang,321323401,6372,949,4147,2279,7812,4101,1395,4297,8398,4569,8716
,QingYangZhen,321324100,190727,18541,126548,77135,197911,119507,45507,121114,240621,128227,254775
˫,ShuangGouZhen,321324101,25097,3528,17234,10576,33002,17234,5874,17261,34495,17265,34499
,ShangTangZhen,321324102,30714,4972,21743,12499,41965,21742,7801,21731,43473,21744,43487
κӪ,WeiYingZhen,321324103,22797,3338,15492,8013,31455,15492,5672,16315,31807,16315,31807
ٻ,LinHuaiZhen,321324104,9007,1207,6171,3862,11648,6164,2105,6121,12285,6148,12319
,BanChengZhen,321324105,9430,1713,6725,4585,13088,6720,2564,6968,13688,6982,13707
԰,SunYuanZhen,321324106,26414,4368,18927,10710,37273,18924,7867,19680,38604,19722,38649
÷,MeiHuaZhen,321324107,22477,3224,16051,8729,30855,16036,6961,16534,32570,16611,32662
,GuiRenZhen,321324108,36734,5458,27355,13215,51992,27354,12380,27216,54570,27217,54572
,JinSuoZhen,321324109,24547,4332,18446,9798,34563,18411,7708,18007,36418,18141,36587
,ZhuHuZhen,321324110,23211,4116,16590,9651,32655,16232,6461,16691,32923,17198,33788
缯,JieJiZhen,321324111,22113,3959,16777,10224,32396,16772,7873,17128,33900,17168,33945
̫ƽ,TaiPingZhen,321324112,18534,3493,13849,8458,27233,13842,5916,14066,27908,14094,27943
,LongJiZhen,321324113,21573,4119,15792,9548,31496,15753,6535,16275,32028,16435,32227
ĺ,SiHeXiang,321324200,15896,3229,12224,7415,22723,12214,4871,11726,23940,11772,23996
ɽ,FengShanXiang,321324201,11720,2428,8878,5516,16686,8870,3386,8585,17455,8656,17534
ں,TianGangHuXiang,321324202,17540,3358,13465,7170,25828,13459,5385,12761,26220,12818,26283
,CheMenXiang,321324203,19834,2625,13320,6811,25798,13319,4507,13630,26949,13646,26966
,YaoGouXiang,321324204,14167,2088,9934,5608,19052,9901,4237,10460,20361,10558,20492
ʯ,ShiJiXiang,321324205,14933,2049,10320,5679,20090,10315,4014,10635,20950,10676,20996
ͷ,ChengTouXiang,321324206,11773,1810,8179,4832,15937,8164,2975,8317,16481,8379,16558
,ChenWeiXiang,321324207,20104,3463,14516,7969,27975,14513,5869,14864,29377,14920,29436
,CaoMiaoXiang,321324208,21884,3561,16153,8676,30100,16153,7435,16727,32880,16727,32880
ｭũ,WuLiJiangNongChang,321324400,5112,461,3365,2132,6068,3152,1061,3134,6286,3269,6634
ũ,HongZeHuNongChang,321324401,5016,1052,2205,2164,4080,2205,488,2511,4716,4351,6556
岨ֵ,QingBoJieDao,330102001,18538,4542,13086,9705,18607,12613,2062,11579,24192,12056,25142
ֵ,HuBinJieDao,330102003,16213,4963,11829,8681,16628,11113,1763,10364,21477,11110,22939
СӪֵ,XiaoYingJieDao,330102004,56476,13124,39192,29521,52916,37129,5687,34512,71641,36095,75287
ǽֵ,NanXingJieDao,330102008,38174,5155,23659,18323,25565,22966,4638,22917,45883,24308,47967
ֵ,ZiYangJieDao,330102009,63670,10237,40674,32318,47576,39315,7795,38458,77773,41028,81702
ֵ,WangJiangJieDao,330102010,72255,9792,45537,34112,48365,43417,9510,43143,86560,46020,91557
ֵ,ChangQingJieDao,330103001,34834,6264,23616,16716,30845,22353,4245,20521,42874,21727,45343
ֵֽ,WuLinJieDao,330103002,27141,6904,19559,14075,27383,18745,3465,17023,35768,17951,37510
ˮֵ,TianShuiJieDao,330103003,25505,5693,17742,12154,25112,15682,2708,14179,29861,16164,33906
ֵ,ChaoMingJieDao,330103005,44266,8650,29943,21903,39785,29153,5119,27241,56394,28092,58035
ͽֵ,ZhaoHuiJieDao,330103006,64219,11603,39902,27371,52940,35240,6399,33313,68553,42319,82221
ͽֵ,WenHuiJieDao,330103007,45219,4339,27341,21215,24308,25642,5772,25444,51086,27989,55330
½ֵ,DongXinJieDao,330103008,99277,7923,57738,50107,48138,54387,11376,56705,111092,60838,118576
ʯŽֵ,ShiQiaoJieDao,330103009,82281,3082,43599,38194,21531,38485,9812,44235,82720,51576,95175
ֵ,KaiXuanJieDao,330104005,54237,7940,35106,24618,40245,32022,6435,30676,62698,33506,68612
ɺɽֵ,CaiHeJieDao,330104006,70134,9623,46686,32239,50927,43499,9662,40489,83988,42733,89419
բŪڽֵ,ZhaNongKouJieDao,330104007,72701,8875,46080,33541,44246,44008,10174,43311,87319,45670,91750
ļֵ,SiJiQingJieDao,330104008,44527,2991,25156,17022,20119,22791,6132,23058,45849,28494,53650
ֵ,BaiYangJieDao,330104009,204521,537,104782,16256,61842,15642,5160,18094,33736,105436,210218
ɳֵ,XiaShaJieDao,330104010,90126,2928,34748,26026,25608,27613,7461,31985,59598,65767,100515
�,PengBuZhen,330104102,133005,4491,69888,62261,31537,62163,13476,69470,131633,81084,150972
,JianQiaoZhen,330104103,77706,4764,42753,38947,33717,41231,9184,46194,87425,48901,91654
,DingQiaoZhen,330104104,28072,2453,15641,9982,15099,14437,3852,14712,29149,18736,34377
ű,JiuBaoZhen,330104105,92355,4128,48837,41851,30213,45187,11133,51172,96359,58779,107616
ֵ,MiShiXiangJieDao,330105001,33871,5958,22173,16299,27036,21102,3711,19898,41000,21367,43540
ֵ,HuShuJieDao,330105002,28440,4138,17552,14222,20547,17011,3314,16815,33826,18340,35892
Сӽֵ,XiaoHeJieDao,330105003,41351,6792,26888,20292,28507,25814,5464,25321,51135,26719,53607
ֵ,HeMuJieDao,330105004,20084,2287,12173,9941,10437,11761,2434,12180,23941,12632,24805
Žֵ,GongChenQiaoJieDao,330105005,36120,7093,24148,17989,32034,23330,4791,22683,46013,23856,48004
ؽֵ,DaGuanJieDao,330105007,41527,5442,26494,19306,29213,25214,4964,24253,49467,25439,51933
ֵ,ShangTangJieDao,330105008,85302,3294,45557,32659,26090,31218,6372,34354,65572,49411,94968
ֵ,XiangFuJieDao,330105009,91847,3857,48720,46643,27112,45239,9714,51614,96853,56698,105418
,KangQiaoZhen,330105102,35515,2060,18785,18121,15107,18009,4525,21250,39259,23315,42100
ɽ,BanShanZhen,330105103,41546,4561,22906,19873,24008,21974,5500,24704,46678,28701,51607
ɽֵ,BeiShanJieDao,330106002,20539,5799,15175,10921,21414,14350,2821,13210,27560,13984,29159
Ϫֵ,XiXiJieDao,330106004,60862,9508,40072,24214,58723,32591,9133,31614,64205,39431,79503
Էֵ,CuiYuanJieDao,330106005,72471,6473,45111,28439,40687,31970,7323,32337,64307,41156,86267
ŵֵ,GuDangJieDao,330106007,54790,5355,33427,25852,30995,30482,7204,30564,61046,33922,67349
ֵ,XiHuJieDao,330106008,24869,2712,15126,8544,14893,11481,2427,11288,22769,14882,30008
½ֵ,LiuXiaJieDao,330106009,88403,2313,43068,24085,25601,22672,5063,25741,48413,52711,95779
תֵ,ZhuanTangJieDao,330106010,58552,5155,35546,18784,44528,27852,7327,27726,55578,35488,71034
ֵ,JiangCunJieDao,330106011,23993,1851,13186,8239,13590,11628,3428,12093,23721,16086,29272
ֵ,LingYinJieDao,330106012,36488,6166,20157,12733,32566,16330,3416,15376,31706,25913,46070
½ֵ,WenXinJieDao,330106013,69034,5894,44055,34622,47549,42783,12979,42224,85007,43852,87907
,SanDunZhen,330106109,111409,7324,62323,38050,63857,49031,13898,51187,100218,70308,132631
˫,ShuangPuZhen,330106110,49934,6702,31761,17033,53467,30750,8402,30628,61378,33277,65038
˽ֵ,XiXingJieDao,330108001,48938,3582,28559,18649,28382,24713,7915,25060,49773,31876,60435
ӽֵ,ChangHeJieDao,330108002,88644,5299,49926,35292,44816,44242,12816,45953,90195,56833,106759
ؽֵ,PuYanJieDao,330108003,134628,5284,72962,51344,49254,50520,11921,56184,106704,78871,151833
ֵ,ChengXiangJieDao,330109001,117951,13102,72414,53344,93783,68171,17535,65207,133378,76174,148588
ɽֵ,BeiGanJieDao,330109002,76751,6496,49154,32752,51168,45607,13851,44067,89674,47944,97098
ɽֵ,ShuShanJieDao,330109003,45864,4149,28596,18120,32643,26034,7972,26787,52821,29389,57985
ֵ,XinTangJieDao,330109004,70036,6270,44135,27027,51356,39174,12146,39156,78330,44317,88452
ֵ,JingJiangJieDao,330109005,32619,3800,20440,12740,28821,19073,5182,19079,38152,21161,41601
ֵ,NanYangJieDao,330109006,41043,4581,25735,17155,34147,24895,6840,25333,50228,26729,52464
ֵ,YiPengJieDao,330109007,51758,6946,33876,22697,49269,32537,9387,32446,64983,34215,68091
ׯֵ,HeZhuangJieDao,330109008,35275,5770,24181,14867,40316,23833,7002,23419,47252,23866,48047
ֵ,XinWanJieDao,330109009,20381,2792,13135,8651,19975,12787,3877,12834,25621,13915,27050
ٽֵ,LinJiangJieDao,330109010,9515,608,4434,3404,4044,3961,1136,4379,8340,6825,11259
ǰֵ,QianJinJieDao,330109011,8347,839,4985,3799,6187,4898,1467,5177,10075,5668,10653
¥,LouTaZhen,330109100,17407,2994,11992,7767,19769,11238,3213,10911,22149,11622,23614
,HeShangZhen,330109101,22944,3439,14739,8448,22671,12874,3531,12599,25473,15175,29914
,DaiCunZhen,330109102,29607,4353,19316,12631,29529,17893,4942,17861,35754,19586,38902
,PuYangZhen,330109103,30111,3611,18145,10094,27455,15477,3974,15668,31145,19551,37696
,JinHuaZhen,330109104,34670,5468,23075,15606,37914,22766,6263,22523,45289,23326,46401
,LinPuZhen,330109105,46387,6246,30381,18991,46186,28022,7722,27531,55553,29974,60355
,YiQiaoZhen,330109106,37875,5505,25107,15916,40267,24317,6784,23710,48027,25057,50164
ǰ,SuoQianZhen,330109107,29137,4321,19573,11355,32798,18970,5642,18598,37568,19527,39100
ǰ,YaQianZhen,330109108,27650,2893,17307,11392,22367,16231,4657,16581,32812,17893,35200
,WenYanZhen,330109109,36126,2887,21449,16256,22541,20542,5440,21569,42111,23004,44453
Χ,NingWeiZhen,330109110,44486,5630,29364,20063,47896,28914,8534,28429,57343,29286,58650
½,XinJieZhen,330109111,51049,5666,32884,22623,46786,31968,9294,32002,63970,33125,66009
ɽ,KanShanZhen,330109112,44081,5931,28664,17536,44025,27401,7867,27556,54957,29215,57879
,GuaLiZhen,330109113,63093,7587,40815,24052,57568,37279,10583,36001,73280,40448,81263
ɽ,DangShanZhen,330109114,39829,5599,25846,18175,36875,25441,6859,25861,51302,26441,52287
ũ,YiNongZhen,330109115,33565,5428,22470,15921,35365,22070,6616,22476,44546,23139,45609
,DangWanZhen,330109120,31861,5092,22156,14541,34407,21475,6432,20125,41600,21229,43385
ɽÿ,XiaoShanJingJiKaiFaQu,330109401,40155,1048,19309,11683,8706,11522,3071,13077,24599,24965,44274
ζȼί,XiangHuLvYouDuJiaQuGuanWeiHui,330109402,3258,217,1664,1407,707,1504,317,1651,3155,2128,3792
Χ,WeiKenQu,330109501,1000,14,376,423,6,345,41,461,806,679,1055
ƽֵ,LinPingJieDao,330110001,26396,3036,17180,12200,19394,15751,3920,15162,30913,16172,33352
Էֵ,NanYuanJieDao,330110002,66874,5536,35941,23249,51828,33677,9845,33038,66715,46314,82255
ֵ,DongHuJieDao,330110003,38067,3313,24191,16334,24029,21732,6008,21583,43315,23197,47388
Žֵ,XingQiaoJieDao,330110004,29350,2253,17175,12549,16244,16623,4989,17695,34318,19417,36592
峣ֵ,WuChangJieDao,330110005,43984,2621,24263,17304,19168,20398,5135,22452,42850,27477,51740
˾,QiaoSiZhen,330110100,90038,4915,50060,43226,38330,43548,8958,47549,91097,53851,103911
˺,YunHeZhen,330110101,36091,4846,23552,15080,34728,23186,6399,23491,46677,23784,47336
,TangQiZhen,330110102,61262,9543,39672,25023,66840,38308,9185,38317,76625,40318,79990
,ChongXianZhen,330110103,41503,4995,26397,17022,38936,26031,7208,26726,52757,27309,53706
ʺ,RenHeZhen,330110104,49838,7001,32561,19016,57388,32054,8368,31711,63765,32646,65207
,LiangZhuZhen,330110105,119876,11077,71387,50206,88155,68176,17993,71149,139325,77559,148946
,XianLinZhen,330110106,39662,3697,24147,16113,25220,22499,6193,22734,45233,25405,49552
ǰ,CangQianZhen,330110107,26241,3844,16959,10669,26474,16536,4267,16470,33006,17393,34352
ຼ,YuHangZhen,330110108,64188,7263,39813,28075,52905,37304,8920,36772,74076,40558,80371
ɽ,JingShanZhen,330110109,25172,4427,16483,11989,30035,16156,3809,16244,32400,16925,33408
ƿҤ,PingYaoZhen,330110110,45046,6752,29009,19323,47771,27573,6698,27530,55103,29487,58496
,LuNiaoZhen,330110111,7875,1454,5270,3837,9439,5222,1116,5089,10311,5175,10445
,BaiZhangZhen,330110112,7359,1126,4649,3486,8021,4533,1072,4481,9014,4908,9557
ƺ,HuangHuZhen,330110113,9000,1562,6037,4203,10627,5946,1550,5949,11895,6075,12112
̩,ZhongTaiXiang,330110200,21647,2822,13402,8696,20497,12696,3240,12984,25680,14307,27709
ຼÿ,YuHangJingJiKaiFaQu,330110300,68985,5027,40823,29172,40880,37808,10792,39674,77482,43981,84804
Ǯÿϰ´,QianJiangJingJiKaiFaQuTangNanBanShiChu,330110400,14189,2242,9436,4883,16816,9184,2630,8952,18136,9625,19061
ֵͩ,TongJunJieDao,330122001,116638,10781,71031,51131,90498,65703,18809,65651,131354,75197,146228
ؽֵ,JiuXianJieDao,330122002,6393,1048,4201,3037,6290,4105,1127,4142,8247,4367,8568
,FuChunJiangZhen,330122101,19160,3573,12317,9606,19612,12120,3126,12551,24671,13542,25859
,HengCunZhen,330122102,35181,4713,22808,16076,32750,21737,6192,22039,43776,23278,46086
ﴨ,FengChuanZhen,330122107,11494,1754,7356,5860,12276,7211,2061,7540,14751,7953,15309
ˮ,FenShuiZhen,330122109,42109,5483,27644,20402,38716,26297,7457,25805,52102,27405,55049
,YaoLinZhen,330122110,19509,4113,13644,9600,24315,13301,3456,12815,26116,13434,27078
ٽ,BaiJiangZhen,330122112,8624,2076,6275,4968,11333,6206,1533,5836,12042,5958,12233
,JiangNanZhen,330122113,27444,4976,18728,13961,34638,18577,5825,19121,37698,19517,38245
ݭɽ,EShanSheZuXiang,330122201,5312,980,3698,2665,6537,3678,1102,3662,7340,3696,7394
ɽ,ZhongShanXiang,330122202,9653,2362,6987,5419,12772,6965,2015,6918,13883,7043,14030
º,XinHeXiang,330122204,3471,540,2157,2031,2937,2112,566,2235,4347,2420,4577
ϴ,HeCunXiang,330122210,3869,1072,2957,2490,5517,2930,853,2793,5723,2837,5794
ǧ,QianDaoHuZhen,330127100,81720,7631,50665,36278,62744,46020,14045,45702,91722,52731,103396
Ĳ,WenChangZhen,330127101,6113,1520,4514,3505,8124,4453,1127,4114,8567,4246,8760
ʯ,ShiLinZhen,330127102,2268,540,1536,1150,2789,1468,354,1431,2899,1626,3162
,LinQiZhen,330127103,9667,1981,7036,5550,12865,7006,2050,6549,13555,6662,13698
ƺ,WeiPingZhen,330127104,20408,5338,15721,12974,28157,15122,4111,13372,28494,14136,29857
,JiangJiaZhen,330127106,9610,2754,7581,6624,13936,7545,2445,7171,14716,7228,14809
ͩ,ZiTongZhen,330127107,8638,2065,6313,5045,12090,6313,1668,6047,12360,6058,12371
ڿ,FenKouZhen,330127108,27211,5055,19861,14116,35782,19088,6322,18053,37141,18727,38588
,ZhongZhouZhen,330127109,6328,1944,5452,4629,9730,5437,1857,4646,10083,4677,10129
,DaShuZhen,330127110,6416,1485,4641,3746,8749,4555,1340,4369,8924,4600,9241
,FengShuLingZhen,330127111,7660,2017,5645,4550,10829,5531,1677,5427,10958,5709,11354
,LiShangXiang,330127200,4884,1209,3499,2746,6566,3419,841,3298,6717,3435,6934
,JinFengXiang,330127201,1622,733,1341,1374,2484,1339,309,1313,2652,1323,2664
,FuWenXiang,330127202,3251,871,2416,1914,4565,2387,647,2297,4684,2353,4769
,ZuoKouXiang,330127203,4818,1268,3570,2811,6689,3563,900,3402,6965,3416,6986
,PingMenXiang,330127205,6074,1367,4596,3546,8501,4595,1352,4189,8784,4197,8793
ɽ,YaoShanXiang,330127206,5682,941,3936,2782,7494,3933,1143,3827,7760,3830,7766
,WangFuXiang,330127208,7849,1957,6077,4938,11297,6040,1774,5359,11399,5503,11580
δ,SongCunXiang,330127210,2819,792,2168,1755,4050,2166,602,2041,4207,2045,4213
,JiuKengXiang,330127211,3366,871,2518,2171,4662,2518,559,2278,4796,2278,4796
˴,LangChuanXiang,330127212,6996,2079,5658,4668,10414,5571,1866,5087,10658,5283,10941
,JieShouXiang,330127214,3476,963,2566,2308,4822,2544,715,2538,5082,2588,5154
,AnYangXiang,330127216,4594,1276,3478,2972,6564,3453,1012,3353,6806,3404,6882
°ֵ,XinAnJiangJieDao,330182001,72905,8793,46866,33880,64145,43972,12254,42929,86901,47086,93952
Ϫֵ,YangXiJieDao,330182002,11727,1496,6920,5087,9562,6220,1747,6852,13072,8050,14970
¥ֵ,GengLouJieDao,330182003,14377,2458,9402,6726,16837,9344,2542,9841,19185,9975,19377
,LianHuaZhen,330182101,5806,1247,3934,2836,7296,3870,935,3913,7783,4054,7988
Ǭ̶,QianTanZhen,330182102,31219,4904,20609,14221,33888,19948,5097,19897,39845,20611,41220
÷,MeiChengZhen,330182104,30594,5332,19992,14933,31546,18830,4430,18811,37641,20364,40356
,YangCunQiaoZhen,330182105,11571,2356,7803,5697,14174,7548,1876,7599,15147,8000,15803
,XiaYaZhen,330182106,13554,3099,9388,6835,17310,9314,2289,9387,18701,9554,18942
,DaYangZhen,330182107,16291,3874,11687,9158,22085,11626,3402,11758,23384,11880,23567
,SanDouZhen,330182108,13143,2865,9046,6713,17044,8876,2348,9036,17912,9310,18356
ٲ,ShouChangZhen,330182109,30111,5199,20223,13817,34214,19148,5333,18823,37971,20420,40643
ͷ,HangTouZhen,330182110,16686,3718,11902,8437,22410,11860,3509,11842,23702,12011,23913
,DaCiYanZhen,330182111,8929,2558,6780,5539,12512,6741,2096,6703,13444,6803,13583
ͬ,DaTongZhen,330182112,24514,6397,18406,14240,34300,18327,5872,18193,36520,18377,36783
,LiJiaZhen,330182113,9488,2381,6810,5394,12934,6783,2084,7028,13811,7143,13953
,QinTangXiang,330182202,5460,945,3638,2638,5858,3412,939,3528,6940,3706,7344
ֵ,FuChunJieDao,330183001,174210,11968,106646,72379,110778,96974,31002,97914,194888,110534,217180
ֵ,ChunJiangJieDao,330183002,39516,2651,22883,17390,21490,22153,7099,25013,47166,26383,49266
¹ɽֵ,LuShanJieDao,330183004,19879,2188,12474,7171,17436,10532,3196,10771,21303,12789,25263
޽ֵ,DongZhouJieDao,330183005,35099,4307,21750,14201,34761,20909,6309,22006,42915,23965,45715
,WanShiZhen,330183100,12925,2683,9074,6408,16860,9001,2504,8920,17921,9038,18112
,DongQiaoZhen,330183101,11406,2375,7752,5187,14807,7611,1792,7591,15202,7821,15573
,LuZhuZhen,330183103,9045,1737,6095,4425,11248,6041,1671,6147,12188,6358,12453
,YongChangZhen,330183105,6754,1228,4552,2850,7761,4229,1186,4212,8441,4616,9168
ɽ,LiShanZhen,330183108,5811,1052,3998,2704,7636,3991,1199,4047,8038,4064,8062
,ChangLvZhen,330183109,6620,1765,4888,3963,9202,4887,1434,4908,9795,4931,9819
,ChangKouZhen,330183110,21425,3922,14542,10319,28582,14505,4362,15080,29585,15167,29709
,ChangAnZhen,330183111,10789,2405,7171,5307,14056,7102,1858,7690,14792,7881,15052
,LongMenZhen,330183112,3369,715,2261,1825,4312,2229,580,2312,4541,2403,4664
,GaoQiaoZhen,330183113,29655,3063,17610,9972,23664,14586,5081,15168,29754,20189,37799
ܽ,ShouXiangZhen,330183114,16436,1799,9951,6684,13242,9400,2903,9782,19182,11187,21138
µ,XinDengZhen,330183115,54132,7181,34816,23886,57547,33339,9267,34023,67362,35764,70580
,XuKouZhen,330183116,11057,2271,7291,5218,13373,7182,1846,7414,14596,7883,15174
Դ,DaYuanZhen,330183117,25862,3802,16836,12216,24578,16235,5567,17307,33542,18395,35231
,LingQiaoZhen,330183118,21542,2621,13494,9070,20047,12967,4018,14018,26985,14687,28181
ͩ,XinTongXiang,330183200,5469,1268,3740,3176,7297,3700,1095,3911,7611,4092,7832
Ϲ,ShangGuanXiang,330183201,7203,852,4491,3170,5771,4018,1356,4327,8345,4920,9411
ɽ,HuanShanXiang,330183204,7874,1092,5255,3482,9464,5072,1848,5355,10427,5559,10814
Դ,HuYuanXiang,330183205,3717,1352,2880,2540,5539,2861,715,2871,5732,2904,5784
,ChunJianXiang,330183206,4700,922,3122,2391,5802,3067,807,3211,6278,3307,6429
ɽ,YuShanXiang,330183207,6595,1353,4639,3262,8380,4608,1337,4478,9086,4646,9285
ǽֵ,JinChengJieDao,330185001,146562,9547,87489,59173,94741,73752,20800,74967,148719,89420,176909
ֵ,LingLongJieDao,330185002,26748,2579,16033,11272,18378,14697,3924,15216,29913,17218,33251
ɽֵ,QingShanHuJieDao,330185003,24642,2174,13314,9093,15593,12083,3569,13434,25517,17071,30385
Ͻֵ,JinNanJieDao,330185005,14115,1242,7762,7412,8744,7564,1677,8893,16457,9272,17034
,SanKouZhen,330185100,4494,968,2935,2362,5307,2840,571,2905,5745,3098,6033
,HengFanZhen,330185101,11609,1620,7235,5019,10872,6772,1711,6923,13695,7705,14940
ߺ,GaoHongZhen,330185102,24338,1584,14168,12789,11438,13840,3106,14496,28336,14860,29028
̫Դ,TaiHuYuanZhen,330185103,21547,3459,13885,10422,22958,13413,3141,13773,27186,14262,28147
Ǳ,YuQianZhen,330185104,28099,4607,18593,14068,31076,17753,4290,17533,35286,18403,36996
Ϫ,ZaoXiZhen,330185105,11694,2310,7837,6017,13904,7624,1762,7513,15137,7929,15766
̫,TaiYangZhen,330185106,10174,1918,6796,5519,11749,6738,1615,6832,13570,6911,13707
Ǳ,QianChuanZhen,330185107,6830,1729,4794,3985,8955,4791,986,4719,9510,4751,9545
,ChangHuaZhen,330185108,17768,2374,11287,7911,16766,10130,2467,10164,20294,11322,22609
,HeQiaoZhen,330185109,8713,2127,6096,5118,11266,6081,1209,5923,12004,5953,12049
,LongGangZhen,330185110,6854,1306,4534,3325,8417,4518,917,4467,8985,4543,9077
Ŀ,TuanKouZhen,330185111,6882,1518,4796,3693,9284,4749,1110,4589,9338,4714,9510
,QingLiangFengZhen,330185112,12572,2626,8498,6223,16299,8494,1712,8407,16901,8412,16910
ʯ,DaoShiZhen,330185113,11896,2130,8127,6239,15614,8105,2368,8223,16328,8267,16394
Ͽ,DaXiaGuZhen,330185114,7297,1310,4810,3678,9372,4790,1292,5033,9823,5089,9899
,BanQiaoXiang,330185200,11030,1785,6974,5353,12268,6924,1662,7318,14242,7503,14477
Ŀ,XiTianMuXiang,330185201,7884,1586,5205,4050,9556,5060,1135,5062,10122,5400,10605
ǧ,QianHongXiang,330185202,3234,723,2238,1856,4248,2236,532,2245,4481,2251,4489
·,HengLuXiang,330185203,5428,1134,3831,2949,7243,3831,985,3716,7547,3716,7547
ƽ,LePingXiang,330185204,5393,1129,3785,2994,6707,3780,898,3632,7412,3635,7420
Х,MaXiaoXiang,330185205,5902,1233,3905,2949,7674,3900,774,3997,7897,4004,7909
,XinQiaoXiang,330185206,4330,812,3016,2260,5795,3012,887,2962,5974,3013,6029
Žֵ,NanMenJieDao,330203001,44861,6415,29466,22169,33518,27677,5655,25931,53608,27465,56931
ýֵ,JiangShaJieDao,330203002,12848,1822,8090,5655,8757,7001,1103,6503,13504,7683,15773
Žֵ,XiMenJieDao,330203003,57432,9056,36414,24790,44117,30659,5704,28500,59159,35778,72192
ºֵ,YueHuJieDao,330203004,17168,3509,11717,8692,14524,10386,1792,9543,19929,10752,22469
¥ֵ,GuLouJieDao,330203005,22985,3846,13009,10048,15834,11909,2031,10998,22907,15853,28862
ƽֵ,BaiYunJieDao,330203006,48241,4829,30806,21382,31506,28217,7498,27321,55538,29762,60568
ֵ,DuanTangJieDao,330203007,44838,3883,27125,21274,27373,25252,6161,25520,50772,27757,54882
ֵ,WangChunJieDao,330203008,50863,3453,30225,23969,22249,29260,7749,29880,59140,31840,62065
ɽֵ,BaiZhangJieDao,330204001,38530,5035,25856,17463,26574,22062,4693,19695,41757,22402,48258
ʤֵ,DongShengJieDao,330204002,30589,4040,20677,14542,20424,17944,3387,15773,33717,17339,38016
¥ֵ,MingLouJieDao,330204003,39417,4754,25460,18645,28706,24196,5490,22811,47007,24201,49661
׺׽ֵ,BaiHeJieDao,330204004,52296,7418,35181,25868,43846,33840,7304,30766,64606,31837,67018
ֵ,DongLiuJieDao,330204005,58484,4494,37709,25915,41482,35345,10469,33563,68908,35738,73447
ֵ,DongJiaoJieDao,330204006,7098,405,3867,3684,2546,3747,1020,4196,7943,4656,8523
ֵ,FuMingJieDao,330204007,51509,2766,28824,23115,19969,26741,7426,27820,54561,32877,61701
ֵ,XinMingJieDao,330204008,16382,1273,9709,7141,7163,8318,2369,8417,16735,10315,20024
ֵ,ZhongMaJieDao,330205001,14923,2317,9731,7450,11053,9278,1712,8495,17773,9221,18952
ɳֵ,BaiShaJieDao,330205002,15954,1953,10281,7778,11857,9840,2124,9293,19133,9750,20031
ֵֽ,KongPuJieDao,330205003,47570,2262,26397,13658,22004,15463,4036,15966,31429,27471,53868
Ľֵ̽,WenJiaoJieDao,330205004,29634,3292,19576,13456,18332,17224,4178,16328,33552,17528,37104
𮽭ֵ,YongJiangJieDao,330205005,24572,1565,14361,12035,10299,13943,4402,15218,29161,16178,30539
ׯŽֵ,ZhuangQiaoJieDao,330205006,63171,4710,37119,29515,31832,35558,10433,37571,73129,41195,78314
ֵ,HongTangJieDao,330205007,44258,3705,26029,20511,23933,24082,6831,25436,49518,28765,54794
ȳ,CiChengZhen,330205103,53478,7331,32690,26807,48120,31679,6831,32548,64227,34950,67640
鿽ֵ,DaXieJieDao,330206001,31845,2878,17873,12851,21955,16190,4441,16459,32649,21291,39164
´\ֵ,XinQiJieDao,330206002,126117,6894,72681,54933,61035,66002,17718,67809,133811,78048,150729
С۽ֵ,XiaoGangJieDao,330206003,77377,5161,44338,36532,37945,42260,11542,45705,87965,49742,94080
\ֵ,DaQiJieDao,330206004,112905,7566,62755,47931,48319,55223,13093,59815,115038,70809,133564
ϼֵֽ,XiaPuJieDao,330206005,36814,3298,21161,16477,21709,20306,5082,21242,41548,24033,45194
Žֵ,ChaiQiaoJieDao,330206006,35861,5907,22574,17743,31954,21890,4115,22019,43909,23309,45883
ݼɽֵ,QiJiaShanJieDao,330206007,20765,1260,11512,9035,10395,10934,3162,11436,22370,13675,25187
׷,BaiFengZhen,330206105,27528,5873,17255,14330,27672,16780,3250,17102,33882,19396,36651
,ChunXiaoZhen,330206107,13733,2688,8372,7112,13079,8033,1491,8141,16174,9540,17912
÷ɽ,MeiShanXiang,330206201,7680,2087,5252,4394,9296,5148,902,4824,9972,5417,10669
˰,BaoShuiQu,330206401,13040,18,7005,984,412,977,176,995,1972,6229,13234
бɽֵ,ZhaoBaoShanJieDao,330211001,63701,7508,40607,31639,50463,39695,10245,38699,78394,40847,81454
Դֵ,JiaoChuanJieDao,330211002,84075,5786,47375,42016,31685,45253,13139,51298,96551,55625,103000
սֵ,LuoTuoJieDao,330211003,78364,6008,45482,36845,39648,43105,11115,45693,88798,50005,95487
ׯнֵ,ZhuangShiJieDao,330211004,53212,3413,30488,25935,22000,29595,8629,32708,62303,34766,65254
,XiePuZhen,330211100,33556,3071,19174,16732,16895,18711,4778,20441,39152,22231,41405
,JiuLongHuZhen,330211101,25694,3004,15010,12557,17323,14211,3202,15284,29495,16890,31900
Ӧֵ,XiaYingJieDao,330212001,69623,3711,40039,31362,27273,37754,11105,40137,77891,44400,84439
ӹֵ,ZhongGongMiaoJieDao,330212002,48229,1944,27750,20620,18033,24773,6957,25691,50464,29380,57130
ʯ\ֵ,ShiQiJieDao,330212003,91527,4385,54041,41715,42473,49315,14494,52085,101400,56365,110406
÷ֵ,MeiXuJieDao,330212004,40286,1971,22543,17521,15109,20576,6075,22253,42829,25789,48332
кӽֵ,ZhongHeJieDao,330212005,77246,3342,47504,31979,37444,41518,13959,41324,82842,47043,94547
Ͻֵ,ShouNanJieDao,330212006,70246,2312,39630,15865,23465,17777,4782,19153,36930,37710,77340
հ,ZhanQiZhen,330212100,26258,3463,15069,13252,18705,14111,2895,14974,29085,17547,32616
,XianXiangZhen,330212101,22622,3350,14014,10715,21447,13201,3175,13241,26442,15133,29147
Ϫ,TangXiZhen,330212102,29450,3240,17863,13852,21701,16808,4359,17345,34153,19186,37049
Ǯ,DongQianHuZhen,330212103,52885,5973,32495,25240,36217,29990,7386,30732,60722,33749,66244
,DongWuZhen,330212104,19404,2191,11072,8886,13369,10027,2354,10632,20659,12877,23949
,WuXiangZhen,330212105,36674,3786,21801,17733,24410,20502,4894,21645,42147,23553,45354
,QiuAiZhen,330212106,59519,4167,35769,24169,32572,30718,8968,31937,62655,36885,72654
,YunLongZhen,330212108,34466,3262,20229,17474,21245,19863,4766,21372,41235,22265,42494
Ϫ,HengXiZhen,330212109,31152,3893,19567,15663,22248,19002,5021,19692,38694,20499,40066
ɽ,JiangShanZhen,330212110,80187,9453,48896,40038,65814,47737,10770,49251,96988,51514,100410
,GaoQiaoZhen,330212113,75391,4723,43346,33304,41050,38381,10484,41398,79779,47252,90598
,HengJieZhen,330212114,34484,5393,21660,17840,27875,20643,3927,20799,41442,22144,43804
˸,JiShiGangZhen,330212115,45202,4280,27255,21672,31310,26236,6425,27101,53337,28652,55907
,GuLinZhen,330212116,89096,6304,53622,39052,45879,46927,13201,48861,95788,54979,108601
,DongQiaoZhen,330212118,28709,2587,17115,13467,17384,15995,4195,16980,32975,18376,35491
۴,YinJiangZhen,330212119,24914,3164,15401,12599,18918,15073,3524,15607,30680,16201,31602
ˮ,ZhangShuiZhen,330212120,14438,3588,9790,8763,16750,9700,1410,9429,19129,9646,19436
,LongGuanXiang,330212200,9115,1338,5691,4636,8542,5597,1129,5680,11277,5891,11582
ֵ,DanDongJieDao,330225001,61915,5134,39421,28041,46542,38280,11949,37376,75656,39577,78998
ֵ,DanXiJieDao,330225002,65152,4567,40148,29160,36192,37273,10771,37638,74911,40342,80490
Ϫֵ,JueXiJieDao,330225003,25720,1541,15039,10363,10771,12798,3193,13279,26077,15415,30454
ʯ,ShiPuZhen,330225101,71152,8162,45558,34038,63845,44484,13228,44779,89263,46984,92542
,XiZhouZhen,330225102,24301,5043,16913,13298,29824,16569,4396,15971,32540,16827,33740
,HePuZhen,330225103,18868,3104,12543,9382,23271,12394,3980,12982,25376,13409,25952
,XianXiangZhen,330225104,11311,3636,8167,7061,14391,8063,1507,7760,15823,8287,16454
ǽͷ,QiangTouZhen,330225105,11303,2575,7811,6054,14307,7681,1866,7658,15339,7933,15744
ͷ,SiZhouTouZhen,330225106,6153,1960,4839,4071,8936,4810,1499,4711,9521,4773,9612
,DingTangZhen,330225107,13706,3458,10241,8060,18750,10222,2774,9677,19899,9697,19938
Ϳ,TuCiZhen,330225108,7794,2456,5566,4747,10135,5439,1006,5128,10567,5690,11256
,DaXuZhen,330225109,9237,2104,6316,4729,11025,6070,1446,5898,11968,6471,12787
,XinQiaoZhen,330225110,11131,2923,8261,6469,15518,8199,2153,7867,16066,7946,16207
,DongChenXiang,330225200,12460,2349,8462,6120,15680,8380,2247,8413,16793,8594,17056
,XiaoTangXiang,330225201,8113,1897,5763,4295,10732,5697,1463,5632,11329,5710,11473
Ʊ,HuangBiAoXiang,330225202,4769,1370,3341,2938,6061,3304,628,3193,6497,3426,6767
é,MaoYangXiang,330225203,5208,1556,3667,3148,7036,3661,874,3905,7566,3971,7638
,GaoTangDaoXiang,330225204,11847,1735,7849,5665,15348,7769,2589,8178,15947,8322,16171
Ծֵ,YueLongJieDao,330226001,135297,11520,86789,61599,88982,83619,26947,83191,166810,86975,173764
Դֵ,TaoYuanJieDao,330226002,64948,3543,38360,30130,30440,36712,12385,39548,76260,42516,80876
÷ֵֽ,MeiLinJieDao,330226003,26771,2439,16198,10995,19573,14394,4900,15649,30043,17912,34110
ͷֵ,QiaoTouHuJieDao,330226004,15582,2191,10207,7910,16278,9908,3204,10457,20365,10770,20977
,ChangJieZhen,330226101,34017,7086,24050,18744,43367,23902,6874,23505,47407,23927,47977
,LiYangZhen,330226102,16439,3622,11636,9230,20598,11531,3412,11560,23091,11837,23473
һ,YiShiZhen,330226104,10745,2311,7555,6031,14604,7514,2223,7695,15209,7724,15279
·,ChaLuZhen,330226105,13239,2747,9473,7408,16970,9391,3075,9287,18678,9588,19061
ǰͯ,QianTongZhen,330226106,14295,2518,9726,7120,17725,9632,3217,10079,19711,10304,20030
ɣ,SangZhouZhen,330226107,7085,2305,5628,4801,10660,5622,1750,5483,11105,5512,11140
̳,HuangTanZhen,330226108,16804,2795,10922,8096,18520,10624,2943,11207,21831,11620,22542
Ѻ,DaJiaHeZhen,330226109,12186,1757,8038,5999,14071,7974,2746,8394,16368,8651,16689
ǿ,QiangJiaoZhen,330226110,14251,1741,8045,7313,11482,7804,2222,8972,16776,10169,18214
,XiDianZhen,330226111,56431,4477,33730,25952,38163,32813,9846,35516,68329,37024,70754
l,ShenQuanZhen,330226112,22522,3738,14585,10586,24004,13837,4321,14929,28766,15996,30581
,HuChenXiang,330226200,7055,2097,5776,4659,10794,5774,2079,5455,11229,5455,11231
Ժ,ChaYuanXiang,330226201,10188,2375,7204,5539,13776,7103,2210,7324,14427,7569,14773
ԽϪ,YueXiXiang,330226202,10455,2105,7151,5443,13914,7094,2043,7307,14401,7452,14603
޽ֵ,LiZhouJieDao,330281001,78140,9363,48918,35692,65103,45930,10926,45848,91778,49511,98429
ɽֵ,FengShanJieDao,330281002,65433,6939,40378,31942,51872,39429,10197,40100,79529,42191,82569
ֵ,LanJiangJieDao,330281003,77704,6382,46860,31885,54037,43149,11229,43117,86266,48455,95315
ֵ,YangMingJieDao,330281004,108475,11665,67730,51085,80239,64617,15782,64419,129036,68192,135922
ֵ,DiTangJieDao,330281005,48407,6027,28059,21057,39527,26959,5771,27773,54732,32146,60205
ϼֵ,LangXiaJieDao,330281006,46983,5745,28462,19318,37059,25699,5518,26249,51948,29784,58246
ɽ,LinShanZhen,330281100,34564,5526,22928,14799,36484,22503,5233,21935,44438,22395,45323
ƼҲ,HuangJiaBuZhen,330281101,31771,5072,20736,14169,35212,20338,4535,20113,40451,20642,41378
Сܶ,XiaoCaoEZhen,330281102,23373,3884,15228,11823,24148,14913,3107,14693,29606,15136,30364
,SiMenZhen,330281103,62305,8537,39753,24870,58356,35179,8133,34087,69266,39222,78975
,MaZhuZhen,330281106,44470,6356,27729,17712,41067,24357,5519,24525,48882,28616,56345
Ĳɽ,MouShanZhen,330281108,15520,2329,9812,6670,16100,9465,2184,9715,19180,10221,20033
ͤ,ZhangTingZhen,330281109,30812,3673,19134,13537,27782,18015,4830,18522,36537,20181,39315
,SanQiShiZhen,330281110,25207,3544,16162,11989,27891,15897,4001,16123,32020,16590,32752
ķ,HeMuDuZhen,330281111,20058,2425,12512,9895,18351,12465,3292,13086,25551,13263,25775
,DaYinZhen,330281112,9483,1013,5737,4144,7455,5133,1512,5306,10439,6271,12008
½,LuBuZhen,330281113,35796,5217,22698,17981,35371,22231,5234,22791,45022,23549,46247
Ū,LiangNongZhen,330281114,21985,3580,14090,10395,25438,13873,2971,13985,27858,14446,28536
,DaLanZhen,330281115,5635,1515,3918,3317,7555,3900,649,3830,7730,3881,7799
ɽ,SiMingShanZhen,330281116,5736,1114,3739,3119,7171,3693,795,3814,7507,3906,7645
¹ͤ,LuTingXiang,330281201,5196,1809,3760,3564,7223,3751,473,3694,7445,3718,7478
ںֵ,ZongHanJieDao,330282002,74456,8341,44831,37446,55866,43327,10731,45682,89009,48697,93528
սֵ,KanDunJieDao,330282003,56413,6180,34341,27606,41613,33462,7608,34365,67827,35860,70201
ɽֵ,HuShanJieDao,330282004,73848,6484,46303,35513,50411,44424,11808,43008,87432,45837,92140
ɳ·ֵ,BaiShaLuJieDao,330282005,69142,5333,40278,32647,38805,37974,8036,38415,76389,42233,82511
ֵ,GuTangJieDao,330282006,59527,4188,35787,29821,31643,33877,8305,33929,67806,36233,72020
,ZhangQiZhen,330282104,53239,5724,32620,27648,43574,31993,7311,32878,64871,33654,66274
ۺ,GuanHaiWeiZhen,330282107,120378,15381,75616,58047,109411,70082,16490,69924,140006,76633,152249
,FuHaiZhen,330282108,38172,2954,21819,20056,22834,20990,4702,22566,43556,24009,45828
ͷ,QiaoTouZhen,330282109,39792,4443,24830,20041,34243,24133,6016,24455,48588,25421,50251
,KuangYanZhen,330282110,24344,2552,14912,10561,19845,13697,3462,13879,27576,15446,30358
,XiaoLinZhen,330282111,44384,5160,27178,23777,35822,26111,5555,26728,52839,27921,55099
,XinPuZhen,330282112,51086,5426,31315,26443,42717,30716,7654,31875,62591,32851,64166
ʤɽ,ShengShanZhen,330282113,43781,4175,26557,21634,32884,25576,5996,26211,51787,27395,53952
,HengHeZhen,330282114,75888,7904,45499,40371,57280,44845,10599,47462,92307,48892,94391
,ChongShouZhen,330282116,30379,3368,18496,14943,23332,17660,4015,17969,35629,19266,37762
ֶ,AnDongZhen,330282118,36541,5158,23247,17709,35899,22520,5322,22727,45247,23774,47021
Ԫ,TianYuanZhen,330282119,29165,3834,18267,15158,23969,17942,4170,18457,36399,18902,37169
,ChangHeZhen,330282120,41066,5856,26017,20662,39115,25671,5353,25781,51452,26258,52275
,ZhouXiangZhen,330282121,89697,12060,56716,45455,77415,55500,12852,56161,111661,57893,114609
ɽ,LongShanZhen,330282123,75504,8191,45377,39910,56258,43694,10215,45861,89555,48533,93910
Ϫũѳ,CiXiShiNongKenChang,330282400,517,95,334,235,547,329,55,315,644,333,667
Ϫֳ,CiXiShiLinChang,330282401,6,0,1,1,0,1,0,1,2,5,6
ȶҵ,CiDongGongYeQu,330282402,4531,4,1708,1434,0,987,72,1416,2403,2899,4607
,NingBoHangZhouWanXinQu,330282403,43346,3127,23601,22008,23465,22049,4916,24283,46332,27788,51389
ֵ,JinPingJieDao,330283001,76506,8045,49115,36262,64788,47079,13231,46791,93870,48667,97782
ֵֽ,YueLinJieDao,330283002,50705,3498,30651,23124,30418,29403,8230,30083,59486,31782,62433
ڽֵ,JiangKouJieDao,330283003,47228,5126,28664,22847,36281,26621,6226,27841,54462,29916,58580
ֵ,XiWuJieDao,330283004,30756,4713,19155,16077,30826,18620,4086,19659,38279,20400,39555
ֵ,XiaoWangMiaoJieDao,330283005,20185,3822,13408,10711,23966,13188,3165,13470,26658,13764,27172
Ϫ,XiKouZhen,330283100,55943,8339,36419,28244,62928,35798,9474,36374,72172,37337,73756
,ShangTianZhen,330283103,24743,4333,15887,12568,27351,15531,3593,16239,31770,16782,32669
ݻ,ChunHuZhen,330283104,41933,6854,27000,22141,48010,26532,6240,27345,53877,28027,55027
ô,QiuCunZhen,330283106,15370,2942,10135,8386,18942,9940,2264,10244,20184,10441,20576
,DaYanZhen,330283107,7326,2724,5407,5111,10635,5380,1076,5660,11040,5719,11126
,SongAoZhen,330283108,10189,1391,5918,5363,8641,5832,1441,6464,12296,7103,13021
ֵ,HongDianJieDao,330302002,46105,3443,27025,20743,14002,25757,7171,26796,52553,29694,56719
ֵ,WuMaJieDao,330302006,62280,10462,42355,28612,48345,38173,8960,34752,72925,39347,81702
Ьнֵ,PuXieShiJieDao,330302007,74475,7570,47228,29103,36672,39292,10899,37721,77013,45716,92944
ؽֵ,LianChiJieDao,330302013,24239,3582,15883,10874,14285,14525,3430,13675,28200,15368,31251
㻯ֵ,GuangHuaJieDao,330302014,52528,3973,31002,23546,16806,28748,7362,29431,58179,32861,63863
ˮĽֵ,ShuiXinJieDao,330302015,58811,6978,37852,27800,28481,34508,7785,32114,66622,35722,73574
ֵֽ,NanPuJieDao,330302016,55025,4905,35685,24166,35893,33886,10016,32388,66274,34261,69946
Žֵ,NanMenJieDao,330302018,51567,5862,33514,21791,31912,30552,7619,28436,58988,31534,65048
ֵ,JiangBinJieDao,330302019,46061,5964,29874,19281,29248,27212,6224,25469,52681,28375,58249
ֵ,LiMingJieDao,330302020,62496,2528,36017,25164,15246,32934,11290,34881,67815,40297,76314
ɽֵ,XiuShanJieDao,330302021,59178,2439,34350,24468,19357,31516,10298,33444,64960,37565,71915
ֵ,HuangLongJieDao,330302022,86395,3174,46854,34107,15244,41066,13505,45061,86127,56220,103074
˫,ShuangYuZhen,330302101,195188,2806,90714,67157,15062,62936,11679,74107,137043,118959,209673
,TengQiaoZhen,330302102,23340,2506,14274,9626,16776,13069,4128,14167,27236,15700,29974
ٽ,LinJiangZhen,330302103,10723,1717,7005,5036,8745,6580,2113,6772,13352,7548,14553
߶,QiDouZhen,330302104,8230,1477,5211,3397,4773,5052,1090,5197,10249,5586,10797
Ͻ,NanJiaoXiang,330302202,70913,2075,35875,30007,9422,31630,8949,36983,68613,46062,81937
,YangYiXiang,330302203,57122,2523,27942,14879,13950,17133,4303,18788,35921,36006,63948
˫,ShuangChaoXiang,330302204,5295,1389,3720,2981,4475,3662,972,3777,7439,3936,7656
,ShangShuXiang,330302205,22688,1697,12019,7513,11631,9563,3008,10894,20457,15374,27393
᮵,AoDiXiang,330302206,1698,645,1360,1110,2387,1344,393,1340,2684,1376,2736
нֵ,YongZhongJieDao,330303001,101884,6756,59743,40052,56126,55037,19734,61779,116816,68631,128374
ݽֵ,PuZhouJieDao,330303002,58761,1418,31092,24983,10753,26769,7287,29846,56615,36374,67466
ֵ,HaiBinJieDao,330303003,57272,2841,32279,25074,21984,31002,9901,35196,66198,37735,70014
˽ֵ,YongXingJieDao,330303004,41337,2931,24252,17795,24406,23659,8530,27166,50825,28546,52798
ǽֵ,HaiChengJieDao,330303005,42631,2624,23655,13111,26155,19076,6902,20984,40060,28502,52157
״Ԫ,ZhuangYuanZhen,330303101,72297,2548,38929,26146,21646,32396,10210,35355,67751,46126,85055
Ϫ,YaoXiZhen,330303102,59081,2953,32147,23741,21929,28225,10114,33043,61268,40001,72148
ɳ,ShaChengZhen,330303103,50497,2851,28739,17281,30094,25199,9693,28602,53801,34302,63041
,TianHeZhen,330303104,41867,2177,23968,15958,19667,20709,7746,23208,43917,27822,51790
,LingKunZhen,330303105,16470,1973,10574,6520,14796,9324,3121,9549,18873,10990,21564
ݾü�,WenZhouJingJiJiShuKaiFaQu,330303400,78280,625,37247,18537,3239,19274,5991,22245,41519,47649,84896
ɽֵ,JingShanJieDao,330304001,31608,2118,17925,12486,8397,15738,4353,16332,32070,20154,38079
ֵ,WuTianJieDao,330304002,196740,4575,101388,71049,39381,78344,22420,88479,166823,122347,223735
ϰֵ,NanBaiXiangJieDao,330304003,50780,1691,26139,16562,10790,20199,6202,22499,42698,32534,58673
ɽֵ,ChaShanJieDao,330304004,68003,2838,38892,10297,26121,16670,5378,17487,34157,37327,76219
¦Žֵ,LouQiaoJieDao,330304005,82309,2694,41577,16828,23703,23387,8148,25076,48463,51574,93151
Žֵ,XinQiaoJieDao,330304006,79899,2795,43106,28548,14608,34470,10837,37780,72250,50425,93531
ֵ,SanYangJieDao,330304007,34000,1684,18933,13340,13858,16871,6021,18901,35772,22772,41705
Ϫ,QuXiZhen,330304103,42966,3437,24283,12609,18535,19441,6025,20596,40037,28145,52428
Ϫ,GuoXiZhen,330304105,104185,4779,55717,33720,30436,45434,14018,49541,94975,67265,122982
,PanQiaoZhen,330304106,60303,4144,33521,17471,33980,26437,8932,28396,54833,39858,73379
,ZeYaZhen,330304108,19513,4769,12462,10121,17274,11429,2747,12729,24158,14567,27029
,LiAoZhen,330304109,27622,3435,16834,10361,13611,14699,3919,15263,29962,18142,34976
,XianYanZhen,330304110,49478,3764,28519,14858,27780,23161,7741,24502,47663,32464,60983
,BeiAoZhen,330322100,31277,4065,21185,15890,30594,20238,6419,18864,39102,20576,41761
,DaMenZhen,330322101,8785,2351,6125,5155,11020,6010,1721,5998,12008,6732,12857
,DongPingZhen,330322102,11092,1941,8130,6170,11966,8100,2620,7388,15488,7523,15653
Ԫ,YuanJiaoXiang,330322200,2821,668,2247,1860,3726,2240,745,1886,4126,1987,4234
,NiYuXiang,330322201,4807,1142,3614,3047,6564,3599,1325,3436,7035,3660,7274
¹,LuXiXiang,330322202,4143,656,2747,2164,4469,2735,1105,2838,5573,3157,5904
,ShangTangZhen,330324100,82411,9253,54079,33616,79453,50616,20516,53505,104121,58101,112180
걱,OuBeiZhen,330324101,253887,11898,141998,92857,111306,121071,46132,136851,257922,169919,311917
ͷ,QiaoTouZhen,330324102,56989,6089,35817,23154,39599,31569,11761,33160,64729,39022,74839
ţ,WuNiuZhen,330324103,31678,3748,20456,13886,26806,19153,7354,20591,39744,22324,42780
,QiaoXiaZhen,330324104,28035,3779,17813,10131,24620,15805,6090,16750,32555,20091,37904
,DaRuoYanZhen,330324105,7684,2317,6058,4789,11532,6033,2318,6181,12214,6261,12319
,BiLianZhen,330324106,7381,1706,5964,4327,9056,5482,2517,5342,10824,5640,11604
լ,XunZhaiZhen,330324107,5291,1551,3945,3636,7299,3925,1384,4250,8175,4281,8226
ͷ,YanTouZhen,330324108,14653,3490,11101,8407,18895,10814,4547,11267,22081,11589,22690
,FengLinZhen,330324109,9982,3072,8148,6904,15156,8128,3520,8377,16505,8426,16574
̹,YanTanZhen,330324110,3281,960,2722,2154,4315,2717,1294,2770,5487,2813,5535
ɳͷ,ShaTouZhen,330324111,8077,2367,5917,4904,9496,5637,1991,5879,11516,6518,12435
Ϫ,XiXiXiang,330324200,9291,3507,7566,6254,14894,7549,2742,7885,15434,7974,15540
,XuAoXiang,330324201,3288,1037,2320,1792,4225,2213,662,2375,4588,2667,4987
,KunYangXiang,330324202,3343,1487,2804,2638,5359,2798,835,2853,5651,2861,5665
,MingAoXiang,330324203,2836,1368,2329,2293,4612,2329,614,2489,4818,2489,4818
ɽ,ShanKengXiang,330324204,1852,600,1362,1286,2752,1344,472,1527,2871,1562,2924
Ӧ,YingKengXiang,330324205,1232,529,1005,951,1996,1003,332,1085,2088,1088,2093
,DaAoXiang,330324206,1410,574,1166,1162,2172,1161,459,1264,2425,1277,2443
Ϫ,XiXiaXiang,330324207,1462,539,1237,1226,2340,1236,700,1460,2696,1464,2701
,JieKengXiang,330324208,2248,694,1671,1657,3260,1668,743,2009,3677,2014,3685
,XiAoXiang,330324209,1264,479,981,939,1881,967,363,1078,2045,1125,2106
ʯȾ,ShiRanXiang,330324210,2062,576,1533,1381,3081,1533,624,1729,3262,1729,3262
壨,WuSanShuNiaoXiang,330324211,3023,957,2442,2109,4401,2432,1083,2613,5045,2621,5063
ɽ,BiaoShanXiang,330324212,1156,486,905,869,1827,892,278,996,1888,1015,1920
,DongGaoXiang,330324213,3150,1128,2602,2180,5024,2589,1161,2771,5360,2837,5439
ʢ,HeShengXiang,330324214,3438,1189,2680,2344,5301,2643,1042,2946,5589,2989,5669
Դ,XiYuanXiang,330324215,2181,752,1732,1578,3420,1732,792,1970,3702,1993,3725
ͷ,LingTouXiang,330324216,2325,1195,2035,2032,4039,2034,729,2209,4243,2214,4249
Ϫ,XiKouXiang,330324217,2379,1074,2014,2068,3928,2013,808,2242,4255,2247,4261
Ϫ,LiXiXiang,330324218,3612,1249,2932,2617,5521,2923,1195,3103,6026,3124,6056
Ϫ,ZhangXiXiang,330324219,2527,894,2069,1850,3896,2064,871,2215,4279,2223,4292
,HuangNanXiang,330324220,2157,610,1624,1432,3242,1597,742,1846,3443,1885,3509
˿,PanKengXiang,330324221,1900,873,1573,1526,3031,1573,577,1770,3343,1777,3350
,DouMenXiang,330324222,1265,992,1214,1302,2387,1212,258,1293,2505,1301,2515
̹,HuaTanXiang,330324223,4719,1966,3978,3701,7631,3966,1399,4092,8058,4106,8084
,QuKouXiang,330324224,4792,1704,3920,3353,7255,3875,1535,4008,7883,4111,8031
,XiaLiaoXiang,330324225,886,554,812,834,1519,811,239,862,1673,867,1679
ز�,XianTeChanChangChangQu,330324400,1705,73,1061,289,294,392,160,434,826,877,1938
ĺɽֳ,SiHaiShanLinChang,330324401,83,3,33,62,26,33,4,57,90,57,90
ɽֳ,ZhengJiangShanLinChang,330324402,56,1,23,38,24,23,0,34,57,34,57
,KunYangZhen,330326100,93775,10452,60091,38518,79489,52333,17245,52724,105057,61381,121472
�,AoJiangZhen,330326101,131405,14094,82121,56553,115829,78641,23451,81690,160331,86829,168950
ˮͷ,ShuiTouZhen,330326102,77365,6784,48796,27080,58965,46058,16340,48522,94580,51693,100489
,XiaoJiangZhen,330326103,49037,5622,31125,20103,48398,30082,10578,32468,62550,34112,65237
鲽,MaBuZhen,330326104,23616,4315,16162,11066,30622,16122,5465,17115,33237,17234,33396
,TengJiaoZhen,330326105,27066,4096,17487,11587,30311,17322,5559,18898,36220,19234,36721
Ǯ,QianCangZhen,330326106,12613,1476,7793,5094,13480,7356,2091,7990,15346,8387,16180
ɽ,ShanMenZhen,330326107,11886,2706,8368,6062,15209,8195,2716,8704,16899,8940,17308
˳Ϫ,ShunXiZhen,330326108,3498,1251,2536,2295,5179,2534,654,2844,5378,2867,5403
,NanYanZhen,330326109,12136,2312,8252,5543,15559,8149,2648,8688,16837,8844,17096
,FengWoZhen,330326110,8004,1945,5678,4114,10642,5620,1976,6070,11690,6247,11925
Ϫ,HeXiZhen,330326111,10767,2308,7505,5872,13619,7464,2576,7857,15321,8146,15651
β,SongBuZhen,330326113,9157,1486,6327,4706,10008,6230,2238,6400,12630,6554,12881
܈,YuYangZhen,330326114,7239,1149,4844,3589,8030,4799,1671,5099,9898,5215,10059
,NanJiZhen,330326116,1020,51,540,460,770,534,105,612,1146,636,1176
ȫ,WanQuanZhen,330326117,41531,3849,24117,17082,30177,22045,7557,23683,45728,28820,52937
,XiWanXiang,330326202,2888,1021,2140,1680,4294,2134,508,2255,4389,2277,4417
÷Ϫ,MeiXiXiang,330326204,6529,1183,4435,3153,8765,4430,1483,4751,9181,4760,9195
÷Դ,MeiYuanXiang,330326205,4290,1142,3157,2558,6098,3155,1066,3289,6444,3341,6498
ﳲ,FengChaoXiang,330326207,5906,1298,4183,3386,7376,4112,1435,4381,8493,4456,8639
β,LongWeiXiang,330326208,393,396,357,526,807,357,85,517,874,517,874
Ϻ,NanHuXiang,330326209,8358,1609,6066,4205,11781,6063,2290,6180,12243,6191,12257
,ZhaoYangXiang,330326210,984,435,755,691,1598,754,258,912,1666,922,1677
ִ,NaoCunXiang,330326211,6475,2075,5084,4123,9466,5044,1631,5011,10055,5097,10181
,XiaoKengXiang,330326212,2984,1676,2568,2511,5154,2554,835,2859,5413,2927,5495
Ϫ,HuaiXiXiang,330326213,2478,1044,1936,1882,4021,1936,666,2251,4187,2252,4188
,QingJieSheZuXiang,330326214,3049,926,2262,1725,4471,2262,683,2396,4658,2396,4658
ά,WeiXinXiang,330326215,870,511,713,754,1532,712,241,908,1620,909,1622
∔,WuYangXiang,330326216,907,332,628,607,1391,628,192,799,1427,803,1431
һũ,DiYiNongChang,330326400,2927,242,1696,1238,950,1506,482,1675,3181,1955,3651
Ϫ,LingXiZhen,330327100,203634,16061,124398,69711,191434,115767,40357,124603,240370,135654,260052
,LongGangZhen,330327101,263735,18428,158972,101095,208155,150895,54772,165534,316429,177963,336935
ɽ,YiShanZhen,330327103,43243,3625,26805,17829,34285,25643,9140,28039,53682,29203,56008
Ǯ,QianKuZhen,330327104,53921,5301,34114,21227,47935,33198,12778,36644,69842,37886,72000
«,LuPuZhen,330327105,9474,1630,6139,4381,9991,5804,2078,6277,12081,7043,13182
,WangLiZhen,330327106,24062,2655,15292,9516,24509,14640,5503,16135,30775,16928,32220
,JinXiangZhen,330327107,65339,6999,40300,23853,59389,38191,13331,41739,79930,45369,85669
u,PaCaoZhen,330327108,23599,3601,15543,10836,24309,15337,5933,16893,32230,17590,33133
ͤ,YanTingZhen,330327109,5407,991,3653,2837,6875,3635,1177,3879,7514,3922,7575
,DaYuZhen,330327110,5171,1450,3828,3202,7141,3821,1108,3878,7699,3901,7729
Ϫ,ZaoXiZhen,330327112,14843,3110,10144,6970,19170,10056,3638,11178,21234,11447,21591
Ŷ,QiaoDunZhen,330327113,23107,3933,15685,10116,28811,15566,5339,16142,31708,16694,32379
Ϫ,JuXiZhen,330327114,5865,1611,4177,3419,8518,4170,1399,4687,8857,4698,8875
,GuanMeiZhen,330327115,14180,2606,10015,6882,18526,9907,3952,10509,20416,10723,20738
ɽ,FanShanZhen,330327116,20005,3689,14663,10026,24955,14308,4722,13291,27599,13753,28416
Ϫ,ChiXiZhen,330327117,7806,1714,5514,4154,10363,5511,1931,5896,11407,5937,11451
վ,MaZhanZhen,330327118,15239,3211,11019,8154,17706,10786,3532,10806,21592,10963,21982
ϼ,XiaGuanZhen,330327119,9674,2097,6766,5037,12845,6717,2025,6878,13595,7030,13796
,YanPuZhen,330327120,6163,2055,4912,4301,9126,4885,1637,4878,9763,4943,9855
,NanSongZhen,330327121,5688,1138,4322,3010,7325,4318,1575,4078,8396,4079,8401
,YunYanXiang,330327202,8963,1653,5960,4122,10557,5870,2134,6605,12475,6790,12750
ɾ,XianJuXiang,330327203,6904,1460,4728,3395,7495,4711,1581,5143,9854,5217,9945
°,XinAnXiang,330327204,10667,1709,7204,4940,10704,7135,2843,7907,15042,8015,15219
ɽ,KuoShanXiang,330327205,4386,1437,3204,2538,5945,3174,946,3523,6697,3565,6769
ʯ,ShiPengXiang,330327206,4291,1032,3143,2506,5762,3137,1064,3181,6318,3244,6387
,FengChiXiang,330327207,6865,994,4333,2982,7110,4318,1467,4928,9246,4993,9326
ͤ,PuTingXiang,330327209,6138,1109,4025,2846,7635,3981,1454,4577,8558,4676,8701
,WuFengXiang,330327210,3893,854,2782,2027,5543,2776,1065,3027,5803,3030,5812
ڈ,TengYangXiang,330327211,2453,714,1820,1504,3506,1820,641,1988,3808,1988,3808
,ChangChanXiang,330327213,590,325,477,547,978,476,117,549,1025,555,1032
ж,ZhongDunXiang,330327214,3708,752,2590,1866,5058,2587,893,2731,5318,2763,5353
ɳ,LongShaXiang,330327215,2825,802,2008,1491,4216,2007,640,2241,4248,2259,4267
,FengYangSheZuXiang,330327216,1331,367,1015,875,2035,1015,405,1088,2103,1088,2103
ѳ,PuChengXiang,330327217,2186,749,1793,1508,3172,1750,590,1689,3439,1732,3525
,DaiLingSheZuXiang,330327218,2150,578,1562,1221,3216,1562,555,1721,3283,1721,3283
,YuLiaoXiang,330327219,2796,787,2033,1680,3950,2023,600,2138,4161,2150,4183
ֳ,XianLinChang,330327402,153,31,75,94,94,61,9,94,155,118,193
N,DaXueZhen,330328100,38254,5714,26910,15929,31216,25510,10268,25660,51170,27326,54236
ɝT,BaiZhangJiZhen,330328101,4832,1120,3297,2758,5786,3188,1261,3609,6797,3916,7213
,NanTianZhen,330328102,9781,2312,7381,6047,11748,7296,3318,7922,15218,8030,15411
,XiKengSheZuZhen,330328103,4263,1267,3141,2675,5733,3102,1149,3451,6553,3538,6679
̹,HuangTanZhen,330328104,6987,2121,5109,4500,9000,5058,1771,5616,10674,5770,10879
ɺϪ,ShanXiZhen,330328105,11342,3685,9012,8026,15915,8938,3334,9227,18165,9349,18361
,JuYuZhen,330328106,6987,1941,5042,4345,8771,4904,1930,5366,10270,5816,10858
,YuHuZhen,330328107,7780,2713,6352,4757,7082,6240,2314,6297,12537,6455,12807
̨,ZhangTaiXiang,330328200,4517,1270,3289,2934,5367,3276,1141,3592,6868,3639,6928
¯,JinLuXiang,330328201,830,331,574,675,930,572,136,720,1292,723,1297
,LongChuanXiang,330328202,4865,1297,3318,2879,5536,3310,1078,3856,7166,3922,7240
,LiYangXiang,330328203,1092,407,725,806,1122,722,124,891,1613,898,1623
Դ,ErYuanXiang,330328204,4438,1058,3256,2631,5060,3245,1288,3502,6747,3528,6784
,HuangLiaoXiang,330328205,452,144,286,354,597,286,95,405,691,405,691
ʮԴ,ShiYuanXiang,330328206,2197,681,1596,1411,2931,1566,654,1914,3480,1936,3532
ʯ,ShiYangXiang,330328207,1229,374,877,834,1608,874,278,1001,1875,1004,1881
,XiaYangXiang,330328208,416,147,312,283,591,311,151,395,706,402,714
,LingHouXiang,330328209,548,214,399,412,706,392,108,457,849,471,870
,FuAoXiang,330328210,1792,697,1269,1329,2487,1263,465,1609,2872,1685,2954
ƺ,YunHuXiang,330328211,624,268,418,550,832,416,112,583,999,586,1004
ɽ,YangShanXiang,330328212,1184,356,871,793,1746,861,326,969,1830,995,1866
ɽ,GuiShanXiang,330328213,1360,482,1042,946,2066,1035,407,1204,2239,1207,2249
N,XueKouXiang,330328214,1455,562,1125,1144,1807,1109,334,1166,2275,1226,2351
,JinYangXiang,330328215,1550,670,1223,1261,2047,1223,331,1327,2550,1328,2551
˫,ShuangGuiXiang,330328216,1908,878,1590,1560,2902,1587,504,1696,3283,1700,3290
ɽ,ZhouShanSheZuXiang,330328217,1191,451,936,889,1718,933,263,967,1900,969,1905
,GongYangXiang,330328218,1314,605,954,1017,1887,946,194,1157,2103,1159,2113
ƽ,PingHeXiang,330328219,1923,683,1418,1378,2498,1406,471,1653,3059,1659,3077
,ZhouRangXiang,330328220,6226,1478,4234,3668,5681,4206,1380,4796,9002,4850,9084
,ShangLinXiang,330328221,1302,297,852,686,1109,851,250,996,1847,997,1849
Ϫ,DongXiXiang,330328222,4552,690,2803,2234,2176,2776,638,3033,5809,3077,5880
,JinXingXiang,330328223,1569,405,1063,888,1416,1051,321,1215,2266,1232,2295
,ZhuYaXiang,330328224,1232,228,721,532,916,710,145,869,1579,884,1605
,LuoYangZhen,330329100,45486,4723,30372,17794,35829,28377,11442,28654,57031,31279,61651
˾ǰ,SiQianSheZuZhen,330329101,7048,1310,4929,3604,7673,4871,2113,5398,10269,5542,10471
,BaiZhangZhen,330329102,1656,698,1193,1319,2405,1181,356,1495,2676,1517,2710
,XiaoCunZhen,330329103,7135,1635,4958,3931,9770,4920,1970,5636,10556,5782,10740
Ϫ,SiXiZhen,330329104,7569,1585,5492,4326,9763,5349,2369,5787,11136,6031,11523
Ϫ,PengXiZhen,330329105,5267,1018,3706,2559,6909,3609,1525,3921,7530,4104,7810
,YaYangZhen,330329106,9329,1779,6799,4670,12083,6570,2987,6895,13465,7296,14095
,ShiYangZhen,330329107,9107,2064,6582,5084,12725,6477,2761,7124,13601,7350,13932
,GuiHuZhen,330329108,3640,844,2523,2075,5202,2495,1084,2999,5494,3045,5568
,SanKuiZhen,330329109,10271,2056,7467,5328,13446,7196,3266,7736,14932,8126,15593
D,XiYangZhen,330329110,2666,815,2034,1858,3938,2015,887,2301,4316,2334,4368
뱱,LingBeiXiang,330329200,1135,347,802,714,1748,802,320,995,1797,1000,1802
,XianRenXiang,330329201,1490,429,1081,923,2158,1079,371,1207,2286,1209,2290
Ժ,NanYuanXiang,330329202,2372,561,1616,1298,3345,1609,664,1943,3552,1981,3597
,BeiPaiXiang,330329203,510,223,357,381,830,357,105,481,838,481,838
,ZhuLiSheZuXiang,330329204,678,210,455,441,968,452,139,561,1013,572,1027
,HuangQiaoXiang,330329205,487,164,325,381,721,314,121,435,749,447,772
,FengMenXiang,330329206,235,112,174,208,362,174,40,213,387,213,387
,BaoYangXiang,330329207,1684,678,1258,1460,2557,1257,378,1481,2738,1482,2740
,XinPuXiang,330329208,2105,810,1612,1630,2946,1612,567,1856,3468,1870,3482
,LianYunXiang,330329209,1374,434,983,851,2035,975,354,1166,2141,1179,2162
ɽ,WengShanXiang,330329210,1567,589,1176,1200,2543,1176,519,1492,2668,1499,2675
,FengYangXiang,330329211,2801,941,2207,2052,4607,2206,1083,2617,4823,2618,4825
,HengKengXiang,330329212,1757,548,1342,1160,2707,1342,592,1554,2896,1555,2897
ŷ,JiuFengXiang,330329213,2085,584,1525,1407,3099,1519,718,1855,3374,1862,3387
,FengWenXiang,330329214,837,254,619,552,1238,616,247,716,1332,719,1338
º,YueHuXiang,330329215,2284,427,1474,1152,2621,1401,594,1582,2983,1831,3305
Ɉ,SongYangXiang,330329216,1868,541,1387,1207,2768,1383,639,1645,3028,1661,3048
,LiuFengXiang,330329217,3127,797,2391,1903,4514,2382,1161,2667,5049,2694,5085
ѩϪ,XueXiXiang,330329218,3321,816,2325,2043,4837,2322,955,2760,5082,2767,5092
,WanPaiXiang,330329219,1276,319,933,834,1824,933,460,1120,2053,1122,2055
Ϫ,DongXiXiang,330329220,3595,994,2739,2319,5351,2701,1166,2979,5680,3016,5755
,DaAnXiang,330329221,3267,802,2440,2034,4797,2430,1009,2625,5055,2638,5078
Ϫ,YangXiXiang,330329222,1783,622,1334,1358,2740,1333,558,1627,2960,1629,2963
,ZhouLingXiang,330329223,1747,659,1370,1332,2684,1370,522,1558,2928,1558,2928
º,XiaHongXiang,330329224,3324,930,2509,2063,4976,2494,1178,2901,5395,2923,5432
Ȼ,WuYanLingZiRanBaoHuQu,330329400,21,1,5,6,1,5,0,6,11,17,22
ֵ,AnYangJieDao,330381001,71589,2670,43837,28773,36299,40871,14774,40966,81837,45196,89033
񺣽ֵ,YuHaiJieDao,330381002,61650,8107,41362,29753,43912,39443,10160,36586,76029,38555,79917
ֵ,JinHuJieDao,330381003,54639,3577,32700,21127,19272,29225,9560,30660,59885,35076,67776
ɽֵ,DongShanJieDao,330381004,46855,1937,26056,18725,17620,24047,7397,26320,50367,30133,56189
ֵ,ShangWangJieDao,330381005,53676,4110,32477,19705,39492,30668,10420,32693,63361,35729,68206
ֵ᷽,PanDaiJieDao,330381006,16215,1851,10017,6456,13386,9369,3080,9960,19329,11129,21146
,TangXiaZhen,330381101,254014,14465,144040,97103,134624,129402,43601,142356,271758,168040,312080
ݷ,ShenChengZhen,330381109,121374,7013,70919,44940,65381,64050,20700,67942,131992,78168,149087
͡,TingTianZhen,330381111,57987,3825,34358,21932,36247,31146,11664,33841,64987,39118,73476
,FeiYunZhen,330381114,102869,8491,63005,36671,72352,56195,19416,58594,114789,67771,130776
ɽ,XianJiangZhen,330381115,71378,3999,41506,24633,31964,37706,12152,40951,78657,46023,87529
,MaYuZhen,330381116,39627,7094,26637,18477,39123,25396,8256,25933,51329,28340,54977
ܴ,CaoCunZhen,330381118,10618,2578,8104,5985,14936,8083,3118,8079,16162,8210,16314
ɽ,TaoShanZhen,330381120,23722,3798,15619,9569,26894,14887,4934,15516,30403,16835,32454
ɽ,BiShanZhen,330381121,16472,2731,11155,7485,17695,10515,3516,10626,21141,11564,22719
,HuLingZhen,330381122,15267,2742,11060,6814,13236,10947,4112,10913,21860,11061,22121
,LongHuZhen,330381123,6416,1552,4669,3553,7128,4621,1641,4857,9478,4940,9609
ƽ,PingYangKengZhen,330381124,7306,2514,5547,4707,9756,5487,1565,5558,11045,5838,11385
,JingGuXiang,330381201,6506,2268,5245,4104,9601,5214,1595,5051,10265,5124,10369
÷,MeiYuXiang,330381202,8228,2242,6022,4628,11770,5981,1988,6310,12291,6436,12458
˳̩,ShunTaiXiang,330381203,3190,899,2392,1786,4590,2376,759,2433,4809,2456,4848
,DaNanXiang,330381204,1909,958,1517,1600,3092,1512,400,1741,3253,1750,3267
ͩ,TongPuXiang,330381205,16887,2941,11262,7448,17615,10650,3593,11118,21768,12159,23421
,YongAnXiang,330381207,4413,1131,3057,2331,4128,3047,891,3321,6368,3378,6435
,GuiFengXiang,330381208,678,356,575,556,1057,571,130,580,1151,589,1164
ׯ,FangZhuangXiang,330381209,3688,1738,2978,2700,5382,2973,817,3236,6209,3265,6243
Ϫ,LinXiXiang,330381210,5655,1374,4021,2974,6864,4000,1404,4389,8389,4412,8433
,JinChuanXiang,330381211,2331,1100,1860,1710,3688,1856,510,2063,3919,2081,3941
,ChaoJiXiang,330381212,5058,996,3403,2520,5668,3376,1173,3674,7050,3824,7227
¹ľ,LuMuXiang,330381213,4640,1303,3595,2596,6614,3573,1345,3640,7213,3693,7288
¥,GaoLouXiang,330381214,6072,1578,4316,3246,6673,4286,1327,4575,8861,4661,8977
Ӫǰ,YingQianXiang,330381215,1784,904,1381,1532,2396,1377,307,1608,2985,1614,2995
,DongYanXiang,330381216,2623,806,1875,1605,2766,1875,504,2032,3907,2058,3933
,NingYiXiang,330381217,2533,734,1854,1412,2596,1849,569,1958,3807,1982,3836
,FengLingXiang,330381218,1937,563,1437,1082,1627,1427,380,1414,2841,1443,2880
,BeiJiXiang,330381219,1122,169,713,711,1167,713,224,789,1502,802,1515
,BeiLongXiang,330381220,504,62,282,294,449,281,77,342,623,361,643
ֳ,LeChengZhen,330382100,188167,13467,114387,78229,124812,104543,35813,108442,212985,123060,237447
,DaJingZhen,330382101,38908,6513,26438,17958,42229,24842,7780,24725,49567,26763,53201
Ϫ,XianXiZhen,330382102,9514,2562,7013,6139,13943,6994,2383,7366,14360,7446,14459
,HuWuZhen,330382103,8612,1893,6079,4828,10971,6029,1848,6051,12080,6274,12353
㵴,YanDangZhen,330382104,29703,5054,20540,15428,37702,19602,6895,20179,39781,21112,41652
ܽ,FuRongZhen,330382105,19130,2629,12391,9066,17083,11838,3999,12923,24761,13367,25758
彭,QingJiangZhen,330382106,26372,3340,16549,10679,27330,15493,5148,16736,32229,18311,34860
,NanTangZhen,330382107,14377,2049,9214,6591,15405,8996,2987,9821,18817,10199,19413
,HongQiaoZhen,330382108,122886,9020,75941,52485,77870,71945,24811,76141,148086,80776,156717
,NanYueZhen,330382109,10720,2164,7481,5284,13747,7382,2689,7764,15146,8092,15573
,PuQiZhen,330382110,19396,2872,13034,8933,21317,12583,4389,13026,25609,13623,26657
Ϫ,DanXiZhen,330382111,24469,2276,15352,11660,16063,14949,5212,16157,31106,16605,31957
ʯ,ShiFanZhen,330382112,33775,2713,20768,14593,24027,19498,7291,21313,40811,23011,43779
ʯ,BaiShiZhen,330382113,27232,2548,15688,9554,18921,13281,5241,14787,28068,19333,35021
,LiuShiZhen,330382114,176887,9159,103109,71995,78838,93994,33334,102990,196984,116271,219380
,BeiBaiXiangZhen,330382115,124513,8747,74209,46392,72913,62913,23081,67847,130760,82132,156341
,XiangYangZhen,330382116,31919,3211,20434,14031,23935,19981,7585,21308,41289,22281,42715
̈,WengYangZhen,330382117,43341,4831,27723,17050,39545,25963,8715,26600,52563,29164,56887
ʯ,PanShiZhen,330382118,16977,1414,9735,4774,11495,7514,2659,7683,15197,11315,21050
,QiLiGangZhen,330382119,21066,2176,13380,9613,14002,12924,4572,13600,26524,14434,27814
ƻ,HuangHuaZhen,330382120,27280,3245,17633,12888,21757,17412,6021,18063,35475,18913,36546
,ZhiRenXiang,330382200,5702,1912,4585,3952,8756,4576,1670,4674,9250,4699,9284
,ZhenAnXiang,330382201,3449,1345,2843,2866,5506,2840,904,2838,5678,2855,5698
Ϫ,FuXiXiang,330382202,910,661,964,1001,1845,962,352,949,1911,959,1923
˫,ShuangFengXiang,330382203,9752,2248,7068,5777,12932,7012,2230,6985,13997,7162,14230
,LongXiXiang,330382204,3247,989,2521,2315,4948,2517,969,2668,5185,2684,5205
,YanHuXiang,330382205,5479,1313,3954,3112,7234,3907,1418,4182,8089,4256,8210
,LingDiXiang,330382206,3163,1026,2413,2166,4555,2399,799,2556,4955,2575,4988
Ķ,SiDouXiang,330382207,5919,1260,4096,3009,7628,4058,1564,4572,8630,4647,8743
,TianChengXiang,330382208,14622,1662,9475,6012,13382,8856,3363,9348,18204,10172,19647
Ǳ,ChengBeiXiang,330382209,910,733,880,979,1729,870,181,920,1790,944,1824
ֵ,JianSheJieDao,330402007,23479,5702,16331,11747,18494,14128,2372,12925,27053,15222,31553
Žֵ,JieFangJieDao,330402008,23035,3361,14424,11100,14861,13747,2952,13908,27655,14924,29348
¼νֵ,XinJiaJieDao,330402009,57380,9139,37648,29414,44480,35831,7505,34258,70089,36376,74024
Ϻֵ,NanHuJieDao,330402010,50760,6972,33056,23982,41761,30987,7745,30357,61344,32421,65477
˽ֵ,XinXingJieDao,330402011,44418,5583,28240,17678,28800,22091,5016,21159,43250,26777,55017
Ͻֵ,ChengNanJieDao,330402012,46606,3142,26802,14725,21974,18870,5242,20062,38932,28188,54990
դֵ,DongShanJieDao,330402013,29849,2553,17955,12526,17434,17327,5543,17791,35118,19990,37945
ˮֵ,ChangShuiJieDao,330402014,27342,1661,15454,8578,10369,11974,3376,11905,23879,16925,32379
,FengQiaoZhen,330402100,36866,5814,23647,16749,37679,23334,5377,23840,47174,24410,48057
,YuXinZhen,330402101,40152,5825,25737,17995,38463,25533,6389,26072,51605,26629,52366
·,XinFengZhen,330402103,38287,5394,24282,14972,36686,23269,5815,23154,46423,25214,49496
,QiXingZhen,330402104,19007,2614,12130,7992,15952,11830,3198,11984,23814,12689,24819
,DaQiaoZhen,330402105,45151,5733,26987,17795,35206,24767,6308,26026,50793,30205,57192
³ǽֵ,XinChengJieDao,330411002,34318,1531,20570,15494,13776,19767,6356,20426,40193,21635,42205
αֵ,JiaBeiJieDao,330411003,55967,3081,33230,22424,24408,29136,8609,29118,58254,34427,67657
ֵ,TangHuiJieDao,330411004,27397,1451,14187,9899,8539,11730,2955,12884,24614,17616,31803
սֵ,GaoZhaoJieDao,330411005,38527,1826,21561,16413,10818,18940,4980,20306,39246,23772,45333
,WangJiangJingZhen,330411101,85463,10973,54259,36506,68022,52555,14685,54962,107517,56862,111121
ͳ,YouCheGangZhen,330411103,37363,6477,24304,17194,35758,24085,5648,24694,48779,25184,49488
,XinChengZhen,330411104,58655,9942,39407,25085,63963,38520,10225,38547,77067,39415,78822
,WangDianZhen,330411105,71776,8527,45646,31270,55049,44227,12988,45492,89719,47645,93291
,HongHeZhen,330411106,55484,3528,33966,24356,25424,32775,10487,33992,66767,35533,69499
κֵ,WeiTangJieDao,330421001,139474,12286,83289,68365,71445,80595,19530,84219,164814,88001,171290
ǽֵ,LuoXingJieDao,330421002,61046,5032,37896,24430,38241,33745,9395,33741,67486,37577,75473
ֵ,HuiMinJieDao,330421003,50442,4285,28858,23125,24892,27085,6322,29690,56775,32191,61049
,DaYunZhen,330421102,18788,2035,11412,8121,12885,10947,2605,11269,22216,12016,23428
,XiTangZhen,330421103,49034,8805,32102,21952,49457,31177,7372,31702,62879,33109,65211
Ҥ,GanYaoZhen,330421105,27877,3708,17424,12845,20693,16979,4507,17888,34867,18668,36092
ׯ,TaoZhuangZhen,330421107,22518,4403,14799,10774,23578,14634,3674,15105,29739,15796,30595
Ҧׯ,YaoZhuangZhen,330421111,40350,6153,25119,18160,34296,24510,6116,26027,50537,27500,52619
,TianNingZhen,330421112,43120,8521,28863,19147,47549,28608,6789,28841,57449,29567,58430
ԭ,WuYuanZhen,330424100,125862,13722,79892,52851,107646,74626,20951,73564,148190,80643,160535
,ShenDangZhen,330424101,26349,4670,17516,11239,29949,17205,3944,16993,34198,17447,34963
ٲ,BaiBuZhen,330424102,26705,4048,17608,10679,28489,17174,4680,17165,34339,17825,35433
ڳ,YuChengZhen,330424103,19352,2799,12542,7594,19357,11872,2987,11891,23763,12596,25138
ɽ,QinShanZhen,330424104,28737,4263,17594,10956,25473,16365,3746,16615,32980,19152,36746
,GanPuZhen,330424105,24026,4541,16170,9549,25787,15078,3219,14534,29612,15616,31786
ͨԪ,TongYuanZhen,330424106,33133,5113,21981,12444,35405,20370,5210,20076,40446,21475,43456
,XiTangQiaoZhen,330424107,48236,7093,31456,17611,51048,29828,7554,29467,59295,31427,62883
ʯֵ,XiaShiJieDao,330481001,68128,9062,44249,30320,55896,41471,10431,40499,81970,43372,87621
޽ֵ,HaiZhouJieDao,330481002,63427,6144,40473,26554,44946,36579,10112,35323,71902,39210,79683
ֵ,HaiChangJieDao,330481003,60154,4483,35216,24022,32848,31761,7859,33244,65005,37280,72496
Žֵ,MaQiaoJieDao,330481004,29288,3549,18255,11265,24741,17253,4352,17772,35025,18934,37189
,XuCunZhen,330481101,88786,12577,59172,30209,97650,57763,16900,57185,114948,59091,118263
,ChangAnZhen,330481103,86668,10507,54449,32398,70287,49173,13177,50147,99320,55903,110352
,ZhouWangMiaoZhen,330481105,37262,6464,24644,14018,41464,23590,5515,23213,46803,24597,49241
,DingQiaoZhen,330481106,34874,6573,23335,13662,38360,22256,4507,21534,43790,22619,45954
б,XieQiaoZhen,330481107,48913,8155,32584,19013,54856,31794,8405,32319,64113,32889,65473
,HuangWanZhen,330481108,16606,3265,11088,7070,19117,11046,2341,10981,22027,11124,22212
ι,YanGuanZhen,330481110,43780,7379,28872,17774,44677,27612,6450,27556,55168,28737,57609
Ԭ,YuanHuaZhen,330481112,43167,6605,27654,17873,43983,27143,6283,27289,54432,28401,56055
ɽ,JianShanXinQu,330481400,4561,15,1609,1572,3,1111,242,1701,2812,3209,4818
ֵ,DangHuJieDao,330482001,119072,14192,76289,50988,95317,70716,18362,68049,138765,75337,151626
ܤֵ,ZhongDaiJieDao,330482002,82999,6262,51722,30016,39960,39431,8892,40124,79555,46431,98153
Žֵ,CaoQiaoJieDao,330482003,27858,4067,18126,10277,27464,17190,4109,17128,34318,17908,36034
է,ZhaPuZhen,330482101,67835,7288,39596,25707,48852,35345,8404,35761,71106,43931,83527
ܤ,XinDaiZhen,330482102,56049,7622,35444,21803,45214,31097,6538,31430,62527,34765,70209
²,XinCangZhen,330482103,38335,5715,25004,15182,35116,22728,5255,22886,45614,24301,49305
,GuangChenZhen,330482106,29734,5695,19843,11851,33394,18964,4080,18933,37897,19666,39509
ܤ,LinDaiZhen,330482107,28998,4904,19063,10919,29758,17481,3926,17376,34857,18765,37828
ɽ,DuShanGangZhen,330482108,83744,11260,53941,30946,71327,46185,10639,46665,92850,51702,105643
ֵͩ,WuTongJieDao,330483001,171127,15092,109167,74562,124536,99591,30801,98941,198532,107853,217020
ֵ,LongXiangJieDao,330483002,19442,3424,12913,8136,22149,12543,2977,12544,25087,12930,25843
ֵ,FengMingJieDao,330483003,41078,6611,27168,16808,42696,26692,7372,27062,53754,27893,55061
,WuZhenZhen,330483100,40446,7452,27103,17501,46561,26401,6090,26114,52515,26885,53988
Ժ,PuYuanZhen,330483101,76743,5745,47819,29748,41406,41352,12839,42003,83355,47508,95327
,TuDianZhen,330483102,25469,3560,16848,10500,25952,16466,4698,16540,33006,16879,33727
ʯ,ShiMenZhen,330483103,38129,7161,25365,14099,46144,25003,5731,25148,50151,25656,51021
ɽ,HeShanZhen,330483104,20738,3966,14103,8385,23710,13984,3487,13941,27925,14088,28191
Ȫ,ZhouQuanZhen,330483105,49060,8413,32930,17811,58210,32365,8980,32686,65051,33523,66453
,DaMaZhen,330483106,25415,4497,17520,9130,31818,17407,5445,17614,35021,17837,35357
縣,ChongFuZhen,330483107,84163,13539,55804,33255,90505,53480,14358,53857,107337,56256,112060
,GaoQiaoZhen,330483108,30543,6248,20718,12382,39280,20525,5009,20871,41396,21082,41800
ºӽֵ,YueHeJieDao,330502001,34087,5630,22693,17075,27144,22331,4944,21341,43672,21968,44661
ֵ,ZhaoYangJieDao,330502002,28935,5642,19551,14707,25822,19061,4053,18644,37705,19079,38630
ɽֵ,AiShanJieDao,330502003,11737,2022,7713,5468,8679,7205,1559,6880,14085,7605,15318
Ӣֵ,FeiYingJieDao,330502004,24485,3529,16375,11893,20048,15920,3607,14852,30772,15246,31621
Ȫֵ,LongQuanJieDao,330502005,52145,4997,34212,17201,36277,23286,5646,22297,45583,28576,62788
˽ֵ,FengHuangJieDao,330502006,43520,4717,28040,20766,35570,27811,7105,26923,54734,27302,55342
ɽֵ,KangShanJieDao,330502007,17300,2069,11138,7383,15485,10961,2993,11059,22020,11224,22362
ʻɽֵ,RenHuangShanJieDao,330502008,24776,1777,15214,7920,17423,12482,4335,12098,24580,15674,30888
ֵ,BinHuJieDao,330502009,9427,1653,6176,3341,10744,6089,1453,5922,12011,6357,12533
֯,ZhiLiZhen,330502100,158641,12749,94285,32172,85574,54824,15219,54827,109651,92324,186609
,BaLiDianZhen,330502101,47949,7739,30840,15539,49323,29242,7145,29183,58425,31993,62833
,MiaoXiZhen,330502102,11071,2115,7202,4604,13434,7118,1537,7258,14376,7521,14723
Ҳ,YangJiaBuZhen,330502103,44071,4352,21532,12952,39000,20095,4930,20770,40865,31821,53353
ܤϪ,DaiXiZhen,330502104,25730,4284,16680,10800,27187,15633,4033,15880,31513,17367,34047
,DongLinZhen,330502105,22158,4566,14946,8586,28054,14695,3101,14363,29058,14879,29825
,DaoChangXiang,330502200,16333,2008,9566,5496,11795,8433,2223,8776,17209,10998,20564
,HuanZhuXiang,330502201,32041,3949,19546,11593,21199,18691,5078,19265,37956,21522,41068
,NanXunZhen,330503100,98336,12955,61826,41617,83280,59381,15581,60562,119943,65046,126872
˫,ShuangLinZhen,330503101,56438,10842,37253,21252,62121,35087,7445,35123,70210,37472,74725
,LianShiZhen,330503102,65919,11984,43520,25451,75752,41853,9352,41810,83663,43735,87255
,ShanLianZhen,330503103,20989,4457,13881,8508,23060,13226,2633,13225,26451,14198,28079
ɹ,JiuGuanZhen,330503104,18778,2961,11683,7845,16128,11294,2957,12091,23385,13013,24696
,LingHuZhen,330503105,46318,10920,32147,22362,57198,31045,6233,30074,61119,31324,63471
,HeFuZhen,330503106,35004,7695,23858,15271,42481,23549,4816,23223,46772,23657,47515
ǧ,QianJinZhen,330503107,13424,3728,9379,6104,17381,9329,1478,9194,18523,9251,18630
ʯ,ShiCongZhen,330503108,10020,2349,6948,4049,12121,6719,1244,6462,13181,6665,13613
,KaiFaQu,330503109,41454,3644,23464,17032,21109,21789,6100,24322,46111,27734,51198
俵,WuKangZhen,330521100,114171,10029,70098,50811,87272,65882,18174,67739,133621,72276,142374
ǬԪ,QianYuanZhen,330521101,36596,6325,23805,16642,36999,23334,5558,23483,46817,24674,48479
,XinShiZhen,330521102,51845,9462,34114,21466,57693,32823,7339,32977,65800,34532,68646
,LuoSheZhen,330521103,17611,2328,10808,7410,14910,10661,2888,11491,22152,12019,22827
ӹ,ZhongGuanZhen,330521104,31606,5673,20339,13422,33251,19446,4480,20228,39674,21420,41759
Īɽ,MoGanShanZhen,330521105,8330,1974,5693,3903,10728,5623,1129,5583,11206,5740,11433
׵,LeiDianZhen,330521110,27766,3914,17515,11668,27512,17348,4972,18529,35877,19137,36652
Խ,YuYueZhen,330521113,23939,3841,15791,9215,26264,15214,4254,15656,30870,16243,32034
°,XinAnZhen,330521114,23028,4234,15239,8910,25959,14468,3905,14664,29132,15928,31167
徭ÿ,DeQingJingJiKaiFaQu,330521130,22379,1770,12856,7334,11666,9332,2140,10066,19398,13433,26289
ͷ,FaTouXiang,330521201,7289,1800,4999,3608,9253,4952,1030,4948,9900,5120,10119
,SanHeXiang,330521202,15022,2542,9791,5660,18195,9761,2446,10086,19847,10219,20010
,ZhiChengZhen,330522100,199398,21805,123501,85705,174394,115195,32240,116990,232185,129942,253443
,HongQiaoZhen,330522101,28071,5091,19027,12001,35947,18818,5642,19306,38124,19777,38804
,LiJiaXiangZhen,330522102,21857,3053,13828,8195,23258,12945,3738,13183,26128,14820,28648
,JiaPuZhen,330522103,22507,3107,14693,8755,24597,14032,4349,14093,28125,15270,29963
ֳ,LinChengZhen,330522104,34703,5930,23049,14761,44502,22983,6379,23741,46724,23963,47012
,SiAnZhen,330522105,34935,5617,22944,14901,43323,22631,6586,23431,46062,24194,47138
,HongXingQiaoZhen,330522106,24486,4252,16152,10511,30600,16032,4065,16407,32439,16651,32803
ƽ,HePingZhen,330522107,26349,4331,17261,10563,31670,16810,4537,17255,34065,17956,35217
С,XiaoPuZhen,330522108,17196,2907,11300,8328,20208,11117,3015,11435,22552,11818,23118
úɽ,MeiShanZhen,330522109,14328,2178,9389,6781,14651,8857,2554,8974,17831,9671,19060
ˮ,ShuiKouXiang,330522200,12874,2062,8541,5340,15589,8317,2469,8409,16726,8864,17405
,ErJieLingXiang,330522201,9534,1535,6231,3992,12022,6181,1850,6558,12739,6688,12919
ɽ,LvShanXiang,330522202,13501,2475,9061,5568,16713,8984,2335,9071,18055,9250,18311
ɽ,WuShanXiang,330522203,10352,1532,6623,4140,11940,6478,1907,6630,13108,7168,13791
,BaiXianXiang,330522204,7170,1202,4747,3489,8578,4619,1236,4577,9196,4861,9608
,HuaiKanXiang,330522205,11239,1629,7395,4601,12867,7112,1874,6956,14068,7347,14742
,DiPuZhen,330523100,164081,14879,99360,70770,131334,92113,25400,96553,188666,105000,204360
÷Ϫ,MeiXiZhen,330523101,31505,5589,20969,14023,38846,20885,5302,21179,42064,21427,42396
,LiangPengZhen,330523102,15357,2408,10044,6588,18438,9972,2696,10175,20147,10417,20461
۵,ZhangWuZhen,330523103,7040,1146,4655,2970,9027,4651,1146,4655,9306,4677,9332
,HangGaiZhen,330523104,20401,3612,13560,9313,26527,13467,3394,13658,27125,13847,27407
Т,XiaoFengZhen,330523105,34311,4740,21851,15465,34651,20965,5229,21270,42235,22429,44280
,BaoFuZhen,330523106,10095,1922,6765,4956,12855,6739,1684,6857,13596,6936,13701
´,ZhangCunZhen,330523107,7931,1640,5514,4109,10607,5504,1386,5436,10940,5443,10957
ƺ,TianHuangPingZhen,330523108,16467,2266,10621,7164,16740,10444,2737,10501,20945,10849,21470
,GaoYuZhen,330523109,18816,2962,12080,8467,22422,11915,3421,12553,24468,13119,25199
ͭ,KunTongXiang,330523200,9476,1743,6337,4025,11637,6046,1484,6043,12089,6366,12703
Ϫ,XiLongXiang,330523201,7078,931,4497,2490,7577,4018,1169,3979,7997,4681,9178
ɽ,GuiShanXiang,330523204,6875,1021,4290,2766,7305,3942,954,3960,7902,4560,8850
,ShangShuXiang,330523205,9390,1584,6092,4255,11109,5982,1411,5986,11968,6293,12385
ɽ,ShanChuanXiang,330523206,2826,663,1977,1439,3722,1960,384,1853,3813,1896,3873
ɽֵ,TaShanJieDao,330602001,39643,7690,27955,20477,33649,26235,5518,23518,49753,24896,52851
ɽֵ,FuShanJieDao,330602002,80047,8464,50851,28795,53745,38276,9179,36400,74676,46839,97690
ުɽֵ,JiShanJieDao,330602003,44973,6460,29877,21365,36628,28744,6080,26374,55118,27636,57513
ֵ,BeiHaiJieDao,330602004,37710,4887,25206,18173,35434,24536,6615,23231,47767,24006,49212
Ͻֵ,ChengNanJieDao,330602005,75899,4634,46656,32938,38924,44485,12470,44073,88558,46347,93003
ɽֵ,JiShanJieDao,330602006,66248,5380,42567,25439,36948,34596,9420,33851,68447,38481,81048
ϵֵ,DiDangJieDao,330602007,15418,1237,8705,5878,7030,7069,1717,7130,14199,9667,18372
,DongHuZhen,330602100,40183,5193,26551,18537,36973,25812,7118,25374,51186,25943,52494
֥,LingZhiZhen,330602101,63476,5635,38022,25764,41875,34648,10812,35162,69810,41901,79923
,DongPuZhen,330602102,49609,4970,31462,22534,36572,29768,9160,30552,60320,32277,63739
,JianHuZhen,330602103,21205,2876,13718,9191,21053,12850,3374,12899,25749,13737,27455
޲,GaoBuZhen,330602104,45181,6252,29805,20185,45770,28704,7800,28213,56917,29428,59233
ɽ,MaShanZhen,330602105,55016,7110,36216,25729,39077,33699,10191,31766,65465,36101,72317
,DouMenZhen,330602106,64622,4851,38193,25846,33538,32181,9513,33043,65224,40793,78986
Žֵ,KeQiaoJieDao,330621001,101786,4956,60299,36337,42371,52114,16488,52782,104896,62931,123230
ҽֵ,KeYanJieDao,330621002,70419,6322,43123,31125,44527,41344,11924,42765,84109,45542,88665
ֵ,HuaSheJieDao,330621003,72698,4717,42126,32978,33582,39774,10928,41989,81763,46217,88343
ֵ,HuTangJieDao,330621004,30488,4182,19444,14040,27351,18543,4807,18817,37360,20033,39477
,QiXianZhen,330621100,67103,5770,40446,30423,42595,36955,11105,37757,74712,43532,83978
Ǯ,QianQingZhen,330621101,88006,6568,52635,37080,54104,48146,13247,50235,98381,55186,107821
,SunDuanZhen,330621102,20142,4504,15603,11676,25094,15426,4753,13177,28603,13796,29399
ȫ,FuQuanZhen,330621103,43996,4609,27288,20831,34307,26288,7741,27568,53856,29058,56346
�,MaAnZhen,330621104,59136,4439,32520,26601,31137,30375,8468,33408,63783,39523,72043
ƽˮ,PingShuiZhen,330621105,36859,6197,24336,17045,39155,22542,5207,21313,43855,23927,48263
,AnChangZhen,330621106,48791,4353,29733,22071,31196,27480,7792,28793,56273,31203,60936
̳,WangTanZhen,330621107,13632,3708,10888,9030,18543,10706,2899,9040,19746,9351,20239
ͤ,LanTingZhen,330621108,29480,3743,18502,13730,26249,17818,4657,18288,36106,19378,37880
,JiDongZhen,330621109,13323,3776,10441,8459,18868,10384,2824,9418,19802,9482,19923
Ѵ,YangXunQiaoZhen,330621110,54342,3882,33146,21800,29875,29660,9182,30239,59899,34260,67406
,LiZhuZhen,330621111,17844,2588,11575,8885,15706,11277,3031,11447,22724,11888,23463
ʢ,FuShengZhen,330621112,13685,3034,9845,7174,17379,9729,2293,8899,18628,9167,19012
,TaoYanZhen,330621113,16073,2657,11008,7869,17469,10603,2955,9977,20580,10677,21685
,XiaLvZhen,330621114,17503,2193,11482,7969,15449,10808,3042,10746,21554,11256,22738
ֵֽ,YuLinJieDao,330624001,32010,3956,20213,15929,32961,19939,5732,21042,40981,21485,41698
ֵ,NanMingJieDao,330624002,69367,7223,45849,34148,58496,45516,15008,45366,90882,45749,91598
ǽֵ,QiXingJieDao,330624003,60208,3799,35658,29129,37279,33535,10916,36203,69738,39265,74923
̶,ChengTanZhen,330624101,12923,2656,8600,7166,14943,7846,1924,8124,15970,8903,17503
÷,MeiZhuZhen,330624102,9430,2012,6439,5806,12432,6435,1598,6601,13036,6601,13040
ɽ,HuiShanZhen,330624104,8683,2757,6522,6205,12349,6506,1613,6501,13007,6531,13053
о,DaShiJuZhen,330624106,17822,2903,11503,8736,18179,10385,3005,11012,21397,12227,23730
С,XiaoJiangZhen,330624107,7207,2349,5122,4957,9914,5051,1077,5410,10461,5511,10633
ɳϪ,ShaXiZhen,330624108,5753,1534,3861,3759,7645,3857,887,4252,8109,4313,8174
,JingLingZhen,330624109,11533,3219,8305,7842,16020,8304,1979,8401,16705,8426,16731
,RuAoZhen,330624110,17237,4275,11928,10640,23296,11868,3018,12493,24361,12602,24530
,ChengNanXiang,330624200,8217,2340,5929,5442,11141,5918,1566,6176,12094,6194,12123
,DongMingXiang,330624201,5506,1641,3903,3747,7654,3878,786,4011,7889,4030,7933
˫,ShuangCaiXiang,330624203,5848,1727,4288,3949,8035,4283,1012,4276,8559,4299,8587
,XinLinXiang,330624205,6202,1373,4370,3883,8332,4369,1168,4369,8738,4373,8743
Ӣ,QiaoYingXiang,330624206,5031,1517,3582,3396,7130,3582,897,3863,7445,3863,7445
ֵ,JiYangJieDao,330681001,197089,17770,126060,82908,135267,111715,34333,105829,217544,123132,249192
佶ֵ,HuanDongJieDao,330681002,42874,5095,27632,18899,36485,24854,8312,24774,49628,28649,56281
ֵ,TaoZhuJieDao,330681003,65256,5779,39705,27131,43333,32844,9891,33048,65892,41221,80926
,DaTangZhen,330681101,67171,3706,39678,20399,25614,28165,8761,28242,56407,39960,79638
Ӧ,YingDianJieZhen,330681102,30572,5123,20367,13878,38594,19974,5514,20354,40328,20842,41209
,CiWuZhen,330681103,27276,3916,17741,11910,31137,16811,5035,16831,33642,18486,36227
,DianKouZhen,330681104,71282,6234,40909,33930,45822,37437,11045,41136,78573,47652,88561
,RuanShiZhen,330681105,25015,3788,16585,10033,27316,15079,4621,15088,30167,16839,33424
ֱ,ZhiBuZhen,330681106,18770,2960,12345,8089,20464,10814,3162,10632,21446,12547,24892
,JiangZaoZhen,330681107,16247,3178,11242,8287,20822,11070,2962,10845,21915,11145,22387
ɽº,ShanXiaHuZhen,330681108,20876,3242,14361,9590,23611,13141,3877,12838,25979,13634,27995
,FengQiaoZhen,330681109,57181,8348,36868,25731,59150,34080,9112,33725,67805,37773,74641
Լ,ZhaoJiaZhen,330681110,19354,3759,13449,9774,25689,13308,3557,13030,26338,13221,26670
�,MaJianZhen,330681111,8366,2119,6216,4753,11865,6145,1887,6084,12229,6156,12372
й,WuXieZhen,330681112,9629,1704,6453,4394,9960,5957,1528,5872,11829,6408,12861
,CaoTaZhen,330681113,43338,4955,27768,14409,31031,20547,6030,20131,40678,26555,54323
Ҿ,WangJiaJingZhen,330681114,21003,3857,14657,10251,23518,13589,3588,12799,26388,13791,28448
ͷ,PaiTouZhen,330681115,31592,5455,21483,14195,32873,18821,5142,17302,36123,20706,42189
ͬɽ,TongShanZhen,330681116,9094,2625,6984,5411,12700,6886,1728,6389,13275,6463,13447
,AnHuaZhen,330681117,25066,3908,16580,10629,25349,14543,4102,14097,28640,16496,33076
ͤ,JieTingZhen,330681118,12660,3060,9117,6536,16873,8955,2295,8642,17597,8898,18015
ɽ,HuangShanZhen,330681119,20164,4352,14298,10668,25989,13865,3729,13232,27097,13947,28245
լ,ChenZhaiZhen,330681120,8203,2196,6319,4840,11106,6102,1730,5629,11731,5810,12129
뱱,LingBeiZhen,330681121,4847,1457,4021,3413,7295,3965,1447,3596,7561,3730,7751
,LiPuZhen,330681122,13189,2196,8716,5534,13859,7370,2063,7250,14620,8732,17448
׺,DongBaiHuZhen,330681124,16455,3782,11675,8972,22735,11649,3162,11659,23308,11724,23399
,DongHeXiang,330681201,8255,2330,6140,4975,11764,6094,1607,5987,12081,6052,12192
ٹٽֵ,BaiGuanJieDao,330682001,117041,11563,75900,49324,100893,67157,20165,62944,130101,72869,148769
ÿίᣨֵܶ´,JingJiKaiFaQuGuanWeiHuiCaoEJieDaoBanShiChu,330682002,63515,5390,40003,24570,50208,33960,9747,33068,67028,38649,78652
ؽֵ,DongGuanJieDao,330682003,30254,4384,20044,13858,30918,19038,5021,18219,37257,19615,39659
,DaoXuZhen,330682100,32191,5700,22744,17672,36500,22512,6610,20572,43084,21757,44501
,ChangTangZhen,330682101,9046,1661,6231,4516,11472,6215,1484,5894,12109,5960,12191
,ShangPuZhen,330682102,15286,2808,10453,7545,19098,10312,2623,10038,20350,10264,20717
,TangPuZhen,330682103,11555,1748,7765,5760,12982,7657,2030,7427,15084,7568,15333
,ZhangZhenZhen,330682104,23676,5318,16489,12671,30339,16332,3797,15878,32210,16302,32791
¹,XiaGuanZhen,330682105,5949,1526,4190,3609,7884,4175,780,4035,8210,4065,8255
,FengHuiZhen,330682106,39651,6198,26071,17808,44934,24634,5915,24250,48884,25693,51764
,YongHeZhen,330682107,10670,1836,6962,5161,13037,6869,1585,6951,13820,7129,14091
,LiangHuZhen,330682108,20205,3541,13643,9113,23465,13208,3154,12566,25774,13257,26900
ͤ,YiTingZhen,330682109,16690,2620,10542,6933,17378,9540,2197,9761,19301,10965,21507
СԽ,XiaoYueZhen,330682110,27825,3607,17348,10423,26110,15152,3850,15285,30437,17934,35282
л,XieTangZhen,330682111,20562,3467,13667,9129,21015,13065,3288,12753,25818,13650,27317
Ǳ,GaiBeiZhen,330682112,23993,3395,15033,12293,20430,14992,3769,15955,30947,16124,31157
,SongShaZhen,330682113,73333,12982,52245,35030,83472,49208,12517,42664,91872,46587,98832
,LiHaiZhen,330682114,38267,7535,26809,20499,37462,24831,6016,19718,44549,25009,51818
,LingNanXiang,330682200,4894,1360,3393,3156,6716,3393,650,3491,6884,3511,6904
Ϫ,ChenXiXiang,330682201,3377,993,2468,2382,4719,2465,490,2370,4835,2392,4860
լ,DingZhaiXiang,330682202,5973,1205,4105,3222,7587,4036,934,3901,7937,4007,8112
ߺֵ,YanHuJieDao,330683001,64464,8012,42829,32453,61514,42274,12302,41101,83375,41949,84778
ֵ,SanJiangJieDao,330683002,54115,2820,32141,24608,28808,29147,8776,29974,59121,33570,65711
¹ɽֵ,LuShanJieDao,330683003,49045,5125,30839,22055,46485,28965,8448,29439,58404,31779,62618
ֿڽֵ,PuKouJieDao,330683004,20284,3443,13838,10538,26786,13804,4334,14095,27899,14223,28061
,GanLinZhen,330683100,54204,9932,35337,27571,69075,34921,8209,36350,71271,37008,72345
,ChangLeZhen,330683101,44860,7736,28762,23853,55059,28074,6578,29707,57781,30412,59174
,ChongRenZhen,330683102,47369,9657,30993,25066,60587,30090,7361,32379,62469,33394,64387
,HuangZeZhen,330683103,30060,4787,19481,14059,35972,18538,5080,19489,38027,20446,39927
,SanJieZhen,330683104,26391,6464,19804,14224,36553,18871,6100,17848,36719,19151,38955
ʯ,ShiHuangZhen,330683105,16754,3135,10713,8339,21360,10592,2403,11371,21963,11579,22292
,GuLaiZhen,330683106,13131,2752,9128,6828,18004,9110,2618,9296,18406,9373,18501
,XianYanZhen,330683107,7266,1828,5041,4462,9791,4985,1380,5299,10284,5433,10474
ͥ,JinTingZhen,330683108,15175,2855,9916,7960,19639,9863,2541,10493,20356,10655,20571
,BeiZhangZhen,330683109,8148,2059,5459,4891,11300,5430,1379,6051,11481,6127,11586
,XiaWangZhen,330683110,5133,1495,3623,3347,7474,3583,1020,3918,7501,4025,7648
,GuiMenXiang,330683200,4968,1254,3388,3073,6966,3385,901,3703,7088,3735,7123
,LiNanXiang,330683201,6511,1459,4225,3815,8711,4211,1167,4877,9088,4912,9137
Ϫ,ZhuXiXiang,330683202,2156,427,1464,1144,2956,1451,444,1539,2990,1563,3027
,YaHuangXiang,330683203,1618,399,1027,1031,2160,1025,216,1196,2221,1206,2233
Ժ,WangYuanXiang,330683204,2607,616,1708,1461,3585,1700,429,1934,3634,1944,3652
ͨԴ,TongYuanXiang,330683205,3300,693,2064,1791,4404,2062,534,2461,4523,2463,4527
ݾÿ,ShengZhouJingJiKaiFaQu,330683400,36367,2345,21290,12078,20355,14662,4323,15313,29975,21745,43035
Ƕֵ,ChengDongJieDao,330702001,24434,3847,16672,12719,19410,15995,4393,15514,31509,16002,32674
нֵ,ChengZhongJieDao,330702002,14725,2986,10645,8136,13304,10072,2848,9374,19446,9914,20559
ֵ,ChengXiJieDao,330702003,18582,2828,11940,10164,11408,11671,3080,12058,23729,12550,24490
Ǳֵ,ChengBeiJieDao,330702004,56062,4505,26460,19647,46941,24326,6913,24215,48541,41020,67480
Ͻֵ,JiangNanJieDao,330702005,29038,2723,18864,15925,20515,18251,5335,17457,35708,18232,37096
ֵ,SanJiangJieDao,330702006,82880,4472,51026,44356,50269,50421,16586,51685,102106,52912,103938
ؽֵ,XiGuanJieDao,330702007,39707,1878,22959,18366,18757,20888,6785,22085,42973,25411,48370
ֵ,QiuBinJieDao,330702008,46196,1432,24365,24323,12018,22939,8266,28804,51743,31529,55894
ʨֵ,XinShiJieDao,330702009,55860,2697,34612,15766,24216,18533,5853,19182,37715,29798,64410
޵,LuoDianZhen,330702100,15252,2220,9804,7094,16390,9208,2593,9420,18628,10261,20065
,YaFanZhen,330702101,13998,2247,9115,7059,16705,9060,2463,9375,18435,9593,18708
,AnDiZhen,330702102,7075,1575,4716,4286,9052,4649,1172,4892,9541,5106,9822
,BaiLongQiaoZhen,330702103,48694,6768,30920,22510,47010,27551,8108,27584,55135,32650,63570
,LangYaZhen,330702104,10735,1853,7198,5549,13719,7189,2045,7426,14615,7435,14633
,JiangTangZhen,330702105,14532,1931,9011,7036,14487,8217,2239,8825,17042,9691,18702
Ϫ,TangXiZhen,330702106,28434,4400,18772,14880,32096,17618,5601,17961,35579,19663,38435
޲,LuoBuZhen,330702107,19663,3746,13283,10311,24851,12771,3353,12772,25543,13479,26762
,YangBuZhen,330702108,7903,1695,5432,4613,9949,5344,1444,5349,10693,5610,11042
Ǭ,QianXiXiang,330702201,21129,2295,13310,10593,17932,13242,4152,14012,27254,14266,27576
,ZhuMaXiang,330702202,7776,1121,5048,4058,8905,4999,1492,5236,10235,5341,10389
ɽ,ChangShanXiang,330702203,6723,1319,4601,3922,8730,4587,1241,4651,9238,4682,9283
,RuoYangXiang,330702204,1463,371,1035,929,2034,1021,290,1063,2084,1089,2124
ɳ,ShaFanXiang,330702205,5310,1284,3567,3106,7317,3564,864,3887,7451,3891,7458
ʯ,TaShiXiang,330702206,3525,1663,2804,3123,5605,2795,571,2944,5739,2955,5759
,LingShangXiang,330702207,3171,511,2177,1615,4126,2175,624,2122,4297,2129,4306
ݷ,ShenFanXiang,330702208,1840,660,1367,1329,2719,1367,321,1452,2819,1454,2821
,SuMengXiang,330702209,11540,1228,7398,5992,11033,7295,2528,7731,15026,7898,15296
ֵ,DuoHuJieDao,330703001,33056,2373,18596,11425,19880,14779,5101,15461,30240,21934,40530
Тֵ,DongXiaoJieDao,330703002,26160,2472,16202,12907,16022,14797,4407,15517,30314,16837,33039
Т˳,XiaoShunZhen,330703101,55237,6900,34044,27633,47772,30386,8875,31877,62263,36968,71012
,FuCunZhen,330703102,23935,2570,14403,10096,18152,11826,3639,12582,24408,15741,30144
լ,CaoZhaiZhen,330703103,25847,4451,16853,14011,29910,16326,4601,17162,33488,18046,34899
,LiPuZhen,330703104,19023,3666,12840,11029,24108,12566,4042,13029,25595,13891,26731
,LingXiaZhen,330703105,8688,1539,5567,4948,10053,5502,1470,5751,11253,6130,11697
,JiangDongZhen,330703106,7585,1108,4853,3919,9101,4797,1255,4963,9760,5095,9948
,TangYaZhen,330703107,15789,2919,10622,9076,19084,10469,2869,10673,21142,10955,21577
,ChiSongZhen,330703108,18236,3051,11826,10148,21857,11732,3294,12380,24112,12755,24581
Դ,YuanDongXiang,330703200,8005,1800,5631,5036,10862,5556,1620,5676,11232,5794,11425
ֵ,BaiYangJieDao,330723001,50699,3558,30045,25021,33298,29570,9585,32528,62098,33797,63842
ɽֵ,HuShanJieDao,330723002,39290,3841,24208,18276,28447,22664,6585,23156,45820,25508,49716
Ϫֵ,ShuXiJieDao,330723003,34512,3996,22045,16957,29024,21129,6433,21682,42811,22896,44941
,LiuChengSheZuZhen,330723100,14099,3526,10260,8055,17564,9890,2890,9822,19712,10255,20515
̹,LvTanZhen,330723101,9772,1370,6105,5228,10267,6094,1604,6611,12705,6641,12746
ͩ,TongQinZhen,330723102,31233,2301,18554,16541,17541,18222,6565,20920,39142,21545,40099
ȪϪ,QuanXiZhen,330723103,25462,2190,14402,13892,15374,14080,4219,16466,30546,17469,31871
լ,XinZhaiZhen,330723104,5568,2715,4452,4563,8903,4434,863,4609,9043,4694,9146
լ,WangZhaiZhen,330723105,16291,2894,10487,8845,18944,10336,2765,10991,21327,11463,21950
Ϫ,TaoXiZhen,330723106,6875,2252,5367,4925,10165,5322,1432,5122,10444,5192,10559
,JiaoDaoZhen,330723107,9800,1223,5777,5114,8110,5638,1576,6248,11886,6822,12599
,DaTianXiang,330723200,4809,1176,3300,2828,6585,3300,751,3432,6732,3436,6736
ķ,BaiMuXiang,330723201,4746,1364,3364,3111,6636,3355,826,3552,6907,3572,6936
Դ,YuYuanXiang,330723202,4328,1358,3192,2983,6160,3172,796,3249,6421,3290,6482
̹,TanHongXiang,330723203,2490,928,1888,1881,3736,1871,428,1932,3803,1958,3846
,XiLianXiang,330723204,2572,799,1942,1630,3828,1922,560,1971,3893,1989,3931
,SanGangXiang,330723205,1212,522,996,994,2008,996,342,1080,2076,1080,2076
Ϫ,DaXiKouXiang,330723206,1072,595,888,1008,1836,888,241,1016,1904,1020,1908
Ͻֵ,PuNanJieDao,330726001,40196,4283,25142,17021,32455,22461,8474,23837,46298,27811,52953
ɻֵ,XianHuaJieDao,330726002,49084,3803,28808,20107,29099,23613,9042,26390,50003,33121,61929
ֵ,PuYangJieDao,330726003,75342,6525,46779,33425,53481,43525,15985,45793,89318,51073,97852
լ,HuangZhaiZhen,330726101,54578,6149,33291,22015,49533,27619,10076,29937,57556,37512,70803
,BaiMaZhen,330726102,17106,2661,11317,8053,19478,10569,3642,11085,21654,12092,23409
֣,ZhengJiaWuZhen,330726103,9649,1147,5910,3587,8416,4762,1637,5039,9801,6523,12433
֣լ,ZhengZhaiZhen,330726104,22398,2664,13628,8803,21958,11779,4358,13023,24802,15792,29420
ͷ,YanTouZhen,330726105,17089,2572,10938,7782,20638,10204,3592,11049,21253,12315,23253
̴Ϫ,TanXiZhen,330726106,7324,1563,4970,4066,8792,4775,1392,5005,9780,5309,10279
ƺ,HangPingZhen,330726107,7693,1945,5528,4668,9020,5523,1762,5856,11379,5872,11400
,DaFanXiang,330726200,4755,971,3266,2608,4393,3186,1171,3511,6697,3631,6897
,ZhongYuXiang,330726201,7397,1276,4666,3106,7328,3842,1228,4027,7869,5235,9901
ǰ,QianWuXiang,330726202,6494,1363,4524,3509,7958,4380,1416,4543,8923,4749,9273
,HuaQiaoXiang,330726203,3120,934,2322,1952,4451,2295,627,2317,4612,2359,4681
լ,YuZhaiXiang,330726204,8802,966,6043,4433,4905,5968,3095,6672,12640,6820,12863
,AnWenZhen,330727100,35889,3348,23765,16783,33168,22414,8558,22045,44459,24030,47795
,XinWoZhen,330727101,8964,1703,6445,5137,10978,6294,2281,6064,12358,6503,12948
ɽ,JianShanZhen,330727102,9247,1467,6148,4744,10966,5918,2020,6018,11936,6586,12734
ʴ,RenChuanZhen,330727103,6255,1492,4606,3954,8978,4565,1601,4675,9240,4742,9348
,DaPanZhen,330727104,3433,806,2526,1987,4368,2450,801,2363,4813,2514,5040
ǰ,FangQianZhen,330727105,6124,1302,4243,3250,8117,4179,1238,4326,8505,4421,8664
ɽ,YuShanZhen,330727106,8810,1677,6426,4762,11666,5946,2108,5615,11561,6169,12595
к,ShangHuZhen,330727107,9596,1839,6878,5322,13069,6744,2421,6802,13546,6978,13856
ˮ,LengShuiZhen,330727108,4942,1049,3685,3173,6561,3675,1317,3595,7270,3623,7308
,ShenZeXiang,330727200,7650,1351,5410,4131,9983,5229,1742,5104,10333,5333,10743
˫,ShuangFengXiang,330727201,2003,551,1514,1349,2927,1512,466,1506,3018,1506,3020
˫Ϫ,ShuangXiXiang,330727203,2679,741,2008,1638,3866,1976,614,1980,3956,2026,4034
񺴨,YaoChuanXiang,330727205,1532,462,1219,995,2284,1219,381,1156,2375,1156,2375
̷,PanFengXiang,330727206,1157,422,873,830,1710,867,190,884,1751,896,1769
߶,GaoErXiang,330727207,1098,415,879,809,1516,870,215,832,1702,849,1728
ά,WeiXinXiang,330727208,835,259,587,495,1104,541,141,597,1138,648,1235
լ,HuZhaiXiang,330727209,6085,1182,4188,3335,8338,4167,1483,4516,8683,4562,8750
,WanCangXiang,330727210,4741,1023,3554,2816,6490,3498,1196,3302,6800,3406,6960
ź,JiuHeXiang,330727211,2479,648,1885,1607,3553,1862,636,1841,3703,1878,3763
ֵ,LanJiangJieDao,330781001,89693,10457,57533,38709,89327,53135,16801,53622,106757,59418,116951
ɽֵ,YunShanJieDao,330781002,57911,9225,38853,28494,63272,38032,10330,37937,75969,38613,77466
ֵ,YongChangJieDao,330781004,26673,4971,18038,13569,34508,17930,5400,18784,36714,19006,37044
Ϫֵ,ChiXiJieDao,330781005,10029,1776,6856,4923,12597,6806,2153,7047,13853,7102,13958
Ůֵ,NvBuJieDao,330781006,20921,4575,14504,10937,28173,14414,4781,15453,29867,15773,30277
ϻֵ,ShangHuaJieDao,330781007,27641,4589,18287,13056,32435,17653,4882,17948,35601,18825,37112
β,YouBuZhen,330781102,20886,4362,14468,11280,25977,13927,3969,14100,28027,14749,29217
,ZhuGeZhen,330781104,13789,2952,10032,7989,18749,9998,3065,9647,19645,9774,19806
Ƶ,HuangDianZhen,330781106,17936,4338,12694,9651,24844,12622,4000,13385,26007,13580,26274
Ϫ,XiangXiZhen,330781108,20206,3435,13543,10133,26238,13415,4402,14168,27583,14500,28043
�,MaJianZhen,330781109,27335,5006,18432,13805,35516,18353,5818,19573,37926,19727,38159
÷,MeiJiangZhen,330781111,21511,4646,15209,11670,28866,14984,4661,15198,30182,15609,30818
Ϫ,HengXiZhen,330781112,16692,2507,11101,7617,17865,9725,3575,9857,19582,11673,22774
鶴,LingDongXiang,330781200,13158,2159,8887,5902,16233,8823,2654,8832,17655,9084,17971
ˮͤ,ShuiTingSheZuXiang,330781203,10091,2407,7522,6217,13761,7496,2431,7338,14834,7407,14929
,BaiSheXiang,330781209,13861,2920,9595,7420,18845,9557,2934,10030,19587,10120,19715
ǽֵ,ChouChengJieDao,330782001,173672,9308,99744,64363,80793,76707,26004,80925,157632,109240,208984
ֵ,JiangDongJieDao,330782002,141548,7194,81704,53967,58814,65082,22364,69036,134118,89402,171106
�ֵ,ChouJiangJieDao,330782003,105453,4700,58553,44273,36872,48076,15515,53131,101207,67115,125668
Էֵ,BeiYuanJieDao,330782004,109981,4375,61256,44805,38603,46362,15881,52354,98716,68981,130237
լֵ,HouZhaiJieDao,330782005,60016,5557,35570,25785,42084,28975,10068,31248,60223,40071,75641
ֵ,ChengXiJieDao,330782006,40266,4385,25127,18660,30448,22738,7930,24080,46818,27454,52581
إֵ,NianSanLiJieDao,330782007,70813,4433,40078,24226,33357,27782,9734,30310,58092,44902,84980
,FoTangZhen,330782100,91671,9684,55635,41658,65535,45747,14216,47927,93674,59936,115571
శ,ChiAnZhen,330782101,21619,5111,15356,13380,25723,14648,4765,14866,29514,16139,31495
ͤ,YiTingZhen,330782102,37400,5946,24527,20166,40244,22514,7319,23635,46149,26138,50665
Ϫ,ShangXiZhen,330782104,41134,5819,26306,21238,37236,22631,7547,23434,46065,28194,54500
Ϫ,SuXiZhen,330782105,67395,4931,39227,28146,40040,32293,10565,35024,67317,43664,82891
,DaChenZhen,330782106,38802,4037,23853,18526,29248,21309,6857,22569,43878,25843,49696
ֵ,WuNingJieDao,330783001,78271,7926,51492,37183,67170,48220,15925,46915,95135,50630,102122
нֵ,NanShiJieDao,330783003,28327,4861,19282,13723,33285,18408,6313,18609,37017,20219,39501
ƽֵ,BaiYunJieDao,330783004,76696,3887,43505,21628,28218,28115,10799,29413,57528,47877,91382
ֵ,JiangBeiJieDao,330783005,49654,5750,30450,20689,40170,23897,8406,23733,47630,33360,63810
Ƕֵ,ChengDongJieDao,330783006,26496,4096,18105,11363,28037,15620,5310,14419,30039,17797,35902
ʯֵ,LiuShiJieDao,330783007,21206,4246,15627,10582,25407,14121,4407,12478,26599,14232,29859
Ρɽ,WeiShanZhen,330783106,35442,8225,27899,21214,43172,26024,8231,21770,47794,23999,51898
¹,HuLuZhen,330783107,13452,3538,10817,8655,18643,10524,3089,8920,19444,9262,20079
ɽ,GeShanZhen,330783108,19966,5081,16030,12686,24201,15657,4741,13139,28796,13758,29788
,ZuoCunZhen,330783109,8403,2966,7149,6442,12628,6997,2030,5980,12977,6250,13399
,DongYangJiangZhen,330783110,8733,2773,7192,5730,11999,6881,1741,5637,12518,6055,13247
Ϫ,HuXiZhen,330783112,23208,5227,17682,13079,29938,16827,4799,14516,31343,15552,33234
լ,MaZhaiZhen,330783114,11232,2896,8587,6870,15810,8504,2574,7924,16428,8115,16702
ǧ,QianXiangZhen,330783116,27956,5359,19709,15058,33539,18112,5648,17466,35578,19254,38963
,NanMaZhen,330783118,45258,7627,30023,24528,52082,28214,9236,29292,57506,32098,62121
ˮ,HuaShuiZhen,330783122,32404,5932,22700,17458,41612,22303,7822,22817,45120,23458,46158
,HengDianZhen,330783123,83597,8572,51836,37709,65376,46706,16047,48778,95484,56380,108216
,SanDanXiang,330783201,5398,1245,4031,3433,7639,4025,1374,3965,7990,3986,8017
ǽֵ,DongChengJieDao,330784001,123762,6600,70157,56071,60366,63942,24131,70610,134552,84336,154493
ǽֵ,XiChengJieDao,330784002,86565,6056,50099,41076,49668,46005,15924,51122,97127,58446,108545
Ͻֵ,JiangNanJieDao,330784003,55123,5856,35856,25956,43486,33017,11902,33982,66999,37025,72881
ʯ,ShiZhuZhen,330784105,26897,3285,17102,13540,24641,16666,6061,18034,34700,19141,36243
ǰ,QianCangZhen,330784106,16263,2527,10528,7726,17339,9758,3643,10391,20149,11905,22433
ɽ,ZhouShanZhen,330784107,10800,2347,7696,6359,13961,7659,2619,7988,15647,8070,15766
ɽ,GuShanZhen,330784108,46061,4407,28188,23739,31507,27357,10206,30420,57777,32486,60674
,FangYanZhen,330784109,18077,2600,11742,9467,15994,11234,3948,12051,23285,12883,24625
ɽ,LongShanZhen,330784110,27300,3650,17662,14248,24484,16891,6177,18147,35038,19465,37127
Ϫ,XiXiZhen,330784111,16621,3377,11550,9716,19599,11475,3725,11940,23415,12173,23723
,XiangZhuZhen,330784112,32084,4183,20667,16342,28339,19952,7545,21532,41484,23145,43812
,TangXianZhen,330784113,24800,4884,17388,13753,28763,16867,6007,17440,34307,18303,35691
,HuaJieZhen,330784114,20562,2887,12653,11295,17165,12434,3787,13738,26172,14583,27236
֥Ӣ,ZhiYingZhen,330784115,44611,5177,28255,22588,37244,27255,10453,29609,56864,31986,60241
½ֵ,XinXinJieDao,330802005,38478,1641,23506,17801,16993,22783,8382,23881,46664,24995,48501
ɽֵ,FuShanJieDao,330802006,27923,5597,19588,13653,26832,16531,4481,15386,31917,18413,38001
ɻֵ,HeHuaJieDao,330802007,40099,4302,26589,19767,32736,25959,8553,25334,51293,26365,52954
Űֵ,XinAnJieDao,330802008,28688,3386,19214,13486,23082,17188,5261,16316,33504,18121,37335
ƽֵ,BaiYunJieDao,330802009,26381,1975,15597,6695,14887,9571,3162,9435,19006,15921,31518
˫۽ֵ,ShuangGangJieDao,330802010,23625,2527,15362,10438,17180,14257,5006,14422,28679,15796,31158
԰ֵ,HuaYuanJieDao,330802011,45902,7392,29627,25098,44596,28745,8384,30129,58874,32051,61678
ʯ,ShiLiangZhen,330802100,17761,3488,11948,8570,23479,11931,3240,12417,24348,12541,24489
,HangBuZhen,330802101,28712,5422,19722,13394,38091,19625,6108,20236,39861,20520,40242
Ƽ,HuangJiaXiang,330802205,12010,1661,7955,5613,14168,7786,2648,7928,15714,8364,16319
,QiLiXiang,330802209,1603,540,1262,1136,2413,1260,391,1271,2531,1272,2534
Ż,JiuHuaXiang,330802210,11026,2507,7661,6041,15254,7640,2400,8200,15840,8272,15933
Ϫ,GouXiXiang,330802211,8246,1628,5698,4224,11212,5689,1823,5946,11635,5999,11697
,HuaShuXiang,330802212,8847,1526,5867,4434,11859,5828,2049,6477,12305,6555,12422
ɽ,JiangJiaShanXiang,330802213,6937,1048,4640,3329,8899,4628,1531,4800,9428,4876,9516
,WanTianXiang,330802214,10245,1817,6896,4963,13138,6877,2078,7208,14085,7244,14140
ʯ,ShiShiXiang,330802215,12543,1514,7842,4759,11217,6752,2033,7100,13852,8248,16090
̶ֵ,ZhangTanJieDao,330803001,49663,2808,22111,14657,24334,18949,7230,20446,39395,37590,59701
ʯֵ,FuShiJieDao,330803002,10038,1635,6716,4906,11097,6716,1941,6884,13600,6898,13614
Ϸ,ShangFangZhen,330803100,15421,3388,11036,8202,20959,10993,3801,11474,22467,11574,22610
Ͽ,XiaChuanZhen,330803101,6896,1766,5102,3994,9977,5094,1774,5312,10406,5334,10436
,LianHuaZhen,330803103,19913,3899,13855,10581,26641,13827,4603,14518,28345,14560,28415
ȫ,QuanWangZhen,330803109,10098,2146,7137,5576,13829,7134,2470,7542,14676,7577,14714
,DaZhouZhen,330803110,9556,1761,6305,4854,12041,6251,1769,6676,12927,6781,13086
Ϫ,HouXiZhen,330803111,14395,2620,9706,7339,19625,9706,3245,10554,20260,10554,20260
إ,NianLiZhen,330803112,19262,2924,12999,8828,24560,12996,4546,13714,26710,13733,26732
,HuNanZhen,330803113,5352,1294,3845,3223,6811,3748,1348,4025,7773,4149,7994
߼,GaoJiaZhen,330803114,35156,5672,23926,16449,44721,22799,7588,23576,46375,24490,48416
,DuZeZhen,330803115,16598,3420,11621,8590,21219,10889,3409,11194,22083,11806,23427
ƺ,HuiPingXiang,330803200,1293,462,1028,895,1973,1024,319,1041,2065,1046,2074
̫,TaiZhenXiang,330803202,1731,679,1346,1238,2667,1346,368,1432,2778,1432,2778
˫,ShuangQiaoXiang,330803203,1610,556,1264,1028,2360,1264,403,1305,2569,1305,2569
ܼ,ZhouJiaXiang,330803206,8826,1643,5998,4255,12032,5994,1919,6382,12376,6390,12388
Ϫ,YunXiXiang,330803207,13626,2665,9375,7253,18196,9363,3218,10120,19483,10134,19509
ٴ,JuCunXiang,330803213,1330,479,938,945,1712,936,277,1131,2067,1148,2086
,LingYangXiang,330803218,3123,810,2140,2255,4211,2140,728,2506,4646,2521,4661
̳,HuangTanKouXiang,330803219,4190,1008,2840,2399,5629,2840,768,3126,5966,3126,5966
ʯ,BaiShiZhen,330822104,3978,771,2978,2309,5144,2947,1105,2801,5748,2876,5854
,ZhaoXianZhen,330822108,14325,3354,10719,8785,20611,10652,4155,10969,21621,11115,21834
ʯ,QingShiZhen,330822109,17222,3001,12273,9072,23720,12227,4874,12617,24844,12824,25097
,QiuChuanZhen,330822111,14763,3208,10204,8160,19044,10136,4305,9740,19876,12072,22276
,TianMaZhen,330822112,63294,7967,42387,30102,65389,39745,13514,39268,79013,42388,84775
Բ,HuiBuZhen,330822113,9394,1508,6287,4325,11610,6155,2171,6313,12468,6786,13073
,FangCunZhen,330822114,7439,1833,6003,4518,11300,5899,2511,5674,11573,5780,11783
μ,HeJiaXiang,330822200,6487,1339,4659,3492,8938,4642,1612,4756,9398,4779,9438
ͬ,TongGongXiang,330822211,5130,897,3679,2744,6877,3670,1383,3662,7332,3731,7410
ͷ,DaQiaoTouXiang,330822213,5751,1337,4354,3505,8291,4350,1625,4344,8694,4359,8713
,SongFanXiang,330822217,7074,1512,5283,4146,10132,5279,2073,5327,10606,5376,10659
²,XinChangXiang,330822219,4910,1538,4110,3346,7690,4092,1674,3982,8074,4012,8122
,XinQiaoXiang,330822220,2428,659,1872,1503,3638,1871,692,1896,3767,1907,3779
,DongAnXiang,330822221,5505,1433,4317,3628,8158,4317,1617,4217,8534,4238,8555
ͩ,TongCunZhen,330824106,6388,1488,5380,4110,9848,5376,2447,4915,10291,4943,10323
,YangLinZhen,330824107,6369,1318,4921,3615,9212,4921,2006,4753,9674,4772,9693
ׯ,SuZhuangZhen,330824108,7920,1700,6115,4769,11703,6079,2389,5782,11861,5894,12009
Ϫ,QiXiZhen,330824109,2393,629,2060,1688,3698,2035,768,1693,3728,1730,3790
ǹ,ChengGuanZhen,330824110,49283,5589,33089,22904,48900,30641,11225,29760,60401,33008,66097
,HuaBuZhen,330824111,25437,3872,17561,12543,28436,16732,5832,16652,33384,17580,35141
,MaJinZhen,330824112,14926,2967,11869,8749,20143,11558,4420,9985,21543,10444,22313
ͷ,CunTouZhen,330824113,5624,1511,4804,3837,8627,4800,1903,4197,8997,4234,9038
ػ,ChiHuaiZhen,330824114,10968,2096,8323,5962,14463,8313,2986,7680,15993,7727,16050
д,ZhongCunXiang,330824202,3338,763,2555,2002,4771,2547,832,2361,4908,2378,4933
,ChangHongXiang,330824205,4706,1195,3733,2890,7020,3710,1328,3453,7163,3496,7229
,ZhangWanXiang,330824206,3315,747,2493,1883,4725,2484,797,2347,4831,2366,4859
,HeTianXiang,330824208,3784,976,3059,2459,5586,3055,1027,2696,5751,2728,5787
,TangWuXiang,330824209,2264,791,2176,1789,3855,2171,965,1830,4001,1844,4020
ɽ,LinShanXiang,330824216,5134,1591,4156,3375,7830,4136,1371,3912,8048,3940,8096
,YinKengXiang,330824217,10542,2394,8277,6065,15453,8247,3191,7781,16028,7850,16127
Ϫ,DaXiBianXiang,330824218,3866,1318,3390,2799,6193,3386,1292,3046,6432,3086,6476
,JinCunXiang,330824219,2008,609,1547,1303,2972,1547,490,1560,3107,1560,3107
޽ֵ,LongZhouJieDao,330825001,69314,7250,40212,28849,58213,37660,12330,36899,74559,48682,88894
ֵ,DongHuaJieDao,330825002,28372,2730,17187,9826,20788,12881,4034,12901,25782,17949,35136
,HuZhenZhen,330825101,31037,5078,20719,16468,35946,19825,6357,20363,40188,21753,42472
СϺ,XiaoNanHaiZhen,330825102,19190,3526,13064,9382,24666,12621,4064,12933,25554,13716,26780
ղ,ZhanJiaZhen,330825106,14918,2894,10248,7548,19632,10032,3178,10294,20326,10742,20990
Ϫ,XiKouZhen,330825109,12646,2552,8851,6947,15837,8736,2664,8825,17561,9011,17862
ɽ,HengShanZhen,330825110,17089,3581,12048,8933,22073,11111,3611,10960,22071,12233,24281
ʯ,TaShiZhen,330825111,23167,4649,16088,12093,31944,15840,5105,16286,32126,16833,32921
޼,LuoJiaXiang,330825201,4113,1061,2942,2476,5771,2940,839,3068,6008,3071,6013
,MiaoXiaXiang,330825203,5676,1475,4172,3335,8071,4145,1296,4193,8338,4275,8447
ʯ,ShiFoXiang,330825207,8015,1973,5886,4811,11405,5869,1916,5973,11842,6018,11904
,SheYangXiang,330825209,4094,1314,3031,2839,6075,3011,884,3214,6225,3261,6292
,DaJieXiang,330825211,3534,803,2494,2000,4919,2492,825,2658,5150,2668,5162
峾,MuChenSheZuXiang,330825212,5261,1305,3723,3109,7390,3703,1084,3898,7601,3927,7650
ģ,MoHuanXiang,330825213,20468,3135,13145,10063,20647,12085,3973,12469,24554,14431,27576
˫ֵ,ShuangTaJieDao,330881001,49089,6136,33820,23615,45777,32449,11988,31697,64146,33393,67213
ɽֵ,HuShanJieDao,330881002,63147,6077,42464,30649,48345,40440,15595,39714,80154,42355,84819
Ķ,SiDouZhen,330881102,8022,1514,5566,4112,10454,5514,1843,5695,11209,5813,11379
,QingHuZhen,330881104,23776,3869,16392,11265,25236,14839,5151,14779,29618,16404,32796
̳ʯ,TanShiZhen,330881105,11410,2826,8732,7105,16053,8729,3216,8639,17368,8720,17452
,DaQiaoZhen,330881106,6885,1764,5200,4256,9711,5183,1643,4928,10111,5092,10292
ͷ,YuTouZhen,330881108,15115,3191,10920,8104,18413,10363,3531,10273,20636,10917,21837
,XinTangBianZhen,330881109,10524,3211,8660,7227,15371,8608,3103,8047,16655,8178,16838
إ˶,NianBaDouZhen,330881112,4364,1144,3455,2880,6699,3450,1514,3527,6977,3567,7022
̨,ChangTaiZhen,330881113,7322,1848,5624,4479,10019,5607,2037,5511,11118,5583,11207
,ShangYuZhen,330881116,23584,3870,15751,11835,27605,14784,5225,15658,30442,16928,32679
ش,HeCunZhen,330881117,30776,5410,21892,16320,33153,21115,7877,21059,42174,22171,44063
,FengLinZhen,330881118,15631,4153,12444,9718,22360,12352,4701,11895,24247,12041,24485
Ͽ,XiaKouZhen,330881119,19649,4191,14713,11057,26583,14565,5606,14415,28980,14733,29446
ʯ,ShiMenZhen,330881120,14064,3644,10946,8807,20601,10904,4210,10801,21705,10972,21918
,DaChenXiang,330881201,2990,888,2249,1997,4161,2246,702,2326,4572,2331,4580
Ҥ,WanYaoXiang,330881203,9169,1899,6473,5003,12191,6459,2286,6817,13276,6881,13354
,BaoAnXiang,330881207,2413,677,1888,1549,3518,1844,661,1791,3635,1863,3751
˫Ϫ,ShuangXiKouXiang,330881211,681,288,527,541,918,525,97,534,1059,539,1066
Ŵ,ZhangCunXiang,330881212,3411,1429,2799,2626,5458,2794,995,2997,5791,3036,5835
Դ,TangYuanKouXiang,330881213,3525,1312,2839,2466,5467,2821,993,2898,5719,2991,5830
Žֵ,JieFangJieDao,330902001,41927,4638,27048,21176,24761,26436,6460,24986,51422,25977,53025
ֵ,ChangGuoJieDao,330902002,24362,3087,16370,12452,19371,15685,4112,14406,30091,15191,31561
Ͻֵ,HuanNanJieDao,330902003,23753,3172,15076,12267,14219,14381,3124,13706,28087,14973,30049
Ƕֵ,ChengDongJieDao,330902004,95989,6074,56199,40328,49789,50447,13431,50014,100461,59295,115494
βֵֽ,YanCangJieDao,330902005,22027,2373,13465,11039,13701,13217,3683,13813,27030,14618,28083
ٳǽֵ,LinChengJieDao,330902006,45646,4339,25296,20034,28879,23478,5912,25093,48571,30601,55897
,JinTangZhen,330902100,27917,5389,18441,16599,29877,18204,4800,18482,36686,19665,38106
Сɳ,XiaoShaZhen,330902101,8931,2377,5395,4843,8594,5127,819,5254,10381,6732,12127
᯸,CenGangZhen,330902102,8737,2242,5352,4787,8488,5291,906,5508,10799,6533,11885
˫,ShuangQiaoZhen,330902103,11105,2325,7209,5846,12960,7160,1546,7482,14642,7767,14976
Ȫ,BaiQuanZhen,330902104,24271,3981,15083,11144,24375,14612,3299,14988,29600,16468,31551
,GanLanZhen,330902105,9422,1563,5809,4814,7943,5655,1256,5944,11599,6432,12241
,MaAoZhen,330902106,8451,1430,5049,4555,7297,4974,1048,5443,10417,5880,10929
,ChangBaiXiang,330902200,2198,698,1399,1410,2518,1392,170,1341,2733,1667,3066
,CeZiXiang,330902201,5515,531,1809,1706,2120,1589,288,1805,3394,4525,6334
,BeiChanXiang,330902202,6624,1520,4050,3513,6676,3984,716,4149,8133,4810,8860
Žֵ,ShenJiaMenJieDao,330903001,114107,11582,67977,53954,71473,65751,14490,64616,130367,72202,140179
ɽֵ,GouShanJieDao,330903002,33637,3487,19818,16204,22988,19630,4520,20988,40618,21826,41644
۽ֵ,DongGangJieDao,330903003,34183,2098,21206,15430,18691,20703,6004,20183,40886,21079,42285
Ҽֵ,ZhuJiaJianJieDao,330903004,22276,2954,13549,10057,19453,12540,2751,12848,25388,14432,27981
չéֵ,ZhanMaoJieDao,330903005,15327,3000,9818,8204,16686,9678,1730,9955,19633,10239,20057
,LiuHengZhen,330903100,47868,8488,27155,22487,46152,26527,4969,27623,54150,34170,61325
Ϻ,XiaZhiZhen,330903102,9474,2903,6221,5691,11225,6158,734,6421,12579,6890,13111
һ,TaoHuaZhen,330903104,7946,2178,5379,4744,9652,5351,743,5390,10741,5488,10867
,DongJiZhen,330903105,1068,421,706,809,1200,703,17,786,1489,800,1506
ɽ,PuTuoShanZhen,330903106,9035,595,4698,4563,3869,3863,781,4566,8429,5713,10411
ϵ,MaYiDaoXiang,330903200,5106,521,2124,1986,2596,1958,187,2278,4236,3690,5814
ǲ,DengBuXiang,330903201,1798,765,1265,1339,2402,1260,54,1317,2577,1352,2617
ɳ,BaiShaXiang,330903202,697,297,472,524,850,460,14,495,955,536,1008
ͤ,GaoTingZhen,330921100,65287,7067,39154,31277,53208,38385,9085,38229,76614,42285,81439
ɳ,DongShaZhen,330921101,10991,3323,7846,7162,11601,7640,983,7261,14901,7451,15297
᷶,DaiDongZhen,330921102,6246,1736,4247,3767,7762,4201,486,4151,8352,4221,8468
,DaiXiZhen,330921103,9549,1979,4792,4209,8355,4589,610,4723,9312,7346,12138
Ϳ,ChangTuZhen,330921105,18845,1855,6589,6014,8303,5923,800,6434,12357,14911,21500
ɽ,QuShanZhen,330921106,41095,6593,25667,20440,45714,25419,5528,25634,51053,27549,53216
ɽ,XiuShanXiang,330921200,8282,1312,3785,3162,4873,3328,512,3485,6813,6321,10106
԰,CaiYuanZhen,330922100,30531,4022,19441,15992,28097,18871,4366,18542,37413,19478,38919
ɽ,ShengShanZhen,330922101,6733,1049,4131,3753,6677,4114,727,4266,8380,4378,8509
ɽ,YangShanZhen,330922102,7644,1005,4732,3708,8406,4669,1083,4469,9138,5000,9732
,WuLongXiang,330922200,2480,635,1565,1483,2799,1557,204,1564,3121,1754,3319
,HuangLongXiang,330922201,5512,989,3292,2922,6213,3276,540,3485,6761,3749,7041
,GouQiXiang,330922202,5942,924,3693,3088,6450,3680,745,3754,7434,3918,7611
,HuaNiaoXiang,330922203,692,253,475,529,884,475,32,488,963,502,977
Žֵ,HaiMenJieDao,331002001,86543,8956,53379,38920,60806,50664,15769,50773,101437,57889,111268
ƽֵ,BaiYunJieDao,331002002,92173,7205,56895,41666,50558,52567,15680,51675,104242,58163,115058
bֵ,JiaZhiJieDao,331002003,94488,7685,56920,37332,53885,48865,15739,50145,99010,60992,117912
ҽֵ,HongJiaJieDao,331002004,57536,5538,35787,21849,41133,31578,10407,32277,63855,37694,73481
׽ֵ,SanJiaJieDao,331002005,46961,6309,29682,22409,45653,28348,9193,29860,58208,32781,62463
³½ֵ,XiaChenJieDao,331002006,42282,4658,26067,19188,34251,25287,7969,26924,52211,28842,54909
ǰֵ,QianSuoJieDao,331002007,33773,4728,21441,15062,32808,20465,7420,21580,42045,24480,45921
°ֵ,ZhangAnJieDao,331002008,46802,7834,32886,21780,62350,32570,12820,33995,66565,34570,67456
,DaChenZhen,331002101,1788,295,914,974,1358,906,144,994,1900,1313,2227
ũ,JiaoJiangNongChang,331002400,2432,306,1349,1403,1219,1336,332,1597,2933,1721,3070
ǽֵ,DongChengJieDao,331003001,77572,7538,48930,34185,48027,44163,12451,43259,87422,48631,97561
ϳǽֵ,NanChengJieDao,331003002,24529,2677,15188,11469,18334,14570,4299,15367,29937,16317,31505
ǽֵ,XiChengJieDao,331003003,70168,7768,44693,30315,51015,41575,12736,42381,83956,45979,90672
ǽֵ,BeiChengJieDao,331003004,43704,3823,25000,19461,28549,23366,6662,25850,49216,29189,54189
ǰֵ,XinQianJieDao,331003005,42833,4788,26726,17770,37174,25241,8097,26436,51677,28992,55718
νֵ,ChengJiangJieDao,331003006,25681,3799,16941,11699,26476,16713,5032,16921,33634,17571,34512
ڽֵ,JiangKouJieDao,331003007,30953,3749,19364,12886,28972,18275,5613,19179,37454,20951,40315
Žֵ,GaoQiaoJieDao,331003008,17133,2589,11470,7497,18127,11097,3418,11187,22284,11670,23140
Ϫ,NingXiZhen,331003101,15271,4055,11963,9266,20204,11761,3856,10986,22747,11219,23182
,BeiYangZhen,331003102,14901,4070,11300,8790,19817,10820,3273,10381,21201,10944,22244
ͷ,TouTuoZhen,331003103,22880,4123,15556,10827,29526,15420,4740,15937,31357,16187,31743
Ժ,YuanQiaoZhen,331003107,55069,7829,36440,24255,54994,35157,10921,35788,70945,37379,73819
ɳ,ShaBuZhen,331003108,14554,2943,10381,7281,16987,10343,3366,10350,20693,10482,20863
ͷ,YuTouXiang,331003200,3790,1628,3159,2673,5967,3146,814,3024,6170,3073,6232
֣,ShangZhengXiang,331003201,3422,1491,2869,2553,5532,2864,792,2824,5688,2836,5705
ɽ,FuShanXiang,331003202,2475,1234,2130,1950,4198,2128,596,2174,4302,2175,4305
é,MaoSheXiang,331003203,3104,1563,3021,2642,5219,2952,1078,2628,5580,2724,5745
ψ,ShangYangXiang,331003204,3570,2229,3550,3503,6549,3540,1031,3268,6808,3280,6830
ƽ,PingTianXiang,331003205,1890,1200,1989,1951,3756,1983,753,1838,3821,1854,3843
·Ͻֵ,LuNanJieDao,331004001,39007,3345,22900,15920,26168,20453,6960,22514,42967,26412,49312
·Žֵ,LuQiaoJieDao,331004002,67644,5467,41540,29620,38639,38058,11428,38654,76712,42999,84539
·ֵ,LuBeiJieDao,331004003,39485,2283,22803,13005,18281,18716,6513,19550,38266,25478,48281
ֵ,LuoYangJieDao,331004004,32545,2481,18555,11310,20085,15671,5610,16553,32224,22081,40636
ֵͩ,TongYuJieDao,331004005,32405,3638,20050,13354,28505,18678,6106,19561,38239,22099,42149
彭ֵ,FengJiangJieDao,331004006,62755,4796,35962,29868,34824,34847,10939,40160,75007,42528,78490
,XinQiaoZhen,331004103,30743,3020,18328,12103,22400,16549,5832,17939,34488,21267,39595
,HengJieZhen,331004104,31982,3075,19015,14376,22151,18229,5740,20022,38251,21782,40797
,JinQingZhen,331004106,83446,11657,53772,36339,81577,50759,16378,53199,103958,57709,111481
,PengJieZhen,331004107,62145,7419,38034,24421,52493,34574,11778,36920,71494,43308,81342
ǽֵ,YuChengJieDao,331021001,143412,8707,84201,67765,85797,82334,26649,89727,172061,94567,178768
Žֵ,KanMenJieDao,331021002,68501,7436,43144,30790,58293,42463,12978,44452,86915,45771,88915
ֵ,DaMaiYuJieDao,331021003,66197,5626,38908,30513,44026,37605,11936,41983,79588,44851,83759
,QingGangZhen,331021101,55231,5467,33721,26873,44019,33514,10838,37049,70563,37815,71536
,ChuMenZhen,331021102,67860,5926,39988,33159,44248,39400,11261,43749,83149,45059,85047
ɽ,GanJiangZhen,331021103,16493,2391,10342,8273,16619,10278,2925,11159,21437,11467,21809
ɳ,ShaMenZhen,331021105,19791,2724,12286,8573,19660,11616,3443,12004,23620,13672,25958
«,LuPuZhen,331021106,19807,1898,11089,8586,14818,10156,2733,11305,21461,13349,24438
Ϫ,LongXiXiang,331021200,23364,2051,13991,11453,15102,13836,4305,15361,29197,15729,29720
ɽ,JiShanXiang,331021201,2388,510,1672,1386,2983,1650,486,1649,3299,1712,3384
ɽ,HaiShanXiang,331021202,1893,735,1493,1400,2882,1487,384,1510,2997,1519,3012
,HaiYouZhen,331022100,79503,7843,51717,35518,71113,48984,18587,50075,99059,54216,105933
ɳ,ShaLiuZhen,331022101,7674,1632,5693,4385,10422,5678,2114,5623,11301,5727,11420
,ZhuAoZhen,331022102,11337,1844,7786,5635,14077,7750,2993,8299,16049,8388,16174
ͤ,TingPangZhen,331022103,22255,4746,16570,11664,31915,15986,6136,16093,32079,16567,33137
,LiuAoZhen,331022104,17491,2822,11899,8854,21029,11657,4366,11952,23609,12780,24679
,JianTiaoZhen,331022105,18592,2662,10951,8860,19373,10554,3571,11479,22033,13874,24825
,HengDuZhen,331022106,4535,1636,3559,3126,6950,3525,1059,3594,7119,3671,7230
,LiPuZhen,331022107,12617,2532,9061,6852,17540,8926,3306,9130,18056,9394,18455
,HuaQiaoZhen,331022108,10127,2381,7805,6211,14524,7713,2791,7363,15076,7494,15299
С,XiaoXiongZhen,331022109,13998,2756,10132,7485,19718,10034,3823,10305,20339,10445,20577
,GaoJianXiang,331022200,10581,1776,7293,5179,13187,7255,2664,7692,14947,7728,15021
س,YanChiXiang,331022203,12487,1643,7373,5978,11900,7002,2374,7697,14699,9131,16504
,SiLinXiang,331022204,12687,1868,8515,6006,15764,8427,3132,8739,17166,9172,17687
,ShePanXiang,331022205,1532,161,868,782,1006,846,253,1038,1884,1078,1946
ǽֵ,ChiChengJieDao,331023001,67435,8328,46913,32790,70833,45202,17505,44382,89584,46355,93268
ʼֵ,ShiFengJieDao,331023002,26086,3629,17975,12532,27112,16750,6799,16796,33546,18539,36514
Ϫֵ,FuXiJieDao,331023003,30898,3475,20527,14149,28169,19643,8187,20889,40532,22033,42560
׺,BaiHeZhen,331023101,24335,6080,18859,15762,35062,18532,6933,18096,36628,18489,37348
ʯ,ShiLiangZhen,331023102,4184,1405,2937,3041,5874,2929,628,3175,6104,3280,6217
ͷ,JieTouZhen,331023104,13729,3820,11205,9504,20694,11092,4490,10696,21788,10834,22039
ƽ,PingQiaoZhen,331023105,40426,10162,31503,23912,55352,29597,11010,28280,57877,30095,61598
̹ͷ,TanTouZhen,331023106,20710,3352,14689,10677,25573,14044,6300,15041,29085,15673,30362
,SanHeZhen,331023107,11798,2801,9620,7679,16480,9490,4578,9373,18863,9557,19177
,HongChouZhen,331023108,8007,1428,5882,4306,9854,5839,2520,6015,11854,6073,11955
,SanZhouXiang,331023200,3017,914,2248,2049,4463,2246,718,2401,4647,2401,4649
Ϫ,LongXiXiang,331023203,1858,719,1563,1407,2905,1552,493,1486,3038,1507,3070
׷,LeiFengXiang,331023204,3338,1333,2837,2671,5322,2831,948,2761,5592,2782,5619
,NanPingXiang,331023207,2419,1254,2079,2122,3994,2078,586,2167,4245,2180,4259
ӾϪ,YongXiXiang,331023209,2537,1022,2055,1985,4021,2055,618,2122,4177,2122,4177
޽ֵ,AnZhouJieDao,331024001,28644,3091,19123,12570,22540,18447,7320,18972,37419,19932,39055
Ϸֵ,NanFengJieDao,331024002,39061,3609,26390,16964,24363,25582,10756,26230,51812,27036,53426
Ӧֵ,FuYingJieDao,331024003,36206,4773,25161,17072,35484,24822,10187,25329,50151,26005,51166
Ϫ,HengXiZhen,331024101,21650,4376,17088,12162,28512,16581,7731,16208,32789,16669,33757
ͷ,BuTouZhen,331024102,6650,1520,5333,3926,9686,5332,2440,5248,10580,5277,10610
,BaiTaZhen,331024103,13835,3671,11925,9253,19618,11773,6373,11704,23477,11954,23879
,TianShiZhen,331024104,7833,2453,6547,5387,12363,6526,3105,6778,13304,6844,13391
·,GuanLuZhen,331024105,10432,1869,7818,5784,13996,7811,3685,8156,15967,8168,15986
¸,XiaGeZhen,331024106,22243,4458,16938,12406,31624,16821,7677,17339,34160,17440,34378
Ϫ,ZhuXiZhen,331024107,6644,2678,5826,5229,10992,5823,2362,5841,11664,5858,11684
,AnLingXiang,331024200,2766,1035,2366,2175,4410,2366,1028,2463,4829,2463,4829
Ϫ,XiGangXiang,331024201,2175,720,1750,1470,3327,1750,714,1858,3608,1859,3609
ɽ,QiuShanXiang,331024202,4302,1477,3570,2997,6942,3569,1458,3651,7220,3667,7237
,DanZhuXiang,331024203,2104,1032,1888,1784,3670,1877,742,1975,3852,1990,3878
̲,PoTanXiang,331024204,3979,1281,3368,2839,6093,3348,1490,3355,6703,3382,6750
,ShangZhangXiang,331024205,3211,990,2459,2148,4952,2433,1030,2730,5163,2772,5231
·,BuLuXiang,331024206,4026,1267,3197,2576,6094,3186,1266,3357,6543,3362,6559
,GuangDuXiang,331024207,2052,841,1644,1359,3278,1644,566,1815,3459,1815,3459
ս,DaZhanXiang,331024209,4877,1476,3979,3191,7451,3969,1668,4003,7972,4042,8021
˫,ShuangMiaoXiang,331024210,3497,1068,2848,2365,5232,2841,1206,2909,5750,2923,5771
̫ƽֵ,TaiPingJieDao,331081001,110410,9920,70728,47850,88455,63995,19366,61134,125129,68968,139696
Ƕֵ,ChengDongJieDao,331081002,59089,5673,35053,25463,37966,31100,8911,31731,62831,38620,73673
ֵ,ChengXiJieDao,331081003,29000,2951,17441,14057,19814,16709,5227,17943,34652,19737,37178
Ǳֵ,ChengBeiJieDao,331081004,48845,2529,26703,21377,15325,22840,6401,25217,48057,31072,57775
ֵ,HengFengJieDao,331081005,65390,3607,36636,27216,25619,31797,10398,34846,66643,42759,79395
,ZeGuoZhen,331081100,153208,14184,90018,70391,95094,82977,25166,89517,172494,102540,192558
Ϫ,DaXiZhen,331081101,127755,14309,76779,58566,94166,71793,21922,77115,148908,87207,163986
,SongMenZhen,331081102,78897,10656,48873,39112,71984,47476,12706,50125,97601,53386,102259
,RuoHengZhen,331081103,79890,15865,54118,45794,91269,53348,15897,56181,109529,57534,111652
º,XinHeZhen,331081104,79603,13741,52729,40181,80496,50360,14982,51689,102049,55597,108326
ʯ,ShiTangZhen,331081105,49726,7646,32284,25820,53597,31959,8398,32361,64320,33486,65770
,BinHaiZhen,331081106,43605,8774,30092,24112,50802,29917,8795,30445,60362,31082,61174
,WenQiaoZhen,331081107,55898,7945,35238,27103,45297,32187,10075,33665,65852,38680,73918
,ChengNanZhen,331081108,44175,8634,30352,22906,55525,30059,8714,30238,60297,31171,61523
ʯͷ,ShiQiaoTouZhen,331081109,11917,3276,8934,7339,16107,8895,2481,8650,17545,8740,17674
,WuGenZhen,331081110,14130,3159,10094,7755,18510,10028,2948,10023,20051,10143,20237
ųǽֵ,GuChengJieDao,331082001,124265,14838,83280,56965,105286,77995,25655,76309,154304,81478,164758
ֵ,DaYangJieDao,331082002,78475,4170,47304,29001,40950,38085,14493,40290,78375,49834,97138
Ͻֵ,JiangNanJieDao,331082003,24785,2636,15134,12081,21245,14301,4517,15601,29902,16804,31938
ֵ,DaTianJieDao,331082004,34146,3901,22367,15205,30686,21169,7458,21365,42534,23138,45505
ۼҶɽֵ,ShaoJiaDuJieDao,331082005,24448,3717,16206,11545,30242,16034,5608,16427,32461,17567,33773
Ѵ,XunQiaoZhen,331082100,12767,2070,8206,6280,14049,8109,2658,8643,16752,9289,17495
,DongChengZhen,331082101,36693,5968,25291,18232,42380,24784,8636,25207,49991,26006,51297
Ϫ,HuiXiZhen,331082103,6034,2023,4723,3852,9018,4716,1331,4636,9352,4665,9388
С֥,XiaoZhiZhen,331082104,17117,3368,12611,8906,24206,12466,4857,12534,25000,12731,25342
ͷ,HeTouZhen,331082105,16108,4098,12671,10306,23910,12669,4699,12223,24892,12234,24905
ˮ,BaiShuiYangZhen,331082106,36737,7856,28203,22184,54539,28037,13362,29503,57540,29752,57955
,KuoCangZhen,331082107,19627,3861,14434,11530,28480,14385,6021,15005,29390,15075,29509
,YongFengZhen,331082108,25916,5092,18333,13482,35982,18126,6801,18979,37105,19476,37809
Ϫ,YouXiZhen,331082109,10339,2848,7765,6161,14694,7625,2285,7570,15195,7707,15472
ӿȪ,YongQuanZhen,331082110,30332,5144,20487,14946,37840,20343,7466,21431,41774,22455,42942
ؽ,YanJiangZhen,331082111,30767,5055,20598,13560,38290,20190,6640,20861,41051,21864,42462
,DuQiaoZhen,331082112,131906,19781,88406,59573,148585,85295,32183,89238,174533,95464,183870
,ShangPanZhen,331082113,30244,5222,21379,14798,40580,21094,8594,21799,42893,22681,44060
,TaoZhuZhen,331082114,49415,9156,36632,26800,69795,36152,14624,36048,72200,36563,73195
Ͻֵ´,ZiJinJieDaoBanShiChu,331102001,64373,5112,40804,29716,31995,39571,13020,39680,79251,41701,82505
Ȫֵ´,YanQuanJieDaoBanShiChu,331102002,62503,3330,37309,23529,22775,32778,12237,34892,67670,40761,78070
ֵ´,WanXiangJieDaoBanShiChu,331102003,33460,4868,22869,17494,21785,21719,6461,20876,42595,21920,44789
ƽֵ´,BaiYunJieDaoBanShiChu,331102004,60278,3725,37270,21535,21524,27980,9681,28294,56274,36414,73684
ˮֵ´,ShuiGeJieDaoBanShiChu,331102005,41068,1841,20168,18282,12883,17268,5046,20831,38099,27787,47955
ֵ´,FuLingJieDaoBanShiChu,331102006,6267,983,4234,2953,7839,4226,1369,4348,8574,4385,8619
̺,BiHuZhen,331102100,29706,4938,19261,16008,30713,18375,5543,19128,37503,20926,40187
,LianChengZhen,331102101,7987,1672,5527,4895,10625,5444,1641,5609,11053,5773,11300
ͷ,DaGangTouZhen,331102102,5863,1364,4154,3839,7178,4124,1314,4330,8454,4387,8541
,LaoZhuSheZuZhen,331102103,5601,1681,4307,4026,8067,4247,1593,4476,8723,4568,8875
Ϫ,YaXiZhen,331102104,4908,2204,4139,4048,8043,4115,1299,4225,8340,4272,8411
̫ƽ,TaiPingXiang,331102200,6802,2307,5285,5083,10422,5275,1785,5594,10869,5609,10894
ɶ,XianDuXiang,331102201,3147,1278,2388,2430,4751,2384,598,2629,5013,2635,5023
Դ,FengYuanXiang,331102202,1840,846,1362,1468,2677,1358,286,1604,2962,1610,2972
Ϫ,GaoXiXiang,331102203,4005,1011,2753,2378,5465,2742,754,2995,5737,3017,5770
,LiXinSheZuXiang,331102204,3409,1084,2552,2431,4885,2552,854,2793,5345,2795,5347
˫,ShuangHuangXiang,331102205,1940,764,1479,1432,2938,1469,430,1601,3070,1655,3134
ƴ,HuangCunXiang,331102206,3318,1245,2457,2694,5108,2454,779,2850,5304,2885,5342
׳,HeChengZhen,331121100,75051,12104,54274,35441,53376,50969,22431,49947,100916,55312,109586
Ϫ,WenXiZhen,331121101,47278,4784,29356,18188,23766,25181,10345,26118,51299,33051,62407
Դ,DongYuanZhen,331121102,8142,1471,5974,4429,10009,5865,2959,6431,12296,6598,12572
ߺ,GaoHuZhen,331121103,6817,1359,5089,3466,9000,4932,2549,5273,10205,5636,10725
,ChuanLiaoZhen,331121104,17690,3097,12893,8777,22548,11868,5815,12374,24242,13709,26602
,HaiKouZhen,331121105,6656,1391,4879,3415,9117,4806,2321,5279,10085,5489,10368
,LaKouZhen,331121106,9168,2187,6847,5224,11617,6634,2661,6845,13479,7169,14016
ɽ,BeiShanZhen,331121107,1653,618,1169,1199,2181,1121,339,1372,2493,1441,2610
ɽ,ShanKouZhen,331121108,5060,1041,3887,2802,4419,3823,1909,3991,7814,4123,8010
ׯ,RenZhuangZhen,331121109,3330,1036,2593,2284,4795,2527,1066,2665,5192,2839,5432
ɽ,WanShanXiang,331121200,473,231,357,406,740,357,84,430,787,431,788
ƈ,HuangYangXiang,331121201,1881,435,1216,1138,2171,1188,467,1500,2688,1567,2783
լ,JiZhaiXiang,331121202,4408,1101,3317,2915,6408,3316,1590,3777,7093,3782,7099
,GaoShiXiang,331121203,2093,574,1592,1302,3066,1583,704,1726,3309,1779,3371
Ϫ,HaiXiXiang,331121204,2662,793,2051,1714,4011,2032,937,2302,4334,2341,4392
´,ZhangCunXiang,331121205,3380,1589,2644,2525,5686,2619,853,3124,5743,3178,5822
,ZhenWangXiang,331121206,1417,468,1072,869,2166,1053,427,1218,2271,1240,2312
,ZhenBuXiang,331121207,5342,1120,3865,2733,7291,3823,1688,4174,7997,4285,8150
,ShuQiaoXiang,331121208,3757,1263,2858,2514,5902,2821,1265,3382,6203,3427,6285
,JuPuXiang,331121209,1586,602,1159,1174,2110,1152,436,1316,2468,1465,2624
,LingGenXiang,331121210,379,163,266,304,546,262,82,357,619,358,624
,WanFuXiang,331121211,1881,716,1405,1254,2811,1401,555,1712,3113,1747,3152
ɽ,FangShanXiang,331121212,2136,810,1858,1595,2842,1823,736,1783,3606,1824,3682
,TangYangXiang,331121213,1091,399,856,757,1469,836,323,908,1744,957,1813
,GuiAoXiang,331121214,928,479,786,802,1450,778,206,810,1588,827,1613
Сɽ,XiaoZhouShanXiang,331121215,829,469,627,900,1073,627,64,735,1362,735,1362
,WuKengXiang,331121216,1655,877,1286,1372,2556,1240,237,1386,2626,1483,2769
ʹ,RenGongXiang,331121217,2846,808,2302,1857,4217,2277,1070,2396,4673,2422,4724
µ,ZhangDanXiang,331121218,1266,384,990,909,1790,986,463,1112,2098,1123,2113
ɽ,FuShanXiang,331121219,3394,1047,2627,2152,4805,2520,1144,2769,5289,2958,5585
ʯϪ,ShiXiXiang,331121220,1950,467,1535,1129,2687,1512,734,1591,3103,1616,3151
,WuYunZhen,331122100,84835,9479,55973,42364,69943,52149,20130,53149,105298,58471,114444
,HuZhenZhen,331122101,57020,8682,39132,31013,63439,37860,13825,38462,76322,40395,79527
½,XinJianZhen,331122102,28043,6864,21731,18014,39830,21255,8886,21461,42716,22062,43793
,ShuHongZhen,331122103,10150,1966,7425,5805,12060,6941,2677,6837,13778,7368,14793
,DaYangZhen,331122105,5741,1381,4242,3808,8275,4232,1737,4607,8839,4617,8859
,DongDuZhen,331122106,16495,3712,12261,10354,21083,12148,4767,12430,24578,12713,24974
,DongFangZhen,331122107,11970,2656,8469,7336,15863,8242,2951,8583,16825,9108,17577
Դ,DaYuanZhen,331122108,5825,2317,4806,4692,9075,4725,1428,4626,9351,4764,9570
,QiLiXiang,331122203,8006,1887,5938,5254,10918,5916,2264,6050,11966,6219,12157
ǰ·,QianLuXiang,331122206,3290,940,2420,2204,4769,2415,749,2548,4963,2559,4979
Ϫ,SanXiXiang,331122207,2031,838,1720,1765,3368,1716,645,1785,3501,1794,3514
ܽ,RongJiangXiang,331122208,4150,1762,3537,3334,6624,3531,1059,3388,6919,3434,6971
˫Ϫ,ShuangXiKouXiang,331122209,3735,1370,3044,2827,5650,3021,938,2964,5985,2999,6043
Դ,HuYuanXiang,331122210,4148,1570,3391,3283,6517,3390,1114,3431,6821,3441,6832
Ϫ,FangXiXiang,331122211,1142,460,864,902,1745,862,228,959,1821,966,1830
ʯ,ShiJianXiang,331122212,1833,690,1464,1404,2755,1456,531,1586,3042,1590,3054
,MiaoGaoZhen,331123100,54395,6232,35671,25007,49088,33556,11072,33546,67102,36028,71699
Ʒ,YunFengZhen,331123101,11606,2282,7932,6446,14788,7856,2562,8355,16211,8518,16450
·,XinLuWanZhen,331123102,5387,1292,3829,3188,7510,3822,1139,3974,7796,3989,7818
,BeiJieZhen,331123103,4364,1104,3317,2601,6071,3251,1162,3212,6463,3313,6630
,JinZhuZhen,331123104,6362,1703,4653,3826,9258,4646,1622,5016,9662,5034,9687
,DaZheZhen,331123105,9193,1700,6139,4197,11444,6125,1840,6448,12573,6594,12733
ʯ,ShiLianZhen,331123106,7296,1361,5051,3476,9075,5016,1642,5198,10214,5248,10299
,WangCunKouZhen,331123107,4272,1090,3040,2478,5891,3029,948,3244,6273,3270,6310
ɳ,HuangShaYaoZhen,331123108,2982,819,2126,1840,4223,2105,641,2223,4328,2316,4442
,SanRenSheZuXiang,331123200,5114,989,3456,2459,6585,3441,976,3592,7033,3623,7079
,LianZhuXiang,331123201,1505,512,1078,968,2058,1033,250,1096,2129,1189,2267
Ӧ,YingCunXiang,331123202,3699,1042,2830,2281,5390,2773,1038,2883,5656,2949,5779
ƺ,GaoPingXiang,331123203,2474,626,1856,1580,3651,1856,795,2037,3893,2039,3895
ɽ,HuShanXiang,331123204,4599,1141,3258,2649,6332,3229,1115,3511,6740,3597,6855
Դ,CaiYuanXiang,331123205,1324,416,977,841,1794,959,277,1021,1980,1040,2017
̲,JiaoTanXiang,331123206,1476,372,1034,780,1939,992,300,1033,2025,1114,2148
,LongYangXiang,331123207,1966,454,1357,1104,2663,1332,427,1451,2783,1490,2847
᷿,ZheDaiKouXiang,331123208,2967,762,2075,1894,4190,2046,633,2228,4274,2287,4362
,XiFanXiang,331123209,1554,469,1164,981,2267,1145,423,1244,2389,1282,2446
,AnKouXiang,331123210,3036,732,2081,1595,4125,2037,634,2245,4282,2321,4402
,XiPingZhen,331124100,49467,5754,32936,24163,45804,31221,10800,31229,62450,33085,66021
,GuShiZhen,331124101,14599,2427,10019,7615,15328,9704,3203,9926,19630,10210,20229
,YuYanZhen,331124102,6100,1141,4464,3537,8228,4443,1972,4704,9147,4749,9213
Ϫ,XiangXiZhen,331124103,5954,1542,4276,3648,8344,4252,1269,4397,8649,4489,8765
󶫰,DaDongBaZhen,331124104,6494,1669,4860,4084,9523,4843,1798,5036,9879,5101,9961
,WangSongXiang,331124200,6258,1016,4102,3416,7270,4090,1345,4351,8441,4517,8619
Ҷ,YeCunXiang,331124201,4558,762,2934,2402,5372,2828,933,3030,5858,3319,6253
ի̳,ZhaiTanXiang,331124202,4376,811,2955,2570,5742,2949,947,3170,6119,3179,6134
,SanDouXiang,331124203,1582,599,1218,1137,2431,1218,315,1277,2495,1278,2496
Դ,ZhuYuanXiang,331124204,1111,492,949,927,1883,949,363,1016,1965,1017,1966
Ķ,SiDouXiang,331124205,705,276,561,543,1132,560,184,601,1161,604,1165
,ChiShouXiang,331124206,5899,1152,4025,3407,7526,4006,1284,4202,8208,4310,8335
,XinXingXiang,331124207,5885,1014,3960,3034,7406,3955,1272,4181,8136,4211,8171
Ϫ,ZhangXiXiang,331124208,5065,988,3531,2918,6910,3531,1178,3699,7230,3700,7231
л,XieCunXiang,331124209,2359,402,1593,1277,3212,1593,692,1860,3453,1860,3453
´,XinChuXiang,331124210,2060,560,1551,1248,3167,1550,687,1755,3305,1756,3307
ƺ,FengPingXiang,331124211,3664,748,2564,1993,5032,2521,910,2699,5220,2758,5322
,BanQiaoSheZuXiang,331124212,1781,609,1342,1121,2671,1326,409,1421,2747,1457,2799
ԣϪ,YuXiXiang,331124213,2424,703,1708,1470,3409,1701,529,1925,3626,1948,3656
,AnMinXiang,331124214,1291,332,922,809,1831,916,332,1017,1933,1033,1955
ƺ,YunHeZhen,331125100,60364,6219,38740,24618,42925,37190,12898,37975,75165,40741,79481
ʯ,ShiTangZhen,331125101,2963,726,1833,1550,3628,1760,457,2148,3908,2313,4146
ˮ̲,JinShuiTanZhen,331125102,1034,380,690,707,1461,690,148,872,1562,872,1562
ͷ,ChongTouZhen,331125103,4433,914,2991,2042,5842,2982,986,3324,6306,3342,6333
Ϫ,WuXiSheZuXiang,331125201,836,199,531,420,1109,531,138,642,1173,642,1173
Ϫ,AnXiSheZuXiang,331125202,1143,287,783,572,1520,783,212,859,1642,859,1642
̳,YunTanXiang,331125203,2170,521,1411,1074,2862,1405,372,1647,3052,1652,3063
,ZhuCunXiang,331125204,2742,748,1916,1567,3841,1905,632,2198,4103,2206,4122
Դ,DaYuanXiang,331125205,552,356,431,474,925,431,62,539,970,539,970
ʯ,ChiShiXiang,331125206,1464,530,1023,963,2083,1022,245,1211,2233,1216,2239
Դ,HuangYuanXiang,331125207,2292,468,1566,1096,3045,1545,563,1728,3273,1757,3323
,DaWanXiang,331125208,670,140,452,330,873,441,153,497,938,511,963
ɳ,ShaPuXiang,331125209,780,207,564,436,1123,564,206,629,1193,629,1193
Ʒ,YunFengXiang,331125210,985,248,648,556,1297,648,148,733,1381,733,1381
Դ,SongYuanZhen,331126100,53891,5119,37280,23544,42322,35459,15083,34941,70400,36813,74093
,HuangTianZhen,331126101,7642,1448,5297,4262,9663,5216,1982,5601,10817,5775,11072
,ZhuKouZhen,331126102,6117,796,3822,2587,6559,3546,1422,3738,7284,4513,8335
,PingDouZhen,331126103,6215,934,4424,3313,7274,4387,1823,4456,8843,4548,8972
ɵ,HeDiZhen,331126104,2439,649,1797,1565,3412,1729,614,1755,3484,1905,3702
Ϫ,ZuoXiZhen,331126105,1469,406,956,910,1850,908,198,957,1865,1117,2073
,XianLiangZhen,331126106,971,326,731,661,1360,703,185,701,1404,751,1482
ͷ,LingTouXiang,331126200,1716,565,1232,1155,2432,1220,288,1322,2542,1337,2569
,WuDaBaoXiang,331126201,2745,694,1943,1658,3779,1890,626,1973,3863,2122,4065
,YuShangXiang,331126202,3423,646,2495,1893,4724,2482,1081,2597,5079,2655,5150
,AnNanXiang,331126203,3153,524,2193,1681,4213,2164,913,2326,4490,2397,4590
Ŵ,ZhangCunXiang,331126204,1246,371,882,837,1772,872,203,912,1784,938,1820
¡,LongGongXiang,331126205,3237,571,2349,1646,4445,2327,1037,2453,4780,2496,4845
ˮ,JuShuiXiang,331126206,1255,361,890,859,1711,884,205,926,1810,931,1821
,JiangGenXiang,331126207,1243,398,930,832,1779,914,247,930,1844,958,1888
Ϻ,HeHuXiang,331126208,1073,340,729,758,1473,718,144,801,1519,828,1557
Ϫ,LongXiXiang,331126209,554,229,413,446,805,413,87,457,870,457,870
ɽ,BaiShanZuXiang,331126210,712,199,423,431,792,405,54,466,871,542,965
,GuanTangXiang,331126211,707,202,510,428,948,499,130,510,1009,529,1039
ɽ,SiShanXiang,331126212,455,148,297,311,613,297,30,336,633,336,633
Ϫ,HeXiZhen,331127100,42162,4475,29242,19240,31298,27979,12036,27787,55766,29431,58673
,BoHaiZhen,331127101,1195,497,759,820,1700,733,148,1038,1771,1081,1840
,DongKengZhen,331127102,3978,901,2543,1851,4917,2379,844,2727,5106,3180,5723
Ӣ,YingChuanZhen,331127103,2382,1028,1738,1765,3422,1704,326,1911,3615,1998,3736
ɳ,ShaWanZhen,331127104,3909,1258,2819,2481,5485,2769,820,2995,5764,3168,5987
,DaJunXiang,331127201,1460,333,979,795,2026,977,309,1117,2094,1123,2102
,ChengZhaoXiang,331127202,2777,651,1824,1354,3551,1784,551,1995,3779,2155,3979
÷,MeiQiXiang,331127203,780,316,528,535,1157,519,136,678,1197,704,1232
֣,ZhengKengXiang,331127205,1047,285,724,546,1495,714,287,875,1589,895,1619
T,DaJiXiang,331127208,1472,302,995,754,1928,975,355,1081,2056,1134,2129
,JingNanXiang,331127209,1906,398,1253,964,2567,1239,385,1386,2625,1436,2689
Ϫ,YanXiXiang,331127210,663,335,483,514,1056,480,109,612,1092,624,1107
ɽ,GeShanXiang,331127211,528,360,431,490,939,431,66,523,954,523,954
,LuCiXiang,331127212,1309,441,962,835,1838,931,248,962,1893,1036,1998
ͩ,WuTongXiang,331127213,1842,452,1369,1066,2597,1345,487,1376,2721,1412,2781
Ϫ,BiaoXiXiang,331127214,1077,321,807,715,1544,789,277,838,1627,868,1675
ë,MaoYangXiang,331127215,1074,265,758,594,1362,731,213,740,1471,794,1552
¯,QiuLuXiang,331127216,825,307,581,526,1179,567,114,628,1195,665,1246
,DaDiXiang,331127217,1213,425,865,760,1829,862,267,1036,1898,1040,1905
ҵ,JiaDiXiang,331127218,586,189,356,360,745,343,56,434,777,475,831
,JiuLongXiang,331127219,2188,644,1448,1390,2975,1420,516,1783,3203,1900,3348
Ԩֵ,LongYuanJieDao,331181001,31006,3333,21124,13530,20589,19931,7580,19616,39547,20795,41919
ֵֽ,XiJieJieDao,331181002,15797,2686,11141,7779,13308,11076,3771,10998,22074,11113,22254
ؽֵ,JianChiJieDao,331181003,34177,2734,22481,14534,17628,21268,8815,21588,42856,23245,45726
˶,BaDouZhen,331181100,13707,2573,9669,6039,17697,9442,3597,9898,19340,10208,19877
ψ,ShangYangZhen,331181101,8039,1531,5656,3931,11132,5650,2133,6019,11669,6047,11703
С÷,XiaoMeiZhen,331181102,5888,1040,4133,2841,7833,4091,1631,4312,8403,4426,8559
,ChaTianZhen,331181103,7360,1419,5244,3757,9731,5166,2011,5268,10434,5546,10790
,AnRenZhen,331181104,10129,1881,6989,5130,12242,6943,2659,7590,14533,7680,14669
Ϫ,JinXiZhen,331181105,5115,1172,3545,2505,7040,3516,1185,3800,7316,3927,7472
ס,ZhuLongZhen,331181106,3138,615,2150,1525,4089,2106,745,2244,4350,2348,4498
,PingNanZhen,331181107,1813,767,1324,1346,2731,1320,291,1540,2860,1547,2871
,LanJuXiang,331181200,6366,1476,4482,3329,8719,4439,1554,4772,9211,4914,9396
Qʯ,DaShiXiang,331181201,3591,780,2436,1814,4411,2392,850,2587,4979,2785,5221
Ϫ,BaoXiXiang,331181202,2887,689,2082,1586,4104,2064,749,2215,4279,2243,4325
,ZhuYangSheZuXiang,331181203,3652,812,2504,1648,5055,2493,861,2805,5298,2821,5325
̫,DaoTaiXiang,331181204,4179,1157,2941,2449,5972,2908,924,3269,6177,3319,6260
,YanZhangXiang,331181205,1294,371,888,755,1811,865,259,1010,1875,1036,1924
Ǳ,ChengBeiXiang,331181206,3423,1162,2507,2192,5180,2481,777,2815,5296,2855,5362
,LongNanXiang,331181207,4235,1396,3078,2720,6277,3053,844,3373,6426,3397,6475
·ֵ,MingGuangLuJieDao,340102001,17710,2116,10626,8502,14379,10186,2438,10561,20747,11638,22264
վֵ,CheZhanJieDao,340102002,19221,1935,11551,8879,12929,10691,2830,11056,21747,12435,23986
ʤ·ֵ,ShengLiLuJieDao,340102003,13089,1890,8331,6260,9305,7273,1493,7217,14490,8141,16472
ֵֽ,SanLiJieJieDao,340102004,44189,5456,27224,21880,34285,25682,5893,25900,51582,28314,55538
ͭ·ֵ,TongLingLuJieDao,340102005,46040,5421,29209,22227,34942,28114,7854,28841,56955,30106,59315
վֵ,QiLiZhanJieDao,340102006,37375,4066,23948,17750,25879,22747,7226,23620,46367,24719,48667
ֵ,HongGuangJieDao,340102007,37660,5820,23461,18820,37729,22718,5964,24252,46970,25983,49444
ƽ·ֵ,HePingLuJieDao,340102008,22618,4101,14945,11903,21017,14652,3360,14726,29378,15134,30079
ͨ·ֵ,DaTongLuJieDao,340102009,23293,3088,15162,11689,20295,14637,4008,14271,28908,15227,30389
Ƕֵ,ChengDongJieDao,340102010,37902,3045,24073,18097,23867,23716,7969,24208,47924,24843,48916
ֵ´,ChangHuaiJieDaoBanShiChu,340102011,53782,3781,32984,23503,30254,31068,9030,31053,62121,33609,66593
ֵ´,FangMiaoJieDaoBanShiChu,340102012,45756,2231,28100,19388,24478,26963,9591,27215,54178,29478,57578
ֵ´,QiLiTangJieDaoBanShiChu,340102013,99730,5156,58617,41716,47001,54033,19652,57193,111226,65921,124538
,DaXingZhen,340102100,29591,2741,18119,12689,18979,17704,5867,18579,36283,20080,38199
ĥ,MoDianXiang,340102200,43781,3213,23728,10807,26644,12595,4373,14554,27149,27639,51367
ҵ԰,YaoHaiQuGongYeYuan,340102400,29748,2528,17955,12816,23393,16937,6233,18582,35519,20554,38509
ϷۺϾÿ,HeFeiLongGangZongHeJingJiKaiFaQu,340102401,76329,3158,46553,34097,29216,45670,19681,50449,96119,52615,99168
·ֵ,BoZhouLuJieDao,340103001,50967,4699,32366,22640,37064,30472,8905,30058,60530,32205,64571
˫ڽֵ,ShuangGangJieDao,340103002,66316,7091,40977,30515,49394,38196,9149,38229,76425,41579,82556
ֵֽ,XingLinJieDao,340103003,38057,2678,23544,16219,25224,21446,7145,21451,42897,24336,47880
Ľֵ,HaiTangJieDao,340103004,26895,1815,17042,12215,15853,16513,5863,16660,33173,17531,34573
ӻֵ,XingHuaCunJieDao,340103005,59925,3880,34868,26685,31934,33071,11216,35993,69064,40153,75021
ңֵ,XiaoYaoJinJieDao,340103006,15413,2332,9659,6999,12605,8515,1766,8828,17343,9852,19511
¥ֵ,SanPaiLouJieDao,340103007,13509,2961,9193,6384,14848,8678,1966,8580,17258,9243,18436
Žֵ,XianQiaoJieDao,340103008,36228,3658,20033,9837,36288,12950,2934,12893,25843,22787,42820
ֵ,YiMinJieDao,340103009,36238,4762,21387,11017,38014,14873,3490,14351,29224,23103,44490
·ֵ,AnQingLuJieDao,340103010,31888,4555,19591,13237,31043,17953,4316,17335,35288,21168,40759
ֵ,GuangMingJieDao,340103011,22097,3233,14477,9883,22902,13572,3081,13046,26618,13934,28411
,DaYangZhen,340103100,48629,3495,29069,19645,34758,25856,8509,26897,52753,31564,60633
ʮ,SanShiGangXiang,340103200,10130,1327,6448,4422,12283,6268,1719,6413,12681,6728,13176
®ҵ,LuYangGongYeQu,340103400,29801,1855,16388,11228,16154,14413,4746,15486,29899,20014,36402
ֵֽ,SanLiAnJieDao,340104001,75030,7585,42482,22039,60478,25832,6640,26934,52766,46773,89255
ֵ,DaoXiangCunJieDao,340104002,43025,3718,22246,17011,20603,18226,4541,19868,38094,29038,51284
ֵ,HuPoJieDao,340104003,74831,5531,40559,19062,52253,24523,6900,24493,49016,46703,87262
ֵ߽,NanQiJieDao,340104004,52912,4670,32228,22640,32636,29159,8644,28855,58014,33998,66226
԰ֵ,XiYuanJieDao,340104005,50217,5571,31983,21308,43098,28850,9652,28874,57724,33457,65440
սֵ,WuLiDunJieDao,340104006,62902,4455,37101,24259,35571,29769,9490,31226,60995,39746,76847
Ҷؽֵ,HeYeDiJieDao,340104007,35553,2324,20240,13272,23506,18085,6225,18829,36914,23862,44102
ʼɽֵ,BiJiaShanJieDao,340104008,20975,1017,11664,8735,9953,11126,3271,11295,22421,13599,25263
,JingGangZhen,340104100,92605,5828,53919,33866,57149,43672,14463,45791,89463,58977,112896
ϸ,NanGangZhen,340104101,9755,1194,5509,4101,9182,5163,1645,5847,11010,7085,12594
ɽ²ҵ԰,ShuShanXinChanYeYuanQu,340104400,13258,821,7732,5554,8717,6851,2463,7366,14217,8810,16542
¼ҵ,GaoXinJiShuChanYeKaiFaQu,340104401,100765,6056,55005,29365,67183,36365,11902,39046,75411,63718,118723
ίԱ,LianHuaSheQuGuanLiWeiYuanHui,340104402,55947,1199,31905,14515,23357,17813,6970,19037,36850,32211,64116
ܽίԱ,FuRongSheQuGuanLiWeiYuanHui,340104403,44441,734,20364,8346,19938,10400,4043,10986,21386,28854,49218
ίԱ,JinXiuSheQuGuanLiWeiYuanHui,340104404,62441,1277,28192,9673,24187,12340,4602,13761,26101,40128,68320
ίԱ,HaiHengSheQuGuanLiWeiYuanHui,340104405,42205,1254,22605,11316,16142,13942,5197,15353,29295,26051,48656
ٺί,LinHuSheQuGuanLiGuanWeiHui,340104406,22269,1021,10924,5693,10149,6144,2287,7605,13749,14653,25577
ڽֵ,LuoGangJieDao,340111001,63028,4181,31213,20901,32205,26999,8746,29251,56250,44742,75955
ֵ,ChangQingJieDao,340111002,86398,5546,47791,37370,40120,42987,13631,48066,91053,57784,105575
ߺ·ֵ,WuHuLuJieDao,340111003,107137,12834,63863,47038,80386,56764,13159,56458,113222,69267,133130
ֵ,BaoGongJieDao,340111004,85892,9228,48079,31329,62109,39915,10002,39221,79136,57043,105122
ֵ,WangHuJieDao,340111005,146302,8651,83456,58059,62205,75669,24971,78612,154281,96468,179924
ǽֵ,YiChengJieDao,340111006,23618,2925,14304,10731,27127,13839,3786,14205,28044,16025,30329
̶սֵ,YanDunJieDao,340111007,73119,4631,33125,26434,46309,29295,10325,34220,63515,54950,88075
Ǻ,FeiHeZhen,340111100,64284,3378,35751,23749,29677,30052,10903,34096,64148,42814,78565
,DaWeiZhen,340111102,15362,2610,9855,7915,17730,9755,3039,10859,20614,11156,21011
ˮ,ShuiHuZhen,340121100,80742,9515,53861,39844,92577,52651,18061,52319,104970,54457,108318
ׯĹ,ZhuangMuZhen,340121101,12756,2143,9275,6645,16956,9201,3918,9380,18581,9542,18817
,YangMiaoZhen,340121102,20705,3324,14523,10685,27205,14329,5335,14416,28745,14841,29364
ɽ,WuShanZhen,340121103,24000,3773,16103,13256,30467,15981,4955,16325,32306,16625,32728
ڼ,GangJiZhen,340121104,38623,5047,24480,17387,44724,23630,7290,24835,48465,26480,50960
˫,ShuangDunZhen,340121105,57398,7590,38132,24344,62635,34418,11110,35139,69557,37966,76098
,XiaTangZhen,340121106,46443,8344,32211,24625,60043,31515,9886,31374,62889,32462,64673
,ZhuXiangZhen,340121107,21830,4183,15489,11173,28307,14914,6163,15072,29986,16687,32176
ʮͷ,SanShiTouZhen,340121108,32234,3844,19973,12397,29798,17394,5730,18096,35490,21835,41808
,LuoTangXiang,340121200,30684,5683,22062,17063,42256,21985,8669,22846,44831,22974,45036
微,YiJingXiang,340121201,21458,3675,15064,11361,29399,14998,5862,15757,30755,15931,30995
¥,TaoLouXiang,340121202,12543,2407,8771,7005,16749,8755,2780,8921,17676,8959,17730
,ZaoJiaXiang,340121203,15506,3389,11048,7630,20744,11020,3540,11264,22284,11387,22435
,ZuoDianXiang,340121204,12789,2708,9557,6944,17759,9463,4143,9935,19398,10083,19640
ż,DuJiXiang,340121205,26375,5824,19990,12279,37027,19830,8414,20217,40047,20623,40613
˫￪,ShuangFengKaiFaQu,340121400,33648,1505,17990,10145,13574,12766,4799,13702,26468,21962,39952
겺,DianBuZhen,340122100,167622,17987,109890,71602,154015,103581,40199,105758,209339,115918,225808
,CuoZhenZhen,340122101,66931,9562,40843,26559,66539,37802,11120,37723,75525,46770,87613
԰,LiangYuanZhen,340122102,37477,8045,27693,18254,51388,26035,10609,26291,52326,28438,56131
ͷ,QiaoTouJiZhen,340122103,23411,5817,17719,12854,30869,17069,5219,15939,33008,16728,34447
ٺ,ChangLinHeZhen,340122104,17335,6685,15060,11872,26788,14476,4686,12583,27059,13646,28706
ʯ,ShiTangZhen,340122105,26000,7155,21634,15593,38752,21376,8201,19461,40837,19722,41356
ų,GuChengZhen,340122106,27524,6759,21833,15256,41765,21367,10356,21971,43338,22806,44639
˶,BaDouZhen,340122107,30506,7069,23436,14853,44644,23128,10474,24073,47201,24613,48049
Ԫ,YuanTuanZhen,340122108,12420,3000,9118,6547,16929,8953,3143,9128,18081,9445,18563
,BaiLongZhen,340122109,33168,7252,24283,15226,45534,23711,8954,23852,47563,25091,49374
,BaoGongZhen,340122110,23487,6448,19938,13813,36279,19644,8954,18383,38027,18951,38889
,ZhongXingXiang,340122200,11266,2490,8359,5305,15669,7981,2915,7925,15906,8312,16671
ż,ZhangJiXiang,340122201,14063,3229,10518,6683,20598,10432,4301,10909,21341,11075,21593
,MaHuXiang,340122202,10145,2716,8358,5936,15782,8306,4281,8669,16975,8784,17142
¼,ChenJiXiang,340122203,11580,2677,8679,6320,16766,8617,4142,9606,18223,9720,18399
쵼,XiangDaoXiang,340122204,14802,3083,10889,7972,21866,10802,5490,12265,23067,12486,23375
,YangDianXiang,340122205,14332,3352,10381,7750,20441,10264,4001,11132,21396,11304,21685
Ʒ,PaiFangHuiZuManZuXiang,340122206,20539,4235,14002,10515,25394,13265,4974,14146,27411,15746,29748
ʶ³ǿ,FeiDongXinChengKaiFaQu,340122401,21911,1513,14001,8677,11388,11904,5048,12657,24561,14471,28472
Ϸѭʾ԰,HeFeiXunHuanJingJiShiFanYuan,340122402,8228,1569,5426,4213,10753,5408,1503,5797,11205,5874,11300
,ShangPaiZhen,340123100,129948,12905,85611,57555,119330,79783,28576,80905,160688,85818,171429
,SanHeZhen,340123101,33106,5686,21810,18330,40492,20793,6814,22858,43651,23796,45606
,GaoLiuZhen,340123102,36887,5744,24441,17508,48022,24146,8351,25738,49884,26541,50982
ͤ,GuanTingZhen,340123103,44416,7961,30594,23108,59109,29513,10588,30952,60465,32371,62965
С,XiaoMiaoZhen,340123104,47438,6990,29891,22059,56412,28899,8455,31830,60729,32992,62883
ɽ,ShanNanZhen,340123105,47371,6576,30043,19989,60317,29399,9380,32452,61851,33284,63327
,HuaGangZhen,340123106,45172,8418,30540,24819,58877,29553,10655,32130,61683,33705,64245
,ZiPengZhen,340123107,22468,3177,14315,10361,23837,12697,3855,13823,26520,15185,29500
һ,TaoHuaZhen,340123108,63631,2341,31797,13321,21873,16906,5666,18219,35125,39841,71638
,FengLeZhen,340123109,27075,4693,18767,12637,35393,18538,6302,19000,37538,19303,38070
ߵ,GaoDianXiang,340123200,22093,3463,15197,10109,29951,14926,5428,15591,30517,15787,30984
,MingChuanXiang,340123201,23064,3449,15113,9207,29830,14972,4507,15608,30580,15907,31020
,ShiShuGangXiang,340123202,28115,4542,19548,13069,36641,19381,6157,19090,38471,19266,38814
ϵ,YanDianXiang,340123203,20921,4063,14859,11232,28911,14644,5356,15253,29897,15481,30340
һҵ԰ί,TaoHuaGongYeYuanGuanWeiHui,340123400,37915,807,22170,8697,5386,10769,3793,11898,22667,20345,42515
ɽί,ZiPengShanGuanWeiHui,340123401,20400,1857,12968,5576,14763,7812,2320,7963,15775,11609,24577
·ֵ,BeiJingLuJieDao,340202001,39591,7411,25596,19730,39582,24667,4444,24047,48714,25850,51446
´ֵ,ZheLuJieDao,340202002,43888,6355,27394,19781,35953,26850,6049,27275,54125,28898,56292
ֵ,JingHuJieDao,340202003,27117,4538,17031,13320,26940,16107,2772,15968,32075,17396,34427
ͽֵ,JiHeJieDao,340202004,34897,5177,21389,16387,33340,20720,3916,20474,41194,22601,43990
ɽֵ,ZheShanJieDao,340202005,53251,8998,34651,21637,53072,28791,5444,27706,56497,33042,67693
߮ɽֵ,YiJiShanJieDao,340202006,40400,6810,24581,19781,36566,23805,4794,24538,48343,27423,52004
͡Ľֵ,TingTangJieDao,340202007,31270,3774,20188,15290,28197,19950,5304,19902,39852,20160,40348
ɽֵ,TianMenShanJieDao,340202008,51647,7033,31704,24406,43981,30775,7212,31923,62698,34188,65892
Žֵ,BeiMenJieDao,340202009,32493,5139,18675,14571,33663,16128,2553,17236,33364,21510,40185
Žֵ,DongMenJieDao,340202010,32052,5188,19384,15386,25826,17705,3275,18460,36165,21131,40515
ɽֵ,JingShanJieDao,340202011,7184,1108,4546,3656,8369,4484,1158,4809,9293,4904,9450
ֵ,FangCunJieDao,340202012,22527,3862,14630,12041,28941,14485,4699,16158,30643,16458,31088
߮Žֵ,YiJiangQiaoJieDao,340203001,27083,3469,17487,12903,17900,17079,3545,15940,33019,16610,34097
ɽ·ֵ,ZhongShanNanLuJieDao,340203002,18088,1814,11157,9237,10849,10590,2431,10851,21441,11176,22333
·ֵ,LiMinLuJieDao,340203003,16639,1807,10472,7789,11215,10278,2096,9690,19968,10070,20542
ֵ,MaTangJieDao,340203004,26655,3075,15460,11468,18451,14953,3727,15915,30868,17997,33457
Z۽ֵ,LuGangJieDao,340203005,83170,2648,44079,14599,39237,16108,4102,18230,34338,45841,89920
𵳹ί(ԭֵ´ѳ),NanRuiDangGongWei(YuanNanRuiJieDaoBanShiChuYiCheXiao),340203098,29646,3265,18944,12921,19675,18796,5278,18866,37662,19245,38189
,HuoLongGangZhen,340203100,53759,6931,33646,23148,63638,32897,10286,35628,68525,37330,70976
ĺɽֵ,SiHeShanJieDao,340207001,23454,3077,14132,10590,19194,13837,2746,13197,27034,15145,29277
ԣϪڽֵ,YuXiKouJieDao,340207002,3114,1269,2423,2479,3618,2414,187,2073,4487,2147,4570
ٶֵ,GuanDouJieDao,340207003,66109,5361,35873,21727,45725,30048,7695,28203,58251,43292,79165
ֵ,WanLiJieDao,340207004,43735,3185,23314,14068,22501,18915,4636,19068,37983,28242,51556
ˮֵ,QingShuiJieDao,340207005,27931,3968,17908,12733,30885,17238,4565,17533,34771,18556,36464
ɽֵ´,LongShanJieDaoBanShiChu,340207006,77980,3501,35621,19861,37840,25176,7218,26431,51607,53078,88699
򴺽ֵ´,WanChunJieDaoBanShiChu,340207007,19125,3378,11168,10605,23201,10905,3037,13169,24074,14372,25540
ߺü�,WuHuJingJiJiShuKaiFaQu,340207400,3799,333,2083,1712,1948,1954,417,2176,4130,2466,4549
ɽֵ,SanShanJieDao,340208001,23080,3079,14740,10931,25071,14321,4280,14695,29016,15699,30439
ֵ,BaoDingJieDao,340208002,19963,3696,13488,10521,25649,13359,3953,13258,26617,14124,27612
ֵ,LongHuJieDao,340208003,17033,2578,11094,8188,20628,10985,3461,11614,22599,11978,23072
ֵ߰,GaoAnJieDao,340208004,16889,2912,11657,7936,23055,11610,3933,11973,23583,12077,23734
,EQiaoZhen,340208100,29210,4800,18566,13614,36126,18395,5511,19764,38159,20955,39521
b,WanZhiZhen,340221100,95474,11006,61706,44041,93417,58098,16820,56491,114589,61594,123300
,LiuLangZhen,340221101,51318,8663,33266,25164,64063,32338,9983,35294,67632,36698,69964
,TaoXinZhen,340221102,27086,5185,18594,14616,36617,18439,6190,19563,38002,19867,38461
,HongYangZhen,340221104,22405,5614,17043,13900,32869,16901,6178,16943,33844,17154,34197
,HuaQiaoZhen,340221105,19321,3967,14046,10249,25912,13823,4829,13480,27303,14071,28117
,FanYangZhen,340222100,77429,9914,50379,38886,87030,49598,13932,49026,98624,50896,101275
ݶ,DiGangZhen,340222101,26586,4249,17105,14288,29761,16836,4310,16958,33794,18040,35145
,SunCunZhen,340222102,41374,5437,26346,18476,48174,24164,7407,25513,49677,27872,54218
ƽ,PingPuZhen,340222103,19679,3009,12687,8516,25559,12646,3604,13511,26157,13605,26292
¸,XinGangZhen,340222104,14463,2106,8656,6087,16499,8339,2455,8881,17220,10368,19024
ɽ,EShanZhen,340222105,16970,2410,10691,7651,18921,10147,2430,10438,20585,11119,21810
ɽ,JiShanZhen,340223100,102671,13637,70164,46292,119060,62436,22332,60920,123356,68476,138640
,XuZhenZhen,340223101,51677,10439,38546,27486,72810,36832,14932,35519,72351,38502,77048
߮,YiJiangZhen,340223102,45835,9989,35003,26343,65576,34763,11886,32365,67128,32707,67710
,SanLiZhen,340223103,19152,4206,14096,11147,26826,13695,5158,13535,27230,14420,28516
,HeWanZhen,340223104,14550,3954,11534,9652,22401,11379,4702,11240,22619,11672,23206
ɽ,GongShanZhen,340223105,23137,5483,17296,13098,33310,16494,6504,16149,32643,17828,35124
̶,YanDunZhen,340223106,7541,1749,5952,4551,11311,5582,2480,5336,10918,5818,11770
ҷ,JiaFaZhen,340223107,15596,3056,11187,7908,20342,10334,3612,10024,20358,11077,22264
ֵ,DongFengJieDao,340302001,14601,2481,9844,7590,14503,9779,2155,9383,19162,9393,19237
Ӱֵ,YanAnJieDao,340302002,10909,2399,7651,5806,11471,7615,1574,7027,14642,7231,14882
λֵ,ZhiHuaiJieDao,340302003,16424,3098,11584,8801,14800,11221,2569,10308,21529,10507,22091
ֵ,DongShengJieDao,340302004,29272,4488,19331,14002,27838,18947,4469,18097,37044,18898,38229
Žֵ,JieFangJieDao,340302005,39240,5921,25628,20493,36265,25159,6455,25585,50744,25988,51616
ɽֵ,CaoShanJieDao,340302006,24497,3564,15832,11842,21128,15623,4490,16264,31887,16719,32551
,ChangHuaiWeiZhen,340302100,33449,4274,21009,13518,40056,20988,7372,21915,42903,24086,45095
¥,LiLouXiang,340302200,14289,1832,9177,5532,17848,8979,3301,9637,18616,10245,19422
Žֵ,TianQiaoJieDao,340303001,7377,1223,5017,4004,7611,4977,1061,4597,9574,4644,9661
ֵ,QingNianJieDao,340303002,15925,2496,10768,8904,15365,10628,2037,9569,20197,9690,20458
γ·ֵ,WeiErLuJieDao,340303003,15041,2256,9766,7976,14377,9749,1894,9383,19132,9425,19191
ׯֵ,HuangZhuangJieDao,340303004,27606,3849,17584,13605,25021,17311,4007,17487,34798,17878,35462
ҵֵ,HongYeCunJieDao,340303005,16842,2944,11029,8533,16974,10826,2327,10818,21644,11084,22113
ʤֵ,ShengLiJieDao,340303006,26513,4599,17777,15197,24033,17481,4075,17068,34549,17410,35187
ֵ,LongHuJieDao,340303007,17768,1703,11169,5840,12787,7400,1894,7346,14746,10196,21365
,HuBinSheQuXingZhengShiWuGuanLiZhongXin,340303008,57819,2419,32196,11161,32656,15751,4994,16068,31819,33036,65232
,HuaiHeSheQuXingZhengShiWuGuanLiZhongXin,340303009,35722,3118,23872,16694,25555,23595,8701,23239,46834,23669,47541
ɽ,YanShanXiang,340303200,26562,3117,16842,10768,29424,16043,6116,16946,32989,18953,35795
ѩ,XueHuaXiang,340303201,16758,1609,10916,7625,8492,10806,4054,11291,22097,11505,22421
ֵ,ZhaoYangJieDao,340304001,12532,2366,8460,6174,13506,8311,2031,8335,16646,8469,16929
γĽֵ,WeiSiJieDao,340304002,27289,4498,17998,13108,29459,17988,4386,18146,36134,18175,36173
ֵ,DaQingJieDao,340304003,32212,5177,20617,15285,34479,20473,5488,20803,41276,22260,42877
Źɽֵ,ZhangGongShanJieDao,340304004,36764,5978,24374,17774,37781,24249,6008,23833,48082,24376,48750
ֵ̨,DiaoYuTaiJieDao,340304005,13138,1397,8119,5137,11120,6884,2192,6502,13386,8608,16727
ؼ,QinJiZhen,340304100,31575,4257,21471,13634,41643,21428,9031,23260,44688,23392,44863
,ChangQingXiang,340304200,22188,2453,14757,10154,20400,14710,5593,15265,29975,15477,30234
¼�,GaoXinJiShuKaiFaQu,340304400,9512,797,6370,4339,7330,6287,2499,6053,12340,6438,12808
ֵ,HuaiBinJieDao,340311001,2346,388,1495,1133,2104,1487,365,1582,3069,1604,3099
С,XiaoBengBuZhen,340311100,36496,4177,24116,14659,45327,23931,7350,23632,47563,23907,48023
С,WuXiaoJieZhen,340311101,20800,2273,13550,7757,25322,12943,4381,13150,26093,13904,27454
ϼ,CaoLaoJiZhen,340311102,24568,4419,17756,11314,33882,17601,7398,18070,35671,18629,36385
÷,MeiQiaoXiang,340311200,20864,3537,15125,9950,29570,15106,6476,15693,30799,15752,30877
�ҵ԰,BengBuGongYeYuanQu,340311400,36,0,1,0,0,0,0,0,0,35,36
ǹ,ChengGuanZhen,340321100,121805,13794,81038,52705,132887,76852,29498,77940,154792,84059,165097
,BaoJiZhen,340321101,37164,7048,29730,17648,54718,29386,16583,30669,60055,31065,60795
,LongKangZhen,340321102,35054,5523,25611,17775,48749,25591,11421,26332,51923,26387,51998
,HeLiuZhen,340321103,35259,5849,25439,16789,49445,25421,10857,26449,51870,26526,51965
,ChangFenZhen,340321104,43800,7679,32316,22467,63189,32237,14583,33685,65922,33746,66062
,MaChengZhen,340321105,46810,6741,33596,19224,66122,33570,16172,36058,69628,36127,69723
˫ż,ShuangQiaoJiZhen,340321106,30778,4714,23172,14030,44540,23094,11897,24172,47266,24217,47389
κׯ,WeiZhuangZhen,340321107,19252,3632,15546,9194,28886,15542,8455,15747,31289,15793,31339
,WanFuZhen,340321108,26324,4536,20580,12355,37381,20580,10906,21185,41765,21186,41766
Ƽ,TangJiZhen,340321109,43283,6255,31188,19126,59595,31102,14346,32623,63725,32696,63884
,FeiNanXiang,340321200,23233,4597,17778,11401,35586,17720,9088,18957,36677,19140,36918
Ǻ,FeiHeXiang,340321201,29415,6417,24909,14989,45303,24896,14077,24901,49797,25000,49909
Ҽ,ChuJiXiang,340321202,24300,3718,19196,11043,34577,19191,9919,18717,37908,18741,37937
¼,ChenJiXiang,340321203,19455,3144,15403,8530,27240,15380,8138,15272,30652,15334,30737
ų,GuChengXiang,340321204,21668,4648,17072,11052,32676,17065,8665,17845,34910,17909,34981
,XuWeiXiang,340321205,23155,3836,17432,11589,33676,17425,8564,18055,35480,18123,35555
,LanQiaoXiang,340321206,21128,3593,15574,9525,30591,15573,7125,16270,31843,16272,31846
,JingQianXiang,340321207,29773,5566,22035,14654,42723,22031,9961,23217,45248,23265,45300
۫,ZhaoYingXiang,340321208,39745,6708,30218,19005,57700,30203,15023,31193,61396,31258,61476
ũ,LongKangNongChang,340321400,6770,1175,5007,3615,7317,5005,2120,5042,10047,5058,10065
ÿ,JingJiKaiFaQu,340321401,2199,382,1621,1156,2819,1564,743,1570,3134,1703,3324
ǹ,ChengGuanZhen,340322100,69840,9808,47710,33730,80566,46933,16592,47754,94687,48530,96240
¼,XinJiZhen,340322101,30513,5494,20969,11951,42842,20285,8069,22050,42335,23107,44076
ĭӿ,MoHeKouZhen,340322102,43627,6792,29767,17081,59017,29388,11379,31476,60864,32031,61798
СϪ,XiaoXiZhen,340322103,17860,2968,12180,7027,25089,12047,4594,12970,25017,13242,25422
˫,ShuangZhongMiaoZhen,340322104,30915,5305,22446,12261,45752,22144,9817,23099,45243,23591,46037
С,XiaoWeiZhen,340322105,26849,4027,18304,9982,37184,18266,7118,19534,37800,19690,37994
,DongLiuJiZhen,340322106,34570,5995,25177,14448,49470,24975,11048,26045,51020,26436,51613
ͷ,TouPuZhen,340322107,33751,5002,22868,12569,45665,22255,8779,23778,46033,24664,47532
,DaXinZhen,340322108,17607,2852,12071,6688,24226,11971,4451,12671,24642,12839,24910
,WuQiaoZhen,340322109,15393,3066,11602,6661,22884,11152,4919,11002,22154,11776,23378
춥,ZhuDingZhen,340322110,31426,4552,21001,11888,43349,20842,7749,22366,43208,22726,43727
,HuiNanZhen,340322111,30805,5578,21516,13823,43766,21510,8604,23417,44927,23471,44987
꼯,ShenJiZhen,340322112,26887,4922,19625,10869,39122,19564,7987,20134,39698,20171,39796
,DuoHuXiang,340322200,10170,1344,6629,4151,13435,6428,2169,6686,13114,7054,13683
ٱ,LinBeiHuiZuXiang,340322201,14410,2621,10159,6433,20619,10159,3749,10593,20752,10621,20780
ǹ,ChengGuanZhen,340323100,81113,9663,54619,33399,93497,50705,18536,50241,100946,54693,109312
ׯ,WangZhuangZhen,340323101,22719,3830,15726,8548,30912,15719,6255,17032,32751,17078,32804
,XinMaQiaoZhen,340323102,37902,4920,25310,13300,47630,23957,8564,25312,49269,26076,51386
,LianChengZhen,340323103,28181,4315,19059,10184,37690,18880,6357,19269,38149,19794,38853
,LiuJiZhen,340323104,33245,5639,23248,13490,45937,22130,8834,23128,45258,24470,47718
,RenQiaoZhen,340323105,33031,5376,22786,13096,44366,22438,7810,22825,45263,23431,46217
,HuGouZhen,340323106,37422,5781,24942,12922,50295,24415,8303,26244,50659,26564,51506
婳,HaoChengZhen,340323107,19009,2758,12830,6740,25803,12828,4808,13729,26557,13745,26575
ʯ,ShiHuXiang,340323200,18631,3240,12637,7570,25421,12441,4390,13147,25588,13624,26261
,YangMiaoXiang,340323201,43361,6236,28311,14582,57580,28287,10277,31461,59748,31563,59874
,ZhongXingXiang,340323202,35005,4949,23489,12787,47385,23238,8933,24872,48110,25398,48887
򿪷,GuZhenKaiFaQu,340323400,1791,174,1053,430,1598,818,286,863,1681,1198,2251
ֵͨ,DaTongJieDao,340402001,23341,3702,14984,11485,25528,14751,2935,14705,29456,14994,29978
Ҥ,ShangYaoZhen,340402100,21944,2547,14610,10066,27788,14575,5823,15565,30140,15704,30314
,LuoHeZhen,340402101,39027,3901,24981,17041,42169,24723,7283,24717,49440,25230,50211
,JiuLongGangZhen,340402102,21125,3642,14134,10494,23906,14038,3899,13844,27882,14532,28666
׵,KongDianXiang,340402200,29311,4321,20334,12604,39532,20287,8116,21026,41313,21414,41748
ﶫֵ,TianDongJieDao,340403001,31397,4392,20652,15363,29872,18385,4089,19030,37415,19226,39878
»ֵ,XinHuaiJieDao,340403002,15563,2217,10184,7249,14549,9862,2722,10091,19953,10318,20502
ֵ,GuoQingJieDao,340403003,49122,5370,30768,23422,44189,30598,8374,31336,61934,32098,62866
ֵ,HuaiBinJieDao,340403004,17633,2475,11118,10097,19438,11096,3022,12006,23102,12012,23130
ֵ,ZhaoYangJieDao,340403005,70600,5503,38611,26072,56167,33517,9211,33749,67266,46703,85314
԰ֵ,GongYuanJieDao,340403006,31791,2814,17493,12797,24152,15957,4773,16650,32607,21885,39378
ɽֵ,DongShanJieDao,340403007,30733,3641,19295,12509,28893,17094,4959,16763,33857,20038,39333
Ȫֵ,LongQuanJieDao,340403008,76781,8345,47147,27607,67263,37319,8840,36414,73733,46819,93966
Ȫɽֵ,QuanShanJieDao,340403009,16376,2237,10167,7706,16921,9851,2075,9853,19704,10521,20688
˴,ShunGengZhen,340403100,46407,3048,29210,18566,31851,28591,10364,29400,57991,30609,59819
,AnChengZhen,340403101,27638,2470,17282,9606,30277,16976,6562,18483,35459,19388,36670
,CaoAnZhen,340403102,18649,2618,12784,8288,24961,12774,5092,13503,26277,13575,26359
,SanHeXiang,340403200,23591,2574,15612,9712,28985,15540,6106,16249,31789,16659,32271
ʷԺ,ShiYuanXiang,340403201,9286,1716,6657,4728,13316,6637,2805,7074,13711,7150,13807
лҼֵ,XieJiaJiJieDao,340404001,39253,5095,24186,17739,42633,23966,4990,24487,48453,25152,49338
̼Ҹڽֵ,CaiJiaGangJieDao,340404002,21492,2689,13254,9515,22355,13161,2663,13224,26385,13590,26844
½ֵ,LiXinJieDao,340404003,14726,2379,9364,6935,15358,9089,1958,9158,18247,9699,19063
лֵ,XieSanCunJieDao,340404004,19746,3162,12643,8751,21671,12564,2812,12768,25332,13077,25720
ƽɽֵ,PingShanJieDao,340404005,17113,2169,10809,7300,17234,10728,2565,10846,21574,11038,21847
,WangFengGangZhen,340404100,39683,5946,25510,17424,44719,25167,6329,25590,50757,26448,51958
۫,LiYingZiZhen,340404101,35205,4680,22031,15207,42390,22019,5044,22884,44903,22898,44929
ɽ,TangShanZhen,340404102,19334,1986,12124,8178,20533,11773,3893,12293,24066,13089,25213
,YangGongZhen,340404103,17629,2806,12421,8460,24279,12086,5073,12647,24733,13087,25508
,SunMiaoXiang,340404200,11168,1892,7849,5458,15331,7814,2969,8036,15850,8180,16029
¶,GuDuiXiang,340404201,9803,1287,6659,4371,13338,6567,2712,6888,13455,7143,13802
ׯνֵ,XinZhuangZiJieDao,340405001,42023,5583,26079,20027,47422,25597,5550,26340,51937,27077,53156
νֵ,TuBaZiJieDao,340405002,23650,3227,15063,11287,22413,14997,3594,15136,30133,15408,30471
ϼҸڽֵ,BiJiaGangJieDao,340405003,15543,2016,9276,7392,16949,9162,1815,9444,18606,10098,19374
˹ɽ,BaGongShanZhen,340405100,17049,1878,10734,7090,7865,10652,3044,11009,21661,11237,21971
ɽ,ShanWangZhen,340405101,38228,5130,24289,17663,44610,24232,6162,25008,49240,25231,49520
ɽֳ,MiaoShanLinChang,340405400,1006,160,699,470,1328,699,335,802,1501,802,1501
Ｏֵ,TianJiJieDao,340406001,64926,4969,39225,24879,67592,37481,12178,38815,76296,42848,82073
߻,GaoHuangZhen,340406100,28833,4011,19078,12092,38478,18997,6822,20389,39386,20588,39666
ƽ,PingWeiZhen,340406101,22257,3092,14513,9041,28439,14412,5332,15584,29996,16168,30681
,NiHeZhen,340406102,31008,2847,19017,13859,31468,18883,5795,19937,38820,20633,39650
˼,PanJiZhen,340406103,30285,2851,16453,10293,30075,15808,5449,15978,31786,22132,38585
«,LuJiZhen,340406104,35945,3821,22659,16167,40798,22597,7977,24578,47175,25084,47743
й,JiaGouXiang,340406200,19224,2643,12711,7991,25424,12671,4710,13593,26264,13866,26577
,QiJiXiang,340406201,11684,1749,7890,5368,15772,7860,3087,8514,16374,8630,16520
Ź,GuGouHuiZuXiang,340406202,18028,2496,12012,7475,23979,11896,4691,12903,24799,13203,25215
ܺ,JiaHeXiang,340406203,16335,2426,10886,7198,21583,10733,3922,11559,22292,11797,22683
,HeTuanXiang,340406204,18366,2386,12617,8113,24537,12555,5539,13337,25892,13674,26291
ǹ,ChengGuanZhen,340421100,60803,6273,38800,26996,60785,36055,11617,36661,72716,39893,78693
¼,XinJiZhen,340421102,42663,4140,27472,17543,44887,27135,11625,30155,57290,30956,58428
,ZhuMaDianZhen,340421103,19993,3755,14953,9399,28484,14778,7325,15781,30559,16120,31073
ż,YueZhangJiZhen,340421104,43391,4421,25040,17856,43636,24375,9752,27048,51423,32524,57564
,GuQiaoZhen,340421105,21664,2491,13311,9000,24507,12938,5368,13868,26806,16212,29523
ë,MaoJiZhen,340421106,35035,4134,22793,15798,39067,22235,8966,24013,46248,25342,48135
ļ,XiaJiZhen,340421107,17081,2579,11257,7649,22146,11185,4198,12392,23577,12601,23858
,GuiJiZhen,340421108,27044,3886,18095,12112,34927,17949,7444,19697,37646,20279,38374
Ǳ,ChengBeiXiang,340421200,28571,3623,19075,12106,30204,18860,7902,20295,39155,21021,40096
,LiChongHuiZuXiang,340421201,10548,1324,7094,4167,13934,7076,2955,7686,14762,7733,14827
,LiuJiXiang,340421202,29483,3427,19039,11931,34882,18941,7324,20167,39108,21195,40234
ŵ,GuDianXiang,340421204,14994,2653,11012,7436,21110,10963,5286,11853,22816,11921,22933
Ǯ,QianMiaoXiang,340421205,20408,3399,14883,9879,28497,14877,6952,15839,30716,15876,30759
,YangCunXiang,340421206,15487,3157,11338,7355,22781,11284,5176,12191,23475,12482,23820
,ShangTangXiang,340421207,13650,3229,10532,6676,21320,10486,5202,11373,21859,11549,22081
,DingJiXiang,340421208,16581,2425,11925,7778,23208,11888,5588,12578,24466,12669,24594
ص,GuanDianXiang,340421209,15078,2099,10371,7340,18869,10313,4739,11357,21670,11545,21916
˼,DaXingJiXiang,340421210,20422,2529,14018,8031,27292,13987,6448,15315,29302,15381,29399
,JiaoGangXiang,340421211,20270,3857,14790,10471,29070,14736,6636,15768,30504,15973,30763
ׯֵ,JinJiaZhuangJieDao,340502001,30441,4651,19159,15307,31536,18789,4303,19345,38134,20236,39395
ֵ,TangXiJieDao,340502003,20559,2144,12177,9742,15145,11970,3216,13015,24985,13742,25919
Ⱥֵ,CiHuJieDao,340502004,11578,1459,6751,6195,11062,6637,1390,7295,13932,7676,14427
ֵ,JiangDongJieDao,340502005,13669,1326,8661,5892,6326,8605,2595,8423,17028,8929,17590
Ⱥ,CiHuXiang,340502200,20956,2204,13214,9821,17189,12989,3103,12387,25376,13049,26263
�ɽȺÿ,MaAnShanCiHuJingJiKaiFaQu,340502400,3686,301,2063,1896,2628,1968,423,2001,3969,2347,4410
ɳ·ֵ,ShaTangLuJieDao,340503001,36292,6825,25019,19565,37688,24726,5708,23535,48261,23806,48825
·ֵ,JieFangLuJieDao,340503002,52379,6599,33401,25909,47021,33178,8954,34286,67464,34531,67932
·ֵ,HuDongLuJieDao,340503003,38434,5444,22558,16329,31479,20018,4722,20340,40358,26042,48600
Դ·ֵ,TaoYuanLuJieDao,340503004,60472,6696,38224,29678,57536,37647,10186,38367,76014,39130,77354
ֵ,HuoLiJieDao,340503005,47425,5908,29757,21795,41026,29532,7811,30575,60107,31387,61144
ƽֵ,PingHuJieDao,340504001,29020,5651,19052,13328,29638,17370,4397,17234,34604,20016,39068
ɽֵ,YuShanJieDao,340504002,37144,8223,24887,18084,37848,23584,5535,23443,47027,26015,50902
ֵ,AnMinJieDao,340504003,46339,3513,27875,17828,40684,25360,7170,25950,51310,29147,57022
ʯֵ,CaiShiJieDao,340504004,5398,1163,3641,2681,5306,3590,825,3639,7229,3745,7386
ɽ,XiangShanZhen,340504100,45210,6663,24412,14421,43046,19535,4607,19732,39267,32068,56480
,YinTangZhen,340504101,16748,2446,10782,6585,19919,10622,3024,10922,21544,11436,22218
ɽ,JiaShanXiang,340504200,54976,4063,31486,19904,33058,28023,8369,29648,57671,35922,67408
�ɽü�,MaAnShanJingJiJiShuKaiFaQu,340504400,8576,204,5175,1067,1685,1386,408,1460,2846,4013,9188
,GuShuZhen,340521100,92456,11738,61572,41296,98168,60376,15449,56365,116741,58071,119643
Ƴ,HuangChiZhen,340521101,30415,5614,21031,14003,39993,20916,5572,20417,41333,20570,41601
Ϫ,WuXiZhen,340521102,16186,2708,10966,6903,20809,10886,3046,10846,21732,10974,21940
ʯ,ShiQiaoZhen,340521103,34491,5236,22528,14542,41484,21312,6139,21786,43098,23338,45866
,TangNanZhen,340521104,19136,3536,13054,8669,25647,12997,4121,13651,26648,13739,26793
,HuHeZhen,340521105,19553,3346,12921,9024,25637,12911,3942,13871,26782,13920,26841
̫,TaiBaiZhen,340521106,39125,5608,23852,15492,45936,23235,5965,24368,47603,26846,50698
,DanYangZhen,340521107,38567,5733,24455,15464,47474,23922,7182,25974,49896,27027,51482
,BoWangZhen,340521108,61387,8208,39278,23463,78663,38907,14185,44257,83164,44502,83780
,XinShiZhen,340521109,24956,3655,16468,9596,32582,16098,6015,17584,33682,18158,34626
¤,DaLongXiang,340521200,20248,3320,13202,8583,26891,13160,4572,14838,27998,14938,28140
궸,NianDouXiang,340521201,24775,3900,15607,11413,29396,15394,3540,16209,31603,16608,32215
,JiangXinXiang,340521202,15411,2764,9902,6823,19037,9632,2850,9923,19555,11123,21025
,HuYangXiang,340521203,19791,3198,12690,7777,25781,12651,3901,14162,26813,14200,26890
Ϳÿ,DangTuJingJiKaiFaQu,340521400,10656,1225,6050,3813,10173,5604,1350,5972,11576,7181,13231
ֵ´,GaoYueJieDaoBanShiChu,340602001,59364,7236,39267,22613,67930,36685,11718,36199,72884,39051,78318
ɽֵ´,KuangShanJiJieDaoBanShiChu,340602002,58639,6945,36732,23593,71505,36425,10347,37043,73468,39199,75931
˷,ShuoLiZhen,340602100,48374,5636,31157,17452,61065,30585,9772,31186,61771,32625,63782
ʯ̨,ShiTaiZhen,340602101,33442,3957,22277,13103,43195,21868,7961,22435,44303,23083,45360
Բ,DuanYuanZhen,340602102,46191,6441,30161,18660,58411,27570,8375,27153,54723,30846,61007
Ͻֵ,XiangNanJieDao,340603001,61682,4031,39534,28337,47620,39192,13973,39749,78941,40152,79686
ֵ,DongJieDao,340603002,49135,4677,31857,17669,39749,22908,6290,22587,45495,28245,60102
ֵ,XiJieDao,340603003,55848,6272,35623,27625,59188,35084,9688,35334,70418,36185,71808
̿ڽֵ,SanDiKouJieDao,340603004,43818,3085,29028,18240,34396,24117,8027,24204,48321,25902,54930
ɽֵ,DongShanJieDao,340603005,25165,3199,15280,11486,22269,15108,4574,15593,30701,17658,32938
·ֵ,RenMinLuJieDao,340603006,11819,946,7627,5525,7060,7609,2566,7646,15255,7704,15331
Žֵ,LiuQiaoJieDao,340603007,15792,1070,9056,7061,17733,9010,2737,10150,19160,10543,19599
׽ֵ´,RenWeiJieDaoBanShiChu,340603008,20197,2352,14001,8124,22051,13188,4394,12052,25240,12942,26943
´ﱸ,NanLiBanShiChuChouBeiZu,340603009,18566,1144,10839,6447,8695,9321,3323,9346,18667,12194,23033
´ﱸ,QuYangBanShiChuChouBeiZu,340603010,15952,1320,10297,7510,13962,10172,3832,10528,20700,10807,21104
,QuGouZhen,340603100,42590,6618,30189,19383,56700,30097,12676,31394,61491,31695,61884
ׯֵ,YangZhuangJieDao,340604001,41720,4809,25075,18326,49089,24913,6532,26214,51127,27986,53061
ٺֵͯ,LinHaiTongJieDao,340604002,37012,2794,21009,15483,41218,20740,6763,22939,43679,25560,46569
ƽֵ,BaiShanJieDao,340604003,14086,1649,8055,3518,17014,4999,2001,5147,10146,9681,17736
¥ֵ,RenLouJieDao,340604004,8349,131,4793,3491,9411,4778,2144,5482,10260,5831,10624
ɽ,LieShanZhen,340604100,51920,6545,34446,19404,65176,33584,10581,33255,66839,34600,69046
,SongDingZhen,340604101,33364,5370,23187,14321,43968,22859,7257,22189,45048,22804,45991
,GuRaoZhen,340604102,55626,8920,39315,22832,76472,38467,13992,38211,76678,39223,78538
Ϫ,SuiXiZhen,340621100,94213,9439,61613,36274,95381,57041,19006,56487,113528,61045,122658
,HanCunZhen,340621101,45789,6047,32040,18221,60358,31521,11820,31117,62638,31616,63656
,LiuQiaoZhen,340621102,42763,5583,30006,16507,57337,29991,10580,28887,58878,28920,58926
幵,WuGouZhen,340621103,58871,8771,42384,24006,82088,41505,18374,42047,83552,43632,86016
ٻ,LinHuanZhen,340621104,56961,8818,39924,22360,78155,38274,15221,37654,75928,41076,81000
˫Ѽ,ShuangDuiJiZhen,340621105,67189,8998,47196,23440,91645,46804,19742,47912,94716,48733,95929
,TieFoZhen,340621106,71915,10875,51617,29598,103854,51543,21692,52773,104316,52865,104482
ƺ,NanPingZhen,340621107,63290,8681,43888,22679,86299,42520,17381,43472,85992,45464,89352
,BaiShanZhen,340621108,76448,12174,53297,30751,106677,50805,20159,52003,102808,55484,108781
,SunDingZhen,340621109,64729,9440,44785,24502,88095,43747,16822,45083,88830,46206,90991
Ĳ,SiBuXiang,340621200,59347,8875,40241,22008,80863,38754,15028,39778,78532,43009,83250
Ϫؾÿ,SuiXiXianJingJiKaiFaQu,340621400,12063,1271,7927,4882,13449,7112,2580,7304,14416,7987,15914
ͭɽֵ,TongGuanShanQuXuNiJieDao,340702198,218007,26912,139366,101373,243619,134304,37295,136571,270875,142848,282214
ռũ,PuJiWeiNongChang,340702500,3931,1222,2674,2660,4534,2578,398,2663,5241,2877,5551
ʨɽֵ,ShiZiShanJieDao,340703001,13230,2880,9320,7405,15912,9288,2382,9074,18362,9172,18492
ֵ,XinMiaoJieDao,340703002,8044,1289,5487,4233,8451,5468,1589,5424,10892,5435,10922
ɽֵ,JiShanJieDao,340703003,7095,996,4449,3923,7184,4440,1140,4655,9095,4782,9231
ɽֵ,FengHuangShanJieDao,340703004,1279,353,903,815,1503,900,160,879,1779,889,1792
´,DongJiaoBanShiChu,340703005,14601,1160,8979,6811,10347,8790,2593,9059,17849,9375,18354
,XiHuZhen,340703100,21233,1948,12047,8903,21224,11894,3589,12562,24456,14723,26770
ͭоÿ,TongLingShiJingJiKaiFaQu,340703400,24584,1284,12603,6837,16266,8991,2868,9575,18566,16133,28736
ϰ´,QiaoNanBanShiChu,340711001,23338,2517,13962,10093,16812,13477,3974,13604,27081,15867,29829
´,AnKuangBanShiChu,340711002,3216,500,2111,1542,3807,2106,638,2114,4220,2243,4354
ͭɽ,TongShanZhen,340711100,6632,1855,5103,4109,9438,5082,1563,4811,9893,4947,10050
ͨ,DaTongZhen,340711101,15951,2638,10799,7466,20377,10392,3135,10241,20633,10925,21724
Һ,HuiHeXiang,340711200,3695,608,2540,1576,4933,2523,806,2538,5061,2569,5109
һ˾רܰ,LiangKuangYiGongSiZhuanGuanBan,340711400,800,204,530,570,963,519,134,517,1036,608,1138
žÿ,DaQiaoJingJiKaiFaQu,340711401,79,7,34,22,0,34,11,37,71,63,97
,WuSongZhen,340721100,36739,3637,24003,16766,30819,23079,7045,22746,45825,23418,47421
˳,ShunAnZhen,340721101,35433,4523,22688,16729,41127,22323,6287,22944,45267,23555,46243
,ZhongMingZhen,340721102,27355,4443,18315,13092,35580,17220,5787,17442,34662,19270,37585
,TianMenZhen,340721103,26352,3833,17497,13133,33378,17462,5387,17731,35193,18075,35572
,LaoZhouXiang,340721200,5995,1282,4238,3323,8044,4175,1075,4033,8208,4114,8352
,DongLianXiang,340721201,13679,2407,9445,7161,18247,9272,3295,9384,18656,9936,19381
,XiLianXiang,340721202,23117,3794,15559,12076,30222,15451,4690,15936,31387,16042,31601
,XuBaXiang,340721203,15254,3172,10984,9460,20954,10899,3169,10417,21316,10611,21595
ѭ԰,XunHuanJingJiYuan,340721400,502,4,130,52,35,48,6,60,108,382,512
Źҵ԰,JinQiaoGongYeYuan,340721401,1227,15,529,122,168,126,91,170,296,804,1333
˳·ֵ,YiChengLuJieDao,340802001,15476,2960,10918,7652,16044,9846,2241,9027,18873,9759,20677
º·ֵ,XinHeLuJieDao,340802002,24004,2986,15568,10595,20650,14587,4503,14572,29159,15925,31493
·ֵ,HuaZhongLuJieDao,340802003,29859,3941,19526,13529,27834,18736,4886,18364,37100,19160,38686
·ֵ,RenMinLuJieDao,340802004,23560,3451,15797,11130,21517,15470,3967,14905,30375,15181,30978
Т·ֵ,XiaoSuLuJieDao,340802005,14105,2854,9978,7385,15258,9665,2085,8798,18463,9066,19044
·ֵ,JianSheLuJieDao,340802006,13878,2482,9555,6903,14230,9406,2021,8646,18052,8826,18381
Ϸ,LaoFengZhen,340802100,25428,3045,15337,10367,24095,12260,3100,12932,25192,16236,31573
ʨ,LongShiQiaoXiang,340802200,24067,2202,13711,10111,19064,13379,4093,13631,27010,16651,30362
,ChangFengXiang,340802201,16938,2642,10695,7852,20802,10533,2958,10935,21468,11843,22538
,XinZhouXiang,340802202,5468,1230,3632,3096,7069,3521,650,3650,7171,3716,7348
¿·ֵ´,DeKuanLuJieDaoBanShiChu,340803001,17154,2365,10815,8882,15372,10438,2589,10533,20971,11293,22108
·ֵ´,YuLinLuJieDaoBanShiChu,340803002,17655,2665,11626,9484,16556,11237,2633,11075,22312,11327,22953
ɽ·ֵ´,LongShanLuJieDaoBanShiChu,340803003,18955,3144,12623,10094,19806,12450,2844,12131,24581,12320,24943
ֵ´,LingHuJieDaoBanShiChu,340803004,31298,4681,20341,13592,30015,18196,4313,17364,35560,19951,40292
·ֵ´,JiXianLuJieDaoBanShiChu,340803005,25152,2766,16440,11399,22635,15993,4520,15570,31563,15998,32438
ʯ·ֵ´,ShiHuaLuJieDaoBanShiChu,340803006,19195,2495,12135,9903,19289,11880,2836,11838,23718,12391,24526
ͤ·ֵ´,HuaTingLuJieDaoBanShiChu,340803007,17141,2187,11214,8284,16653,10850,3194,10752,21602,11308,22522
,HaiKouZhen,340803100,25058,3695,17774,10390,33362,17422,6292,16701,34123,17271,35045
ʮ,ShiLiPuXiang,340803200,18659,1750,11416,7095,12695,9953,3055,10011,19964,12048,23464
ɽ,ShanKouXiang,340803201,4768,941,3586,2949,6656,3546,1517,3345,6891,3640,7226
ۿ,DaGuanKaiFaQu,340803400,260,6,67,50,0,47,5,55,102,204,271
ũ,WanHeNongChang,340803500,13333,3243,9671,6800,18615,9612,2639,9367,18979,9544,19215
Žֵ´,DaQiaoJieDaoBanShiChu,340811001,32893,3244,20776,13496,29758,19867,6007,19728,39595,21368,42144
ⱱֵ´,LingBeiJieDaoBanShiChu,340811002,82625,5505,51895,37714,55238,49588,16310,49795,99383,52545,104440
ɽ,DaLongShanZhen,340811100,35969,1886,21900,6308,20470,8898,2627,8863,17761,18582,40482
,YangQiaoZhen,340811101,14766,2472,10170,7946,17718,9660,2767,9147,18807,9835,20005
,LuoLingZhen,340811102,8766,2464,7229,5768,13778,7177,2929,6819,13996,6930,14159
,BaiZeHuXiang,340811200,18372,2915,12158,8133,21744,11690,3432,11943,23633,12561,24719
,WuHengXiang,340811201,4829,1691,4258,3470,8183,4181,1962,4171,8352,4224,8482
ߺ,GaoHeZhen,340822100,64360,6761,42265,25763,69048,39735,14872,39928,79663,43728,85993
ʯ,ShiPaiZhen,340822101,54925,9138,37441,21846,71429,35939,12222,36523,72462,38844,76285
ɽ,YueShanZhen,340822102,22094,2902,14069,7988,26653,12625,4554,12901,25526,15481,29550
,MaMiaoZhen,340822103,27215,4046,18139,10225,36197,18102,6098,19149,37251,19220,37359
,JinGongZhen,340822104,20987,2739,13482,7550,26373,12799,4286,13475,26274,14530,28012
,ChaLingZhen,340822105,22585,2977,14769,8185,29434,14409,5045,15209,29618,15838,30607
,GongLingZhen,340822106,13608,2639,9784,6001,18797,9422,3394,9295,18717,9857,19641
ƶ,HuangDunZhen,340822107,22091,3317,14965,8206,29344,14532,4988,14893,29425,15431,30396
,SanQiaoZhen,340822108,14760,2621,10149,5441,20220,9727,3289,9866,19593,10521,20670
С,XiaoShiZhen,340822109,15599,2406,10551,5587,20870,10482,3286,10606,21088,10740,21291
,HuangLongZhen,340822110,9032,1745,6471,3636,12635,6346,2187,6266,12612,6493,12964
ƽɽ,PingShanZhen,340822111,21916,3805,14828,7508,29964,14082,4738,14251,28333,15631,30459
,LaShuZhen,340822112,20035,2899,13626,6996,27352,13554,4945,14141,27695,14253,27879
,HongPuZhen,340822113,23445,3376,15583,8317,31333,15342,5284,16193,31535,16522,32105
,JiangZhenZhen,340822114,14005,3179,10630,6474,21011,10463,4653,10882,21345,11207,21837
ͤ,LiangTingXiang,340822200,13858,2457,10097,5499,19821,10080,4282,10456,20536,10500,20597
ʯ,ShiJingXiang,340822201,13686,2155,9156,5236,18111,8928,3172,9404,18332,9857,19013
ɽ,XiuShanXiang,340822202,10982,2176,8008,4540,15693,7860,2967,7762,15622,8117,16125
,QingHeXiang,340822203,10591,2013,7369,4103,14710,7129,2431,7216,14345,7666,15035
ײ,LeiBuXiang,340822204,11644,2085,8385,4567,16417,8198,3203,8209,16407,8547,16932
,ZongYangZhen,340823100,73175,8202,50594,32435,81940,47015,15555,43257,90272,46338,96932
ŷɽ,OuShanZhen,340823101,29640,3936,20605,11208,38545,20395,7826,20300,40695,20797,41402
,TangGouZhen,340823102,54304,7949,37887,21019,71421,36785,13612,36896,73681,37978,75865
,LaoZhouZhen,340823103,43912,6504,30615,16838,58888,29835,11612,30243,60078,31413,62028
,ChenYaoHuZhen,340823104,30762,4066,20817,12126,40340,20551,7636,21230,41781,21647,42464
̶,ZhouTanZhen,340823105,27713,3765,18858,10828,36156,18200,7044,18977,37177,19664,38522
Ჺ,HengBuZhen,340823106,48559,6279,32781,19895,61036,31436,11797,32186,63622,33854,66635
,XiangPuZhen,340823107,19267,2203,12910,6924,23775,12092,4834,12524,24616,13394,26304
Ǯ,QianQiaoZhen,340823108,35686,4594,23765,13639,45647,23101,8472,24005,47106,24987,48752
,QiLinZhen,340823109,28828,3554,19122,9777,36321,18552,6446,19082,37634,19706,38828
,YiJinZhen,340823110,31978,4282,21566,11590,40735,20586,7152,21085,41671,21846,43412
ɽ,FuShanZhen,340823111,18539,1841,11536,5522,19869,9921,3830,10778,20699,12674,24210
Ṭ,HuiGongXiang,340823112,29142,3448,19363,10266,36658,18123,7151,18609,36732,20378,39741
ٲ,GuanBuQiaoZhen,340823113,21905,2954,14904,8843,27463,14382,5656,14609,28991,15611,30515
ͭ,TieTongXiang,340823200,6750,1123,4532,2688,8707,4505,1450,4777,9282,4791,9323
,FengYiXiang,340823201,4617,830,3129,1750,6068,3049,943,3065,6114,3261,6390
ɳ,ChangShaXiang,340823202,3778,588,2555,1323,4956,2493,814,2486,4979,2625,5180
Ǯ,QianPuXiang,340823203,17217,2514,11583,6416,22591,11368,3841,11784,23152,11989,23572
,JinSheXiang,340823204,25184,3615,17288,9128,33747,17198,6661,17946,35144,18172,35460
÷,BaiMeiXiang,340823205,13289,1878,9282,5233,17814,9007,3656,9136,18143,9541,18823
׺,BaiHuXiang,340823206,23101,3306,16044,9262,31157,15916,6116,16353,32269,16479,32523
̳,YuTanXiang,340823207,18812,2746,12827,6817,24891,12424,4392,12596,25020,13123,25950
�ÿ,ZongYangJingJiKaiFaQu,340823400,4359,495,2958,1550,5386,2839,1027,2832,5671,2923,5881
÷,MeiChengZhen,340824100,78371,8081,51737,30809,80034,49961,16476,49404,99365,51191,102928
Դ̶,YuanTanZhen,340824101,44935,5878,29696,16759,55830,28261,9273,28647,56908,30390,60086
ྮ,YuJingZhen,340824102,31635,5394,22479,13282,43495,22088,7964,21919,44007,22514,44993
,WangHeZhen,340824103,29184,4458,20254,10722,39779,20233,6762,20103,40336,20150,40404
,HuangPuZhen,340824104,32321,4542,21583,11548,41289,20508,7018,20775,41283,22298,43881
ˮ,ChaShuiZhen,340824105,20935,3275,13813,8380,26642,13099,3885,13688,26787,14282,28095
ˮ,ShuiHouZhen,340824106,19678,3279,13218,8065,26346,13063,4248,13665,26728,13987,27205
ׯ,GuanZhuangZhen,340824107,17504,2973,11520,7527,22981,11350,3341,11995,23345,12298,23818
,HuangNiZhen,340824108,9746,1893,7218,4308,13820,7145,2729,7060,14205,7150,14368
ư,HuangBoZhen,340824109,9487,1227,6057,3571,12284,6000,1789,6319,12319,6446,12503
ɽ,TianZhuShanZhen,340824110,8450,1254,5489,3411,8679,4833,1693,4835,9668,5908,11397
,TaFanXiang,340824200,12823,1858,8355,5011,16888,8319,2534,8800,17119,8860,17215
Ͱ,YouBaXiang,340824201,12404,1960,8351,4254,16572,8340,2501,8496,16836,8514,16865
̶,LongTanXiang,340824202,9710,1770,6520,4115,13254,6484,2186,7098,13582,7146,13666
ķ,DouMuXiang,340824203,10729,1597,7441,4200,14290,7392,2601,7403,14795,7486,14927
,WuMiaoXiang,340824204,5842,1053,4201,2861,8044,4181,1481,4121,8302,4175,8376
,KaiFaQu,340824400,14996,1217,9817,5919,11095,9543,3352,9371,18914,9748,19565
,JinXiZhen,340825100,65767,7539,43643,27493,61074,38409,13534,38166,76575,43197,86840
,XuQiaoZhen,340825101,32025,4353,20396,11801,40916,19969,5731,20968,40937,21713,42109
²,XinCangZhen,340825102,48203,6949,31379,16572,63993,30899,9942,32496,63395,33715,65094
С,XiaoChiZhen,340825103,28830,4100,19013,10609,37608,18595,5550,18976,37571,19467,38480
ǰ,SiQianZhen,340825104,18312,2908,11874,6992,24650,11820,3574,12767,24587,12920,24794
컪,TianHuaZhen,340825105,21388,3324,13564,8033,28061,13339,3941,14600,27939,15089,28653
ţ,NiuZhenZhen,340825106,16722,2147,10502,6175,21658,10204,3259,11165,21369,11626,22128
,MiTuoZhen,340825107,23580,3048,15133,9408,29572,14321,4909,15274,29595,16404,31537
,BeiZhongZhen,340825108,25116,3094,15557,8768,31937,14932,4620,16284,31216,17273,32830
,BaiLiZhen,340825109,16569,1852,10306,5833,21300,10233,3270,11210,21443,11385,21691
ʯ,DaShiXiang,340825200,21483,2843,13818,7107,27973,13579,4160,14104,27683,14668,28486
,ChengXiXiang,340825201,16599,2330,10377,5996,21299,10243,3175,11533,21776,11727,22104
,JiangTangXiang,340825202,23336,3312,14925,7860,30800,14886,4638,16212,31098,16361,31286
Ȫ,TangQuanXiang,340825203,11685,1754,7469,4802,15500,7433,2324,8150,15583,8294,15763
,LiuFanXiang,340825204,14026,1790,8930,5280,18388,8863,3052,9777,18640,9938,18868
ÿ,JingJiKaiFaQu,340825400,3523,371,2324,1102,3918,2076,726,2029,4105,2296,4620
,FuYuZhen,340826100,80836,7055,52856,32418,78556,48546,20171,51437,99983,55206,108062
,FuXingZhen,340826101,23807,4264,17739,11871,34393,16653,7324,15754,32407,17656,35395
,HuiKouZhen,340826102,19415,4018,14699,10781,28143,14437,5778,14053,28490,14512,29211
,XuLingZhen,340826103,16015,3857,13879,10521,25288,13477,7942,13290,26767,13935,27814
²,XiaCangZhen,340826104,13864,2980,11792,8300,21977,11680,6427,11233,22913,11479,23271
,ErLangZhen,340826105,13128,2823,10549,7769,19364,10420,5315,10266,20686,10717,21266
,PoLiangZhen,340826106,20091,3509,14976,10181,26071,13828,7097,14262,28090,15721,30697
ͤ,LiangTingZhen,340826107,16511,3385,13682,9629,24459,13438,7503,13302,26740,13717,27399
,ChangPuZhen,340826108,13280,2439,10213,7295,19276,9899,5251,10398,20297,10757,20970
,GaoLingXiang,340826200,7866,1953,6758,5051,12665,6732,3775,6723,13455,6836,13594
,ChengLingXiang,340826201,10383,2036,8662,6302,16694,8552,5130,8656,17208,8887,17549
Ź,JiuGuXiang,340826202,11192,1802,8441,6022,15183,7835,4320,8011,15846,8873,17314
ǧ,QianLingXiang,340826203,16161,3256,13265,9659,24327,12679,7452,12583,25262,13604,26869
ͷ,ZhouTouXiang,340826204,19641,3827,15342,10519,28388,15062,6571,14190,29252,14697,30039
,ZuoBaXiang,340826205,15653,3761,12948,10341,24866,12583,7528,13473,26056,13994,26942
ԡ,BeiYuXiang,340826206,4576,1107,3526,2781,6923,3449,1614,3581,7030,3771,7297
º,ChenHanXiang,340826207,10868,2268,8024,6429,15956,7952,3624,8568,16520,8736,16760
,AiKouXiang,340826208,9133,2236,7092,5887,13657,6981,3217,7294,14275,7494,14586
ƺ,LiuPingXiang,340826209,4942,1277,3727,2714,7570,3625,1682,3933,7558,4174,7901
ֺ,ZhiFengXiang,340826210,4296,1295,3491,3009,6898,3432,1723,3685,7117,3823,7314
,HeTaXiang,340826211,9992,2748,9024,6768,16631,8867,5264,8719,17586,8980,18004
,WuLiXiang,340826212,15066,2010,10257,6606,17918,9560,4622,9974,19534,11441,21698
,XuNiDiQu,340826400,8700,809,1956,1992,3491,1936,358,2100,4036,7911,9867
ũܳ,HuaYangHeNongChangZongChang,340826401,6981,2596,5662,5068,10561,5625,1629,5498,11123,5544,11206
,HuaYangZhen,340827100,98632,10853,64829,34654,106745,54818,19768,54431,109249,64424,129253
,YangWanZhen,340827101,17658,2791,11903,6705,23513,11596,3829,11750,23346,12375,24278
ĺ,ZhangHuZhen,340827102,15820,2389,10806,5922,21510,10787,3686,11010,21797,11089,21895
,SaiKouZhen,340827103,23583,3352,15772,7917,30298,14638,5290,14860,29498,16453,32225
ʿ,GaoShiZhen,340827104,47670,6879,32651,17464,64384,31937,11283,32059,63996,33181,65832
ѻ̲,YaTanZhen,340827105,45742,6994,31515,17659,62834,30941,11272,31755,62696,32493,64008
,ChangLingZhen,340827106,41539,6878,29070,16219,58646,28577,10979,29215,57792,30326,59396
̫,TaiCiZhen,340827107,40115,6190,27859,15496,55128,27787,9737,28025,55812,28183,56042
Ȫ,LiangQuanXiang,340827200,24266,3683,17001,9780,33721,16965,6135,16995,33960,17083,34084
׳,LeiChiXiang,340827201,28781,4495,19891,11303,38897,19824,6423,19632,39456,19808,39699
,TianTangZhen,340828100,42304,3680,28090,18080,42625,26199,9118,25751,51950,27012,55102
ǰ,DianQianZhen,340828101,12009,1823,8576,6055,15580,7993,3225,7790,15783,8481,17057
,LaiBangZhen,340828102,13946,1646,9163,6121,18043,9033,3074,9341,18374,9503,18666
,ChangPuZhen,340828103,12523,2038,8724,6409,16884,8557,2862,8506,17063,8699,17423
ͷ,TouTuoZhen,340828104,5822,878,3710,2628,7564,3622,1040,3849,7471,4030,7740
ñ,BaiMaoZhen,340828105,10444,1752,7335,5415,14121,7293,2563,7278,14571,7424,14759
Ȫ,WenQuanZhen,340828106,21438,2365,14243,8498,27370,13879,4899,13831,27710,14459,28702
쳦,XiangChangZhen,340828107,10128,1482,7139,4713,13901,7116,2510,6934,14050,6981,14120
ͼ,HeTuZhen,340828108,5602,945,3698,2899,7383,3676,1067,3853,7529,3916,7614
,WuHeZhen,340828109,10724,1465,7209,4835,14525,7178,2541,7397,14575,7521,14730
,ZhuBuZhen,340828110,4657,670,2996,2019,6129,2994,883,3205,6199,3214,6210
ұϪ,YeXiZhen,340828111,10643,1804,7668,5611,15108,7624,2987,7652,15276,7766,15434
β,HuangWeiZhen,340828112,4201,648,2753,1919,5353,2711,817,2803,5514,2913,5666
ëɽ,MaoJianShanXiang,340828200,7994,1083,5414,3340,10632,5401,1779,5397,10798,5442,10856
,LianYunXiang,340828201,13258,1397,8751,5099,17323,8667,2912,8744,17411,8816,17567
,QingTianXiang,340828202,6441,942,4271,2982,8582,4218,1467,4501,8719,4579,8850
,BaoJiaXiang,340828203,3398,482,2152,1517,4404,2130,622,2326,4456,2350,4502
ŷ,GuFangXiang,340828204,4514,756,3175,2262,6177,3155,1052,3095,6250,3147,6322
ͷ,TianTouXiang,340828205,6541,910,4238,3009,8536,4191,1240,4359,8550,4453,8691
й,ZhongGuanXiang,340828206,11672,1474,7989,5043,15733,7981,2809,7923,15904,7966,15955
ʯ,ShiGuanXiang,340828207,6616,885,4409,3029,8737,4371,1472,4547,8918,4564,8973
Ҧ,YaoHeXiang,340828208,4253,723,2886,1975,5808,2871,943,3009,5880,3033,5919
ƽ,HePingXiang,340828209,5837,765,3658,2488,7579,3628,1167,4051,7679,4111,7769
Ρ,WeiLingXiang,340828210,2260,343,1422,1014,2942,1408,406,1556,2964,1587,3009
ڽֵ,LongTengJieDao,340881001,19530,1985,13290,7071,20403,12367,3929,11470,23837,12154,25444
Ĳֵ,WenChangJieDao,340881002,45472,5913,30906,19069,46666,28570,8666,27726,56296,29145,60051
ֵ߽,LongMianJieDao,340881003,63816,6501,41896,25459,59857,39959,12675,39161,79120,41096,82992
׳,KongChengZhen,340881100,48445,6936,32971,17653,63665,32349,10174,31864,64213,32584,65555
ͤ,LvTingZhen,340881101,38409,5529,26442,13741,51285,26247,8580,25779,52026,26076,52518
,FanGangZhen,340881102,44010,6092,28342,15077,55061,27298,7990,28382,55680,29750,58092
¶,XinDuZhen,340881103,47457,6943,31810,18208,59175,30711,9164,29848,60559,31754,63564
˫,ShuangGangZhen,340881104,32360,5588,22607,13521,43259,22214,6757,21662,43876,22098,44705
,DaGuanZhen,340881105,42818,5766,29556,15862,56898,29320,9659,28358,57678,28687,58243
,QingCaoZhen,340881106,46989,6949,30425,16476,60998,29675,7947,30533,60208,31460,61885
,JinShenZhen,340881107,37017,5671,25125,13941,49442,24753,7417,24426,49179,24980,50105
Ӻ,XiZiHuZhen,340881108,14562,2317,9706,5554,19228,9683,2704,9829,19512,9877,19583
,TangWanZhen,340881109,6939,1305,4632,2762,9429,4575,1306,4770,9345,4918,9550
Ƽ,HuangJiaZhen,340881110,8670,1526,5422,3376,11378,5326,1356,5934,11260,6130,11552
,XunYuZhen,340881111,453,90,316,289,490,309,73,295,604,300,616
Ŷֵ´,YuDongJieDaoBanShiChu,341002001,18908,2295,12459,9227,13909,12156,3348,11706,23862,12092,24551
нֵ´,YuZhongJieDaoBanShiChu,341002002,27063,3752,18964,12113,24926,16432,4265,15385,31817,16116,35080
ֵ´,YuXiJieDaoBanShiChu,341002003,13790,1254,8275,4942,9623,6768,1833,6264,13032,8602,16877
Ͻֵֽ´,LaoJieJieDaoBanShiChu,341002004,9779,1509,6286,5446,9652,6141,1546,6074,12215,6548,12834
͹,TunGuangZhen,341002100,37609,3805,23586,16272,31802,22179,6066,21926,44105,23894,47480
,YangHuZhen,341002101,34600,2723,20599,10965,23433,15712,4705,15113,30825,21429,42028
,LiYangZhen,341002102,12339,1692,7979,4666,12559,7550,1862,7488,15038,7914,15893
̶,XinTanZhen,341002103,9413,981,5699,3438,8252,5219,1493,5401,10620,6188,11887
,YiQiZhen,341002104,8596,1066,5263,2936,8923,4986,1345,5217,10203,5744,11007
³ǽֵ´,XinChengJieDaoBanShiChu,341003001,18532,1967,12771,9636,15936,12075,3226,10469,22544,10954,23725
,GanTangZhen,341003100,19099,2142,12029,8666,16543,11409,3176,11588,22997,12388,24417
Դ,XianYuanZhen,341003101,6493,1268,4315,3342,7787,4285,1102,4467,8752,4548,8863
,TangKouZhen,341003102,12104,1110,7200,5462,10859,6578,1963,7051,13629,7977,15177
̷,TanJiaQiaoZhen,341003103,5090,878,3120,2723,6025,3043,762,3431,6474,3610,6730
̫ƽ,TaiPingHuZhen,341003104,5749,942,3498,2770,6753,3354,915,3646,7000,4108,7606
,JiaoCunZhen,341003105,7391,1803,4919,4388,9815,4840,1211,5294,10134,5486,10405
,GengChengZhen,341003106,5852,970,3656,2630,7071,3536,907,3864,7400,4073,7729
,SanKouZhen,341003107,5238,1039,3271,2679,6574,3243,778,3742,6985,3784,7055
,XinMingXiang,341003200,4405,846,2639,2137,5479,2627,562,3129,5756,3174,5813
,LongMenXiang,341003201,2752,569,1601,1462,3365,1552,323,1899,3451,2043,3644
ʯ,WuShiXiang,341003202,6867,1372,4450,3690,8843,4387,1084,4728,9115,4873,9323
»,XinHuaXiang,341003203,3294,721,2170,1895,4332,2141,604,2351,4492,2449,4619
·,XinFengXiang,341003204,3080,831,2163,1875,4208,2157,573,2311,4468,2321,4484
,YongFengXiang,341003205,3340,744,2239,1843,4451,2200,569,2353,4553,2414,4653
ɽ羰,HuangShanFengJingQu,341003400,3275,56,1088,977,1044,434,46,850,1284,2289,3377
ݽֵ´,HuiZhouJieDaoBanShiChu,341004001,10501,821,6695,4705,7949,6390,2276,6377,12767,6903,13598
,YanSiZhen,341004100,24568,2791,15394,10321,24833,14941,4255,15230,30171,16220,31614
Ϫ,XiXiNanZhen,341004101,12573,1611,7761,4369,14885,7682,1867,7932,15614,8290,16051
Ǳ,QianKouZhen,341004102,9086,1346,5826,3662,10732,5778,1495,5784,11562,6101,11927
ʿ,ChengKanZhen,341004103,8674,1270,5203,3537,10719,5181,1232,5863,11044,5973,11176
Ǣ,QiaSheXiang,341004200,1626,323,972,835,2093,942,192,1119,2061,1169,2141
,YangCunXiang,341004201,2971,447,1860,1390,3639,1849,425,1958,3807,1983,3843
Ϫ,FuXiXiang,341004202,3858,653,2553,1865,5006,2553,668,2620,5173,2626,5179
ճ,HuiChengZhen,341021100,56506,7079,37485,24184,52597,33518,10764,32526,66044,36864,74349
,ShenDuZhen,341021101,13377,2594,9237,6739,17284,9062,2568,9032,18094,9302,18539
,BeiAnZhen,341021102,13823,2581,9336,6542,17735,9218,2676,9440,18658,9744,19080
,FuYeZhen,341021103,11692,1687,7475,4905,13994,7425,1868,7697,15122,7772,15247
֣,ZhengCunZhen,341021104,13392,1670,8496,4914,13703,8182,2215,8164,16346,8781,17277
,GuiLinZhen,341021105,19531,2679,12380,8167,21701,12009,3770,12585,24594,13600,25980
,XuCunZhen,341021106,5987,914,3945,2384,7571,3890,1151,4022,7912,4107,8052
Ϫͷ,XiTouZhen,341021107,9564,1935,6105,4506,11776,5983,1721,6155,12138,7115,13220
,QiZiLiZhen,341021108,13467,2778,9603,7488,18236,9569,2939,9359,18928,9581,19184
ϼ,XiaKengZhen,341021109,10574,1897,7224,5232,13893,7140,2000,7140,14280,7247,14471
,ChaKouZhen,341021110,10519,1689,6895,4637,13488,6836,1772,6981,13817,7085,13980
ֿ,JieKouZhen,341021111,6423,1321,4542,3271,8706,4541,1168,4362,8903,4370,8912
,WangCunZhen,341021112,16647,2403,10707,6059,20451,10461,2946,10795,21256,11289,21996
ӿ,KengKouXiang,341021200,3993,1394,3288,2979,5894,3285,959,3034,6319,3058,6346
۴,XiongCunXiang,341021201,8385,1487,5538,3389,10751,5506,1419,5735,11241,5753,11291
Ϸ,ShangFengXiang,341021202,8114,1307,5291,3389,10491,5261,1515,5537,10798,5645,10936
Ϫ,ChangXiXiang,341021203,3532,690,2460,1744,4738,2361,748,2362,4723,2510,4970
,WuYangXiang,341021204,6450,1084,4368,3081,8400,4324,1139,4194,8518,4305,8673
,SanYangXiang,341021205,11487,2055,8007,5651,15228,7954,2283,7701,15655,7818,15825
,JinChuanXiang,341021206,6549,888,4203,2935,8434,4203,1383,4614,8817,4617,8820
С,XiaoChuanXiang,341021207,5443,1413,4231,3512,7780,4231,1263,3888,8119,3888,8119
Ϫ,XinXiKouXiang,341021208,4806,781,3143,1996,6270,3131,925,3353,6484,3369,6512
,HuangTianXiang,341021209,12735,1901,8323,5107,16502,8302,2336,8568,16870,8649,16972
,ChangGaiXiang,341021210,9063,1182,5781,3263,11669,5759,1710,6083,11842,6174,11955
ɭ,SenCunXiang,341021211,8036,1418,5178,3247,10598,5174,1537,5807,10981,5813,10991
,ShaoLianXiang,341021212,7869,1206,5068,3040,10056,5068,1363,5368,10436,5370,10438
ʯ,ShiMenXiang,341021213,2608,368,1564,916,3233,1520,389,1674,3194,1801,3365
ʨʯ,ShiShiXiang,341021214,953,137,596,406,1217,596,187,676,1272,681,1277
ؾÿ,XiXianJingJiKaiFaQu,341021400,2361,19,979,655,1,425,90,647,1072,1491,2470
,HaiYangZhen,341022100,36531,5242,24208,16429,42834,23205,7155,23064,46269,24720,48928
ɽ,QiYunShanZhen,341022101,9632,1424,6031,3842,11944,6004,1207,6145,12149,6232,12263
,WanAnZhen,341022102,16679,2113,10841,6028,18874,10080,2605,9853,19933,10556,21397
,WuChengZhen,341022103,17314,2563,10595,6065,21491,10471,2786,11241,21712,12068,22663
Ϫ,DongLinXiZhen,341022104,13579,2033,8818,5031,16746,8715,2333,8866,17581,9127,17945
,LanTianZhen,341022105,8552,1213,5294,3253,10738,5266,1199,5543,10809,5670,10964
Ϫ,XiKouZhen,341022106,16921,2518,10653,6825,21561,10512,2585,11059,21571,11371,22024
,LiuKouZhen,341022107,3144,451,2146,1380,4146,2142,637,2068,4210,2086,4232
,WangCunZhen,341022108,4584,813,3496,2488,6671,3489,1347,3232,6721,3248,6744
ɽ,ShangShanZhen,341022109,15986,2244,10185,5700,20178,10045,2735,10374,20419,10780,20965
ɽ,ShanDouXiang,341022201,3437,499,2190,1278,4334,2184,671,2309,4493,2417,4607
,LingNanXiang,341022202,2269,322,1525,876,2966,1489,522,1503,2992,1588,3113
μ,WeiQiaoXiang,341022203,8936,1534,5426,3333,11104,5309,1192,5689,10998,6236,11662
,BanQiaoXiang,341022204,3698,458,2437,1446,4856,2435,738,2451,4886,2457,4894
ϼ,ChenXiaXiang,341022205,6058,986,3929,2454,8071,3925,1128,4234,8159,4243,8172
׳,HeChengXiang,341022206,5254,662,3517,2031,7045,3503,1214,3570,7073,3613,7130
Դ,YuanFangXiang,341022207,3895,515,2353,1433,4920,2352,577,2631,4983,2634,4987
ܴ,YuCunXiang,341022208,7035,1040,4507,2589,8778,4493,1174,4697,9190,4742,9249
,LongTianXiang,341022209,3624,403,2220,1323,4659,2203,733,2491,4694,2540,4760
諼,HuangJianXiang,341022210,1684,244,1125,731,2260,1119,394,1192,2311,1197,2322
׼,BaiJiXiang,341022211,986,202,672,509,1383,670,248,762,1432,764,1436
,BiYangZhen,341023100,28140,4064,18806,15339,32715,18427,4701,17601,36028,18099,36905
,HongCunZhen,341023101,11728,1984,7625,6410,14169,7597,1815,7862,15459,7902,15527
ͤ,YuTingZhen,341023102,6150,836,3899,3064,7384,3884,1092,4031,7915,4179,8078
,XiDiZhen,341023103,3582,659,2396,2071,4415,2393,529,2350,4743,2374,4770
´,KeCunXiang,341023200,3447,635,2326,1692,4564,2303,637,2359,4662,2393,4719
Ϫ,MeiXiXiang,341023201,2154,376,1428,1105,2736,1405,387,1427,2832,1489,2917
̶,HongTanXiang,341023202,2958,611,2017,1554,3976,2003,562,2106,4109,2114,4131
,HongXingXiang,341023203,2714,459,1808,1377,3574,1777,502,1798,3575,1867,3675
ɽ,QiShanZhen,341024100,41773,4892,28420,19306,42332,26805,8835,25703,52508,27080,55500
С·,XiaoLuKouZhen,341024101,3539,528,2255,1741,4448,2220,719,2370,4590,2531,4786
,JinZiPaiZhen,341024102,6491,1097,4149,3274,7655,3966,1143,4139,8105,4582,8731
ƽ,PingLiZhen,341024103,3870,644,2708,2074,5118,2707,860,2664,5371,2666,5374
,LiKouZhen,341024104,7786,1337,5674,4111,10445,5588,1965,5323,10911,5414,11088
,ShanLiZhen,341024105,6630,794,4005,2483,7604,3826,1340,3972,7798,4759,8764
,AnLingZhen,341024106,8069,1270,5443,3462,10597,5300,1611,5320,10620,5507,10950
,FuFengZhen,341024107,4407,893,3392,2533,6296,3377,1225,3121,6498,3133,6525
̹,DaTanXiang,341024200,2548,369,1735,1051,3357,1704,561,1700,3404,1743,3478
Ϫ,BaiXiXiang,341024202,2495,428,1765,1329,3370,1737,635,1709,3446,1793,3558
,TaFangXiang,341024203,3890,679,2894,2154,5070,2828,986,2634,5462,2661,5555
,QiHongXiang,341024204,2423,535,1684,1515,3258,1679,471,1721,3400,1745,3429
ܿ,RongKouXiang,341024205,2719,503,1852,1362,3569,1828,567,1867,3695,1937,3789
«Ϫ,LuXiXiang,341024206,2484,577,1730,1452,3412,1708,505,1788,3496,1836,3566
便,ZhuKouXiang,341024207,4395,619,2627,1967,4830,2570,889,2596,5166,3276,5903
Ϫ,GuXiXiang,341024208,3666,490,2458,1687,4841,2452,859,2516,4968,2557,5015
°,XinAnXiang,341024209,4026,583,2687,1975,5216,2651,947,2762,5413,2869,5556
,RuoKengXiang,341024210,4570,613,2993,2052,5937,2959,1018,3180,6139,3208,6201
ֵ´,LangYaJieDaoBanShiChu,341102001,48975,6180,33401,20550,44960,29036,7597,27409,56445,29351,62752
Žֵ´,DongMenJieDaoBanShiChu,341102002,12388,1842,8218,6181,11641,8073,2131,7941,16014,8143,16361
Žֵ´,XiMenJieDaoBanShiChu,341102003,13031,1887,8902,6636,11718,8650,1938,7765,16415,7954,16856
Žֵ´,NanMenJieDaoBanShiChu,341102004,21402,2402,13931,10065,22144,13674,3390,12960,26634,13263,27194
Žֵ´,BeiMenJieDaoBanShiChu,341102005,15721,2115,10498,7668,13453,10358,2905,10206,20564,10243,20741
ֵ´,QingLiuJieDaoBanShiChu,341102006,43632,4158,27631,21277,39658,27144,8410,27759,54903,28569,56200
ӽֵ´,YangZiJieDaoBanShiChu,341102007,27954,2870,17554,12588,28166,17443,5535,18080,35523,18805,36359
˽ֵ´п,FengHuangJieDaoBanShiChuChuZhouShiKaiFaQu,341102008,27802,1185,15864,8564,15856,11695,4191,12252,23947,17314,33178
Ǳ´,ChengBeiXinQuBanShiChu,341102009,10859,1171,6762,4566,10881,6624,2084,7032,13656,7352,14114
�ֵ´,XiJianJieDaoBanShiChu,341102010,20391,2523,12790,10286,21552,12767,3758,13811,26578,13882,26672
ֵ´,DaiWangJieDaoBanShiChu,341103002,7266,1065,4711,3205,8902,4692,1377,4943,9635,4997,9708
ֵ´,LongPanJieDaoBanShiChuChou,341103003,50123,2831,28994,20371,32432,27863,9689,28967,56830,33649,62643
,WuYiZhen,341103100,29388,4518,18900,13932,35574,18528,4967,19033,37561,19973,38873
ɳ,ShaHeZhen,341103101,22695,3457,15065,11833,28125,15043,3782,14795,29838,14869,29934
¹,ZhangGuangZhen,341103102,13072,2827,9245,7057,18384,9161,2791,9340,18501,9445,18690
,HuangNiGangZhen,341103103,11453,1764,7985,6330,14933,7962,2389,7583,15545,7621,15606
,ZhuLongZhen,341103104,10740,1786,7263,5604,13648,7186,1931,6940,14126,7194,14457
,DaLiuZhen,341103105,5875,1209,4160,3519,7901,4133,1230,4117,8250,4154,8314
,YaoPuZhen,341103106,21203,2403,12686,8776,24231,12682,3186,12963,25645,14106,26792
ʩ,ShiJiZhen,341103107,15878,3229,10856,8781,20860,10735,2780,10743,21478,11031,21887
۹ҵ԰,NanQiaoGongYeYuanQu,341103400,4025,451,2235,1508,3469,2149,514,2154,4303,2755,4990
°,XinAnZhen,341122100,79797,9412,53932,35631,88594,52514,16419,50099,102613,51696,105628
,BanTaZhen,341122101,48166,7040,33561,19407,63660,33163,11508,32850,66013,33153,66714
ˮ,ShuiKouZhen,341122102,37074,5547,25041,16181,47034,24715,7551,24726,49441,25131,50172
,ChaHeZhen,341122103,27314,3906,17481,11657,33145,17261,4554,17705,34966,18293,35774
Ӣ,DaYingZhen,341122104,12264,1659,7808,5081,14025,7547,1987,7833,15380,8102,15910
׹,LeiGuanZhen,341122105,16585,2905,11324,7729,22233,11322,3431,11581,22903,11597,22921
ʩ,ShiGuanZhen,341122106,25228,3775,16882,10781,33223,16840,5154,17220,34060,17275,34157
˴ɽ,ShunShanZhen,341122107,19345,3150,13059,8520,25919,13041,4181,13553,26594,13617,26676
,SanChengXiang,341122200,13664,2246,9050,6205,17706,9030,2479,9314,18344,9339,18389
ɽ,DuShanXiang,341122201,13576,2063,9332,5453,18176,9332,3049,9354,18686,9356,18688
ɽ,ZhangShanXiang,341122202,14825,2213,10348,6797,19129,10344,3355,9993,20337,10045,20393
۫,YangYingXiang,341122203,12143,1641,8182,4738,15857,8178,2815,8301,16479,8417,16599
,XiangHeZhen,341124100,104134,12343,69384,44354,106835,65278,22077,64179,129457,69170,138554
ź,GuHeZhen,341124101,20187,3873,14478,10443,26839,14351,5452,14935,29286,15034,29512
,DaShuZhen,341124102,20430,4960,15398,10859,30230,15048,6149,15482,30530,16141,31539
ɿ,ErLangKouZhen,341124103,26915,5741,19238,13764,37173,18578,6490,19048,37626,19908,39146
,WuGangZhen,341124104,10972,2388,7529,5485,14202,7222,2188,7340,14562,8019,15548
�,MaChangZhen,341124105,19711,4206,14248,9218,27427,13853,4640,13603,27456,14309,28557
ʯ,ShiPeiZhen,341124106,12225,2700,8754,6374,16587,8502,2677,8514,17016,8848,17602
ʮ,ShiZiZhen,341124107,23527,4122,15236,11006,28252,14359,3617,14952,29311,16030,31266
,XiWangZhen,341124108,12029,2766,8739,6133,17153,8691,3000,8960,17651,9056,17795
,LiuZhenZhen,341124109,24860,4883,16779,10525,33326,16368,4623,16840,33208,17587,34366
,DingChengZhen,341125100,127573,14807,83433,48431,140100,74772,32503,78634,153406,91450,174883
¯,LuQiaoZhen,341125101,50193,7835,36282,22889,70974,36263,16891,38608,74871,38637,74919
,YongKangZhen,341125102,29561,4944,21090,13084,41618,20580,9808,22383,42963,23223,44313
,WuWeiZhen,341125103,33110,6183,23367,13912,47960,23360,9865,25769,49129,25791,49158
,ZhuWanZhen,341125104,11111,2137,7824,4891,16283,7814,3225,8619,16433,8649,16473
,ZhangQiaoZhen,341125105,30459,5264,21553,13508,43499,21455,9464,23437,44892,23634,45187
ź,OuTangZhen,341125106,27863,4876,19456,11457,38867,19399,7162,20381,39780,20445,39901
غ,ChiHeZhen,341125107,28767,4469,19834,12810,39250,19808,7729,20844,40652,21131,40965
,LianJiangZhen,341125108,16911,3575,12171,7726,25341,12050,5140,13262,25312,13455,25626
Ƽ,JiePaiJiZhen,341125109,14463,2739,10124,6562,19848,10114,3648,10677,20791,10726,20850
,CangZhen,341125110,14470,3057,10831,7262,21375,10820,4616,11282,22102,11312,22143
ͼ,SanHeJiZhen,341125111,19658,3101,13467,7779,27665,13464,5289,14430,27894,14581,28048
ئ,XiSaDianZhen,341125112,20030,3516,13850,8257,27725,13826,5401,15031,28857,15097,28947
ɣ,SangJianZhen,341125113,19761,3659,13876,8010,28051,13801,5272,14637,28438,14816,28692
,JiangJiZhen,341125114,15111,2788,10335,6456,21287,10325,3839,11362,21687,11403,21738
,DaQiaoZhen,341125115,13762,2664,9827,6184,19772,9740,4027,10397,20137,10626,20453
,YanQiaoXiang,341125200,12468,2111,8337,4483,16942,8330,2875,9056,17386,9117,17454
,FuXiaoXiang,341125201,11578,2278,8460,5233,16468,8459,3168,8545,17004,8564,17024
,NengRenXiang,341125202,11284,1869,8743,5208,16315,8718,4758,9139,17857,9168,17911
,QiLiTangXiang,341125203,14777,2762,10623,6837,21367,10622,4860,11741,22363,11776,22399
,ErLongHuiZuXiang,341125204,6926,1275,4822,3626,10079,4815,2037,5370,10185,5416,10238
,FanGangXiang,341125205,8160,1604,5591,3849,11027,5528,2088,6043,11571,6261,11852
,FuChengZhen,341126100,103410,10653,65374,34418,108187,56480,21049,58400,114880,69738,135112
ٻ,LinHuaiZhen,341126101,28592,3821,19079,12767,35338,18825,5751,18708,37533,19085,38164
,WuDianZhen,341126102,37036,4355,25762,14427,50997,25762,12288,27917,53679,27917,53679
Ȫ,XiQuanZhen,341126103,23962,3263,16934,9610,31903,16790,8021,18069,34859,18312,35246
,GuanTangZhen,341126104,17250,2892,13306,7925,25682,13207,7100,13690,26897,13936,27242
,LiuFuZhen,341126105,45915,6196,30770,17636,61649,30543,12794,33757,64300,34135,64905
,DaMiaoZhen,341126106,29235,4800,20233,12137,40733,20022,8726,22091,42113,22528,42761
,YinJianZhen,341126107,12626,2708,9282,6294,18066,9090,3795,9480,18570,9847,19129
,ZongPuZhen,341126108,25623,4580,18303,11206,36402,18160,7439,19086,37246,19339,37642
,HongXinZhen,341126109,15155,3281,11797,7646,22903,11684,5572,12041,23725,12211,24008
,BanQiaoZhen,341126110,34649,5499,24572,15904,48498,23832,10023,24896,48728,25599,50171
Ϫ,DaXiHeZhen,341126111,15614,2691,11408,7248,21771,11282,4825,11519,22801,11722,23130
СϪ,XiaoXiHeZhen,341126112,25400,4738,18586,11961,37089,18339,7894,19152,37491,19446,38032
,ZaoXiangZhen,341126113,11304,2494,8994,6345,18011,8884,4582,9181,18065,9386,18380
,HuangWanXiang,341126201,9757,2028,7656,5345,14897,7539,3638,7604,15143,7767,15423
عҵ԰,FengYangXianGongYeYuanQu,341126400,16421,2079,10902,6984,18371,10628,3371,10402,21030,10969,21871
쳤ֵ´,TianChangJieDaoBanShiChu,341181001,100043,10148,65411,36911,99728,53850,21568,53986,107836,66348,131759
ͭ,TongChengZhen,341181100,47362,7931,32318,19818,60526,31018,8967,30564,61582,31942,64260
⽧,ChaJianZhen,341181101,36457,5374,24955,14965,46134,24414,7590,23695,48109,24466,49421
,QinLanZhen,341181102,31471,4350,20933,11416,34531,19088,6080,19120,38208,20968,41901
ͨ,DaTongZhen,341181103,26419,4119,17923,10097,35026,17698,5501,17777,35475,18116,36039
,YangCunZhen,341181104,25676,4411,17719,11028,33605,17633,5634,17782,35415,18002,35721
ʯ,ShiLiangZhen,341181105,19333,3122,13305,8080,24957,13194,4073,13059,26253,13223,26528
,JinJiZhen,341181106,22212,3716,15732,9631,29382,15685,4995,15033,30718,15191,30923
,YongFengZhen,341181107,15351,2606,10512,6266,18825,10062,3115,10053,20115,10560,21072
ʺͼ,RenHeJiZhen,341181108,24950,4378,17425,11047,32213,17065,5457,16936,34001,17360,34785
ұɽ,YeShanZhen,341181109,21844,3182,14873,9057,27537,14446,4700,14265,28711,14853,29726
֣,ZhengJiZhen,341181110,14142,2205,9526,5792,18102,9296,2837,9179,18475,9658,19184
,ZhangPuZhen,341181111,19199,3027,13321,8592,25335,13313,4341,13225,26538,13246,26567
½,XinJieZhen,341181112,14135,2370,10067,6472,18634,10048,3303,9697,19745,9741,19808
,WanShouZhen,341181113,8221,1775,6070,3881,11083,6061,1954,5837,11898,5880,11950
Ƕ,ChengDongXinQu,341181400,16232,1097,11179,7085,11774,10574,4249,9583,20157,10399,21578
ʡũ,AnHuiShengDaKuangWeiNongChang,341181500,1109,297,799,646,1400,799,212,817,1616,819,1618
ֵ´,MingGuangJieDaoBanShiChu,341182001,104885,13142,71462,47110,111214,67686,22239,65379,133065,68804,140266
�ֵ´,MingDongJieDaoBanShiChu,341182002,10775,1712,7547,5079,14257,7534,2793,7652,15186,7733,15280
Ͻֵ´,MingNanJieDaoBanShiChu,341182003,9123,1518,6356,4042,12604,6353,2545,6805,13158,6830,13186
ֵ´,MingXiJieDaoBanShiChu,341182004,15624,2726,11298,7257,21493,11254,4416,11288,22542,11468,22766
Ű,ZhangBaLingZhen,341182100,16754,3385,12276,8701,23040,12262,4317,12125,24387,12180,24456
,SanJieZhen,341182101,10071,1737,7030,4729,13174,6937,2360,7022,13959,7138,14168
ܵ,GuanDianZhen,341182102,10681,1794,7694,5360,13701,7606,2894,7570,15176,7675,15369
,ZiLaiQiaoZhen,341182103,15925,2486,11062,6978,21792,11058,4249,11538,22596,11598,22660
Ϫ,JianXiZhen,341182104,27247,4505,19535,12036,38035,19495,7505,19613,39108,19722,39257
ʯ,ShiBaZhen,341182105,26547,4337,18948,11456,36789,18925,6899,18725,37650,18835,37783
,SuXiangZhen,341182106,13645,2288,9723,6237,18743,9721,3703,9878,19599,9913,19636
ͷ,QiaoTouZhen,341182107,15194,2949,11073,7530,21835,11066,4896,11913,22979,11966,23039
Ůɽ,NvShanHuZhen,341182108,27157,3742,18515,11913,36943,18513,6785,19139,37652,19169,37684
,GuPeiZhen,341182109,15479,2994,10990,7551,22353,10977,4348,11805,22782,11831,22821
˴,PanCunZhen,341182110,32493,6463,25194,16660,47453,25123,10883,24561,49684,24645,49839
,LiuXiangZhen,341182111,14169,2874,10985,6762,21651,10867,4982,10745,21612,11040,22025
,BoGangXiang,341182200,8417,1476,6245,3567,12177,6240,2604,6244,12484,6252,12497
¥ֵ´,GuLouJieDaoBanShiChu,341202001,34687,4600,24123,15312,33411,23622,7369,22245,45867,22533,46656
ķֵ´,WenFengJieDaoBanShiChu,341202002,100490,7977,67665,43856,85237,63809,22920,60809,124618,63722,131387
ӽֵ´,QingHeJieDaoBanShiChu,341202003,46259,3268,29655,20285,41853,29532,11830,29966,59498,31702,61357
ֵ´,YingXiJieDaoBanShiChu,341202004,61409,5724,41298,25603,65736,39053,16219,40108,79161,42054,83352
ֵ´,XiHuJingQuJieDaoBanShiChu,341202005,5524,960,4380,2942,7908,4375,1882,3969,8344,3986,8366
�Ű´,FuYangKaiFaQuJingJiuBanShiChu,341202006,65794,5127,43195,29452,62192,41182,17476,42775,83957,45202,88397
,WangDianZhen,341202100,34241,5082,25039,16795,47463,24956,10977,25108,50064,25261,50300
̼,ChengJiZhen,341202101,24825,3795,17670,12579,33375,17550,6870,17682,35232,17820,35490
,SanHeZhen,341202102,18875,3226,14277,9860,25992,14227,6075,13784,28011,13899,28176
,XiHuZhen,341202103,16583,3123,12733,8709,24043,12580,5550,12388,24968,12523,25256
,JiuLongZhen,341202104,21573,3659,16016,10866,30050,15903,6410,15546,31449,15626,31642
ʮ,SanShiLiPuZhen,341202105,21806,3659,15983,11326,30422,15959,6766,16169,32128,16248,32231
Ԭ,YuanJiZhen,341202106,22939,3662,17759,11599,31754,17727,7176,15907,33634,16018,33777
կ,MaZhaiXiang,341202200,24618,3809,17953,12250,33966,17883,6884,17344,35227,17358,35311
Ӷ´,HeDongBanShiChu,341203001,45534,3204,28296,18683,43523,27733,10855,28125,55858,31297,59593
»ֵ´,XinHuaJieDaoBanShiChu,341203002,25339,3637,17473,10650,34371,17177,6476,17471,34648,17979,35452
ֵ´,XiangYangJieDaoBanShiChu,341203003,42608,4468,28002,16404,46905,25975,9547,25516,51491,28621,56623
,KouZiZhen,341203100,37947,6348,28482,16979,55226,28128,12886,28127,56255,28699,57181
廨,ChaHuaZhen,341203101,41897,7553,30712,20070,59709,30554,12641,31108,61662,31379,62091
Ԭկ,YuanZhaiZhen,341203102,33979,5337,25114,16863,47932,24752,10581,24159,48911,24783,49897
ׯ,ZaoZhuangZhen,341203103,22495,3688,16442,9979,32419,16437,7399,17128,33565,17140,33582
,LaoMiaoZhen,341203104,20441,3843,16735,10144,30843,16720,7465,14950,31670,15014,31749
,ZhengWuZhen,341203105,25272,4303,18970,11897,35586,18958,7121,17657,36615,17726,36696
¥,YangLouZiZhen,341203106,21307,3134,14417,9029,26633,14160,5758,14041,28201,15782,30199
ڽ,XinWuJiangZhen,341203107,25135,4025,17935,11824,36130,17899,7480,18645,36544,18705,36640
Ƚ,RanMiaoXiang,341203200,20600,3165,14508,9801,28545,14505,6094,15298,29803,15351,29859
нֵ´,ZhongShiJieDaoBanShiChu,341204001,104647,11263,70542,46377,104480,69084,24483,67878,136962,69851,140393
ֵ´,ZhouPengJieDaoBanShiChu,341204002,49070,6128,34554,21952,65038,34382,13159,31530,65912,33803,68357
,WuMingZhen,341204100,63178,10143,48521,33304,92580,48397,22610,47144,95541,47410,95931
ׯ,NingLaoZhuangZhen,341204101,47351,8392,38565,25456,71798,37888,19713,36226,74114,36891,75456
ż,WenJiZhen,341204102,57178,10568,45744,34593,85525,45613,20478,42254,87867,42480,88224
,XingLiuZhen,341204103,57262,9638,45643,30658,86776,45449,22426,43218,88667,43683,89326
ǹ,ChengGuanZhen,341221100,115983,10845,80181,47515,126282,76346,34928,77981,154327,81575,161756
,YangQiaoZhen,341221101,27127,5296,21609,15672,41065,21435,9490,19909,41344,20304,41913
ͬ,TongChengZhen,341221102,31306,4348,23668,13639,46592,23421,11557,23051,46472,23543,47211
̷,TanPengZhen,341221103,32047,5578,24270,15774,47059,24172,10515,23758,47930,23870,48140
ϼ,LaoJiZhen,341221104,25020,4969,20899,14434,40311,20822,11048,19997,40819,20138,41037
,HuaJiZhen,341221105,31225,5704,26967,16345,49747,26941,14796,24723,51664,24758,51725
կ,LvZhaiZhen,341221106,19324,4075,17073,11065,33162,17071,9864,16179,33250,16190,33263
,DanQiaoZhen,341221107,25224,4320,20483,13486,38217,20480,9576,18619,39099,18637,39120
,ZhangGuanZhen,341221108,30273,5932,24898,17407,47869,24740,12108,23074,47814,23415,48313
μ,SongJiZhen,341221109,31656,6373,27572,16219,52419,27204,15748,25147,52351,26205,53777
,ZhangXinZhen,341221110,20421,4087,18129,11154,33291,18037,10233,16503,34540,16612,34741
ͤ,AiTingZhen,341221111,29913,5388,25719,14678,49412,25714,14208,23722,49436,23790,49509
¼,ChenJiZhen,341221112,24308,4799,21574,12491,41220,21572,12723,20226,41798,20256,41830
Τկ,WeiZhaiZhen,341221113,40180,5566,31198,17817,61433,31042,16129,30259,61301,30677,61875
ӭ,YingXianZhen,341221114,30232,4760,24959,15498,48448,24907,14383,24270,49177,24416,49375
ߵ,WaDianZhen,341221115,28896,5240,24026,14892,47590,23872,14042,23781,47653,24152,48178
կ,JiangZhaiZhen,341221116,34831,5370,27788,17041,54263,27122,14537,25505,52627,26950,54738
,MiaoChaZhen,341221117,33158,4739,27434,15884,50846,27299,13489,23641,50940,23952,51386
,HuangLingZhen,341221118,34133,5141,29297,16865,53020,29159,14164,23882,53041,24141,53438
,BaiMiaoZhen,341221119,27475,4105,22183,12951,40568,22051,9544,18673,40724,18941,41124
,GuanMiaoZhen,341221120,33157,4835,27800,15941,50512,27768,13076,23148,50916,23268,51068
ţׯ,NiuZhuangXiang,341221200,29086,4954,23439,15132,42608,23279,8996,19284,42563,19597,43036
,GaoTangXiang,341221201,24976,4367,21809,13829,38526,21802,9776,17304,39106,17310,39119
˼,FanXingJiXiang,341221202,19234,3057,15293,9368,28136,15183,6064,12769,27952,13062,28355
,TuBeiXiang,341221203,31295,5102,24360,15729,46491,24308,11080,22972,47280,23117,47477
л,XieJiXiang,341221204,26351,3885,20140,11073,40217,20113,10371,20374,40487,20467,40607
С,YangXiaoJieXiang,341221205,24817,4462,18536,11903,37006,18454,7985,18413,36867,18728,37264
,TaoLaoXiang,341221206,22349,3340,17474,10302,33286,17318,8631,16399,33717,16846,34320
,TianQiaoXiang,341221207,34062,4529,24687,15059,49098,24643,10738,24572,49215,24642,49329
Ӫ,ZhangYingXiang,341221208,30914,3810,21601,12777,43125,21481,8751,21532,43013,21874,43475
Ӫ,PangYingXiang,341221209,30508,4295,23782,14097,46450,23779,12369,23374,47153,23390,47172
Ȫҵ԰,LinQuanGongYeYuanQu,341221400,21827,2000,14391,9375,27015,14212,5720,14727,28939,15156,29547
ǹ,ChengGuanZhen,341222100,122553,9899,82546,50156,126402,77084,33516,78839,155923,83422,165968
,JiuXianZhen,341222101,31974,4938,23894,15688,45213,23765,9740,22587,46352,22758,46652
˰,ShuiZhenZhen,341222102,23253,4279,18789,12666,35075,18733,8408,16891,35624,17151,35940
Ƥ,PiTiaoSunZhen,341222103,12972,2067,10284,7250,18759,10246,4682,9378,19624,9437,19721
ԭǽ,YuanQiangZhen,341222104,30651,5570,24094,15517,45377,23896,10855,22810,46706,22982,47076
,NiQiuZhen,341222105,32378,4987,25589,16198,47539,25538,12204,23783,49321,23980,49569
,LiXingZhen,341222106,42825,5501,31387,19337,60457,31239,14046,30616,61855,30985,62372
,DaXinZhen,341222107,30783,5290,23233,15932,44126,23204,9348,22117,45321,22188,45421
Ф,XiaoKouZhen,341222108,30786,4965,24388,17195,45065,24275,10306,21323,45598,21669,46057
ؼ,GuanJiZhen,341222109,24226,4676,19533,12942,35804,19463,9072,18243,37706,18441,37974
,SanTaZhen,341222110,32438,6158,25240,17650,48195,25218,12184,25468,50686,25540,50780
˫,ShuangFuZhen,341222111,24164,4015,17753,12416,34951,17647,8242,18516,36163,18668,36421
,CaiMiaoZhen,341222112,14734,2798,11236,8155,22173,11199,5464,11671,22870,11760,22996
,SanTangZhen,341222113,26130,4343,19726,13894,38361,19693,9750,20433,40126,20497,40223
ϼ,MiaoLaoJiZhen,341222114,25040,4396,19519,12381,37532,19463,10581,20441,39904,20498,40017
,ZhaoMiaoZhen,341222115,28662,4798,21837,14922,42725,21546,11120,22447,43993,22743,44580
,GongJiZhen,341222116,21646,3736,17040,11408,31705,16883,9018,17150,34033,17360,34400
̨,FenTaiZhen,341222117,45738,7236,34016,22732,64591,33890,16808,35532,69422,35766,69782
ɽ,HongShanZhen,341222118,39150,5574,28879,16418,57273,28743,14850,30544,59287,30695,59574
ǳ,QingQianZhen,341222119,17851,2975,14101,9992,27331,14076,7867,14551,28627,14592,28693
,WuXingZhen,341222120,22627,3665,16662,11916,32529,16658,7790,17407,34065,17420,34082
,GaoMiaoZhen,341222121,13200,2026,9578,6533,18900,9559,4484,10098,19657,10132,19710
ɣӪ,SangYingZhen,341222122,23648,3459,17158,10754,33561,17123,8626,18488,35611,18575,35733
�,DaMiaoJiZhen,341222123,21783,4096,17078,11883,33300,17015,8796,17461,34476,17597,34675
,RuanQiaoZhen,341222124,24782,4189,18803,12553,36711,18765,9665,19735,38500,19833,38636
˫,ShuangMiaoZhen,341222125,27255,3710,19827,12109,39347,19801,10304,21417,41218,21442,41269
,HuZongXiang,341222200,10710,2093,8205,5909,16111,8169,3695,8180,16349,8293,16498
Լ,ZhaoJiXiang,341222201,22895,3952,17250,12035,33420,17182,7886,17410,34592,17483,34733
,GuoMiaoXiang,341222202,22573,4592,17729,12667,34883,17699,8886,18230,35929,18322,36051
�,MaJiXiang,341222203,21589,3494,15742,10337,31317,15741,7295,16632,32373,16636,32378
,ErLangXiang,341222204,17366,2760,13401,8765,25026,13369,7187,13842,27211,13912,27313
ίԱ,KaiFaQuGuanLiWeiYuanHui,341222400,18998,2007,12645,7748,22626,11469,4846,11769,23238,13206,25851
,FangJiZhen,341225101,17993,2573,15142,8148,25126,15125,6679,12061,27186,12103,27245
и,ZhongGangZhen,341225102,18965,2902,15900,9042,27668,15885,7543,13486,29371,13510,29410
,ChaiJiZhen,341225103,29881,5209,25690,15946,43223,25679,12052,21429,47108,21452,47142
´,XinCunZhen,341225104,22735,4172,20434,13237,34027,20411,9477,15907,36318,15950,36384
,SanTaZhen,341225105,28653,5383,26417,16420,42738,26397,12318,19914,46311,19937,46354
կ,ZhuZhaiZhen,341225106,31826,5553,27538,17109,45035,27515,11901,21708,49223,21742,49280
,LiuGouZhen,341225107,17523,3405,15975,9699,26685,15963,7506,12432,28395,12459,28434
Լ,ZhaoJiZhen,341225108,20895,3791,17746,11106,31266,17713,7832,14725,32438,14772,32518
Ｏ,TianJiZhen,341225109,24783,4326,22174,12873,38945,22174,11320,18244,40418,18255,40429
缯,MiaoJiZhen,341225110,25547,4317,22484,12967,37536,22385,10589,17810,40195,17969,40453
Ƹ,HuangGangZhen,341225111,26360,3852,22479,13104,38118,22440,10812,18462,40902,18545,41024
,JiaoBeiZhen,341225112,26984,4593,24314,14662,40046,24308,11524,18771,43079,18787,43101
կ,ZhangZhaiZhen,341225113,24527,4085,21044,12528,35644,21038,9255,16807,37845,16823,37867
,WangYanZhen,341225114,24751,3740,22569,12445,34928,22560,11241,17149,39709,17163,39732
س,DiChengZhen,341225115,17113,2466,14821,8986,23837,14810,6927,11647,26457,11685,26506
,HongHeQiaoZhen,341225116,33002,3980,24959,14695,46422,24951,13593,25587,50538,25616,50575
Ұ,WangJiaBaZhen,341225117,13324,1899,9164,6667,19078,9118,5300,11274,20392,11359,20523
,WangHuaZhen,341225118,17264,2700,12510,8500,24455,12501,7005,14433,26934,14459,26969
ܼ,CaoJiZhen,341225119,22023,2812,15177,11101,30361,15177,7991,17642,32819,17649,32826
¹,LuChengZhen,341225120,105372,10785,73310,45976,111879,71050,33948,73913,144963,76795,150105
,WangDianZiXiang,341225200,23777,4009,17052,12468,33848,16465,10035,19780,36245,20769,37821
,XuTangXiang,341225201,26347,4910,19143,15473,41331,19138,11768,23854,42992,23882,43025
,HuiLongXiang,341225202,20414,3386,14404,10051,30046,14371,7471,16801,31172,16867,31271
۫,DuanYingXiang,341225204,27033,4279,20373,13968,40405,20356,12984,23884,44240,23923,44296
,GongQiaoXiang,341225205,23615,3640,17372,12015,34270,17364,9957,19821,37185,19840,37212
,LongWangXiang,341225206,14303,2208,10178,7354,19917,10174,5638,11966,22140,11971,22149
ڼ,YuJiXiang,341225207,12923,2035,9095,7088,19333,9094,5441,11304,20398,11304,20399
Ϲ,LaoGuanXiang,341225208,16817,2395,11356,9881,24006,11330,6502,14322,25652,14358,25714
̨۬,GaoTaiXiang,341225209,24580,3464,21952,12261,37320,21951,12238,18319,40270,18330,40282
Ϲҵ԰,FuNanGongYeYuanQu,341225400,11756,1675,9165,5352,15952,9073,4389,8457,17530,8655,17820
ũ,FuMengNongChang,341225500,809,192,643,477,1114,643,245,603,1246,603,1246
,ShenChengZhen,341226100,103218,13035,72125,44268,121246,70477,29034,71405,141882,73162,145287
л,XieQiaoZhen,341226101,53952,6438,36325,26236,62802,36081,16076,39887,75968,40141,76466
,NanZhaoZhen,341226102,23515,4019,17673,13625,32967,17494,8461,18063,35557,18322,35995
,YangHuZhen,341226103,21286,4275,16422,12976,31617,16413,7695,16778,33191,16834,33256
,JiangKouZhen,341226104,31850,5733,25572,18714,46673,25511,13333,25260,50771,25344,50916
,RunHeZhen,341226105,28199,4694,21141,15958,42000,21139,10538,22275,43414,22290,43431
¼,XinJiZhen,341226106,16782,3677,13694,9876,25813,13546,6703,13449,26995,13468,27162
ʮ,LiuShiPuZhen,341226107,25821,4679,20149,14250,37055,19960,9723,19903,39863,20074,40223
,GengPengZhen,341226108,29607,6084,23249,17258,44608,23180,11548,23910,47090,23990,47239
,BanGangZhen,341226109,21810,3958,16940,13167,32931,16691,8505,17242,33933,17333,34273
,WangGangZhen,341226110,19634,3193,14637,9968,28404,14577,7078,15232,29809,15268,29905
,XiaQiaoZhen,341226111,23720,3950,17964,11790,34307,17899,8978,18643,36542,18684,36648
,JiangDianZiZhen,341226112,26230,4226,19010,13434,37964,19002,8979,20374,39376,20425,39435
,ChenQiaoZhen,341226113,19194,3401,13967,10135,27892,13839,6577,14999,28838,15205,29172
,HuangQiaoZhen,341226114,29828,5001,22336,15155,43217,22315,10208,22661,44976,22701,45037
,BaLiHeZhen,341226115,21712,4312,16745,12075,32453,16745,8157,17417,34162,17436,34181
Ϲ,DiGouZhen,341226116,22978,3155,15877,11907,31164,15852,7027,17173,33025,17283,33160
ʮ,XiSanShiPuZhen,341226117,18336,3620,15267,10074,27152,15126,7129,13631,28757,13818,29085
,HongXingZhen,341226118,19889,2994,15095,8622,27765,15058,6572,14258,29316,14360,29455
ʮ,ShiBaLiPuZhen,341226119,26190,4321,21259,13758,36285,21257,8577,17761,39018,17829,39088
³,LuKouZhen,341226120,15874,3108,13437,9123,22936,13435,5578,11073,24508,11123,24560
,JianYingXiang,341226200,35202,5630,28739,17504,50807,28730,12772,24835,53565,24865,53604
ʮ,WuShiPuXiang,341226201,19674,3060,14059,9417,26510,14034,5819,14417,28451,14494,28553
ʢ,ShengTangXiang,341226202,21212,3240,15099,10612,29009,15096,6554,15891,30987,15907,31006
,GuanTunXiang,341226203,17080,2175,11772,8570,23112,11770,4623,12077,23847,12106,23878
,ChuiGangXiang,341226204,12327,1937,8842,6316,17139,8841,3759,9173,18014,9181,18023
,SaiJianHuiZuXiang,341226205,12943,1770,8928,6665,17873,8928,3423,9203,18131,9208,18136
,LiuJiXiang,341226206,32369,4910,23226,16080,43880,23198,10022,23997,47195,24075,47301
ư,HuangBaXiang,341226207,22957,3179,15923,9378,32045,15827,7106,17062,32889,17319,33242
ų,GuChengXiang,341226208,27245,3074,18924,11465,36644,18758,8499,19518,38276,19894,38818
ǰ´,DongChengBanShiChu,341282001,48119,5492,32580,21058,52349,32295,12231,32562,64857,33262,65842
ǰ´,XiChengBanShiChu,341282002,50507,5067,33610,23809,46444,32532,11879,32825,65357,33843,67453
ϰ´,YingNanBanShiChu,341282003,26393,3314,17869,11351,33057,17869,6142,17929,35798,17980,35849
,GuangWuZhen,341282100,32307,4287,23218,14880,44272,23171,10192,23491,46662,23568,46786
Ȫ,QuanYangZhen,341282101,17115,3514,13888,11143,25020,13823,6054,12751,26574,12795,26683
«,LuCunZhen,341282102,12893,2425,10222,7773,18987,10203,4749,9784,19987,9845,20067
�,XinMaJiZhen,341282103,17266,3214,13528,9712,25208,13524,5908,12848,26372,12860,26388
,DaiHuangZhen,341282104,15090,2864,11537,8411,22589,11533,5137,11537,23070,11554,23091
Ӫ,TianYingZhen,341282105,15986,2419,11430,8294,22717,11415,4718,11600,23015,11693,23123
,TaoMiaoZhen,341282106,28252,4926,21129,14884,40241,21129,8360,20409,41538,20409,41538
,WangJiZhen,341282107,19908,3835,16007,12471,29953,16006,7503,15238,31244,15239,31246
ש,ZhuanJiZhen,341282108,22625,3933,17631,11804,33332,17547,8142,16912,34459,17069,34700
˼,GuJiZhen,341282109,16898,3418,13795,9927,25338,13786,6143,12613,26399,12664,26459
,DaiQiaoZhen,341282110,11075,2756,9397,7243,17115,9381,4073,8465,17846,8507,17904
ׯ,ShuZhuangZhen,341282111,12018,2453,9632,7446,18278,9597,4343,9123,18720,9182,18814
,BingJiXiang,341282200,15923,2602,11816,7776,22009,11779,5013,11625,23404,11722,23538
կ,JinZhaiXiang,341282201,11708,1911,8475,6139,16450,8426,3566,8565,16991,8710,17185
կ,RenZhaiXiang,341282202,9589,2104,8052,6129,14459,8037,3597,7207,15244,7238,15290
Žֵ,YongQiaoJieDao,341302001,35839,3532,23805,17595,34283,21498,6935,19664,41162,22501,46306
ӽֵ,DuoHeJieDao,341302002,26645,4426,18274,13061,27122,17950,5111,17146,35096,17908,36182
ֵ,DaoDongJieDao,341302003,22820,2557,14756,8461,21689,12595,4387,12297,24892,15008,29764
ؽֵ,DongGuanJieDao,341302004,34834,3675,23622,13382,32913,20190,6710,19796,39986,21597,45219
ֵ,SanLiWanJieDao,341302005,24626,2228,16215,11056,19390,16069,5420,15907,31976,16059,32274
Ϲؽֵ,NanGuanJieDao,341302006,54456,5125,35707,21716,52267,32228,10622,30486,62714,34496,70203
ؽֵ,XiGuanJieDao,341302007,48827,4821,32412,19089,40641,30927,10630,30165,61092,31866,64278
ؽֵ,BeiGuanJieDao,341302008,26614,3124,17546,10697,23136,15491,5277,15242,30733,17469,35015
ӽֵ,BianHeJieDao,341302009,20914,3052,14608,9459,25894,14060,5462,14254,28314,14820,29428
˽ֵ,SanBaJieDao,341302010,37210,3566,24200,14926,30260,23587,8729,24131,47718,25305,49505
Ƕֵ,ChengDongJieDao,341302011,13270,1533,8827,5067,15261,8640,3027,8684,17324,9003,17830
𺣽ֵ´,JinHaiJieDaoBanShiChu,341302012,28603,2342,17988,10173,23258,16592,6702,17129,33721,19659,37647
,FuLiZhen,341302100,54998,8399,39540,25015,68341,35742,13614,35755,71497,37471,77011
«,LuLingZhen,341302101,56561,6895,36277,22925,71942,35842,13389,38182,74024,40568,76845
ׯ,ZhuXianZhuangZhen,341302102,63233,7482,41100,21397,67470,34851,11784,35614,70465,41399,82499
,ChuLanZhen,341302103,29928,4935,20614,14039,41241,20029,7829,21483,41512,22078,42692
ܴ,CaoCunZhen,341302104,37170,6169,26906,18387,51582,26734,10415,26652,53386,26848,53754
й,JiaGouZhen,341302105,31323,6680,24213,16840,46119,23877,9821,23579,47456,23611,47824
,LanGanZhen,341302106,34661,6999,26306,18587,50801,26280,11206,26487,52767,26560,52866
ʱ,ShiCunZhen,341302107,41541,7832,31201,19386,60054,30152,13314,29348,59500,31486,62687
,YongAnZhen,341302108,29966,5721,21901,14719,43609,21775,8716,22462,44237,22502,44403
ҹ,HuiGuZhen,341302109,19060,3672,13485,8358,27276,13106,5262,13610,26716,14509,27994
,DaDianZhen,341302110,47633,6749,33496,18526,65944,32345,14662,33903,66248,35548,69044
,XiSiPoZhen,341302111,34867,5365,24764,14928,47279,24620,10279,25674,50294,25747,50511
԰,TaoYuanZhen,341302112,58050,7072,39454,24208,76622,39249,16347,40904,80153,42015,81469
ޭ,QiXianZhen,341302113,44375,5400,30291,19282,52745,29622,12481,30694,60316,31965,62256
Ӫ,DaYingZhen,341302114,23335,3461,17145,10398,32647,17134,7754,17388,34522,17405,34550
ׯ,YangZhuangXiang,341302200,21529,4079,15591,11580,30216,15550,5890,15806,31356,15907,31498
֧,ZhiHeXiang,341302201,18570,3522,14228,9792,27505,14204,6254,14103,28307,14118,28346
⼯,JieJiXiang,341302202,31887,5653,23487,15081,46914,23487,10971,25019,48506,25024,48511
ҹ,TaoGouXiang,341302203,16702,3344,12624,9114,24722,12580,5220,12570,25150,12642,25266
˳,ShunHeXiang,341302204,24311,4071,17279,11474,34348,17266,7173,18243,35509,18276,35555
﹵,HaoGouXiang,341302205,24967,4769,18293,12313,36225,18232,7997,19385,37617,19440,37733
簲,MiaoAnXiang,341302206,28049,4298,20020,11571,40018,19758,9447,21129,40887,21774,41794
,YongZhenXiang,341302207,14160,2293,10130,6755,20029,10128,4583,10890,21018,10906,21036
,XiErPuXiang,341302208,12089,1830,8295,5255,16208,8284,3041,8640,16924,8665,16960
йũ,JiaGouNongChang,341302400,607,145,448,348,30,448,135,439,887,439,887
�,DangChengZhen,341321100,118534,12826,77862,42717,144087,68332,25172,69835,138167,78670,156532
,ZhaoTunZhen,341321101,33959,5909,25068,17771,50066,24972,10686,25281,50253,25486,50554
ׯ,LiZhuangZhen,341321102,32878,4622,22339,14980,45352,22055,8317,22809,44864,23478,45817
կ,TangZhaiZhen,341321103,43871,7185,30193,19038,61407,29645,10856,30795,60440,31719,61912
,GeJiZhen,341321104,41180,5764,26689,16558,54732,26640,8401,28518,55158,28656,55345
կ,ZhouZhaiZhen,341321105,42568,6981,29735,19282,58420,28614,10636,28940,57554,30450,60185
,XuanMiaoZhen,341321106,57198,9003,40726,26585,80339,40668,16002,41405,82073,41477,82203
ׯ,GuanZhuangBaZhen,341321107,26417,4653,19844,13557,39463,19670,8989,19754,39424,20215,40059
ׯ,CaoZhuangZhen,341321108,18098,3485,14677,9834,28107,14532,7093,13777,28309,13999,28676
ص,GuanDiMiaoZhen,341321109,47498,8171,34990,22774,69807,34957,15086,35635,70592,35765,70755
¥,ZhuLouZhen,341321110,20587,3884,15476,10365,30683,15272,6620,15300,30572,15615,31091
,LiangLiZhen,341321111,33098,5105,22585,15584,45416,22064,7935,23023,45087,23553,46138
ׯ,ChengZhuangZhen,341321112,32178,5554,23046,14982,46868,23005,9693,24262,47267,24379,47425
ÿ,JingJiKaiFaQu,341321400,12510,1313,8149,5500,14853,8025,2809,8430,16455,8483,16632
Ѧ¥ļӹ԰,XueLouBanCaiJiaGongYuan,341321401,5140,558,3351,1960,7066,3344,1386,3718,7062,3733,7084
,LongChengZhen,341322100,108270,10694,69613,36146,109080,57220,22550,57417,114637,71901,141514
ƿ,HuangKouZhen,341322101,58906,7978,40637,21774,77502,36257,15209,35915,72172,41456,82093
¥,YangLouZhen,341322102,41567,7136,30953,18640,58768,30288,10393,27363,57651,28143,59096
Ƽ,YanJiZhen,341322103,27658,4492,21233,12424,40262,21168,8600,19393,40561,19517,40750
ׯ,XinZhuangZhen,341322104,40215,6798,30382,18277,59106,30130,13054,29285,59415,29685,60067
,LiuTaoZhen,341322105,27684,4526,20038,12259,38319,19752,6806,18245,37997,18978,39016
�,MaJingZhen,341322106,45137,7585,32791,19724,65116,32163,13286,32098,64261,33217,66008
,DaTunZhen,341322107,34699,6102,26794,16575,52326,26719,12553,26409,53128,26560,53354
ׯ,ZhaoZhuangZhen,341322108,34854,6401,27415,17063,53695,27409,13064,26891,54300,26904,54319
¥,DuLouZhen,341322109,35528,6789,26695,17507,52126,26415,11763,26601,53016,27385,54080
,DingLiZhen,341322110,23566,4101,17488,10967,33690,17377,7021,17003,34380,17200,34688
կ,WangZhaiZhen,341322111,36232,7894,28828,19099,55070,28437,13456,28162,56599,28754,57582
¥,ZuLouZhen,341322112,20297,5066,16672,10703,32151,16527,7874,16385,32912,16565,33237
,QingLongJiZhen,341322113,14958,2722,11323,6986,22338,11221,5400,11602,22823,11757,23080
ׯկ,ZhangZhuangZhaiZhen,341322114,41807,8471,31976,19193,63106,31408,14259,31504,62912,32561,64537
,YongGuZhen,341322115,17721,3266,12595,8384,24331,12493,4427,12548,25041,12819,25414
,BaiTuZhen,341322116,18009,3338,13113,9003,25527,12807,5114,12825,25632,13348,26461
,GuanQiaoZhen,341322117,11970,2195,8594,5938,16503,8484,3326,8723,17207,8897,17491
ʥȪ,ShengQuanXiang,341322200,44813,6776,31016,18362,61810,30744,10822,30917,61661,31395,62411
Ƶ,JiuDianXiang,341322201,32688,5712,24106,14324,48382,23693,10670,24076,47769,24964,49070
,SunWeiZiXiang,341322202,26097,5070,19919,12596,38594,19868,8782,19967,39835,20030,39949
ׯ,ZhuangLiXiang,341322203,14561,2923,10884,7584,21307,10884,4748,11346,22230,11348,22232
ʯ,ShiLinXiang,341322204,13125,2475,10491,6257,19420,10467,4969,10033,20500,10078,20569
ؾÿ,XiaoXianJingJiKaiFaQu,341322400,2692,442,1872,1287,3709,1868,764,2014,3882,2026,3898
,LingChengZhen,341323100,98741,8974,64843,35118,110299,56198,24591,58234,114432,67463,132306
Τ,WeiJiZhen,341323101,28074,4739,20140,11444,40283,20019,8378,20859,40878,21051,41191
,HuangWanZhen,341323102,26696,4024,18799,10710,36720,18169,7739,19176,37345,19660,38459
¦ׯ,LouZhuangZhen,341323103,46467,6741,33373,18207,64932,33152,14903,34507,67659,34738,68111
,YangTuanZhen,341323104,41435,5980,29283,15771,58410,29080,12858,30611,59691,30990,60273
,YinJiZhen,341323105,32498,6617,26085,16412,51150,25852,12833,25302,51154,25863,51948
䫹,HuiGouZhen,341323106,22608,4576,18077,11542,34922,17977,8586,17461,35438,17693,35770
ȼ,YouJiZhen,341323107,26675,4439,20309,12258,39060,20145,9579,20152,40297,20384,40693
¥,XiaLouZhen,341323108,38392,6139,27817,15833,55847,27620,12440,28673,56293,29154,56971
,ZhaoYangZhen,341323109,44584,6913,31296,18091,62983,30842,12566,31928,62770,32767,64063
湵,YuGouZhen,341323110,37208,5729,27800,16381,51186,26608,12626,26556,53164,27763,55563
¥,GaoLouZhen,341323111,33084,5973,25445,15313,49658,25140,11998,24979,50119,25610,51055
,FengMiaoZhen,341323112,35451,6626,27833,16844,53508,27479,12825,26634,54113,27069,54902
,XiangYangXiang,341323200,23906,3436,17043,9439,33666,16929,7357,17409,34338,17656,34699
켯,ZhuJiXiang,341323201,26063,3664,19013,9938,37258,18990,8635,19313,38303,19349,38362
·,DaLuXiang,341323202,19181,3410,15238,8948,29456,15169,7314,14476,29645,14667,29905
,DaMiaoXiang,341323203,23146,4640,18468,11779,35587,18352,8590,17617,35969,17908,36376
,ChanTangXiang,341323204,22202,4209,17895,11118,33810,17728,8489,16639,34367,17005,34900
ݼ,YuJiXiang,341323205,26484,3658,18844,10111,36987,18816,8090,19297,38113,19388,38232
ҵ԰,GongYeYuanQu,341323400,8382,951,5807,3171,8243,5409,2196,5385,10794,5722,11529
,SiChengZhen,341324100,69407,7561,46007,27339,76751,42223,15324,42099,84322,46285,92292
ռ,DunJiZhen,341324101,19077,3324,13953,8167,27803,13816,5851,14024,27840,14299,28252
,DingHuZhen,341324102,34834,5565,24012,13159,48816,23601,9094,24424,48025,25481,49493
ݹ,CaoGouZhen,341324103,49243,7772,35062,18462,70981,34799,14766,36079,70878,36719,71781
,ChangGouZhen,341324104,29781,4170,20743,11367,41692,20543,8583,21339,41882,21791,42534
,HuangWeiZhen,341324105,38247,6111,27906,15242,54471,27744,11588,27708,55452,28040,55946
ׯ,DaZhuangZhen,341324106,43460,6616,31022,15684,59492,29683,12244,29576,59259,31298,62320
ɽͷ,ShanTouZhen,341324107,38984,6406,29179,16868,57384,28939,13512,29176,58115,29723,58902
,LiuWeiZhen,341324108,24702,4365,19029,11933,36800,18938,8372,18186,37124,18410,37439
,HeiTaZhen,341324109,46931,7340,34230,20053,67603,34118,14897,34613,68731,34938,69168
,CaoMiaoZhen,341324110,17027,2421,11851,6691,23560,11806,4597,12092,23898,12194,24045
ɽ,PingShanZhen,341324111,41408,6076,28888,16434,57169,28774,11029,29281,58055,29625,58513
·,DaLuKouXiang,341324200,26771,4107,18696,10767,37564,18493,7063,18762,37255,19245,37941
,DaYangXiang,341324201,24553,4038,17917,9829,35489,17888,7603,18194,36082,18277,36194
߷,WaFangXiang,341324202,35475,5600,25915,14487,51686,25572,11108,25392,50964,26268,52183
ؿί,SiXianKaiFaQuGuanWeiHui,341324400,16419,1587,10971,6153,14938,9532,3641,9654,19186,10676,21647
ֵ´,ZhongMiaoJieDaoBanShiChu,341402001,4905,1228,3400,2176,5850,2899,849,2593,5492,3582,6982
Ǹֵ´,YaFuJieDaoBanShiChu,341402002,39090,5337,25221,13754,37409,19308,7839,20205,39513,27045,52266
ţɽֵ´,WoNiuShanJieDaoBanShiChu,341402003,58700,7596,36645,20325,54818,29192,11321,29618,58810,40972,77617
ɽֵ´,FengHuangShanJieDaoBanShiChu,341402004,81925,9266,52255,34942,65838,47384,15460,49023,96407,54396,106651
ӽֵ´,TianHeJieDaoBanShiChu,341402005,30865,3855,19389,11439,24657,16240,5733,17054,33294,21064,40453
ֵ´п,BanTangJieDaoBanShiChuShiKaiFaQu,341402006,31869,2468,19074,7959,23516,12081,4011,12229,24310,19274,38348
˼,LanGanJiZhen,341402100,23568,5277,17784,11794,33980,17597,6137,16742,34339,17198,34982
,SuWanZhen,341402101,25377,5992,20215,14162,36042,20004,6877,17600,37604,18031,38246
ϸ,ZheGaoZhen,341402102,47536,9023,32940,18961,64271,30014,9507,29674,59688,33126,66066
,YinPingZhen,341402103,22381,4050,14734,9218,27908,14296,4143,14668,28964,15840,30574
ĸ,XiaGeZhen,341402104,30772,7628,23802,16192,43355,23245,7179,20412,43657,21777,45579
к,ZhongHanZhen,341402105,18206,4417,13759,9413,25475,13587,4243,12714,26301,13107,26866
ɢ,SanBingZhen,341402106,27345,4111,18267,10861,32374,16923,5802,17091,34014,18991,37258
,TongYangZhen,341402107,33878,9182,25503,16957,47663,24363,6667,22626,46989,24224,49727
´,HuangLuZhen,341402108,19026,5614,14784,11294,26896,14420,3516,12777,27197,13372,28156
,HuaiLinZhen,341402109,35052,5847,24887,17976,45909,24174,8530,23719,47893,24542,49429
,BaZhenZhen,341402110,20087,3731,12717,9666,24954,12559,4353,13757,26316,15454,28171
,MiaoGangXiang,341402200,15192,4379,11122,8787,22485,10993,3769,11913,22906,12218,23340
®,LuChengZhen,341421100,120752,14208,82367,53169,130296,79810,29923,79202,159012,82516,164883
ұɽ,YeFuShanZhen,341421101,26179,4981,19149,12400,35473,18524,6967,17921,36445,18978,38127
ɽ,WanShanZhen,341421102,25504,3728,18634,12389,34152,18336,6941,16986,35322,17539,36173
,TangChiZhen,341421103,22861,4205,17596,12750,30970,17343,6371,15456,32799,15841,33437
,GuoHeZhen,341421104,36598,5395,24810,15013,49114,24429,8842,25315,49744,26025,50835
ţ,JinNiuZhen,341421105,20847,3155,14376,9781,26864,14132,4934,14124,28256,14560,28936
ʯͷ,ShiTouZhen,341421106,22506,2984,15547,9350,29349,15316,5906,15453,30769,15849,31396
ͬ,TongDaZhen,341421107,39212,7453,27682,18142,54374,27505,10225,28670,56175,29208,56890
ɽ,BaiShanZhen,341421108,32004,5715,22676,14845,42743,22276,8252,22660,44936,23295,45971
ʢ,ShengQiaoZhen,341421109,41371,6636,28172,18279,55387,27945,9561,28950,56895,29396,57568
׺,BaiHuZhen,341421110,49761,7827,35151,21963,67299,34354,12587,34391,68745,35024,70175
,LongQiaoZhen,341421111,31111,4670,22732,15136,42179,22628,9103,21622,44250,22152,44884
ɽ,FanShanZhen,341421112,29991,5709,22943,15319,41959,22812,8850,21316,44128,21607,44550
޺,LuoHeZhen,341421113,39672,5484,28707,17327,52241,28444,11192,26151,54595,27641,56348
,NiHeZhen,341421114,52706,8232,40030,24986,71165,39128,14630,34715,73843,35538,75568
,LeQiaoZhen,341421115,38368,5170,27165,16040,51526,26506,8844,24237,50743,25217,52382
̹,KeTanZhen,341421116,39531,5330,27384,16103,53010,27182,9304,26427,53609,26781,54165
®ÿ,AnHuiLuJiangJingJiKaiFaQu,341421400,3560,280,2322,1489,2394,2195,863,2223,4418,2381,4703
ʡ,AnHuiShengXuNiDiQu,341421401,19473,2091,4460,4021,7186,4084,710,4083,8167,17814,22274
ʡ׺ų޹˾,AnHuiShengBaiHuFaMenChangYouXianGongSi,341421402,3113,276,664,689,1086,664,107,702,1366,2832,3496
ʡﷸѵ,AnHuiShengZuiFanJiShuPeiXunZhongXin,341421403,1021,37,127,131,229,126,31,154,280,962,1089
޳,WuChengZhen,341422100,120602,18056,82220,56570,136281,77918,26282,77547,155465,82720,164940
尲,XiangAnZhen,341422101,34462,5532,23573,14346,45495,23328,8156,24225,47553,24577,48150
,ErBaZhen,341422102,33673,6080,22218,15801,43061,22026,6812,22745,44771,24347,46565
,TangGouZhen,341422103,36061,7008,25264,16478,49877,24767,8528,25461,50228,26333,51597
,DouGouZhen,341422104,42362,8089,29300,16454,58307,28729,9388,29684,58413,30539,59839
ʯ,ShiJianZhen,341422105,40357,7504,28337,17081,55220,28072,10331,29224,57296,29855,58192
,YanQiaoZhen,341422106,40944,7078,27988,15908,53355,27046,9771,28531,55577,29805,57793
,KaiChengZhen,341422107,37560,6780,26074,15606,50322,25667,8779,26546,52213,27045,53119
ɽ,ShuShanZhen,341422108,37371,5758,25748,16310,49736,25321,9281,26054,51375,26662,52410
ţ,NiuBuZhen,341422109,43561,5687,28536,15821,57104,27596,9759,29085,56681,30471,59007
,LiuDuZhen,341422110,24484,3974,16264,10379,32614,15944,5443,16992,32936,17637,33901
Ҧ,YaoGouZhen,341422111,23209,3758,15671,9704,30086,15472,5086,15950,31422,16382,32053
,NiChaZhen,341422112,40910,6634,27931,16697,53693,27694,8936,28150,55844,28549,56480
,BaiMaoZhen,341422113,50577,9023,35070,21343,66861,34228,10165,33823,68051,34695,69765
,FuDuZhen,341422114,23675,4233,16652,10179,31281,16588,5390,16519,33107,16646,33298
Ȫ,QuanTangZhen,341422115,35904,6071,24683,15051,48621,24635,8525,25717,50352,25817,50500
յ,HeDianZhen,341422116,26149,4095,17729,9959,34555,17536,5348,17594,35130,17863,35592
,HongMiaoZhen,341422117,26110,4201,18527,10746,35510,18170,6163,17307,35477,17947,36474
߹,GaoGouZhen,341422118,32148,4505,21212,13994,39174,21032,6540,20920,41952,21981,43193
ë,HeMaoXiang,341422200,19115,2672,13182,7663,25684,13163,4523,13050,26213,13128,26310
ʮ,ShiLiDunXiang,341422201,26526,3811,17902,9933,34228,17628,5854,17657,35285,18289,36191
ɽ,KunShanXiang,341422202,24199,2948,15742,9403,31495,15670,5526,16786,32456,16931,32673
,HongXiangXiang,341422203,30737,4253,20535,12394,39660,20377,6876,21069,41446,21331,41866
Ϊÿ,AnHuiWuWeiJingJiKaiFaQu,341422400,150,8,56,14,35,14,3,17,31,105,161
,HuanFengZhen,341423100,72840,10808,51398,34912,91035,50271,17586,48412,98683,49836,101234
,YunCaoZhen,341423101,22844,4013,16357,10464,29825,15905,5016,14982,30887,15516,31873
ͭբ,TongZhaZhen,341423102,18522,3244,13204,8118,24643,13045,4114,12463,25508,12676,25880
ճ,TaoChangZhen,341423103,23708,3541,16144,9649,30653,16023,5138,15920,31943,16243,32387
ͷ,LinTouZhen,341423104,49070,8082,32567,23706,63012,32303,9799,33699,66002,34384,66951
Ϫ,QingXiZhen,341423105,31010,4605,20223,13242,41145,20087,6664,21780,41867,22056,42279
,XianZongZhen,341423106,40398,6311,25784,17435,53559,25217,8859,28840,54057,29784,55568
ѹ,ZhaoGuanZhen,341423107,14558,2258,9261,6206,19425,9204,3448,10840,20044,11003,20264
,LiYangZhen,341424100,105849,16825,71988,49055,119479,68104,22059,68870,136974,72745,144733
,ShenXiangZhen,341424101,72541,11790,49391,28712,98034,48520,17544,51248,99768,52484,101875
,BaiQiaoZhen,341424102,24943,5714,17233,11837,35368,17192,6093,19310,36502,19517,36750
,LaoQiaoZhen,341424103,33479,6536,22864,13934,46726,22735,8890,25280,48015,26041,48905
,GongQiaoZhen,341424104,25091,4900,17501,11400,36549,17449,7848,20128,37577,20338,37839
,XiBuZhen,341424105,31497,6320,21763,13738,44492,21359,8293,23898,45257,24347,46110
Ȫ,XiangQuanZhen,341424106,24267,4997,16542,10056,32700,16372,4896,17327,33699,17618,34160
ڽ,WuJiangZhen,341424107,39752,8125,26910,18514,51499,26620,7207,27557,54177,28174,55084
ƺ,ShanHouZhen,341424108,18544,3180,12779,7618,25551,12695,4630,13462,26157,13575,26354
ʯ,ShiYangZhen,341424109,20904,4233,14347,10377,26015,13883,4596,14019,27902,15386,29733
ʡؾÿ,AnHuiShengHeXianJingJiKaiFaQu,341424400,473,12,140,95,0,75,8,99,174,353,493
нֵ,ZhongShiJieDao,341502001,56775,7709,35173,17133,53058,24650,9116,24450,49100,38427,73600
нֵ,DongShiJieDao,341502002,30247,3824,18238,11336,21704,15761,4705,15784,31545,20538,38776
Žֵ,SanLiQiaoJieDao,341502003,34418,3298,22371,15159,22914,20305,6699,19811,40116,22044,44415
ǽֵ,WangChengJieDao,341502004,27891,2285,17934,7514,23747,11862,4329,11972,23834,16571,34505
ˮӽֵ,QingShuiHeJieDao,341502005,16027,1681,10530,6717,16030,10508,3465,10591,21099,10643,21173
ľ,MuChangZhen,341502100,21154,3042,14535,8570,28553,14424,5504,15021,29445,15165,29700
ͷ,MaTouZhen,341502101,17324,2464,11785,7269,23491,11749,4472,12392,24141,12475,24260
,DongQiaoZhen,341502102,22024,2951,14773,9248,30095,14707,5654,15759,30466,15856,30629
ŵ,ZhangDianZhen,341502103,30077,4686,20323,11527,40940,20302,6914,21326,41628,21354,41677
ë̹,MaoTanChangZhen,341502104,16179,1914,11290,5142,14446,8336,2757,8136,16472,9560,20850
ӿ,DongHeKouZhen,341502105,24126,5046,18258,10804,35003,18216,6401,17236,35452,17315,35573
˫,ShuangHeZhen,341502106,23644,4136,16670,10109,33110,16047,5929,16321,32368,17039,33709
ʩ,ShiQiaoZhen,341502107,29841,4827,20638,11935,42480,20457,7855,21541,41998,21885,42523
,SunGangZhen,341502108,30464,4617,21079,12368,42892,21039,8339,22120,43159,22341,43420
ʮ,SanShiPuZhen,341502109,45611,5416,29753,17658,58936,28449,10718,31053,59502,31992,61745
,ChunShuZhen,341502110,21623,3053,13857,8811,28959,13838,4645,15361,29199,15464,29321
Ǳ,ChengBeiXiang,341502200,32781,3382,19545,11038,37891,17793,6351,19088,36881,22969,42514
̶,WengDunXiang,341502201,15148,1969,9962,6436,20948,9936,4019,11043,20979,11174,21136
Ķ,PeiDongXiang,341502202,20876,3243,14164,9056,29829,14163,5770,15712,29875,15725,29889
е,ZhongDianXiang,341502203,17166,2593,11230,7026,23418,11142,3837,12261,23403,12366,23596
,HengTangGangXiang,341502204,10535,2159,7711,5103,15472,7693,2959,7892,15585,7942,15653
,XianShengDianXiang,341502205,17344,2206,10978,6613,23266,10955,3980,12417,23372,12552,23530
�ÿ,LiuAnJingJiKaiFaQu,341502400,22521,1133,13500,8504,8993,10602,3851,11762,22364,14005,27505
¥ֵ,GuLouJieDao,341503001,49448,5487,30663,11318,36863,16649,9069,16585,33234,33341,64004
нֵ,XiShiJieDao,341503002,27086,3486,17194,14949,18139,16657,4481,17284,33941,17859,35053
Сɽֵ,XiaoHuaShanJieDao,341503003,27732,1568,17907,11499,12681,17189,6776,17721,34910,18169,36076
ղ,SuBuZhen,341503100,48637,6503,31521,20097,64243,30870,11184,34299,65169,34803,66324
ڶ,HanBaiDuZhen,341503101,26123,4706,18257,12427,36121,18181,7059,19519,37700,19631,37888
°,XinAnZhen,341503102,46743,5606,29652,18317,60068,29373,10307,32291,61664,33004,62656
˳,ShunHeZhen,341503103,25691,3563,16814,11482,35157,16793,6712,18975,35768,19152,35966
ɽ,DuShanZhen,341503104,42739,5331,28872,16330,57761,27880,11406,29898,57778,30604,59476
ʯŵ,ShiPoDianZhen,341503105,24356,3605,17581,10887,33955,17206,7163,16971,34177,17543,35124
,ChengNanZhen,341503106,28567,2809,18040,10857,32061,16038,5925,17240,33278,19261,37301
,DingJiZhen,341503107,30460,4333,19604,12624,41361,19576,7509,22600,42176,22698,42302
,GuZhenZhen,341503108,25247,3216,16318,11996,33885,16316,6396,18513,34829,18541,34859
켯,XuJiZhen,341503109,21076,3349,14802,10402,29245,14567,5839,15313,29880,15462,30264
·,FenLuKouZhen,341503110,26706,3826,17670,11804,36164,17605,6774,19353,36958,19636,37306
ҵ,JiangJiaDianZhen,341503111,18174,3457,12968,9183,26421,12415,5195,12919,25334,13858,26826
,DanWangXiang,341503200,14792,3351,11785,9208,23337,11785,6010,12368,24153,12368,24153
ɽ,QingShanXiang,341503201,20766,3548,14656,9557,29885,14448,6239,15596,30044,15897,30553
ʯ,ShiBanChongXiang,341503202,11051,1967,8155,5567,16109,8129,3674,8463,16592,8537,16692
ӿ,XiHeKouXiang,341503203,15451,2882,11017,7473,22261,10913,4367,11556,22469,11683,22700
ƽ,PingQiaoXiang,341503204,43063,3245,26915,18819,21485,26478,8691,27475,53953,28084,54999
޼,LuoJiXiang,341503205,19008,3514,13313,9072,27564,13244,5521,14575,27819,14730,28043
ʨӸ,ShiZiGangXiang,341503206,17501,2593,12341,7910,24382,12289,4916,12619,24908,12669,25010
ԣÿ,LiuAnShiYuAnQuJingJiKaiFaQu,341503400,8348,995,5393,3646,10666,5386,1727,5645,11031,5677,11070
ٴ,ShouChunZhen,341521100,88162,11679,59312,41304,105384,51550,18052,50484,102034,58581,117893
˫,ShuangQiaoZhen,341521101,26962,5345,20743,14294,39119,20507,8831,19993,40500,20395,41138
,JianGouZhen,341521102,21985,4264,17539,13239,31540,17526,6866,15437,32963,15576,33115
ׯ,FengZhuangZhen,341521103,16243,3409,13432,9864,23512,13396,5102,11232,24628,11322,24754
,ZhengYangGuanZhen,341521104,30189,5406,22614,18007,41023,22479,7548,20282,42761,20529,43143
ӭ,YingHeZhen,341521105,32030,6291,25634,19119,44292,25425,9577,21951,47376,22264,47898
,BanQiaoZhen,341521106,27499,5573,21863,15349,38731,21759,7500,18550,40309,18709,40572
,AnFengTangZhen,341521107,21635,4487,17233,13528,30379,17151,6161,14829,31980,15050,32283
߿,YanKouZhen,341521108,30895,5996,23495,15913,42707,22892,8234,20619,43511,21630,45125
,BaoYiZhen,341521109,34551,5127,23263,16472,46223,23176,8355,24529,47705,24770,48033
,YinXianZhen,341521110,30041,4308,19578,13964,40046,19512,6819,21385,40897,21590,41168
,AnFengZhen,341521111,46081,7332,30441,23598,58831,29548,9882,31555,61103,32854,63295
,ZhongXingZhen,341521112,30985,4541,20460,15944,40458,20455,6981,22043,42498,22047,42507
,ChaAnZhen,341521113,18217,2818,12258,8681,24506,12179,4201,12819,24998,12978,25236
,SanJiaoZhen,341521114,34862,5411,23249,18550,46692,23188,7821,24606,47794,24845,48094
,YanLiuZhen,341521115,41040,5858,27196,19947,53844,27096,8470,27859,54955,28172,55368
,LiuGangZhen,341521116,20563,3760,14119,11147,27231,13973,4388,14440,28413,14592,28711
˫�,ShuangMiaoJiZhen,341521117,16043,2647,11049,8321,21398,10971,3862,11333,22304,11503,22552
С,XiaoDianZhen,341521118,34665,6369,24469,19334,47551,24451,8530,24959,49410,25095,49564
߲,WaBuZhen,341521119,17141,2812,11834,9275,23139,11761,4146,12168,23929,12265,24099
˳,DaShunZhen,341521120,22390,4014,15191,14013,30284,15172,5208,16334,31506,16421,31612
˹ɽ,BaGongShanXiang,341521200,13081,1934,8757,7081,15959,8742,2746,8971,17713,9004,17761
,ZhangLiXiang,341521201,25333,4225,16899,13602,34076,16843,5467,18064,34907,18126,35025
Ҥ,YaoKouXiang,341521202,19349,3732,13322,10919,26093,13319,4539,14184,27503,14298,27620
յ,TaoDianHuiZuXiang,341521203,7215,1363,5026,4028,10020,5003,1752,5200,10203,5304,10330
ũ,ShouXiHuNongChang,341521500,6062,1377,4514,3237,6595,4325,1377,4188,8513,4302,8816
ũ,ZhengYangGuanNongChang,341521501,1651,404,1234,991,1809,1233,349,1151,2384,1170,2404
ǹ,ChengGuanZhen,341522100,83244,8952,53572,34200,93206,50074,16728,51622,101696,55352,108924
ӿ,HeKouZhen,341522101,15850,2268,10555,6571,21269,10421,3513,10974,21395,11076,21631
ܼ,ZhouJiZhen,341522102,39499,5568,27996,18084,55227,27518,12880,29283,56801,29951,57947
ˮ,LinShuiZhen,341522103,34461,4209,24937,16487,48559,24933,12326,26055,50988,26059,50996
µ,XinDianZhen,341522104,37848,6143,26536,16469,50941,25908,10694,27587,53495,28149,54685
ʯ,ShiDianZhen,341522105,28757,3783,18573,10843,38972,18468,7009,20823,39291,20976,39549
,MaDianZhen,341522106,25666,3174,16700,9588,34526,15373,6873,16887,32260,19013,35713
ϼ,MengJiZhen,341522107,32712,4221,21992,13590,46175,21971,9860,24643,46614,24801,46793
԰,HuaYuanZhen,341522108,23526,3125,15470,9598,31511,15436,6236,17371,32807,17417,32887
,HuHuZhen,341522109,33101,4704,21619,12805,44357,21573,7883,23985,45558,24069,45688
,ChangJiZhen,341522110,20649,2630,13481,8274,26654,13090,4793,14090,27180,14591,28072
鼯,HongJiZhen,341522111,22211,3427,14867,9827,30770,14732,5854,16566,31298,16625,31492
Ҧ,YaoLiZhen,341522112,33129,4288,21832,13027,44761,21811,8854,24402,46213,24439,46271
,WuLongZhen,341522113,25545,3175,16219,10097,34168,16201,5926,18360,34561,18427,34646
,GaoTangZhen,341522114,26862,3525,18275,12623,37681,18265,8237,20264,38529,20349,38624
̶,LongTanZhen,341522115,21419,3074,14386,9677,29042,14302,5408,15392,29694,15515,29901
·,ChaLuZhen,341522116,21287,2678,13778,8168,28467,13760,4929,15060,28820,15116,28894
뾮,FengJingZhen,341522117,42616,5163,27840,17232,53772,26808,12560,28428,55236,32499,60339
˼,ZhongXingJiZhen,341522118,19219,3023,13104,8407,27021,13070,5103,14160,27230,14241,27345
ĵ,XiaDianZhen,341522119,21992,3124,14733,10979,30166,14723,5940,16263,30986,16323,31056
,CaoMiaoZhen,341522120,20313,2720,13184,9055,28036,13143,5304,14951,28094,15153,28337
´,ZhenQuBanShiChu,341522121,43766,5027,29748,18780,54950,28658,12215,30395,59053,31260,61008
ƽڰ´,PingGangBanShiChu,341522122,10591,1685,7238,4565,14149,7117,2883,7735,14852,7921,15159
,PengTaXiang,341522200,22381,3311,15218,9561,32422,15211,7172,17527,32738,17646,32864
,WangJieLiuXiang,341522201,21359,3569,16122,11098,32553,16107,8093,16868,32975,16899,33021
,FanQiaoXiang,341522202,18411,2583,12545,7536,25291,12382,5669,13094,25476,14118,26663
ٻ,LinHuaiGangXiang,341522203,23620,4194,17038,11922,34193,17038,6864,17638,34676,17640,34678
,ChengXiHuXiang,341522204,28067,4279,20274,13832,40292,20273,8663,20728,41001,20735,41009
ε,SongDianXiang,341522205,24373,3939,17186,11274,34728,17148,7014,18090,35238,18140,35326
,SanLiuXiang,341522206,20528,3048,13941,9339,28781,13935,5444,15030,28965,15079,29020
۸,ShaoGangXiang,341522207,17112,2643,11752,7356,23841,11750,4397,12366,24116,12400,24152
,BaiLianXiang,341522208,22036,2728,14430,8681,29842,14426,5377,15681,30107,15711,30141
˼,PanJiXiang,341522209,26416,4018,18223,10758,36658,18038,7679,19600,37638,19890,38113
,FengLingXiang,341522210,28902,3926,19556,10718,41271,19544,8524,21783,41327,21796,41352
,SunGangXiang,341522211,23229,3474,15544,9212,30274,15129,5965,16923,32052,17124,32668
Ԫ,SanYuanXiang,341522212,18087,2844,12127,7345,24188,11904,4473,12853,24757,13277,25404
ǹ,ChengGuanZhen,341523100,137261,17126,93816,56088,157118,78564,28796,74414,152978,89367,183183
,XiaoTianZhen,341523101,15986,3722,11921,9313,22275,11747,3689,11249,22996,11476,23397
Ϫ,TaoXiZhen,341523102,21797,2990,14602,9841,26161,14011,4379,14120,28131,14564,29166
,WanFoHuZhen,341523103,18507,3991,14480,9506,25998,14098,5126,12841,26939,13144,27624
ǧ,QianRenQiaoZhen,341523104,23983,5257,18257,12561,32117,17501,6460,16635,34136,17443,35700
,BaiShenMiaoZhen,341523105,19112,3895,14227,8980,27080,14209,5072,13785,27994,13852,28079
,HangBuZhen,341523106,22023,4970,16565,11861,30414,16018,5658,15783,31801,16086,32651
,ShuChaZhen,341523107,11885,2899,9893,7410,17507,9863,3518,8346,18209,8409,18302
ϸ,NanGangZhen,341523108,28139,4975,19727,12870,37871,19684,6599,19874,39558,19986,39713
,GanChaHeZhen,341523109,31664,5499,21868,13124,42719,21739,7044,22227,43966,22339,44207
ĸ,ZhangMuQiaoZhen,341523110,10772,3356,9762,7418,17157,9738,3805,8094,17832,8171,17933
,WuXianZhen,341523111,14055,3578,11613,8315,21322,11505,4370,10260,21765,10390,22003
ɽ,ShanQiZhen,341523112,15469,3273,12247,8256,21966,12231,3677,10108,22339,10172,22419
,HePengZhen,341523113,10174,2084,8212,5660,14439,8212,2606,6652,14864,6652,14864
,TangChiZhen,341523114,25826,5048,21203,14083,36440,20837,6709,15987,36824,16380,37583
,ChunQiuXiang,341523200,16229,3162,12085,8102,22490,12065,3569,10812,22877,10875,22960
,BoLinXiang,341523201,23463,3856,16355,11595,31247,16277,5091,15902,32179,16055,32410
,TangShuXiang,341523202,25166,3662,16807,10283,33574,16789,5439,17387,34176,17460,34267
ڵ,QueDianXiang,341523203,21215,3796,14449,10191,29084,14446,4576,15086,29532,15138,29587
߷,GaoFengXiang,341523204,14682,2764,10401,7608,20211,10370,3417,10354,20724,10462,20863
®,LuZhenXiang,341523205,10724,1823,7015,5376,14451,7011,2098,7603,14614,7630,14645
ؾÿ,ShuChengXianJingJiKaiFaQu,341523400,13586,1257,8719,5834,11936,8263,2874,8828,17091,8998,17717
÷ɽ,MeiShanZhen,341524100,80901,10656,53483,38331,97873,52005,20233,56333,108338,58307,111790
鲺,MaBuZhen,341524101,8905,1489,6037,4464,11622,6013,1967,6124,12137,6324,12361
ɽ,QingShanZhen,341524102,15027,2196,9818,6150,19199,9483,3194,10482,19965,10599,20417
Ӻ,YanZiHeZhen,341524103,17552,2923,12024,8862,23710,11246,4447,12152,23398,12898,24922
կ,TianTangZhaiZhen,341524104,9937,1513,6861,4810,13717,6783,2832,7304,14087,7421,14282
ű,GuBeiZhen,341524105,18651,3230,14021,9941,26670,13391,5987,13386,26777,13847,27868
ҵ,WuJiaDianZhen,341524106,13037,1969,9472,6393,18637,9072,4115,9182,18254,9649,19121
԰,BanZhuYuanZhen,341524107,13254,1492,8878,5775,16490,8383,3292,8635,17018,9160,18038
һ,TangJiaHuiZhen,341524108,15641,3419,12576,9228,24534,12212,6398,12418,24630,12882,25458
Ϫ,NanXiZhen,341524109,30137,4195,20749,12028,41251,12840,7865,13585,26425,21448,42197
˫,ShuangHeZhen,341524110,11874,1989,8635,6173,16409,8439,3684,8648,17087,8912,17547
,BaiTaFanXiang,341524200,26136,4010,18746,11430,36655,18626,8308,19529,38155,19708,38454
ų,ZhangChongXiang,341524201,6991,1194,4768,3330,9655,4723,1617,4974,9697,5034,9802
ͷ,YouFangDianXiang,341524202,15659,2507,10565,6610,21285,10395,3600,11033,21428,11201,21766
,ChangLingXiang,341524203,8154,1444,5987,4260,11547,5986,2403,6006,11992,6014,12001
,HuaiShuWanXiang,341524204,12953,2403,9603,6454,18862,9529,3985,9636,19165,9738,19341
ʯ,HuaShiXiang,341524205,6126,1281,4534,3446,8974,4413,1967,4703,9116,4840,9374
ɳ,ShaHeXiang,341524206,9867,1100,6416,3587,13157,6256,2421,6826,13082,6972,13388
,TaoLingXiang,341524207,11833,2341,9177,6566,17849,9062,4077,8965,18027,9074,18251
԰,GuoZiYuanXiang,341524208,9131,1127,5978,3394,12403,5942,2364,6593,12535,6644,12622
,GuanMiaoXiang,341524209,5111,806,3690,2632,7025,3648,1483,3614,7262,3710,7400
ȫ,QuanJunXiang,341524211,3982,809,2984,2162,5929,2951,1516,3265,6216,3323,6307
,TieChongXiang,341524214,6137,964,4458,2876,9072,4353,2254,4748,9101,4897,9355
ÿ,JingJiKaiFaQu,341524400,1857,158,1061,638,1618,909,379,950,1859,1333,2394
ɽ,HengShanZhen,341525100,52575,5850,34536,23226,50481,33499,10399,33063,66562,34288,68824
,FoZiLingZhen,341525101,11211,1830,7313,4610,14073,6749,1955,7074,13823,7683,14996
·,XiaFuQiaoZhen,341525102,11106,1674,7400,4513,15246,7229,2668,7723,14952,8048,15448
,DanJiaMiaoZhen,341525103,8541,1472,6030,3778,11774,6019,2128,6064,12083,6111,12141
,YuErJieZhen,341525104,22757,3747,15643,8458,29802,15138,4700,15017,30155,15561,31204
ʯ,HeiShiDuZhen,341525105,15835,2334,10194,5910,20501,10045,2850,10474,20519,10825,21019
,ZhuFoAnZhen,341525106,18255,3201,12961,8407,23907,12411,4008,11975,24386,12503,25464
,LuoErLingZhen,341525107,5986,968,3958,2450,7958,3958,1177,4169,8127,4173,8131
ĥ̶,MoZiTanZhen,341525108,9118,1343,5746,3209,11389,5417,1480,5804,11221,6195,11941
ƺ,DaHuaPingZhen,341525109,14218,2391,9456,6244,19270,9420,3027,10047,19467,10180,19636
ˮ,ManShuiHeZhen,341525110,13536,1901,8274,4825,17587,7916,2358,8677,16593,9521,17795
ʿ,ShangShiShiZhen,341525111,10597,1548,7167,4530,13567,6574,2400,6671,13245,7378,14545
,DanLongSiXiang,341525200,8127,1596,5238,3454,10643,5054,1602,5190,10244,6087,11325
Ϫ,DongXiXiXiang,341525201,7185,1208,4696,2771,9576,4659,1436,5038,9697,5133,9829
̫ƽ,TaiPingFanXiang,341525202,7277,1214,5169,3483,10141,5062,1764,4908,9970,5086,10255
̫,TaiYangXiang,341525203,5506,680,3546,2112,6987,3365,1077,3443,6808,3717,7263
ÿ,JingJiKaiFaQu,341525400,11941,1177,7493,4171,10720,6643,2210,6733,13376,7835,15328
Ϸ¥´,HuaXiLouBanShiChu,341602001,43825,4464,28511,15881,44056,23701,8987,23764,47465,28765,57276
Ѧ´,XueGeBanShiChu,341602002,92869,6437,60734,37159,75824,57748,23462,60498,118246,62034,122768
´,TangLingBanShiChu,341602003,59940,5176,40083,25169,56626,37849,14745,38576,76425,39778,79861
ž,GuJingZhen,341602100,47217,5733,31541,19114,63115,31315,11919,33300,64615,33328,64869
«,LuMiaoZhen,341602101,23055,3315,16719,10597,32361,16517,6435,15728,32245,16086,32805
٢,HuaTuoZhen,341602102,29243,3871,20045,12258,39666,19911,7418,20193,40104,20487,40532
κ,WeiGangZhen,341602103,33311,4988,23360,14417,45758,23032,8734,23324,46356,23673,47033
ţ,NiuJiZhen,341602104,39947,6312,28875,19281,56593,28858,11639,28892,57750,29023,57898
ռ,YanJiZhen,341602105,30929,4793,22312,15012,42943,22249,8879,22135,44384,22289,44601
,WuMaZhen,341602106,25318,3806,17048,11884,34206,16930,6098,17802,34732,18174,35222
ʮ,ShiBaLiZhen,341602107,41991,5666,29432,18546,57750,29427,11195,29327,58754,29420,58852
۶,QiaoDongZhen,341602108,41308,5678,28667,18508,55942,28269,10453,28369,56638,28772,57439
ʮ,ShiJiuLiZhen,341602109,45965,5185,31621,19467,58635,29959,11597,30698,60657,31126,62747
ɳ,ShaTuZhen,341602110,33228,5054,23551,16166,46452,23376,10452,24869,48245,25183,48734
,GuanTangZhen,341602111,42341,5006,29667,18344,58638,29542,14406,31852,61394,32086,61753
,DaYangZhen,341602112,39716,5526,27792,16333,55801,27415,12338,29082,56497,29788,57580
Ǹ,ChengFuZhen,341602113,38716,5171,27928,16626,57618,27832,13989,29750,57582,29948,57876
ʮ,ShiHeZhen,341602114,40581,6094,29111,17709,58599,29011,13455,30799,59810,31019,60130
˫,ShuangGouZhen,341602115,49718,7244,35072,22314,71349,34975,16099,37759,72734,37989,73061
Ǻ,FeiHeZhen,341602116,26744,4344,19081,11949,39011,19046,8391,20310,39356,20398,39479
ų,GuChengZhen,341602117,32941,4594,22937,15035,44271,22647,9899,24094,46741,24497,47434
,LongYangZhen,341602118,29840,5081,22989,16017,44429,22940,11309,23133,46073,23241,46230
,LiDeZhen,341602119,30296,3814,21108,12749,43627,21023,9942,22849,43872,22944,44052
ŵ,ZhangDianXiang,341602200,27225,3783,18585,12154,37374,18398,7514,19433,37831,19937,38522
,ZhaoQiaoXiang,341602201,37542,4991,26158,16255,51386,26094,11111,27351,53445,27486,53644
оü�,BoZhouShiJingJiJiShuKaiFaQu,341602400,14335,1103,9240,5643,13710,9231,3600,9771,19002,9798,19038
ǹ,ChengGuanZhen,341621100,78022,7019,52235,34114,86847,50391,22109,52706,103097,54915,107150
,ChengXiZhen,341621101,28280,3561,20354,12314,39034,20349,9967,21442,41791,21454,41808
Ƕ,ChengDongZhen,341621102,20168,2722,14405,8701,28640,14382,6646,14994,29376,15131,29536
,XiYangZhen,341621103,23403,3623,17163,9939,33958,17159,7663,17505,34664,17526,34689
˫,ShuangMiaoZhen,341621104,30695,4251,23841,14573,47028,23820,13254,24300,48120,24359,48200
,ChuDianZhen,341621105,25956,4236,19675,11809,39002,19653,9472,19785,39438,19989,39664
߹,GaoGongZhen,341621106,22188,3696,17215,10989,34647,17211,9276,17923,35134,17945,35160
բ,ZhaBeiZhen,341621107,46397,6046,33092,19384,65176,33006,14635,33857,66863,33986,67078
¯,GaoLuZhen,341621108,26822,4183,19753,12954,38079,19744,8645,19794,39538,19897,39650
,CaoShiZhen,341621109,42090,6352,31214,18351,61460,31126,15165,32202,63328,32393,63607
,QingDingZhen,341621110,42425,5837,31198,20475,62390,31169,15391,32235,63404,32455,63653
ʯ,ShiGongZhen,341621111,27354,4233,20556,13219,38911,20547,9693,20686,41233,20724,41280
ɽ,LongShanZhen,341621112,33715,4842,26183,17318,48000,26179,13348,25709,51888,25722,51905
,YiMenZhen,341621113,47272,5868,32601,18121,67069,32569,14611,35082,67651,35150,67751
,XinXingZhen,341621114,37029,5825,27722,18416,56510,27710,13847,28936,56646,28979,56701
ٺ,LinHuZhen,341621115,32851,5098,23983,16451,48952,23965,11626,25571,49536,25592,49575
,DanChengZhen,341621116,31504,4724,24293,16322,46985,24281,12755,24656,48937,24690,48983
꼯,MaDianJiZhen,341621117,26704,3612,18908,12400,37287,18672,9362,19303,37975,20770,39678
,HuaGouZhen,341621118,26091,4224,19475,13175,39025,19474,9344,20179,39653,20184,39659
꼯,DianJiZhen,341621119,20934,2859,15472,9411,31255,15472,7669,15990,31462,15990,31462
´,ChenDaZhen,341621120,25837,4159,19858,13040,39733,19828,10468,20532,40360,20606,40464
Ʒ,PaiFangZhen,341621121,49411,6300,35843,22359,71763,35839,20098,39927,75766,39966,75809
,GongJiSiZhen,341621122,25466,3975,17887,11090,37211,17884,7819,19363,37247,19373,37260
,BiaoLiZhen,341621123,29330,4256,21783,14264,44455,21781,11113,22912,44693,22916,44699
ֳ,DanJiLinChang,341621400,11270,1746,8080,5311,16204,8080,3617,8552,16632,8553,16633
ǹ,ChengGuanZhen,341622100,77724,7517,54520,33449,79234,50992,22999,50727,101719,53720,108240
˫,ShuangJianZhen,341622101,36231,5086,27200,15663,52507,27189,12353,26412,53601,26470,53670
С,XiaoJianZhen,341622102,34447,5505,26128,16961,50413,25853,11504,24768,50621,25328,51456
԰´򼶵λ,QiYuanBanShiChuZhenJiDanWei,341622103,38363,5199,27840,16400,52604,27489,12076,27244,54733,27798,55638
̳,TanChengZhen,341622104,29433,4694,23414,14595,42491,23397,10986,21626,45023,21699,45113
ҵ԰򼶵λ,FanJiGongYeYuanQuZhenJiDanWei,341622105,9366,1167,7190,4361,12781,7179,3505,6804,13983,6848,14038
,XuTuanZhen,341622106,44924,5020,32477,18237,61099,32458,15005,32072,64530,32472,64949
ż,BanQiaoJiZhen,341622107,46767,5762,34710,19765,65619,34691,16761,34465,69156,34580,69290
�,MaJiZhen,341622108,35576,5240,27837,16585,50457,27821,13925,26847,54668,26904,54741
,YueFangZhen,341622109,33228,4841,25088,14758,49360,25054,12602,25461,50515,25583,50671
,LiCangZhen,341622110,44701,8085,35347,22916,70277,35336,19424,36685,72021,36863,72210
,ChuCunZhen,341622111,38506,7693,30227,20584,60500,30214,17038,32922,63136,33010,63237
,LeTuZhen,341622112,48176,7455,35900,22862,70823,35893,18757,38423,74316,38488,74388
,SanYiZhen,341622113,33051,5790,25859,16792,51814,25859,14245,27224,53083,27227,53086
,LiBaZhen,341622114,24979,4938,19626,13709,39493,19593,10860,21070,40663,21151,40777
ɳũҵίԱᣨ򼶵λֱϽ弶λ,MengChengXianNongYeWeiYuanHuiZhenJiDanWeiZhiXiaCunJiDanWei,341622198,1139,138,792,530,1521,792,375,857,1649,860,1652
ׯܰ´缶λ,ZhuangZhouBanShiChuXiangJiDanWei,341622200,35243,4083,25032,14682,44637,23874,11341,24033,47907,25635,50667
,WangJiXiang,341622201,38906,5509,28253,17412,55271,28234,13524,29603,57837,29686,57939
С,XiaoXinJiXiang,341622202,41396,6234,30770,18892,61690,30425,16027,32212,62637,32887,63657
ҵι˾ú,HuaiBeiKuangYeJiTuanYouXianZeRenGongSiXuTuanMeiKuang,341622401,2612,0,142,147,2,95,0,141,236,2470,2612
ֳ,BaiYangLinChang,341622500,9135,1497,6699,4577,13360,6686,3417,7242,13928,7350,14049
ǹ,ChengGuanZhen,341623100,102181,10613,73916,45127,121335,72477,36539,73270,145747,75417,149333
,KanTuanZhen,341623101,41731,7000,35028,21466,62061,34974,17120,30669,65643,30823,65851
Ŵ,ZhangCunZhen,341623102,41230,6288,33051,20016,61277,33048,16001,30457,63505,30468,63519
,JiangJiZhen,341623103,36357,5334,29030,16727,53346,29003,14602,27203,56206,27263,56293
ɳ,JiuChengZhen,341623104,33983,4462,26792,13529,51109,26772,14795,26313,53085,26448,53240
¥,XiPanLouZhen,341623105,30808,4536,24679,14548,44428,24670,12157,22705,47375,22822,47501
Ｏ,SunJiZhen,341623106,22098,3419,17897,10600,33601,17880,9153,16715,34595,16773,34670
꼯,RuJiZhen,341623107,33419,5720,26829,16659,50355,26798,13111,25353,52151,25421,52250
,GongDianZhen,341623108,32500,6472,27064,18139,49865,27034,12926,24696,51730,24834,51898
,WangRenZhen,341623109,22685,5246,18945,13876,37210,18934,10194,19077,38011,19180,38125
,WangShiZhen,341623110,26157,4528,19746,12770,38885,19736,9790,20691,40427,20729,40475
,YongXingZhen,341623111,21381,4082,16675,11962,32819,16666,8436,17199,33865,17224,33899
,MaDianZiZhen,341623112,29070,5429,23242,15214,45387,23236,12383,23600,46836,23640,46882
,DaLiJiZhen,341623113,22714,4549,18053,12714,35786,18050,9949,19112,37162,19159,37212
,HuJiZhen,341623114,36625,6358,28633,17438,55660,28568,15943,29688,58256,30293,58926
չ,ZhanGouZhen,341623115,16248,3093,11789,8579,24608,11787,6016,13530,25317,13568,25357
̼Ҽ,ChengJiaJiZhen,341623116,24231,4704,19762,12240,39196,19747,11921,20950,40697,21094,40856
,ZhongTuanZhen,341623117,28593,4625,22897,13774,44340,22897,13700,24021,46918,24021,46918
,WangTuanZhen,341623118,50226,7280,38715,22889,75115,38706,22212,40918,79624,41003,79718
Ҽ,LiuJiaJiXiang,341623202,23046,3643,17930,10483,34705,17930,10267,19017,36947,19026,36956
,JiWangChangXiang,341623203,23287,4161,18854,11254,35099,18840,10693,19205,38045,19287,38141
,SunMiaoXiang,341623204,21998,4117,17455,11286,34181,17453,9875,18530,35983,18535,35990
ż,XinZhangJiXiang,341623205,20740,3770,14357,11617,31545,14356,8290,18373,32729,18443,32800
ֳַ,ChaiHuLiangZhongFanZhiChang,341623400,195,33,143,78,225,143,49,134,277,134,277
ֵ´,ChiYangJieDaoBanShiChu,341702001,21604,1731,13381,8545,17534,11958,4531,12143,24101,14485,27866
ֵֽ´,QiuPuJieDaoBanShiChu,341702002,30721,2454,20339,14077,27001,19839,7652,19716,39555,20488,40827
ɽֵ´,LiShanJieDaoBanShiChu,341702003,13040,2084,8759,5862,17407,8693,2897,9011,17704,9262,18021
ڽֵ´,JiangKouJieDaoBanShiChu,341702004,6653,814,4496,3038,8202,4390,1611,4185,8575,4582,9078
ýֵ´,MaYaJieDaoBanShiChu,341702005,31522,3131,20867,9715,27437,14426,4945,14252,28678,18731,39598
Ͻֵ´,DunShangJieDaoBanShiChu,341702006,20303,3498,14345,9525,27801,14066,4843,13589,27655,14299,28644
÷ֵ´,MeiLongJieDaoBanShiChu,341702007,27324,4002,18796,11126,36277,18213,6389,17792,36005,18919,37715
ｭֵ´,QiuJiangJieDaoBanShiChu,341702008,37947,5990,26756,15606,51235,26595,9039,25805,52400,26220,52976
ӻֵ´,XingHuaCunJieDaoBanShiChu,341702009,36996,2889,23036,11890,28258,16390,6539,16314,32704,23388,46424
ֵ´,QingFengJieDaoBanShiChu,341702010,38655,3410,25201,17121,37184,23838,8707,23959,47797,25571,50772
Ϫֵ´,QingXiJieDaoBanShiChu,341702011,10013,931,6012,3929,9255,5405,2117,5640,11045,7049,13061
,YinHuiZhen,341702100,28608,4506,20267,11846,37970,19793,7162,19323,39116,20009,40276
ţͷɽ,NiuTouShanZhen,341702101,20839,3531,15746,10241,28691,15623,6386,14194,29817,15010,30756
,JuanQiaoZhen,341702102,20009,2816,13649,8161,26485,13592,4616,13563,27155,13792,27441
÷,MeiJieZhen,341702103,12607,2253,8503,5758,16487,8446,2456,8528,16974,8813,17316
÷,MeiCunZhen,341702104,16178,2943,11101,6780,21840,10970,3334,11083,22053,11354,22455
,TangTianZhen,341702105,12495,2167,8942,5486,16998,8891,2840,8394,17285,8560,17502
¥,PaiLouZhen,341702106,14418,2083,9695,5361,18994,9683,2919,9689,19372,9725,19420
ɳ,WuShaZhen,341702107,23813,4041,17584,10228,33022,17537,6472,16333,33870,16742,34326
Ϫ,TangXiZhen,341702108,6667,1399,4428,3119,8909,4401,1300,4877,9278,4938,9366
չعҵ԰,AnHuiGuiChiGongYeYuan,341702400,3098,52,1313,503,8,508,180,583,1091,2017,3330
п,ChiZhouShiKaiFaQu,341702401,5341,376,3030,1932,3427,2754,1028,2693,5447,3715,6745
лվվǰ,ChiZhouShiHuoCheZhanZhanQianQu,341702402,1113,14,516,327,0,425,226,490,915,837,1353
Ң,YaoDuZhen,341721100,66675,6991,44673,28070,66700,41807,14451,40458,82265,43444,88117
,DongLiuZhen,341721101,23033,2821,14896,8427,26949,13321,4373,13121,26442,15331,30227
ɿ,DaDuKouZhen,341721102,41552,6247,28652,16911,53123,27180,8509,26018,53198,27656,56308
ʤ,ShengLiZhen,341721103,33478,5806,23894,13042,45933,22814,8104,21714,44528,23494,47388
Ϫ,ZhangXiZhen,341721104,32491,4737,22481,12062,44188,22064,8274,22383,44447,23021,45502
,YangHuZhen,341721105,18147,2489,12093,6801,23865,12032,4071,12487,24519,12614,24707
,GeGongZhen,341721106,15367,2094,9937,5822,20082,9809,3185,10427,20236,10709,20646
,XiangYuZhen,341721107,23610,2788,15181,8472,30040,15055,4705,15519,30574,15922,31103
ٸ,GuanGangZhen,341721108,17332,2292,11304,6458,22403,11127,3663,11778,22905,11983,23287
̶,ZhaoTanZhen,341721109,12988,1633,8534,4627,15861,7856,2720,7992,15848,8807,17341
Ȫ,LongQuanZhen,341721110,18243,2064,11967,6473,23342,11676,4152,12042,23718,12492,24459
Ϫ,NiXiZhen,341721111,14195,2012,9421,5569,18685,9291,3102,9694,18985,9888,19309
԰,HuaYuanXiang,341721200,7381,1033,4603,2847,9383,4468,1344,4938,9406,5155,9758
ľ,MuTaXiang,341721201,10331,1360,6724,3797,13447,6549,2346,7053,13602,7313,14037
ɽ,QingShanXiang,341721202,10424,1242,7018,3930,13618,6827,2666,7097,13924,7314,14332
绯԰,XiangYuHuaGongYuanQu,341721400,951,20,275,199,226,119,18,178,297,714,989
ɿھÿ,DaDuKouJingJiKaiFaQu,341721401,557,104,368,234,628,290,109,298,588,402,770
,RenLiZhen,341722100,19161,2540,12882,9096,21104,12206,3666,11950,24156,12485,25367
߶,QiDouZhen,341722101,10672,1874,7062,4878,14238,7012,2152,7459,14471,7636,14698
Ԣ,XianYuZhen,341722102,7687,1525,5535,3654,10855,5521,1851,5449,10970,5528,11063
,DingXiangZhen,341722103,5776,999,3989,2706,7818,3977,1260,4002,7979,4046,8035
С,XiaoHeZhen,341722104,10644,1910,7527,5167,14611,7510,2447,7429,14939,7474,15001
,HengDuZhen,341722105,5216,1048,3481,2423,7024,3432,1028,3689,7121,3811,7292
,DaYanXiang,341722200,4568,760,3003,1954,6173,2996,941,3221,6217,3266,6269
̲,JiTanXiang,341722201,3283,596,2241,1452,4409,2228,634,2204,4432,2272,4513
س,RongChengZhen,341723100,50682,6520,35011,24115,60701,34379,12125,33308,67687,34316,69327
ľ,MuZhenZhen,341723101,16501,2516,11415,7329,21156,10391,4006,10327,20718,11608,23023
ǰ,MiaoQianZhen,341723102,14550,2352,10062,6151,18405,8916,3309,8769,17685,10149,20211
,LingYangZhen,341723103,16331,2675,10684,7408,21157,10449,3335,11109,21558,11657,22341
º,XinHeZhen,341723104,11228,1566,7485,4515,14114,7144,2398,6948,14092,7707,15192
,DingQiaoZhen,341723105,12176,1804,8521,5654,16220,8344,3125,8184,16528,8584,17105
챸,ZhuBeiZhen,341723106,5334,927,3606,2472,7187,3571,1203,3771,7342,3858,7464
,YangTianZhen,341723107,11867,2116,8213,5397,16142,7963,2715,8058,16021,8485,16698
Ż,JiuHuaZhen,341723108,3672,288,2236,1199,2383,1664,481,1389,3053,2205,4441
ľ,QiaoMuXiang,341723200,6280,1038,4333,2654,8338,4279,1503,4325,8604,4488,8821
ϻ,YouHuaXiang,341723201,9334,1435,6062,3748,12312,5880,1977,6302,12182,6684,12746
Ŵ,DuCunXiang,341723202,12135,2094,8321,5459,16619,8234,2904,8645,16879,8812,17133
Ż,JiuHuaXiang,341723203,8627,1169,5608,3693,10343,5469,1877,5569,11038,6065,11673
ؿ,QingYangXianKaiFaQu,341723400,512,12,278,140,1,130,33,104,234,279,557
ֵֽ´,XiLinJieDaoBanShiChu,341802001,38874,3909,24906,13991,28457,19172,7142,18703,37875,25019,49925
νֵ´,ChengJiangJieDaoBanShiChu,341802002,27513,3512,18066,11558,20055,15964,4736,15613,31577,17695,35761
ֵ´,AoFengJieDaoBanShiChu,341802003,62842,4995,38756,23955,48743,32400,9622,31146,63546,38703,77459
ôֵ´,JiChuanJieDaoBanShiChu,341802004,31574,3072,19904,12895,20061,17319,5861,17421,34740,20603,40507
ͤɽֵ´,JingTingShanJieDaoBanShiChu,341802005,5897,1167,3905,1817,6877,2473,955,2536,5009,4114,8019
˫Žֵ´,ShuangQiaoJieDaoBanShiChu,341802006,11014,1615,7347,5026,12382,6957,2064,7190,14147,7346,14693
ɲʽֵ´,FeiCaiJieDaoBanShiChu,341802007,15000,981,9100,5757,7678,7867,2809,8313,16180,9690,18790
ӽֵ´,JinBaJieDaoBanShiChu,341802008,12763,2099,8432,5706,14606,7471,2437,7807,15278,8867,17299
ˮ,ShuiYangZhen,341802100,45290,9848,33466,22627,62501,32804,11071,31785,64589,32743,66209
,LiQiaoZhen,341802101,32347,6533,24417,17115,45448,24182,9145,23102,47284,23608,48025
,ShenCunZhen,341802102,19904,3998,14348,10658,26702,14268,5242,14615,28883,14796,29144
Ȫ,GuQuanZhen,341802103,17649,3001,11786,8462,19492,11352,3592,11755,23107,12456,24242
,HongLinZhen,341802104,19958,3870,14376,11092,26464,14159,5392,14523,28682,14844,29220
ͤ,HanTingZhen,341802105,11837,2485,8197,6318,14384,8092,2604,8562,16654,8729,16926
Ĳ,WenChangZhen,341802106,9174,2064,6823,4644,12952,6779,2264,6642,13421,6679,13502
ﲺ,SunBuZhen,341802107,33014,5114,22291,14708,41858,21245,7384,22147,43392,23221,45512
,XiangYangZhen,341802108,26698,4333,17917,12028,35047,17601,5717,18301,35902,18831,36748
,YangLiuZhen,341802109,18948,3859,13350,9497,25649,13023,4281,13412,26435,13738,27088
ˮ,ShuiDongZhen,341802110,18682,3562,12384,9189,24059,12233,3684,13101,25334,13544,25928
,XinTianZhen,341802111,9229,2187,6686,5151,12965,6415,2059,6490,12905,6789,13475
,ZhouWangZhen,341802112,9484,2309,6779,5179,12652,6611,1928,6696,13307,6942,13721
Ϫ,XiKouZhen,341802113,14999,2675,9744,6393,19484,9432,2543,10072,19504,10473,20217
,ZhuQiaoXiang,341802200,17728,3008,11841,7793,23747,11727,3882,12568,24295,12777,24618
,YangXianXiang,341802201,19094,4268,14069,9964,27366,14009,5251,14387,28396,14544,28613
,WuXingXiang,341802202,15918,2311,10397,6652,19785,10203,3080,10635,20838,10912,21309
ƶ,HuangDuXiang,341802204,17552,3841,12510,9235,23938,12482,4147,12757,25239,13030,25540
ƽ,JianPingZhen,341821100,45843,5470,30030,20287,48334,29065,9181,28955,58020,30464,60494
ʮ,ShiZiZhen,341821101,29518,4496,20299,14319,34699,19840,6896,20081,39921,20611,40910
·,XinFaZhen,341821102,12195,1597,8266,5733,13242,8144,3048,8185,16329,8574,16840
γ,TaoChengZhen,341821103,20901,3523,12869,8553,23272,12435,4101,13409,25844,15656,28525
Ϸ,NanFengZhen,341821104,21862,2973,14439,8817,26116,13627,4752,14261,27888,15148,29587
÷,MeiZhuZhen,341821105,18353,2476,12110,7800,22646,11953,3851,12215,24168,12570,24680
,DongXiaZhen,341821106,10391,1576,6855,4463,13565,6847,2289,7355,14202,7401,14256
,BiQiaoZhen,341821107,10935,1682,7597,5040,14253,7540,2886,7833,15373,7906,15503
,LingDaXiang,341821200,19297,2521,12945,8089,24763,12779,4526,13006,25785,13399,26344
,FeiLiXiang,341821201,11865,1825,8080,5597,15673,8063,2981,8533,16596,8591,16671
Ҧ,YaoCunXiang,341821202,12705,1727,8180,4806,16320,8096,2468,8615,16711,8720,16900
Ҹ,XingFuXiang,341821203,10252,1677,6985,4905,13834,6946,2595,7423,14369,7539,14524
Ϫÿί,LangXiJingJiKaiFaQuGuanWeiHui,341821400,11532,1413,7504,5291,12093,6888,2448,7379,14267,7889,15393
,TaoZhouZhen,341822100,111764,13013,71906,40338,120074,58243,21833,59019,117262,74704,146610
ص,BaiDianZhen,341822101,28016,4400,18408,11544,36681,18217,5607,19336,37553,19615,38023
Ľ,ShiJieZhen,341822102,41796,6458,27645,17665,55085,27369,8925,29055,56424,29534,57179
,QiuCunZhen,341822103,48175,6662,31768,19977,61040,31333,10419,32613,63946,33488,65256
º,XinHangZhen,341822104,48612,6262,31458,19480,57516,29946,9924,30377,60323,33340,64798
¬,LuCunXiang,341822200,25245,4276,16456,10982,33423,16403,5075,18063,34466,18140,34596
ͤ,DongTingXiang,341822201,13923,1822,9027,5339,17518,8891,2869,9314,18205,9587,18614
̲,YangTanXiang,341822202,26167,4637,17689,11716,35361,17461,5601,18474,35935,18716,36405
ĺ,SiHeXiang,341822203,14520,2541,9276,6337,19008,9245,2887,10586,19831,10672,19948
ÿ,JingJiKaiFaQu,341822400,3913,21,1463,380,307,489,201,425,914,2672,4135
ɽڲ賡,CiShanGangChaChang,341822500,1223,247,836,626,1290,831,209,822,1653,843,1679
,JingChuanZhen,341823100,81518,9837,53057,38607,75849,50877,14789,49878,100755,53087,106144
ï,MaoLinZhen,341823101,12268,2644,7862,6116,16350,7832,1995,8957,16789,9045,16907
,LangQiaoZhen,341823102,19220,3662,12458,9116,24056,12390,3274,13229,25619,13698,26156
һ̶,TaoHuaTanZhen,341823103,16750,3526,11026,8410,22143,10924,2997,11952,22876,12247,23273
Ϫ,QinXiZhen,341823104,10205,2076,6703,5055,12987,6615,1878,7165,13780,7456,14159
̴,CaiCunZhen,341823105,10647,2153,7089,5040,14170,6725,1794,7005,13730,7505,14594
,YunLingZhen,341823106,22878,4679,14751,10757,30577,14626,4380,16769,31395,17186,31937
ƴ,HuangCunZhen,341823107,13183,2559,8500,5857,17440,8440,2352,9457,17897,9594,18094
,DingJiaQiaoZhen,341823108,9907,1913,6332,4607,12899,6293,1780,7145,13438,7268,13600
͡Ϫ,TingXiXiang,341823200,6910,1415,4424,3479,9207,4406,1148,4978,9384,5049,9473
,ChangQiaoXiang,341823201,18184,3517,12021,8564,23601,11807,3517,12569,24376,13197,25218
,HuaYangZhen,341824100,39892,4616,26368,15363,44441,20779,8811,19234,40013,26951,53319
Ϫ,LinXiZhen,341824101,6677,1089,4256,2775,7674,4057,1109,4124,8181,4619,8875
,ChangAnZhen,341824102,11914,2334,8154,5550,15644,7846,1968,7658,15504,8062,16216
ׯ,ShangZhuangZhen,341824103,8386,1765,5740,3667,11079,5512,1458,5404,10916,5869,11609
Ϫ,YangXiZhen,341824104,8082,1498,5215,3479,9898,5113,1162,5277,10390,5527,10742
,FuLingZhen,341824105,9691,2696,6869,5107,13379,6533,1588,6398,12931,7106,13975
ɳ,JinShaZhen,341824106,5434,850,3387,2348,6752,3304,776,3515,6819,3673,7060
,YingZhouXiang,341824200,5515,1230,3681,2642,6704,3615,768,3583,7198,3832,7513
ͷ,BanQiaoTouXiang,341824201,8303,1632,5002,3542,10171,4782,1058,5222,10004,5991,10993
,JiaPengXiang,341824202,6788,1579,4526,3369,9113,4425,1086,4653,9078,4927,9453
,JingZhouXiang,341824203,4641,752,3088,2068,6147,3079,979,3255,6334,3284,6372
,JingYangZhen,341825100,29184,4550,19924,14132,31968,19279,5744,18554,37833,19554,39478
̼,CaiJiaQiaoZhen,341825101,8856,1723,5543,3420,11411,5463,1311,6091,11554,6347,11890
Ϫ,SanXiZhen,341825102,7088,1393,4607,3144,9286,4549,1199,4959,9508,5073,9680
,MiaoShouZhen,341825103,7078,1172,4649,2872,9008,4556,1271,4767,9323,4872,9521
׵,BaiDiZhen,341825104,7525,1442,5085,3321,9839,5023,1491,5181,10204,5373,10458
,YuCunZhen,341825105,7577,1561,4974,3143,9998,4933,1189,5294,10227,5353,10327
,BanShuXiang,341825200,6818,1197,4162,2738,8079,4114,975,4414,8528,4828,8990
,YunLeXiang,341825202,3330,746,2227,1597,4556,2150,581,2339,4489,2430,4657
¡,XingLongXiang,341825203,5220,1061,3345,2159,6893,3240,776,3566,6806,3712,7057
,SunCunXiang,341825204,5810,1131,3868,2366,7535,3780,1040,3952,7732,4113,7981
ֵ,XiJinJieDao,341881001,62671,5426,41130,26283,51985,35830,12743,34084,69914,39710,80840
ɽֵ,NanShanJieDao,341881002,54872,3834,33259,22741,31487,29786,9563,30977,60763,35010,68269
ֵ,HeLiJieDao,341881003,26462,3847,16623,11976,25743,15877,4250,16446,32323,17936,34559
Ϫֵ,WangXiJieDao,341881004,12839,2430,8145,6259,15355,7941,2051,8501,16442,9175,17320
ֵ,ZhuFengJieDao,341881005,4156,774,2560,2033,4960,2529,521,2847,5376,2891,5451
ֵ,TianHuJieDao,341881006,2848,501,1885,1357,3140,1786,783,2032,3818,2247,4132
ۿ,GangKouZhen,341881100,19451,3595,12741,10378,23065,12557,3142,13090,25647,13447,26188
÷,MeiLinZhen,341881101,11954,2363,7596,5931,15155,7558,1863,8425,15983,8584,16180
Ϫ,ZhongXiZhen,341881102,14137,2884,9014,7422,17369,8860,1906,9708,18568,9913,18927
,NingDunZhen,341881103,7978,1761,5194,4424,10152,5074,1268,5617,10691,5813,11007
ϼ,XianXiaZhen,341881104,11218,2357,7544,5836,14880,7491,1920,7918,15409,7951,15495
·,JiaLuZhen,341881105,9295,1560,5991,4036,12055,5961,1673,6477,12438,6537,12528
,HuLeZhen,341881106,7402,1511,4943,3773,9713,4908,1333,5249,10157,5303,10246
ϼ,XiaXiZhen,341881107,10198,2563,6449,6081,13391,6353,1217,7388,13741,7529,13978
,YunTiSheZuXiang,341881200,3451,645,2278,1606,4471,2263,633,2423,4686,2451,4729
ϼ,NanJiXiang,341881201,6770,1199,4120,3485,8476,4065,944,4747,8812,4793,8913
,WanJiaXiang,341881202,7524,1610,4773,4056,9926,4725,1165,5426,10151,5526,10299
,QingLongXiang,341881203,6552,1384,3725,3556,8237,3652,569,4713,8365,4780,8505
,FangTangXiang,341881204,6899,1596,4147,3824,9041,4046,796,4988,9034,5144,9291
Ķֵ,GuDongJieDao,350102001,30984,5208,21064,13164,27621,18631,4577,16925,35556,19705,40769
ֵ,GuXiJieDao,350102002,52390,7568,34483,20123,42324,29230,7462,26763,55993,32937,67420
Ȫֵ,WenQuanJieDao,350102003,54906,6544,33959,18494,43308,26081,6461,24008,50089,33952,67911
ֵֽ,DongJieJieDao,350102004,24534,3891,17033,9781,24028,14604,4013,13370,27974,15405,32438
Ͻֵֽ,NanJieJieDao,350102005,35024,5537,23480,14753,28506,20803,5102,19534,40337,22183,45663
ֵ̩,AnTaiJieDao,350102006,25414,4079,17135,11190,21259,15679,3812,14816,30495,16170,33305
ֵ,HuaDaJieDao,350102007,81937,8834,51259,26220,77073,37670,10718,35499,73169,50230,101489
ˮֵ,ShuiBuJieDao,350102008,35616,4930,23463,14437,25344,21128,5200,19634,40762,22283,45746
ֵ,WuFengJieDao,350102009,87098,8760,55378,33120,55267,46520,13571,43834,90354,54051,109429
ɽ,HongShanZhen,350102100,115584,10692,71430,42440,62739,59036,17259,57192,116228,72105,143535
޽ֵ,YingZhouJieDao,350103001,43490,4581,26768,18369,28002,25477,6115,25536,51013,27418,54186
޽ֵ,HouZhouJieDao,350103002,34573,5654,21443,15651,30815,20094,3820,19536,39630,22604,44047
޽ֵ,YiZhouJieDao,350103003,30821,5223,20728,13918,23568,20047,4363,18899,38946,19679,40407
¸۽ֵ,XinGangJieDao,350103004,40686,4298,23930,15199,30432,19981,4625,19620,39601,25679,49609
Ϻֵ,ShangHaiJieDao,350103005,56853,8872,37027,23200,42431,32670,7285,31702,64372,35983,73010
ϼֵ,CangXiaJieDao,350103007,33209,5817,22250,15498,27934,21655,4628,20805,42460,21404,43654
ֵͤ,ChaTingJieDao,350103009,26721,4193,17293,11087,20542,15600,3527,14889,30489,17148,34441
нֵ,YangZhongJieDao,350103010,22486,3678,14638,10087,18929,13907,3031,13497,27404,14557,29195
ֵ,AoFengJieDao,350103011,34067,2754,21258,14515,23702,20856,6981,21589,42445,22544,43802
ֵ,NingHuaJieDao,350103012,26554,3842,17275,11508,20262,16394,4144,15912,32306,17265,34540
ǰֵ,CangQianJieDao,350104001,17493,2935,12179,8537,16706,11583,3235,11171,22754,11484,23663
ֵ,DongShengJieDao,350104002,10258,1301,6536,4104,5965,6149,1636,5873,12022,6659,13195
Ժֵ,DuiHuJieDao,350104003,30553,2476,18934,7530,15138,10338,2756,9331,19669,16851,35785
ٽֵ,LinJiangJieDao,350104004,24728,2413,10751,7114,14020,10254,2457,9611,19865,18847,29598
ֵֽ,SanChaJieJieDao,350104005,18447,2696,12170,8052,12846,11685,2850,11145,22830,11823,23993
϶ɽֵ,ShangDuJieDao,350104006,34353,3284,22292,12625,19886,19227,5985,18858,38085,21330,43622
¶ɽֵ,XiaDuJieDao,350104007,27513,3677,18388,12212,21098,18206,5085,17658,35864,17887,36275
ɽֵ,JinShanJieDao,350104008,61650,3705,39762,26406,43185,38609,15436,38926,77535,41029,80791
ɽ,CangShanZhen,350104100,24577,2007,14496,8763,13230,12907,3663,13082,25989,15751,30247
,ChengMenZhen,350104101,78401,5893,47222,24106,64567,39023,12245,40387,79410,49317,96539
ɽ,GaiShanZhen,350104102,99346,7042,58475,33278,64029,51587,15630,53353,104940,63543,122018
,JianXinZhen,350104103,174079,6348,93362,48727,54764,62511,21498,67025,129536,108563,201925
,LuoZhouZhen,350104104,15352,1162,8186,4957,9682,7018,1948,7548,14566,10276,18462
ũ,HongXingNongChang,350104400,5462,508,3217,1667,4774,2720,663,2544,5264,3416,6633
ǽֵ,LuoXingJieDao,350105001,48826,2849,28972,19778,25487,26364,8442,26769,53133,31145,60117
β,MaYiZhen,350105100,53339,3000,29695,16700,21974,22596,6960,23180,45776,33604,63299
ͤ,TingJiangZhen,350105101,32207,3857,20896,12630,14739,17306,3560,16466,33772,18728,39624
,LangQiZhen,350105102,55805,6025,34770,20008,40297,30488,7059,31164,61652,34119,68889
԰ֵ,ChaYuanJieDao,350111001,73076,7947,45011,30671,37695,38545,9022,37878,76423,45034,90045
ׯֵ,WangZhuangJieDao,350111002,37124,3479,24122,15192,20739,22332,6377,21239,43571,22858,46980
԰ֵ,XiangYuanJieDao,350111003,39258,3277,23909,16849,18095,21713,6182,21498,43211,24808,48717
ɽ,GuShanZhen,350111100,231929,10220,135555,104225,81994,127165,43946,136777,263942,150540,286095
µ,XinDianZhen,350111101,134077,8524,79337,55023,49564,71732,23682,75213,146945,86946,166283
,YueFengZhen,350111102,104567,8893,64362,48519,46403,59761,16943,60719,120480,66041,130403
Ϫ,HuanXiZhen,350111103,9563,1105,5949,3271,9249,5087,1297,5215,10302,6016,11965
ɽ,ShouShanXiang,350111201,5935,1076,3900,2752,6969,3870,1080,4041,7911,4191,8091
Ϫ,RiXiXiang,350111202,2873,541,1797,1412,3332,1734,498,1921,3655,2115,3912
ֵ,GanZheJieDao,350121001,38742,3731,25153,15531,35805,23591,8501,24152,47743,25821,50974
ɳ,BaiShaZhen,350121101,23449,2717,15212,9678,24439,14646,5645,15554,30200,16599,31811
,NanYuZhen,350121102,46501,5423,30036,17307,50221,27891,8783,27741,55632,30671,60707
и,ShangGanZhen,350121103,15230,1753,9687,6125,14072,9015,3194,9624,18639,10490,20177
ǫ,XiangQianZhen,350121104,39478,4685,24625,15750,45554,24147,8393,25795,49942,27931,52556
,QingKouZhen,350121105,62366,6411,36804,23865,60844,34814,12711,37650,72464,44684,81488
ͨ,NanTongZhen,350121106,26934,3991,18132,12413,32240,17861,5942,18299,36160,18735,36867
Ͻ,ShangJieZhen,350121107,146591,6460,82858,22805,72935,37948,12809,37943,75891,83002,165860
Ϫ,JingXiZhen,350121108,44772,4461,25723,14147,37427,22817,7639,22977,45794,31149,56872
,ZhuQiXiang,350121200,18148,2707,12542,7790,22080,12379,4709,12589,24968,13022,25564
β,HongWeiXiang,350121201,21964,2648,14229,8643,27882,14127,5145,15370,29497,15528,29757
,YangLiXiang,350121202,8924,1952,6678,5261,12654,6576,2867,6905,13481,7065,13743
,DaHuXiang,350121203,10094,1998,6835,5678,13308,6652,2732,7590,14242,7989,14824
͢ƺ,TingPingXiang,350121204,8645,2329,6216,5691,12458,6192,2419,7116,13308,7177,13393
С,XiaoRuoXiang,350121206,3820,728,2750,2020,4725,2680,1132,2843,5523,2930,5680
ũ,JiangYangNongChang,350121400,1285,291,842,732,1587,814,269,947,1761,1003,1845
,FengChengZhen,350122100,56009,6115,38988,24692,49141,37955,13429,35289,73244,36565,75553
,AoJiangZhen,350122101,41658,3120,25817,17896,25964,24051,7858,24498,48549,26819,52636
,DongDaiZhen,350122102,12514,2652,9876,6823,17029,9804,3625,8759,18563,8915,18791
gͷ,GunTouZhen,350122103,48003,6015,29911,21202,32171,29038,6037,28121,57159,30144,60055
,XiaoAoZhen,350122104,21418,3279,14749,9282,27044,14565,4823,14476,29041,14771,29520
,DongHuZhen,350122105,10854,1453,7498,4005,13413,7423,2965,7623,15046,7774,15272
,DanYangZhen,350122106,17698,2346,11713,7518,21322,11464,4240,12017,23481,12571,24284
,ChangLongZhen,350122107,6728,965,4406,2695,8736,4368,1450,4656,9024,4737,9143
͸,TouBaoZhen,350122108,9149,1718,6755,4364,12260,6649,2588,6439,13088,6700,13455
,MaBiZhen,350122109,18321,3406,13298,8297,24306,12810,4789,12671,25481,13218,26516
,GuanBanZhen,350122110,17803,2604,12051,7068,23575,11984,4541,12739,24723,12897,24948
,XiaoChengZhen,350122111,19433,2294,12510,7494,23733,12368,4098,13009,25377,13315,25825
,HuangQiZhen,350122112,17764,1849,11212,7898,18602,10932,3755,11622,22554,12156,23368
̦Ǌ,TaiLuZhen,350122113,18929,2018,12328,8577,21337,12197,4682,12915,25112,13301,25629
ֿ,PuKouZhen,350122114,20154,2914,13615,8710,25340,13235,4887,13747,26982,14340,27955
԰,KengYuanZhen,350122115,12283,1677,7599,4980,14014,7345,2203,7604,14949,8564,16163
˶,PanDuXiang,350122200,12323,1661,8266,4599,15420,8206,2771,8346,16552,8489,16755
,JiangNanXiang,350122201,17179,2230,11548,6799,16380,11227,3575,10936,22163,11436,22984
ޤ,LiaoYanXiang,350122202,17485,2238,11482,6749,22476,11390,4493,12402,23792,12734,24216
,AnKaiXiang,350122203,10372,1262,6748,4577,12232,6642,2662,7250,13892,7548,14296
¹,XiaGongXiang,350122204,8612,1001,5273,2926,9959,5031,1567,5390,10421,5907,11180
С,XiaoCangSheZuXiang,350122205,2149,294,1431,807,2783,1423,503,1476,2899,1515,2946
ɽ,FengShanZhen,350123100,59504,5418,39249,25568,43080,38235,13162,37555,75790,38835,78084
ɽ,SongShanZhen,350123101,16969,2857,10857,8054,21064,10780,3134,11821,22601,12103,22960
,QiBuZhen,350123102,17159,2491,10676,6756,20829,10424,2580,11223,21647,11554,22230
з,ZhongFangZhen,350123103,6800,1533,4345,4005,8986,4267,1392,5191,9458,5380,9725
,FeiZhuZhen,350123104,4933,1204,3244,2928,6032,3184,972,3606,6790,3865,7109
,JianJiangZhen,350123105,5253,1086,3583,2931,6853,3544,1014,3706,7250,3770,7353
,BaiTaXiang,350123200,7054,1284,4249,3307,7682,4167,1173,4520,8687,5262,9511
,HongYangXiang,350123201,6080,1122,3818,3161,7290,3751,1154,4298,8049,4538,8356
,XiLanXiang,350123202,8171,1116,4420,3523,6924,4061,1341,4646,8707,6208,10628
,HuoKouSheZuXiang,350123203,5708,1237,3902,3323,7397,3863,1355,4288,8151,4398,8300
,BiLiXiang,350123204,12017,1728,7187,5047,13973,6789,1924,7524,14313,8482,15669
Դ,LuoYuanWan,350123500,7437,25,2040,1425,38,1168,290,1584,2752,5712,7752
÷,MeiChengZhen,350124100,29119,3039,19217,12774,26021,18737,7055,18885,37622,19996,39213
÷Ϫ,MeiXiZhen,350124101,17835,2161,11687,7380,15048,10989,4087,11702,22691,12396,24083
,BaiZhangZhen,350124102,10562,1473,7099,4870,10877,6859,2624,7003,13862,7560,14659
ɳ,JinShaZhen,350124103,6486,1273,4424,3447,8200,4322,1526,4538,8860,4861,9285
,BaiZhongZhen,350124104,12456,1381,8079,4693,13734,7441,2896,7768,15209,8654,16733
԰,ChiYuanZhen,350124105,15512,1875,10410,6276,16666,9316,3930,9654,18970,10907,21317
ණ,BanDongZhen,350124106,21645,3783,15995,10963,27324,15750,6194,15303,31053,15627,31622
ׯ,TaZhuangZhen,350124107,9665,1922,7105,5251,13000,7061,2752,7129,14190,7234,14339
ʡ,ShengHuangZhen,350124108,7307,1528,5569,4238,10248,5547,2337,5575,11122,5603,11172
۽,XiongJiangZhen,350124109,2250,428,1408,1322,2610,1343,409,1536,2879,1679,3087
,DongQiaoZhen,350124110,10712,1473,7338,5093,13323,7137,3140,7425,14562,7987,15325
,YunLongXiang,350124200,7010,1092,4660,3161,7786,4508,1636,4714,9222,5078,9738
,ShangLianXiang,350124201,6532,909,4305,2818,8086,4194,1645,4582,8776,4781,9086
Ϫ,SanXiXiang,350124204,3316,628,2289,1911,4443,2255,847,2452,4707,2502,4791
,JuLinXiang,350124205,2574,430,1551,1332,2942,1501,503,1655,3156,1956,3507
ף,XiaZhuXiang,350124206,6237,1346,4504,3705,8756,4474,2103,5125,9599,5182,9686
,ZhangChengZhen,350125100,20923,2258,14302,10369,22050,14096,5164,13664,27760,14043,28345
Կ,SongKouZhen,350125101,14095,2227,9300,6952,17835,8909,2997,9450,18359,10019,19319
ͩ,WuTongZhen,350125102,17459,2737,11898,7244,22980,11733,4417,12101,23834,12715,24613
,GeLingZhen,350125103,10063,1627,6124,4027,11490,5765,1659,6001,11766,7225,13349
Ƿ,ChengFengZhen,350125104,27692,1994,17966,11059,19058,16847,7265,17365,34212,18985,36951
,QingLiangZhen,350125105,6093,1060,4151,2830,7687,4121,1238,4197,8318,4240,8391
,ChangQingZhen,350125106,6878,1468,4595,3790,9266,4500,1735,5044,9544,5486,10081
ͬ,TongAnZhen,350125107,11482,2092,7469,5733,14861,7358,2608,7968,15326,8713,16182
,DaYangZhen,350125108,12638,2320,9192,6765,16758,8747,3143,8429,17176,8909,18101
ǰ,TangQianXiang,350125200,2455,447,1609,1148,2901,1544,482,1621,3165,1775,3384
Ȫ,FuQuanXiang,350125201,3109,587,2048,1608,3966,2027,640,2056,4083,2288,4336
·,LingLuXiang,350125202,4696,740,2977,1804,5654,2900,971,2978,5878,3430,6407
,ChiXiXiang,350125203,7433,1047,4536,3044,8702,4400,1639,4581,8981,5583,10119
,FuKouXiang,350125204,5885,797,3799,2640,7599,3785,1163,4003,7788,4046,7845
,GaiYangXiang,350125205,4154,584,2720,1981,5498,2707,1117,3031,5738,3135,5855
,DongYangXiang,350125206,4076,582,2434,1761,5049,2419,857,2853,5272,3081,5515
ϼ,XiaBaXiang,350125207,6524,1112,4676,3405,9019,4660,1942,4852,9512,4902,9578
̹,PanGuXiang,350125208,4236,689,3041,2039,6023,3037,1310,3188,6225,3194,6235
,HongXingXiang,350125209,4066,673,2606,2001,5318,2585,790,2889,5474,2923,5529
,BaiYunXiang,350125210,5206,957,3606,2623,6978,3604,1177,3716,7320,3734,7340
,DanYunXiang,350125211,1389,316,944,778,1953,942,275,1029,1971,1036,1980
̶,TanChengZhen,350128100,84161,5310,54986,31669,48694,54426,21976,55735,110161,56461,111447
հ,SuAoZhen,350128101,12238,2088,9322,5931,16981,9296,3508,8415,17711,8512,17834
ˮ,LiuShuiZhen,350128102,29493,3859,20447,11895,39746,20395,7649,20439,40834,20554,41001
ǰ,AoQianZhen,350128103,31127,2979,21472,12519,32417,21299,8750,21109,42408,21384,42856
,BeiCuoZhen,350128104,15596,2416,10835,6789,19849,10703,3903,10148,20851,11080,21915
ƽԭ,PingYuanZhen,350128105,9905,1725,8239,5244,14152,8230,3411,6776,15006,6802,15041
,AoDongZhen,350128106,14562,2147,10321,6678,19162,10301,3744,10081,20382,10132,20453
,BaiQingXiang,350128200,8641,1441,6606,4414,11880,6602,2189,5659,12261,5665,12271
ͷ,YuTouXiang,350128201,9990,1154,6968,3811,12702,6960,2708,6852,13812,6884,13852
,DaLianXiang,350128202,3039,520,2286,1355,4314,2266,946,2190,4456,2219,4505
«,LuYangXiang,350128203,2661,430,2040,1297,3588,2026,695,1716,3742,1746,3786
¥,ZhongLouXiang,350128204,11539,1668,8340,5254,15500,8294,3126,7905,16199,7993,16333
,DongXiangXiang,350128205,4298,649,3129,2106,5912,3101,1444,3174,6275,3262,6391
ᰳ,LanChengXiang,350128206,17391,1730,12040,7149,16644,11937,4620,11484,23421,11701,23741
Ϻ,NanHaiXiang,350128207,4514,726,3230,2108,5757,3230,1094,3104,6334,3104,6334
ֵ,YuPingJieDao,350181002,53648,5753,37174,24168,42129,34285,12836,32685,66970,35063,72237
ɽֵ,LongShanJieDao,350181003,44790,5000,30114,17559,38847,28673,10350,28587,57260,30026,60140
ֵ,LongJiangJieDao,350181004,41532,3158,26848,14344,25165,21551,8343,21927,43478,26185,53033
·ֵ,HongLuJieDao,350181005,39457,2617,23071,11411,24581,18821,7068,18986,37807,26071,49142
ʯֵ,ShiZhuJieDao,350181006,37818,1218,19696,11284,11537,14820,5458,16048,30868,24798,44494
ֵ,YinXiJieDao,350181007,62430,4417,37380,22526,35122,34365,13126,33905,68270,42593,79973
½ֵ,YangXiaJieDao,350181008,48051,3576,28534,17101,30419,24204,7920,25195,49399,31013,59547
,HaiKouZhen,350181103,44131,5693,30325,18018,46723,28601,10543,29221,57822,30042,60367
ͷ,ChengTouZhen,350181104,30156,4276,20682,13327,33773,20250,7756,20287,40537,21506,42188
,NanLingZhen,350181105,3248,471,2133,1453,4095,2124,765,2333,4457,2351,4484
,LongTianZhen,350181106,82657,9951,55540,30826,87290,52612,19348,53585,106197,56416,111956
,JiangJingZhen,350181107,54893,6818,37557,20550,58017,37215,14208,37786,75001,38362,75919
ͷ,GangTouZhen,350181108,41401,6236,28871,18358,46068,28235,10251,28287,56522,29017,57888
ɽ,GaoShanZhen,350181109,42124,5600,29592,17347,46896,29261,10728,28501,57762,28860,58452
ɳ,ShaPuZhen,350181110,27763,4012,19969,10362,33526,19896,7783,19490,39386,19589,39558
ɽ,SanShanZhen,350181111,58759,8843,42082,25322,72061,41745,16130,41103,82848,41650,83732
,DongHanZhen,350181112,21904,3395,15770,8946,23156,15702,5284,14656,30358,14813,30583
Ϫ,YuXiZhen,350181113,37124,4435,24931,15450,37202,24367,9108,24214,48581,25736,50667
,ShangJingZhen,350181114,21118,2638,14293,8711,21983,13714,5137,13669,27383,14600,28893
,XinCuoZhen,350181115,18965,2876,12526,7450,15880,12196,3337,12100,24296,12652,25178
,JiangYinZhen,350181116,51540,5399,34053,19687,46748,33370,14534,35643,69013,37420,71473
,DongZhangZhen,350181117,17816,2597,12220,7480,19880,11870,4221,12081,23951,12414,24634
,JingYangZhen,350181118,26802,2231,15914,7977,20073,13212,4721,13463,26675,17840,33754
һ,YiDouZhen,350181119,6423,876,4253,2730,7006,4237,1497,4505,8742,4543,8796
,JiangJingHuaQiao,350181400,3025,416,2051,1303,3587,2042,877,2241,4283,2267,4318
,DongGeHuaQiao,350181401,2524,367,1706,1177,2583,1636,541,1645,3281,1726,3432
⺽ֵ,WuHangJieDao,350182001,59049,5556,39429,26101,37914,37079,11701,34793,71872,36877,76306
ǽֵ,HangChengJieDao,350182002,58517,3385,34714,22919,23607,31688,9418,32681,64369,36606,71320
Ӫǰֵ,YingQianJieDao,350182003,27506,3073,17089,11503,21545,16745,4829,17604,34349,18319,35408
ĸ۽ֵ,ZhangGangJieDao,350182004,36461,3613,22610,15423,29249,21004,6446,21694,42698,23910,46520
ռ,ShouZhanZhen,350182102,16618,2136,10681,7012,14676,10589,2805,10490,21079,10878,21559
,YuTianZhen,350182103,24406,3107,15927,9742,27240,15658,5328,16551,32209,16914,32841
,SongXiaZhen,350182104,20255,1587,11865,6408,14769,9597,3439,10004,19601,13416,25281
,JiangTianZhen,350182105,34541,3352,21213,15120,29743,19819,6659,21047,40866,23339,44552
Ż,GuHuaiZhen,350182106,33609,3926,21244,14257,30475,19847,6347,21054,40901,22638,43882
ɰ,WenWuShaZhen,350182107,16058,1334,9314,5616,15354,8735,2593,9494,18229,10671,19985
,HeShangZhen,350182108,40553,4485,24482,16117,36888,23394,6285,25489,48883,26841,51323
,HuNanZhen,350182110,22269,1981,13014,8530,16068,11704,3125,11989,23693,14361,27375
,JinFengZhen,350182111,67344,5713,41596,28329,45743,38392,11842,39459,77851,43303,84899
,WenLingZhen,350182112,21649,2617,13655,9703,18454,13277,3414,13309,26586,14025,27680
÷,MeiHuaZhen,350182113,11004,1502,7214,5711,10712,7127,1710,6901,14028,7002,14216
̶ͷ,TanTouZhen,350182114,37986,4887,23713,15565,30655,22657,5153,22873,45530,24313,48026
,LuoLianXiang,350182200,4693,780,3152,2266,5204,3076,953,3074,6150,3274,6426
,HouYuXiang,350182201,3961,631,2677,1773,2083,2640,435,2285,4925,2350,5027
ø۽ֵ,ShaGangJieDao,350203001,33310,4553,21652,14973,22132,19336,4733,18074,37410,20944,42596
лֵ,ZhongHuaJieDao,350203003,28522,3766,19717,12729,18815,17156,4611,15364,32520,17182,36899
�ֵ,BinHaiJieDao,350203005,53385,3247,29929,15792,28567,17479,4979,18719,36198,31682,61611
ؽֵ,LuJiangJieDao,350203006,50905,5963,33348,22770,30931,30813,8430,28256,59069,31950,65298
Ԫֵ,KaiYuanJieDao,350203007,71254,9451,48053,30635,46671,42561,11280,38867,81428,43932,91985
ֵ,WuCunJieDao,350203008,102431,9092,66216,44418,52951,58669,15345,53841,112510,60652,126868
oYֵ,YunDangJieDao,350203009,131732,11448,84755,54328,84056,75100,23116,69438,144538,81541,166296
ǰֵ,LianQianJieDao,350203010,176163,9271,106172,77739,68886,93549,30688,95919,189468,109950,216122
ֵ,JiaLianJieDao,350203011,86653,6554,56125,36591,45618,49803,14874,45256,95059,51956,108081
ֵ,GuLangYuJieDao,350203012,10840,2005,7541,4729,7928,6309,1397,5747,12056,6701,14242
׽ֵ,HaiCangJieDao,350205001,117898,5973,69186,48784,65257,63950,22087,66965,130915,76772,145958
ֵ,XinYangJieDao,350205002,87034,1433,43150,43400,12095,36344,8629,44697,81041,53946,97096
,DongFuZhen,350205103,33364,2338,18817,14843,23408,17756,5671,19674,37430,22556,41373
һũ,DiYiNongChang,350205401,1584,191,950,660,1602,937,277,945,1882,1102,2052
ũ,HaiCangNongChang,350205402,1923,56,936,793,541,800,189,927,1727,1232,2168
ɽֳ,TianZhuShanLinChang,350205403,44,6,30,25,25,30,11,28,58,31,61
ڼӹ,ChuKouJiaGongQu,350205406,30,1,14,9,2,3,0,6,9,17,31
ֵ,HuLiJieDao,350206001,144098,6087,87973,60393,57919,76462,24250,75438,151900,86462,174435
ǰֵ,DianQianJieDao,350206002,183967,2702,100347,89248,20229,87452,25872,96932,184384,112194,212541
ɽֵ,HeShanJieDao,350206003,191172,2408,98649,94236,20074,85739,24838,99889,185628,119769,218418
ͷֵ,JiangTouJieDao,350206004,177368,5075,101193,83506,40359,90762,28224,97313,188075,109474,210667
ɽֵ,JinShanJieDao,350206005,95045,2804,51907,46657,24024,49207,17381,56861,106068,63323,115230
߼�,HuoJuGaoJiShuKaiFaQu,350206405,0,0,0,0,0,0,0,0,0,0,0
챣˰,XiangYuBaoShuiQu,350206406,0,0,0,0,0,0,0,0,0,0,0
ֵ,JiMeiJieDao,350211001,54164,2335,28533,11622,24721,15235,4572,14977,30212,32538,61071
Ӣֵ,QiaoYingJieDao,350211002,113437,1724,60164,49137,23546,43986,12215,49980,93966,67212,127376
ֵֽ,XingLinJieDao,350211003,71517,3967,42403,32683,32450,38929,12668,40820,79749,45749,88152
ӱֵ,XingBinJieDao,350211004,106723,2811,58414,50952,22568,51598,16735,59843,111441,67855,126269
,GuanKouZhen,350211102,83469,3532,45877,40331,37466,43298,15628,50879,94177,56752,102629
Ϫ,HouXiZhen,350211103,59729,2426,32349,14960,28685,19371,6579,20393,39764,36385,68734
ڶũ,DiErNongChang,350211401,2227,178,1396,981,2071,1372,405,1351,2723,1414,2810
ʡ�,ShengTianMaZhongZhuChang,350211402,391,65,215,164,300,205,38,197,402,279,494
�ũ,TianMaHuaQiaoNongChang,350211403,2724,131,1565,1281,1149,1500,467,1600,3100,1757,3322
ͷֳ,BanTouFangHuLinChang,350211404,0,0,0,0,0,0,0,0,0,0,0
ֵͬ,DaTongJieDao,350212001,65259,6101,42157,25518,50138,38882,12731,38129,77011,41934,84091
ƽֵ,XiangPingJieDao,350212002,91625,4442,52058,29997,44038,43419,15737,44188,87607,59746,111804
,LianHuaZhen,350212105,24658,2807,15622,9491,28819,15010,5066,15763,30773,16909,32531
,XinMinZhen,350212106,93088,3043,49117,31663,37006,37482,11850,41737,79219,58864,107981
,HongTangZhen,350212107,27818,2725,17257,10867,29269,16475,5311,16969,33444,18597,35854
,XiKeZhen,350212108,51497,3197,28983,19245,34314,24840,7402,26422,51262,33113,62096
͡Ϫ,TingXiZhen,350212109,12682,1388,8169,5458,14432,7794,2642,7765,15559,8543,16712
,WuXianZhen,350212110,31296,2671,19524,11485,33486,17684,5746,17958,35642,20189,39713
ũ,FengNanNongChang,350212401,744,29,391,247,376,342,107,353,695,489,880
ɳũ,BaiShaLunNongChang,350212402,1633,151,1002,620,1557,890,307,890,1780,1089,2091
ӻũ,ZhuBaHuaQiaoNongChang,350212403,1850,222,1179,720,1976,1123,304,1112,2235,1197,2376
ؽֵ,DaDengJieDao,350213001,13531,1892,9320,5983,15995,9080,2905,8373,17453,9008,18328
,MaXiangZhen,350213102,96257,7286,55582,35566,74963,45990,14063,48260,94250,62024,117606
,XinWeiZhen,350213103,28038,2979,17206,11380,32261,16483,5124,17821,34304,18935,36141
µ,XinDianZhen,350213104,73558,7308,44816,28636,71282,37828,11904,37491,75319,47954,92770
,NeiCuoZhen,350213111,28645,2889,18090,12891,31796,17389,5720,17935,35324,19164,37254
ñɽũ,DaMaoShanNongChang,350213404,1598,236,1104,821,2127,1097,400,1113,2210,1130,2234
Žֵ,LongQiaoJieDao,350302001,68595,4872,42481,19808,34942,31518,11967,30739,62257,42953,85434
ɽֵ,FengHuangShanJieDao,350302002,59045,4403,37194,21963,35261,32072,10911,31822,63894,37165,74359
ϼֵֽ,XiaLinJieDao,350302003,46670,2762,28183,16764,24256,25168,9360,26533,51701,30609,58792
̫,ChangTaiZhen,350302100,12387,3479,10098,7546,19147,10001,4122,9682,19683,9890,19988
ͤ,HuaTingZhen,350302101,69464,8341,47157,26384,77056,43313,15280,41295,84608,45928,93085
鴨,LingChuanZhen,350302102,30472,4309,22948,12263,40803,22235,9412,20164,42399,21245,44193
,DongHaiZhen,350302103,25943,3733,19775,9805,33847,18705,8326,17136,35841,18227,38002
ֵ,HanDongJieDao,350303001,46702,4052,27263,15823,32427,24200,7886,22970,47170,31377,58640
ֵ,HanXiJieDao,350303002,28801,2993,18926,10652,18113,17430,5554,16610,34040,18422,37348
,SanJiangKouZhen,350303100,41940,4457,27271,13155,42256,25410,8325,24681,50091,27451,54722
,BaiTangZhen,350303101,35952,3681,23057,10857,35812,20766,6857,20117,40883,23433,46490
,GuoHuanZhen,350303102,42779,3375,26505,13745,31143,23026,7729,22999,46025,27378,53883
,WuTangZhen,350303103,36203,4009,23686,12061,31323,21325,6873,20472,41797,23399,47085
,JiangKouZhen,350303104,77216,7160,49016,21390,48525,39529,12519,37398,76927,47879,96895
c«,QiuLuZhen,350303105,14781,2615,10644,6274,18472,10568,3401,9943,20511,10153,20797
ɳ,BaiShaZhen,350303106,8026,1966,6229,4555,11245,6166,2285,5816,11982,6048,12277
ׯ,ZhuangBianZhen,350303107,10000,2221,7550,5469,14048,7470,2981,7319,14789,7652,15202
,XinXianZhen,350303108,8524,1940,6289,4665,11641,6243,2376,6341,12584,6551,12840
,DaYangXiang,350303200,5998,1367,4585,3213,7936,4532,1677,4092,8624,4457,9042
ۿ,ChiGangKaiFaQu,350303500,4044,290,2374,1411,1929,1797,542,1872,3669,2502,4876
򺣽ֵ,ZhenHaiJieDao,350304001,56561,4697,35412,20401,38231,31821,11967,31454,63275,37813,73225
ֵ,GongChenJieDao,350304002,55230,4389,34628,16215,38156,28054,9319,27477,55531,34310,68938
β,XiTianWeiZhen,350304100,47653,4396,29502,13155,35996,22418,7166,21750,44168,29713,59215
ʯ,HuangShiZhen,350304101,113502,11214,73348,36112,115222,64938,24126,63037,127975,75494,148842
¶,XinDuZhen,350304102,63345,6919,42624,20916,72929,40610,15077,39257,79867,42717,85341
,BeiGaoZhen,350304103,41863,6578,33699,16930,60021,33495,15108,29646,63141,29850,63549
ʯ,HuShiZhen,350305100,79087,7700,53844,25687,90861,49547,19896,47271,96818,52839,106683
ׯ,DongZhuangZhen,350305101,28018,6189,22351,13886,38535,21767,8095,18552,40319,19951,42302
,ZhongMenZhen,350305102,10734,2479,9217,5443,12735,8514,3419,6650,15164,7415,16632
,DongPuZhen,350305103,11038,3478,9576,6792,14675,9424,3075,7511,16935,8015,17591
,DongQiaoZhen,350305104,64727,7664,46277,22016,84437,45244,16782,41156,86400,42896,89173
ܤͷ,DaiTouZhen,350305105,67702,9330,49330,25217,90316,48291,17328,43683,91974,45030,94360
ƽ,PingHaiZhen,350305106,46273,7114,36537,17853,66270,36361,15826,32318,68679,32676,69213
,NanRiZhen,350305107,37211,4088,25168,11924,48798,25069,9485,25451,50520,25616,50784
,MeiZhouZhen,350305108,21340,2707,15766,7989,28586,15470,6282,14127,29597,14563,30329
,YueTangXiang,350305200,17247,3523,14556,7919,23182,14262,5970,11656,25918,12184,26740
ɽͤ,ShanTingZhen,350305201,17571,4171,14579,8485,24195,14337,5086,11651,25988,12249,26828
ǰũ,QianQinNongChang,350305400,54,4,14,23,43,8,2,23,31,46,60
󺣹,HouHaiGuanLiJu,350305401,44,1,9,2,12,0,1,2,2,37,46
ǽֵ,LiChengJieDao,350322001,76192,7945,52322,31317,62818,48034,18257,46414,94448,50072,102394
ͤ,FengTingZhen,350322100,74379,7389,50155,25710,84998,45979,19238,45136,91115,50851,101006
ͷ,BangTouZhen,350322101,90931,10173,61482,35113,114996,60873,25435,63726,124599,65057,126539
β,JiaoWeiZhen,350322102,52172,5224,36085,19097,65312,35302,13713,34097,69399,35024,71109
β,DuWeiZhen,350322103,41674,5706,30459,19178,58193,30068,13260,29888,59956,30181,60640
,LiNanZhen,350322104,34640,4147,24494,14778,37222,23919,10234,23475,47394,24527,49021
,LaiDianZhen,350322105,38180,4874,27116,15072,46625,24952,10657,24769,49721,26595,53711
β,GaiWeiZhen,350322106,50095,6431,36277,21563,65611,35576,14934,34133,69709,35183,71460
԰ׯ,YuanZhuangZhen,350322107,17167,3513,14133,10349,26203,13953,7574,13885,27838,14121,28254
,DaJiZhen,350322108,42597,6215,30504,18698,57743,29541,12725,29409,58950,31033,61537
,LongHuaZhen,350322109,24863,3931,19203,11835,36426,19040,9376,18789,37829,18967,38170
ɽ,ZhongShanZhen,350322110,9558,1780,6903,5115,13694,6758,2765,6882,13640,7200,14103
,YouYangZhen,350322111,9323,2358,6951,6431,12605,6853,2773,7248,14101,7503,14454
Է,XiYuanXiang,350322200,7819,1257,5225,3461,10240,5071,1985,5166,10237,5836,11061
ʯ,ShiCangXiang,350322201,3616,847,2610,2365,5157,2570,1002,2716,5286,2855,5465
,SheXingXiang,350322202,2444,690,1849,1809,3373,1817,634,1807,3624,1919,3768
,ShuFengXiang,350322203,5762,1029,4118,2863,8166,4002,1559,4058,8060,4232,8350
Ϫ,CaiXiXiang,350322204,2315,599,1838,1609,3538,1817,751,1750,3567,1827,3665
жֵ,LieDongJieDao,350402001,54773,6537,36680,23501,48945,31943,9801,30741,62684,34431,71111
ֵ,LieXiJieDao,350402002,42264,4374,26338,20137,33100,25758,8517,27208,52966,28817,55155
ֵ̽,XuBiJieDao,350402003,27021,1867,15977,12344,15378,15564,5750,17013,32577,18661,34638
´,ChenDaZhen,350402100,6298,1204,3875,3138,6441,3819,1204,4180,7999,4831,8706
Ϫ,YangXiXiang,350402200,4072,781,2874,2093,4883,2798,1116,2978,5776,3095,5969
÷оÿ,FuJianMeiLieJingJiKaiFaQu,350402500,823,30,387,341,316,376,107,455,831,573,960
ǹؽֵ,ChengGuanJieDao,350403001,50919,5039,32589,21446,35732,30236,9951,30291,60527,33320,65909
ɳֵ,BaiShaJieDao,350403002,26552,4024,17105,12823,21665,16791,4962,17511,34302,18433,35538
˱ֵ,FuXingBaoJieDao,350403003,21455,2326,13875,9276,13734,12359,4498,12707,25066,14404,28279
ֵ,JingXiJieDao,350403004,10547,639,5709,1583,2163,1803,527,1935,3738,6004,11713
ݷ,ShenKouZhen,350403100,12753,1914,7854,5046,14207,7693,2238,8452,16145,9051,16905
ǰ,YanQianZhen,350403101,13419,1878,8700,5580,15419,8594,2891,9145,17739,9488,18188
Ƕ,ChengDongXiang,350403200,8133,665,4950,3402,4400,4836,1946,5399,10235,5794,10744
д,ZhongCunXiang,350403201,8712,1375,5328,3255,10835,5281,1595,6106,11387,6354,11682
ѩ,XueFengZhen,350421100,25595,3027,17489,11610,19386,16677,6055,16245,32922,17188,34677
,GaiYangZhen,350421101,9251,1750,6114,4754,9853,6040,1725,6468,12508,6612,12726
,HuFangZhen,350421102,6053,865,3422,2638,4873,3332,762,3896,7228,4258,7680
,HanXianZhen,350421103,8034,1184,4938,2933,6786,4777,1178,5048,9825,5458,10396
ǹ,ChengGuanXiang,350421200,8106,1001,5095,3471,5931,5077,1551,5466,10543,5563,10658
ɳϪ,ShaXiXiang,350421201,5418,650,3042,2078,2610,2952,728,3267,6219,3754,6796
,XiaYangXiang,350421202,7890,1365,5031,3408,8230,4983,1498,5528,10511,5722,10753
Ϫ,FengXiXiang,350421203,2558,491,1800,1279,3117,1800,540,1787,3587,1789,3589
ķ,XiaFangXiang,350421204,4012,596,2620,1679,4306,2557,784,2682,5239,2772,5392
,LongJinZhen,350423100,28819,3285,18737,11477,26399,17761,6637,18013,35774,20004,38741
Ϫ,SongXiZhen,350423101,11125,1396,7330,3751,12507,6992,2627,7044,14036,7818,15148
Կ,SongKouZhen,350423102,11316,1340,7259,4124,12859,7130,2666,7373,14503,8063,15322
,LingDiZhen,350423103,7049,1201,4705,2991,9359,4688,1618,5123,9811,5163,9868
У,ChangXiaoZhen,350423104,7382,1148,5136,3048,9797,5080,1908,5236,10316,5302,10438
½,WenJiaoXiang,350423201,2792,360,1761,921,3458,1723,640,1849,3572,2031,3792
,LinSheXiang,350423202,7384,728,2859,1941,5117,2823,850,3192,6015,6103,8962
Դ,TianYuanXiang,350423203,4530,559,2864,1542,5351,2817,992,2953,5770,3217,6081
ɳ,ShaWuXiang,350423204,2631,365,1655,1032,3121,1633,590,1760,3393,1931,3586
,LaiFangXiang,350423205,4853,889,3505,2151,6525,3499,1611,3814,7313,3848,7353
,YuPengXiang,350423206,3410,513,2153,1223,4213,2079,806,2308,4387,2576,4729
,LiJiaXiang,350423208,5454,922,3593,2416,7260,3582,1225,3907,7489,4008,7601
,LiTianXiang,350423209,3365,486,2240,1331,4266,2202,776,2296,4498,2387,4627
佭,CuiJiangZhen,350424100,47280,4964,31634,18438,37350,29323,10647,29295,58618,31257,62891
Ȫ,QuanShangZhen,350424101,11473,1944,7966,4878,15142,7879,2792,8104,15983,8243,16209
,HuCunZhen,350424102,9229,1520,6234,4085,11266,6161,2164,6477,12638,6679,12913
ʯ,ShiBiZhen,350424103,18320,2915,12230,7279,23182,11829,3854,12053,23882,12859,25089
ǽ,ChengJiaoXiang,350424200,13901,1920,9050,5173,15294,8956,2877,9315,18271,9648,18698
,ChengNanXiang,350424201,5486,790,3624,2190,6846,3545,1109,3705,7250,3761,7385
ô,JiCunXiang,350424202,7621,1263,5170,3137,10148,5107,1573,5144,10251,5287,10457
,HuaiTuXiang,350424203,12854,2699,9300,5686,17773,9247,3459,9480,18727,9712,19012
,FangTianXiang,350424204,3582,837,2622,1994,5127,2622,843,2633,5255,2640,5262
,AnLeXiang,350424205,9630,1401,6524,3680,12864,6505,2322,6773,13278,6829,13353
ܷ,CaoFangXiang,350424206,9280,1791,7334,4895,13257,7304,3662,7291,14595,7399,14733
ƽ,ZhiPingSheZuXiang,350424207,5787,1068,4070,2582,7977,4036,1519,4210,8246,4304,8374
ɳ,ZhongShaXiang,350424208,6736,1193,4840,3010,9243,4782,1894,4798,9580,4983,9823
,HeLongXiang,350424209,3788,623,2662,1675,5260,2652,1027,2752,5404,2776,5438
ˮ,ShuiQianXiang,350424210,12585,2445,9152,5548,17812,9148,3267,9122,18270,9145,18297
Զ,AnYuanXiang,350424211,16742,2625,11861,7123,23538,11796,5142,12462,24258,12648,24509
Ϫ,JunXiZhen,350425100,76045,5118,47032,28988,59848,43407,16851,46535,89942,50982,98014
ʯ,ShiPaiZhen,350425101,10619,1348,6610,4340,12205,6519,2047,7212,13731,7404,14014
Ͼ,ShangJingZhen,350425102,14370,1561,8567,5785,14688,8367,2672,9385,17752,10036,18603
ƽ,GuangPingZhen,350425103,22316,2683,13525,7991,26481,13428,4395,15065,28493,15869,29394
Դ,TaoYuanZhen,350425104,10322,1249,6303,3965,12363,6244,1821,6908,13152,7089,13392
̫,TaiHuaZhen,350425105,20973,2320,12466,7422,24912,12301,3334,13487,25788,14161,26627
,JianSheZhen,350425106,16507,1773,9518,5347,18520,9154,2675,10506,19660,11437,20955
,QiTaoZhen,350425107,7880,1134,4860,2927,9638,4816,1457,5428,10244,5611,10471
,HuaXingXiang,350425200,5066,865,3128,2133,6260,3110,618,3335,6445,3421,6549
ɽ,PingShanXiang,350425201,5500,1112,3548,2590,7117,3535,743,3721,7256,3807,7355
ɽ,WuShanXiang,350425202,5518,642,3251,2118,6208,3072,955,3347,6419,3864,7115
,JiYangXiang,350425203,3936,649,2454,1637,4928,2426,581,2587,5013,2712,5166
,WuLingXiang,350425204,5108,861,3265,2195,6447,3244,909,3519,6763,3613,6878
л,XieYangXiang,350425205,3772,604,2319,1458,4688,2291,541,2504,4795,2598,4917
Ľ,WenJiangXiang,350425206,10130,1542,6195,3841,12729,6141,1712,6881,13022,7189,13384
÷ɽ,MeiShanXiang,350425207,10404,1738,6658,4687,13413,6650,2046,7444,14094,7530,14188
,HuMeiXiang,350425208,5843,863,3647,2595,7173,3588,1015,3861,7449,4074,7721
ǰƺ,QianPingXiang,350425209,3778,514,2286,1385,4517,2255,568,2399,4654,2574,4860
ũ,DongFengNongChang,350425400,1500,294,988,692,1892,975,234,1010,1985,1040,2028
ǹ,ChengGuanZhen,350426100,54249,4097,33069,21633,41498,30442,11114,32202,62644,36391,69460
÷,MeiXianZhen,350426101,20735,2972,13192,8083,25398,13152,4428,14790,27942,14943,28135
,XiBinZhen,350426102,14972,2078,9769,6606,18366,9604,3185,10214,19818,10466,20235
,YangZhongZhen,350426103,15708,2109,9980,6485,19329,9795,3295,10593,20388,11132,21112
,XinYangZhen,350426104,21756,3773,14421,9715,28560,14171,4925,15746,29917,16033,30454
ǰ,GuanQianZhen,350426105,12737,2088,8189,5801,16595,8179,2752,9287,17466,9388,17577
,XiChengZhen,350426106,32282,3375,19934,12252,31567,18982,6601,20750,39732,22324,42258
Ϫ,YouXiKouZhen,350426107,738,88,468,361,450,455,166,483,938,524,992
,LianHeXiang,350426200,10819,1876,7128,4602,14096,7084,2101,7551,14635,7668,14796
,TangChuanXiang,350426201,8320,1430,5323,4002,10739,5285,1652,5907,11192,6079,11402
Ϫβ,XiWeiXiang,350426202,6926,1178,4476,3420,8716,4415,1419,4955,9370,5047,9523
,ZhongXianXiang,350426203,19942,2553,11899,8071,23124,11813,4231,13424,25237,14827,26726
̨Ϫ,TaiXiXiang,350426204,17692,2274,11241,6699,21988,11118,3863,12123,23241,12588,23829
,BanMianXiang,350426205,20094,2798,12705,8218,25263,12671,3693,13734,26405,13880,26585
,BaZiQiaoXiang,350426206,6619,991,4132,2733,8458,4095,1373,4768,8863,4851,8983
ڽֵ,FengGangJieDao,350427001,58514,6883,38699,25422,48191,36803,13246,37105,73908,39944,78643
򰽭ֵ,QiuJiangJieDao,350427002,23146,2873,15316,10711,16947,14974,6212,15845,30819,16915,32231
,QingZhouZhen,350427101,8557,1279,5871,4017,9403,5727,2605,6061,11788,6570,12441
ï,XiaMaoZhen,350427102,15784,3031,11996,7934,21414,11744,5920,12227,23971,12739,24735
ɰ,GaoShaZhen,350427104,8220,1456,5490,3928,9869,5373,2364,5926,11299,6550,12040
,GaoQiaoZhen,350427105,8429,1508,6063,4006,10996,5983,2703,6398,12381,6577,12640
,FuKouZhen,350427106,6424,1378,4482,3571,7866,4355,1877,4754,9109,5197,9679
,DaLuoZhen,350427107,4779,906,3270,2347,6250,3240,1316,3647,6887,3731,7001
ϼ,NanXiaXiang,350427201,4171,963,3125,2069,6024,3118,1466,3439,6557,3475,6600
,NanYangXiang,350427203,4147,948,2946,2070,5717,2918,1302,3280,6198,3451,6397
֣,ZhengHuXiang,350427204,4430,917,3119,2164,6071,3097,1365,3518,6615,3593,6712
Դ,HuYuanXiang,350427205,2593,520,1784,1231,3534,1774,842,2123,3897,2171,3955
ɳ԰,JinShaYuanKaiFaQu,350427400,3790,73,1745,1596,153,1492,590,1930,3422,2708,4453
԰,JinGuYuanKaiFaQu,350427401,1911,65,869,724,281,726,269,905,1631,1376,2245
ɽֽҵҵ,QingShanZhiYeGongYeQu,350427402,5115,552,3347,2828,5277,3201,1230,3379,6580,3550,6897
,GuYongZhen,350428100,33511,3652,21323,13348,25996,20632,7598,20860,41492,23438,44761
,WanAnZhen,350428101,5130,778,3519,2187,6567,3499,1364,3655,7154,3753,7272
,GaoTangZhen,350428102,6761,1018,4486,2767,8469,4338,1573,4601,8939,4866,9352
,BaiLianZhen,350428103,6187,1354,4555,3003,7983,4519,1706,4512,9031,4692,9247
̶,HuangTanZhen,350428104,6927,1013,4817,2794,9031,4791,1790,4839,9630,4913,9730
ˮ,ShuiNanZhen,350428105,18315,1646,11351,7182,9669,10955,4012,11268,22223,12622,23973
,GuangMingXiang,350428200,4717,670,2938,1814,5596,2859,906,3015,5874,3355,6293
ĮԴ,MoYuanXiang,350428201,3108,604,2043,1269,3908,2010,874,2239,4249,2543,4586
Ͽ,NanKouXiang,350428202,7048,1102,4818,2752,9215,4771,1676,4923,9694,5008,9826
ȫ,WanQuanXiang,350428203,3542,600,2400,1485,4461,2386,883,2586,4972,2625,5025
,AnRenXiang,350428204,4891,979,3496,2314,6961,3476,1483,3798,7274,3857,7353
Դ,DaYuanXiang,350428205,4157,717,2954,1873,5743,2927,1304,3127,6054,3224,6178
෻,YuFangXiang,350428206,3748,612,2457,1631,4829,2409,911,2596,5005,2814,5271
ɼ,ShanChengZhen,350429100,37962,4008,24073,15259,33164,23215,8375,23566,46781,26272,50345
,ZhuKouZhen,350429101,12100,1991,8378,5427,16262,8231,3279,8672,16903,8992,17370
,XinQiaoXiang,350429200,4053,576,2711,1693,5338,2643,989,2785,5428,2907,5618
,ShangQingXiang,350429201,3837,718,2629,1743,5257,2581,927,2721,5302,2853,5482
,DaTianXiang,350429202,4808,547,2611,1454,5002,2446,801,2574,5020,3545,6156
÷,MeiKouXiang,350429203,3087,448,1996,1153,3948,1979,614,2090,4069,2153,4149
,XiaQuXiang,350429204,5039,765,3407,1982,6733,3310,1157,3385,6695,3554,6961
,KaiShanXiang,350429205,4232,634,2777,1611,5235,2669,914,2773,5442,3003,5780
,DaLongXiang,350429208,5999,901,4051,2315,7760,3980,1517,4139,8119,4366,8417
Ϫ,SuiXiZhen,350430100,26847,2829,18098,11414,24672,17385,6396,17090,34475,17974,36072
,LiXinZhen,350430101,11818,1784,8214,5383,14853,8156,3149,8219,16375,8537,16751
Ϫ,XiKouZhen,350430102,12581,1727,8549,5323,14590,8505,2956,8549,17054,8715,17264
,JunKouZhen,350430103,9909,1332,6977,4001,13032,6918,2992,6949,13867,7256,14233
,YiJiaXiang,350430201,5292,968,3851,2593,7265,3815,1535,3864,7679,3944,7795
Ʒ,HuangFangXiang,350430202,4708,745,3030,2015,5628,2950,950,2982,5932,3373,6403
ϪԴ,XiYuanXiang,350430203,4361,723,2976,1935,5773,2956,1055,3106,6062,3163,6139
ͷ,KeFangXiang,350430204,4266,949,3234,2297,6099,3221,1273,3224,6445,3254,6488
Ʋ,HuangBuXiang,350430205,6215,937,4241,2575,7767,4205,1538,4255,8460,4449,8690
ɹҵ԰,XiangFeiGongYeYuanQu,350430400,117,12,66,37,92,55,15,63,118,78,144
ණֵ,YanDongJieDao,350481001,31262,4453,19907,14021,21736,18270,5650,18327,36597,21458,41365
ֵ,YanXiJieDao,350481002,26109,2694,16330,11061,21440,15384,5318,15848,31232,17791,34121
Ͻֵ,YanNanJieDao,350481003,49943,5514,32914,22821,40671,31936,10949,32080,64016,33492,66406
౱ֵ,YanBeiJieDao,350481004,28323,2778,14911,10412,17750,14164,4567,14719,28883,20757,35668
,XiYangZhen,350481100,11466,1603,7624,5027,13932,7585,2717,7904,15489,8162,15786
,GongChuanZhen,350481101,6243,966,4095,2603,7684,4010,1456,4341,8351,4570,8665
ɰ,AnShaZhen,350481102,13268,1487,7797,5933,11596,7709,2978,8715,16424,9936,17733
С,XiaoTaoZhen,350481103,17911,2748,11763,7809,22843,11665,4202,12809,24474,13098,24861
,DaHuZhen,350481104,12568,1708,8220,5048,15517,8178,2991,8838,17016,9047,17267
Զ,CaoYuanZhen,350481105,23200,2047,12607,9822,17288,11991,4377,13916,25907,17017,29624
,HongTianZhen,350481106,11176,1579,7056,4726,12841,6951,2583,7643,14594,8282,15338
,HuaiNanXiang,350481201,12634,1629,8000,4634,15363,7932,3332,9338,17270,9595,17595
ƺ,ShangPingXiang,350481202,3833,588,2556,1718,4544,2541,1009,2844,5385,2874,5430
޷,LuoFangXiang,350481203,2987,494,2016,1442,3600,1973,732,2114,4087,2197,4213
ˮ,QingShuiXiang,350481204,9305,1340,5935,3791,11698,5857,2325,6586,12443,7035,12970
ֵ,HaiBinJieDao,350502001,31646,3798,20667,13964,20378,19411,5245,18682,38093,20022,40689
ٽֵ,LinJiangJieDao,350502002,18094,2260,11702,7599,12485,10612,2663,10099,20711,11315,23017
нֵ,LiZhongJieDao,350502003,42091,5455,27591,18393,27983,24357,6350,23215,47572,26305,53896
Ԫֵ,KaiYuanJieDao,350502004,49523,5595,32963,19686,33964,27749,8127,26232,53981,30282,63245
Žֵ,FuQiaoJieDao,350502005,27838,1850,16389,11082,15377,14679,4450,15398,30077,17749,34138
Ͻֵ,JiangNanJieDao,350502006,48110,1635,26449,19875,13338,22394,6893,24591,46985,30189,56638
ֵ,JinLongJieDao,350502007,48704,1614,26909,17855,13338,20221,6347,22580,42801,29756,56665
ֵ̩,ChangTaiJieDao,350502008,33128,1672,17787,12756,15220,15214,4971,17125,32339,21984,39771
�ÿ,QingMengJingJiKaiFaQu,350502400,34314,112,16746,7666,1325,7744,2332,8746,16490,20012,36758
ֵ,DongHuJieDao,350503001,59322,3566,34492,23177,25572,31654,9930,30815,62469,38326,72818
ֵ,FengZeJieDao,350503002,76964,4644,47681,31259,37869,42618,13189,41384,84002,47116,94797
Ȫֵ,QuanXiuJieDao,350503003,38956,2091,22636,14543,17475,19841,6334,20044,39885,24745,47381
Դֵ,QingYuanJieDao,350503004,35420,1973,20665,13860,10927,19159,6741,20088,39247,23469,44134
ֵ,HuaDaJieDao,350503005,28338,1082,14800,7414,11457,8280,2330,8993,17273,16950,31750
Ƕֵ,ChengDongJieDao,350503006,40126,1905,21874,15021,20257,18816,5950,20627,39443,26107,47981
ֵ,DongHaiJieDao,350503007,100761,3387,58553,30918,34492,40086,13437,42732,82818,59032,117585
ֵ,BeiFengJieDao,350503008,62557,2330,32961,21897,21430,25781,8307,28906,54687,40233,73194
򰲽ֵ,WanAnJieDao,350504001,26655,860,14873,9350,9599,11449,3917,12448,23897,16559,31432
˫ֵ,ShuangYangJieDao,350504002,29517,1244,16468,10472,13025,12955,4176,13819,26774,18469,34937
Ϫ,LuoXiZhen,350504100,16602,2640,12081,8149,20300,11638,4202,10688,22326,11363,23444
,MaJiaZhen,350504101,48230,3544,30383,14850,40026,22590,8214,22491,45081,29605,59988
,HeShiZhen,350504102,24684,2461,16248,10101,26002,15551,5586,15371,30922,16483,32731
ɽ,HongShanXiang,350504200,2981,689,2413,1921,4308,2384,987,2175,4559,2244,4657
ɽֵ´,ShanYaoJieDaoBanShiChu,350505001,48233,4383,31272,18944,48980,28612,8975,26750,55362,30319,61591
,NanPuZhen,350505100,40088,4774,27247,17466,48265,26778,9347,25516,52294,26962,54209
ɽ,JieShanZhen,350505101,29696,3643,20689,11889,37092,20131,7064,19055,39186,19714,40403
,HouLongZhen,350505102,33788,3453,22175,14265,32357,21408,6871,20520,41928,21937,44112
β,FengWeiZhen,350505103,30861,3867,21604,13978,38500,21347,7046,19858,41205,20170,41774
ǰ,QianHuangZhen,350505105,24246,2797,16625,10368,28003,16229,4912,14320,30549,15330,31955
Ϳ,TuLingZhen,350505106,29685,3569,20296,12208,35187,19656,6241,17511,37167,19199,39495
ݳ,LuoChengZhen,350521100,90496,7412,58592,35005,72407,51735,16476,47154,98889,55792,114384
,LuoYangZhen,350521101,61091,5687,40112,21777,63926,37670,11668,34592,72262,38334,78446
,HuangTangZhen,350521102,30206,2735,19434,10743,33969,18716,6161,18211,36927,19668,39102
ɽ,ZiShanZhen,350521103,23550,2455,15879,8853,27752,15214,4709,14121,29335,14835,30714
,LuoYangZhen,350521104,55401,4782,34414,17652,51809,29952,9099,28669,58621,34868,69282
԰,DongYuanZhen,350521105,44822,4409,29334,14729,46332,26248,7953,24493,50741,27850,57184
,ZhangBanZhen,350521106,51231,5496,34982,19886,60300,34478,10703,31460,65938,32448,67430
,ChongWuZhen,350521107,63428,5732,40124,24284,65285,38646,12570,37920,76566,41606,81730
ɽϼ,ShanXiaZhen,350521108,33593,3306,23477,13083,39397,22898,7253,19269,42167,20675,44152
Ϳկ,TuZhaiZhen,350521109,55663,5843,38960,21271,67722,38182,10939,32378,70560,33485,72445
,DongLingZhen,350521110,42881,4013,29746,15891,49426,28024,8554,23924,51948,25702,55448
,DongQiaoZhen,350521111,40679,4137,28648,15744,49904,28288,8950,23253,51541,25118,53766
,JingFengZhen,350521112,38142,4623,28194,16090,49011,28078,9655,22935,51013,24226,52420
С,XiaoZuoZhen,350521113,20549,2161,14426,8154,26911,14374,4816,13006,27380,13100,27526
,WangChuanZhen,350521114,43843,5115,30597,17721,54889,30293,8977,26752,57045,27338,57935
,BaiQiHuiZuXiang,350521200,15098,1246,9410,4990,12887,8314,3349,8368,16682,10283,19693
Ϲҵ,ChengNanGongYeQu,350521400,7884,23,4379,1782,377,1444,249,1682,3126,3777,8156
Ϲҵ,HuiNanGongYeQu,350521401,13637,27,5880,3022,58,3174,754,3504,6678,8538,14418
,FengChengZhen,350524100,79941,3909,49714,33401,53403,46161,20070,49868,96029,54206,103920
,PengLaiZhen,350524101,41706,4518,27674,15614,50273,26480,9620,26912,53392,28170,55844
ͷ,HuTouZhen,350524102,55691,4764,35586,20130,67204,34534,13549,37079,71613,38418,74004
,GuanQiaoZhen,350524103,48519,4863,32584,18284,58354,30828,12248,31432,62260,33046,65630
,JianDouZhen,350524104,30354,2253,19329,9848,35069,19152,7756,20377,39529,21034,40363
,ChengXiangZhen,350524105,65575,4881,40903,23095,53871,38125,15686,40983,79108,45239,86142
,JinGuZhen,350524106,25396,2993,17322,10243,32730,17063,7433,17890,34953,18500,35822
,LongMenZhen,350524107,42470,4471,27990,15773,51109,27069,10353,27484,54553,29304,57294
,HuQiuZhen,350524108,31774,2933,20957,10906,38177,20817,8332,21909,42726,22082,43039
«,LuTianZhen,350524109,8723,869,5658,3423,10331,5640,2459,6312,11952,6393,12051
е,GanDeZhen,350524110,40173,2478,25687,12865,47541,25192,10642,26849,52041,27606,53293
,KuiDouZhen,350524111,16112,1647,10425,5961,20451,10409,3457,10730,21139,10791,21216
ƺ,XiPingZhen,350524112,34744,3153,21909,11705,41386,21842,7853,23609,45451,23841,45750
,CanNeiXiang,350524200,15256,1817,10223,6110,18589,10098,3886,10217,20315,10736,20959
,BaiLaiXiang,350524201,6114,486,3876,2296,7460,3844,1701,4280,8124,4425,8301
,HuShangXiang,350524202,14350,1340,9366,5619,17591,9309,3925,10038,19347,10249,19615
,ShangQingXiang,350524203,21146,2117,13893,7927,25985,13796,5205,14259,28055,14575,28468
ƺ,DaPingXiang,350524204,8639,1179,5478,3652,10538,5453,1967,6224,11677,6307,11785
,LongJuanXiang,350524205,39068,4706,28075,14988,49192,28003,13226,28671,56674,28925,57000
,ChangKengXiang,350524206,47884,4333,31170,18041,56182,30944,13431,34153,65097,34478,65648
,LanTianXiang,350524207,14479,1393,9721,5832,17294,9674,4006,9921,19595,10157,19878
黪,XiangHuaXiang,350524208,24436,1775,15920,7909,29258,15861,7284,17272,33133,17575,33495
,TaoZhouXiang,350524209,7923,658,4964,2760,9443,4921,1963,5439,10360,5580,10544
,FuTianXiang,350524210,5428,507,3426,2161,6490,3412,1439,3829,7241,3948,7374
ҳ,TaoChengZhen,350525100,56900,5814,37584,21558,50010,33462,11665,33505,66967,36795,74379
,WuLiJieZhen,350525101,26910,3064,18510,11501,23630,18083,6546,17493,35576,18010,36520
һ,YiDouZhen,350525102,11089,1018,6605,4608,12495,6233,2235,7068,13301,7737,14342
,XiaYangZhen,350525103,17740,838,8222,5941,11679,7772,2991,9039,16811,13347,21569
,PengHuZhen,350525104,36837,4582,25556,16465,47409,25215,10182,25609,50824,26045,51601
,DaPuZhen,350525105,40912,4827,27713,16006,52280,27520,11677,29273,56793,29703,57416
,WuFengZhen,350525106,8709,1354,6204,4303,11960,6195,2529,6352,12547,6388,12592
ʯ,ShiGuZhen,350525107,20888,2510,13989,8634,25219,13913,4876,14182,28095,14285,28274
ɽ,HuShanZhen,350525108,12347,1872,8893,5734,16149,8714,3232,8285,16999,8558,17451
ƽ,DongPingZhen,350525109,12393,1479,8243,4705,15804,8111,2620,8054,16165,8249,16492
,HuYangZhen,350525110,9610,2652,7449,6429,13921,7422,2587,7347,14769,7400,14849
п,KengZaiKouZhen,350525111,12114,1053,7174,4460,13610,7128,2401,8020,15148,8394,15568
,YuDouZhen,350525112,11716,1234,7619,4948,14897,7582,3163,8370,15952,8494,16113
,JinDouZhen,350525113,10281,1097,6626,4269,12905,6612,2522,7213,13825,7274,13900
,DongGuanZhen,350525114,6428,1098,4698,3386,8649,4673,1709,4494,9167,4537,9235
,GuiYangZhen,350525115,6520,916,4248,3142,8362,4205,1317,4437,8642,4505,8753
տ,SuKengZhen,350525116,7668,1087,5135,3741,10224,5135,1940,5548,10683,5560,10695
ɼ,XianJiaZhen,350525117,6461,1090,4765,2931,8725,4703,1808,4474,9177,4594,9359
,HengKouXiang,350525200,5864,523,3392,2217,6399,3283,1284,3793,7076,4279,7671
,ChengXiangXiang,350525201,4672,523,2970,1704,5769,2961,1011,3215,6176,3236,6206
鸣,JieFuXiang,350525202,4694,552,3103,2180,5956,3087,1228,3324,6411,3371,6474
ɽ,WaiShanXiang,350525204,1693,375,1313,1185,2261,1313,690,1440,2753,1445,2758
,XunZhongZhen,350526100,58085,2760,36347,23518,25571,34550,13717,36204,70754,38215,74562
,LongXunZhen,350526101,92498,4362,58504,39911,44099,57526,23071,60549,118075,61427,119931
,SanBanZhen,350526102,13164,1261,8327,5382,15448,8286,2747,8772,17058,8845,17172
̲,LongMenTanZhen,350526103,3242,780,2139,2257,4261,2115,443,2231,4346,2326,4465
׷,LeiFengZhen,350526104,3791,989,2689,2675,5259,2682,614,2681,5363,2705,5394
,NanChengZhen,350526105,2423,759,1617,1802,3234,1588,272,1707,3295,1837,3454
ˮ,ShuiKouZhen,350526106,3716,1017,2493,2558,4793,2418,529,2541,4959,2769,5262
ˮ,ChiShuiZhen,350526107,2844,928,1954,2213,3847,1924,291,1951,3875,2109,4063
ӿ,ShangYongZhen,350526108,6055,1146,3888,3706,7147,3623,796,3511,7134,4109,7997
,GeKengZhen,350526109,4403,898,2669,2719,5318,2602,687,2816,5418,3319,5988
÷,YangMeiXiang,350526200,1743,392,1049,1123,2113,1028,199,1195,2223,1285,2334
ͷ,TangTouXiang,350526202,2210,428,1330,1548,2658,1327,205,1497,2824,1513,2843
,GuiYangXiang,350526204,1776,406,1111,1255,2220,1098,224,1216,2314,1295,2406
ǵ,GaiDeXiang,350526205,6183,1211,4072,3335,8048,4065,981,4273,8338,4303,8375
,GuoBaoXiang,350526206,2262,688,1614,1672,3142,1607,280,1592,3199,1616,3230
,MeiHuXiang,350526207,3761,984,2420,2401,4812,2387,413,2529,4916,2738,5158
,DaMingXiang,350526208,1107,373,772,904,1534,766,123,781,1547,831,1603
,ChunMeiXiang,350526209,2685,702,1772,1742,3459,1754,243,1771,3525,1858,3630
ֵ,HuBinJieDao,350581001,72735,2808,40628,26391,26871,33550,9653,35803,69353,44568,85196
ֵ,FengLiJieDao,350581002,63131,2683,34385,19709,22677,25429,6820,27445,52874,38249,72634
,LingXiuZhen,350581100,109604,2695,57399,33519,26240,39048,11817,42719,81767,66717,124116
,BaoGaiZhen,350581101,79988,2840,42340,24122,31358,30039,8979,33086,63125,49467,91807
,HanJiangZhen,350581102,62915,3837,35763,19276,44235,29510,9674,31901,61411,40663,76426
֥,XiangZhiZhen,350581103,42367,2296,23167,13145,27379,19064,7417,21283,40347,28913,52080
ɽ,HongShanZhen,350581104,34122,2029,18398,11313,23831,16760,5410,18214,34974,23163,41561
,JinShangZhen,350581105,27467,1795,14899,10627,18768,13955,4134,15414,29369,18497,33396
,YongNingZhen,350581106,48240,3918,28388,17033,35352,25508,7326,26190,51698,31096,59484
ֵ´,QingYangJieDaoBanShiChu,350582001,87043,3829,48713,30410,38981,39760,13362,41998,81758,55521,104234
÷ֵ´,MeiLingJieDaoBanShiChu,350582002,55912,2544,31292,20063,24810,26448,8810,28668,55116,35974,67266
԰ֵ´,XiYuanJieDaoBanShiChu,350582003,38815,2508,23534,13250,31544,21237,8292,22544,43781,26081,49615
ɽֵ´,LuoShanJieDaoBanShiChu,350582004,59983,3334,34223,16919,43141,27682,10425,29948,57630,39519,73742
ֵ´,XinTangJieDaoBanShiChu,350582005,55307,2863,31077,17935,29333,26103,8870,27684,53787,35963,67040
Դֵ´,LingYuanJieDaoBanShiChu,350582006,27648,1973,16488,9272,24849,15531,5353,16749,32280,18486,34974
,AnHaiZhen,350582101,132169,9056,79844,42447,102458,70657,25529,73142,143799,86910,166754
,CiZaoZhen,350582102,82073,6021,48351,29485,65145,43934,13943,45105,89039,53686,102037
ܤ,ChenDaiZhen,350582103,331056,5982,160746,79747,71663,97849,33468,110583,208432,209760,370506
ʯ,DongShiZhen,350582104,128133,8066,76379,39533,88533,63757,25106,66551,130308,84926,161305
,ShenHuZhen,350582105,75198,4372,44066,24603,37597,34829,10045,35245,70074,45549,89615
,JinJingZhen,350582106,67667,5355,40527,24785,41105,34558,10631,35259,69817,43126,83653
ص,ChiDianZhen,350582107,129229,4653,70350,48487,50612,60083,19622,66734,126817,83154,153504
ڿ,NeiKengZhen,350582109,62914,4866,38200,19972,54502,34318,12549,34616,68934,42129,80329
,LongHuZhen,350582110,100125,7133,57228,32703,66518,47288,13868,49336,96624,63898,121126
,YongHeZhen,350582111,85257,4997,49028,24442,57479,40937,15193,43733,84670,56419,105447
Ӣ,YingLinZhen,350582112,74726,3787,42363,16814,38399,27773,11503,28710,56483,47653,90016
ñ,ZiMaoZhen,350582113,12682,1028,7570,4387,10947,6958,2208,6902,13860,8348,15918
,XiBinZhen,350582114,12861,178,5970,3929,1224,4453,1409,5019,9472,8478,14448
ƽ,AnPingKaiFaQu,350582400,6608,174,3515,2295,34,2349,680,2767,5116,3947,7462
оÿ,JinJiangShiJingJiKaiFaQu,350582401,26381,47,10989,4810,76,3564,621,4792,8356,16060,27049
Ȫݳڼӹ,QuanZhouChuKouJiaGongQu,350582402,391,1,139,103,0,69,15,95,164,268,407
Ϫֵ,XiMeiJieDao,350583001,66626,5316,41138,22906,61331,36825,12289,37640,74465,43093,84231
ǽֵ,LiuChengJieDao,350583002,53425,4087,33463,18912,50074,31545,11036,31905,63450,35085,68548
ֵֽ,MeiLinJieDao,350583003,59947,4688,34948,16768,57366,30833,10415,33341,64174,40102,75050
ʡ,ShengXinZhen,350583100,38476,2926,23180,11410,36749,20808,7308,21986,42794,25530,48710
ز,LunCangZhen,350583101,69197,2926,34351,11311,28042,17240,5697,18091,35331,43469,77820
,DongTianZhen,350583102,25010,3119,16800,9188,32269,16571,5696,16438,33009,17025,33825
Ӣ,YingDouZhen,350583103,26333,3871,17473,10220,31004,16539,4838,16031,32570,17569,35042
,XiangYunZhen,350583104,10221,1863,7689,5206,13673,7637,3097,7400,15037,7492,15181
,JinTaoZhen,350583105,43406,5654,29745,17013,54292,28665,9369,27445,56110,28684,58429
ʫɽ,ShiShanZhen,350583106,44310,5811,30463,17191,55327,29720,9704,28438,58158,29362,59825
,PengHuaZhen,350583107,7148,1603,5704,3945,10360,5665,2178,5139,10804,5225,10929
ͷ,MaTouZhen,350583108,36487,5150,25646,13864,45686,24788,8122,23060,47848,24113,49759
Ŷ,JiuDouZhen,350583109,11367,1101,7372,4553,11530,6924,2157,6777,13701,7253,14625
ַ,LeFengZhen,350583110,19922,2471,13642,7351,25779,13623,4324,13002,26625,13075,26717
޶,LuoDongZhen,350583111,32174,3975,22218,12418,39211,21225,7019,19812,41037,20950,43168
÷ɽ,MeiShanZhen,350583112,51527,4638,32533,15445,52415,28473,8908,28307,56780,32540,65073
,HongLaiZhen,350583113,68144,5915,42650,20340,72045,38629,12292,39198,77827,43701,86351
÷,HongMeiZhen,350583114,22599,2898,16189,9460,29685,16097,5625,14805,30902,14933,31122
,KangMeiZhen,350583115,40825,3562,25795,12378,41004,22147,7743,21792,43939,26335,52130
,FengZhouZhen,350583116,35208,3357,22023,10922,37794,20835,6085,20844,41679,22627,44650
ϼ,XiaMeiZhen,350583117,54669,4623,32683,16001,59612,31261,9202,31881,63142,35811,68494
,GuanQiaoZhen,350583118,84938,7460,52419,29641,79127,48610,16054,48693,97303,56033,108452
ˮͷ,ShuiTouZhen,350583119,117601,8319,66771,36567,81541,56640,21417,57307,113947,80566,147337
ʯ,ShiJingZhen,350583120,72289,5817,43734,25384,61638,40733,14700,41512,82245,49072,92806
üɽ,MeiShanXiang,350583200,7365,1512,5447,4011,9979,5438,1803,5210,10648,5233,10680
,XiangYangXiang,350583201,5725,788,3842,2419,7604,3810,1388,3893,7703,4059,7901
ѩί,XueFengGuanWeiHui,350583400,1326,91,662,604,490,609,179,690,1299,934,1596
ͷֵ,DongPuTouJieDao,350602001,51745,4814,31733,14418,35430,20451,5506,18623,39074,30332,62065
Žֵ,XiQiaoJieDao,350602002,17759,2680,11892,8408,13991,11556,3197,11189,22745,11744,23636
Žֵ,XinQiaoJieDao,350602003,45986,4542,30628,18936,33888,28733,8948,27189,55922,28848,59476
ڽֵ,XiangKouJieDao,350602004,58610,6517,38995,26420,45477,36894,11117,35073,71967,37249,76244
Ͽӽֵ,NanKengJieDao,350602005,61054,6397,40192,27083,47386,39040,13541,39042,78082,40800,80992
ֵͨ,TongBeiJieDao,350602006,55332,4407,34072,16205,23591,21782,6959,21275,43057,32626,66698
,PuNanZhen,350602100,19008,2628,12281,8053,22251,12171,3969,12566,24737,13324,25605
챦,TianBaoZhen,350602101,31975,3996,21311,13239,39047,20840,7338,21188,42028,21998,43309
֥ɽ,ZhiShanZhen,350602102,33498,2120,19909,13836,17129,18037,6642,19519,37556,22351,42260
ʯͤ,ShiTingZhen,350602103,40328,3464,25481,16097,36591,24870,9549,26396,51266,27860,53341
ܼţ,XiangChengQuNaiNiuChang,350602400,35,5,15,25,13,15,1,26,41,26,41
ũ,HouFangNongChang,350602401,1231,175,787,569,1293,774,203,775,1549,822,1609
챦ֳ,TianBaoLinChang,350602402,84,12,34,43,36,27,3,49,76,65,99
ũ,DaFangNongChang,350602403,1544,187,903,517,1503,802,275,812,1614,1103,2006
ũ,WuFengNongChang,350602404,585,99,397,302,740,397,121,408,805,408,805
,LanTianZhen,350603100,36307,2682,21671,13838,30595,20228,6855,21400,41628,24173,45844
,BuWenZhen,350603101,38633,2672,24314,14976,29770,23008,8753,23531,46539,25744,50058
,ZhaoYangZhen,350603102,30156,3385,19461,10901,35216,19063,6301,19613,38676,20381,39842
,GuoKengZhen,350603103,13051,1684,8355,4773,14473,8122,2612,8311,16433,8992,17347
￪ί,LanTianKaiFaQuGuanWeiHui,350603500,13018,284,6614,3805,1921,3504,1070,4320,7824,7758,14372
,YunLingZhen,350622100,49537,5702,32992,18611,51930,32232,12203,33301,65533,34450,67442
,ChenDaiZhen,350622101,26516,3635,17603,9374,34602,17548,5664,18085,35633,18212,35815
,DongShaZhen,350622102,38347,4849,25056,13652,50056,24958,9276,27111,52069,27416,52472
,PuMeiZhen,350622103,58339,5063,38380,19991,48952,36910,15111,38815,75725,40133,78513
,LieYuZhen,350622104,14957,2160,9806,5567,19856,9773,3253,10502,20275,10564,20370
,HuoTianZhen,350622105,36342,4574,24480,13771,47851,24448,10164,26539,50987,26600,51080
º,XiaHeXiang,350622200,29889,3489,19295,10521,38545,18820,8060,21791,40611,22143,41438
,MaPuXiang,350622201,19506,2920,13903,8369,27724,13899,7013,15516,29415,15536,29439
ƽ,HePingXiang,350622202,9207,1580,6349,4120,12825,6337,2720,7087,13424,7158,13507
ƽũ,HePingNongChang,350622400,3954,564,2659,1612,5303,2655,1120,2974,5629,2979,5638
ɽȾÿ,ChangShanHuaQiaoJingJiKaiFaQu,350622500,14761,1944,9648,5602,16860,9430,3416,9703,19133,10473,20121
簲,SuiAnZhen,350623100,98771,8939,64227,34999,94976,59479,20431,59165,118644,63914,128141
,JiuZhenZhen,350623101,51406,5912,33898,18043,65238,33443,11562,34328,67771,34982,68880
,FoTanZhen,350623102,40573,4528,26988,15142,50666,26093,9259,26513,52606,27372,54360
,ChiHuZhen,350623103,39667,4470,26531,14528,50735,25716,9871,26638,52354,27477,54008
,DuXunZhen,350623104,42613,5557,28601,15910,56669,28483,10207,29530,58013,29776,58377
ϼ,XiaMeiZhen,350623105,40113,4768,26584,13637,52927,26539,9501,27775,54314,27798,54382
,GuanXunZhen,350623106,12822,1769,8972,5481,16764,8763,3437,8709,17472,9056,18028
ʯ,ShiLiuZhen,350623107,30810,3867,20200,11316,40299,20159,6709,21111,41270,21186,41386
,PanTuoZhen,350623108,20324,2216,13850,7200,24762,12930,4970,12966,25896,13660,27510
,ChangQiaoZhen,350623109,9263,1223,6110,3724,11217,6053,2015,6169,12222,6391,12501
ǰͤ,QianTingZhen,350623110,20602,2562,13910,8009,27244,13764,5259,14144,27908,14513,28423
ƺ,MaPingZhen,350623111,10524,1527,7217,4357,14046,7183,2649,7385,14568,7483,14700
,ShenTuZhen,350623112,35188,4088,23270,12632,46053,23120,8809,24563,47683,24815,48085
,LiuAoZhen,350623113,18533,2240,12012,6736,23852,11901,4392,12604,24505,13153,25165
ɳ,ShaXiZhen,350623114,31081,4051,20168,11118,40737,20155,6526,21454,41609,21490,41658
,GuLeiZhen,350623115,27321,2943,17105,8716,33428,16920,5756,17302,34222,18915,36020
,DaNanBanZhen,350623116,6997,860,4557,2683,7792,4383,1648,4412,8795,4948,9505
,NanPuXiang,350623200,5529,886,3865,2620,7410,3855,1418,3940,7795,3968,7833
,ChiLingSheZuXiang,350623201,8019,878,5404,3132,10843,5391,2258,5710,11101,5751,11155
,HuXiSheZuXiang,350623202,16287,2016,11115,6121,22196,11075,4466,11517,22592,11654,22769
,ChiTuXiang,350623203,13359,1356,8533,4713,16691,8232,2954,8580,16812,9136,17669
γ,ZhangPuYanChang,350623400,5370,835,3534,2330,6798,3521,1174,3783,7304,3845,7379
ũ,WanAnNongChang,350623401,4268,540,2928,1796,4800,2926,1041,2913,5839,2921,5849
ʯũ,ShiGuNongChang,350623402,1523,184,987,587,1793,984,345,1038,2022,1065,2052
ũ,ChangQiaoNongChang,350623403,1522,225,1010,621,1663,898,330,935,1833,1067,2077
ũ,BaiZhuHuNongChang,350623404,1223,192,816,544,1546,807,242,822,1629,841,1657
ɽȲ,NanShanHuaQiaoChaGuoChang,350623405,612,106,422,335,808,422,176,472,894,472,894
ֳ,ZhongXiLinChang,350623406,1282,189,838,570,1632,832,285,890,1722,918,1756
ɽ賡,DaiMaoShanChaChang,350623407,308,51,208,169,423,208,81,231,439,232,440
²ֳ,XiaCaiLinChang,350623408,261,13,141,72,132,115,38,120,235,171,312
گ,NanZhaoZhen,350624100,52101,7106,34223,20158,60575,33195,9061,33367,66562,34045,68268
Ķ,SiDouZhen,350624101,39478,5485,26393,13851,51716,26352,8784,27324,53676,27354,53747
÷,MeiLingZhen,350624102,23022,2822,15448,7788,30539,15426,5616,15969,31395,16012,31460
Ŷ,QiaoDongZhen,350624103,45161,6107,30606,16582,57857,30226,10757,31108,61334,31419,62025
,ShenQiaoZhen,350624104,43443,4949,29016,14506,54256,28963,10017,29304,58267,29393,58409
̫ƽ,TaiPingZhen,350624105,34833,3809,22837,11768,45419,22833,9343,25037,47870,25148,47985
ϼ,XiaGeZhen,350624106,24953,2228,16472,8006,32386,16472,7366,18075,34547,18075,34547
,GuanBeiZhen,350624107,36840,3810,24119,11507,48444,24116,11398,27920,52036,27929,52048
׭,XiuZhuanZhen,350624108,26490,3098,17584,9250,36778,17577,8539,20471,38048,20543,38127
,JinXingXiang,350624200,12895,1755,8671,4559,16728,8635,3047,8874,17509,9026,17697
̶,XiTanXiang,350624201,32929,4179,22723,11496,44771,22663,9082,23403,46066,23467,46190
,BaiYangXiang,350624202,21274,2626,14141,7448,28348,14141,5214,14973,29114,14973,29114
,JianSheXiang,350624203,9157,1152,5775,3177,11347,5468,2041,5796,11264,6575,12350
,HongXingXiang,350624204,10897,1220,6912,4050,14303,6911,2591,7788,14699,7796,14708
÷,MeiZhouXiang,350624205,13314,1761,8785,4830,17405,8766,3030,9295,18061,9320,18105
Ӫɽũ,GuoYingXiShanNongChang,350624401,148,8,30,112,0,28,5,118,146,131,161
Ӫֳ,GuoYingHuNeiLinChang,350624402,78,22,33,16,102,28,14,42,70,81,114
Ϫзֳ,LingXiaXiGuoYouFangHuLinChang,350624403,16,0,3,1,2,1,1,2,3,14,17
óί,BianMaoLvYouQuGuanWeiHui,350624500,8291,954,5465,2868,10850,5443,1887,5629,11072,5667,11132
گҵ԰ί,ZhaoAnGongYeYuanQuGuanWeiHui,350624600,1304,77,752,356,261,555,213,607,1162,842,1594
䰲,WuAnZhen,350625100,38874,4370,25334,14882,41217,24288,7815,23778,48066,25725,51059
Ϫ,YanXiZhen,350625101,27067,3337,17639,10346,33719,17458,5620,17869,35327,18385,36024
,ChenXiangZhen,350625102,21140,2666,13204,7417,25040,12979,3927,13357,26336,14529,27733
,FangYangZhen,350625103,12220,1509,7708,4418,15312,7656,2322,8202,15858,8343,16051
,BanLiXiang,350625200,7261,1109,4770,3035,9154,4681,1381,4785,9466,4981,9751
Ӫũũ,GuoYingGuNongNongChangXuNiZhen,350625400,9498,1183,5980,3550,9876,5847,1787,5974,11821,6488,12468
̩ÿ,ChangTaiJingJiKaiFaQu,350625500,16847,540,8439,3942,5499,4957,1737,5481,10438,10685,19124
Ϫ̬,MaYangXiShengTaiLvYouQu,350625501,7630,980,4798,2906,8725,4583,1544,4527,9110,5356,10154
ֶչҵ,LinDunGongYeQu,350625502,18961,1393,11417,6463,16941,10849,4091,11836,22685,13028,24445
,XiPuZhen,350626100,36466,4250,24715,13854,42098,23939,8498,23579,47518,24499,49214
,ZhangTangZhen,350626101,11777,1729,7957,4035,14784,7893,2510,7894,15787,8059,16016
,KangMeiZhen,350626102,18477,2177,11550,6422,17512,11261,3284,11295,22556,12388,23938
ӳ,XingChenZhen,350626103,19607,2793,13184,6890,25376,13154,4193,13300,26454,13409,26593
³,ChenChengZhen,350626104,26495,3018,16399,8393,30426,16191,5235,16455,32646,18349,34748
ǰ¥,QianLouZhen,350626105,9128,1316,6228,3099,11589,6217,2020,6174,12391,6236,12464
ͭ,TongLingZhen,350626106,37886,4869,23842,14247,44124,23427,5777,23507,46934,24690,48532
ɽ,ShanChengZhen,350627100,70341,8186,46202,27142,79955,44669,14739,45105,89774,47064,93266
,FengTianZhen,350627101,7963,921,4874,2716,8178,4495,1417,4662,9157,5427,10301
,JingChengZhen,350627102,49988,5462,32260,16432,59471,30439,10031,31001,61440,33221,65481
ɽ,LongShanZhen,350627103,28114,3293,18299,10625,34751,18180,6413,18851,37031,19521,37820
ɽ,JinShanZhen,350627104,28357,3418,18751,10579,34868,17880,6203,18257,36137,19227,37978
Ϫ,HeXiZhen,350627105,14259,1977,9424,5991,17747,9357,3202,9674,19031,10014,19438
,KuiYangZhen,350627106,7151,1270,5039,3421,9268,4988,1755,5014,10002,5137,10176
÷,MeiLinZhen,350627107,6899,989,4778,3025,9057,4768,1696,4784,9552,4806,9584
,ShuYangZhen,350627108,13328,1928,8812,5050,16904,8547,3011,8934,17481,9455,18267
,ChuanChangZhen,350627109,15799,2388,10213,5854,20262,10182,3110,10998,21180,11084,21297
Ͽ,NanKengZhen,350627110,7508,1258,4979,3506,9674,4961,1595,5325,10286,5382,10361
СϪ,XiaoXiZhen,350628100,69601,7396,46360,26663,76676,44518,18116,46383,90901,48753,95113
ɽ,ShanGeZhen,350628101,30728,3574,20365,11460,39819,20341,7861,21662,42003,21798,42163
ķ,WenFengZhen,350628102,10177,1211,6464,4059,12536,6398,2301,7133,13531,7225,13689
ʤ,NanShengZhen,350628103,16543,2145,11210,6881,21907,11210,4177,11646,22856,11655,22865
,BanZaiZhen,350628104,27779,3279,18774,10520,37236,18729,7402,19634,38363,19686,38460
,AnHouZhen,350628105,33070,4067,23684,13699,47176,23619,13090,26440,50059,26543,50227
Ϫ,DaXiZhen,350628106,25235,3975,17666,11243,36510,17622,9491,20920,38542,21035,38701
ϼկ,XiaZhaiZhen,350628107,30253,4072,21201,12706,41751,21167,9526,22528,43695,22650,43851
ŷ,JiuFengZhen,350628108,25759,3814,18433,11062,36218,18246,9116,19967,38213,20256,38689
«Ϫ,LuXiZhen,350628109,22033,3293,15785,9819,31704,15780,7715,17219,32999,17256,33041
կ,WuZhaiXiang,350628200,10631,1473,7619,4608,14955,7619,3651,8133,15752,8136,15755
ǿ,GuoQiangXiang,350628201,13787,1803,9170,5462,18817,9150,4119,10389,19539,10539,19709
,QiLingXiang,350628202,14562,2073,10153,5744,19963,10141,4726,11150,21291,11208,21361
,ChangLeXiang,350628203,5160,898,3640,2203,7274,3603,1722,4074,7677,4140,7780
,XiuFengXiang,350628204,6063,1423,4566,2922,9210,4541,2378,5188,9729,5298,9864
ũ,AnHouNongChang,350628400,1620,287,1254,834,2138,1223,660,1278,2501,1313,2567
ƾҵ,HuangJingGongYeKaiFaQu,350628401,3614,278,2100,1416,3398,2018,806,2256,4274,2598,4698
,HuaFengZhen,350629100,31471,3549,20730,13145,35667,19864,7136,20290,40154,21426,42156
ɽ,FengShanZhen,350629101,14446,2006,9365,6232,18052,9258,3052,9765,19023,10139,19504
ɳ,ShaJianZhen,350629102,18351,2187,11986,7235,22490,11692,4230,12290,23982,12782,24768
,XinWeiZhen,350629103,8667,1100,5568,3269,10410,5486,1851,5756,11242,6050,11618
߰,GaoAnZhen,350629104,8605,1043,5440,3265,10672,5417,1887,6001,11418,6095,11535
ɶ,XianDouZhen,350629105,21304,2360,14358,8412,27499,14337,5540,14806,29143,14846,29204
߳,GaoCheXiang,350629200,4654,602,2878,1672,5703,2843,928,3120,5963,3306,6184
,MaKengXiang,350629201,3785,506,2351,1491,4706,2319,836,2694,5013,2776,5127
,HuLinXiang,350629203,6637,823,4270,2551,7861,4212,1596,4561,8773,4786,9056
ʯ,ShiMaZhen,350681100,48207,7388,32698,21931,53427,31944,8285,29926,61870,31182,63880
,HaiChengZhen,350681101,56099,6853,37203,20908,66951,36024,11890,36021,72045,37639,74842
,JiaoMeiZhen,350681102,124452,10910,74391,51858,109506,70861,23424,75926,146787,84395,158786
ˮ,BaiShuiZhen,350681103,28307,3845,19162,10624,37162,19045,6489,19337,38382,19479,38641
,FuGongZhen,350681104,39083,4219,24707,13491,47473,24465,7951,25305,49770,26546,51253
Ϫ,ChengXiZhen,350681105,24736,3092,15822,10217,28903,14931,4712,15628,30559,16718,32540
β,GangWeiZhen,350681106,35459,3682,22222,12565,39082,21093,7649,20903,41996,24568,46790
ź,JiuHuZhen,350681107,45900,4954,28976,16047,51048,27840,8829,28648,56488,30707,59683
,YanCuoZhen,350681108,42836,4472,27799,14616,47914,26723,9569,27019,53742,29078,56877
ɽ,BangShanZhen,350681109,63286,6636,41463,22687,70265,40620,13984,40622,81242,42443,83906
,ZiNiZhen,350681110,41955,5259,27521,14568,51720,27396,8569,27358,54754,28262,55783
԰,DongYuanZhen,350681111,26413,3318,17363,8980,33099,17076,5833,17214,34290,18201,35564
,DongSiXiang,350681200,12393,1809,8571,5209,16569,8552,3066,8632,17184,8697,17268
¡,LongJiaoSheZuXiang,350681201,15518,2165,10530,5717,20361,10485,3913,10716,21201,11066,21596
˫ڻũ,ShuangDiHuaQiaoNongChang,350681400,2240,479,1525,1194,2675,1500,374,1506,3006,1568,3093
ֳ,JiuLongLingLinChang,350681401,105,18,56,54,98,55,10,68,123,77,133
Ϫũ,ChengXiNongChang,350681402,1073,112,635,524,568,611,209,678,1289,759,1394
ֳ,LiangZhongChang,350681403,632,80,402,286,553,402,105,408,810,415,817
ũ,CangBanNongChang,350681404,883,67,514,204,668,424,164,427,851,600,1114
ֳ,LinXiaLinChang,350681405,445,86,295,190,547,282,51,276,558,287,582
ҵ,JiaoMeiGongYeKaiFaQu,350681500,1856,11,703,560,5,397,97,565,962,1261,1964
̾ݿ,ZhaoShangJuZhangZhouKaiFaQu,350681501,40850,892,22176,7065,10889,8882,3544,9941,18823,23110,45286
԰,DongYuanKaiFaQu,350681502,41,2,19,18,43,19,8,24,43,32,51
ؿ,LongChiKaiFaQu,350681503,22354,278,10970,7987,1617,8866,3287,9910,18776,14949,25919
÷ɽֵ,MeiShanJieDao,350702001,23456,2715,15041,10218,14999,13754,3771,13154,26908,14901,29942
ƶսֵ,HuangDunJieDao,350702002,24193,3297,16056,11865,17477,15431,4762,15256,30687,16196,32252
ƽֵ,ZiYunJieDao,350702003,40270,5039,27071,18826,34087,25479,7865,24799,50278,26103,53174
ĺ׽ֵ,SiHeJieDao,350702004,49538,5393,32740,22827,38581,31186,10500,30777,61963,32691,65431
ˮϽֵ,ShuiNanJieDao,350702005,29438,4125,19290,14590,22543,18981,6496,19806,38787,20769,40059
ˮֵ,ShuiDongJieDao,350702006,29441,3000,18368,13573,18441,17908,6185,18572,36480,20258,38626
,LaiZhouZhen,350702100,6099,924,3893,3157,5070,3803,1313,4013,7816,4443,8336
,ZhangHuZhen,350702101,10620,1913,7526,5345,13990,7454,2709,7555,15009,7716,15242
ĵ,XiaDaoZhen,350702102,20011,2642,13097,7641,22940,12345,4905,12533,24878,14461,27558
,XiQinZhen,350702103,15962,2807,11337,8620,20180,11162,4825,11757,22919,12257,23594
Ͽ,XiaYangZhen,350702104,10754,2179,7972,5994,14970,7916,3071,7821,15737,8032,16004
ɽ,NanShanZhen,350702105,12483,2023,8703,6165,16467,8643,3378,8902,17545,9181,17884
,DaHengZhen,350702106,10413,1428,6891,4684,11159,6706,2516,6672,13378,7466,14357
̨,WangTaiZhen,350702107,11114,2031,8040,5715,15112,7986,3161,8139,16125,8266,16306
̫ƽ,TaiPingZhen,350702108,9572,1447,6147,4288,11135,6063,2371,6625,12688,7243,13390
ǰ,TaQianZhen,350702109,10170,1922,7355,5208,13842,7291,3538,8169,15460,8275,15630
ã,MangDangZhen,350702110,7824,1229,5121,4148,8295,5023,1970,5731,10754,5902,11023
,YangHouZhen,350702111,4786,894,3312,2588,6599,3309,1463,3820,7129,3831,7143
¯,LuXiaZhen,350702112,8517,1072,5613,3352,10672,5501,2245,5964,11465,6221,11834
޿,JuKouXiang,350702200,3319,907,2256,2047,4373,2229,836,2517,4746,2806,5062
,ChiMenXiang,350702202,3330,798,2398,1912,4541,2299,900,2395,4694,2630,5028
˫Ϫֵ,ShuangXiJieDao,350721001,47309,6535,32107,22729,43744,30453,9551,29637,60090,31288,63395
,JianXiZhen,350721100,7723,1710,5438,4377,10045,5409,1639,5574,10983,5634,11072
,YangKouZhen,350721101,9211,1710,6387,4567,11253,6269,2150,6268,12537,6684,13071
Ԫ,YuanKengZhen,350721102,8236,1441,5617,4209,10113,5532,1989,5839,11371,6049,11666
,PuShangZhen,350721103,12146,1899,8160,5805,14307,8106,2732,8398,16504,8617,16777
,DaLiZhen,350721104,4068,839,2855,2203,5371,2825,928,2888,5713,2980,5835
,DaGanZhen,350721105,9484,1386,6073,4327,10957,6031,1816,6372,12403,6613,12686
,RenShouZhen,350721106,8993,1363,6072,4056,10796,6017,2267,6455,12472,6551,12623
,YangDunXiang,350721200,5732,908,3848,2599,6985,3811,1278,3970,7781,4070,7918
֣,ZhengFangXiang,350721201,4880,978,3433,2673,6496,3407,1381,3711,7118,3806,7239
,LanXiaXiang,350721202,10965,1829,7293,5175,14203,7242,2127,7543,14785,7628,14921
,GaoYangXiang,350721203,10092,1637,6923,4760,13539,6899,2656,7374,14273,7462,14385
ֵֽ,NanPuJieDao,350722001,40955,5247,28649,18238,36302,27423,9622,25965,53388,27175,55824
ӱֵ,HeBinJieDao,350722002,22963,3438,16513,11381,17320,16185,6173,15551,31736,16061,32574
,FuLingZhen,350722101,14894,3163,10757,7646,20924,10619,4354,10932,21551,11654,22411
ʯ,ShiBeiZhen,350722102,16411,2641,12139,7950,23175,12029,5692,12396,24425,12605,24744
ٽ,LinJiangZhen,350722103,8330,1498,6328,4340,11911,6230,2819,6140,12370,6319,12647
,XianYangZhen,350722104,15407,3219,11485,7670,21533,10768,4792,11018,21786,11933,23418
ˮ,ShuiBeiJieZhen,350722105,7901,1764,5862,4664,11264,5718,2536,6072,11790,6339,12201
,YongXingZhen,350722106,8699,1900,6557,5181,12595,6521,2785,6714,13235,6827,13384
,ZhongXinZhen,350722107,10959,2703,8523,6690,16316,8453,3809,8718,17171,8948,17471
,LianTangZhen,350722108,11350,1984,8153,6090,13553,8072,3520,8494,16566,8701,16854
,JiuMuZhen,350722109,5919,1096,4371,2917,8368,4306,1911,4444,8750,4555,8926
,WanAnXiang,350722200,6081,1060,4316,3057,7949,4281,1711,4350,8631,4536,8852
¥,GuLouXiang,350722201,4899,973,3450,2672,6793,3401,1432,3689,7090,3854,7304
ɽ,ShanXiaXiang,350722202,4316,822,3207,2278,6294,3146,1496,3356,6502,3427,6634
Ϫ,FengXiXiang,350722203,2464,589,1679,1353,3481,1639,657,1955,3594,2031,3710
婴,HaoCunXiang,350722204,3261,638,2490,1619,4658,2455,1238,2567,5022,2647,5137
,GuanCuoXiang,350722205,6131,1763,4853,3951,9422,4739,2045,4932,9671,5086,9939
ͤ,PanTingXiang,350722206,6093,1284,4877,3448,8916,4795,2550,4878,9673,5050,9927
·,GuanLuXiang,350722207,4466,1076,3677,2684,6721,3651,1712,3530,7181,3577,7254
ˮũ,ShuiNanNongChang,350722400,3815,466,2750,1742,2976,2719,1091,2569,5288,2622,5372
,HangChuanZhen,350723100,35885,3950,24343,16738,27747,23634,9144,23475,47109,24636,48979
կ,ZhaiLiZhen,350723101,9886,1811,7090,4640,13079,6765,2937,7000,13765,7544,14634
ֹ,ZhiMaZhen,350723102,6781,1226,5020,3515,8980,4918,2278,5040,9958,5265,10285
,LuanFengXiang,350723200,12996,1523,8555,5482,13395,8132,3345,8655,16787,9309,17864
,ChongRenXiang,350723201,6375,965,4394,2917,7744,4296,1878,4637,8933,4824,9218
,LiFangXiang,350723202,4568,944,3424,2539,6379,3379,1550,3534,6913,3638,7062
,HuaQiaoXiang,350723203,8292,1532,6159,4166,11090,6105,2842,6388,12493,6507,12666
˾ǰ,SiQianXiang,350723204,8972,1738,6560,4445,12645,6516,2695,6724,13240,6845,13405
Դֵ,SongYuanJieDao,350724001,31575,3403,20984,13544,27799,20148,7414,20397,40545,21408,42392
֣,ZhengDunZhen,350724101,9308,1462,6259,4700,12101,6180,2378,6529,12709,6889,13148
μ,WeiTianZhen,350724102,10258,1897,7147,5535,14111,7096,2452,7392,14488,7460,14607
Ӷ,HeDongXiang,350724200,8899,1228,6052,4139,7947,6015,2195,6072,12087,6270,12322
ƽ,ChaPingXiang,350724201,7642,1014,5260,3394,10230,5242,2077,5433,10675,5473,10733
,JiuXianXiang,350724202,6722,1094,4328,3342,8474,4258,1329,4561,8819,4817,9145
Ϫ,XiDongXiang,350724203,5890,975,4023,2946,8146,3968,1453,4187,8155,4295,8318
,HuaQiaoXiang,350724204,6422,1133,4557,3131,8978,4425,1707,4556,8981,4705,9262
,ZuDunXiang,350724205,4003,768,2683,2069,5316,2674,774,2832,5506,2862,5545
ɽֵ,XiongShanJieDao,350725001,35061,3256,23011,14103,29805,21677,9300,22965,44642,24606,47617
ƽ,DongPingZhen,350725101,14095,1735,9125,6286,17557,9096,3501,10052,19148,10206,19331
ʯ,ShiTunZhen,350725102,11636,1555,7513,5552,12882,7409,2940,7984,15393,8618,16131
ɽ,TieShanZhen,350725103,12690,1409,8225,5058,15849,8142,3333,8977,17119,9207,17432
ǰ,ZhenQianZhen,350725104,11029,1738,7464,5530,14734,7402,3017,8229,15631,8320,15784
Ϫ,XingXiXiang,350725200,11384,1190,6797,4414,13053,6596,2214,7271,13867,7991,14788
,WaiTunXiang,350725201,5629,785,3671,2742,7213,3602,1335,3930,7532,4078,7749
Դ,YangYuanXiang,350725202,8584,1230,4680,3653,9300,4525,1480,5125,9650,6614,11294
Դ,ChengYuanXiang,350725203,10331,1779,6926,5753,13752,6915,2644,7679,14594,7828,14754
,LingYaoXiang,350725204,5071,621,3188,2311,6429,3173,1143,3620,6793,3647,6835
ֵ´,ZhaoYangJieDaoBanShiChu,350781001,34688,3569,23229,16322,23478,22675,7959,22285,44960,22987,46216
ֵ̩ͨ´,TongTaiJieDaoBanShiChu,350781002,49924,4465,33472,22673,25528,32942,12770,32853,65795,33687,67159
ˮֵ´,ShuiBeiJieDaoBanShiChu,350781003,26401,4275,17697,13535,18388,17487,5120,17560,35047,18099,35796
ɹڽֵ´,ShaiKouJieDaoBanShiChu,350781004,5124,952,3307,2899,4334,3265,967,3492,6757,3736,7043
ǽ,ChengJiaoZhen,350781100,11179,1294,6822,5358,9267,6651,2195,7239,13890,7846,14668
ˮ,ShuiBeiZhen,350781101,11042,1789,7211,5098,12795,7068,2158,7366,14434,7778,14989
ɳ,XiaShaZhen,350781102,4044,550,2481,1868,4327,2427,694,2602,5029,2807,5288
,WeiMinZhen,350781103,3969,658,2731,2021,4873,2694,984,2781,5475,2880,5611
ɽ,YanShanZhen,350781104,7135,1279,4950,3892,9352,4930,1583,4983,9913,5047,9997
ÿ,NaKouZhen,350781105,11200,1996,7543,5954,14423,7511,2484,8030,15541,8137,15680
,HongDunZhen,350781106,7489,1303,5026,3495,9514,4928,1749,5193,10121,5515,10541
󲺸,DaBuGangZhen,350781107,4269,1020,2850,2649,5501,2771,791,2998,5769,3230,6080
ƽ,HePingZhen,350781108,5688,1322,3936,3450,7470,3852,965,3863,7715,4039,7975
Фҷ,XiaoJiaFangZhen,350781109,3910,984,2712,2412,5162,2662,859,2776,5438,3041,5753
,DaZhuZhen,350781110,3559,655,2382,1795,4592,2356,810,2484,4840,2642,5024
,WuJiaTangZhen,350781111,3932,690,2593,1952,4777,2481,856,2535,5016,2885,5478
,GuiLinXiang,350781200,3559,773,2314,2058,4687,2254,703,2567,4821,2721,5035
,ZhangCuoXiang,350781201,2562,481,1670,1400,3148,1650,588,1813,3463,1961,3631
,JinKengXiang,350781202,2351,418,1368,1246,2692,1329,379,1477,2806,1780,3148
簲ֵ,ChongAnJieDao,350782001,38625,3803,25116,16771,30418,24343,8611,24168,48511,25923,51039
·ֵ,XinFengJieDao,350782002,29920,2505,19695,11784,17720,19121,7393,19466,38587,20123,39818
Ľֵ,WuYiJieDao,350782003,38960,2154,23348,9751,20682,14740,5162,15099,29839,22928,46276
Ǵ,XingCunZhen,350782100,15422,2053,10070,6617,18216,9941,3538,10612,20553,10943,21013
,XingTianZhen,350782101,20080,2082,10696,6947,19310,9947,3385,10524,20471,14851,25547
,WuFuZhen,350782102,6834,1122,4545,3662,8803,4526,1556,4821,9347,4967,9512
÷,ShangMeiXiang,350782200,6535,996,4185,3132,8524,4145,1378,4657,8802,4724,8909
,WuTunXiang,350782201,7789,1333,5269,4180,10374,5127,1878,5516,10643,5731,11000
᰹,LanGuXiang,350782202,7006,1223,4778,3882,9450,4740,1807,5175,9915,5258,10036
ׯ,YangZhuangXiang,350782203,7942,900,4535,3101,8588,4339,1562,4598,8937,5869,10404
ֵ,JianAnJieDao,350783001,20292,2320,13644,9075,16111,12935,4296,12545,25480,13264,26908
ͨýֵ,TongJiJieDao,350783002,10316,1370,6886,5016,8408,6753,2092,6681,13434,6892,13778
ֵ,OuNingJieDao,350783003,28299,2268,18323,12058,15545,17608,6616,17613,35221,18860,37183
֥ɽֵ,ZhiShanJieDao,350783004,34088,4783,23243,16164,30642,22030,7266,21700,43730,22894,46137
,XuDunZhen,350783100,22209,2800,14767,9730,26982,14502,5870,15033,29535,16112,30879
,JiYangZhen,350783101,15974,2340,11207,7494,21379,11163,4275,11277,22440,11382,22589
,FangDaoZhen,350783102,18025,2866,12640,8852,24208,12596,4858,13003,25599,13109,25749
,NanYaZhen,350783103,24500,3275,16943,11023,31714,16669,7320,17176,33845,18152,35095
Ͽ,DiKouZhen,350783104,17316,2256,11660,8181,22523,11624,4868,12645,24269,12780,24440
С,XiaoQiaoZhen,350783105,20760,2938,14386,9398,28454,14314,5768,14940,29254,15080,29466
ɽ,YuShanZhen,350783106,12647,1624,8541,6034,16470,8511,3318,8972,17483,9048,17589
,DongYouZhen,350783107,21055,2801,14228,9991,25887,14081,5860,14722,28803,15488,29716
,DongFengZhen,350783108,23228,2885,15263,10161,28189,14778,5488,15507,30285,16338,31601
С,XiaoSongZhen,350783109,15373,2293,10982,7103,21073,10859,4683,10998,21857,11367,22349
˳,ShunYangXiang,350783200,6791,882,4315,3050,8050,4228,1520,4558,8786,4878,9193
ˮԴ,ShuiYuanXiang,350783201,12241,1659,8360,5727,16004,8334,3394,8871,17205,8934,17294
ʯ,ChuanShiXiang,350783202,12981,1893,8950,6190,16868,8833,4220,9309,18142,10144,19094
,LongCunXiang,350783203,8783,1118,6253,3874,12210,6196,3213,6760,12956,6861,13114
̶ǽֵ,TanChengJieDao,350784001,48543,6107,33321,22388,39574,31342,10699,30187,61529,32028,65349
ͯνֵ,TongYouJieDao,350784002,46043,3890,27196,17888,33680,26289,9917,27098,53387,32654,59850
,JiangKouZhen,350784102,10294,1449,6542,4578,11631,6453,2304,6675,13128,7505,14047
,XuShiZhen,350784103,10315,1934,7600,5301,14085,7545,3232,7769,15314,7881,15481
,JuKouZhen,350784104,12280,2064,8632,6300,15150,8579,3394,8872,17451,9106,17738
ɳ,MaShaZhen,350784105,18933,3017,13171,9195,23376,12889,5142,13371,26260,13921,27092
ƿ,HuangKengZhen,350784106,8408,1232,5643,3762,9025,5491,2178,5640,11131,6175,11818
ˮ,ShuiJiZhen,350784107,16687,2700,11513,8083,20472,11329,4627,11414,22743,12501,24014
Ķ,ZhangDunZhen,350784108,11239,2013,8068,5596,14392,7938,3886,8326,16264,9070,17138
С,XiaoHuZhen,350784109,8931,1509,6489,4568,11561,6449,2828,6576,13025,6779,13268
,ChongLuoXiang,350784200,4687,918,3218,2424,5946,3184,1250,3430,6614,3637,6855
鷻,ShuFangXiang,350784201,5129,817,3619,2482,6546,3569,1604,3774,7343,3931,7550
,HuiLongXiang,350784202,6398,1068,4246,3102,7659,4171,1696,4349,8520,4916,9162
ǽֵ,DongChengJieDao,350802001,37689,3992,23677,16228,25503,21770,7364,22365,44135,25368,49045
ϳǽֵ,NanChengJieDao,350802002,45721,4200,29124,21232,24650,27674,9134,27736,55410,29931,59055
ǽֵ,XiChengJieDao,350802003,45545,3651,28509,20620,21328,25333,6923,24588,49921,27610,56119
гǽֵ,ZhongChengJieDao,350802004,62771,5133,35609,24007,42832,31116,10386,30766,61882,42681,78290
ֵ,XiBeiJieDao,350802005,79111,4589,46621,33370,27794,43280,15894,46609,89889,52973,99594
Ϫֵ,CaoXiJieDao,350802006,48413,2899,26781,17795,20390,23324,8000,25678,49002,32531,59312
Фֵ,DongXiaoJieDao,350802007,31593,2841,17815,10105,19533,13924,4078,14841,28765,20697,38512
Žֵ,LongMenJieDao,350802008,33574,2844,19839,14063,21556,19212,6419,20768,39980,22998,42837
ɽֵ,TieShanJieDao,350802009,16419,1286,8162,5881,9984,7718,2438,8231,15949,11981,20143
췻,HongFangZhen,350802100,18127,2658,11291,7563,18897,10825,3066,11172,21997,12560,23851
,ShiZhongZhen,350802101,25265,2909,16003,9654,29340,15483,5307,15942,31425,17478,33481
ʯ,YanShiZhen,350802102,22778,3035,12995,10426,21238,12532,3602,13593,26125,16420,29415
ɳ,BaiShaZhen,350802103,18278,2037,10013,7981,17491,9769,2980,11106,20875,13282,23295
,WanAnZhen,350802104,5498,1102,3707,3169,7036,3584,1123,3673,7257,4016,7723
,DaChiZhen,350802105,7190,1190,4654,3307,7985,4438,1363,4607,9045,5089,9743
С,XiaoChiZhen,350802106,7954,1331,5017,3474,8811,4781,1352,4951,9732,5620,10637
ɽ,JiangShanXiang,350802200,5822,1003,3646,2902,6799,3606,955,3735,7341,4134,7780
ɽ,YanShanXiang,350802201,4225,462,2066,1560,3200,1851,567,1925,3776,3188,5254
,SuBanXiang,350802202,6124,1332,3781,3333,7368,3657,887,3910,7567,4562,8343
͡,TingZhouZhen,350821100,68560,8000,47125,28655,48271,41433,16360,42049,83482,45795,92920
ͬ,DaTongZhen,350821101,48668,5945,33545,19506,33657,32862,13294,33374,66236,34362,67907
ų,GuChengZhen,350821102,7532,1437,5447,3691,10216,5341,2075,5291,10632,5597,11044
,XinQiaoZhen,350821103,12339,2855,9873,6112,18060,9676,4537,9511,19187,9858,19731
ǰ,GuanQianZhen,350821104,7236,1282,5131,3320,9848,5095,1887,5155,10250,5274,10405
ͯ,TongFangZhen,350821105,9625,2349,7874,5453,14393,7763,3863,7753,15516,7963,15837
,HeTianZhen,350821106,30480,4801,21700,13402,40384,21241,8749,21594,42835,22330,44030
ɽ,NanShanZhen,350821107,18625,3044,13190,7411,24586,13029,4963,13043,26072,13442,26632
,ZhuoTianZhen,350821108,23445,4085,17040,9912,33629,16918,7553,17712,34630,18043,35083
Ķ,SiDouZhen,350821109,6619,1112,4539,3131,8769,4528,1592,4752,9280,4784,9323
Ϳ,TuFangZhen,350821110,8920,2097,6935,5102,13275,6876,3208,7151,14027,7290,14225
,CeWuXiang,350821200,12522,2087,8973,5562,16650,8873,3402,8779,17652,9038,18011
,TieChangXiang,350821201,1931,409,1390,1089,2771,1385,512,1452,2837,1462,2852
ֽ,AnJieXiang,350821202,2409,633,1762,1328,3405,1741,535,1742,3483,1815,3577
,SanZhouXiang,350821203,4506,1057,3708,2721,7087,3659,1995,3756,7415,3850,7558
,XuanChengXiang,350821204,4105,907,3104,2006,5885,3081,1166,2994,6075,3074,6178
ɽ,HongShanXiang,350821205,3151,600,2345,1665,4499,2338,1013,2378,4716,2419,4764
,YangGuXiang,350821206,2130,638,1640,1432,3181,1623,545,1608,3231,1673,3313
,FengChengZhen,350822100,40493,4681,28645,18011,37578,27611,11417,26944,54555,27946,56591
,KanShiZhen,350822101,21797,1799,13009,8224,19871,12201,4181,12952,25153,14768,27777
,XiaYangZhen,350822102,17103,3244,12526,8525,22066,11859,5095,11764,23623,12916,25442
,HuLeiZhen,350822103,14516,2870,10140,7906,19093,9776,3777,9613,19389,11023,21163
,GaoBeiZhen,350822104,31874,3300,19400,12476,34985,18506,6225,19298,37804,21999,41399
,FuShiZhen,350822105,20328,2203,12382,8387,20865,12067,4804,12533,24600,14953,27335
,HuKengZhen,350822106,7611,1808,5660,4721,10423,5587,2063,5471,11058,5822,11482
,PeiFengZhen,350822107,25348,2820,15791,10132,27507,15481,5594,16606,32087,17971,33762
̶,LongTanZhen,350822108,13837,1013,7405,6373,10131,7286,2855,8984,16270,10300,17705
,FengShiZhen,350822109,2650,614,2011,1540,3702,2002,757,1941,3943,2010,4021
ǽ,ChengJiaoXiang,350822200,6245,975,4337,2948,7532,4108,1492,4047,8155,4375,8712
Ϫ,XiXiXiang,350822201,1987,345,1388,1054,2586,1382,518,1397,2779,1462,2850
ɰ,JinShaXiang,350822202,2508,516,1896,1428,3488,1885,655,1763,3648,1783,3679
ʦ,XianShiXiang,350822203,7492,1523,5641,4129,10813,5616,2175,5485,11101,5549,11190
ɽ,HongShanXiang,350822204,5169,735,3218,2299,5573,3121,1265,3349,6470,3951,7169
ɽ,HuShanXiang,350822205,3361,955,2671,2250,5040,2652,1220,2728,5380,2865,5536
,QiLingXiang,350822206,5428,1035,3719,2895,6785,3595,1315,3568,7163,4059,7778
,GuZhuXiang,350822207,3854,1139,3208,2635,6062,3193,1326,3081,6274,3111,6319
ñ,TangBaoXiang,350822208,3833,1094,2936,2612,5595,2903,945,2817,5720,2936,5872
Ϫ,HeXiXiang,350822209,3634,1094,2995,2526,5622,2964,1108,2740,5704,2841,5836
,HuGangXiang,350822210,8831,1304,5697,3965,10864,5671,2106,5996,11667,6544,12241
Ϫ,DaXiXiang,350822211,4328,1044,3274,2597,6119,3242,1237,3148,6390,3335,6609
¶,ChenDongXiang,350822212,4860,991,3222,2692,6044,3153,1120,3162,6315,3749,6971
ͷ,GaoTouXiang,350822213,3615,757,2554,1874,4049,2157,847,2148,4305,2665,5219
ٽ,LinJiangZhen,350823100,23576,3263,16521,11385,21296,15788,5446,14842,30630,15764,32285
ٳ,LinChengZhen,350823101,57159,6286,37430,20953,35575,34624,11625,34173,68797,37640,75070
ж,ZhongDouZhen,350823102,7583,1845,5690,4013,10583,5658,1584,5225,10883,5322,11012
Ϫ,LanXiZhen,350823103,7743,1765,5889,3944,10247,5483,1780,5037,10520,5399,11288
,RenTianZhen,350823104,8390,2153,6645,4903,12408,6632,2197,6052,12684,6095,12740
ɰ,BaiShaZhen,350823105,11303,2532,8177,5449,15011,7981,2834,7499,15480,8492,16669
,GuTianZhen,350823106,12668,1876,8012,5708,14538,7748,2447,8337,16085,8979,16991
Ϫ,CaiXiZhen,350823107,12823,2129,9276,5489,16607,8882,3083,8293,17175,8759,18035
,NanYangZhen,350823108,20468,3685,15525,9326,27954,15120,6548,14733,29853,15176,30701
,HuYangXiang,350823200,11297,2519,8596,5975,16097,8559,2880,7982,16541,8100,16696
¶,XiaDouXiang,350823201,5196,1046,3746,2531,7091,3716,1102,3465,7181,3598,7344
®,LuFengSheZuXiang,350823202,11442,2791,8980,6095,16607,8946,2919,8100,17046,8172,17152
̫,TaiBaXiang,350823203,6085,1599,4755,3689,9030,4753,1697,4614,9367,4626,9381
Ϫ,XiKouXiang,350823204,5055,1088,3673,2698,6973,3662,1119,3550,7212,3589,7262
,ChaDiXiang,350823205,2977,899,2407,1934,4487,2399,819,2269,4668,2288,4695
,PanJingXiang,350823206,1898,545,1589,1264,2860,1589,578,1424,3013,1432,3021
,JiaoYangXiang,350823207,15353,2458,9307,6869,17490,9088,3157,9782,18870,11661,20968
,BuYunXiang,350823208,2240,376,1464,1118,2901,1464,463,1611,3075,1615,3079
,JiuXianXiang,350823209,18067,2683,10956,7340,20025,10676,3781,10821,21497,13575,24531
ͨ,TongXianXiang,350823210,9432,1855,7349,4549,13501,7348,3149,7081,14429,7087,14436
ׯ,GuanZhuangSheZuXiang,350823211,10298,2662,8525,6145,15725,8507,3507,7917,16424,7942,16467
ɺ,ShanHuXiang,350823212,2733,678,2125,1510,4108,2123,813,2082,4205,2099,4224
ƽ,PingChuanZhen,350824100,42509,4344,28696,17209,37484,26379,10619,26199,52578,28776,57472
ɽ,ZhongShanZhen,350824101,9068,1701,6297,4277,12196,6224,1790,6144,12368,6262,12559
ǰ,YanQianZhen,350824102,25144,3810,16195,10048,29940,15637,4418,15851,31488,17177,33372
ʮ,ShiFangZhen,350824103,20512,3877,14710,9654,26889,14171,4584,13671,27842,14263,28973
б,ZhongBaoZhen,350824104,12789,2689,9171,6127,17502,9004,2929,8670,17674,9236,18407
Ϫ,TaoXiZhen,350824105,7367,1869,6078,4406,10863,5940,2724,5573,11513,5882,11960
,ChengXiangXiang,350824200,16282,2311,10684,7178,17466,10298,3347,10556,20854,11256,21940
,WanAnXiang,350824201,6928,1087,4665,2983,8818,4654,1475,4799,9453,4825,9490
,DongLiuXiang,350824202,10749,1757,7571,4947,14663,7547,2732,7597,15144,7667,15238
,MinZhuXiang,350824203,3314,605,2309,1510,4535,2288,722,2254,4542,2332,4641
°,XiaBaXiang,350824204,3609,664,2416,1601,4709,2379,659,2418,4797,2516,4932
г,ZhongChiXiang,350824205,4577,1046,3452,2293,6428,3408,1121,3183,6591,3292,6744
,XiangDongXiang,350824206,7517,1451,5338,3542,10258,5281,1596,5079,10360,5226,10564
䶫,WuDongXiang,350824207,9617,2786,7778,5813,14509,7699,2688,7017,14716,7313,15091
ƽ,YongPingXiang,350824208,7567,1781,5623,4075,10602,5528,1830,5356,10884,5555,11178
,XiangDianXiang,350824209,4319,923,3367,2097,6295,3321,1494,3287,6608,3369,6736
,DaHeXiang,350824210,6090,1163,4498,3146,8313,4432,1632,4228,8660,4387,8885
,LianFengZhen,350825100,47083,4912,29885,20028,48965,28616,8509,29091,57707,30619,60504
,BeiTuanZhen,350825101,10539,2047,7123,5326,14200,7045,2246,7481,14526,7709,14832
,GuTianZhen,350825102,10917,1741,7176,5225,14171,7058,2239,7410,14468,7721,14897
,PengKouZhen,350825103,16308,2122,10863,7348,19569,10425,3786,10589,21014,11353,22216
Ϫ,JuXiZhen,350825104,9305,1649,6300,4651,12372,6198,1981,6403,12601,6635,12935
Ȫ,XinQuanZhen,350825105,16360,2484,11024,7187,21302,10434,3529,10463,20897,11349,22373
ǰ,MiaoQianZhen,350825106,17044,2774,11755,8376,22263,11594,3673,11289,22883,11736,23491
,JieLeXiang,350825200,4903,703,3136,2189,6154,3104,933,3257,6361,3403,6539
ǰ,TangQianXiang,350825201,1854,424,1274,1051,2503,1274,297,1292,2566,1301,2575
,GeChuanXiang,350825202,5390,829,3558,2687,6977,3528,1084,3679,7207,3745,7303
ı,SiBaoXiang,350825203,6742,1344,5054,3665,9695,5043,1840,4846,9889,4872,9926
޷,LuoFangXiang,350825204,4535,961,3120,2436,6275,3097,1044,3371,6468,3420,6540
ַ,LinFangXiang,350825205,6109,1022,4115,3271,8052,4105,1250,4229,8334,4266,8381
ĺ,WenHengXiang,350825206,14851,2483,10089,7532,19532,10051,3208,10332,20383,10453,20542
Ϫ,QuXiXiang,350825208,2484,464,1620,1279,3255,1567,515,1743,3310,1843,3463
Դ,LaiYuanXiang,350825209,2841,414,1681,1262,3312,1624,459,1808,3432,2033,3714
,XuanHeXiang,350825210,5856,1206,4181,3292,8194,4163,1352,4194,8357,4233,8414
ݼǽֵ,JingChengJieDao,350881001,42209,3919,26188,18660,33096,24357,8625,24851,49208,28565,54753
ֵֽ,GuiLinJieDao,350881002,23100,1954,14589,10266,17517,13905,4895,14589,28494,15360,29949
,XinQiaoZhen,350881100,18132,2605,11698,8783,22232,11636,3757,12490,24126,12796,24494
˫,ShuangYangZhen,350881101,6529,871,4080,3013,7909,4017,1403,4396,8413,4723,8803
,YongFuZhen,350881102,24351,3979,16695,12011,32198,16643,6047,17540,34183,17682,34377
Ϫ,XiNanZhen,350881103,11587,1386,6566,4821,12612,6278,2134,6890,13168,8541,15107
ƽ,HePingZhen,350881104,7328,915,4233,3287,7773,4135,1077,4651,8786,5087,9320
,GongQiaoZhen,350881105,4134,719,2484,2247,4729,2461,658,2606,5067,3027,5511
,XiangHuZhen,350881106,6402,889,4130,3223,8088,4112,1432,4515,8627,4593,8723
ˮ,ChiShuiZhen,350881107,5055,703,3157,2347,6071,3105,1050,3365,6470,3651,6808
«֥,LuZhiXiang,350881200,8420,951,5186,4217,8619,5122,1696,5641,10763,5881,11067
԰,XiYuanXiang,350881201,8262,1219,4874,3693,9587,4799,1280,5305,10104,5887,10761
,NanYangXiang,350881202,3802,767,2581,2261,5111,2571,708,2677,5248,2696,5277
,GuanTianXiang,350881203,3980,871,2767,2263,5066,2731,898,2921,5652,2982,5749
,WuCiXiang,350881204,2965,550,1946,1566,3913,1918,691,2180,4098,2260,4206
,LingDiXiang,350881205,3957,572,2409,1910,4563,2378,760,2561,4939,2880,5289
Ͻֵ,JiaoNanJieDao,350902001,64286,4643,40999,25406,39169,37966,12813,38274,76240,40743,81742
ֵ,JiaoBeiJieDao,350902002,38368,3642,24623,16793,27359,23695,7789,23741,47436,25176,49799
,ChengNanZhen,350902100,35466,2015,22703,12536,17794,20191,7557,20407,40598,22335,45038
,ZhangWanZhen,350902101,32789,3948,21615,11344,37852,19486,6290,20427,39913,21412,43027
߶,QiDouZhen,350902102,13936,2266,9011,6211,17501,8996,2783,9936,18932,9974,18985
˶,BaDouZhen,350902103,8078,1790,5206,4544,10060,5006,1215,5712,10718,5877,11083
Ŷ,JiuDouZhen,350902104,5086,883,3213,2504,6146,3091,851,3420,6511,3607,6820
ͯ,HuoTongZhen,350902105,15415,2515,10283,6956,18249,10000,3079,10396,20396,10726,21009
Ϫ,ChiXiZhen,350902106,9512,1875,6365,5002,12383,6281,1987,6903,13184,7009,13374
,YangZhongZhen,350902107,11624,2542,7293,6618,15191,7239,1752,8508,15747,8625,15918
,FeiLuanZhen,350902108,12193,1863,7843,5012,15039,7622,2345,8395,16017,8558,16401
,SanDouZhen,350902109,18634,2111,10897,6720,21062,10598,3703,12296,22894,13551,24448
,JinHanSheZuXiang,350902200,19689,1810,11005,6690,14073,10073,3172,11128,21201,13666,24671
,HongKouXiang,350902201,1611,211,991,943,1894,968,337,1092,2060,1168,2159
ʯ,ShiHouXiang,350902202,3754,955,2294,2316,4610,2275,558,2775,5050,2973,5267
,HuBeiXiang,350902203,7065,1417,4492,3679,9245,4464,1230,5162,9626,5220,9712
ȿ,DongQiaoKaiFaQu,350902500,32541,1343,19123,11487,11371,17051,5923,16933,33984,20684,39807
ɳǽֵ,SongChengJieDao,350921001,81445,7235,52149,32015,71971,50615,16657,51470,102085,53188,105337
ɸ۽ֵ,SongGangJieDao,350921002,46898,4270,29306,17798,38126,28150,9225,29260,57410,31087,60393
,ChangChunZhen,350921101,32064,4904,20134,15103,41542,20038,6792,23494,43532,23626,43760
,YaChengZhen,350921102,19478,2497,11980,8546,24212,11947,3544,13496,25443,13539,25519
Ϫ,XiNanZhen,350921103,26045,3703,16642,10777,34008,16602,5820,18685,35287,18926,35568
ɳ,ShaJiangZhen,350921104,24850,3657,15448,9950,32064,15346,4780,17693,33039,17839,33287
,XiaHuZhen,350921105,20095,3086,12893,9398,25862,12878,4721,14971,27849,15009,27902
ɳ,SanShaZhen,350921106,28388,3247,17865,12765,33807,17744,5283,18627,36371,19053,36918
,YanTianSheZuXiang,350921200,17505,2333,10633,7097,20731,10148,3590,11532,21680,12795,23428
ˮ,ShuiMenSheZuXiang,350921201,9374,1480,5967,5011,12180,5937,1919,6738,12675,6806,12773
,ChongRuSheZuXiang,350921202,10433,1785,6510,5078,13434,6467,1877,7481,13948,7585,14095
,BaiYangXiang,350921203,15417,2246,9200,6684,19602,9031,2600,10851,19882,11063,20263
,BeiBiXiang,350921204,10056,1489,6473,4563,12877,6459,2473,7537,13996,7545,14018
,HaiDaoXiang,350921205,6028,752,3673,3014,7065,3671,1135,4228,7899,4242,7915
Ƕֵ´,ChengDongJieDaoBanShiChu,350922001,35711,4271,22893,15399,30564,22028,6493,22622,44650,23582,46475
ֵ´,ChengXiJieDaoBanShiChu,350922002,51879,6003,33040,21558,45854,32082,9337,33351,65433,34179,67219
ƽ,PingHuZhen,350922101,21526,2995,13577,9846,27044,13487,4072,14871,28358,15016,28593
,DaQiaoZhen,350922102,20870,3027,13280,9685,25569,12958,3890,14118,27076,14507,27787
,HuangTianZhen,350922103,15745,1956,10064,7240,17627,9577,3084,10025,19602,10721,20785
,HeTangZhen,350922104,25477,3040,15726,10526,27848,15267,5169,16695,31962,17960,33686
ɼ,ShanYangZhen,350922105,11007,2297,7323,6098,14567,7276,2238,7993,15269,8219,15542
ﶼ,FengDouZhen,350922106,11402,1694,7199,5935,14781,7173,2280,8140,15313,8177,15376
ˮ,ShuiKouZhen,350922107,5558,802,3440,2635,6508,3383,942,3707,7090,3862,7302
,JiXiangXiang,350922201,18651,2690,11603,8451,23458,11516,3403,13031,24547,13141,24744
,PanYangXiang,350922203,4049,706,2484,1990,5204,2466,656,2873,5339,2927,5411
,FengPuXiang,350922204,10074,1241,6251,3886,12359,6114,1715,6500,12614,6779,13030
׿,ZhuoYangXiang,350922205,7270,1345,4611,3684,9255,4577,1247,5151,9728,5251,9862
,DaJiaXiang,350922206,5498,1282,3691,3169,7594,3666,1108,4151,7817,4197,7888
ŷ,GuFengZhen,350923100,29130,2739,19474,11980,24851,19113,7060,19106,38219,19455,38929
˫Ϫ,ShuangXiZhen,350923101,8997,1092,5203,3156,10168,4885,1421,5439,10324,6307,11510
Ϫ,DaiXiZhen,350923102,11820,1981,7446,5063,15358,7351,2132,8358,15709,8487,15933
,ChangQiaoZhen,350923103,9863,1235,6307,4158,12464,6207,2193,6834,13041,6984,13291
,PingChengXiang,350923200,5149,771,3251,2526,5668,3210,998,3543,6753,3667,6918
Ŀ,TangKouXiang,350923201,9625,1210,6189,4211,12011,6104,1928,6384,12488,6574,12763
,GanTangXiang,350923202,6581,1056,4324,2929,8150,4185,1404,4558,8743,4717,9041
,XiLingXiang,350923203,7231,1172,4505,3017,9346,4422,1263,5042,9464,5161,9666
·,LuXiaXiang,350923204,5915,792,3743,2354,7485,3612,1210,3947,7559,4174,7917
ɽ,ShouShanXiang,350923205,3061,462,1821,1492,3641,1769,478,2058,3827,2180,4001
,LingXiaXiang,350923206,5646,849,3667,2502,7149,3634,1260,4038,7672,4088,7755
,AoYangZhen,350924100,40273,2869,25383,14678,30781,23505,10537,25584,49089,28296,53679
б̲,XieTanZhen,350924101,11412,1587,7258,4775,12967,6415,2569,7143,13558,8310,15568
,NanYangZhen,350924102,12757,1876,8596,5675,16204,8413,3392,9105,17518,9429,18025
,WuQuZhen,350924103,5933,1024,3836,2525,7085,3526,1300,3766,7292,4421,8257
,DaAnXiang,350924200,4437,1122,3239,2679,6394,3208,1202,3470,6678,3522,6761
ӵ,KengDiXiang,350924201,6470,1394,4992,3693,9441,4744,2553,5145,9889,5425,10417
Դ,QingYuanXiang,350924202,7289,1233,4991,3470,9386,4966,1735,5211,10177,5266,10257
,ZhuGuanLongXiang,350924203,3157,569,2148,1556,3855,2041,803,2144,4185,2381,4529
ϬϪ,XiXiXiang,350924204,6010,1159,4050,3129,7946,3943,1622,4529,8472,4741,8791
,QinYangXiang,350924205,5192,1047,3566,2605,7397,3272,1517,3750,7022,4190,7756
Ϫ,TuoXiXiang,350924206,4391,972,3220,2404,6049,2863,1233,3142,6005,3376,6596
ƽϪ,PingXiXiang,350924207,9212,1629,6814,4238,13007,6640,3365,7145,13785,7392,14206
,FengYangXiang,350924208,5687,1161,4014,2865,7674,3980,1654,4416,8396,4488,8502
µ,XiaDangXiang,350924209,1697,363,1156,946,2201,1094,470,1253,2347,1374,2530
ʨ,ShiChengZhen,350925100,27877,3641,19062,13187,24988,18759,6955,18951,37710,19411,38473
̴,XianCunZhen,350925101,11518,2054,7684,5607,14986,7550,2663,8419,15969,8551,16235
Դ,PuYuanZhen,350925102,8010,1781,5541,4178,10562,5434,1622,5723,11157,5872,11413
߲,QiBuZhen,350925103,5718,1386,3906,3141,7489,3815,1269,4184,7999,4467,8373
,LiDunZhen,350925104,6403,1213,3554,2773,6943,3392,1004,3867,7259,5066,8620
,ChunChiZhen,350925105,6473,1345,4361,3298,8676,4249,1380,4710,8959,4837,9198
,SiQiaoXiang,350925200,4632,1087,3348,2576,6518,3285,1209,3521,6806,3580,6928
,LiMenXiang,350925201,4217,1140,2989,2419,5915,2857,1020,3164,6021,3388,6377
,MaKengXiang,350925202,5168,979,2996,2579,5967,2912,937,3449,6361,4088,7084
˫,ShuangChengZhen,350926100,30226,2455,19920,10809,22586,19231,7195,19186,38417,19956,39876
Ϫ,FuXiZhen,350926101,4382,865,2802,2198,5834,2794,877,3288,6082,3322,6124
ǽ,ChengJiaoXiang,350926200,7335,954,4752,3093,6297,4547,1658,4999,9546,5195,9947
է,ZhaYangXiang,350926201,4100,668,2483,1657,5013,2459,730,2880,5339,3015,5498
Դ,DongYuanXiang,350926202,5221,715,3060,2220,4533,2929,972,3236,6165,3848,6908
ư,HuangBoXiang,350926203,3215,714,2033,1610,4247,2029,539,2426,4455,2435,4468
լ,ZhaiZhongXiang,350926204,3176,481,1991,1429,4089,1990,606,2266,4256,2272,4263
ƺ,ChuPingXiang,350926205,5265,907,3390,2533,6878,3386,1048,3818,7204,3830,7220
Ӣɽ,YingShanXiang,350926206,2884,592,1861,1511,3758,1842,607,2202,4044,2222,4083
Ͻֵ,ChengNanJieDao,350981001,28934,2331,18388,11821,15746,17944,6648,18813,36757,19525,37913
Ǳֵ,ChengBeiJieDao,350981002,62799,4182,39289,23430,32923,37120,13907,39657,76777,41599,80888
ͷֵ,YangTouJieDao,350981003,27262,2182,17567,10698,14137,17056,6194,17392,34448,18071,35638
,SaiQiZhen,350981100,39249,4061,25229,16291,39071,24884,9497,26988,51872,27578,52807
,MuYangZhen,350981101,9956,1482,6548,4644,12367,6466,1810,6578,13044,6700,13248
ϰʯ,ShangBaiShiZhen,350981102,9025,1661,5875,4920,11498,5574,1711,6236,11810,6522,12397
̶ͷ,TanTouZhen,350981103,12412,2360,7920,6386,16607,7811,2112,8808,16619,8964,16884
,SheKouZhen,350981104,10260,1824,6436,5262,12784,6408,2063,7648,14056,7711,14147
,XiaoYangZhen,350981105,4730,937,3110,2569,6318,3084,1114,3592,6676,3671,6781
Ϫ̶,XiTanZhen,350981106,17057,2670,10884,8131,22277,10855,3493,12293,23148,12336,23220
,GanTangZhen,350981107,31626,3160,19607,11480,37510,19099,6986,21189,40288,22165,41772
°ʯ,XiaBaiShiZhen,350981108,26437,3329,15821,11025,31508,15683,5689,18168,33851,19634,35455
Ϫβ,XiWeiZhen,350981109,7972,1252,4919,3378,10218,4833,1477,5628,10461,5782,10701
Ϫ,XiBingZhen,350981110,17014,2322,10874,7612,21851,10826,3609,11976,22802,12071,22945
,WanWuXiang,350981111,12345,1666,7624,5450,14932,7545,2721,8949,16494,9108,16732
,ChengYangXiang,350981200,24888,2286,15653,9803,22562,15467,5870,16975,32442,17391,33044
,BanZhongSheZuXiang,350981201,20888,2198,13122,8470,16585,11946,4797,13846,25792,14761,27883
,FanKengXiang,350981202,8822,1445,5362,4034,11705,5335,1705,6555,11890,6610,11972
,MuYunSheZuXiang,350981203,11078,1811,6995,5275,14537,6915,2291,8068,14983,8185,15180
,KangCuoSheZuXiang,350981204,14473,1951,8923,6389,17928,8913,3112,10545,19458,10613,19536
,SongLuoXiang,350981206,6869,1125,4319,3507,9005,4315,1528,5190,9505,5203,9522
ᪿ,SaiQiKaiFaQu,350981500,12543,1046,8002,4154,12362,7294,2739,7759,15053,8326,16328
忪,FuAnSheZuKaiFaQu,350981501,1092,145,699,436,1369,699,248,786,1485,786,1485
빤ҵ,WanWuGongYeJiZhongQu,350981502,5705,548,2789,1754,5182,2648,909,3083,5731,4373,7162
ͩɽֵ,TongShanJieDao,350982001,46622,4589,30532,19057,40255,29728,9240,28739,58467,29919,60451
ͩǽֵ,TongChengJieDao,350982002,69836,5586,44454,26748,51691,43131,14686,43226,86357,45654,90108
ɽǰֵ,ShanQianJieDao,350982003,32602,2175,20051,12383,21221,19762,7016,20923,40685,21742,41793
,GuanLingZhen,350982100,10220,1951,6430,5124,12916,6314,1811,7300,13614,7552,13982
ǰ,QianQiZhen,350982101,27235,3955,18568,12901,31877,18012,6442,18580,36592,19064,37632
ɳ,ShaChengZhen,350982102,19255,2717,12509,8478,23537,12391,3335,12693,25084,12798,25307
,DianXiaZhen,350982103,22898,3259,14450,9705,26436,13573,3825,14727,28300,15532,29982
,QinYuZhen,350982104,46540,4051,25399,16502,42458,23830,8248,24969,48799,33440,58839
Ϫ,PanXiZhen,350982105,10911,1928,7083,5777,14138,6982,2438,8009,14991,8194,15277
,BaiLinZhen,350982106,25524,3004,16468,11546,28485,15974,5973,17400,33374,18033,34501
ͷ,DianTouZhen,350982107,25517,3290,16654,11457,30036,16485,5634,17493,33978,17787,34441
,GuanYangZhen,350982108,24409,3913,16055,11245,31329,15890,5920,17922,33812,18187,34242
ɽ,YuShanZhen,350982109,2588,370,1682,1285,3149,1662,505,1722,3384,1781,3463
,XiaMenSheZuXiang,350982200,10134,1259,6158,5110,9252,5917,2113,6116,12033,7348,13506
ʯ,DieShiXiang,350982201,7695,1645,5013,3860,10364,5013,1701,6022,11035,6028,11041
,JiaYangXiang,350982202,7781,1658,5013,4241,10388,4955,1544,5854,10809,5970,10983
�,LongAnKaiFaQu,350982500,10909,760,6275,4789,4894,5990,2317,6728,12718,7711,13986
԰ֵ´,GongYuanJieDaoBanShiChu,360102001,22813,3453,17116,8413,20675,13261,4062,12380,25641,13212,30328
ֵ´,TengWangGeJieDaoBanShiChu,360102002,27710,3665,18124,10930,24332,16779,4352,16306,33085,17603,35727
һŽֵ´,BaYiQiaoJieDaoBanShiChu,360102003,27422,3502,17934,11328,22857,17602,4016,16758,34360,17006,34940
ٻ޽ֵ´,BaiHuaZhouJieDaoBanShiChu,360102004,37726,4874,24950,14485,36263,23385,6077,22279,45664,23727,48677
ֵ´,DunZiTangJieDaoBanShiChu,360102005,30067,4118,20286,10967,27614,18015,4696,16944,34959,18595,38881
Ժֵ´,DaYuanJieDaoBanShiChu,360102006,23943,4810,16806,8876,28016,16029,4940,15234,31263,16887,33693
ԥ½ֵ´,YuZhangJieDaoBanShiChu,360102007,42821,6045,28724,17633,42439,28009,7807,27034,55043,27949,56673
Ҥֵ´,DongJiaYaoJieDaoBanShiChu,360102008,75725,10187,49564,29945,64856,46629,13049,46262,92891,49397,98961
Žֵ´,PengJiaQiaoJieDaoBanShiChu,360102009,43497,4718,28231,15811,32045,23311,6544,23858,47169,26528,54759
ɳֵ´̲,ShaJingJieDaoBanShiChuHongGuTanXinQu,360102050,58606,3330,35812,22085,32358,33273,14485,34140,67413,40609,76421
ʿί,XianShiHuGuanWeiHui,360102400,32172,1529,19610,14386,6889,18874,7741,20969,39843,21832,41442
޹�̲,FengHuangZhouGuanLiChuHongGuTanXinQu,360102450,18641,1310,11748,7394,9794,11279,5036,12140,23419,13239,24987
ֵֽ´,NanPuJieDaoBanShiChu,360103001,35463,4637,23248,14268,32703,23004,5920,22468,45472,22772,46020
޽ֵ´,ZhaoYangZhouJieDaoBanShiChu,360103002,30087,3253,19331,12293,20720,19071,5649,19029,38100,19658,38989
Žֵ´,GuangRunMenJieDaoBanShiChu,360103004,29203,3653,19110,11979,25859,18607,4752,18154,36761,18498,37608
ֵ´,XiHuJieDaoBanShiChu,360103005,26298,3353,16888,10251,27056,16232,3857,15956,32188,16620,33508
ϵ׮ֵ´,XiMaZhuangJieDaoBanShiChu,360103006,39901,5487,26459,15698,40362,25872,6673,24868,50740,25602,52061
ֵ´,ShengJinTaJieDaoBanShiChu,360103007,28931,4270,19288,12299,30617,18385,4562,18360,36745,18475,37763
·ֵ´,DingGongLuJieDaoBanShiChu,360103009,39235,6545,26327,16664,39194,25942,6407,25537,51479,25860,52187
վֵ´,NanZhanJieDaoBanShiChu,360103010,30904,6203,21347,13365,33480,20739,5477,20553,41292,21237,42584
Դֵ´,TaoYuanJieDaoBanShiChu,360103011,33639,2855,21764,13328,23275,21040,7034,21305,42345,21764,43528
ʮֵֽֽ´,ShiZiJieJieDaoBanShiChu,360103012,49204,4764,30241,18866,38672,28566,8369,28891,57457,32096,62337
һ,TaoHuaZhen,360103101,30379,1476,18329,10152,14524,16055,7152,17990,34045,20678,39007
ϲгũ,NanChangShiZhaoYangNongChang,360103400,13368,922,8602,4945,5810,8468,3939,9115,17583,9627,18229
鶼ֵ´,HongDouJieDaoBanShiChu,360104002,39971,8410,27414,18130,48742,26910,7480,26759,53669,28447,55861
ɽֵ´,JingShanJieDaoBanShiChu,360104006,33965,4614,22504,14492,29805,22057,6790,22522,44579,22865,45369
ҵֵ´,SanJiaDianJieDaoBanShiChu,360104007,29132,4185,19293,12569,26430,18796,5724,18960,37756,19748,39041
ɽֵ´,DaiShanJieDaoBanShiChu,360104008,30353,2997,17258,10121,22172,14558,4422,14822,29380,20514,37772
ҷֵ´,XuJiaFangJieDaoBanShiChu,360104009,43056,5339,27742,18502,30374,27383,7907,27861,55244,28560,56302
,QingYunPuZhen,360104100,60920,3727,37858,23222,28667,37287,16519,41592,78879,43308,81166
ϲϹҵ԰,NanChangChangNanGongYeYuan,360104400,1013,20,551,443,5,549,179,658,1207,661,1212
վǰֵ´,ZhanQianJieDaoBanShiChu,360105001,8912,700,5329,2406,4092,3386,1414,3478,6864,5697,11026
Ҹֵ´,XingFuJieDaoBanShiChu,360105002,3768,609,2730,1980,2903,2714,1216,2840,5554,2863,5593
,ZhaoXianZhen,360105100,19826,1498,13076,5167,17032,8671,4796,9331,18002,13044,26120
÷,MeiLingZhen,360105101,3380,723,2577,1892,4723,2564,1111,2606,5170,2637,5214
ͤ,LuoTingZhen,360105102,8843,597,4575,2087,7440,3274,1798,3603,6877,6663,11238
̫ƽ,TaiPingZhen,360105103,2551,702,2440,2010,4403,2439,1519,2332,4771,2332,4772
ɽ·ֵ´,QingShanLuJieDaoBanShiChu,360111001,15907,3173,10885,6542,16344,9597,2361,9255,18852,10556,21441
Ϻ·ֵ´,ShangHaiLuJieDaoBanShiChu,360111003,60958,7306,38896,24533,55415,38158,10812,39300,77458,40180,79076
,JingDongZhen,360111100,53550,2872,31848,17635,25155,27913,12330,30258,58171,36904,68752
޼,LuoJiaZhen,360111103,38783,4093,25779,13314,47437,25736,12316,29243,54979,29413,55192
,HuFangZhen,360111104,126360,10034,78145,49646,70468,72247,26958,77702,149949,85207,163352
ɽ,TangShanZhen,360111105,92298,6330,55380,30369,50590,44209,16439,46440,90649,59687,115067
,YangZiZhouZhen,360111106,15547,1931,10612,5603,18769,10545,4808,11407,21952,11674,22286
ϲü�,JiaoQiaoZhenNanChangJingJiJiShuKaiFaQu,360111180,160537,5075,78566,18605,74776,28762,12797,30989,59751,99843,178409
ˮ�ϲü�,BaiShuiHuGuanLiChuNanChangJingJiJiShuKaiFaQu,360111481,52221,2669,20526,7488,31280,11832,5006,12433,24265,39370,59896
ɽ�(ϲü�),GuanShanGuanLiChu(NanChangJingJiJiShuKaiFaQu),360111482,22002,858,9877,3036,8655,4722,2057,5022,9744,15040,24917
Ϫ�ϲ¿,AiXiHuGuanLiChuNanChangGaoXinKaiFaQu,360111490,30176,2038,18268,8755,21805,15203,7272,16428,31631,21218,39486
ϲҵ,NanChangChangDongGongYeQu,360111501,27051,2109,17389,7932,25495,15170,7121,16846,32016,18892,36281
ũ,YangZiZhouNongChang,360111503,915,162,617,384,1042,610,187,630,1240,647,1264
޼ҵʡеλ,LuoJiaDiQuShengShiDanWei,360111504,18985,3457,12728,8969,23861,12557,3904,13380,25937,13618,26346
½ϲ¿,HuXiXinJianQuNanChangGaoXinKaiFaQu,360111593,4889,282,2684,1694,3328,2413,907,2449,4862,3394,6078
,LianTangZhen,360121100,115563,8995,72979,41862,94114,67499,29412,72086,139585,80991,153970
,XiangTangZhen,360121101,98244,10661,65622,31957,111042,55921,21637,58878,114799,64920,130542
,SanJiangZhen,360121102,14790,2198,11130,6297,20389,11083,5656,11443,22526,11514,22644
,TangNanZhen,360121103,22929,4661,18049,11279,34315,18018,9776,19234,37252,19317,37366
,YouLanZhen,360121104,25193,5692,19462,12517,36794,19365,9018,20264,39629,20441,39903
,JiangXiangZhen,360121105,41400,5908,30134,15377,59868,29749,16121,32710,62459,33295,63429
,WuYangZhen,360121106,25294,3557,17391,9766,34662,17368,8057,19464,36832,19517,36908
,GangShangZhen,360121107,27454,3692,19119,10220,33318,17856,8427,19144,37000,20454,39573
㸣,GuangFuZhen,360121108,18765,2718,14592,8124,26563,14569,8170,14974,29543,15061,29653
ϲ¿,ChangDongZhenNanChangGaoXinKaiFaQu,360121191,123091,5883,68063,19649,77555,34135,19331,37756,71891,80242,148305
ϲ¿,MaQiuZhenNanChangGaoXinKaiFaQu,360121192,22354,3302,16387,9057,29567,16024,9017,17433,33457,18286,34673
,JingKouXiang,360121200,28457,4425,20407,12009,41181,20353,10229,22556,42909,22704,43111
,NanXinXiang,360121201,22246,3976,17622,9826,34463,17612,10101,18684,36296,18701,36323
,TaChengXiang,360121202,15458,3044,11427,7181,22710,11414,5018,12062,23476,12093,23520
,HuangMaXiang,360121203,19302,2928,13508,7865,25770,13471,5959,14606,28077,14681,28189
ɽ,FuShanXiang,360121204,11313,1325,8106,4164,15553,8100,4590,9106,17206,9122,17228
,DongXinXiang,360121205,22236,1771,14765,8416,18190,14712,7353,16408,31120,16595,31360
һ,BaYiXiang,360121206,24327,3136,16541,8956,27762,16499,7529,18320,34819,18451,34992
Сÿ,XiaoLanJingJiKaiFaQu,360121403,26621,1957,16324,6916,22341,13601,7061,14813,28414,19315,35639
ϲǿֳ,NanChangShiWuXingKenZhiChang,360121501,4319,759,3061,2384,5554,3052,1313,3296,6348,3330,6391
ǹ�,YinSanJiaoGuanLiChu,360121502,18835,1566,11216,6742,12023,10655,4555,11656,22311,13740,24956
,ChangZhen,360122100,147369,8905,88509,45535,119686,81655,42908,90437,172092,110673,199182
,WangChengZhen,360122101,28249,963,13625,4026,16070,7978,4595,8647,16625,20182,33807
,ShengMiZhen,360122102,24402,1936,15880,7079,27827,13209,7798,14279,27488,18256,34136
ɽ,XiShanZhen,360122103,17365,2390,13587,6968,27054,13056,8367,13677,26733,14535,28122
ʯ,ShiGangZhen,360122104,29450,2774,21376,10760,44219,21356,13202,23984,45340,24050,45426
ɺ,SongHuZhen,360122105,16105,2345,12644,6616,25595,12643,7747,13553,26196,13553,26197
,QiaoSheZhen,360122106,18816,2359,13897,6728,27469,13155,7310,13732,26887,14588,28485
ֻ,LeHuaZhen,360122107,16538,1985,11877,5838,22256,11188,6278,11942,23130,12924,24801
Ϫϼ,XiXiaZhen,360122108,15666,1950,11753,5251,22487,11196,6547,11559,22755,12410,24163
ɽ,XiangShanZhen,360122109,9731,1671,7722,4420,15341,7714,4309,7977,15691,7989,15711
ʯ,ShiBuXiang,360122200,25405,2313,18399,8050,37241,18367,11177,20438,38805,20496,38895
,LiuHuXiang,360122201,20079,2238,14944,6914,31142,14941,9433,16798,31739,16806,31750
,HouTianXiang,360122202,10182,1419,7558,4004,15349,7558,3868,7904,15462,7911,15469
,LianWeiXiang,360122203,16885,2307,12422,6976,24266,12422,6131,12901,25323,12901,25323
,JinQiaoXiang,360122204,9994,1304,7635,3716,14939,7629,4204,7854,15483,7867,15502
,TieHeXiang,360122205,4987,646,3556,2409,7022,3550,1626,3682,7232,3703,7259
ƺ,DaTangPingXiang,360122206,11287,2043,8745,4662,17494,8571,4562,8821,17392,9147,17892
,ChangYiXiang,360122207,8917,1360,6980,4125,13782,6964,4022,7291,14255,7319,14299
,NanJiXiang,360122208,2139,306,1607,902,3181,1461,844,1570,3031,1682,3289
ֳ,HengHuKenZhiChang,360122400,4017,1377,3150,2552,5407,3110,969,3159,6269,3213,6363
ʵҵ޹˾,ChengXinShiYeYouXianGongSi,360122402,2046,317,1239,1102,2067,1218,360,1347,2565,1484,2723
ʵҵ޹˾,ZhuGangShiYeYouXianGongSi,360122403,1154,150,639,634,1044,622,159,743,1365,824,1463
�Ͷʹҵ,JiangXiChangWaiShangTouZiGongYeQu,360122404,8174,594,5733,3187,10426,5720,3102,6117,11837,6137,11870
޹�̲,HongJueZhouGuanLiChuHongGuTanXinQu,360122450,106990,1140,50626,7304,54232,11844,6043,12673,24517,63547,114173
�̲,JiuLongHuGuanLiChuHongGuTanXinQu,360122451,2824,439,2268,1573,4429,2256,1393,2347,4603,2388,4656
ɣ޹˾ɣÿ,JiangXiSangHaiJiTuanYouXianGongSiJiangXiSangHaiJingJiKai,360122460,11897,2309,8216,5417,14802,7505,2967,7671,15176,8957,17173
ܹ�ɣü�,XinQiZhouGuanLiChuJiangXiSangHaiJingJiJiShuKaiFaQu,360122461,3543,367,2610,1456,4864,2607,1394,2690,5297,2694,5304
·ֳ,XinFengKenZhiChang,360122502,1403,216,902,612,1749,877,360,1018,1895,1077,1979
,LongJinZhen,360123100,52835,4395,35332,20729,60569,31530,16868,33866,65396,38766,74098
,WanBuZhen,360123101,8540,1835,7013,5163,12806,6983,3853,7138,14121,7215,14228
ʯ,ShiBiZhen,360123102,10846,2798,9382,7058,17974,9244,5278,9313,18557,9540,18922
,DingHuZhen,360123103,12236,2452,9346,6210,16937,9053,4199,9163,18216,9541,18887
,ChangBuZhen,360123104,4668,1339,4089,3077,7911,3985,2206,3996,7981,4124,8213
,DongYangZhen,360123105,5928,1293,4799,2953,9162,4794,2220,4629,9423,4642,9441
,HuangZhouZhen,360123106,5171,1293,4051,2814,7428,3777,1787,3696,7473,4200,8251
,QiaoLeXiang,360123200,5327,973,4369,2832,8648,4321,2724,4582,8903,4655,9024
,ChangJunXiang,360123201,4544,920,3721,2563,7131,3447,2033,3432,6879,3776,7497
,XinMinXiang,360123202,4341,997,3316,2381,6455,3304,1346,3341,6645,3368,6684
幤ҵ԰,JiangXiAnYiGongYeYuanQu,360123402,2747,11,724,184,1,179,9,188,367,2043,2767
Ӫ򲺿ֳ,GuoYingWanBuKenZhiChang,360123501,962,191,666,375,1289,516,244,571,1087,731,1397
Ӫֳ,GuoYingQiaoLingKenZhiChang,360123502,613,86,355,160,777,184,86,239,423,430,785
,MinHeZhen,360124100,117915,10581,82972,47247,126635,82014,41906,86012,168026,87430,170402
,LiDuZhen,360124101,28659,3478,19843,10117,38214,19817,8814,21067,40884,21108,40951
,WenZhenZhen,360124102,28731,2994,18156,9652,36695,18148,8651,20346,38494,22220,40376
ĸ,WenGangZhen,360124103,23647,3551,16961,10028,31416,16879,8011,18074,34953,18248,35209
÷ׯ,MeiZhuangZhen,360124104,21296,2556,15306,7970,30728,15275,7777,16267,31542,16323,31629
Ź,ZhangGongZhen,360124105,19090,2377,13671,7179,26598,13655,6664,14419,28074,14460,28131
Ϫ,LuoXiZhen,360124106,17570,2361,12838,7330,25463,12838,6374,13467,26305,13467,26305
,JiaQiaoZhen,360124107,16535,2053,12097,6828,24160,12090,6162,12625,24715,12653,24750
ǰ,QianFangZhen,360124108,17623,2223,12701,6729,25135,12674,6303,13376,26050,13448,26149
,SanLiXiang,360124200,20005,2970,15901,8442,31073,15841,9630,16578,32419,16704,32605
,ErTangXiang,360124201,8478,1077,6073,3260,12327,6063,3092,6530,12593,6574,12647
,ZhongLingXiang,360124202,15752,2105,10608,5521,21725,10091,4919,10589,20680,12168,22776
Ϫ,ChiXiXiang,360124203,13675,1725,9645,5585,19409,9600,4759,10390,19990,10514,20159
̨,NanTaiXiang,360124204,10125,1393,7477,3933,15003,7466,3788,7809,15275,7829,15306
,SanYangJiXiang,360124205,16269,2310,12670,6900,24810,12639,7066,12917,25556,12975,25645
,QiLiXiang,360124206,18032,2572,13031,6941,26219,12982,6456,13888,26870,14029,27060
²,XiaBuJiXiang,360124207,16223,1772,12201,6436,23926,12175,6813,12367,24542,12607,24808
ǰ,YaQianXiang,360124208,9920,1179,7081,3545,14147,7051,3577,7434,14485,7595,14676
,BaiWeiXiang,360124209,16981,1987,12321,6176,24379,12289,6563,13127,25416,13210,25531
ɽ,ChangShanYanXiang,360124210,13212,1439,8887,4416,15817,8211,6226,8896,17107,11990,20877
Ȫ,QuanLingXiang,360124211,16566,1907,11727,5902,22214,11696,5981,12601,24297,12727,24454
�ֵ,XiJiaoJieDao,360202001,45380,4387,28482,17697,33045,24420,7444,24607,49027,28729,57211
·ֵ,XinFengJieDao,360202002,15958,2031,10377,7190,14498,10372,3003,10607,20979,10615,20992
,JingChengZhen,360202100,32357,2160,21135,11458,32313,21075,8909,22193,43268,22291,43426
ɽ,NianYuShanZhen,360202101,23448,1994,13438,7887,24407,13040,6797,14217,27257,18801,32239
,LiYangXiang,360202201,8848,985,6411,3847,12800,6391,3489,6850,13241,6911,13322
,HeTangXiang,360202202,2010,288,1435,928,2696,1435,628,1490,2925,1491,2926
,LvMengXiang,360202290,14011,884,8753,4947,8730,8492,3787,9273,17765,9929,18682
�԰,ChangJiangHuaGongYuanQu,360202451,1,0,0,1,0,0,0,1,1,1,1
߿Ƽ԰,LiuLingErSuoGaoKeJiYuan,360202452,1,0,0,1,0,0,0,1,1,1,1
�,ChangJiangKaiFaQu,360202453,1,0,1,1,0,1,0,0,1,0,1
ɽܳ,FengShuShanZongChang,360202500,2498,415,1690,1082,2136,1617,489,1676,3293,1712,3402
ʯʨֵ´,ShiShiBuJieDaoBanShiChu,360203001,21921,2577,14841,9663,23846,13280,3809,13290,26570,13466,28307
³ֵ´,XinChangJieDaoBanShiChu,360203002,50007,5050,30744,18606,41758,25676,7767,26003,51679,32080,62824
ֵ´,LiCunJieDaoBanShiChu,360203003,27037,3040,17330,12196,23648,17252,5177,17786,35038,17924,35254
·ڽֵ´,ZhouLuKouJieDaoBanShiChu,360203004,11084,1096,6978,4964,8062,6917,2225,7233,14150,7427,14405
ֵ´,ChangJiangJieDaoBanShiChu,360203005,14028,2095,9157,6690,15189,9134,2288,9191,18325,9254,18411
´ֵ´,XinCunJieDaoBanShiChu,360203006,45774,5648,30161,20183,45980,30058,9133,30231,60289,30394,60555
ɽֵ´,ZhuShanJieDaoBanShiChu,360203007,11589,1889,7744,5699,12665,7677,1935,7569,15246,7669,15413
̫԰ֵ´,TaiBaiYuanJieDaoBanShiChu,360203008,19289,1919,12338,8665,18763,12153,4207,12777,24930,13077,25415
ӽֵ´,ChangHeJieDaoBanShiChu,360203009,15455,2467,10247,7657,17612,10038,2851,9885,19923,10526,20773
¼�,GaoXinJiShuKaiFaQu,360203400,1,0,0,1,1,0,0,1,1,1,1
,FuLiangZhen,360222100,24639,1524,15842,9552,25827,15663,6182,16248,31911,16503,32345
,EHuZhen,360222101,19147,1848,12545,7001,25256,12526,5034,13400,25926,13484,26029
,JingGongQiaoZhen,360222102,11153,1169,7336,4110,13844,7334,2596,7560,14894,7582,14918
̶,JiaoTanZhen,360222103,15926,1594,10281,5318,20481,10272,3856,11064,21336,11095,21376
,XiangHuZhen,360222104,35976,2184,18884,7982,24767,13016,4628,13776,26792,23904,42788
,YaoLiZhen,360222105,9046,1093,5953,3585,11956,5944,2218,6389,12333,6404,12357
Դ,HongYuanZhen,360222106,11985,952,7947,3910,15462,7902,3404,8331,16233,8394,16341
ٰ,ShouAnZhen,360222107,22933,2208,14543,9321,28545,14482,5606,15982,30464,16204,30747
,SanLongZhen,360222108,12606,744,6817,2847,10290,5056,2050,5528,10584,8583,15400
,WangGangXiang,360222200,7596,771,4871,2645,8639,4838,1460,4889,9727,4956,9827
ׯ,ZhuangWanXiang,360222201,9481,970,6023,3259,11972,5969,1984,6174,12143,6412,12435
̳,HuangTanXiang,360222203,8722,772,5363,2669,11120,5363,1889,6020,11383,6020,11383
,XingTianXiang,360222204,5655,687,3630,2033,7364,3629,1222,3910,7539,3934,7564
,JiangCunXiang,360222205,6897,798,4431,2619,8990,4400,1579,4763,9163,4843,9274
̲,ZhiTanXiang,360222206,9101,1002,5989,3226,11999,5950,2317,6274,12224,6431,12420
չ,LeGongXiang,360222207,6057,653,3856,2139,7431,3808,1161,3997,7805,4015,7871
,XiHuXiang,360222208,7532,807,4560,2512,9113,4546,1485,5195,9741,5264,9824
޼(մɹҵ԰),LuoJiaQiaoXiang(TaoCiGongYeYuan),360222209,5919,383,3650,1735,6495,3265,1202,3343,6608,3854,7504
ҵ԰,FuLiangGongYeYuanQu,360222400,2020,81,1175,515,2139,756,321,751,1507,1247,2422
޼ҿֳ,LuoJiaKenZhiChang,360222500,546,43,372,197,434,353,149,356,709,366,738
ֵ´,JiYangJieDaoBanShiChu,360281001,104905,8713,68859,39687,116805,67560,26711,70370,137930,71470,140329
ɽֵ´,TaShanJieDaoBanShiChu,360281002,15557,1259,9865,6142,19590,9774,4373,11127,20901,11324,21189
,ZhenQiaoZhen,360281100,36790,3313,24525,11873,51172,23808,11611,26268,50076,27189,51714
ָ,LeGangZhen,360281101,57344,5330,37302,19856,77387,36995,16666,41232,78227,42038,79340
ӿɽ,YongShanZhen,360281102,25750,2298,17548,9416,36053,17532,9290,19730,37262,19790,37338
ڲ,ZhongBuZhen,360281103,47473,4406,36373,20553,75287,36267,24203,39539,75806,39709,76082
Ӷ,JieDuZhen,360281104,46736,4022,33162,15763,67451,33116,18019,35491,68607,35615,68777
,HongYanZhen,360281105,12077,1149,7966,4113,16167,7680,3377,8232,15912,8637,16603
,LiLinZhen,360281106,36536,2897,23911,12301,50633,23831,11937,27357,51188,27459,51370
,HouGangZhen,360281107,32118,2951,21951,11205,42883,21316,11465,23261,44577,24583,46534
ǰ,TaQianZhen,360281108,27738,2459,18450,9836,38829,18433,9288,20984,39417,21035,39485
˫,ShuangTianZhen,360281109,28585,2456,19149,10095,39876,19063,9533,21290,40353,21425,40574
ٸ,LinGangZhen,360281110,18041,1561,12737,6318,26679,12719,7504,14293,27012,14369,27106
߼,GaoJiaZhen,360281111,11149,1174,8635,4832,17440,8635,5388,9076,17711,9076,17711
,MingKouZhen,360281112,16316,1577,11650,5361,23976,11617,6129,12305,23922,12372,24022
䴿,WuKouZhen,360281113,18516,1536,13138,6980,27749,13138,7848,14762,27900,14762,27900
,LuCiXiang,360281200,14616,1222,10067,5150,21169,10067,5812,11583,21650,11583,21650
ʮ,ShiLiGangXiang,360281201,10378,1068,7355,3886,15323,7352,4057,8131,15483,8148,15503
ũҵ԰,NongYeGaoXinYuan,360281400,4547,334,3146,1658,6238,3145,1579,3313,6458,3314,6460
ƽҵ԰,JiangXiYuePingGongYeYuanQu,360281401,369,4,230,4,9,1,293,5,6,436,666
ֵֽ´,DongDaJieJieDaoBanShiChu,360302001,31907,2599,21205,9114,28643,15614,5001,15308,30922,18302,39507
˽ֵֽ´,FengHuangJieJieDaoBanShiChu,360302002,107626,8501,68257,38194,100343,63947,21703,63256,127203,69573,137830
һֵֽ´,BaYiJieJieDaoBanShiChu,360302003,31020,3316,19755,10683,29968,17388,5388,16954,34342,19969,39724
󲺽ֵֽ´,HouBuJieJieDaoBanShiChu,360302004,55157,6093,35862,20370,58081,33504,10188,32528,66032,35576,71438
ֵֽ´,DanJiangJieJieDaoBanShiChu,360302005,13437,1647,8990,4525,16043,7379,2429,7467,14846,8523,17513
Դֵֽ´,BaiYuanJieJieDaoBanShiChu,360302006,12559,1095,8912,3736,13083,7153,2702,7305,14458,7444,16356
Դ,AnYuanZhen,360302100,37823,4340,24421,13577,39258,23893,7125,23740,47633,24867,49288
߿,GaoKengZhen,360302101,40600,5974,25784,15337,48626,24957,7203,25109,50066,27993,53777
,WuBeiZhen,360302102,11072,1213,7216,3716,12938,7148,2548,7293,14441,7617,14833
ɽ,QingShanZhen,360302103,31383,3945,20086,11007,37926,20027,6366,20865,40892,21608,41694
ǽί,ChengJiaoGuanWeiHui,360302401,40110,3631,26678,13712,32369,26217,8859,25494,51711,25922,52600
Ͽɽڽֵ´,XiaShanKouJieDaoBanShiChu,360313001,29105,3574,19560,12078,34281,19552,6261,19258,38810,19380,38940
涫,XiangDongZhen,360313101,50915,5573,33731,16724,62094,32622,11596,32984,65606,34353,68084
Ң,HeYaoZhen,360313102,25101,2792,16419,7995,32579,16390,6048,17327,33717,17522,33941
Ϲ,LaoGuanZhen,360313103,24696,2763,16370,7979,32844,16369,6175,17253,33622,17264,33634
,LaShiZhen,360313104,21624,2391,14261,7006,28506,14256,5315,15056,29312,15069,29330
²,XiaBuZhen,360313105,28844,3197,19109,9672,36773,18782,7013,19198,37980,19945,39054
,PaiShangZhen,360313106,18382,3263,13767,8378,26370,13748,5903,13743,27491,13781,27548
,DongQiaoZhen,360313107,21782,3172,14938,8169,29454,14886,5918,15810,30696,15934,30872
ɽ,MaShanZhen,360313108,25231,3112,16771,8393,32904,16324,6422,17243,33567,17994,34765
㺮կ,GuangHanZhaiXiang,360313200,6358,899,4192,2543,8699,4180,1574,4623,8803,4639,8831
,BaiZhuXiang,360313201,9786,1465,6706,3871,13529,6636,2740,7119,13755,7285,13991
ͤ,QinTingZhen,360321101,51556,4603,35760,15814,62498,29206,16242,29166,58372,36641,72401
·,LuKouZhen,360321102,8135,1321,6278,3405,11730,6248,3170,6261,12509,6348,12626
,LiangFangZhen,360321103,17366,3085,14071,7546,24875,14010,6823,12976,26986,13203,27274
,ShengFangZhen,360321104,10125,1271,7203,3542,13603,7163,3144,7294,14457,7337,14540
¥,FangLouZhen,360321105,13383,2222,10012,5724,18725,9810,4785,9722,19532,10378,20390
ʯ,ShanShiXiang,360321200,6223,1132,4896,2720,8946,4839,2432,4689,9528,4891,9787
,HuShangXiang,360321201,7262,1217,5908,3270,10937,5893,3168,5686,11579,5739,11647
,SanBanQiaoXiang,360321202,6704,721,4826,2624,9267,4796,2336,4869,9665,4935,9761
Ȫ,ShenQuanXiang,360321203,11147,1477,8421,4535,15553,8384,4265,8243,16627,8468,16889
,LiuShiXiang,360321204,4365,667,3339,1949,5953,3301,1668,3253,6554,3361,6700
,GaoZhouXiang,360321205,8044,1409,6426,3313,11906,6387,3394,6310,12697,6421,12847
,HeTangXiang,360321206,7644,1126,5865,3347,10905,5838,2889,5699,11537,5794,11659
,NanLingXiang,360321207,6524,1015,4953,2820,8878,4889,2268,4699,9588,4854,9807
,ShangLiZhen,360322101,61000,5709,41813,20441,76102,41115,18961,42772,83887,43857,85670
ͩľ,TongMuZhen,360322102,48294,5125,36259,17043,66907,36207,20173,37140,73347,37333,73592
ɽ,JinShanZhen,360322103,49200,5050,34815,16047,63633,33176,17075,34825,68001,36510,71325
,FuTianZhen,360322104,31324,3531,21326,10895,37789,21025,8766,21723,42748,22295,43621
,PengGaoZhen,360322105,19970,2210,13704,6859,25562,13644,5689,13917,27561,14165,27869
ɽ,ChiShanZhen,360322106,33562,4566,24277,12635,46659,24263,11164,24907,49170,25015,49292
ɽ,JiGuanShanXiang,360322200,20043,2186,14618,6558,28244,14560,7636,15132,29692,15247,29865
ƽ,ChangPingXiang,360322201,28540,3788,19934,10652,39440,19917,8704,21017,40934,21098,41032
Դ,DongYuanXiang,360322202,28706,4392,21968,11740,41271,21946,11850,22907,44853,22980,44948
«Ϫ,LuXiZhen,360323101,46350,5249,32066,17924,54920,31023,12934,30977,62000,32467,64533
,XuanFengZhen,360323102,21104,2869,15718,9107,28604,15310,7666,15301,30611,15921,31639
ϲ,ShangBuZhen,360323103,24548,3314,16887,9855,32106,16838,6534,17290,34128,17509,34396
Ͽ,NanKengZhen,360323104,25073,2956,17156,8859,33221,17151,7296,18158,35309,18169,35325
,YinHeZhen,360323105,24291,3217,18302,9563,33355,18228,9448,18403,36631,18654,36956
Դ,YuanNanXiang,360323200,9526,1173,6649,3495,12751,6597,3152,7006,13603,7202,13851
,ChangFengXiang,360323201,1559,294,1113,754,2191,1105,483,1214,2319,1223,2336
żѷ,ZhangJiaFangXiang,360323202,5239,922,3794,2444,7579,3761,1856,4164,7925,4223,8017
Ȫ,XinQuanXiang,360323203,14224,2188,10040,6325,19587,9787,4693,10610,20397,11065,21105
ɽ,WanLongShanXiang,360323204,6359,1069,4375,2934,8785,4345,1837,4797,9142,4890,9265
ʮֵ´,ShiLiJieDaoBanShiChu,360402001,89000,6623,49853,22762,48493,32549,10857,33077,65626,56627,106480
ֵ´,WuLiJieDaoBanShiChu,360402002,27190,1885,17061,10566,17090,16975,6376,17340,34315,18390,35451
ֵ´(Žÿ),QiLiHuJieDaoBanShiChu(JiuJiangJingJiKaiFaQu),360402090,17258,1163,9964,4156,13655,7706,3471,7882,15588,11928,21892
,GuTangZhen,360402100,13395,1615,9005,5364,15856,8913,3410,9145,18058,9415,18420
,WeiJiaZhen,360402101,5408,756,3766,2034,6602,3741,1399,3748,7489,3797,7563
¸,XinGangZhen,360402102,20455,2798,13827,7709,24332,13481,5385,14076,27557,14811,28638
,LianHuaZhen,360402103,16445,2636,10987,6801,16235,10767,3366,11029,21796,11460,22447
,HaiHuiZhen,360402104,17742,2193,12020,6699,23439,11975,4971,12638,24613,12886,24906
,SaiYangZhen,360402105,6726,754,4458,2663,8098,4395,1771,4562,8957,4793,9251
(®ɽ),GuLingZhen(LuShanGuanLiJu),360402176,10761,1522,7063,4688,11200,6554,1680,6419,12973,6900,13963
ݼҺ,YuJiaHeXiang,360402200,9301,1058,5972,3257,9855,5789,2110,5855,11644,6497,12469
®ɽ,LuShanChaKeSuo,360402470,357,53,255,246,468,255,108,256,511,263,518
®ɽֿ(®ɽ),LuShanLinKeSuo(GuiShuLuShanQu),360402471,156,52,116,89,221,115,22,111,226,114,230
Ľֵ,GanTangJieDao,360403001,74516,9003,49742,30456,74514,47837,13932,46399,94236,47709,97451
ֵֽ,PenPuJieDao,360403002,24210,3179,15950,10123,23990,14793,4170,14293,29086,15609,31559
·ֵ,RenMinLuJieDao,360403003,74975,6668,48759,26642,64630,39127,12832,38975,78102,45716,94475
ˮֵ,BaiShuiHuJieDao,360403004,42425,5108,26967,18249,34877,25641,7726,25726,51367,28292,55259
½ֵ,JinJiPoJieDao,360403005,22026,3067,14080,10127,20622,13704,3899,13672,27376,14912,28992
ֵ´Žÿ,XiangYangJieDaoBanShiChuJiuJiangJingJiKaiFaQu,360403091,38585,2666,24552,12882,27148,19396,6933,19709,39105,23632,48184
˽ֵ´Žÿ,BinXingJieDaoBanShiChuJiuJiangJingJiKaiFaQu,360403092,35642,5086,22788,15310,37420,22273,5339,22734,45007,23279,46067
éɽͷҵ(Žÿ),MaoShanTouQiYeJiTuan(JiuJiangJingJiKaiFaQu),360403400,626,40,390,274,550,383,105,378,761,381,771
ɳӽ,ShaHeJieZhen,360421100,28190,3014,18963,10571,32110,16253,8356,16918,33171,20597,39560
,MaHuiLingZhen,360421101,18932,1676,13098,6696,25676,13011,6434,13827,26838,13944,27042
,JiangZhouZhen,360421102,22556,2997,14828,7644,29600,14735,4565,15083,29818,15290,30118
,ChengZiZhen,360421103,10599,1398,7410,3772,14442,7166,3122,7294,14460,7709,15119
ۿڽ,GangKouJieZhen,360421104,19464,2005,13282,7037,26110,13223,5824,13764,26987,14011,27293
º,XinHeZhen,360421105,9602,1250,6882,3492,13482,6871,3175,7084,13955,7145,14027
ʨ,ShiZiZhen,360421106,14264,1629,10349,5333,19503,10286,4525,9793,20079,10069,20418
(Žÿ),YongAnXiang(JiuJiangJingJiKaiFaQu),360421200,14442,2149,10642,6637,20698,10598,5141,10920,21518,11090,21732
ӿȪ,YongQuanXiang,360421201,9819,1185,7321,3656,13493,7235,3559,6921,14156,7242,14563
,XinTangXiang,360421202,12462,1759,9391,4601,17336,9235,3917,8348,17583,8747,18138
,ChengMenXiang,360421203,15108,2075,11442,6384,21136,11393,4804,10166,21559,10545,21987
ɽ,MinShanXiang,360421204,18276,1733,12842,7372,24454,12691,5578,12468,25159,12745,25587
ɳӾü�,ShaHeJingJiJiShuKaiFaQu,360421403,22554,1558,14321,7718,23202,12782,5933,13737,26519,15724,30045
޿ֳ,XinZhouKenZhiChang,360421501,3458,392,2342,1290,4601,2335,835,2330,4665,2343,4685
Ǻˮֳ,SaiChengHuShuiChanYangZhiChang,360421502,140,39,89,63,203,88,36,91,179,126,215
ɽֳ,MinShanLinChang,360421503,90,44,89,68,149,89,32,77,166,77,166
Ǻֳ(Žÿ),SaiChengHuKenZhiChang(JiuJiangJingJiKaiFaQu),360421504,3448,360,2019,1509,3221,1962,716,2074,4036,2505,4524
,XinNingZhen,360423100,62826,6332,42935,26023,56683,41885,16304,41136,83021,42527,85462
Ȫ,QuanKouZhen,360423101,13395,1405,9236,4860,18482,9140,4587,10021,19161,10151,19387
³Ϫ,LuXiZhen,360423102,23471,2150,15991,7706,31436,15975,6985,16547,32522,16615,32606
̲,ChuanTanZhen,360423103,20148,2109,13428,7537,25963,13390,5364,14028,27418,14193,27621
Ϫ,LiXiZhen,360423104,16365,1690,10946,5565,21204,10889,4170,10968,21857,11279,22225
ƺ,LuoPingZhen,360423105,12252,1266,8107,3943,15531,8063,2884,8224,16287,8295,16402
ʯ¥,ShiMenLouZhen,360423106,14821,1814,9835,4986,19773,9832,3815,10613,20445,10615,20450
Ϫ,SongXiZhen,360423107,8430,974,5333,2899,10204,5219,1579,5340,10559,5650,10983
,DaDongXiang,360423200,4854,610,3460,1989,6473,3457,1571,3572,7029,3575,7035
·,HengLuXiang,360423201,11825,1508,8631,4918,16729,8622,4101,8787,17409,8803,17434
,GuanLianXiang,360423202,10607,1175,7137,3819,14381,7134,2880,7463,14597,7525,14662
,JinKouXiang,360423203,4587,634,3162,1776,6024,3142,1078,3024,6166,3137,6299
,DongLinXiang,360423204,5585,636,3770,2110,7506,3761,1542,3959,7720,3993,7763
,ShangTangXiang,360423205,3890,504,2520,1503,5157,2490,890,2718,5208,2764,5284
,FuTianXiang,360423206,8462,1093,5500,3291,11025,5480,1959,5920,11400,6014,11514
彭,QingJiangXiang,360423207,8220,1062,5539,3172,10808,5529,1941,5661,11190,5684,11223
ʯ,ShiDuXiang,360423208,9630,1080,6188,3376,12202,6068,2122,6393,12461,6644,12832
,YangZhouXiang,360423209,5178,705,3414,2028,6800,3351,1187,3496,6847,3656,7070
Ϫ,LuoXiXiang,360423210,8886,1364,5995,3579,12074,5883,2021,6044,11927,6276,12271
򸣾ü�ί,WanFuJingJiJiShuKaiFaQuGuanWeiHui,360423500,9309,578,5666,3707,5460,5041,1859,5299,10340,6080,11746
,YiNingZhen,360424100,80154,6772,55138,31410,65633,51947,23057,51271,103218,54845,109983
,BaiLingZhen,360424101,21603,2191,15043,7264,29231,14880,6919,15405,30285,15670,30713
ȫ,QuanFengZhen,360424102,18631,1936,12904,6357,25505,12681,5817,13125,25806,13480,26384
,GuShiZhen,360424103,23938,2667,17078,7884,33778,16524,8490,17040,33564,18017,35095
,DaQiaoZhen,360424104,22289,2685,16864,8182,31894,16703,8722,16510,33213,16832,33696
,ZhaJinZhen,360424105,29421,3497,22342,10530,38260,21318,10544,19958,41276,21120,43462
,MaAoZhen,360424106,21837,2870,16326,8212,31676,16131,7870,15871,32002,16251,32577
,HangKouZhen,360424107,10298,1400,8260,4003,15769,8147,4226,7364,15511,7664,15924
ۿ,GangKouZhen,360424108,14379,1329,9832,5294,18802,9736,4589,10097,19833,10465,20297
Ϫ,XiKouZhen,360424109,17679,2390,13488,6906,26344,13432,7098,13530,26962,13679,27167
,XiGangZhen,360424110,13937,1585,10275,5204,20626,10178,5614,10649,20827,10861,21136
ɽ,ShanKouZhen,360424111,10689,1731,7933,4485,15352,7796,3431,7699,15495,7918,15851
ɳ,HuangShaZhen,360424112,12646,1869,8877,4777,17709,8844,3704,9254,18098,9342,18219
Ƹ,HuangGangZhen,360424113,9757,1438,7274,3791,13756,7226,3479,7264,14490,7400,14674
,HeShiZhen,360424114,11759,1754,9210,4690,17982,9184,4985,9202,18386,9288,18498
Ϸ,ShangFengZhen,360424115,10111,1286,7222,3432,14127,7166,3264,7288,14454,7439,14661
Ķ,SiDouZhen,360424116,13911,1907,10423,5334,20095,10406,4869,10191,20597,10264,20687
̫,TaiYangShengZhen,360424117,19086,2273,14302,7619,26781,14251,6492,13367,27618,13549,27851
,NingZhouZhen,360424118,14553,1398,10060,4318,17150,8834,3914,8327,17161,9805,19865
·,LuKouXiang,360424200,9669,1047,7293,3346,13806,7282,3612,7001,14283,7035,14328
,HuangLongXiang,360424201,10778,1380,8459,4078,16007,8416,4432,8038,16454,8131,16590
,ShangShanXiang,360424202,8452,968,6458,3082,12059,6409,3035,5882,12291,5997,12455
,YuDuanXiang,360424203,2721,440,2064,985,3955,2054,978,2048,4102,2075,4139
ˮԴ,ShuiYuanXiang,360424204,7410,957,5812,2733,11092,5795,3075,5594,11389,5630,11442
ʯ,ShiAoXiang,360424205,9682,983,7475,3450,14117,7475,3778,6968,14443,6968,14443
,DongGangXiang,360424206,7764,939,5540,2810,11034,5514,2646,5697,11211,5809,11349
Ϻ,ShangHangXiang,360424207,10387,1407,8386,4141,15780,8356,4479,7840,16196,7887,16273
,XinWanXiang,360424209,6470,924,4960,2476,9659,4944,2451,4846,9790,4885,9845
,BuJiaXiang,360424210,5992,642,4234,2061,8280,4222,1860,4227,8449,4260,8494
,ManJiangXiang,360424211,5546,751,4151,2062,7916,4129,1787,3880,8009,3933,8084
Դ,FuYuanXiang,360424212,2806,374,2053,1066,3685,2026,863,1902,3928,1990,4043
ƺ,ZhuPingXiang,360424213,5635,709,4075,1917,7977,4075,1773,4042,8117,4042,8117
,ZhengCunXiang,360424214,8791,1325,6605,3404,12421,6581,2991,6417,12998,6502,13107
,MiaoLingXiang,360424215,6254,916,4457,2198,8679,4449,1796,4490,8939,4509,8966
,HuangAoXiang,360424216,10447,1387,7287,3538,14489,7259,3065,7545,14804,7612,14899
,DaChunXiang,360424217,11529,1223,8315,3985,16467,8296,3920,8301,16597,8357,16672
Ϳ,TuBuZhen,360425100,48045,4925,32586,20629,47501,30654,13315,31610,62264,33699,66285
,WuChengZhen,360425101,9515,1304,7523,4378,14587,7383,4205,7395,14778,7501,15024
Ϫ,SanXiQiaoZhen,360425102,9366,971,6202,3324,11723,6138,2595,6419,12557,6730,12932
,QiuJinZhen,360425103,12947,1473,8771,4828,16247,8691,3479,9001,17692,9128,17899
,AiChengZhen,360425104,12920,1314,9032,4338,17492,9014,4514,9546,18560,9716,18748
̲Ϫ,TanXiZhen,360425105,13178,1225,8690,4844,17875,8666,4116,9784,18450,9829,18519
,BaiChaZhen,360425106,9989,1252,6652,3919,13352,6632,2500,7031,13663,7089,13741
÷,MeiTangZhen,360425107,10292,1222,6944,3642,13778,6535,2828,6904,13439,7398,14342
෻,YanFangZhen,360425108,9011,1017,6159,3360,11906,6151,2452,6315,12466,6321,12480
,MaKouZhen,360425109,18899,1855,12632,6417,25390,12623,5762,13866,26489,13884,26516
,ZheLinZhen,360425110,6581,724,4324,2214,7385,4040,1556,4149,8189,4537,8861
򣨹࿪ſ,JiangYiZhenGongQingKaiFangKaiFaQu,360425180,7847,854,5517,2955,10239,5466,2623,5721,11187,5807,11324
,SanJiaoXiang,360425200,16470,1531,11249,5816,22591,11226,5388,12081,23307,12140,23389
ź,JiuHeXiang,360425201,14267,1630,9911,5155,20036,9739,4703,10353,20092,10689,20600
,LiXinXiang,360425202,16796,1672,11730,5329,23524,11591,6433,12937,24528,13171,24901
,JiangShangXiang,360425203,7464,1004,5028,2787,8964,4955,1894,5164,10119,5334,10362
ɽü�,JiangXiYongXiuYunShanJingJiJiShuKaiFaQu,360425404,2106,141,863,625,33,747,234,811,1558,1618,2481
ɽҵ,YunShanQiYeJiTuan,360425500,23810,3578,16323,9222,30333,15950,5984,16744,32694,17049,33372
ҵ,HengFengQiYeJiTuan,360425501,9510,1596,6420,4086,12349,6359,2242,6840,13199,6928,13348
˽ֳ,BaJiaoLingKenZhiChang,360425502,3322,458,2323,1182,4098,2306,888,2289,4595,2345,4668
ֳ,YongFengKenZhiChang,360425503,4459,458,3037,1549,5682,2721,1398,2882,5603,3278,6315
ɽֵ´(࿪ſ),ChaShanJieDaoBanShiChu(GongQingKaiFangKaiFaQu),360426084,38055,1345,22333,11405,28814,16800,7884,17988,34788,24951,47284
ͤ,PuTingZhen,360426100,38970,3600,26323,15465,40589,25411,10580,25935,51346,26827,53150
,NieQiaoZhen,360426101,5381,646,3781,2060,7106,3775,1667,3878,7653,3913,7694
,CheQiaoZhen,360426102,5925,781,4168,2613,8112,4155,1802,4284,8439,4340,8508
,FengLinZhen,360426103,8121,906,5663,2923,10449,5643,2478,5768,11411,5842,11505
¶(࿪ſ),GanLuZhen(GongQingKaiFangKaiFaQu),360426182,9490,665,5943,2891,9641,5502,2476,5869,11371,6688,12631
(࿪ſ),JinHuZhen(GongQingKaiFangKaiFaQu),360426183,5496,532,3949,1807,7155,3931,2047,4084,8015,4126,8075
,BaoTaXiang,360426200,6652,682,4421,2298,7786,4408,1816,4691,9099,4729,9150
Ӷ,HeDongXiang,360426201,8161,992,5636,3177,8697,5248,2193,5418,10666,5710,11346
,GaoTangXiang,360426202,3694,456,2640,1616,4925,2617,1326,2791,5408,2836,5476
Ȫ,LinQuanXiang,360426203,4320,586,3133,2056,5935,3110,1523,3231,6341,3296,6429
ɽ,WuShanXiang,360426204,8569,1272,5827,3410,10875,5797,2291,6132,11929,6305,12132
ĥϪ,MoXiXiang,360426205,6753,941,4689,2383,9213,4670,1964,4933,9603,4969,9658
,AiMinXiang,360426206,4456,485,2983,1542,6011,2923,1358,3236,6159,3316,6299
,ZouQiaoXiang,360426207,5837,679,4005,2059,7920,3995,1790,4262,8257,4301,8306
ɽ,TangShanXiang,360426208,1699,446,1514,1051,2823,1494,862,1454,2948,1493,3007
ɽֳ,PengShanLinChang,360426500,463,73,327,225,431,326,132,330,656,341,668
԰ճ,YuanYiChang,360426501,763,55,471,244,768,448,186,437,885,533,1004
Ͽ,NanKangZhen,360427100,32229,2650,21651,12649,38086,20853,9762,21639,42492,22990,44641
¹,BaiLuZhen,360427101,19455,1945,13108,6527,25460,13044,5761,13942,26986,14053,27161
Ȫ,WenQuanZhen,360427102,16480,1473,11236,5926,22324,11200,5447,12101,23301,12164,23400
ޤ,LiaoHuaZhen,360427103,14576,1699,10028,5119,19779,9865,4784,10668,20533,11031,21059
,HuaLinZhen,360427104,18690,1653,12920,6041,25177,12898,6740,14140,27038,14163,27083
,JiaoTangZhen,360427105,14004,1359,9853,4748,19644,9852,5268,10775,20627,10778,20631
,HengTangZhen,360427106,11862,1055,8274,4083,16604,8274,4526,9169,17443,9169,17443
ޤ,LiaoNanXiang,360427200,14359,1819,10572,5211,20940,10571,5712,11317,21888,11318,21890
ռҵ,SuJiaDangXiang,360427201,17022,1586,12014,5758,24228,11990,6533,13098,25088,13127,25141
Ȫ,ZeQuanXiang,360427202,9704,995,6985,3288,13553,6942,3832,7468,14410,7546,14531
ɳɽ�,ShaHuShanGuanLiChu,360427400,1235,144,890,538,1744,889,442,920,1809,931,1821
ɽֳ,DongGuShanLinChang,360427401,203,31,151,89,277,149,83,163,312,166,317
ũ,NongKeSuo,360427402,271,23,204,108,310,204,114,204,408,204,408
,DouChangZhen,360428100,71071,4486,48683,21448,90046,41030,27597,44026,85056,54471,103154
Ϫ,ZhouXiZhen,360428101,30172,2775,21639,10532,41835,21620,10902,22150,43770,22210,43849
,SanChaGangZhen,360428102,21871,1674,14780,6354,30290,13290,7345,14164,27454,16110,30890
й,ZhongGuanZhen,360428103,14750,1259,10536,4814,20947,10531,5592,11029,21560,11065,21601
ɳ,DaShaZhen,360428104,21307,1797,15414,6950,30146,15411,7822,15510,30921,15512,30926
,WanHuZhen,360428105,18031,1702,13216,5498,25984,13186,6874,13321,26507,13391,26607
Ϸ,NanFengZhen,360428106,12664,1113,8847,4153,17773,8847,4266,9193,18040,9196,18043
,TuTangZhen,360428107,31863,3346,22906,10973,45683,22887,12057,24304,47191,24360,47266
,DaGangZhen,360428108,16426,1508,10946,5454,22585,10893,4937,11793,22686,11925,22871
,CaiLingZhen,360428109,24082,2004,16537,7871,31865,15969,7974,16497,32466,17523,34060
첺,XuBuZhen,360428110,19960,1829,14363,7114,28480,14308,7957,15299,29607,15383,29746
,ZuoLiZhen,360428111,16747,1484,11578,5490,23202,11250,5584,11338,22588,12237,23815
ͺ,HeHeXiang,360428200,14715,1668,11737,5522,21703,11731,6138,10761,22492,10784,22521
,YangFengXiang,360428201,18300,1878,14374,6867,26793,14367,7180,12977,27344,12984,27358
Դ,XiYuanXiang,360428202,13629,1549,10816,5318,20274,10801,5391,9712,20513,9753,20569
ܼϪ,XiangXiXiang,360428203,14990,1377,11848,5353,21549,11836,5495,9970,21806,10014,21862
ʨɽ,ShiShanXiang,360428204,10323,1009,8186,4089,15594,8174,4610,7732,15906,7756,15942
ɽ,MingShanXiang,360428205,14345,1602,11356,5319,21084,11340,5667,10199,21539,10258,21614
,ChunQiaoXiang,360428206,10194,1153,7662,4095,14137,7651,3359,7031,14682,7044,14706
ɽ,SuShanXiang,360428207,13661,1354,10184,5039,18975,9994,5444,9762,19756,10275,20459
౦,DuoBaoXiang,360428208,11421,1103,8507,4275,16103,8445,4126,8019,16464,8143,16650
,WangDunXiang,360428209,28236,2776,21761,10082,40272,21443,11085,19930,41373,20336,42097
ɽ,BeiShanXiang,360428210,18568,1609,13646,6600,25865,13641,7266,13782,27423,13797,27443
,DaShuXiang,360428211,21050,1940,16064,7528,29432,16047,8417,15085,31132,15343,31407
ʡ⾭üʾ,JiangXiShengDuiWaiJingJiJiShuHeZuoCaiLingShiFanQu,360428400,109,3,59,2,24,2,0,2,4,53,112
ֳ,DouChangXianLiangZhongChang,360428500,536,61,430,208,771,429,205,370,799,372,802
˫,ShuangZhongZhen,360429100,61203,4250,38823,22984,59800,36688,16714,37819,74507,43344,82167
,LiuSiZhen,360429101,18605,2143,13055,7076,25553,12760,5689,12681,25441,13382,26437
Ӱ,MaYingZhen,360429102,17003,1595,11110,5831,22005,11085,4623,11909,22994,12111,23221
ɽ,WuShanTian,360429103,8887,1027,5847,2868,11640,5683,2152,5913,11596,6219,12066
ɽ,ChengShanZhen,360429104,15603,1623,10483,5397,21350,10394,4323,10898,21292,11066,21549
,DaLongXiang,360429200,8524,1126,6116,3192,12042,6103,2814,6309,12412,6348,12464
˴,HuangCunXiang,360429201,11271,1168,7745,4254,15007,7693,3466,8048,15741,8160,15905
,ZhangQingXiang,360429202,12594,1362,8629,4401,17230,8565,3715,8895,17460,9042,17671
,WenQiaoXiang,360429203,19725,2127,13002,6582,26011,12675,4923,12952,25627,13773,26775
,FuLongXiang,360429204,10329,1065,6923,3628,13706,6911,2662,7059,13970,7133,14056
˴,ShunDeXiang,360429205,9610,1146,7430,4008,13662,7390,3108,6382,13772,6434,13864
,LiuFangXiang,360429206,6274,692,4503,2287,8591,4481,1900,4331,8812,4363,8866
ϱˮ,NanBeiGangShuiChanChang,360429500,393,45,284,141,528,284,101,255,539,255,539
ɽֳ,WuShanKenZhiChang,360429501,140,20,106,82,177,106,57,111,217,111,217
,LongChengZhen,360430100,47821,4436,32400,18619,55031,29524,13479,29530,59054,33336,65736
޴,MianChuanZhen,360430101,26682,3245,17956,8722,35423,17949,5925,17851,35800,17896,35852
툛,MaDangZhen,360430102,24811,2504,17003,8004,33642,16950,6663,16843,33793,16975,33978
ܽض,FuRongDunZhen,360430103,23546,2340,16217,7455,29902,15415,6689,15335,30750,16358,32575
ɽ,DingShanZhen,360430104,10816,1161,7640,3805,14504,7310,3527,7505,14815,7864,15504
,TianHongZhen,360430105,11525,1039,7652,3624,15452,7519,3410,7973,15492,8322,15974
,YangZiZhen,360430106,20836,2361,14255,6951,28778,13982,6296,14822,28804,15238,29493
,DongShengZhen,360430107,10145,1105,6955,3424,13398,6816,2820,6864,13680,7115,14070
Ϫ,LangXiZhen,360430108,9206,999,6293,3260,12489,6213,2725,6465,12678,6637,12930
ƻ,HuangHuaZhen,360430109,12478,1205,8761,4251,16914,8671,4395,9195,17866,9317,18078
̫ƽ,TaiPingGuanXiang,360430200,14246,1414,10150,4738,19895,10112,4952,10385,20497,10462,20612
,HuangLingXiang,360430201,12125,1216,8346,3664,16528,8339,3575,8555,16894,8570,16916
ɽ,HaoShanXiang,360430202,9120,1039,6205,3114,12621,6172,2816,6716,12888,6770,12975
ϳ,JianZhuCaiLiaoChang,360430403,2073,285,1432,943,2659,1417,540,1425,2842,1466,2898
ˮֳ,XianShuiChanYangZhiChang,360430404,581,75,412,270,752,412,137,381,793,381,793
̫ũҵۺϿ,TaiBoHuNongYeZongHeKaiFaQu,360430500,3900,448,2719,1250,5228,2714,1155,2775,5489,2784,5503
ʮۺϿֳ,ShangShiLingZongHeKenZhiChang,360430501,2506,313,1767,878,3305,1756,704,1729,3485,1756,3523
ܽũ,FuRongNongChang,360430502,8222,916,5351,3564,10448,5344,1970,5722,11066,5757,11108
޿,MianKeSuo,360430503,681,122,519,313,1003,519,202,486,1005,486,1005
޻ԭֳ,MianHuaYuanZhongChang,360430504,1678,174,1154,603,2312,1143,504,1196,2339,1202,2356
̫ˮֳ,TaiBoHuShuiChanYangZhiChang,360430505,411,52,306,168,576,306,119,276,582,276,582
ֳ,HuangLeLinChang,360430506,502,42,324,153,672,324,144,364,688,364,688
Գǽֵ´,PenChengJieDaoBanShiChu,360481001,47658,3621,31385,17453,50558,28925,12694,29836,58761,32588,63973
ֵֽ´,GuiLinJieDaoBanShiChu,360481002,34681,3401,23305,13072,33794,23157,10124,24439,47596,24901,48206
ͷ,MaTouZhen,360481100,29649,3308,19949,11532,40427,19834,8997,21392,41226,22005,41954
,BaiYangZhen,360481101,11146,1545,7376,5017,14422,7248,2741,7498,14746,8056,15432
,NanYiZhen,360481102,14782,1417,9902,4984,19859,9683,3907,9878,19561,10204,20106
,HengGangZhen,360481103,17013,1997,11777,6143,22837,11719,4502,11606,23325,11735,23512
,FanZhen,360481104,22147,2498,14565,7398,29942,14329,5799,15430,29759,15879,30444
س,ZhaoChenZhen,360481105,9085,1014,6109,3108,12250,6033,2483,6314,12347,6473,12582
߷,GaoFengZhen,360481106,13347,1642,9204,4984,18416,9165,3973,9648,18813,9758,18962
,XiaFanZhen,360481107,12085,1246,8020,4193,15969,7959,3584,8616,16575,8895,16915
԰,LeYuanXiang,360481200,8481,986,6036,2954,12098,6006,2937,6283,12289,6368,12404
һ,HongYiXiang,360481201,11085,1075,7419,3704,15262,7382,3384,8018,15400,8125,15544
԰,HuaYuanXiang,360481202,12425,1224,8731,4228,17647,8692,4313,9153,17845,9231,17962
,HongXiaXiang,360481203,6999,971,5632,2809,10429,5608,2555,4841,10449,4893,10525
,WuJiaoXiang,360481204,8512,1157,6493,3313,11816,6461,2742,5762,12223,5918,12411
ɽ,HengLiShanXiang,360481205,5337,813,4113,2200,7611,4108,1760,3780,7888,3797,7910
ƽ,HuangJinXiang,360481206,6515,746,4547,2301,8398,4434,2057,4194,8628,4771,9318
,NanYangXiang,360481207,8846,1211,6373,3555,11740,6354,2791,6385,12739,6475,12848
ũ,SaiHuNongChang,360481500,17456,1061,11387,6304,8831,10953,5133,11665,22618,12263,23650
ɽֳ,QingShanLinChang,360481501,895,162,722,487,1326,721,301,624,1345,636,1358
дɽֳ,RuiChangShiDaDeShanLinChang,360481502,2033,245,1615,854,3013,1602,753,1408,3010,1416,3031
Ͻֵ´,ChengNanJieDaoBanShiChu,360502001,82829,5936,53888,36126,61635,53025,22161,55925,108950,57038,110926
Ǳֵ´,ChengBeiJieDaoBanShiChu,360502002,185265,12562,113799,71163,112458,102617,43692,108082,210699,127720,241519
Ԭӽֵ´,YuanHeJieDaoBanShiChu,360502003,13042,1600,8428,6124,12231,8358,2919,8561,16919,9133,17561
ˮ,ShuiBeiZhen,360502100,13997,3167,10034,7608,20498,10030,3682,10797,20827,10812,20846
´,XiaCunZhen,360502101,23636,4272,16388,10325,32761,14525,6635,15257,29782,18155,34543
ɽ,LiangShanZhen,360502102,11794,1488,7600,5804,13492,7536,3006,8337,15873,8688,16288
޷,LuoFangZhen,360502103,32692,5408,23355,16052,47098,23301,10213,24865,48166,24958,48313
Ҧ,YaoWeiZhen,360502104,6607,2192,5936,5272,11699,5921,3480,6230,12151,6343,12279
ɺ,ZhuShanZhen,360502105,21198,2728,14305,8762,28640,14201,5985,15489,29690,15606,29911
,HeXiaZhen,360502170,18698,1525,9979,4644,14514,7203,2942,7543,14746,13186,23165
۳,GuanChaoZhen,360502180,16630,2004,10948,6729,22459,10647,4577,11509,22156,12263,23211
ŷ,OuLiZhen,360502181,13457,1714,9015,5238,18675,8919,4076,9860,18779,10232,19247
ˮ,ShuiXiZhen,360502190,92137,8466,57027,30451,90305,46805,19904,51073,97878,63480,120507
ɽ,HuShanXiang,360502200,6098,1100,4356,3248,8908,4349,1903,4676,9025,4745,9101
˺,RenHeXiang,360502201,7271,1502,5441,4008,10836,5416,2447,5723,11139,5779,11220
ˮ,JieShuiXiang,360502202,6818,1173,4913,3589,9685,4904,2012,5061,9965,5090,10003
ϰ,NanAnXiang,360502203,5455,1014,3998,3266,7902,3974,1774,4166,8140,4245,8243
Ϫ,XinXiXiang,360502204,5389,1249,4365,3375,8546,4356,2401,4654,9010,4674,9039
ɽ,JiuLongShanXiang,360502271,5278,713,3569,2358,7100,3539,1443,3786,7325,3865,7434
¸ֵֽ´,XinGangJieDaoBanShiChu,360502400,45185,5456,28945,21412,51454,28370,9147,28987,57357,30843,59788
´,XianLaiBanShiChu,360502401,4844,320,3074,1855,4205,2577,1180,2678,5255,3270,6344
,FenYiZhen,360521100,91508,9206,60234,35269,98274,54348,24276,56572,110920,64756,124990
,YangQiaoZhen,360521101,24727,3592,16076,10950,30095,15874,6436,17345,33219,18679,34755
,HuZeZhen,360521102,12251,1616,7829,4967,15070,7698,3135,8433,16131,9173,17002
˫,ShuangLinZhen,360521103,15455,2219,10442,6231,20994,9971,4760,10851,20822,11992,22434
ɽ,QianShanZhen,360521104,17680,2344,11640,7182,23381,11390,4658,12291,23681,13042,24682
,YangJiangZhen,360521105,9804,1563,6522,4108,13707,6495,2642,7430,13925,7487,14009
,FengYangXiang,360521200,12994,1814,8564,5566,17221,8136,3628,8960,17096,9872,18436
,DongCunXiang,360521201,8005,1056,5279,3147,10922,5186,2314,5870,11056,6096,11375
,GaoLanXiang,360521202,10235,1426,6962,4332,14574,6935,3138,7796,14731,7837,14799
ٳ,CaoChangXiang,360521203,9274,1575,6474,4109,13376,6453,2829,7164,13617,7204,13678
ֳ,NianZhuLinChang,360521501,340,70,212,165,429,200,82,238,438,280,492
ɽֳ,ShanXiaLinChang,360521502,275,76,177,172,328,171,53,189,360,227,404
ֳ,ChangBuLinChang,360521504,366,110,298,237,578,292,145,306,598,323,621
´,FengHuangWanBanShiChu,360521505,1198,192,799,597,1685,793,319,903,1696,910,1709
ֵ߽´,JiangBianJieDaoBanShiChu,360602001,24858,2376,15761,10406,24562,15548,5807,15413,30961,17280,33041
ֵͨ´,JiaoTongJieDaoBanShiChu,360602002,28763,2905,18843,12087,25582,17904,6341,18090,35994,19166,38009
ֵ´,DongHuJieDaoBanShiChu,360602003,23687,2491,15575,10907,19803,15315,5441,15525,30840,16044,31619
÷԰ֵ´,MeiYuanJieDaoBanShiChu,360602004,22372,3316,15178,11010,21127,14794,5080,14423,29217,15590,30768
ֵ´,SiQingJieDaoBanShiChu,360602005,19768,1854,13364,7479,16997,11863,5186,12583,24446,13444,26808
¶ֵ´,BaiLuJieDaoBanShiChu,360602006,16019,1291,11044,6637,14573,9448,4928,10158,19606,11194,22238
ͯ,TongJiaZhen,360602100,14386,1375,9676,5286,18116,9306,4925,10527,19833,11010,20686
Ĳ,XiaBuXiang,360602200,7545,701,5255,2713,9546,5040,2814,5432,10472,5805,11060
˲,DengBuZhen,360622100,45108,4083,31204,15882,48111,29851,14623,30645,60496,32610,63814
,JinJiangZhen,360622101,32845,4196,23380,13045,46093,22499,12204,24975,47474,25865,49245
Ϫ,HuangXiZhen,360622102,24632,2537,16682,8302,34285,16534,8253,18320,34854,18740,35422
ͯ,ZhongTongZhen,360622103,22598,2593,14920,6658,30642,14507,6796,16342,30849,17067,31987
,MaQuanZhen,360622104,17997,1817,12543,5406,24816,12356,6343,13265,25621,13614,26157
,HuaQiaoZhen,360622105,10643,1295,7345,3635,14896,7231,3843,8190,15421,8436,15781
ƽ,PingDingXiang,360622200,18983,2124,12437,6220,25893,12212,5367,13529,25741,14037,26474
,ChunTaoXiang,360622201,21901,2363,14794,7530,30612,14697,7297,16516,31213,16767,31561
Ϫ,YangXiXiang,360622202,11883,1283,8175,4225,16720,7979,4136,8770,16749,9127,17302
,HongHuXiang,360622203,10969,1161,7240,3572,14138,6793,3387,7498,14291,8277,15517
ׯ,HuangZhuangXiang,360622204,8720,979,5841,2960,11904,5775,2689,6412,12187,6547,12388
཭عҵ԰,YuJiangXianGongYeYuanQu,360622408,1945,9,916,203,2,154,41,219,373,1079,1995
ӥ̶,YingTanShiLongGangXinQu,360622409,31,1,15,20,0,15,6,23,38,23,38
߹կӪֳ,GaoGongZhaiYingLinChang,360622501,1270,143,875,404,1816,866,439,953,1819,977,1852
վֳ,LiuJiaZhanKenZhiChang,360622502,8603,936,5692,3196,10682,5653,2317,6080,11733,6164,11856
˼Ҳˮԭֳ,DengJiaBuShuiDaoYuanZhongChang,360622503,3323,729,2509,1946,4109,2502,985,2493,4995,2528,5037
཭ˮ,YuJiangXianShuiChanChang,360622504,1326,118,897,455,1732,897,433,975,1872,980,1877
Դֳ,TangChaoYuanLinChang,360622505,513,58,371,192,691,371,175,375,746,375,746
Źũ,ZhangGongQiaoNongChang,360622506,360,67,297,194,499,293,153,275,568,283,580
ۺϿֳ,QingNianZongHeKenZhiChang,360622507,1330,89,1005,420,789,765,413,747,1512,827,1832
ũ,DaQiaoNongChang,360622508,670,96,489,261,751,487,249,505,992,526,1015
԰ֵ,HuaYuanJieDao,360681001,19462,2186,12356,8891,20653,11608,3845,11695,23303,13137,25493
ʯֵ,XiongShiJieDao,360681002,26052,2238,16326,9456,19574,14888,6065,15508,30396,18029,34355
Žֵ,DongMenJieDao,360681003,34767,3178,22619,14642,32849,22481,8950,23599,46080,24276,46895
,SiLiZhen,360681100,21439,2047,14411,7816,30477,14342,7653,16661,31003,16728,31139
̶,HeTanZhen,360681101,17446,1593,11253,5825,22817,11177,5989,12796,23973,13775,25028
ܷ,ZhouFangZhen,360681102,24519,2482,16263,8803,33881,16115,7795,18229,34344,18533,34796
,HongTangZhen,360681103,23278,2314,15525,7821,32610,15517,7703,17746,33263,17770,33295
־,ZhiGuangZhen,360681104,22639,2234,15399,7766,31705,15340,7799,17108,32448,17273,32672
,LiuKouZhen,360681105,13024,1257,8691,4371,17659,8672,4322,9860,18532,9912,18603
޺,LuoHeZhen,360681106,34362,3223,22735,11551,46558,22400,11065,25367,47767,25915,48650
,JinTunZhen,360681107,13378,1597,8965,5020,18130,8929,4198,10124,19053,10208,19173
,TangWanZhen,360681108,23177,2514,15106,8178,31653,14871,6938,17231,32102,17523,32629
ķ,WenFangZhen,360681109,16589,1994,11047,6183,22384,11025,4881,12379,23404,12417,23464
ˮ,LengShuiZhen,360681110,2904,295,1813,1093,3261,1781,712,1877,3658,2098,3911
ɽɽ羰ίᣩ,LongHuShanZhenLongHuShanFengJingLvYouQuGuanWeiHui,360681190,6446,633,4619,2571,8979,4569,2570,4935,9504,5030,9649
ɽ羰ίᣩ,ShangQingZhenLongHuShanFengJingLvYouQuGuanWeiHui,360681191,8015,1196,5875,3790,11506,5855,3007,6293,12148,6343,12218
,BinJiangXiang,360681200,25639,2620,17644,8901,35128,17531,9106,19490,37021,19721,37365
,BaiTianXiang,360681201,10590,1183,7114,3786,14943,7088,3747,8349,15437,8406,15520
Ϫ,LeiXiXiang,360681202,11020,1295,7587,4353,15225,7548,3801,8433,15981,8529,16116
,PengWanXiang,360681203,7592,798,4871,2629,10212,4827,2208,5662,10489,5727,10598
ƺ,ZhangPingSheZuXiang,360681204,2523,341,1705,935,3425,1702,687,1832,3534,1846,3551
,ErKouXiang,360681205,6463,704,4322,2384,8952,4269,1997,4793,9062,4842,9164
,YuJiaXiang,360681206,16530,1403,10924,5529,22794,10812,5697,12489,23301,12706,23630
Ϫйҵ԰,GuiXiShiGongYeYuanQu,360681407,728,8,221,85,1,102,43,121,223,558,779
԰ճ,TaQiaoYuanYiChang,360681500,2288,211,1463,908,2058,1441,525,1539,2980,1561,3024
̶ֳ,HeTanBuKenZhiChang,360681501,1263,138,814,395,1542,706,332,753,1459,919,1733
Ҥֳ,XiYaoLinChang,360681502,147,37,47,38,184,44,17,57,101,154,201
˫ֳ,ShuangZhenLinChang,360681503,345,44,143,171,336,136,29,227,363,275,418
ֳ,ErKouLinChang,360681504,351,52,199,181,404,193,65,246,439,269,468
ˮֳ,LengShuiLinChang,360681505,1251,202,737,474,1555,725,227,852,1577,943,1680
ֳ,SanXianLingLinChang,360681506,1386,177,931,560,1842,922,366,966,1888,998,1929
ֳɽ羰ίᣩ,ShangQingLinChangLongHuShanFengJingLvYouQuGuanWeiHui,360681592,233,28,137,115,251,134,44,155,289,168,305
Žֵ´,JieFangJieDaoBanShiChu,360702001,46649,6533,29926,18981,44141,29145,8173,27369,56514,31429,61355
ӽֵ´,GanJiangJieDaoBanShiChu,360702002,55581,7987,38391,22639,60289,37865,11733,36304,74169,36910,75301
ֵ´,NanWaiJieDaoBanShiChu,360702003,74906,7720,45959,24714,68958,38188,11878,37332,75520,48545,94504
ֵ´,DongWaiJieDaoBanShiChu,360702004,59396,6594,38673,24831,56141,37784,12096,37496,75280,39413,78086
ƽֵ´ݾü�,HuangJinLingJieDaoBanShiChuGanZhouJingJiJiShuKaiFaQu,360702091,35830,2461,22764,11213,24606,18311,8067,18495,36806,23594,46358
ɳʯ,ShaShiZhen,360702100,26267,2692,18913,8381,30732,15832,7709,16582,32414,17755,36668
ˮ,ShuiDongZhen,360702101,22682,2723,14662,8375,25348,14448,5101,14526,28974,15844,30506
ˮ,ShuiNanZhen,360702102,48776,3294,29067,14890,39361,25212,10232,24630,49842,33235,62302
򣨸ݾü�,HuBianZhenGanZhouJingJiJiShuKaiFaQu,360702103,28935,2841,18772,9365,27505,16325,7147,16769,33094,20151,38923
ɳ,ShaHeZhen,360702104,24392,1865,16312,9532,20984,16085,7340,16792,32877,17285,33597
ˮ,ShuiXiZhen,360702105,20505,2617,14388,7692,25778,14064,6147,14202,28266,14881,29269
򣨸ݾü�,PanLongZhenGanZhouJingJiJiShuKaiFaQu,360702190,45200,2463,28493,8947,30390,16498,7372,16414,32912,26542,55035
ɳӹҵ԰,ShaHeGongYeYuan,360702401,746,2,512,36,27,30,1,35,65,237,749
÷,MeiLinZhen,360721100,65450,4384,44668,23656,68089,39400,23877,41517,80917,49043,93711
ĸ,WangMuDuZhen,360721101,23566,3134,18128,8849,34933,17779,10241,18259,36038,18813,36941
ɳ,ShaDiZhen,360721102,23955,3370,17664,9257,34603,17307,8636,17638,34945,18297,35961
,JiangKouZhen,360721103,23676,2951,18208,8492,34765,16904,10555,16878,33782,18974,37182
,TianCunZhen,360721104,24857,3704,19635,9888,38015,19090,11536,19219,38309,20462,40097
,NanTangZhen,360721105,25360,3243,19261,8846,38173,18407,11182,18993,37400,20524,39785
é,MaoDianZhen,360721106,17717,2158,12899,7218,23740,12762,6542,13165,25927,13518,26417
,JiBuZhen,360721107,17511,2626,13800,7138,24781,12491,7620,12629,25120,13957,27757
,WuYunZhen,360721108,14550,1922,10190,5441,19840,10100,4243,10372,20472,10525,20715
,HuJiangXiang,360721109,25167,3642,18929,10278,37298,18359,10145,18889,37248,20025,38954
,HanFangXiang,360721200,21907,2850,15560,7772,32027,15049,8442,16345,31394,17639,33199
,YangBuXiang,360721201,13987,1583,9740,4471,19417,9704,4735,10475,20179,10565,20305
,DaBuXiang,360721202,11678,1470,8428,4388,16241,8183,4273,8372,16555,8993,17421
,ChangLuoXiang,360721203,7143,843,5106,2649,10390,5074,2664,5460,10534,5544,10650
,DaTianXiang,360721204,8052,1075,6012,3318,11578,5789,3260,5924,11713,6375,12387
̶,ChuTanXiang,360721206,12506,1572,8690,4782,16861,8612,3775,8959,17571,9163,17853
ʯܾ,ShiYuanXiang,360721207,8179,1132,6533,3145,12252,6475,3748,6417,12892,6526,13059
Ϫ,SanXiXiang,360721208,6494,969,5215,2516,10269,5065,3325,5321,10386,5573,10788
,BaiLuXiang,360721209,6812,1142,6054,3250,11547,5959,4251,5962,11921,6151,12205
ؾÿ,GanXianJingJiKaiFaQu,360721400,1426,33,923,188,183,219,118,235,454,654,1577
ζ,JiaDingZhen,360722100,117438,10196,80842,42158,123386,74275,34782,74812,149087,81574,162416
,DaTangBuZhen,360722101,37931,4181,27622,14093,54454,27441,14104,28358,55799,28594,56216
,GuBeiZhen,360722102,22397,2633,15847,7701,31292,15311,7305,15622,30933,16488,32335
,DaQiaoZhen,360722103,13874,1752,9723,4921,19659,9101,4676,9321,18422,10579,20302
,XinTianZhen,360722104,15302,1746,11181,5723,21843,11099,5704,11367,22466,11571,22752
,AnXiZhen,360722105,26225,3279,18527,9875,37651,18120,8934,19110,37230,19911,38438
С,XiaoJiangZhen,360722106,23046,2467,16550,8200,31972,16181,8172,16337,32518,17135,33685
ʯ,TieShiKouZhen,360722107,27906,2668,19453,9483,38005,18194,9854,18875,37069,20975,40428
,DaAZhen,360722108,27433,3111,19962,9523,38726,19505,9689,19754,39259,20271,40233
ɽ,YouShanZhen,360722109,11516,1401,7944,4154,15968,7879,3582,8404,16283,8555,16499
С,XiaoHeZhen,360722110,22436,2773,17732,9044,32534,17521,8417,15559,33080,15894,33626
ţ,XiNiuZhen,360722111,42713,4395,29896,13704,49963,25847,10918,24917,50764,28130,58026
ƽ,ZhengPingZhen,360722112,36442,3965,25519,12696,51124,25141,12262,26310,51451,27150,52669
ɽ,HuShanXiang,360722200,10448,1261,7527,3913,14917,7435,3357,7415,14850,7539,15066
,ChongXianXiang,360722201,14382,1411,10011,5001,20296,9965,4803,10420,20385,10585,20596
¡,WanLongXiang,360722202,13734,1672,10472,5484,20364,10301,5354,9861,20162,10288,20760
ϰ,NanAnZhen,360723100,66532,7516,45051,24878,74409,42406,18014,41475,83881,47011,92062
³,XinChengZhen,360723101,37308,4566,27602,14505,53867,27162,13896,27390,54552,28168,55770
,ZhangDouZhen,360723102,8247,1461,5304,3018,11508,4680,2357,4955,9635,6761,12065
ؽ,ChiJiangZhen,360723103,28943,3638,21437,11394,42096,20860,10915,21271,42131,22059,43496
,QingLongZhen,360723104,17318,2348,12763,6710,24556,12652,6258,12879,25531,13161,25924
,ZuoBaZhen,360723105,5677,656,3417,2241,6498,3379,1146,3599,6978,4062,7479
,HuangLongZhen,360723106,11640,1440,8242,4820,15155,8027,3685,7894,15921,8523,16765
,JiCunZhen,360723107,10271,1316,7329,4008,14196,7241,3263,7296,14537,7521,14850
,FuJiangXiang,360723200,7061,710,4238,2336,7191,3967,1572,4019,7986,5105,9343
Ӷ,HeDongXiang,360723201,2322,346,1613,994,3161,1567,709,1637,3204,1764,3377
,NeiLiangXiang,360723202,4478,588,3308,1753,6374,3268,1619,3282,6550,3377,6685
͹ҵ԰,XinShiJiGongYeYuan,360723400,1552,1,1056,124,0,83,9,94,177,506,1562
ɽ,DongShanZhen,360724100,55827,6210,40101,22149,62709,38919,18897,39396,78315,40833,80934
ˮ,DouShuiZhen,360724101,3609,439,2400,1391,4443,2198,927,2303,4501,2575,4975
Ϫ,SheXiZhen,360724102,16999,2858,13049,7027,25962,13027,6866,13599,26626,13674,26723
Ӫǰ,YingQianZhen,360724103,14511,2597,11311,6592,20113,11091,5897,11225,22316,11694,23005
Ʋ,HuangBuZhen,360724104,9444,1398,6985,3674,13877,6943,3382,7194,14137,7239,14224
÷ˮ,MeiShuiXiang,360724200,9275,1374,6549,3561,13350,6481,2982,6883,13364,7082,13631
ʯ,YouShiXiang,360724201,10777,1779,8119,4349,16045,7976,4058,8256,16232,8495,16614
,AnHeXiang,360724202,5155,950,3877,2229,7973,3871,1941,4143,8014,4169,8046
,SiXiaXiang,360724203,9118,1483,6447,3989,13020,6373,2871,6883,13256,7025,13472
˫Ϫ,ShuangXiXiang,360724204,4906,1171,4000,2748,7959,3993,2048,4089,8082,4125,8125
ˮ,ShuiYanXiang,360724205,12353,2097,9387,4887,19049,9312,4864,9777,19089,9927,19314
ƽ,PingFuXiang,360724206,5587,1006,4127,2152,8294,4067,1965,4301,8368,4431,8558
ָ,WuZhiFengXiang,360724207,5053,663,3479,1999,6896,3411,1491,3560,6971,3728,7207
,ZiYangXiang,360724208,8634,1189,5728,3039,12097,5695,2517,6519,12214,6612,12340
ػƲҵ,ShangYouXianHuangBuGongYeQu,360724400,295,1,84,2,0,2,0,1,3,212,296
ˮ,HengShuiZhen,360725100,40039,3864,27853,16713,39769,26742,12427,26859,53601,28477,56330
ü,YangMeiZhen,360725101,10485,1465,7500,3954,14267,7423,3296,7535,14958,7746,15246
,GuoBuZhen,360725102,8849,1115,6130,3153,11595,5973,2618,6119,12092,6452,12582
Ǧ,QianChangZhen,360725103,7422,875,4984,2792,9404,4777,1902,4879,9656,5215,10199
,ChangLongZhen,360725104,7436,946,4978,2734,9105,4767,2209,4902,9669,5613,10591
,GuanTianZhen,360725105,5941,806,4128,2194,7716,4028,1673,3999,8027,4292,8420
,LongGouXiang,360725200,8623,1285,6426,3516,12190,6409,3206,6647,13056,6688,13114
ܰ,JieBaXiang,360725201,3723,621,2668,1490,5054,2650,1103,2692,5342,2779,5447
,JinKengXiang,360725202,4236,672,3124,1715,6043,3081,1362,3061,6142,3146,6270
˼˳,SiShunXiang,360725203,6214,1146,4502,2651,8775,4442,1718,4445,8887,4576,9078
̶,LinTanXiang,360725204,3987,628,3005,1597,5553,2963,1413,2905,5868,3023,6028
ϱ,ShangBaoXiang,360725205,6944,837,4821,2517,9480,4791,2047,4948,9739,5007,9828
,NieDouXiang,360725206,5100,662,3749,1978,7147,3702,1711,3648,7350,3724,7473
Ӣ,WenYingXiang,360725207,4135,480,2872,1701,5542,2807,1301,2931,5738,3044,5916
ֶ,LeDongXiang,360725208,1701,225,1208,708,2348,1202,579,1289,2491,1297,2505
,FengZhouXiang,360725209,5597,690,3875,2104,7127,3768,1671,3726,7494,4083,7958
̨ɽֳ,TianTaiShanLinChang,360725500,198,17,109,67,229,107,34,112,219,140,249
ɽ,XinShanZhen,360726100,66624,5426,44097,21047,79992,42091,19951,45204,87295,47904,92001
,KongTianZhen,360726101,17579,2017,12930,6481,24927,12813,6823,13294,26107,13489,26419
ʯ,BanShiZhen,360726102,17304,1852,12489,5820,22398,11929,6601,12260,24189,13268,25757
,TianXinZhen,360726103,20053,2312,15603,6473,30331,15560,9486,16166,31726,16248,31851
,LongBuZhen,360726104,14616,1609,10886,4601,21081,10848,5950,11211,22059,11289,22175
,HeZiZhen,360726105,9007,1019,6252,2946,12700,6209,3040,6732,12941,6814,13066
ɽ,SanBaiShanZhen,360726106,9614,1108,7046,3382,13761,6893,3647,7023,13916,7323,14369
ͷ,CheTouZhen,360726107,11627,1456,8377,4015,16832,8071,4156,8327,16398,8862,17239
,ZhenGangXiang,360726200,9104,982,6447,3233,12757,6396,3191,6737,13133,6830,13277
ɽ,FengShanXiang,360726201,7136,826,5183,2523,10269,5140,2614,5250,10390,5393,10576
,XinLongXiang,360726202,7281,955,5121,2712,10384,5075,2474,5463,10538,5589,10710
̷,CaiFangXiang,360726203,3031,337,2100,924,3974,2083,1106,2122,4205,2374,4474
ʯ,ZhongShiXiang,360726204,7616,1002,6272,2874,11996,6247,3982,6254,12501,6328,12600
ɳ,ChangShaXiang,360726205,6394,939,5582,2532,10604,5572,3610,5328,10900,5361,10943
,FuChaXiang,360726206,9650,1062,7824,3176,15310,7815,4802,7678,15493,7690,15514
˫ܾ,ShuangYuanXiang,360726207,3746,498,2943,1490,5569,2940,1626,2916,5856,2927,5870
,TangCunXiang,360726208,4188,545,3453,1710,6488,3444,2200,3466,6910,3480,6933
ɽ,GaoYunShanXiang,360726209,4885,619,3374,1825,6788,3343,1453,3515,6858,3583,6957
ҵ԰,JiuLongGongYeYuan,360726400,8,0,5,5,5,5,1,4,9,4,9
,LongNanZhen,360727100,87282,7784,59699,30991,78473,55464,22420,54117,109581,57787,117486
䵱,WuDangZhen,360727101,7269,1038,5598,2833,10044,5511,2791,5268,10779,5500,11098
,YangCunZhen,360727102,24147,3161,19572,9313,33609,19379,11230,18432,37811,18966,38538
,WenLongZhen,360727103,10927,1249,7520,4211,14356,7451,3042,7464,14915,7698,15218
,ChengLongZhen,360727104,5509,789,3851,2051,7391,3847,1459,3882,7729,3906,7757
,GuanXiZhen,360727105,3664,515,2567,1412,4916,2522,1014,2520,5042,2626,5193
,LiRenZhen,360727106,14164,1637,9900,5297,16931,9528,3902,9418,18946,9803,19703
ɽ,DuJiangZhen,360727107,13141,1802,9223,5082,17703,9196,3380,9015,18211,9100,18323
ҽ,TaoJiangXiang,360727200,11858,1513,8099,4477,14426,8050,2723,7888,15938,7995,16094
,DongJiangXiang,360727201,7387,892,4943,2383,9045,4841,1744,4831,9672,5080,10023
,LinTangXiang,360727202,8883,1195,6437,3457,11776,6363,2451,5937,12300,6092,12529
Ϻ,NanHengXiang,360727203,7065,1119,5544,2830,9810,5493,2372,4886,10379,5012,10556
к,JiaHuXiang,360727204,6021,1003,4604,2793,8548,4576,2182,4512,9088,4602,9206
,JinTangKaiFaQu,360727400,4196,8,2850,149,68,155,38,169,324,1392,4242
ɽֳ,AnJiShanLinChang,360727500,239,32,133,126,238,126,36,132,258,174,307
ɽֳ,JiuLianShanLinChang,360727501,2616,417,2000,1289,3622,1994,995,2012,4006,2028,4028
,LiShiZhen,360728100,67012,6592,47627,25001,62035,46404,21430,45894,92298,47407,95034
ɽ,KuiMeiShanZhen,360728101,5886,1033,4136,2781,8066,4078,1578,4203,8281,4361,8497
ϳ,LaoChengZhen,360728102,7121,1100,5085,2756,9381,4897,2024,4755,9652,5160,10245
,TianJiuZhen,360728103,9702,1938,7151,4024,13551,6773,3111,6717,13490,7600,14751
,LongTangZhen,360728104,7063,1115,5330,3090,10072,5259,2489,5135,10394,5337,10667
뱱,LingBeiZhen,360728105,9713,1619,6828,4243,12964,6650,2624,6646,13296,7128,13956
칫,EGongZhen,360728106,10856,2276,9133,5620,17415,9041,5155,8990,18031,9154,18287
عҵ԰,DingNanXianGongYeYuan,360728400,1317,2,758,20,9,26,15,29,55,576,1334
,ChengXiangZhen,360729100,40495,3715,28474,15792,44121,27697,13704,28479,56176,29440,57914
ɽ,DaJiShanZhen,360729101,8946,1208,6292,3044,11853,6229,2613,6281,12510,6475,12767
ͷ,BeiTouZhen,360729102,13691,2028,9767,5209,18342,9573,4044,9563,19136,9996,19763
,JinLongZhen,360729103,15285,2270,11495,6156,19543,11438,5230,11169,22607,11290,22785
,NanJingZhen,360729104,12995,1614,8890,4129,17048,8539,3929,8823,17362,9648,18538
Դ,LongYuanBaZhen,360729105,9180,1076,6240,3163,12131,6176,2548,6360,12536,6564,12804
կ,ZhongZhaiXiang,360729200,8627,1136,6049,3075,12155,5989,2541,6114,12103,6255,12304
,SheJingXiang,360729201,6901,914,4892,2457,9724,4780,2280,4895,9675,5203,10095
,LongXiaXiang,360729202,3612,517,2553,1526,4778,2533,997,2467,5000,2573,5126
ɽίԱ,DaJiShanKuangSheQuGuanLiWeiYuanHui,360729400,3957,1193,3135,2576,5641,3133,1057,3053,6186,3072,6207
ȫعҵ԰,QuanNanXianGongYeYuan,360729402,2376,7,1807,29,51,45,5,29,74,581,2388
÷,MeiJiangZhen,360730100,123680,9122,82419,43659,127810,77708,38158,83894,161602,88541,170960
,QingTangZhen,360730101,22865,2405,16754,8313,31823,16529,9084,17203,33732,17600,34354
ʤ,ChangShengZhen,360730102,37736,3916,26014,13378,51851,25872,12855,28191,54063,28493,54507
,HuangBeiZhen,360730103,25918,2979,17808,9605,35113,17247,8814,19102,36349,19903,37711
̴,GuCunZhen,360730104,26990,3125,18003,9561,36295,17905,8312,20147,38052,20424,38427
,LaiCunZhen,360730105,33297,3021,25161,10939,46915,25005,14939,25694,50699,26096,51257
ʯ,ShiShangZhen,360730106,19460,2470,13371,8023,27348,13245,6420,14697,27942,14979,28350
ɽ,DongShanBaZhen,360730107,17013,1798,11266,6144,22723,11178,5357,12575,23753,12902,24168
,LuoKouZhen,360730108,21024,2463,14403,8278,29082,14249,6907,15721,29970,15991,30394
С,XiaoBuZhen,360730109,10361,1292,7052,3870,13745,6966,3367,7737,14703,7968,15020
ʯ,HuangShiZhen,360730110,22030,2817,16946,8528,34243,16878,10851,18561,35439,18752,35698
ͷ,TianTouZhen,360730111,25598,2856,18278,9069,37078,18185,10255,20230,38415,20431,38709
,ZhuZeXiang,360730200,18737,2361,13145,7419,26226,12862,6846,14211,27073,14799,27944
Է,DuiFangXiang,360730201,18290,1995,13043,6391,26626,12962,7598,14704,27666,14840,27883
̺,GuHouXiang,360730202,15055,1800,10548,5737,20492,10397,5125,11160,21557,11432,21980
ﲺ,TianBuXiang,360730203,16809,1863,11947,5829,23502,11870,6040,12601,24471,12765,24712
ͬ,HuiTongXiang,360730204,20603,2429,13706,7584,27135,13553,6165,15222,28775,15491,29197
տ,ZhanTianXiang,360730205,11927,1361,8151,4565,16303,8092,3778,8812,16904,8915,17066
,AnFuXiang,360730206,7504,914,4646,2909,9174,4526,1912,5043,9569,5684,10330
,DongShaoXiang,360730207,14682,1520,9565,4846,19087,9482,3993,10335,19817,10630,20195
Ф,XiaoTianXiang,360730208,6851,644,4656,2470,9408,4595,2238,4941,9536,5077,9733
,DiaoFengXiang,360730209,7878,813,5379,2670,10712,5356,2709,5973,11329,6021,11400
,DaGuXiang,360730210,10553,1455,7425,4007,14644,7323,3483,7877,15200,8066,15491
̽,CaiJiangXiang,360730211,9883,1175,6904,3425,13465,6858,3420,7457,14315,7574,14478
عҵ԰,NingDouXianGongYeYuan,360730400,4816,15,3314,13,141,23,11,21,44,1528,4842
,GongJiangZhen,360731100,145296,11275,104574,42612,165717,98100,63911,105479,203579,115908,220482
ɽ,TieShanLongZhen,360731101,9886,1459,7369,4723,14497,7204,4541,7597,14801,8517,15886
̹ɽ,PanGuShanZhen,360731102,11823,1552,9457,4640,17358,9402,5354,8926,18328,9272,18729
̷,HeFengZhen,360731103,26710,4285,23907,11857,44087,23716,14923,21631,45347,22011,45918
»ɽ,QiLuShanZhen,360731104,7049,900,5103,2560,9456,5031,2519,4910,9941,5365,10468
ɽ,ZiShanZhen,360731105,32618,4912,27675,13848,51633,27092,16327,25138,52230,26182,53857
,YinKengZhen,360731106,34170,4310,30268,12600,53478,29680,20446,27576,57256,28658,58926
뱳,LingBeiZhen,360731107,28797,4146,24849,11740,46229,24745,15466,23428,48173,23560,48409
,LuoAoZhen,360731108,21819,3943,19617,10808,37833,19435,12792,18651,38086,18937,38554
޽,LuoJiangXiang,360731200,14556,2509,14820,7295,25913,14638,10714,12676,27314,12959,27779
СϪ,XiaoXiXiang,360731201,11664,2127,10840,5541,19708,10802,7249,10123,20925,10200,21040
,LiCunXiang,360731202,14359,2442,12683,6715,22849,12427,7271,10920,23347,11389,24072
,XinBeiXiang,360731203,10305,1714,9662,4828,17348,9560,6431,8634,18194,8788,18450
ʯ,JingShiXiang,360731204,12156,1783,11271,5369,21226,10985,8145,10293,21278,10813,22084
,HuangLinXiang,360731205,15478,2337,14162,6690,25052,13964,8942,12275,26239,12595,26757
ɳ,ShaXinXiang,360731206,3812,634,3544,1698,6418,3480,2391,3187,6667,3293,6837
,KuanTianXiang,360731207,16968,2623,15873,7345,29225,15666,10774,14099,29765,14492,30365
,GeAoXiang,360731208,23939,3461,23897,10079,42994,23640,18205,21294,44934,21708,45605
ͷ,QiaoTouXiang,360731209,6977,1067,6252,3358,11821,6179,4222,5799,11978,6014,12266
�,MaAnXiang,360731210,8742,1626,8557,4230,15362,8502,5594,7246,15748,7405,15962
,XianXiaXiang,360731211,23194,3575,22285,10425,40790,21987,15503,19588,41575,19987,42272
Ϫ,CheXiXiang,360731212,13149,2234,12315,6458,22740,12200,8214,11058,23258,11282,23597
,DuanWuXiang,360731213,9862,1582,9532,4552,17109,9432,6466,8181,17613,8378,17910
ڶҵ԰,YuDouGongYeYuan,360731400,7185,2,4883,1,59,1,45,2,3,2349,7232
,LianJiangZhen,360732100,88127,6988,57033,30047,99347,46509,28080,50597,97106,66162,123195
,JiangBeiZhen,360732101,16458,2248,12850,6288,25066,12841,7324,13160,26001,13180,26030
,GuLongGangZhen,360732102,21480,3128,16796,8044,32394,16692,9965,17560,34252,17777,34573
÷,MeiJiaoZhen,360732103,14172,1586,10783,4959,21543,10683,6802,11620,22303,11777,22560
,GaoXingZhen,360732104,37131,4271,26220,12793,52357,25799,12598,27310,53109,27780,54000
,LiangCunZhen,360732105,9922,2039,8793,5318,16369,8747,5795,8837,17584,8963,17756
,LongKouZhen,360732106,14501,1724,10513,5043,21104,10474,5770,11399,21873,11482,21995
˽,XingJiangXiang,360732200,16865,2366,12126,6349,23986,11618,6353,12569,24187,13458,25584
ľ,ZhangMuXiang,360732201,8925,1080,6645,2974,13224,6603,3770,7074,13677,7130,13775
,DongCunXiang,360732202,10786,1516,8461,3747,16987,8446,5088,8904,17350,8929,17390
,XingLianXiang,360732203,10176,1448,8227,4080,16799,8167,5275,8562,16729,8672,16899
ܴ,JieCunXiang,360732204,11437,1650,9189,4462,18057,9186,5423,9315,18501,9321,18510
縻,SheFuXiang,360732205,23237,2982,17989,8475,35851,17818,10443,18380,36198,18673,36662
ͷ,BuTouXiang,360732206,23903,2801,17398,8616,33794,17276,8722,17584,34860,18028,35426
,YongFengXiang,360732207,20842,2411,16071,7325,31373,15972,9731,16779,32751,16913,32984
¡ƺ,LongPingXiang,360732208,5886,935,5129,2758,9682,5129,3467,5131,10260,5159,10288
,JunCunXiang,360732209,22854,3464,18967,8858,36203,18805,12162,19294,38099,19513,38480
԰,ChaYuanXiang,360732210,10966,1710,8838,4086,17190,8790,5247,8996,17786,9085,17923
,ChongXianXiang,360732211,14706,2104,11004,5433,21682,10913,5806,11438,22351,11612,22616
,FengBianXiang,360732212,8373,1350,6079,3021,12622,6039,3219,6753,12792,6863,12942
Ͽ,NanKengXiang,360732213,6194,1056,4506,2473,9337,4494,2444,5172,9666,5188,9694
Ǹ,ChengGangXiang,360732214,13804,2358,11398,6098,21131,11384,6926,11658,23042,11690,23088
̫,FangTaiXiang,360732215,10469,1376,7420,3601,14751,7374,3535,7839,15213,7960,15380
,DingLongXiang,360732216,14895,2206,11644,5775,22645,11585,7105,12387,23972,12562,24206
,ChangGangXiang,360732217,26190,3345,18918,9878,34023,18834,9138,19636,38470,19755,38673
˹عҵ԰,XingGuoXianGongYeYuan,360732400,9150,12,5367,42,187,53,39,49,102,3834,9201
,WenWuBaZhen,360733100,65841,5934,45496,21718,78349,42777,24291,45253,88030,50570,96066
,JunMenLingZhen,360733101,27879,2953,19715,9114,38659,19267,10893,20338,39605,22010,41725
,XiJiangZhen,360733102,34616,3872,26479,11388,52591,26337,15212,26944,53281,27221,53700
,ZhouTianZhen,360733103,32631,3912,25365,11420,50209,24984,15215,25650,50634,26393,51758
,MaZhouZhen,360733104,16948,1839,13422,6448,25441,13350,8562,13743,27093,13927,27349
ׯ,ZhuangKouZhen,360733105,15714,1899,12998,5406,24948,12835,8261,12528,25363,12876,25874
Ϫ,QingXiXiang,360733200,2722,238,1730,732,3080,1538,814,1625,3163,2044,3774
ˮ,YouShuiXiang,360733201,8577,1165,6760,3090,13524,6691,4067,6876,13567,7049,13809
,GaoPaiXiang,360733202,7554,894,5960,2711,11403,5920,3559,5947,11867,6047,12007
,XiaoLongXiang,360733203,8200,906,6464,2722,12554,6412,3867,6390,12802,6509,12973
,ZhuLanXiang,360733204,9305,1199,7289,3375,14135,7160,4464,7398,14558,7679,14968
ͷ,DongTouXiang,360733205,5253,616,3715,1664,7609,3666,1976,3982,7648,4130,7845
д,ZhongCunXiang,360733206,4286,583,3360,1866,6624,3343,1980,3438,6781,3489,6849
վ,ZhanTangXiang,360733207,9614,1100,7424,2963,14460,7251,4459,7284,14535,7749,15173
¡,YongLongXiang,360733208,4223,565,3150,1411,6314,3120,1749,3206,6326,3387,6537
,FuChengXiang,360733209,7681,967,5518,2629,11522,5459,3004,5963,11422,6134,11652
С,XiaoMiXiang,360733210,11057,1159,8678,3764,16944,8502,5435,8587,17089,8973,17651
ׯ,ZhuangBuXiang,360733211,4858,750,4389,1921,7932,4342,2915,4011,8353,4134,8523
׶,BaiEXiang,360733212,9484,1405,8698,3762,16221,8437,5772,7439,15876,7963,16661
ѹҵ԰,HuiChangXianYanZiWoGongYeYuan,360733400,226,3,114,11,4,36,14,25,61,129,243
,ChangNingZhen,360734100,50062,4142,32923,17468,52520,30338,14605,32261,62599,35886,68809
,ChenGuangZhen,360734101,11802,2041,8981,5179,17363,8864,4534,9048,17912,9396,18377
,LiuCheZhen,360734102,19837,2588,13884,6323,27357,13709,5695,13715,27424,14236,28120
,NanQiaoZhen,360734103,19516,2400,14033,6890,27117,13844,6345,13794,27638,14228,28261
̶,JiTanZhen,360734104,13668,1833,9645,5368,19365,9629,4330,10130,19759,10186,19831
ν,ChengJiangZhen,360734105,20157,2041,13885,6618,28190,13663,6882,14578,28241,15195,29080
ñ,GuiZhuMaoZhen,360734106,6451,895,4579,2487,8821,4449,2068,4578,9027,4835,9414
ķ,WenFengXiang,360734200,18375,1868,12086,6187,22032,11291,5046,11946,23237,13203,25289
,SanBiaoXiang,360734201,8572,1046,5978,2809,11996,5947,2623,6205,12152,6263,12241
,ChangPuXiang,360734202,5186,1055,4360,2672,8355,4287,2415,4144,8431,4296,8656
͢,LongTingXiang,360734203,2472,445,1971,1145,3700,1927,989,1861,3788,1935,3906
Ϫ,DanXiXiang,360734204,9160,1123,6469,2824,12537,6447,2688,6454,12901,6502,12971
ɽ,XiangShanXiang,360734205,3601,687,2445,1543,4962,2394,937,2605,4999,2780,5225
ˮԴ,ShuiYuanXiang,360734206,6056,862,4599,2645,9228,4588,2605,4898,9486,4924,9523
ɺ,LuoShanXiang,360734207,5888,742,4144,2045,8154,4058,1874,4169,8227,4360,8504
ٽ,QinJiangZhen,360735100,61506,6377,42708,23074,75690,41322,20085,43119,84441,45260,87968
С,XiaoSongZhen,360735101,19525,2494,13475,7114,27214,13414,5830,14308,27722,14374,27849
ɽ,PingShanZhen,360735102,20759,2506,14351,7694,29082,14277,6640,15474,29751,15554,29905
Ὥ,HengJiangZhen,360735103,28125,3377,18847,9625,39210,18765,8528,21073,39838,21183,40030
,GaoTianZhen,360735104,16306,1623,10943,5436,22030,10942,4675,11661,22603,11661,22604
ľ,MuLanXiang,360735200,7316,810,4976,2546,10136,4960,2209,5341,10301,5359,10335
ɽ,FengShanXiang,360735201,11791,1308,7971,4006,16181,7952,3402,8505,16457,8530,16501
,DaYouXiang,360735202,13262,1572,9532,4429,18991,9522,4642,9928,19450,9944,19476
,LongGangXiang,360735203,6569,876,4734,2509,9023,4675,2183,4825,9500,4894,9628
,ZhuKengXiang,360735204,9452,1169,6888,3442,13482,6874,3329,7025,13899,7062,13950
,XiangHuZhen,360781100,124460,9604,87489,39823,144148,80571,48998,86381,166952,95573,183062
,RuiLinZhen,360781101,20106,2494,16542,6970,32758,16354,11195,16866,33220,17253,33795
,RenTianZhen,360781102,30189,3779,21611,11718,42974,21490,9993,21912,43402,22350,43961
ű,JiuBaoZhen,360781103,32326,4578,25506,13184,49368,25399,14636,25687,51086,26034,51540
ɳް,ShaZhouBaZhen,360781104,17403,1978,12165,5252,19953,10797,5421,10562,21359,12637,24802
л,XieFangZhen,360781105,22654,2663,17262,8049,33009,17097,9703,17296,34393,17758,35020
,WuYangZhen,360781106,18723,2425,14489,6813,27875,14308,7840,13992,28300,14499,28988
Ҷƺ,YePingXiang,360781200,37713,4976,28180,13998,52823,27961,12708,26650,54611,27217,55397
,DingBeiXiang,360781201,5212,796,4775,2280,8636,4767,3444,4673,9440,4677,9452
ص,DaBaiDiXiang,360781202,6510,986,4999,2781,9315,4930,2220,4574,9504,4717,9716
,GangMianXiang,360781203,9548,1375,8172,3675,15345,8084,5256,7838,15922,8007,16179
ն,RiDongXiang,360781204,10078,1661,8097,4259,15635,7928,4313,7637,15565,7955,16052
,WanTianXiang,360781205,7173,1068,6352,2860,11387,6342,3898,5756,12098,5787,12139
ư,HuangBoXiang,360781206,22775,2771,16488,8274,31603,16233,7768,16297,32530,16826,33314
ʯɽ,YunShiShanXiang,360781207,25668,3259,19674,9823,35469,19584,10352,19425,39009,19605,39279
,ZeQinXiang,360781208,12590,1527,8483,4351,16647,8429,3489,9000,17429,9123,17606
Ӣ,BaYingXiang,360781209,4947,741,3754,2054,7384,3729,2152,4047,7776,4086,7840
йҵ԰,RuiJinShiGongYeYuan,360781400,735,4,441,48,0,45,4,53,98,302,743
ؽֵ´,RongJiangJieDaoBanShiChu,360782001,77016,7177,54017,26454,79312,43935,26841,44890,88825,57017,111034
ɽֵ´,DongShanJieDaoBanShiChu,360782002,64150,4807,42442,21888,47920,36632,21584,38236,74868,48099,90541
ƽ,TangJiangZhen,360782100,53422,7559,41316,21892,73922,40183,21177,39561,79744,40842,82158
,FengGangZhen,360782101,25276,3526,19351,9746,35492,18561,9616,18111,36672,19067,38418
̶򣨸ݾü�,TanKouZhenGanZhouJingJiJiShuKaiFaQu,360782102,29947,4048,22937,12889,40918,22677,11956,22601,45278,23014,45951
,LongLingZhen,360782103,22606,2857,16351,8478,29332,15784,7889,16043,31827,17001,33352
,LongHuiZhen,360782104,18126,2968,13733,8379,26369,13327,7151,13514,26841,14512,28245
,JingBaZhen,360782105,19474,2655,14005,7662,25336,13858,6655,13879,27737,14779,28784
,HengShiZhen,360782106,10683,2029,9035,5475,16577,8914,5238,8712,17626,8915,17950
̶򣨸ݾü�,TanDongZhenGanZhouJingJiJiShuKaiFaQu,360782192,22342,2651,17404,7884,26879,14868,8433,15128,29996,16022,33426
ʯ,FuShiXiang,360782200,11409,1858,8864,5161,16820,8685,4695,8712,17397,9098,17962
,ChiTuSheZuXiang,360782201,24307,3296,17462,8428,34478,17204,8093,17465,34669,18234,35696
կ,HengZhaiXiang,360782202,9889,1442,7301,3854,13350,7176,3652,7344,14520,7682,14983
췻,ZhuFangXiang,360782203,20517,2992,15784,8197,29434,15609,8161,15585,31194,15886,31670
̫,TaiWoXiang,360782204,11991,1639,9189,4760,17055,9161,4730,9080,18241,9171,18360
,SanJiangXiang,360782205,19350,3018,15070,8066,28857,14988,7850,14962,29950,15148,30218
,LongHuaXiang,360782206,26537,3701,20765,10242,39408,20512,11179,20114,40626,20652,41417
ʮ,ShiBaTangXiang,360782207,14281,2691,11864,6983,22481,11756,6583,11483,23239,11691,23555
˫,MaShuangXiang,360782208,10552,2440,9285,5390,17541,9152,5476,8875,18027,9183,18468
ƺ,DaPingXiang,360782209,8606,1941,7432,4843,14053,7363,4145,7140,14503,7260,14692
ƺ,PingShiXiang,360782210,9744,1671,7904,4586,15389,7827,4332,7701,15528,7843,15747
¡ľ,LongMuXiang,360782211,7932,1627,6920,4036,13177,6882,4363,6877,13759,7002,13922
Ͽйҵ԰,NanKangShiGongYeYuan,360782400,1080,3,496,11,70,12,4,9,21,591,1087
Ͻֵ´,GuNanJieDaoBanShiChu,360802001,27710,3843,18443,10187,33219,16467,6215,16491,32958,19325,37768
ֵ´,YongShuJieDaoBanShiChu,360802002,30153,3394,19878,11491,30582,16933,4548,17310,34243,18217,38095
ɽֵ´,WenShanJieDaoBanShiChu,360802003,23755,3378,16136,10402,26168,16051,4836,15732,31783,15833,31969
ϰϪŽֵ´,XiXiQiaoJieDaoBanShiChu,360802004,28776,3708,19055,12379,30858,18846,5777,18951,37797,19206,38261
Žֵ´,BeiMenJieDaoBanShiChu,360802005,51028,5767,32954,20348,54255,30697,10838,30801,61498,34679,67633
ֵ´,BaiTangJieDaoBanShiChu,360802006,10041,958,6794,4163,11745,6778,2868,7053,13831,7073,13867
,XingQiaoZhen,360802100,15042,1725,10542,5505,21219,10461,5037,11136,21597,11262,21804
ɽ,ZhangShanZhen,360802101,13768,1532,9617,4953,19340,9578,4663,10301,19879,10346,19963
,ChangTangZhen,360802102,22967,2433,15799,8655,32060,15744,7664,17148,32892,17265,33064
,QuLaiZhen,360802103,10837,1288,7552,3866,15384,7520,3636,8153,15673,8209,15761
̲,HeBuXiang,360802200,12241,1429,8441,4641,14904,8367,3711,8822,17189,8940,17381
ҵ԰С,JiZhouQuGongYeYuanXiaoQu,360802400,2379,10,1815,205,1,216,64,191,407,638,2453
,XuNiDiQu,360802500,391,44,219,207,334,212,69,262,474,285,504
Ӷֵ´,HeDongJieDaoBanShiChu,360803001,38600,2299,23395,10161,30192,16168,8024,17167,33335,25528,48923
�ֵ´,BinJiangJieDaoBanShiChu,360803002,12750,1022,8073,4359,12530,7283,3524,7574,14857,9223,17296
,TianYuZhen,360803100,10257,1107,6942,3795,13934,6907,3211,7544,14451,7633,14575
ֵ,ZhiXiaZhen,360803101,17619,2040,12699,6666,24909,12524,6558,13270,25794,13518,26217
,XinWeiZhen,360803102,11403,1164,7968,4192,16081,7962,4117,8709,16671,8716,16684
̲,FuTanZhen,360803103,14665,1653,10473,5595,20182,10403,5338,11027,21430,11183,21656
,FuTianZhen,360803104,17818,1781,12267,7060,24928,12162,6327,13457,25619,13659,25926
,WenBeiXiang,360803200,8880,1013,6286,3368,12568,6239,3119,6637,12876,6726,13012
,DongGuSheZuShaoShuMinZuXiang,360803201,10989,1244,7781,3938,15239,7677,3654,7957,15634,8106,15887
½ֵ´,GaoXinJieDaoBanShiChu,360821001,6163,601,4522,2827,8797,4522,2405,4646,9168,4647,9169
غ,DunHouZhen,360821100,63605,5386,42632,24972,71497,40063,18917,41928,81991,45276,87908
,YongYangZhen,360821101,20180,2422,13914,8005,27494,13833,6323,14855,28688,15011,28925
,TianHeZhen,360821102,11255,1429,7226,4064,14270,6985,2663,7495,14480,8121,15347
Ὥ,HengJiangZhen,360821103,14483,1488,9498,5730,19114,9454,3726,10106,19560,10199,19697
̽,GuJiangZhen,360821104,13584,1580,8885,4531,18380,8461,3678,9402,17863,9957,18842
,WanFuZhen,360821105,26073,3064,17573,9766,36753,17473,8347,19639,37112,19911,37484
,YongHeZhen,360821106,15971,1646,10938,6425,21715,10917,5113,11781,22698,11792,22730
ͩƺ,TongPingZhen,360821107,24242,2757,16452,9246,33936,16235,7607,17657,33892,18154,34606
,FengHuangZhen,360821108,13423,1178,8670,4771,16776,8433,3640,9064,17497,9571,18241
,YouTianZhen,360821109,17079,1854,11041,6855,22394,10826,4872,12057,22883,12764,23805
,AoChengZhen,360821110,13065,1383,8485,4434,17292,8224,3429,8878,17102,9392,17877
Դ,BeiYuanXiang,360821200,12188,1429,8175,4854,17209,8017,4008,9146,17163,9450,17625
,DaChongXiang,360821201,8762,999,5780,3315,12186,5635,2675,6410,12045,6656,12436
,LiTianXiang,360821202,11651,1361,7599,4201,15672,7542,3208,8508,16050,8621,16220
÷,MeiTangXiang,360821203,16315,1808,10741,5403,22019,10458,4536,11432,21890,11918,22659
,DengLongXiang,360821204,11347,1124,7454,3772,15040,7346,3428,8223,15569,8445,15899
,AnTangXiang,360821205,8053,843,5304,2987,10398,5271,2294,5801,11072,5886,11190
,GuanTianXiang,360821206,9522,1181,6247,3319,12960,6003,2409,6474,12477,6865,13112
ָ,ZhiYangXiang,360821207,7283,866,4751,2472,9977,4659,2004,5159,9818,5402,10153
عҵ԰,JiAnXianGongYeYuanQu,360821400,3831,2,2665,1,452,7,0,0,7,1168,3833
ɽü�,JingGangShanJingJiJiShuKaiFaQu,360821401,6460,28,3599,78,115,112,49,109,221,2938,6537
ķ,WenFengZhen,360822100,86856,6259,60552,36583,96912,56629,34237,61372,118001,66800,127352
,FuTianZhen,360822101,25253,3455,16750,10295,35447,16112,7865,18631,34743,19823,36573
̹,PanGuZhen,360822102,19654,2536,13287,7809,27783,13233,6729,15444,28677,15632,28919
㽭,FengJiangZhen,360822103,22682,3070,14890,9292,31338,14719,6769,17053,31772,17631,32521
,HuangQiaoZhen,360822104,17248,2313,11485,7185,23485,11459,4975,12993,24452,13051,24536
̲,JinTanZhen,360822105,23436,2568,15433,8945,29896,14375,6376,16387,30762,16947,32380
˶,BaDouZhen,360822106,23770,2386,15665,10319,31264,15642,7849,18282,33924,18340,34005
˫,ShuangCunZhen,360822107,7675,843,4944,2827,10649,4943,2221,5794,10737,5795,10739
,LaoQiaoZhen,360822108,13671,1570,9143,5294,17935,8871,4143,9677,18548,10241,19384
,LuoTianZhen,360822109,13123,1464,8701,4991,18134,8678,4073,9934,18612,9959,18660
ɳ,BaiShaZhen,360822110,14515,1746,9635,5800,19725,9324,4428,10646,19970,11054,20689
ˮ,BaiShuiZhen,360822111,7747,855,5042,3023,10097,4993,2206,5645,10638,5766,10808
,DingJiangZhen,360822112,8984,958,6119,3514,12149,6116,2918,6722,12838,6741,12860
ڽ,WuJiangZhen,360822113,13824,1437,9102,5020,18586,8956,4417,10238,19194,10576,19678
ˮ,ShuiNanZhen,360822114,19282,2396,12790,7826,25757,12767,5474,14235,27002,14362,27152
,ShangXianXiang,360822200,14280,1952,9626,5824,20092,9611,4260,10817,20428,10866,20492
ˮ,ShuiTianXiang,360822201,11188,1292,7570,4604,16007,7547,3545,8427,15974,8455,16025
ɽ,GuanShanXiang,360822202,6120,742,3956,2420,8170,3817,1702,4438,8255,4608,8564
ˮ,ShuiBianZhen,360823100,35595,2674,23179,13077,44179,22231,11567,25004,47235,26657,49836
�,MaBuZhen,360823101,10658,1142,6938,3568,13620,6539,3111,7312,13851,7973,14911
,BaQiuZhen,360823102,24328,2689,16885,10188,29382,16617,8238,17948,34565,18370,35255
ʺ,RenHeZhen,360823103,10281,1183,6762,3646,13821,6407,2896,6974,13381,7598,14360
Ϫ,YanXiZhen,360823104,8314,1069,5418,3246,11078,5271,2254,5923,11194,6219,11637
,LuoTianZhen,360823105,13185,1471,8727,5073,17383,8708,3896,9743,18451,9825,18552
ͩ,TongLinXiang,360823200,5580,591,3665,1995,7095,3637,1707,4131,7768,4213,7878
,FuMinXiang,360823201,6788,784,4487,2233,8808,4292,1949,4628,8920,5034,9521
ƺ,GePingXiang,360823202,5666,625,3627,1942,7569,3451,1578,3888,7339,4242,7869
,JinJiangXiang,360823203,7308,913,4800,2694,9745,4696,1985,5100,9796,5406,10206
ƺ,JinPingMinZuXiang,360823204,2179,304,1433,968,2588,1417,614,1619,3036,1664,3097
Ͽعҵ԰,XiaJiangXianGongYeYuanQu,360823400,1058,19,644,324,268,388,284,524,912,717,1361
,JinChuanZhen,360824100,63623,4751,41943,24647,63807,39852,19204,42561,82413,45635,87578
,SanHuZhen,360824101,27337,3420,18460,10857,36815,18219,7725,19700,37919,20022,38482
,DaYangZhouZhen,360824102,16840,1714,11308,7128,22336,11198,5182,12102,23300,12428,23736
,QiQinZhen,360824103,21383,2173,13963,8193,29348,13954,7030,16618,30572,16623,30586
б,MaiXieZhen,360824104,14800,1458,9624,6082,19866,9541,4710,11128,20669,11344,20968
཭,LiJiangXiang,360824200,13504,1326,8948,4900,18149,8868,4257,9960,18828,10139,19087
Ϫ,TaoXiXiang,360824201,10188,947,6473,3614,13452,6264,2836,7055,13319,7498,13971
,ChengShangXiang,360824202,9794,1054,6404,3513,13183,6373,3089,7375,13748,7533,13937
̶,TanQiuXiang,360824203,12629,1342,8309,5141,16921,8285,4001,9558,17843,9663,17972
,ShenZhengQiaoXiang,360824204,7157,689,4580,2950,9505,4462,1991,5092,9554,5257,9837
ʽ,YiJiangXiang,360824205,8242,886,5466,3493,10917,5418,2683,6252,11670,6345,11811
粺,JieBuXiang,360824206,16561,1774,10984,6428,22129,10893,5142,12247,23140,12493,23477
,HePuXiang,360824207,12080,1428,8207,4732,16477,8129,3815,9009,17138,9116,17323
¸ɹҵ԰,XinGanGongYeYuanQu,360824404,864,32,506,211,352,295,169,325,620,559,1065
,EnJiangZhen,360825100,60887,4791,40213,23412,70696,39331,19098,42842,82173,44563,84776
,KengTianZhen,360825101,13434,1395,8692,4729,17524,8582,3422,9295,17877,9559,18251
,YanBeiZhen,360825102,17241,1595,11155,5443,23514,10900,5096,12403,23303,12777,23932
,GuXianZhen,360825103,15401,1582,10119,5173,20626,10002,4614,11138,21140,11478,21597
,YaoTianZhen,360825104,15560,1631,10543,4849,21907,10522,5009,11606,22128,11657,22200
,TengTianZhen,360825105,24788,2606,16952,8045,34524,16737,8756,18740,35477,19198,36150
ʯ,ShiMaZhen,360825106,22470,2441,15190,7180,31341,14996,7617,16831,31827,17338,32528
ɳϪ,ShaXiZhen,360825107,14065,1698,9677,5026,19382,9559,4481,10238,19797,10567,20244
,ZuoLongXiang,360825200,27035,2704,17673,9276,36063,17567,7094,18935,36502,19160,36833
˽,BaJiangXiang,360825201,7896,828,5306,2734,10791,5210,2334,5531,10741,5752,11058
̶,TanChengXiang,360825202,12356,1247,7920,3963,16536,7760,3325,8571,16331,9008,16928
¹,LuGangXiang,360825203,9537,913,6122,2965,12617,6013,2669,6668,12681,6997,13119
߶,QiDouXiang,360825204,9585,957,6345,3187,13269,6186,2951,6872,13058,7148,13493
,TaoTangXiang,360825205,9759,1085,6227,3097,12709,5982,2860,6584,12566,7477,13704
д,ZhongCunXiang,360825206,4413,565,2902,1595,5831,2869,1185,3167,6036,3261,6163
Ϫ,ShangXiXiang,360825207,3642,455,2348,1210,4785,2314,885,2524,4838,2634,4982
̶ͷ,TanTouXiang,360825208,6891,832,4795,2398,9343,4686,2202,4880,9566,5130,9925
,SanFangXiang,360825209,4009,493,2642,1395,5322,2600,1058,2805,5405,2918,5560
Ϲ,ShangGuXiang,360825210,6640,644,4581,2193,9308,4510,2275,4818,9328,4978,9559
,JunBuXiang,360825211,7795,942,5487,2732,10787,5414,2716,5813,11227,5966,11453
,LongGangSheZuXiang,360825212,8762,1082,6331,3103,12664,6157,3209,6432,12589,6722,13053
ֳ̿,LuoPuKenZhiChang,360825501,1672,145,1029,505,2193,924,431,1089,2013,1219,2248
ɽֳ,GuanShanLinChang,360825502,399,46,228,78,499,146,75,171,317,292,520
ν,ChengJiangZhen,360826100,81544,6919,55279,29202,89213,47864,23801,47832,95696,56985,112264
Ϫ,BiXiZhen,360826101,11460,1347,8057,4232,15066,7807,3965,7976,15783,8715,16772
ͷ,QiaoTouZhen,360826102,10749,1331,7014,3793,13944,6800,2538,7197,13997,7604,14618
,HeShiZhen,360826103,15066,1796,10134,5459,20036,9959,4050,10427,20386,10778,20912
Ϫ,LuoXiZhen,360826104,22085,2581,15363,8112,29859,14895,6352,14876,29771,15655,31018
Ϫ,SuXiZhen,360826105,14097,1694,9327,5081,18322,8532,3345,8663,17195,9809,19136
,MaShiZhen,360826106,25775,2732,16679,9544,33288,16238,5813,16981,33219,17641,34320
,TangZhouZhen,360826107,22961,2327,15564,8837,30020,15306,6097,15512,30818,15821,31385
ڳ,GuanChaoZhen,360826108,14185,1465,9519,5160,18659,9390,3863,9697,19087,9994,19513
ɳ,ShaCunZhen,360826109,10069,1143,7008,3992,12710,6822,3216,7082,13904,7420,14428
Ӫ,LaoYingPanZhen,360826110,4089,492,2696,1470,5507,2615,1152,2808,5423,3037,5733
С,XiaoLongZhen,360826111,5006,938,3198,2364,6641,3163,1059,3542,6705,3805,7003
Ϫ,GuanXiZhen,360826112,17414,1763,11907,6820,23750,11815,5203,12233,24048,12473,24380
Էǰ,YuanQianZhen,360826113,18278,1777,13171,7467,25368,13130,6712,13481,26611,13596,26767
,WanHeZhen,360826114,34638,3464,23129,14091,46777,23058,10295,24740,47798,25268,48397
Ϫ,YanXiZhen,360826115,14555,1520,9881,5793,18563,9311,3927,9451,18762,10121,20002
ʯɽ,ShiShanXiang,360826200,8825,1026,6105,3289,11881,5986,2630,6146,12132,6376,12481
Ϫ,NanXiXiang,360826201,9722,991,6487,3517,12864,6427,2577,6642,13069,6803,13290
ģ,ShangMoXiang,360826202,7174,858,5049,2655,9667,4979,2265,5105,10084,5248,10297
ˮ,ShuiChaXiang,360826203,7650,1054,5437,2770,10716,5360,2439,5512,10872,5706,11143
,ShangYiXiang,360826204,5621,783,3920,2007,7584,3769,1708,3816,7585,4192,8112
,ZhongLongXiang,360826205,4678,545,3162,1858,6269,3108,1320,3244,6352,3381,6543
̩عҵ԰,TaiHeXianGongYeYuanQu,360826405,3535,20,2274,397,479,426,156,486,912,1437,3711
Ȫ,QuanJiangZhen,360827100,77294,7660,54146,28579,94266,51940,26206,53875,105815,57014,111160
,YuTianZhen,360827101,38096,4079,26260,14672,52710,26231,12864,28698,54929,28779,55039
,BiZhouZhen,360827102,7936,1055,5444,3048,11196,5328,2524,5856,11184,6071,11515
,CaoLinZhen,360827103,20744,2322,14890,7476,28945,14871,7762,15825,30696,15938,30828
ǰ,DuiZiQianZhen,360827104,14109,1669,9881,5021,19692,9799,5177,10912,20711,11074,20955
,ZuoAnZhen,360827105,22776,2803,15303,7946,30627,15197,7030,17092,32289,17306,32609
ƺ,GaoPingZhen,360827106,9775,1166,6553,3432,13291,6510,3092,7303,13813,7480,14033
,DaFenZhen,360827107,25704,2871,17700,8489,34612,17404,8724,18957,36361,19599,37299
ǰ,YaQianZhen,360827108,8226,994,5644,2888,10904,5559,2381,5746,11305,5957,11601
Դ,HeYuanZhen,360827109,14334,1693,9978,5225,19828,9856,4888,10658,20514,10937,20915
,TangHuZhen,360827110,11112,1462,7516,3879,15012,7431,3386,8233,15664,8444,15960
,ZhuTianXiang,360827200,14812,1612,10350,4931,20405,10346,5193,11258,21604,11267,21617
ʯ,JinShiXiang,360827201,17092,1840,12048,5740,23450,11930,6111,12610,24540,12995,25043
,DaKengXiang,360827202,10395,1225,7133,3763,14393,7065,3684,7875,14940,8171,15304
ö,MeiJiangXiang,360827203,13954,1569,9682,5055,19192,9613,4594,10258,19871,10435,20117
˫,ShuangQiaoXiang,360827204,4648,553,3175,1578,6454,3131,1404,3318,6449,3430,6605
½,XinJiangXiang,360827205,6852,819,4711,2376,9094,4661,1905,4711,9372,4865,9576
嶷,WuDouJiangXiang,360827206,8747,963,5715,3071,11315,5658,2322,6121,11779,6317,12032
Ϫ,XiXiXiang,360827207,10033,1119,7031,3538,13277,6969,3747,7680,14649,7868,14899
Ͻ,NanJiangXiang,360827208,7258,998,5158,2619,10082,5105,2616,5592,10697,5714,10872
ƿ,HuangKengXiang,360827209,12025,1456,8657,4446,16453,8617,4575,9242,17859,9399,18056
,DaiJiaPuXiang,360827210,9334,1124,6346,3262,12676,6268,3181,7079,13347,7293,13639
Ӫ,YingPanWeiXiang,360827211,3357,397,2219,1214,4478,2191,998,2422,4613,2533,4752
촨عҵ԰,SuiChuanXianGongYeYuanQu,360827402,1382,18,889,202,37,266,148,269,535,659,1548
ܽ,FuRongZhen,360828100,42770,4498,29131,15403,49172,24376,11761,23875,48251,29898,59029
,WuFengZhen,360828101,14492,1742,10148,4888,17840,9270,3791,9351,18621,9877,20025
ͷ,JianTouZhen,360828102,18085,2187,12208,5647,24141,11945,4746,12232,24177,12810,25018
Ҥͷ,YaoTouZhen,360828103,20879,2400,14021,6746,28028,13711,5626,14273,27984,14884,28905
ټ,BaiJiaZhen,360828104,14026,1804,9783,4763,18785,9641,3776,9531,19172,9823,19606
,GaoBeiZhen,360828105,8755,1081,6032,2726,11378,5861,2353,5870,11731,6157,12189
º,LuTianZhen,360828106,13730,1429,9241,4395,18195,9133,3551,9247,18380,9469,18710
ɳƺ,ShaPingZhen,360828107,9621,1039,6449,2951,12609,6172,2598,6396,12568,6809,13258
,XiaZaoZhen,360828108,10074,1120,6943,3567,13972,6874,3202,7271,14145,7453,14396
,LuoTangXiang,360828200,10470,1185,6966,3388,13886,6890,2733,7238,14128,7422,14388
ǰ,DanQianXiang,360828201,8807,1226,6210,2891,12151,6140,2560,6240,12380,6383,12593
,WuShuXiang,360828202,4371,537,3060,1492,6068,3011,1385,3112,6123,3233,6293
ɽ,BaoShanXiang,360828203,7711,1083,5598,2892,10995,5516,2859,5904,11420,6055,11653
,JianTianXiang,360828204,9147,1265,6603,3449,13190,6582,3219,6994,13576,7028,13631
˳,ShunFengXiang,360828205,6083,757,4462,2036,9089,4439,2477,4803,9242,4855,9317
ؿ,ShaoKouXiang,360828206,15130,1696,10429,5258,20437,10402,4421,10762,21164,10818,21247
Դֳ,WanAnXianMaYuanKenZhiChang,360828501,1042,120,720,340,1320,707,279,700,1407,721,1441
ƽ,PingDouZhen,360829100,60329,5927,41182,24456,68706,39912,16177,39800,79712,41251,82433
䰿,HuKengZhen,360829101,9335,1844,6114,4167,11572,5866,1708,5971,11837,6773,12887
޺,ZhouHuZhen,360829102,27535,3049,17652,9765,35279,17571,5931,18658,36229,18863,36515
,HengLongZhen,360829103,16043,1854,10408,5577,18715,9995,3782,10642,20637,11271,21679
Ϫ,YangXiZhen,360829104,11656,1652,8031,4478,15630,8007,3105,8349,16356,8382,16413
,YanTianZhen,360829105,18036,2187,11969,6346,23996,11936,4762,12956,24892,13016,24985
,FengTianZhen,360829106,16992,1761,10769,5870,20906,10677,3652,11432,22109,11636,22405
,ZhuJiangXiang,360829200,10871,1169,7122,3584,14250,7059,2816,7600,14659,7734,14856
,GuaSheXiang,360829201,7836,837,5078,2660,10281,5077,1945,5503,10580,5540,10618
Ǯɽ,QianShanXiang,360829202,8356,1118,5366,2849,11010,5336,1994,5961,11297,6102,11468
,ChiGuXiang,360829203,5438,544,3369,1975,6561,3269,1464,3518,6787,4077,7446
ɽׯ,ShanZhuangXiang,360829204,14959,1644,9603,5324,19298,9552,3662,10533,20085,10662,20265
,YangMenXiang,360829205,14944,2054,10069,5138,20323,9982,3764,10529,20511,10693,20762
,JinTianXiang,360829206,15005,1932,9849,5026,19848,9754,3460,10345,20099,10548,20397
�,PengFangXiang,360829207,5070,612,3235,1685,6475,3229,1038,3404,6633,3485,6720
̩ɽ,TaiShanXiang,360829208,8474,956,5515,2851,10785,5484,2017,5850,11334,5932,11447
,LiaoTangXiang,360829209,19052,2225,12355,6087,24817,12296,4287,13053,25349,13209,25564
,GanLuoXiang,360829210,8552,1014,5690,2775,11404,5685,2109,5968,11653,5985,11675
ׯ,ZhangZhuangXiang,360829211,4276,443,2794,1380,5561,2773,1102,2975,5748,3027,5821
عҵ԰,AnFuXianGongYeYuan,360829400,1267,4,833,32,0,31,4,27,58,442,1275
̴,HeChuanZhen,360830100,51272,5694,36439,20800,58024,34817,16686,34770,69587,37213,73652
ʯ,ShiQiaoZhen,360830101,16796,2235,11560,5594,23405,11513,5034,12416,23929,12505,24065
Դ,LongYuanKouZhen,360830102,16973,2034,11438,5636,22837,11347,4835,12129,23476,12404,23842
,LiTianZhen,360830103,29218,3593,20418,10356,39050,20371,8778,21088,41459,21171,41589
,LongMenZhen,360830104,13581,1644,9103,4385,18520,9085,3804,9874,18959,9926,19029
ɳ,ShaShiZhen,360830105,13063,1554,9021,4262,18283,9012,4001,9563,18575,9597,18618
,WenZhuZhen,360830106,16226,2021,11013,5440,22506,10817,4765,11142,21959,11999,23012
ǰ,BuQianZhen,360830107,14162,1784,10253,5192,18224,9723,4772,9889,19612,10465,20718
,HuaiZhongZhen,360830108,14546,1743,9947,4882,19854,9901,4097,10390,20291,10439,20386
¥,GaoQiaoLouZhen,360830109,10867,1276,7389,3715,14408,7302,3219,7742,15044,7973,15362
,AoNanXiang,360830200,5467,729,3623,1715,7508,3607,1495,3983,7590,4068,7691
,QuBaiXiang,360830201,5773,702,3929,1817,7973,3861,1616,4060,7921,4162,8091
ŷ,CaiFengXiang,360830202,10603,1270,7394,3544,13651,7287,3141,7503,14790,7620,15014
̸,YanGeXiang,360830203,11583,1499,8109,3941,15992,8103,3506,8462,16565,8479,16588
,ZaiZhongXiang,360830204,10249,1322,7158,3394,14214,7141,3025,7403,14544,7438,14596
,SanWanXiang,360830205,3789,477,2408,1101,4903,2362,901,2529,4891,2759,5167
̨,TaiLingXiang,360830206,8235,983,5476,2724,11128,5436,2269,5905,11341,6011,11487
,LongTianXiang,360830207,12097,1428,8492,3957,16387,8464,3864,8854,17318,8897,17389
Ϫ,GaoXiXiang,360830208,12977,1551,9029,4600,18245,8941,4147,9447,18388,9646,18675
,LianZhouXiang,360830209,11929,1402,8212,4164,16885,8198,3682,8773,16971,8801,17013
,GaoShiXiang,360830210,8839,1043,6021,3072,12086,5948,2609,6315,12263,6470,12491
,XiangXingXiang,360830211,19607,2654,13640,7179,26987,13611,5909,14455,28066,14530,28170
«Ϫ,LuXiXiang,360830212,15189,2094,10416,5353,21195,10404,4329,11141,21545,11196,21612
عҵ԰,YongXinXianGongYeYuanQu,360830400,1313,5,750,91,7,74,5,79,153,573,1323
ƺֵ´,CiPingJieDaoBanShiChu,360881001,9801,1008,6408,3744,8486,5390,1939,5273,10663,6340,12748
ƺ,ShaPingZhen,360881100,11900,1002,8124,5274,10488,7876,3869,8036,15912,8647,16771
,LongShiZhen,360881101,19060,1717,13540,7092,17338,13006,6397,13001,26007,13634,27174
ų,GuChengZhen,360881102,7940,1004,5775,2842,10490,5744,2803,5882,11626,5972,11747
³,XinChengZhen,360881103,4430,550,3215,1678,5881,3167,1429,3110,6277,3194,6409
¤,DaLongZhen,360881104,2553,373,1799,893,3430,1776,697,1791,3567,1824,3623
ɽ,NaShanXiang,360881200,8969,996,6444,3225,11628,6170,3033,6150,12320,6554,12998
,HuangAoXiang,360881201,4190,563,2884,1696,5733,2877,1303,3138,6015,3172,6056
,XiaQiXiang,360881202,4355,589,3202,1775,6058,3153,1645,3218,6371,3387,6589
ƺ,ChangPingXiang,360881203,1145,112,685,379,1406,663,256,739,1402,828,1513
,AoLiXiang,360881204,2172,275,1580,763,2994,1578,782,1648,3226,1649,3229
,ELingXiang,360881205,3223,373,2163,1128,4023,2116,923,2146,4262,2356,4519
¶,BaiLuXiang,360881206,1633,232,1156,611,2286,1093,469,1093,2186,1178,2334
éƺ,MaoPingXiang,360881207,2111,312,1457,788,2849,1455,551,1514,2969,1517,2974
,GeTianXiang,360881208,3575,541,2584,1269,4738,2583,1091,2612,5195,2623,5207
ɻ,HeHuaXiang,360881209,1767,260,1308,660,2428,1308,543,1262,2570,1262,2570
,MuCunXiang,360881210,4336,617,2971,1456,5618,2939,1194,2949,5888,3176,6147
,DongShangXiang,360881211,5039,584,3505,1759,6303,3494,1449,3520,7014,3567,7072
,JingQiJiTuan,360881400,3673,706,2851,1643,4746,2810,1209,2663,5473,2737,5588
ɽȻ,JingGangShanZiRanBaoHuQu,360881401,4561,647,3152,1770,5563,3065,1275,3113,6178,3331,6483
ʯֳ,BaiShiKenZhiChang,360881501,367,72,294,181,407,292,120,244,536,265,559
Ȫֵ,LingQuanJieDao,360902001,60417,7434,40926,24477,65267,39797,13259,38862,78659,40184,81110
㽭ֵ,XiuJiangJieDao,360902002,51176,4183,34873,19630,39168,31290,14162,30750,62040,34648,69521
տɽֵ,ZhanLangJieDao,360902004,15670,1631,10775,6592,12252,10430,4279,10433,20863,10805,21580
Ȫֵ,ZhuQuanJieDao,360902005,15091,2115,10601,6822,13491,10051,4376,10262,20313,10981,21582
ɽֵ,HuaChengJieDao,360902006,22609,2162,15179,8632,18004,13484,5993,13405,26889,15585,30764
԰ֵ,GuanYuanJieDao,360902007,42063,2851,27925,15636,25459,26514,12758,27153,53667,29747,57672
ֵֽ,XiaPuJieDao,360902008,15724,1864,11292,5756,19883,11178,5690,11452,22630,11986,23278
˽ֵ,FengHuangJieDao,360902009,52807,3855,34929,13365,31126,21079,8970,20904,41983,30703,65632
԰ֵ,JinYuanJieDao,360902010,9174,843,6510,3703,11785,6397,3359,6760,13157,6866,13376
,BinJiangZhen,360902100,30151,3773,21937,11692,43153,21878,11296,23102,44980,23283,45220
,XiCunZhen,360902101,39055,4552,28229,13180,53502,27694,14061,28252,55946,29439,57668
,JinRuiZhen,360902102,21533,2854,15329,7422,30058,15228,7644,16488,31716,16702,32031
,WenTangZhen,360902103,15580,2155,10744,5670,19834,10367,4943,11247,21614,11934,22678
,SanYangZhen,360902104,26362,2549,18199,8708,35627,17698,9195,19133,36831,19907,38106
Ȼ,CiHuaZhen,360902105,40551,4702,32926,16113,55223,32758,21198,33198,65956,33525,66451
̨,TianTaiZhen,360902106,29500,3920,21522,11479,43119,21423,11858,23570,44993,23756,45278
,HongTangZhen,360902107,30758,3993,21329,10774,43725,21095,11105,24052,45147,24527,45856
׽,WoJiangZhen,360902108,9282,1071,6350,3576,12489,6188,3092,6797,12985,7095,13445
·,XinFangZhen,360902109,14600,1887,9791,5509,18776,9515,4594,10502,20017,11290,21081
կ,ZhaiXiaZhen,360902110,20942,3078,15289,8660,31549,14907,8617,16754,31661,17348,32637
«,LuCunZhen,360902111,15236,1733,10466,5274,21272,10292,5212,11451,21743,11715,22181
,HuTianZhen,360902112,19706,2138,13686,7278,27408,13605,6768,14707,28312,14926,28612
,XinTianZhen,360902113,17388,2425,12743,6216,25275,12703,6787,13743,26446,13857,26600
齭,HongJiangXiang,360902202,8289,1038,5452,2699,11058,5148,2358,5780,10928,6233,11685
,NanMiaoXiang,360902203,13747,1634,9287,4677,18750,9126,4314,10104,19230,10408,19695
ͤ,ZhuTingXiang,360902204,14968,1497,10149,4834,20866,10098,4860,11062,21160,11176,21325
ˮ,ShuiJiangXiang,360902205,15148,1896,10577,5062,21140,10419,5487,11538,21957,11954,22531
ľ,NanMuXiang,360902206,11950,1449,8002,3851,16281,7736,3829,8764,16500,9226,17228
,LiaoShiXiang,360902207,11784,2078,9608,5202,18365,9502,5776,9777,19279,10030,19638
ľ,BaiMuXiang,360902210,13539,1616,9163,4733,18596,9020,4490,10166,19186,10482,19645
ɽ̶,FeiJianTanXiang,360902213,14000,1527,10227,4754,20118,10187,5513,10725,20912,10813,21040
˴ÿίԱ,YiChunJingJiKaiFaQuGuanLiWeiYuanHui,360902400,3360,19,1727,55,237,74,66,77,151,1718,3445
Ԭҵ԰,YuanZhouQuGongYeYuanQu,360902401,446,5,167,0,0,0,9,0,0,293,460
˴ɽȪ羰ʤίԱ,YiChunShiMingYueShanWenQuanFengJingMingShengQuGuanLiWeiYuanHui,360902402,222,2,48,36,73,27,5,32,59,181,229
˴ίԱ,YiChunShiYiYangXinQuGuanLiWeiYuanHui,360902403,0,0,0,0,0,0,0,0,0,0,0
ũʵ鳡,NongMuShiYanChang,360902500,1135,135,824,429,935,795,383,766,1561,829,1653
벼԰,XiLingBuGuoYuanChang,360902501,1241,135,937,440,1749,937,529,963,1900,968,1905
ɽֳ,MingYueShanCaiYuLinChang,360902502,155,14,94,74,207,94,40,115,209,115,209
·ֳ,XinFangCaiYuLinChang,360902503,645,85,431,255,880,427,192,480,907,491,922
Ͳֳ,YouChaLinChang,360902504,1346,199,977,573,1320,956,438,970,1926,1006,1983
봨,FengChuanZhen,360921100,58003,4366,40628,20742,59007,33307,19223,33033,66340,40964,81592
శ,ChiAnZhen,360921101,23878,2546,16937,9804,32467,16739,8640,17911,34650,18127,35064
,ChiTianZhen,360921102,20549,2010,14091,7996,27836,13804,7152,15123,28927,15620,29711
β,SongBuZhen,360921103,19277,2102,13111,7472,26690,13039,6592,14687,27726,14860,27971
,GanZhouZhen,360921104,23654,2540,15874,9529,31487,15843,6859,17079,32922,17179,33053
,ZaoXiaZhen,360921105,7665,994,4973,3261,10350,4844,2118,5561,10405,5804,10777
Ჺ,HuiBuZhen,360921106,14192,1781,9863,5952,19002,9348,4756,10198,19546,10866,20729
,LuoShiZhen,360921107,9589,1094,6297,3804,12498,6258,2859,7033,13291,7245,13542
ϸ,ShangFuZhen,360921108,11243,1351,7822,4904,13048,7691,3766,8102,15793,8538,16360
ʷ,GanFangZhen,360921109,3914,471,2560,1343,5067,2365,1076,2628,4993,2901,5461
ɽ,YangShanXiang,360921200,5064,596,3447,1940,6631,3325,1580,3577,6902,3793,7240
Ϫ,ZaoXiXiang,360921201,5823,714,3974,2233,7786,3788,1967,4279,8067,4530,8504
Ϫ,LiuXiXiang,360921202,3431,406,2162,1295,4449,2111,938,2503,4614,2613,4775
عҵ԰,FengXinXianGongYeYuanQu,360921400,0,0,0,0,0,0,0,0,0,0,0
ʯϪ´,ShiXiBanShiChu,360921500,4089,478,2794,1551,5455,2704,1367,2997,5701,3140,5934
ɽʤ羰,BaiZhangShanMingShengFengJingQu,360921501,1801,214,1169,652,2305,1155,477,1260,2415,1323,2492
޿ֳ,GanZhouKenZhiChang,360921502,2111,241,1447,892,2618,1427,647,1534,2961,1552,2999
ֳ,DongFengKenZhiChang,360921503,3753,804,2712,1832,4357,2431,935,2482,4913,2780,5492
ũֳ,NongMuYuLiangZhongChang,360921504,890,74,617,317,1031,481,296,516,997,643,1260
ֵֽ,KangLeJieDao,360922001,66479,6145,46788,26082,79799,45275,20836,44551,89826,46672,93460
̶,ZhuTanZhen,360922100,37666,3346,29713,14220,51367,29399,19260,30300,59699,30559,60272
é,HuangMaoZhen,360922101,32877,3454,25067,12729,46005,25065,15925,27181,52246,27189,52256
̶,TanBuZhen,360922102,21938,2528,18259,9188,31053,18242,12163,18316,36558,18370,36629
˫,ShuangQiaoZhen,360922103,19031,2536,14478,8448,27627,14441,8533,15475,29916,15622,30100
ߴ,GaoCunZhen,360922104,9599,1365,6625,4426,13334,6621,2962,7296,13917,7301,13926
޳,LuoChengZhen,360922105,13341,1734,9783,5852,18815,9664,5185,10274,19938,10477,20260
,SanXingZhen,360922106,15116,1783,11277,6837,21560,11276,6276,11891,23167,11898,23175
,EFengXiang,360922200,12397,1312,9156,4641,17286,9140,5126,9620,18760,9679,18835
�,MaBuXiang,360922201,16519,1763,12082,6816,23759,12082,6973,13171,25253,13173,25255
߳,GaoChengXiang,360922202,16910,2397,13036,8278,25299,13024,7818,14062,27086,14089,27125
,ChiXingXiang,360922203,6335,1042,4715,3086,9431,4708,2749,5387,10095,5411,10126
붫,LingDongXiang,360922204,7567,856,5367,2895,10655,5356,3123,6161,11517,6179,11546
ˮ,BaiShuiXiang,360922205,5793,903,4342,2569,8123,4293,2388,4662,8955,4742,9084
Դ,XianYuanXiang,360922206,8562,1418,6533,4097,12491,6485,3534,6859,13344,6981,13514
,BaiLiangXiang,360922207,12604,1577,9470,5726,18130,9459,5448,10144,19603,10159,19629
,JiaoHuXiang,360922208,7414,932,4819,3012,10122,4807,2217,5715,10522,5744,10563
عҵ԰,WanZaiXianGongYeYuanQu,360922400,1061,13,699,95,0,110,27,104,214,402,1101
ֵ,AoYangJieDao,360923001,66569,5039,43444,25439,64010,40626,17396,42272,82898,45560,89004
,TianXinZhen,360923100,24378,3264,17055,10120,33761,16999,7864,18342,35341,18451,35506
Ҷ,XuJiaDuZhen,360923101,14398,2233,10534,6598,20288,10471,5190,11139,21610,11287,21821
,JinJiangZhen,360923102,22471,2577,15008,9284,25348,14903,6291,16065,30968,16331,31339
Ϫ,SiXiZhen,360923103,22642,3051,15459,10284,31460,15394,6398,16484,31878,16632,32091
,HanTangZhen,360923104,10882,1739,7764,4787,15095,7674,3369,8008,15682,8226,15990
ϸ,NanGangZhen,360923105,8483,1573,6048,4240,12179,6019,2665,6603,12622,6673,12721
ɽ,AoShanZhen,360923106,5953,722,4000,2567,7527,3964,1592,4232,8196,4267,8267
«,LuZhouXiang,360923200,8777,1289,5904,3584,11941,5767,2522,6440,12207,6684,12588
,TaXiaXiang,360923201,7019,1162,4677,3332,8615,4650,1782,5179,9829,5286,9963
ɽ,MengShanXiang,360923202,9145,1186,5774,3392,11773,5765,1992,6468,12233,6549,12323
,ZhenDuXiang,360923203,6848,892,4695,2767,9635,4685,2164,5176,9861,5209,9904
Ұ,YeShiXiang,360923204,5043,700,3361,2201,6989,3319,1363,3645,6964,3745,7106
½粺,XinJieBuXiang,360923205,11555,1574,7965,4891,15802,7942,3391,8495,16437,8555,16520
ϸعҵ԰,ShangGaoXianGongYeYuanQu,360923400,4525,52,2812,293,194,387,159,430,817,1924,4736
īɽֳ,MoShanKenZhiChang,360923500,3925,368,2668,1726,3864,2645,1195,2683,5328,2820,5488
ϸɽֳ,ShangGanShanLinChang,360923501,974,105,632,424,795,616,251,658,1274,698,1330
²,XinChangZhen,360924100,49216,5183,34479,21881,57125,34140,14448,33907,68047,34368,68847
,ChengTangZhen,360924101,12948,1654,8712,5450,17471,8525,3901,9283,17808,9791,18503
,TangPuZhen,360924102,16657,2191,11151,5906,22540,9927,4619,10757,20684,12316,23467
ׯ,XinZhuangZhen,360924103,10856,1127,6966,4089,13586,6468,3198,7091,13559,8215,15181
̶ɽ,TanShanZhen,360924104,10645,1395,7336,4299,13334,7173,2977,7410,14583,7681,15017
Ϫ,FangXiZhen,360924105,12947,1856,9258,6051,18211,9249,4329,9839,19088,9874,19132
ʯ,ShiShiZhen,360924106,18282,2423,12703,8110,25938,12672,6181,14096,26768,14183,26886
,HuaQiaoXiang,360924200,7018,915,4578,3117,9243,4511,1949,4952,9463,5304,9882
ͬ,TongAnXiang,360924201,5477,663,3641,2228,7434,3601,1523,3915,7516,4022,7663
챦,TianBaoXiang,360924202,10479,1268,6852,4101,13553,6750,2863,7321,14071,7758,14610
Ƹ,HuangGangXiang,360924203,6584,852,4602,2729,8639,4584,1985,4774,9358,4819,9421
,QiaoXiXiang,360924204,11386,1221,7825,4797,13911,7669,3445,8076,15745,8227,16052
˷عҵ԰,YiFengXianGongYeYuanQu,360924400,2602,26,848,183,6,207,104,238,445,1884,2732
ֳ,CheShangLinChang,360924500,4616,634,3139,1908,6161,3097,1299,3318,6415,3410,6549
˫ֳ,ShuangFengLinChang,360924501,2901,467,2019,1237,3906,1924,857,2007,3931,2206,4225
ʯֳ,ShiHuaJianKenZhiChang,360924502,3796,703,2701,1852,4143,2621,1073,2702,5323,2871,5572
Ƹɽֳ,HuangGangShanKenZhiChang,360924503,7119,1345,4996,3431,9122,4863,1843,5127,9990,5311,10307
˫Ϫ,ShuangXiZhen,360925100,32440,3210,22140,14015,37423,22010,8780,21916,43926,22290,44430
,RenShouZhen,360925101,13803,1836,9304,5517,19288,9273,4346,10609,19882,10681,19985
,BaoFengZhen,360925102,5791,628,3571,2181,7061,3507,1346,3779,7286,4194,7765
ߺ,GaoHuZhen,360925103,8690,994,5748,3186,11563,5647,2374,6158,11805,6310,12058
궼,ZaoDouZhen,360925104,4027,550,2657,1617,5218,2592,1038,2831,5423,2958,5615
,XiangTianXiang,360925200,9688,1066,6366,3913,12412,6314,2706,6869,13183,7094,13460
ˮ,ShuiKouXiang,360925201,8537,970,5491,3293,11127,5461,2137,6082,11543,6153,11644
Դ,ZhongYuanXiang,360925202,7932,1026,5179,3340,10264,5127,2277,5842,10969,6056,11235
,LuoWanXiang,360925203,8237,1192,5195,3254,10517,5080,1870,5776,10856,6104,11299
צ,SanZhaoLunXiang,360925205,1978,269,1144,765,2181,1052,388,1115,2167,1491,2635
׹,LeiGongJianXiang,360925206,3044,305,2027,1112,2841,1728,759,1792,3520,2081,4108
عҵ԰,JingAnXianGongYeYuanQu,360925400,536,7,192,18,0,28,23,29,57,374,566
,YongNingZhen,360926100,31647,3180,21825,12909,33481,21433,8564,21086,42519,21566,43391
Ȫ,WenQuanZhen,360926101,13161,1513,8803,5212,16464,8689,3760,9296,17985,9631,18434
ƺ,QiPingZhen,360926102,9815,989,6629,3541,12900,6617,2846,6990,13607,7021,13650
Ų,PaiBuZhen,360926103,7109,784,4599,2812,9112,4509,2208,5034,9543,5502,10101
,SanDouZhen,360926104,9742,1095,6372,3660,11666,6249,2758,6704,12953,7223,13595
,DaDuanZhen,360926105,11301,1309,7448,4300,14541,7390,3394,8045,15435,8556,16004
,GaoQiaoXiang,360926200,3811,479,2601,1399,5192,2592,1225,2885,5477,2914,5515
ۿ,GangKouXiang,360926201,3742,410,2444,1249,4900,2426,1072,2704,5130,2780,5224
Ϫ,DaiXiXiang,360926202,5601,512,3563,1989,6977,3518,1607,3823,7341,4157,7720
ɽֳ,HuaShanLinChang,360926500,301,49,216,131,417,216,108,242,458,242,458
ɽֳ,DaWeiShanLinChang,360926501,251,68,188,155,345,182,66,190,372,197,385
ɽֳ,ChaShanLinChang,360926502,239,58,168,142,346,168,70,199,367,199,367
ֳ,LongMenLinChang,360926503,196,37,132,113,259,132,62,162,294,163,295
ֵ,JianGuangJieDao,360981002,49575,5338,32805,19552,58168,31784,12674,33665,65449,34782,67587
޽ֵ,HeZhouJieDao,360981006,39530,2932,24285,12390,41129,22037,9991,24025,46062,28168,52453
Ͻֵ,JianNanJieDao,360981007,32330,3394,21646,11264,38839,21268,9719,23243,44511,23797,45443
ɽֵ,SunDuJieDao,360981008,42120,3790,28098,14389,58119,28061,13916,31476,59537,31728,59826
ׯֵ,ShangZhuangJieDao,360981009,27458,2742,18345,8769,35668,17809,8369,19551,37360,20224,38569
,BaiTuZhen,360981101,27152,3077,18708,9208,38058,18707,9543,21060,39767,21064,39772
Ԭ,YuanDuZhen,360981102,36839,4660,24445,13508,50832,24440,10129,27175,51615,27183,51628
,ZhangXiangZhen,360981104,37362,3563,25154,12908,52112,24977,12627,28100,53077,28398,53552
,DuShiZhen,360981105,23876,2097,16199,7455,33067,16079,8404,17942,34021,18178,34377
ɳ,TaoShaZhen,360981106,27941,2750,18851,9067,40049,18804,10092,21667,40471,21932,40783
,XiuShiZhen,360981107,41581,3866,27154,13032,58365,26209,13395,30023,56232,31688,58842
,LuoShiZhen,360981109,27220,2627,18029,9309,36816,18006,8614,20362,38368,20432,38461
·,TieLuZhen,360981110,28514,2859,18776,9220,39626,18476,9495,21636,40112,22092,40868
,LiCunZhen,360981111,15069,1426,9523,4864,20087,9407,3903,10693,20100,10875,20398
,DongJiaZhen,360981115,16902,1767,11080,5765,22871,10986,4786,12173,23159,12375,23455
,HuangChengZhen,360981116,23746,2646,16142,8389,33314,16142,7669,17918,34060,17919,34061
С,XiaoGangZhen,360981119,46067,4864,32307,14766,64671,32290,17018,35601,67891,35642,67949
ʯ̲,ShiTanZhen,360981120,22742,2599,15811,7875,32396,15807,7970,17495,33302,17500,33311
Ŷ,QiaoDongZhen,360981121,28151,3155,19601,10603,41278,19389,10577,21966,41355,22282,41883
,RongTangZhen,360981122,46919,4962,31276,14791,65896,30678,15445,35092,65770,36050,67326
ϴ,TuoChuanZhen,360981123,40292,4366,25542,11931,52114,22763,10624,25816,48579,29740,55282
Ȫ,QuanGangZhen,360981124,27977,3089,18751,9479,38947,18715,8870,21118,39833,21185,39936
÷,MeiLinZhen,360981125,20801,2307,14322,7369,28363,14132,6985,15524,29656,15771,30093
,QuJiangZhen,360981126,40241,4053,26606,13429,53926,26262,12850,29525,55787,30538,57144
,ShangTangZhen,360981127,11875,1019,7631,3814,14609,7469,3333,8302,15771,8596,16227
,XiaoTangXiang,360981201,17106,1842,11618,5828,24442,11574,6001,13291,24865,13331,24949
̶,DuanTanXiang,360981202,25228,2628,17207,7968,34367,17189,8086,18726,35915,18735,35942
,JiaoKengXiang,360981203,8945,946,6170,2815,12507,6155,3291,6981,13136,7012,13182
ʯ,ShiJiangXiang,360981204,8283,920,5322,2777,11694,5304,2517,6348,11652,6398,11720
ɺ,HeHuXiang,360981205,19695,2084,12454,6304,26736,12032,5252,13984,26016,14577,27031
,HuTangXiang,360981206,14558,1616,9771,4570,20253,9627,4490,10633,20260,10893,20664
ͬ,TongTianXiang,360981207,25097,2162,17929,8138,36374,17814,9998,19139,36953,19328,37257
ǿ,FengChengKuangWuJu,360981400,39945,5743,25654,14415,46943,24740,8430,25175,49915,28464,54118
йҵ԰,FengChengShiGongYeYuanQu,360981402,2290,4,1080,0,5,0,9,0,0,1223,2303
ֵ,GanYangJieDao,360982001,43471,3760,28622,16334,52910,27383,10546,27375,54758,29155,57777
¹ֵ,LuJiangJieDao,360982002,28485,2910,18903,11562,32980,18217,6373,17910,36127,18865,37768
ǽֵ,FuChengJieDao,360982003,17471,1415,11620,7231,19868,11585,4418,11635,23220,11684,23304
Žֵ,DaQiaoJieDao,360982004,21958,2223,14567,7329,29275,14559,5432,15016,29575,15046,29613
żɽֵ,ZhangJiaShanJieDao,360982005,43428,5061,28646,14864,58189,27257,10327,28289,55546,30170,58816
ٽ,LinJiangZhen,360982100,30693,3233,20215,11643,40694,19690,7875,20609,40299,21586,41801
̩,YongTaiZhen,360982101,11704,1121,7694,4271,15718,7670,3151,8236,15906,8282,15976
,HuangTuGangZhen,360982102,17360,1775,11360,6711,24259,11267,5483,13067,24334,13258,24618
¥,JingLouZhen,360982103,16081,1879,11027,7192,22323,10980,4749,11621,22601,11682,22709
,ChangFuZhen,360982104,19038,2147,13287,7301,27346,13265,6805,14661,27926,14703,27990
,DianXiaZhen,360982105,15713,1413,10394,5304,20987,10271,4355,10881,21152,11087,21481
ɽ,GeShanZhen,360982106,14111,1272,9283,5303,18865,9279,3611,9697,18976,9711,18994
,LiuGongMiaoZhen,360982107,14265,1531,9278,5156,18700,9216,3489,9888,19104,10007,19285
,GuanShangZhen,360982108,17852,1830,11780,6272,24316,11767,4925,12804,24571,12827,24607
,YiChengZhen,360982109,17207,1781,11211,6258,23407,11180,4912,12583,23763,12689,23900
,ZhongZhouXiang,360982200,13419,1412,8574,4811,18407,8574,3668,9925,18499,9925,18499
,ZhouShangXiang,360982201,21544,3005,15355,9297,30156,15278,6048,15075,30353,15242,30597
,YangHuXiang,360982202,21230,2053,14103,7382,28287,14097,5375,14536,28633,14555,28658
,WuChengXiang,360982203,15848,1788,10219,5926,21156,10036,4002,11067,21103,11419,21638
йҵ԰,ZhangShuShiGongYeYuanQu,360982400,491,0,99,4,72,4,1,3,7,393,492
ʡ˫԰ճ,ShengShuangJinYuanYiChang,360982500,4893,628,3201,1731,6398,3201,1076,3389,6590,3396,6597
ݽֵ,RuiZhouJieDao,360983001,94880,5493,58784,26024,95484,39255,24680,42203,81458,66269,125053
ֵ,JunYangJieDao,360983002,70558,6366,47117,25977,79774,40438,20638,43018,83456,50445,97562
,LanFangZhen,360983100,22565,3459,16107,9793,31880,15504,7541,16577,32081,17458,33565
,HeLingZhen,360983101,14086,1748,9386,6087,19360,9377,4350,10775,20152,10798,20184
ɳ,HuangShaGangZhen,360983102,20592,2567,14247,9081,28706,13831,6969,15398,29229,15881,30128
½,XinJieZhen,360983103,27432,3061,18162,10845,37325,17307,8534,19466,36773,20865,39027
˾,BaJingZhen,360983104,22933,2282,15127,9176,27451,14321,7097,15548,29869,17185,32312
,DuChengZhen,360983105,20712,2002,13343,7641,27304,12885,5720,14443,27328,15091,28434
̫,TaiYangZhen,360983106,12235,1529,8487,5077,17318,7886,4115,8638,16524,9392,17879
ɽ,JianShanZhen,360983107,11411,1376,7542,4975,15285,7036,2988,7579,14615,8233,15775
,TianNanZhen,360983108,12340,1156,8044,5178,16474,7962,3719,9017,16979,9171,17215
,XiangChengZhen,360983109,17959,2027,11677,7363,23693,11084,5092,12253,23337,13401,25078
Ҳ,HuiBuZhen,360983110,30373,3287,20058,12923,38556,18280,8600,20156,38436,22202,42260
ʯ,ShiNaoZhen,360983111,32355,3244,21005,10763,37833,18206,8794,19881,38087,23388,44393
̶,LongTanZhen,360983112,22201,2752,15143,9537,31321,14334,7328,15904,30238,17138,32281
,YangWeiZhen,360983113,27822,3336,18524,11377,37832,17756,8453,20098,37854,21087,39611
ǰ,CunQianZhen,360983114,16202,1730,10743,6767,21847,10437,4911,11683,22120,12100,22843
,WuQiaoZhen,360983115,10423,1248,6993,4249,14241,6820,3213,7552,14372,7891,14884
,XiangFuZhen,360983116,17810,1713,11648,7773,23247,11369,5113,12367,23736,12988,24636
,DaChengZhen,360983117,16671,1637,11639,6731,23011,11007,6221,11934,22941,12890,24529
Ϻ,ShangHuXiang,360983200,17339,2345,11605,7017,23486,10929,4681,11883,22812,12760,24365
,WangJiaWeiXiang,360983201,8239,1030,5459,3619,10913,5278,2259,5819,11097,6069,11528
߰͹ҵǹί,GaoAnShiXinShiJiGongYeChengGuanWeiHui,360983400,12760,151,5472,824,1533,1099,495,1247,2346,7934,13406
Ӣ,YingGangLingKuangWuJu,360983403,9375,991,5684,4382,11180,5578,1926,5923,11501,6608,12292
˾ú޹˾,JiangXiBaJingMeiKuangYouXianGongSi,360983404,3727,353,2107,1648,4233,1941,859,2165,4106,2832,4939
ïʵҵ˾,JiangXiXinMaoShiYeGongSi,360983405,2296,430,1456,1213,2403,1443,334,1498,2941,1604,3060
ǿֳ,XiangChengKenZhiChang,360983500,1462,159,984,707,1641,973,495,1088,2061,1132,2116
ˮ⹤̹,ShangYouShuiKuGongChengGuanLiJu,360983501,614,67,397,236,804,359,197,366,725,481,878
߰лɽ羰ί,GaoAnShiHuaLinShanFengJingQuGuanWeiHui,360983503,8009,1147,5258,3118,10979,4527,2244,4976,9503,6142,11400
ƽֵ´,QingYunJieDaoBanShiChu,361002001,82932,5595,50231,26642,61731,40593,15627,43139,83732,53923,104154
ֵֽ´,XiDaJieJieDaoBanShiChu,361002002,36558,3107,22113,12227,31192,18287,7406,18529,36816,24958,47071
·ֵ´,JingGongLuJieDaoBanShiChu,361002003,31550,3164,21343,15449,30971,19873,7869,20125,39998,21240,42583
ˮŽֵ´,LiuShuiQiaoJieDaoBanShiChu,361002004,32036,3206,20494,13341,28584,18563,7177,18855,37418,21925,42419
Ĳֵ´,WenChangJieDaoBanShiChu,361002005,33577,3244,21782,13093,27219,21536,8238,22794,44330,23277,45059
ֵ´𳲿,ChengXiJieDaoBanShiChuJinChaoKaiFaQu,361002091,14356,1149,9732,5950,10232,9659,4707,10323,19982,10480,20212
ֵ´𳲿,ZhongLingJieDaoBanShiChuJinChaoKaiFaQu,361002092,26071,2425,17528,7610,25660,13251,6333,14087,27338,17301,34829
϶ٶ,ShangDunDuZhen,361002100,79255,7883,55759,34105,95433,54640,30300,59989,114629,61679,117438
Ȫ,WenQuanZhen,361002101,18364,2338,14064,7346,26225,13182,9230,14464,27646,15868,29932
ƺ,GaoPingZhen,361002102,14920,2251,12043,6398,23745,11937,8030,12948,24885,13158,25201
Ϫ,QiuXiZhen,361002103,13947,1914,10183,5388,20976,10047,5971,11376,21423,11649,21832
ɽ,RongShanZhen,361002104,14072,1668,9697,5467,19855,9348,4864,10297,19645,10907,20604
Ϫ,LongXiZhen,361002105,7789,1307,6917,4365,12110,6844,4828,6854,13698,7007,13924
,DaGangZhen,361002107,21880,2595,14392,7674,29748,14392,6445,16528,30920,16528,30920
ɽ,YunShanZhen,361002108,27133,2709,18708,10214,36204,17522,11794,19881,37403,22928,41636
,ChangKaiZhen,361002109,29260,3482,21376,11408,41823,21229,11755,22862,44091,23121,44497
,LuoZhenZhen,361002110,31308,3568,21686,11882,44086,21601,11110,24175,45776,24300,45986
޺,LuoHuZhen,361002111,42311,4374,29917,13857,56600,29521,14926,30899,60420,31694,61611
̫,TaiYangZhen,361002112,11591,1376,8714,4741,17485,8628,5239,9297,17925,9492,18206
,DongGuanZhen,361002113,12776,1366,8811,4715,18384,8704,4603,9810,18514,9934,18745
,TengQiaoZhen,361002114,17963,1857,12236,6888,25625,11936,6464,13539,25475,14048,26284
,QingNiZhen,361002115,9166,1821,8673,5900,17929,8657,7486,9719,18376,9800,18473
Т,XiaoQiaoZhen,361002116,17987,1825,11811,6840,22779,11761,5266,13199,24960,13267,25078
,FuBeiZhen,361002117,6407,716,4264,2610,7797,4240,1857,4654,8894,4716,8980
򣨽𳲿,ChongGangZhenJinChaoKaiFaQu,361002190,16380,1821,11922,6697,22851,11773,6682,12587,24360,12961,24883
չƺ,ZhanPingXiang,361002200,13700,1422,9042,4897,17359,8756,4474,9533,18289,10554,19596
,LianChengXiang,361002201,12506,1516,9210,5089,18004,9148,5055,9730,18878,9867,19077
ͩԴ,TongYuanXiang,361002202,15778,1911,11431,6157,22455,11376,6087,12237,23613,12345,23776
,HuNanXiang,361002203,30388,3050,20546,11352,41163,20538,10011,22889,43427,22903,43449
,QiLiGangXiang,361002204,9927,1218,7607,4479,15167,7420,4733,8023,15443,8271,15878
Ժ,SongHuXiang,361002205,10209,1597,8165,4983,16261,8165,5195,8836,17001,8836,17001
,PengTianXiang,361002206,4498,751,3737,2805,7652,3730,2705,4199,7929,4217,7954
é,MaoPaiXiang,361002207,2753,376,1976,1209,4064,1835,1204,2103,3938,2357,4333
Ӳ,HeBuXiang,361002208,4603,815,3624,2737,7217,3619,2212,3987,7606,4006,7630
ɽֳ,RongShanKenZhiChang,361002400,276,29,180,134,341,180,84,208,388,209,389
ڿֳ,QiLiGangKenZhiChang,361002401,139,39,110,79,202,110,43,111,221,111,221
ίԱ,KaiFaQuGuanLiWeiYuanHui,361002500,26,1,3,2,3,2,0,2,4,24,27
,JianChangZhen,361021100,79925,6381,54400,29607,85091,52556,22802,53783,106339,54708,109108
,ZhuLiangZhen,361021101,26089,2249,17496,9691,35216,17482,8066,18776,36258,18908,36404
,ShangTangZhen,361021102,19780,1953,13194,7037,26765,13107,5587,13890,26997,14126,27320
,LiTaZhen,361021103,12709,1111,8550,4777,17359,8525,3887,9120,17645,9157,17707
,HongMenZhen,361021104,8015,785,5458,3137,10883,5413,2421,5650,11063,5763,11221
ɳ,ShaZhouZhen,361021105,9598,751,6533,3314,12866,6514,3322,7075,13589,7138,13671
,LongHuZhen,361021106,12047,1474,8250,4704,16729,8031,3678,8592,16623,8949,17199
·,XinFengJieZhen,361021107,5546,646,3843,2124,7332,3831,1589,3887,7718,3938,7781
,WanFangZhen,361021108,17432,1554,11772,6274,23754,11649,5449,12481,24130,12663,24435
,XuJiaXiang,361021200,14905,1362,10426,5163,21097,10301,5254,10854,21155,11095,21521
쾮Դ,TianJingYuanXiang,361021201,9480,1002,6475,3495,12786,6470,2885,6870,13340,6892,13367
Ϫ,XunXiXiang,361021203,4551,479,3030,1736,6232,2984,1472,3382,6366,3472,6502
շ,RiFengZhen,361022100,60667,5718,40476,25880,63788,39199,16282,40898,80097,42191,82667
,HongCunZhen,361022101,9919,1040,6461,3358,13179,6364,2559,6911,13275,7057,13518
䭿,XunKouZhen,361022102,7083,870,4807,2616,9691,4785,2097,5220,10005,5243,10050
ܴ,XiongCunZhen,361022103,10034,1219,6564,4190,13863,6548,2893,7531,14079,7582,14146
,LongAnZhen,361022104,10121,979,6550,3507,13711,6528,2815,7318,13846,7365,13915
ʤ,DeShengZhen,361022105,7448,1084,5350,3187,10763,5323,2640,5734,11057,5822,11172
̶Ϫ,TanXiXiang,361022200,13551,1232,8829,4613,18027,8811,3628,9548,18359,9582,18411
,HuFangXiang,361022201,6011,732,4068,2202,8421,4051,1856,4494,8545,4531,8599
Դ,HeYuanXiang,361022202,6246,611,4072,2378,8240,4070,1610,4384,8454,4395,8467
,HouCunXiang,361022203,5296,623,3464,1945,7158,3421,1493,3868,7289,3948,7412
ƻ,ShePingXiang,361022204,5655,620,3609,2116,7584,3604,1391,4035,7639,4057,7666
Ϫ,ZhangXiXiang,361022205,4864,551,3339,1825,6612,3316,1354,3374,6690,3430,6769
,XiChengXiang,361022206,6388,682,4082,2124,8532,4075,1576,4544,8619,4564,8646
,ZhongTianXiang,361022207,9968,869,6645,3365,13461,6582,2858,6942,13524,7050,13695
ɽֳ,HuaShanKenZhiChang,361022400,2160,263,1435,804,2989,1435,625,1613,3048,1613,3048
ʤҵ,DeShengQiYeJiTuan,361022500,1416,177,915,526,1867,915,312,989,1904,990,1905
ٳ,QinChengZhen,361023100,74120,5840,49325,29737,75917,48143,20027,49250,97393,50662,99987
̫,TaiHeZhen,361023101,14837,1443,9733,5339,19687,9646,3917,10312,19958,10464,20197
,BaiSheZhen,361023102,25937,2408,17494,9211,34183,17324,8485,18996,36320,19336,36830
ɽ,ShiShanZhen,361023103,26124,2018,17250,9219,33071,17223,8008,18865,36088,18900,36150
Ǣ,QiaWanZhen,361023104,11494,1060,7530,4141,15245,7513,3271,8184,15697,8295,15825
ɣ,SangTianZhen,361023105,9272,826,6113,3582,12305,6113,2624,6609,12722,6609,12722
,ZiXiaoZhen,361023106,8981,1155,6222,3406,12155,6207,2643,6489,12696,6557,12779
Ϫ,SanXiXiang,361023200,7470,745,4728,2702,9774,4706,1937,5344,10050,5424,10152
ƺ,DongPingXiang,361023201,3919,474,2821,1727,5577,2779,1416,2891,5670,2988,5809
Ϫ,LaiXiXiang,361023202,11112,1047,7436,4170,14630,7413,3153,7846,15259,7876,15312
̫Դ,TaiYuanXiang,361023203,6084,612,3768,2229,7523,3748,1584,4219,7967,4512,8280
,FuFangXiang,361023204,9601,1041,6495,3470,12887,6445,2702,6770,13215,6849,13344
Ϸسֳ,NanFengXianZhangHongKenZhiChang,361023400,162,47,101,89,141,101,23,131,232,131,232
ϷṤҵ԰,NanFengGongYeYuanQu,361023500,310,1,184,0,18,0,2,0,0,129,313
ɽ,BaShanZhen,361024100,69607,6394,50665,25886,78155,47950,27747,51925,99875,53083,103748
ɽ,XiangShanZhen,361024101,16362,1565,10883,6243,22451,10866,5369,12399,23265,12413,23296
,HangBuZhen,361024102,19322,1583,14834,6360,29234,14771,9137,15033,29804,15208,30042
ﷻ,SunFangZhen,361024103,13072,1252,9568,5018,19974,9542,5908,10539,20081,10664,20232
,HeShangZhen,361024104,16031,1759,11876,5735,24167,11750,7327,12870,24620,13241,25117
,LiBeiZhen,361024105,8104,927,5622,2956,11587,5194,2864,5632,10826,6273,11895
�,MaAnZhen,361024106,12096,1314,8797,4175,17899,8797,5021,9634,18431,9634,18431
ʯׯ,ShiZhuangXiang,361024200,8079,717,5470,2658,11046,5447,2733,6009,11456,6059,11529
,LiuJiaQiaoXiang,361024201,12088,1070,8838,3802,17713,8727,5633,9686,18413,9953,18791
·,BaiLuXiang,361024202,11288,1173,7968,3897,16661,7802,4697,8875,16677,9190,17158
ɽ,SanShanXiang,361024203,8349,949,6185,2993,12509,6176,3623,6701,12877,6736,12921
,BaiBeiXiang,361024204,7599,731,5402,2744,11324,5396,3171,6070,11466,6099,11501
Դ,TaoYuanXiang,361024205,11462,1062,7497,3939,15623,7496,3515,8536,16032,8542,16039
�,XuFangXiang,361024206,8385,785,5924,2899,11703,5900,3098,6286,12186,6344,12268
,GuoWeiXiang,361024207,10295,1010,7046,3653,14494,6938,3564,7620,14558,7823,14869
Ϫ,AoXiZhen,361025100,59575,4588,39741,24120,64938,38792,18554,41786,80578,42976,82717
Ϫ,GongXiZhen,361025101,19082,2501,12914,7883,25080,12653,5971,14108,26761,14640,27554
ɽ,ShanDangZhen,361025102,14708,1627,9989,5653,20478,9942,5295,11502,21444,11641,21630
,GongFangZhen,361025103,12478,1588,8872,5709,18170,8749,4802,9714,18463,9996,18868
,DaiFangZhen,361025104,22514,2503,15278,8196,31538,14759,7779,16640,31399,17518,32796
ţ,NiuTianZhen,361025105,12965,1445,9326,5264,19121,9307,5315,10375,19682,10399,19725
,WanChongZhen,361025106,9195,957,6581,3480,13020,6581,3787,7358,13939,7358,13939
,ZengTianZhen,361025107,12878,1313,8343,5207,17612,8342,3882,9725,18067,9730,18073
Я,ZhaoXieZhen,361025108,15427,1684,10495,5843,21212,10495,5108,11724,22219,11724,22219
Ϫ,HuXiXiang,361025200,7342,1002,5000,2881,10247,4996,2291,5611,10607,5635,10635
,LuoBeiXiang,361025201,9405,1081,7088,4017,14178,7001,4334,7523,14524,7732,14820
ƺ,HuPingXiang,361025202,11592,1332,8363,4669,16467,8322,4592,9139,17461,9153,17516
ϴ,NanCunXiang,361025203,14446,1462,9367,5689,19480,9339,4500,10989,20328,11041,20408
ȸ,GuGangXiang,361025204,8360,954,5494,3625,11545,5493,2623,6441,11934,6443,11937
,JinZhuSheZuXiang,361025205,8162,909,5274,3143,11067,5250,2286,6022,11272,6083,11357
ͷֳ,DaMaTouKenZhiChang,361025400,1110,121,748,434,1487,739,341,799,1538,824,1572
,FengGangZhen,361026100,46903,4024,31903,18646,59594,31770,13788,32584,64354,32812,64715
,TangYinZhen,361026101,11446,1112,7900,4329,15898,7653,3635,7950,15603,8293,16193
,HuangBeiZhen,361026102,16840,1620,11217,5917,21977,11203,5034,12233,23436,12277,23494
,DongBeiZhen,361026103,8284,896,5652,2975,10340,5642,2374,5875,11517,5902,11554
Ϫ,LiXiZhen,361026104,13451,986,8794,4155,17833,8501,3835,9022,17523,9478,18272
,ErDouZhen,361026105,11256,1003,7684,4182,15097,7586,3572,7916,15502,8147,15831
и,ZhongGangXiang,361026200,14518,1249,9690,4860,19679,9448,4455,10036,19484,10532,20222
·,XinFengXiang,361026201,5250,564,3426,1733,6950,3416,1427,3774,7190,3815,7241
,ShenGangXiang,361026202,7567,688,5090,2665,10257,5042,2147,5227,10269,5312,10402
ڿ,ZhenKouXiang,361026203,7972,850,5501,2820,10862,5424,2359,5526,10950,5680,11181
Դ,NanYuanXiang,361026204,6264,585,4222,2222,8556,4099,1877,4281,8380,4504,8726
,TaoBeiXiang,361026205,9985,894,6899,3323,13677,6638,3168,6766,13404,7148,14047
ưֳ,HuangBoLingKenZhiChang,361026400,246,46,162,79,329,113,39,122,235,169,331
ֳ,QingNianKenZhiChang,361026401,233,22,140,56,283,114,40,120,234,155,295
˻عҵ԰,YiHuangXianGongYeYuanQu,361026500,1529,5,624,1,0,0,1,1,1,911,1535
,XiuGuZhen,361027100,57917,4321,39534,23064,66077,38738,18915,40587,79325,41619,81153
,HuWanZhen,361027101,18428,1827,12139,7503,24554,12104,5116,13180,25284,13232,25371
˫,ShuangTangZhen,361027102,8005,739,5292,2780,10584,5278,2223,5654,10932,5675,10967
Դ,HeYuanZhen,361027103,11013,1023,7458,3704,14906,7449,3246,7789,15238,7824,15282
,HeShiZhen,361027104,16720,1508,11066,5866,22191,10992,4976,11946,22938,12138,23204
,LangJuZhen,361027105,18810,1632,12505,6768,25560,12494,6175,14078,26572,14112,26617
,ZuoFangZhen,361027106,14991,1289,9858,5057,20167,9838,4620,10978,20816,11042,20900
ͨ,HuangTongXiang,361027200,7451,623,4990,2590,10016,4958,2380,5295,10253,5464,10454
,DuiQiaoXiang,361027201,12353,1070,8408,4104,16673,8181,3939,8648,16829,8954,17362
½,LuFangXiang,361027202,10414,894,7124,3528,14473,7119,3460,7635,14754,7644,14768
·,ChenFangJiXiang,361027203,7731,598,5004,2488,10604,4944,2436,5666,10610,5761,10765
,LiuLiXiang,361027204,15729,1192,10505,6143,21333,10449,5273,11548,21997,11689,22194
ʯ,ShiMenXiang,361027205,9771,891,6622,3287,13646,6528,3311,7147,13675,7351,13973
ũ,HuaQiaoNongChang,361027400,1261,124,875,550,1530,874,431,938,1812,941,1816
׳,HeChengZhen,361028100,30517,3227,20619,12262,33855,20007,8397,20111,40118,21522,42141
ͷɽ,MaTouShanZhen,361028101,8073,932,5533,2860,10767,5444,2202,5510,10954,5674,11207
߸,GaoFuZhen,361028102,11370,1158,7850,4113,15132,7802,3574,8131,15933,8252,16102
,SongShiZhen,361028103,6860,732,4680,2554,8846,4464,1971,4543,9007,4883,9563
ʯ,WuShiZhen,361028104,10054,1252,7174,3918,13867,7076,2855,6754,13830,6987,14161
,GaoTianXiang,361028200,9626,954,6864,3569,13104,6828,2879,6478,13306,6595,13459
ʯϿ,ShiXiaXiang,361028201,3770,418,2692,1504,5169,2675,1162,2592,5267,2658,5350
Т,XiaoGangZhen,361029100,94031,6894,59766,35830,104434,58415,26151,64255,122670,67310,127076
С,XiaoHuangZhen,361029101,24895,2884,17533,8400,35261,17392,8986,18906,36298,19232,36765
,WeiShangQiaoZhen,361029102,15349,1569,9877,5737,20222,9797,3931,10807,20604,10972,20849
,MaWeiZhen,361029103,30039,3057,20519,10169,41418,20233,10244,22236,42469,22821,43340
ղ,ZhanWeiZhen,361029104,19346,1880,12908,6984,27119,12908,6303,14620,27528,14621,27529
ϻ,GangShangJiZhen,361029105,13663,1551,9280,5203,18700,9202,4489,10176,19378,10423,19703
ŵ,YangQiaoDianZhen,361029106,23906,2772,15979,7717,32722,15465,6674,16510,31975,17373,33352
,LiWeiZhen,361029107,10559,953,6657,3617,13896,6587,2707,7416,14003,7562,14219
,WangQiaoZhen,361029108,10775,1040,7224,3536,14453,7075,3440,7724,14799,8031,15255
\,PoGanXiang,361029200,10755,1210,7406,3460,14858,7279,3931,7981,15260,8490,15896
˼,DengJiaXiang,361029201,15542,1473,10071,5277,20306,9735,3991,10456,20191,10935,21006
,HuWeiXiang,361029202,11969,1231,7853,4095,15882,7720,3388,8489,16209,8735,16588
,YaoWeiXiang,361029203,8363,711,5507,2601,11200,5438,2591,5990,11428,6158,11665
ҵ,HongXingQiYeJiTuan,361029400,10241,1587,7123,4729,13697,7111,2796,7481,14592,7501,14624
ֳ,HongGuangKenZhiChang,361029401,2789,284,1835,779,3339,1562,720,1691,3253,1958,3793
ֳ,HongLiangKenZhiChang,361029402,1372,181,927,624,1643,925,404,1013,1938,1030,1957
ʿֳ,GanKengLinChang,361029403,5353,482,3462,1808,7110,3424,1513,3816,7240,3886,7348
ͭҵŹ˾ͬҵι˾,JiangXiTongYeJiTuanGongSiDongTongKuangYeYouXianZeRenGongSi,361029404,2643,517,1806,1449,2548,1653,580,1623,3276,1934,3740
׷ʳ,JiangXiLinFeiChang,361029405,2100,673,1499,1913,2881,1499,528,1802,3301,1802,3301
ؾÿ,DongXiangXianJingJiKaiFaQu,361029406,308,1,93,24,0,16,4,30,46,220,313
콭,XuJiangZhen,361030100,63558,5720,43191,24542,76029,43060,18181,44064,87124,44268,87459
ͷ,TouBeiZhen,361030101,16739,1790,11099,6442,22446,11012,4551,11886,22898,11981,23080
ˮ,ChiShuiZhen,361030103,13601,1551,9222,5215,19016,9218,4235,10146,19364,10165,19387
ǰ,YiQianZhen,361030104,17381,1715,11047,5954,22918,11026,4167,12179,23205,12216,23263
,GanZhuZhen,361030105,18907,1474,11978,5626,24789,11931,4783,13122,25053,13186,25164
ǧ,QianShanXiang,361030200,3938,404,2595,1376,5229,2565,1065,2759,5324,2812,5407
ˮ,ShuiNanWeiXiang,361030201,4375,462,2876,1420,5762,2849,1181,3103,5952,3142,6018
,ChangQiaoXiang,361030202,4247,531,2905,1756,5912,2899,1277,3138,6037,3150,6055
Ϫ,YangXiXiang,361030203,3731,436,2419,1253,4935,2418,883,2620,5038,2631,5050
,JianFengXiang,361030204,9236,1387,6074,4169,12913,5986,2611,6868,12854,7160,13234
,TangFangXiang,361030205,13878,1339,9007,4402,18442,8956,4035,9742,18698,10245,19252
ɽֳ,CuiLeiShanKenZhiChang,361030400,711,122,468,318,844,451,124,448,899,489,957
عҵ԰,GuangChangXianGongYeYuanQu,361030500,847,53,477,238,890,469,169,502,971,592,1069
ˮϽֵ´,ShuiNanJieDaoBanShiChu,361102001,33441,3887,23044,12305,37457,20808,6576,20249,41057,20860,43904
нֵ´,DongShiJieDaoBanShiChu,361102002,52804,5995,35125,21245,57747,34011,10318,33073,67084,33992,69117
нֵ´,XiShiJieDaoBanShiChu,361102003,50790,6851,34145,21928,52732,33238,9195,31813,65051,32691,66836
Žֵ´,BeiMenJieDaoBanShiChu,361102004,41088,3489,27907,15081,33999,24345,9294,24535,48880,25964,53871
éֵ,MaoJiaLingJieDao,361102005,38575,2233,25287,10352,26877,18391,8595,18870,37261,24116,49403
ɳϪ,ShaXiZhen,361102100,27681,3734,21325,11000,40046,21195,11558,21405,42600,21648,42973
Ϫ,LingXiZhen,361102101,20391,1934,14702,6949,27031,14639,7385,14694,29333,15008,29710
ط,QinFengXiang,361102201,19420,2445,14301,7703,29128,14301,7513,15077,29378,15077,29378
,ZhaoYangXiang,361102202,20883,2278,15213,7467,28216,14911,7866,15112,30023,15814,31027
սֵ´,XuRiJieDaoBanShiChu,361121001,60786,3410,41290,23126,53567,39606,18963,39862,79468,41869,83159
Žֵ´,LuoQiaoJieDaoBanShiChu,361121002,21049,1623,13701,5758,22517,11516,5847,11625,23141,14818,28519
԰ֵ´,XingYuanJieDaoBanShiChu,361121003,14884,1232,9736,4221,13265,8410,4150,8536,16946,10530,20266
,TianDunZhen,361121101,32280,3433,23804,10791,45046,23677,13141,24763,48440,25050,48854
,ShangLuZhen,361121102,16538,1599,11612,5487,23121,11354,6001,12131,23485,12526,24138
̳ɽ,HuaTanShanZhen,361121103,12079,1598,8647,4747,16744,8615,4697,9461,18076,9727,18374
ͤ,ChaTingZhen,361121104,27185,2297,19176,8627,36406,19129,10135,20295,39424,20441,39617
ͷ,ZaoTouZhen,361121105,21111,2003,14839,7677,26802,14759,7414,15297,30056,15689,30528
ʮ,SiShiBaZhen,361121106,13478,1561,9628,4626,18611,9577,5318,10451,20028,10729,20357
ͷ,FengLingTouZhen,361121107,20091,2332,14402,6956,27325,13598,7270,13954,27552,15291,29693
͹,HuangGuZhen,361121108,27461,3331,20828,10742,38762,20535,11414,20925,41460,21378,42206
,HuaTingZhen,361121109,21608,1848,14865,7895,29473,14844,7449,15975,30819,16040,30905
帮ɽ,WuFuShanZhen,361121110,11380,1418,7925,4479,14964,7807,4118,8288,16095,8991,16916
֣,ZhengFangZhen,361121111,15041,2027,11063,5765,20878,10927,6225,11605,22532,12230,23293
,WangXianXiang,361121200,6418,1172,5619,3426,10341,5618,3858,5829,11447,5829,11448
ʯ,ShiRenXiang,361121201,16943,2272,12891,6991,25048,12891,7794,14118,27009,14118,27009
ˮ,QingShuiXiang,361121202,14733,1705,11173,5684,21730,11168,5982,11219,22387,11247,22420
ʯʨ,ShiShiXiang,361121203,13885,1207,9885,4734,17931,9833,4747,9840,19673,9954,19839
,HuCunXiang,361121204,25670,3098,18598,9169,37173,18578,10220,20351,38929,20390,38988
,ZunQiaoXiang,361121207,18305,1739,13159,6034,26516,12964,7151,13744,26708,14036,27195
Ӧ,YingJiaXiang,361121209,16878,1783,12137,5365,23323,12095,6718,13113,25208,13242,25379
ɳ,HuangShaLingXiang,361121210,13719,1427,10267,5007,19601,10204,5596,10333,20537,10475,20742
ɽ,TieShanXiang,361121211,7984,1019,5702,2930,11561,5691,3172,6458,12149,6473,12175
,DongTuanXiang,361121290,24713,2600,18800,9276,36762,18683,10934,19319,38002,19447,38247
ֵ´,YongFengJieDaoBanShiChu,361122001,72416,5612,52327,21336,89867,50863,27929,52223,103086,53630,105957
«ֵֽ´,LuLinJieDaoBanShiChu,361122002,25429,1879,17982,7456,31004,16651,8657,16992,33643,17983,35965
Ϫֵ´,FengXiJieDaoBanShiChu,361122003,34092,2720,23324,10940,35655,20918,9988,20637,41555,23476,46800
嶼,WuDouZhen,361122101,41803,4570,29796,14475,56607,29518,14396,30670,60188,30973,60769
,YangKouZhen,361122102,44379,4398,31461,16874,59797,31309,15323,32225,63534,32639,64100
ɽ,HengShanZhen,361122103,23395,2709,17188,7975,32773,17162,8993,17847,35009,17909,35097
ͩ,TongFanZhen,361122104,21687,3125,16986,8534,32739,16925,9870,17613,34538,17696,34682
,HuFengZhen,361122105,13732,1818,10367,5342,19341,10258,5714,10473,20731,10897,21264
,DaNanZhen,361122106,10636,1416,7860,4189,14985,7672,4123,7876,15548,8315,16175
ɽ,PaiShanZhen,361122107,18644,2146,13626,6956,26723,13519,6980,13968,27487,14144,27770
ë,MaoCunZhen,361122108,12178,1504,8674,4545,16436,8616,4542,9401,18017,9550,18224
ŵ,JianDiZhen,361122109,12747,1331,9421,4514,17806,9412,5133,9753,19165,9790,19211
Ȫ,QuanBoZhen,361122110,13508,1990,9995,4877,19906,9985,5261,10719,20704,10764,20759
,HuQiaoZhen,361122111,14065,1858,10660,5317,20439,10655,6028,11277,21932,11291,21951
ϼ,XiaFengZhen,361122112,20169,2182,14927,7291,29048,14927,7966,15386,30313,15390,30317
Ϫ,XiaXiZhen,361122113,22086,1991,15692,7116,27417,15506,7413,15607,31113,15798,31490
,WuCunZhen,361122114,27490,2314,18576,9174,37137,18349,8902,19721,38070,20130,38706
ɳ,ShaTianZhen,361122115,17694,2230,13532,6540,25742,13528,7488,13838,27366,13880,27412
ͭɽ,TongBoShanZhen,361122116,9217,1336,6978,3712,13785,6960,3937,7450,14410,7512,14490
ʯ,DaShiXiang,361122200,16273,1849,11912,5211,22830,11884,6036,12215,24099,12246,24158
,DongYangXiang,361122202,12774,2022,9530,5563,18338,9501,4326,9517,19018,9592,19122
Է,SongFengXiang,361122204,11625,1694,8665,4986,17065,8663,4783,9433,18096,9437,18102
,ShaoYangXiang,361122206,12585,1581,9784,4909,18494,9779,5468,9811,19590,9850,19634
ͭɽֳ,TongBaShanKenZhiChang,361122500,487,150,376,315,768,373,161,410,783,422,798
ְ´,FengLinBanShiChu,361123001,6237,922,4988,2852,9560,4983,2814,4980,9963,4985,9973
Ϫ,BingXiZhen,361123100,119479,8238,74737,32675,100084,61830,29657,62058,123888,82637,157374
ٺ,LinHuZhen,361123101,17845,2630,14797,7803,27444,14190,9854,14640,28830,15532,30329
ķ,BiMuZhen,361123102,16874,2370,13426,7208,25392,12842,7958,13224,26066,13776,27202
,HengJieZhen,361123103,18458,2636,13885,7603,26626,13758,7192,14168,27926,14401,28286
ĳ,WenChengZhen,361123104,17601,2233,13215,7269,24442,13044,7037,13343,26387,13656,26871
,XiaZhenZhen,361123105,23071,3560,18567,10515,34093,17893,9943,17116,35009,18007,36574
,YanRuiZhen,361123107,30890,3841,21449,13295,40257,20430,10288,21427,41857,23570,45019
˫,ShuangMingZhen,361123108,14728,2248,11123,6351,21292,10679,5805,10940,21619,11658,22781
Ϻ,ZiHuZhen,361123109,12129,1848,9207,4932,17713,9126,4773,9311,18437,9543,18750
,XianYanZhen,361123110,15304,2860,11058,6453,21861,10585,5239,11430,22015,12345,23403
,ZhangCunZhen,361123111,17864,2609,14469,7406,25619,13398,8287,13010,26408,14291,28760
ɽ,NanShanXiang,361123200,8478,1169,6225,3329,12589,6046,3491,6609,12655,6913,13138
,HuaiYuXiang,361123201,10886,1858,8757,4951,16306,8581,4821,8289,16870,8808,17565
,XiaTangXiang,361123202,12495,1644,9792,5468,19021,9552,5972,9915,19467,10319,20111
Ĺ,SiGuQiaoXiang,361123203,16903,2187,12576,7285,23751,12307,6665,12716,25023,13179,25755
,LiuDouXiang,361123204,24131,3100,18030,10265,34194,17314,10028,17536,34850,19229,37259
,SanQingXiang,361123290,3205,494,2541,1488,4884,2541,1520,2678,5219,2678,5219
ӿ,HeKouZhen,361124100,47169,4755,32374,17894,58555,31859,13302,32053,63912,32852,65226
ƽ,YongPingZhen,361124101,32558,3197,22020,11738,43136,21742,9350,22668,44410,23085,45105
ʯ,ShiTangZhen,361124102,11698,1157,7926,4099,15934,7924,3403,8288,16212,8332,16258
,EHuZhen,361124103,36601,3510,25719,14035,51490,25690,13530,27825,53515,27922,53641
,HuFangZhen,361124105,17971,1857,12764,6650,23823,12716,6506,13449,26165,13570,26334
ɽ,WuYiShanZhen,361124106,16364,1810,11036,6278,21747,10973,4995,11626,22599,12133,23169
,WangErZhen,361124108,23717,2451,15942,8566,31628,15867,7254,17171,33038,17480,33422
·,ChenFangXiang,361124200,8170,921,5469,2991,11304,5433,2410,5958,11391,6032,11501
,HongQiaoXiang,361124201,11919,1083,8128,4096,16255,8119,4267,9135,17254,9141,17269
̲,XinTanXiang,361124202,22248,1815,14858,6938,30169,14797,7317,16447,31244,16522,31380
ɽ,GeXianShanXiang,361124203,22400,1938,15205,7373,30634,15149,7950,16912,32061,17083,32288
,JiaXuanXiang,361124205,14004,1258,9362,4651,19105,9275,4327,10049,19324,10227,19589
Ӣ,YingJiangXiang,361124206,8648,697,5703,2790,11985,5692,2704,6338,12030,6346,12049
Ϫ,ZiXiXiang,361124207,12764,1166,8774,4294,17547,8710,3865,8911,17621,9021,17795
̫Դ,TaiYuanSheZuXiang,361124208,1400,215,932,472,1923,831,356,892,1723,1039,1971
ɽ,TianZhuShanXiang,361124209,4908,501,3086,1632,6491,3035,1441,3493,6528,3764,6850
,HuangBiSheZuXiang,361124210,2587,253,1762,796,3485,1749,721,1763,3512,1799,3561
ͭҵŹ˾ֹͭ˾,JiangXiTongYeJiTuanGongSiYongTongFenGongSi,361124406,7021,993,4428,3586,7963,4392,1091,4454,8846,4677,9105
ǦɽعӪɭ,QianShanXianGuoYingSenLinMiaoPu,361124501,348,25,243,127,467,243,112,242,485,242,485
˰ֵ´,XingAnJieDaoBanShiChu,361125001,51631,3709,32651,19135,38305,31566,13088,33970,65536,35777,68428
,CenYangZhen,361125100,8514,1100,6087,3851,11834,6067,2934,6392,12459,6461,12548
Դ,GeYuanZhen,361125101,9807,1968,8013,5635,15484,7956,4424,8083,16039,8186,16199
Ҧ,YaoJiaXiang,361125200,7931,905,5406,3099,11045,5389,2708,6073,11462,6138,11544
,LianHeXiang,361125201,10830,1426,8189,4952,16232,8134,4725,8701,16835,8792,16981
˾,SiPuXiang,361125202,5325,751,4129,2546,8231,4113,2473,4314,8427,4420,8549
۱,GangBianXiang,361125203,5898,1226,4951,3386,9841,4951,2938,5111,10062,5111,10062
,LongMenFanXiang,361125204,11122,1684,8674,5537,17224,8672,4678,8805,17477,8810,17484
,QingBanXiang,361125205,7642,1242,5698,3853,11672,5693,3068,6238,11931,6254,11952
ǰú,PuQianMeiKuang,361125400,581,83,379,356,513,379,121,403,782,406,785
ſֳ,HongQiaoKenZhiChang,361125500,1320,131,923,522,1318,923,452,980,1903,980,1903
ϿԴֳ,ShangKengYuanLinChang,361125502,201,96,180,210,375,180,79,196,376,196,376
ɽֳ,ShanHuangLinChang,361125503,296,28,182,163,400,182,80,222,404,222,404
´,XinHuangBanShiChu,361125504,5326,590,3615,2053,7524,3597,1739,4000,7597,4040,7655
Ϫ,CaoXiZhen,361126101,15739,1573,11065,6138,22797,10866,6345,12176,23042,12592,23657
Ṥ,QiGongZhen,361126102,19788,2511,14076,7416,29494,13966,7503,15555,29521,15726,29802
,ZhangShuDunZhen,361126103,6792,1141,4760,2401,9982,4691,2236,5268,9959,5409,10169
,NanYanZhen,361126104,25775,2467,17513,10029,28789,17178,8045,18003,35181,18774,36287
,ZhuKengZhen,361126105,15373,1457,10470,5428,21721,10259,5377,11251,21510,11737,22207
,GuiFengZhen,361126106,17584,2049,12085,6301,25110,12038,6636,14086,26124,14184,26269
ɽ,DieShanZhen,361126107,7740,925,5233,2766,10348,5092,2254,5455,10547,5686,10919
ۿ,GangKouZhen,361126108,9537,1151,6850,3650,13477,6820,3505,7272,14092,7343,14193
߮,YiJiangZhen,361126109,52142,5971,34208,20803,58788,33333,12428,34748,68081,36333,70541
,SanXianLingXiang,361126200,9964,1222,7211,4657,14064,7134,4291,7899,15033,8266,15477
,ZhongFanXiang,361126202,18612,2206,13251,7581,28290,13250,7943,15505,28755,15510,28761
Ϫ,GeXiXiang,361126203,13254,1440,9148,4381,18929,9138,4851,10361,19499,10397,19545
,WanLiXiang,361126204,10650,1081,7468,4121,15359,7377,4082,8211,15588,8345,15813
,QingHuXiang,361126206,9139,884,6308,3364,13020,6298,3337,7003,13301,7052,13360
ͤ,HuaTingXiang,361126400,6702,788,4466,2493,8115,4447,1894,4845,9292,4918,9384
,XuGuangXiang,361126401,5024,638,3286,1946,6292,3181,1333,3468,6649,3709,6995
ͤ,YuTingZhen,361127100,88127,7478,58501,31306,103733,57964,26629,62894,120858,63733,122234
,RuiHongZhen,361127101,45737,4924,31495,17126,64627,31330,15030,33884,65214,34196,65691
ƽ,HuangJinBuZhen,361127102,45509,4313,30569,15538,62080,30222,14825,33240,63462,34078,64647
Ų,GuBuZhen,361127104,37698,3590,26394,12338,54251,26308,13818,28622,54930,28712,55106
,WuNiZhen,361127105,6898,655,4668,2414,9569,4610,2273,5007,9617,5158,9826
ʯ,ShiKouZhen,361127106,24967,2561,17270,8975,35597,17270,8817,19074,36344,19075,36345
,YangBuZhen,361127107,20462,2037,14214,6457,29449,14110,7523,15595,29705,15808,30022
,JiuLongZhen,361127108,18883,1752,12953,6387,26678,12907,6410,13996,26903,14092,27045
ɽ,KangShanXiang,361127200,6658,711,4421,2543,9189,4400,1907,4806,9206,4855,9276
,DongTangXiang,361127202,12482,1270,8204,3746,17134,8160,3557,8975,17135,9105,17309
,DaTangXiang,361127204,5792,555,3994,1842,7995,3994,1916,4269,8263,4269,8263
,LuSiGangXiang,361127206,19581,1966,13403,6154,27725,13273,6744,14757,28030,14888,28291
,SanTangXiang,361127207,46302,5052,32167,16007,65756,32039,16065,35033,67072,35252,67419
,HongJiaZuiXiang,361127209,52102,5542,36978,16479,73083,36835,18789,39094,75929,39455,76433
,BaiMaQiaoXiang,361127210,26627,2375,18494,8366,38065,18269,10212,20238,38507,20720,39214
,JiangBuXiang,361127211,28205,3149,20328,9444,41990,20226,11084,21986,42212,22110,42438
,FengGangXiang,361127213,29203,2956,20229,10067,41087,20229,9883,21813,42042,21813,42042
Ϫ,DaXiXiang,361127214,20297,2030,13891,6265,28904,13861,7076,15460,29321,15512,29403
÷,MeiGangXiang,361127217,37290,3509,25278,10782,52371,24318,12124,26148,50466,27645,52923
,SheGengXiang,361127218,22558,2350,15918,8196,32098,15896,8122,17065,32961,17112,33030
غˮ,YuChiHuShuiChanChang,361127500,577,54,385,207,715,377,138,363,740,384,769
ֳ,XianLiangZhongChang,361127501,755,95,508,234,1017,500,174,499,999,516,1024
÷ֳ,LiMeiLinChang,361127502,846,122,662,376,1237,662,396,702,1364,702,1364
ɽֳ,KangShanKenZhiChang,361127503,7118,434,4045,2513,9240,3714,1778,4390,8104,5285,9330
ֳ,HeHuLingKenZhiChang,361127504,4870,678,3458,1691,6229,3453,1524,3607,7060,3614,7072
Ͽɽֳ,XiaShanLinChang,361127505,3201,426,2489,1373,4855,2489,1317,2455,4944,2455,4944
ŷֳ,XinFengKenZhiChang,361127506,4619,465,3004,1532,6108,3003,1072,3124,6127,3152,6156
۶,PoYangZhen,361128100,164462,14109,105336,51671,179562,96720,42991,102291,199011,116226,221562
л̲,XieJiaTanZhen,361128101,40859,4580,28748,15924,58890,28742,14914,31596,60338,31605,60353
ʯŽ,ShiMenJieZhen,361128102,16243,1516,10739,4937,22139,9888,4625,10583,20471,11645,22384
ʮ,SiShiLiJieZhen,361128103,18574,2148,13785,8511,28025,13749,8073,14961,28710,15010,28795
Ͷս,YouDunJieZhen,361128104,54725,6130,39872,18181,80795,39414,21820,42042,81456,42803,82675
,TianFanJieZhen,361128105,38758,4389,27476,13772,55943,27350,13888,29358,56708,29559,57035
,JinPanLingZhen,361128106,18471,2074,12877,6420,26695,12389,6574,13448,25837,14242,27119
߼,GaoJiaLingZhen,361128107,23460,2301,16097,7622,32978,15534,8222,17127,32661,17886,33983
˸,HuangGangZhen,361128108,42279,4193,29630,15823,61068,29428,16666,33129,62557,33508,63138
˫,ShuangGangZhen,361128109,42136,4627,31394,13983,62803,31358,17470,32794,64152,32839,64233
ض,GuXianDuZhen,361128110,50583,5352,36104,17310,74825,34141,20907,38096,72237,40738,76842
ķ,RaoFengZhen,361128111,26919,2733,18220,10156,37123,18198,8415,19786,37984,19847,38067
ַ,LeFengZhen,361128112,18426,2169,12798,6560,26095,12544,6015,13309,25853,13812,26610
Ĳ,RaoBuZhen,361128113,24795,2876,18783,9684,36757,18714,10937,19710,38424,19825,38608
Ҹ,HouJiaGangXiang,361128201,20346,2275,14536,7473,29103,14493,7340,15297,29790,15425,29961
ɽ,LianHuaShanXiang,361128202,4444,575,3011,1526,6009,2999,1165,3114,6113,3173,6184
ˮ̲,XiangShuiTanXiang,361128203,19634,2723,14892,9101,30572,14663,8644,15744,30407,16109,31001
,JianTianJieXiang,361128206,14242,1620,9493,4797,19490,9223,4093,9982,19205,10462,19955
ϸ,ZheGangXiang,361128207,27653,3056,20211,10778,41712,20175,11519,21948,42123,22017,42228
ѻȵ,YaQueHuXiang,361128208,7181,1109,5157,2863,10231,5111,2242,5321,10432,5375,10532
,YinBaoHuXiang,361128209,10265,1232,8206,4698,16138,8204,5206,8487,16691,8497,16703
γ,YouChengXiang,361128210,31894,3322,22195,9496,45255,22045,11032,23696,45741,24053,46248
,ZhuHuXiang,361128211,8867,1973,8189,5166,15508,8163,5102,7708,15871,7753,15942
ɳ,BaiShaZhouXiang,361128212,4902,637,3547,1753,7101,3545,1719,3699,7244,3711,7258
,TuanLinXiang,361128213,23649,2184,16718,7553,34464,16705,8819,17916,34621,17934,34652
,ChangZhouXiang,361128215,19568,1869,13616,6373,28962,13616,7835,15656,29272,15656,29272
ǰ,SanMiaoQianXiang,361128216,39861,4007,27984,12765,58132,27781,14947,30505,58286,30831,58815
,LianHuXiang,361128217,36222,4647,28562,16806,57266,28541,18072,30335,58876,30379,58941
«,LuTianXiang,361128218,27388,2906,19325,10713,39409,19313,10131,21070,40383,21100,40425
ũ,NongKeSuo,361128401,1403,156,1040,514,2006,1032,544,1052,2084,1063,2103
,XuNiDiQu,361128402,3825,707,2444,1907,3920,2384,601,2384,4768,2689,5133
Ӫ,ChenYingZhen,361129100,75060,5586,50905,25435,78125,45136,25769,48093,93229,55510,106415
ʯ,ShiZhenZhen,361129101,22120,3018,15723,10460,32065,15569,8257,17306,32875,17672,33395
,QingYunZhen,361129102,15713,1906,10691,5594,19957,10175,4615,10853,21028,11543,22234
,ZiBuZhen,361129103,25903,2517,17927,8801,37181,17600,9594,19488,37088,20087,38014
Դ,DaYuanZhen,361129104,11478,1247,8344,4090,17004,8315,4654,8968,17283,9035,17379
÷,PeiMeiZhen,361129105,14959,1619,10573,6087,19966,10544,5273,11221,21765,11278,21851
,HuYunXiang,361129200,11542,1502,8740,4650,17733,8683,5170,9213,17896,9474,18214
벺,QiBuXiang,361129201,13394,1766,9870,5363,20266,9809,5477,10586,20395,10767,20637
,WangJiaXiang,361129203,11577,1526,8266,4388,16602,8035,4207,8683,16718,9044,17310
Ϸ,ShangFangXiang,361129205,12780,1459,9410,5102,18077,9069,5277,9722,18791,10106,19516
,SuQiaoXiang,361129206,19467,2355,14893,8448,29682,14806,9182,15864,30670,16111,31004
,ZhuTianXiang,361129208,9078,936,6157,3207,13085,6128,3115,6878,13006,6972,13129
ųǽֵ,RanChengJieDao,361130001,37063,3189,25498,14321,46929,24398,10281,23544,47942,25035,50533
,ZiYangZhen,361130100,34431,2982,23109,11816,41504,21079,9971,22117,43196,24275,47384
廪,QingHuaZhen,361130101,10168,1414,7216,4503,14089,7183,3000,7307,14490,7366,14582
,QiuKouZhen,361130102,14804,1708,10159,5143,20037,10053,4387,10279,20332,10740,20899
,JiangWanZhen,361130103,18934,2429,13457,7709,26048,13240,5441,12971,26211,13347,26804
˼,SiKouZhen,361130104,8947,1142,6206,3571,12415,6177,2622,6459,12636,6505,12711
,FuChunZhen,361130106,20388,2178,13692,8199,27337,13627,5499,14230,27857,14373,28065
ͷ,ZhenTouZhen,361130107,7420,802,5121,2942,9925,5060,2189,5193,10253,5290,10411
̫,TaiBaiZhen,361130109,9844,1152,6754,4011,13324,6745,2817,7026,13771,7059,13813
,ZhongYunZhen,361130110,16441,1730,11046,6071,22287,11029,4650,11738,22767,11775,22821
,XuCunZhen,361130111,11617,1277,7746,4540,15564,7636,3298,8232,15868,8446,16192
Ϫͷ,XiTouXiang,361130200,7853,1062,5387,3156,10731,5355,2007,5471,10826,5535,10922
ݷ,DuanShenXiang,361130201,9391,1433,6499,3931,13216,6490,2545,6847,13337,6870,13369
Դ,ZheYuanXiang,361130204,8711,1181,6113,3625,12029,6112,2369,6144,12256,6148,12261
,DuoChuanXiang,361130205,4491,523,2949,1704,5858,2822,1185,3065,5887,3250,6199
۵ɽ,DaZhangShanXiang,361130206,12237,1334,8801,5040,17452,8770,4155,8864,17634,8925,17726
ɽ,ZhenZhuShanXiang,361130208,6713,805,4543,2870,9116,4535,1810,4757,9292,4785,9328
ǽֵ´,YinChengJieDaoBanShiChu,361181001,51671,5804,34810,19650,59382,30245,13150,30478,60723,35815,70625
ƶ,RaoErZhen,361181103,17062,2206,12253,6737,24361,12101,6227,13071,25172,13242,25495
,HaiKouZhen,361181105,8373,994,5726,3707,10828,5659,2624,5992,11651,6265,11991
¸ɽ,XinGangShanZhen,361181106,14230,1887,9914,5901,19358,9673,4694,10418,20091,10897,20811
,SiZhouZhen,361181107,20715,2663,14360,8945,26162,14249,6050,14699,28948,15068,29428
,HuaQiaoZhen,361181190,12947,1939,8637,5686,14834,8455,3299,8688,17143,9548,18185
ư,HuangBoXiang,361181200,16944,1779,12710,6474,23898,12529,7208,13087,25616,13221,25931
,WanCunXiang,361181201,9029,1065,6631,3406,12719,6617,3631,7055,13672,7094,13725
Ŵ,ZhangCunXiang,361181202,12822,1574,9356,4946,17967,9343,5095,10095,19438,10135,19491
L,BanDaXiang,361181203,5666,722,3939,2380,7514,3876,1758,4075,7951,4207,8146
լ,LiZhaiXiang,361181204,6755,796,4421,2570,8660,4389,2059,4724,9113,5189,9610
ͷɽ,LongTouShanXiang,361181205,8770,1133,5577,3571,10554,5460,2603,5838,11298,6929,12506
ʡͭ,JiangXiShengDeXingTongKuang,361181401,20828,1902,13011,9688,23582,12908,4527,13493,26401,14246,27257
·ֵ´,JieFangLuJieDaoBanShiChu,370102001,32803,3711,19774,11107,27375,16384,4236,14840,31224,20976,40750
ǧɽֵ´,QianFoShanJieDaoBanShiChu,370102002,58811,6225,33588,15745,39159,21792,4782,20640,42432,36230,69818
ͻȪֵ´,BoTuQuanJieDaoBanShiChu,370102003,45724,4797,26970,11094,26559,15608,3353,14552,30160,26904,53874
Ȫ·ֵ´,QuanChengLuJieDaoBanShiChu,370102004,16129,910,8007,3329,5540,3839,678,3619,7458,9710,17717
ֵ´,DaMingHuJieDaoBanShiChu,370102005,18148,2200,10203,6429,12414,8521,1849,7975,16496,11994,22197
ؽֵ´,DongGuanJieDaoBanShiChu,370102006,41750,5611,25963,17772,34844,22915,4558,21725,44640,25956,51919
Ķֵ´,WenDongJieDaoBanShiChu,370102007,78226,8403,49465,24110,57883,34123,9141,32434,66557,46305,95770
½ֵ´,JianXinJieDaoBanShiChu,370102008,35934,5511,20242,14016,35238,19482,4491,18856,38338,25694,45936
ֵ´,DianLiuJieDaoBanShiChu,370102009,39578,3800,24875,12688,31247,18348,5599,17322,35670,24102,48977
ɽֵ´,YanShanJieDaoBanShiChu,370102010,34742,4032,23176,11761,25951,16859,4585,15306,32165,20183,43359
Ҧҽֵ´,YaoJiaJieDaoBanShiChu,370102011,141607,6393,79150,37045,67039,49858,14929,50357,100215,83779,162929
ֵ´,LongDongJieDaoBanShiChu,370102012,25748,1588,13414,8236,12568,11708,3992,11608,23316,17914,31328
Զֵ´,ZhiYuanJieDaoBanShiChu,370102013,20441,1928,12231,7843,15684,11444,3476,11287,22731,13614,25845
˴·ֵ´,ShunHuaLuJieDaoBanShiChu,370102014,36473,1667,20991,15428,17206,18610,5577,18875,37485,22726,43717
԰ֵ´,DaGuanYuanJieDaoBanShiChu,370103002,14437,2265,9655,6565,13378,8996,2120,8476,17472,9167,18822
ʯŽֵ´,GanShiQiaoJieDaoBanShiChu,370103003,33152,5494,22986,15594,35053,22448,5672,20672,43120,21332,44318
ֵ´,SiLiCunJieDaoBanShiChu,370103004,36519,5017,23161,13029,26092,19312,3991,17476,36788,22366,45527
κׯֵ´,WeiJiaZhuangJieDaoBanShiChu,370103006,19033,1552,7041,4805,12310,6189,1417,6008,12197,14961,22002
´ֵ´,ErQiXinCunJieDaoBanShiChu,370103008,29177,5478,20072,14407,27107,19843,4351,18676,38519,18934,39006
ɽֵ´,QiLiShanJieDaoBanShiChu,370103009,34084,4740,22859,16868,29057,22475,5266,20913,43388,21231,44090
ɽֵ´,LiuLiShanJieDaoBanShiChu,370103010,43826,6382,28705,21302,33458,27966,6206,26604,54570,27709,56414
˴·ֵ´,ShunYuLuJieDaoBanShiChu,370103012,57572,4929,34571,18001,39312,25079,6630,23793,48872,34560,69131
Դֵ´,LuoYuanJieDaoBanShiChu,370103014,18363,3789,12667,9115,18353,12097,2161,11113,23210,11646,24313
ׯֵ´,WangGuanZhuangJieDaoBanShiChu,370103015,32562,3753,20839,16121,25749,20713,5243,20257,40970,20719,41558
˴ֵ´,ShunGengJieDaoBanShiChu,370103016,13716,1280,8457,5766,8065,8223,2516,8023,16246,9055,17512
ɽֵ´,BaiMaShanJieDaoBanShiChu,370103017,43588,4201,27752,19208,25057,27458,8188,27242,54700,28225,55977
ͽֵ´,QiXianJieDaoBanShiChu,370103018,66585,2676,35382,20716,31810,22956,6375,25221,48177,40254,75636
ʮӽֵ´,ShiLiuLiHeJieDaoBanShiChu,370103019,51549,3531,30906,19735,35303,27910,9397,28580,56490,33571,64477
¡ֵ´,XingLongJieDaoBanShiChu,370103020,19909,1924,11238,6277,17285,9875,3415,9968,19843,14010,25248
ҽֵ´,DangJiaJieDaoBanShiChu,370103021,33181,3170,21083,10572,35684,18468,6163,18771,37239,21431,42514
ֵ´,DouGouJieDaoBanShiChu,370103022,20155,2517,13810,7628,25074,13794,4364,13177,26971,13226,27036
˽ֵֽ´,ZhenXingJieJieDaoBanShiChu,370104001,30335,3823,19438,13939,22300,18613,5621,17945,36558,20341,39779
дֵ´,ZhongDaHuaiShuJieDaoBanShiChu,370104002,13116,1876,8482,6705,8477,8094,1868,7582,15676,8378,16860
½ֵֽ´,DaoDeJieJieDaoBanShiChu,370104003,13123,1740,7676,5463,9719,6663,1343,6462,13125,8530,16206
гֵ´,XiShiChangJieDaoBanShiChu,370104004,6354,1076,4020,2860,5184,3673,751,3521,7194,4161,8181
﹵ֵ´,WuLiGouJieDaoBanShiChu,370104005,18121,3063,12205,8894,13926,10941,2101,10224,21165,11080,23285
Ӫнֵֽ´,YingShiJieJieDaoBanShiChu,370104006,20143,4572,14245,10395,21353,14067,2966,13336,27403,13436,27681
깫԰ֵ´,QingNianGongYuanJieDaoBanShiChu,370104007,21019,2049,12115,5506,20133,7305,1665,6871,14176,12618,24733
ׯֵ´,NanXinZhuangJieDaoBanShiChu,370104008,22050,3867,14660,10498,23302,14205,3413,13601,27806,14670,29330
ε걱·ֵ´,DuanDianBeiLuJieDaoBanShiChu,370104009,33475,3541,21198,15220,20007,20493,5301,19816,40309,21119,42317
ׯ·ֵ´,ZhangZhuangLuJieDaoBanShiChu,370104010,39649,2777,24083,14589,20066,20386,6143,19780,40166,24486,48569
ɽֵ´,KuangShanJieDaoBanShiChu,370104011,43349,3362,27047,20022,28889,26726,7434,26648,53374,27098,54145
ֵ´,MeiLiHuJieDaoBanShiChu,370104012,27449,1741,17003,11325,15475,16388,5464,16707,33095,17651,34654
ұ,WuJiaBaoZhen,370104100,20347,2154,13572,7631,22386,13371,4435,12916,26287,13364,26936
ε,DuanDianZhen,370104101,67728,5033,37296,20955,57471,33943,11374,32824,66767,46839,84135
Ӱɽֵ´,WuYingShanJieDaoBanShiChu,370105001,28860,4572,19771,13556,21381,18202,4574,17500,35702,18235,38006
Ŷֵֽ´,TianQiaoDongJieJieDaoBanShiChu,370105003,7943,1564,5387,4265,8217,5290,869,4910,10200,4989,10376
´山ֵ,GongRenXinCunBeiCunJieDao,370105004,20576,3199,13943,9729,20149,12800,2847,12198,24998,12679,26622
´ϴֵ,GongRenXinCunNanCunJieDao,370105005,26359,3177,16670,13107,20264,16455,3754,16029,32484,16620,33290
̿·ֵ´,DiKouLuJieDaoBanShiChu,370105006,54093,7046,33418,23941,40378,29940,7274,29349,59289,34995,68413
ֵ̹´,BeiTanJieDaoBanShiChu,370105007,11797,1720,7678,5814,7020,7506,1692,7169,14675,7531,15209
ƽнֵ´,ZhiJinShiJieDaoBanShiChu,370105009,14677,2744,10187,7519,15119,10076,2125,9293,19369,9359,19546
ֵֽ´,BaoHuaJieJieDaoBanShiChu,370105010,5103,744,3321,2471,3939,3271,733,3167,6438,3259,6580
Ӫֵ´,GuanZhaYingJieDaoBanShiChu,370105011,7786,1474,5074,4294,8083,5009,798,4901,9910,4984,10058
γ·ֵ´,WeiBeiLuJieDaoBanShiChu,370105012,23095,3513,15155,10928,18143,13976,2886,13323,27299,14339,29494
ҩɽֵ´,YaoShanJieDaoBanShiChu,370105013,50952,3086,26218,18152,26699,24340,7466,24427,48767,35286,61504
԰ֵ´,BeiYuanJieDaoBanShiChu,370105014,171074,12063,101597,61150,78676,80622,22054,80749,161371,103594,205191
ڽֵ´,LuoKouJieDaoBanShiChu,370105015,64498,6115,40616,28861,46461,39655,11149,39504,79159,41146,81762
ɣ,SangZiDianZhen,370105101,23644,2938,16253,9339,31286,16219,5722,15888,32107,16051,32304
,DaQiaoZhen,370105102,36967,4184,25274,13763,48523,25246,8909,24734,49980,24786,50060
ɽ·ֵ´,ShanDaLuJieDaoBanShiChu,370112001,56283,5292,33929,16458,40110,22465,5560,21674,44139,33206,67135
¥ֵ´,HongJiaLouJieDaoBanShiChu,370112002,35322,2759,22429,12494,20451,16121,5071,15548,31669,20723,43152
ֵ´,DongFengJieDaoBanShiChu,370112003,79541,5756,50514,33221,45535,45450,14070,44519,89969,48853,99367
ȫֵ´,QuanFuJieDaoBanShiChu,370112004,54605,5268,33495,20684,32963,27934,7655,27064,54998,34033,67528
ֵ´,SunCunJieDaoBanShiChu,370112005,22942,2900,15621,8668,28063,15095,5095,14426,29521,15316,30937
Ұӽֵ´,JuYeHeJieDaoBanShiChu,370112006,46959,3055,26428,8242,28105,14538,4483,14014,28552,28069,54497
ɽֵ´,HuaShanJieDaoBanShiChu,370112007,48749,3293,30409,18986,36961,27707,9571,27140,54847,31204,61613
ɻ·ֵ´,HeHuaLuJieDaoBanShiChu,370112008,16313,1988,10818,5993,19734,10688,3481,10383,21071,10964,21782
˽ֵ´,WangSheRenJieDaoBanShiChu,370112009,51103,5033,33075,18595,46018,29865,10420,28861,58726,33481,66556
ɽֵ´,BaoShanJieDaoBanShiChu,370112010,60303,7975,38001,23859,72158,36069,11897,34858,70927,42174,80175
ֵ´,GuoDianJieDaoBanShiChu,370112011,23044,1781,14413,6775,16206,10558,3740,10304,20862,14152,28565
ұֵ´,TangYeJieDaoBanShiChu,370112012,23209,1969,14756,7268,19460,10870,3911,10388,21258,14333,29089
۹ֵ´,GangGouJieDaoBanShiChu,370112013,53692,4780,29117,14842,47987,23348,8384,23272,46620,37739,66856
ңǽֵ´,YaoQiangJieDaoBanShiChu,370112014,18879,2960,12958,7852,24636,12851,3893,12516,25367,12774,25732
ٸ۽ֵ´,LinGangJieDaoBanShiChu,370112015,27923,3250,16914,8723,27475,14341,4360,14085,28426,18619,35533
ٹ,ZhongGongZhen,370112101,79445,11180,52980,35531,100509,51192,17353,52876,104068,54998,107978
,LiuBuZhen,370112103,40699,6722,26909,17666,53890,26206,7886,27275,53481,28398,55307
,DongJiaZhen,370112106,34748,4059,22036,11933,37599,19953,6063,19371,39324,22834,44870
,TangWangZhen,370112107,40888,6453,28390,16711,55986,28387,8929,27876,56263,27880,56270
Ӫ,XiYingZhen,370112111,20901,3577,14082,10074,28061,14049,4316,14639,28688,14712,28794
ʯ,CaiShiZhen,370112112,44666,3469,25982,8370,27915,14374,4435,14153,28527,26588,52570
Ĳֵ´,WenChangJieDaoBanShiChu,370113001,91757,9574,60698,37537,92914,58333,19996,57506,115839,60629,121327
ƺֵ´,GuYunHuJieDaoBanShiChu,370113002,94027,3673,55815,13047,45151,19942,7123,19705,39647,49008,104823
ƽֵ´,PingAnJieDaoBanShiChu,370113003,46975,4739,30181,14698,50423,26483,9052,25833,52316,30585,60766
ɽֵ´,WuFengShanJieDaoBanShiChu,370113004,19830,3066,13668,8866,26758,13647,4482,13632,27279,13710,27378
,GuiDeZhen,370113101,47914,8229,33553,21249,65141,33522,10252,32734,66256,32842,66395
Т,XiaoLiZhen,370113102,27561,5367,19515,12706,37710,19492,5584,18906,38398,18997,38512
,WanDeZhen,370113103,49426,7243,33600,21037,65928,33404,11225,33809,67213,34294,67894
,ZhangXiaZhen,370113106,31823,4669,22276,13588,42360,22059,7809,21773,43832,22025,44301
ɽ,MaShanZhen,370113107,18428,3129,13005,8766,25164,12968,4113,12591,25559,12665,25670
˫Ȫ,ShuangQuanZhen,370113108,15675,2884,11023,7806,21026,11011,3115,10494,21505,10651,21674
ɽ´,YuShanBanShiChu,370124001,72740,7724,48824,32093,69134,46690,15630,45215,91905,47270,96094
ˮ´,JinShuiBanShiChu,370124002,23279,3058,15885,10033,25437,15733,5079,15325,31058,15531,31416
,DongAZhen,370124102,20905,4248,15232,10188,28366,15230,4173,14090,29320,14094,29326
Тֱ,XiaoZhiZhen,370124103,38352,6007,26820,17099,50660,26781,8324,25740,52521,25863,52683
״,KongCunZhen,370124104,23689,4352,16810,10916,31527,16746,5076,16179,32925,16307,33117
鷶,HongFanChiZhen,370124105,14704,3181,10519,6892,20214,10513,2877,10231,20744,10243,20762
õ,MeiGuiZhen,370124106,25272,5321,18187,12695,34261,18183,5005,17400,35583,17411,35598
,AnChengZhen,370124107,23709,4284,16463,10296,31596,16426,4723,16002,32428,16253,32716
ֵ´,JiYangJieDaoBanShiChu,370125001,52963,7408,37027,21948,61691,35750,12684,34573,70323,36028,73055
ñֵ´,JiBeiJieDaoBanShiChu,370125002,24678,1954,15944,8757,21230,14071,5304,13754,27825,15992,31936
ʯ,DuoShiZhen,370125101,48260,7741,34203,19424,66097,34167,11906,33612,67779,33704,67907
﹢,SunGengZhen,370125102,33809,4959,23829,13401,45247,23084,8540,22956,46040,23479,47308
,QuDiZhen,370125103,48431,8593,34580,20183,67115,34485,11622,33909,68394,34066,68646
ʷ,RenFengZhen,370125104,40753,6126,28632,16450,55737,28601,9974,28142,56743,28221,56853
կ,CuiZhaiZhen,370125107,35141,4803,24100,12788,41563,21697,6929,21482,43179,22773,46873
̫ƽ,TaiPingZhen,370125108,32927,5889,24186,14994,46439,24133,8730,23206,47339,23360,47546
غ,HuiHeZhen,370125109,30371,5086,20860,11791,41461,20825,6638,21109,41934,21235,42095
,XinShiZhen,370125110,26131,3639,17785,9935,35043,17773,5959,17933,35706,17944,35729
̰´,XuShangBanShiChu,370126001,76173,8504,50379,29233,89565,47172,16652,46879,94051,50950,101329
,YinXiangZhen,370126101,35536,6092,25905,15335,49742,25897,9151,24857,50754,24874,50779
,HuaiRenZhen,370126102,21118,2723,14849,8284,28475,14639,5087,13648,28287,14079,28928
ɣ,LongSangSiZhen,370126104,27533,4620,19610,10795,38080,19600,6780,19269,38869,19323,38933
֣·,ZhengLuZhen,370126105,41602,6324,29175,15715,56817,29154,10043,28722,57876,28794,57969
ׯ,JiaZhuangZhen,370126106,33263,4425,23428,13404,44888,23398,8537,22647,46045,22797,46225
,YuHuangMiaoZhen,370126107,42744,5979,29633,16426,57468,29506,11080,29855,59361,30170,59803
Ｏ,SunJiXiang,370126201,32371,5056,22986,13041,45087,22978,8471,22891,45869,22912,45898
ɳ,ShaHeXiang,370126204,27217,4095,19102,10330,37522,19075,6874,19056,38131,19084,38186
,HanMiaoXiang,370126205,21565,3248,15040,8717,30383,14999,5820,15539,30538,15593,30633
ŷ,ZhangFangXiang,370126207,14204,2016,10350,5703,20032,10240,4226,9774,20014,10096,20446
,BaiQiaoXiang,370126212,32053,4885,22355,12247,44445,22315,8058,22566,44881,22641,44996
ˮֵ´,MingShuiJieDaoBanShiChu,370181001,126098,12538,82676,52340,118100,74375,24436,72100,146475,80396,163072
˫ɽֵ´,ShuangShanJieDaoBanShiChu,370181002,100685,5754,61763,27998,47611,41954,15048,40638,82592,59724,121487
԰ֵ´,ZaoYuanJieDaoBanShiChu,370181003,24678,3493,16318,9821,28636,15799,4613,15002,30801,16466,32784
ɽֵ´,LongShanJieDaoBanShiChu,370181004,42901,6240,29256,17138,56147,29242,8417,28279,57521,28302,57558
ֵ´,BuCunJieDaoBanShiChu,370181005,25690,3216,16652,10107,26936,14972,4470,14355,29327,16724,33376
ʥֵ´,ShengJingJieDaoBanShiChu,370181006,33418,3745,21949,11270,34899,18817,5463,17672,36489,20677,42626
ռ,PuJiZhen,370181101,41264,7016,29041,17997,52378,27659,8373,26381,54040,27612,56653
,XiuHuiZhen,370181103,41060,5772,28101,15839,50896,26969,8326,26020,52989,27057,55158
๫ׯ,XiangGongZhuangZhen,370181104,42111,7331,29811,18932,55777,29795,8785,28401,58196,28416,58227
ׯ,DuoZhuangZhen,370181105,20208,3782,14094,9195,27401,14086,4096,13977,28063,13992,28086
ˮկ,ShuiZhaiZhen,370181106,24728,3798,16845,10071,33675,16841,5644,17309,34150,17325,34170
,WenZuZhen,370181109,30696,4858,21354,13874,40334,21348,6204,20394,41742,20404,41758
,DiaoZhen,370181110,44942,6782,31354,18175,59881,31279,10307,30434,61713,30677,62031
ܷ,CaoFanZhen,370181111,24001,4352,16868,11148,32679,16857,4872,16341,33198,16357,33225
ƺ,BaiYunHuZhen,370181113,24209,3374,16678,9275,32696,16670,5732,16618,33288,16637,33315
߹կ,GaoGuanZhaiZhen,370181114,35430,5668,24588,15420,48834,24526,8414,24753,49279,24924,49512
Ҳ,NingJiaBuZhen,370181115,22857,3385,15745,9320,30527,15707,4788,15192,30899,15285,31030
ׯ,GuanZhuangZhen,370181121,34595,6205,23335,15532,45868,23157,6291,22696,45853,23756,47091
կ,XinZhaiZhen,370181122,23848,3912,16398,9969,32374,16374,5054,16365,32739,16416,32814
ƺ,HuangHeXiang,370181204,35689,5542,25131,14599,49844,25126,9006,25090,50216,25106,50237
·ֵ´,XiangGangZhongLuJieDaoBanShiChu,370202001,47360,5790,29824,19831,36171,26441,6222,23966,50407,29548,59372
˴Ͽֵ´,BaDaXiaJieDaoBanShiChu,370202002,15618,3209,10624,6910,14866,9840,2212,9207,19047,10415,21039
ֵ̨´,TaiXiJieDaoBanShiChu,370202003,39709,7308,26880,18924,36852,25184,4993,23300,48484,25130,52010
·ֵ´,YunNanLuJieDaoBanShiChu,370202004,16922,2950,10089,7242,13821,9510,1953,9041,18551,11736,21825
ɽ·ֵ´,ZhongShanLuJieDaoBanShiChu,370202005,17744,2673,11384,8351,12351,9964,2156,9398,19362,11189,22573
ۺ·ֵ´,GuanHaiLuJieDaoBanShiChu,370202006,12916,2329,8750,6658,11144,8251,2039,7948,16199,8534,17284
·ֵ´,JiangSuLuJieDaoBanShiChu,370202007,20638,4616,15101,10756,22129,14548,3553,13251,27799,13706,28807
·ֵ´,JinKouLuJieDaoBanShiChu,370202008,21901,3428,15290,7935,22937,11788,3399,10358,22146,13438,28728
˴ؽֵ´,BaDaGuanJieDaoBanShiChu,370202009,17617,2854,12364,7138,18811,10799,3395,9472,20271,11502,23866
տɽֵ´,ZhanShanJieDaoBanShiChu,370202010,31631,4265,19482,12454,24966,17331,4550,15445,32776,20964,40446
·ֵ´,JinHuLuJieDaoBanShiChu,370202011,37098,5557,24737,16019,29303,22325,4962,20703,43028,22880,47617
˴ֵ´,BaDaHuJieDaoBanShiChu,370202012,43636,6425,27253,18157,36077,24957,6072,23468,48425,28880,56133
·ֵ´,JinMenLuJieDaoBanShiChu,370202013,66558,9257,42942,27393,48087,36953,8847,34001,70954,41720,84662
麣·ֵ´,ZhuHaiLuJieDaoBanShiChu,370202014,32356,4172,20802,13791,22067,18871,3957,16751,35622,19683,40485
·ֵ´,LiaoNingLuJieDaoBanShiChu,370203005,39026,7289,26197,20315,29835,25355,4884,24027,49382,25002,51199
Ӱ·ֵ´,YanAnLuJieDaoBanShiChu,370203008,28919,6198,19793,14954,24500,19331,3710,18164,37495,19034,38827
·ֵ´,HuaYangLuJieDaoBanShiChu,370203010,24001,3206,15119,11823,15350,14723,2923,14389,29112,15011,30130
·ֵ´,DengZhouLuJieDaoBanShiChu,370203011,29611,4392,19474,13667,21656,17716,3368,16723,34439,17897,37371
·ֵ´,NingXiaLuJieDaoBanShiChu,370203013,36478,5909,24676,17180,26276,22974,4982,21516,44490,22693,47369
ػ·ֵ´,DunHuaLuJieDaoBanShiChu,370203014,34423,4644,22272,16409,23098,21429,4659,20277,41706,21454,43726
Դ·ֵ´,LiaoYuanLuJieDaoBanShiChu,370203015,35374,5509,22927,17095,23912,22353,4579,21483,43836,22535,45462
Ϸ·ֵ´,HeFeiLuJieDaoBanShiChu,370203016,18482,1128,11262,7801,6809,10753,3582,10662,21415,11930,23192
С۽ֵ´,XiaoGangJieDaoBanShiChu,370203018,4848,626,2847,2071,3109,2735,527,2553,5288,3154,6001
۽ֵ´,DaGangJieDaoBanShiChu,370203019,11378,1529,6935,5294,7157,6734,1399,6337,13071,7371,14306
ī·ֵ´,JiMoLuJieDaoBanShiChu,370203020,28121,4415,18409,14762,20038,17509,3463,16701,34210,17590,35999
ֵ̨´,TaiDongJieDaoBanShiChu,370203021,39570,5590,26020,18569,29924,24135,4853,22216,46351,23993,50013
·ֵ´,ZhenJiangLuJieDaoBanShiChu,370203022,37868,5031,24848,18326,27076,24011,5287,22385,46396,23338,48186
ɽ½ֵ´,HongShanPoJieDaoBanShiChu,370203023,23545,3060,15844,11386,15654,15338,4207,14385,29723,14968,30812
ͬ·ֵ´,TongAnLuJieDaoBanShiChu,370203024,9738,824,6237,4426,4819,6045,1664,5742,11787,5989,12226
ɽֵ´,FuShanXinQuJieDaoBanShiChu,370203025,32601,5592,22351,16873,22150,21630,5206,20370,42000,21048,43399
·ֵ´,FuXinLuJieDaoBanShiChu,370205001,76800,9212,45989,29743,55325,39742,8158,38968,78710,48181,94170
·ֵ´,HaiLunLuJieDaoBanShiChu,370205002,47129,6612,30466,22458,34249,29116,6691,28424,57540,29966,60432
·ֵ´,JiaXingLuJieDaoBanShiChu,370205003,61182,10637,40436,29575,49356,38677,7245,36925,75602,38628,79064
¡·ֵ´,XingLongLuJieDaoBanShiChu,370205004,46522,6738,30003,22214,37628,29035,6340,28502,57537,29597,59600
ˮ幵ֵ´,ShuiQingGouJieDaoBanShiChu,370205005,52453,7736,33177,24554,36934,31903,7172,31542,63445,34184,67361
·ֵ´,LuoYangLuJieDaoBanShiChu,370205006,62713,8509,37759,25276,48270,32655,7180,32951,65606,40643,78402
ֵ´,HeXiJieDaoBanShiChu,370205007,19183,1426,10362,6810,7453,9107,2859,9558,18665,13106,23468
Ƶֵ´,HuangDaoJieDaoBanShiChu,370211001,60812,4556,34766,25858,33847,32882,11400,36194,69076,42002,76768
ֵ´,XinAnJieDaoBanShiChu,370211002,112407,5065,55174,37922,45539,42272,13538,50181,92453,75836,131010
Ѧҵֵ´,XueJiaDaoJieDaoBanShiChu,370211003,59677,4061,28706,16633,30732,22537,7431,23103,45640,42463,71169
�ֵ´,LiuHuaBoJieDaoBanShiChu,370211004,9283,1847,6289,4270,10587,6068,1809,6114,12182,6650,12939
·ֵ´,ChangJiangLuJieDaoBanShiChu,370211005,167027,7814,94442,57476,74254,71864,23869,73293,145157,104268,198710
ʯ½ֵ´,HongShiYaJieDaoBanShiChu,370211006,24084,4470,16404,11074,28881,16111,5056,16109,32220,17206,33610
кֵ,ZhongHanJieDao,370212001,204791,12878,116013,65330,73981,82012,22557,82258,164270,124213,240226
ɳӿڽֵ,ShaZiKouJieDao,370212002,52093,6614,34190,23168,51088,32192,9169,30561,62753,33686,67876
ׯֵ,WangGeZhuangJieDao,370212003,32753,5682,22463,16602,40969,22022,5823,21205,43227,21795,44258
լֵ,BeiZhaiJieDao,370212004,19636,3542,13719,8778,24942,13540,3931,13053,26593,13390,27109
·ֵ´,ZhenHuaLuJieDaoBanShiChu,370213001,20827,3219,12987,9732,15510,12388,2730,12097,24485,13789,26776
·ֵ´,YongQingLuJieDaoBanShiChu,370213002,34697,4086,21794,15881,20018,21092,5732,20958,42050,22721,44515
·ֵ´,YongAnLuJieDaoBanShiChu,370213003,35257,6143,23331,17474,30214,22552,4673,21578,44130,22742,46073
˻·ֵ´,XingHuaLuJieDaoBanShiChu,370213004,22945,3164,14805,11195,17329,14478,3293,14086,28564,14597,29402
˳·ֵ´,XingChengLuJieDaoBanShiChu,370213005,12900,2585,8588,6882,11077,8453,1660,8185,16638,8557,17145
ֵ´,LiCunJieDaoBanShiChu,370213006,71732,7716,46299,31627,46974,42597,12144,40882,83479,45293,91592
ɽ·ֵ´,HuShanLuJieDaoBanShiChu,370213007,53449,3180,33468,20738,25540,27714,8861,27244,54958,32022,65490
ɽ·ֵ´,FuShanLuJieDaoBanShiChu,370213008,48792,3148,29513,19937,18543,26726,8816,26850,53576,31243,60756
ˮ·ֵ´,JiuShuiLuJieDaoBanShiChu,370213009,53958,3928,33653,13050,29120,19047,5609,17846,36893,29842,63495
̶·ֵ´,XiangTanLuJieDaoBanShiChu,370213010,35211,2703,20186,10965,19559,14651,5058,14819,29470,22786,42972
¥ɽֵ´,LouShanJieDaoBanShiChu,370213011,19391,2042,11269,7589,13024,10248,2740,10122,20370,12904,24173
ֵ´,ChengYangJieDaoBanShiChu,370214001,188217,11485,115586,62339,106584,84376,26769,81929,166305,110885,226471
ׯֵ´,XiaZhuangJieDaoBanShiChu,370214002,89431,8605,58669,33489,62707,45504,13619,44573,90077,52986,111655
ֵͤ´,LiuTingJieDaoBanShiChu,370214003,112178,7108,68492,32580,59752,43540,13692,42943,86483,64486,132978
ֵ̲´,JiHongTanJieDaoBanShiChu,370214004,53511,5276,32057,18622,40570,25221,7810,25197,50418,34540,66597
ֵ´,ShangMaJieDaoBanShiChu,370214005,40853,5691,26519,17306,36728,22467,6157,22104,44571,26182,52701
쵺ֵ´,HongDaoJieDaoBanShiChu,370214006,31823,4844,20727,14997,34559,18928,5006,18499,37427,20946,41673
׽ֵ´,HeTaoJieDaoBanShiChu,370214007,35953,5811,24428,16414,38103,21351,6062,20754,42105,23398,47826
ϧֵ´,XiFuZhenJieDaoBanShiChu,370214008,46056,4317,27827,15123,37843,22263,6935,21561,43824,29481,57308
ֵ´,FuAnJieDaoBanShiChu,370281001,69898,7917,47327,32526,56279,45299,14939,43741,89040,45427,92754
ƽֵ´,ZhongYunJieDaoBanShiChu,370281002,61982,6944,41281,29020,51140,39975,13465,39392,79367,41110,82391
ؽֵ´,BeiGuanJieDaoBanShiChu,370281003,27158,3060,18009,11336,25802,17401,6229,17408,34809,18438,36447
ӽֵ´,SanLiHeJieDaoBanShiChu,370281004,49674,4323,31603,16356,35181,25716,8880,25136,50852,31274,62877
Ϫֵ´,YunXiJieDaoBanShiChu,370281005,25273,1483,15358,8939,13850,12930,4921,12789,25719,16319,31677
Ӫֵ´,YingHaiJieDaoBanShiChu,370281006,27325,4397,18929,12053,32085,18653,5922,18356,37009,18715,37644
ֵ´,JiaoDongJieDaoBanShiChu,370281007,44943,6542,30957,18977,50214,28106,9544,27653,55759,30072,61029
,JiaoLaiZhen,370281100,27562,5029,19364,12625,36688,19306,6330,19417,38723,19557,38921
,MaDianZhen,370281101,26718,4469,18549,11756,33399,17879,5921,17863,35742,18559,37108
ׯ,LiGeZhuangZhen,370281102,49291,6305,32965,21143,49397,30614,10118,30529,61143,32749,65714
̼,PuJiZhen,370281105,37499,6936,26645,16164,50712,25993,8128,25306,51299,25918,52563
Ӧ,ZhangYingZhen,370281106,20080,3874,14536,9200,25800,13915,4567,13693,27608,13985,28521
,LiChaZhen,370281108,18871,3655,13252,8384,25538,13164,4093,13172,26336,13367,26619
,JiaoXiZhen,370281110,42035,7253,29818,17539,55339,29431,10264,29333,58764,29734,59552
,YangHeZhen,370281111,35617,7299,24986,15855,48330,24975,7455,25367,50342,25385,50371
,JiuLongZhen,370281112,19677,3929,13839,9356,25159,13541,4532,13797,27338,14299,28138
Ŵ,DuCunZhen,370281113,14042,3043,10167,6456,19327,10156,3395,10267,20423,10313,20480
,JiaoBeiZhen,370281114,21743,3724,15023,8981,27803,14653,4781,14676,29329,15225,30248
ֵ,HuanXiuJieDao,370282001,54310,5767,35764,20704,46958,31189,10032,30703,61892,34345,70109
ֵ,ChaoHaiJieDao,370282002,62556,5571,40582,26120,51705,37412,13160,37718,75130,40705,81287
ͨýֵ´,TongJiJieDaoBanShiChu,370282003,183460,14322,118354,78483,153705,109681,39454,111154,220835,118882,237236
ֵ,BeiAnJieDao,370282004,37976,5496,25277,15770,40795,23986,7691,24218,48204,25886,51163
ɽֵ´,LongShanJieDaoBanShiChu,370282005,31630,4280,20890,13425,33735,19336,6304,19253,38589,21324,42214
ɽ,AoShanWeiZhen,370282101,34492,6121,24060,16390,45727,23757,7197,23356,47113,23750,47810
Ȫ,WenQuanZhen,370282102,32570,6081,22634,14856,44499,22442,7004,22770,45212,23021,45655
Ȫ,LongQuanZhen,370282103,34785,6370,24265,14985,44519,23388,7266,23963,47351,24156,48421
ׯ,LiuJiaZhuangZhen,370282104,18842,3455,13059,8881,24394,12762,3805,12642,25404,13043,26102
,LanCunZhen,370282105,36108,3899,22487,13897,32198,19901,6742,20696,40597,24262,46749
꼯,DianJiZhen,370282106,32793,5886,22447,15031,40797,20964,6489,21266,42230,22721,45168
ɽ,LingShanZhen,370282107,19852,3773,13780,9717,25597,13236,4164,13509,26745,14009,27789
߼,QiJiZhen,370282108,22735,4081,15802,11240,30359,15773,5110,16046,31819,16124,31926
,WangCunZhen,370282110,26239,4855,18023,12857,34680,17506,5248,17767,35273,18319,36342
,FengChengZhen,370282112,33079,6804,23175,16221,45479,23109,6730,23345,46454,23438,46613
β,DuanBoLanZhen,370282115,20169,4199,14389,10209,27334,14263,4593,14348,28611,14572,28961
Ʒ,YiFengDianZhen,370282117,33128,6677,23740,16933,46529,23514,8082,23841,47355,24147,47887
ն,PuDongZhen,370282118,26449,5123,18444,12134,34949,17997,5345,18174,36171,18473,36917
,DaXinZhen,370282119,22645,3215,14268,9036,24296,13073,4183,13173,26246,15775,30043
,TianHengZhen,370282121,29204,5876,20709,15313,40071,20668,6044,20211,40879,20415,41124
,JinKouZhen,370282122,20076,3992,14106,9336,27713,14097,4362,14322,28419,14324,28430
ɽ,HuaShanZhen,370282123,27933,5124,19685,12086,38433,19401,6723,19870,39271,20095,39780
Ȫ,NanQuanZhen,370282124,29322,4467,19613,12748,32361,18431,5686,18716,37147,19862,39475
ǹؽֵ´,ChengGuanJieDaoBanShiChu,370283001,93085,9341,59446,35215,83518,50517,17247,49433,99950,60227,119673
԰ֵ´,LiYuanJieDaoBanShiChu,370283002,55975,7733,37756,24892,62433,36695,11537,35800,72495,37489,75245
ͬͽֵ´,TongHeJieDaoBanShiChu,370283003,31511,4069,21562,12447,31406,19006,5911,18710,37716,19929,41491
ֵ´,XiangDianJieDaoBanShiChu,370283004,27183,3504,17837,10696,30302,16872,5576,16558,33430,18426,36263
,MaLanZhen,370283100,30184,4684,20020,12754,40420,19973,6235,20241,40214,21083,41103
,GuXianZhen,370283101,32761,5098,22042,14027,43175,21940,6674,22164,44104,22491,44533
,RenZhaoZhen,370283102,47085,7411,31753,20146,63697,31488,10073,32296,63784,32816,64569
Ÿׯ,ZhangGeZhuangZhen,370283103,32299,5414,22162,14691,43873,21873,7106,22317,44190,22657,44819
ׯ,GuoZhuangZhen,370283104,21911,3364,14720,8964,29205,14704,4354,14874,29578,14909,29629
ϴ,NanCunZhen,370283105,42882,6993,29600,19880,54864,28692,9457,28422,57114,29732,59332
,LanDiZhen,370283106,25140,4677,17737,11184,34467,17589,5432,17289,34878,17512,35249
,WanJiaZhen,370283107,27195,5681,19408,12593,38227,19402,6062,19518,38920,19530,38938
ޤ,LiaoLanZhen,370283108,33366,5560,22563,13677,42237,21118,6442,20937,42055,22805,45368
޼Ҽ,CuiJiaJiZhen,370283109,34020,6412,23914,14623,45661,23580,7219,23324,46904,23737,47651
,MingCunZhen,370283110,38680,6963,27042,17877,52522,26994,8283,26708,53702,26884,53926
ײ,BaiBuZhen,370283111,38945,7700,26884,15879,53396,26292,7544,26407,52699,27305,54189
Ŵ,MenCunZhen,370283112,27938,5326,19258,11966,38158,18926,5598,19167,38093,19604,38862
ׯ,TianZhuangZhen,370283113,19510,4077,13950,10409,27180,13891,4217,13777,27668,13854,27804
ׯ,MaGeZhuangZhen,370283114,20410,3497,14019,8783,27189,13849,3964,13577,27426,13852,27871
,ZhangSheZhen,370283115,26503,5259,18430,12985,36511,18155,5391,18192,36347,18723,37153
º,XinHeZhen,370283116,15884,2798,10891,7208,20146,10225,2974,10141,20366,10765,21656
Ҳ,HuiBuZhen,370283117,34564,6457,23758,15687,45899,23223,7207,23459,46682,24470,48228
,ChangLeZhen,370283118,21048,3973,14410,9675,28527,14026,4170,14270,28296,14781,29191
,DianZiZhen,370283119,36500,7383,25614,17565,49603,25028,7384,25132,50160,25653,51267
ɽ,DaZeShanZhen,370283120,22283,4033,15306,10343,30261,15260,4527,15428,30688,15537,30843
,DaTianZhen,370283121,23800,3869,15653,10040,31725,15315,4539,16009,31324,16555,32208
ɵ,JiuDianZhen,370283122,24780,3985,16746,11733,33387,16598,5507,17210,33808,17526,34272
ף,ZhuGouZhen,370283123,22334,3699,15363,10130,30174,15157,5091,15410,30567,15761,31124
ɽ,YunShanZhen,370283124,37938,5902,25567,16689,50992,25490,8409,26438,51928,26682,52249
,CuiZhaoZhen,370283125,21410,3362,14427,9017,28578,14253,4626,14816,29069,14971,29398
ƽ͹ҵ,PingDuWaiXiangXingGongYeJia,370283400,25970,1427,16808,10953,17140,15117,5923,15147,30264,16512,33320
ɽֵ´,ZhuShanJieDaoBanShiChu,370284001,65353,5816,42553,29792,53459,42007,14812,42381,84388,43428,85981
麣ֵ´,ZhuHaiJieDaoBanShiChu,370284002,78734,7588,52201,35537,64398,51261,17843,50562,101823,51964,104165
ֵ´,YinZhuJieDaoBanShiChu,370284003,92861,7805,57969,38518,65428,53263,19316,54825,108088,62013,119982
ɽֵ´,LingShanWeiJieDaoBanShiChu,370284004,47914,3637,28531,17166,26322,23620,8617,24342,47962,31637,60168
ɽֵ´,TieShanJieDaoBanShiChu,370284005,16064,3380,11016,7734,19740,10814,2940,11138,21952,11368,22384
�ֵ´,BinHaiJieDaoBanShiChu,370284006,40251,4842,23816,13708,35790,20617,6401,20457,41074,27678,51494
,LangYaZhen,370284102,25046,5480,17567,12707,32982,17502,5217,17827,35329,18176,35743
,BoLiZhen,370284103,44024,9137,30762,21093,56635,29625,8692,29549,59174,31091,61853
,DaChangZhen,370284104,30468,6693,21483,15434,40588,21001,5794,20878,41879,21472,42955
,DaCunZhen,370284105,23464,5739,16778,13024,32058,16728,4738,17011,33739,17163,33941
,LiuWangZhen,370284106,29288,7066,20966,15930,40457,20956,6030,21372,42328,21418,42384
̨,WangTaiZhen,370284107,48071,9005,33516,22976,61006,32998,10095,32938,65936,33655,67171
ż¥,ZhangJiaLouZhen,370284110,27328,6274,19150,13907,35383,19008,5276,19427,38435,19728,38878
,HaiQingZhen,370284112,23960,5129,17048,12213,32831,17041,4875,16880,33921,16916,33964
ɽ,BaoShanZhen,370284113,17893,4403,12670,9578,24484,12665,3532,13089,25754,13158,25828
,CangNanZhen,370284115,18467,4226,13092,9529,24958,13078,3695,13255,26333,13296,26388
,LiWuGuanZhenXiangGaiZhen,370284116,10592,2362,7549,5545,14485,7516,2115,7478,14994,7520,15069
ˮֵ´,ShuiJiJieDaoBanShiChu,370285001,107509,9929,69210,46714,88459,65117,22370,62964,128081,70598,139808
ǽֵ´,WangChengJieDaoBanShiChu,370285002,32762,5011,21731,13457,38577,20547,6239,20369,40916,22281,44012
ˮֵ´,LongShuiJieDaoBanShiChu,370285004,17012,2780,11485,6517,18810,9876,2879,9668,19544,11186,22671
÷ɽֵ´,MeiHuaShanJieDaoBanShiChu,370285005,15985,3015,10949,7416,20353,10626,3206,10892,21518,11257,22206
·ֵ´,BinHeLuJieDaoBanShiChu,370285006,30618,2704,20413,13889,24689,20047,6955,19470,39517,19864,40277
ӽֵ´,GuHeJieDaoBanShiChu,370285007,30573,5198,20501,12498,36146,18506,5346,18635,37141,20616,41117
,SunShouZhen,370285100,22898,4263,15627,10538,30403,15623,4218,15748,31371,15752,31379
ɽ,JiangShanZhen,370285101,35761,5914,23773,15137,42113,22363,6410,22623,44986,24312,48085
ĸׯ,XiaGeZhuangZhen,370285102,22315,4098,15273,9915,29368,15050,4293,15222,30272,15433,30706
Ժ,YuanShangZhen,370285104,26721,5096,18426,12554,36070,18412,5373,18733,37145,18764,37190
ׯ,RiZhuangZhen,370285105,31573,6199,21820,15294,41825,20865,5986,20983,41848,21938,43758
,NanShuZhen,370285106,29314,5951,19429,14219,38550,18608,4923,19160,37768,20759,40188
ͷ,HeTouDianZhen,370285107,27766,5575,18888,13902,36241,18819,5057,19172,37991,19510,38398
겺,DianBuZhen,370285108,38090,7103,26193,16757,50858,25765,7420,25754,51519,26420,52613
Ȩׯ,LiQuanZhuangZhen,370285109,28693,4236,19685,11187,33704,18288,5628,18532,36820,18872,38557
䱸,WuBeiZhen,370285112,27055,4787,18357,12075,36037,18211,5221,18388,36599,18706,37063
ׯ,MaLianZhuangZhen,370285116,30796,6016,20820,15866,40754,20735,5385,21183,41918,21377,42197
·ֵ,BanYangLuJieDao,370302001,47849,3800,30578,19668,39081,27103,8699,26176,53279,29770,60348
·ֵ,SongLingLuJieDao,370302002,47977,3557,31503,18539,36381,25098,9438,24825,49923,29469,60972
̳·ֵ,ShangChengLuJieDao,370302003,21426,1583,13378,9529,15333,13248,4031,13459,26707,13662,27040
¥ֵ,ZhongLouJieDao,370302004,40733,4086,27516,14454,32591,20555,7042,20404,40959,24345,51861
,ChengNanZhen,370302101,23414,3139,15923,10464,22971,14761,4552,14514,29275,15182,31105
,KunLunZhen,370302102,38756,5162,23153,16235,40792,22449,6050,21570,44019,26815,49968
Ŵ,CiCunZhen,370302103,17398,3333,12090,9209,22350,11806,3588,11636,23442,12229,24319
,LingZiZhen,370302104,26429,4035,16570,12403,31104,16462,4741,16090,32552,18635,35205
̼,ShangJiaZhen,370302105,14172,2407,9993,6942,18554,9901,3094,9482,19383,9680,19673
,HeiWangZhen,370302108,15968,2855,10617,7044,20682,10568,3004,10465,21033,11210,21827
ͺ,ZiHeZhen,370302109,14573,2523,9662,6852,19251,9627,2350,9677,19304,9784,19446
ƺ,DongPingZhen,370302110,9618,1962,6699,4902,12928,6698,1552,6433,13131,6433,13132
,XiHeZhen,370302111,15407,2720,10568,7908,19486,10529,2694,10142,20671,10253,20821
Ȫ,LongQuanZhen,370302112,29685,4807,20431,13767,36801,20014,5888,19349,39363,19949,40380
կ,ZhaiLiZhen,370302113,24268,3987,16886,10972,28910,16415,4972,15674,32089,16341,33227
޴,LuoCunZhen,370302114,41176,6577,28334,19820,52992,28106,8549,27425,55531,27968,56302
ɽ,HongShanZhen,370302115,37570,6040,25608,18332,37662,25071,6860,23738,48809,24862,50470
˫,ShuangYangZhen,370302116,54596,5853,34217,24674,52192,33208,11112,34184,67392,37344,71561
̫,TaiHeXiang,370302200,12896,2690,9114,6425,17822,9040,2368,8703,17743,8840,17954
ׯ,EZhuangXiang,370302201,9939,1928,6837,5094,13530,6803,1892,6843,13646,6922,13759
ׯ,ZhangZhuangXiang,370302202,9129,1934,6304,4611,12162,6297,1415,6136,12433,6174,12478
վֵ´,CheZhanJieDaoBanShiChu,370303001,41132,5085,26631,19991,36487,25989,7103,25524,51513,26689,53320
԰ֵ´,GongYuanJieDaoBanShiChu,370303002,47791,5490,29340,17916,38199,23731,5609,22342,46073,29550,58890
԰ֵ´,XingYuanJieDaoBanShiChu,370303003,27230,3283,17151,12706,22912,16140,4693,16358,32498,18055,35206
ƽֵ,HePingJieDao,370303004,30644,4029,20680,14650,30798,20152,6063,19537,39689,20056,40736
Էֵ´,KeYuanJieDaoBanShiChu,370303005,99657,9162,64935,46009,97041,61473,20261,59813,121286,64145,129080
ֵ´,TiYuChangJieDaoBanShiChu,370303006,53157,5126,31374,23882,50350,30573,9297,30586,61159,36206,67580
ʯŽֵ´,ShiQiaoJieDaoBanShiChu,370303007,70437,5585,44769,29247,54914,41276,13877,40630,81906,45130,89899
ıɽֵ´,SiBaoShanJieDaoBanShiChu,370303008,24682,2722,15655,10244,24716,14925,4723,14679,29604,16472,32127
,MaShangZhen,370303100,102976,5619,58633,34866,64632,48002,15955,47341,95343,65917,124550
϶,NanDingZhen,370303101,68924,10301,43678,33029,70641,42101,11223,42506,84607,46770,90448
ˮ,FengShuiZhen,370303102,27801,3648,17673,11821,29351,16859,4985,16875,33734,18761,36434
,HuTianZhen,370303103,20149,2821,12846,9698,19671,12676,3547,12752,25428,13671,26517
,FuJiaZhen,370303104,53208,4383,31646,23406,36989,30903,10061,32424,63327,36006,67652
в,ZhongBuZhen,370303105,15707,2397,9209,6843,17943,9049,2318,8882,17931,11213,20422
,WeiGuZhen,370303106,19798,2565,13173,8000,24405,12996,4027,12745,25741,13217,26390
,FangZhenZhen,370303107,23228,2556,14168,7861,22132,12553,4207,12410,24963,15823,29991
Ƕֵ´,ChengDongJieDaoBanShiChu,370304001,37304,6041,24928,18347,40694,24532,5752,23209,47741,24169,49097
ֵ´,ChengXiJieDaoBanShiChu,370304002,55116,7265,35703,25005,52737,33257,7921,32096,65353,34599,70302
ļׯֵ´,XiaJiaZhuangJieDaoBanShiChu,370304003,20700,3439,13936,10575,21063,13915,3255,13397,27312,13458,27394
ɽͷֵ´,ShanTouJieDaoBanShiChu,370304004,40422,6788,26393,20133,42776,26121,5478,25603,51724,26295,52688
,YuChengZhen,370304102,58936,6715,39250,24486,56006,33373,10337,33065,66438,36738,75988
,BaiTaZhen,370304103,27283,3897,18222,12733,31337,18049,5581,17692,35741,18539,36761
˶,BaDouZhen,370304106,26242,6046,18215,14035,32886,18054,4069,17466,35520,18142,36357
ɽ,GuShanZhen,370304107,14036,2518,9848,7467,18461,9840,2928,9613,19453,9634,19482
ʯ,ShiMaZhen,370304108,15962,2750,10896,8266,21456,10864,3153,10899,21763,10969,21865
ɽ,BeiBoShanZhen,370304109,18726,2957,12311,9260,24723,12305,3318,12671,24976,12690,25001
ϲɽ,NanBoShanZhen,370304110,13818,2639,9148,7801,18175,9139,2057,9343,18482,9366,18514
ԴȪ,YuanQuanZhen,370304111,8662,1763,6043,5167,11705,6010,1578,5892,11902,5960,12003
,ChiShangZhen,370304112,12877,2456,8856,7345,16928,8809,2228,8658,17467,8705,17561
ؽֵ,WenShaoJieDao,370305001,60993,6854,40569,30141,61236,39880,12540,38934,78814,39818,80387
ѩֵ,XueGongJieDao,370305002,39139,3722,25971,19103,34575,25416,8293,24656,50072,25183,51154
ֵ,XinDianJieDao,370305003,48862,6172,31857,22419,46451,30366,8796,29507,59873,31973,63830
½ֵ,JiXiaJieDao,370305004,50135,4456,31897,20897,44700,30739,10822,30918,61657,33516,65413
ֵ,QiLingJieDao,370305005,22208,3847,15382,9685,28916,15366,4607,15247,30613,15280,30662
붼,QiDouZhen,370305100,35670,5295,23760,13598,40016,21676,6402,21422,43098,23607,47367
ʳ,HuangChengZhen,370305102,35644,6345,24499,15497,47986,24425,7594,24731,49156,25084,49583
,JingZhongZhen,370305103,21930,3831,15215,9957,29740,15133,5174,15453,30586,15720,30935
̨,ZhuTaiZhen,370305104,35460,5434,24434,15470,46652,24306,8481,24453,48759,24941,49375
̨,WuTaiZhen,370305106,17056,2847,11702,7888,22512,11541,3746,11727,23268,11947,23649
,JinLingZhen,370305107,11545,2073,7856,5375,12784,7545,2049,7277,14822,7811,15667
,NanWangZhen,370305108,41324,7708,27859,23065,48714,27670,6391,26868,54538,27564,55423
,FengHuangZhen,370305109,37294,5771,24854,15971,45449,24632,7960,24796,49428,26171,51025
ߺ,BianHeZhen,370305110,20528,3674,14178,9880,27750,14135,4159,14001,28136,14183,28361
˿·ֵ´,SiChouLuJieDaoBanShiChu,370306001,35890,4284,24277,15895,32309,21823,6339,21003,42826,22236,46513
ֵֽ´,DaJieJieDaoBanShiChu,370306002,29795,4075,20406,13485,28693,19176,5759,18276,37452,19223,39629
·ֵ´,QingNianLuJieDaoBanShiChu,370306003,40921,4395,25917,17762,39292,25248,7442,24130,49378,26841,52758
ֵ´,YongAnJieDaoBanShiChu,370306004,30705,3766,20451,13594,32060,19581,5631,18805,38386,19651,40102
Ǳ·ֵ´,ChengBeiLuJieDaoBanShiChu,370306005,11413,1483,7637,4503,11570,7034,2316,6834,13868,7575,15212
,BeiJiaoZhen,370306100,49524,4017,32887,11388,34635,18151,5544,17851,36002,26198,59085
Ͻ,NanJiaoZhen,370306101,28214,4201,19142,11768,33403,18467,5740,17954,36421,19013,38155
,WangCunZhen,370306102,31227,5532,21468,14891,40857,21361,6266,20409,41770,21557,43025
ˮ,MengShuiZhen,370306103,20401,3238,13948,9034,27073,13934,4176,13830,27764,13867,27815
ֵ´,SuoZhenJieDaoBanShiChu,370321001,50519,7475,34682,22219,60140,34625,10708,33852,68477,34020,68702
ٺֵ´,ShaoHaiJieDaoBanShiChu,370321002,66612,4518,43732,28268,53407,41534,16223,41484,83018,43621,87353
,QiFengZhen,370321101,37441,6724,25952,15752,51269,25946,8535,26713,52659,26748,52700
ϼ,XingJiaZhen,370321102,12716,2267,9126,5560,17157,8947,2875,8607,17554,8732,17858
ׯ,TianZhuangZhen,370321103,32284,5729,22920,14060,44273,22896,7117,22180,45076,22210,45130
,JingJiaZhen,370321104,29717,5421,20869,12655,40618,20862,6237,20497,41359,20506,41375
,MaQiaoZhen,370321105,23280,3242,15471,9864,28433,15030,5151,14985,30015,16202,31673
ׯ,ChenZhuangZhen,370321106,14025,2306,9826,6168,18816,9818,3203,9643,19461,9708,19534
³,XinChengZhen,370321107,25042,3885,17298,10757,33115,17252,5306,16827,34079,16935,34233
ܼ,ZhouJiaZhen,370321108,13303,2059,9246,5904,17807,9231,2923,8980,18211,9039,18285
ɽ,TangShanZhen,370321109,28201,4452,19613,11134,33638,17992,5460,17357,35349,18500,38113
,GuoLiZhen,370321110,37186,5078,24806,13707,41516,21665,6791,21374,43039,24249,49055
ֵ´,TianZhenJieDaoBanShiChu,370322001,29530,4221,20443,14223,33491,20151,6998,19891,40042,20306,40749
«ֵ´,LuHuJieDaoBanShiChu,370322002,29434,2599,19465,13486,25717,18231,6549,17809,36040,19117,38582
,QingChengZhen,370322101,23077,3510,16022,9382,31234,16011,5374,15912,31923,15939,31961
߳,GaoChengZhen,370322102,26724,4854,19214,13334,37202,19147,6543,18673,37820,18907,38121
կ,HeiLiZhaiZhen,370322103,28067,4155,19764,12000,38637,19728,7090,19415,39143,19548,39312
Ʒ,TangFangZhen,370322104,20967,3603,14913,10686,28753,14875,4874,14424,29299,14531,29444
,ChangJiaZhen,370322105,20020,3045,14067,8859,27264,14041,5028,13966,28007,14026,28093
,HuaGouZhen,370322106,37834,6338,26320,19175,52092,26040,8789,26091,52131,26641,52961
Ե,ZhaoDianZhen,370322107,12815,2096,8787,5882,17193,8702,2939,8755,17457,9063,17850
ľ,MuLiZhen,370322108,21810,3585,15432,8830,30317,15413,5399,15329,30742,15362,30794
ɽֵ´,LiShanJieDaoBanShiChu,370323001,73509,6177,48302,35252,74404,47232,17562,47658,94890,48946,97248
,NanMaZhen,370323100,45347,4793,30563,22007,50410,30189,10809,30030,60219,30386,60949
,TuMenZhen,370323101,11971,1947,7928,5948,15765,7928,2071,8061,15989,8061,15989
³,LuCunZhen,370323102,38373,5325,24718,15362,50026,22452,6648,22089,44541,25628,50346
,DongLiZhen,370323103,36869,5479,24850,17079,49361,24845,7912,25381,50226,25410,50260
ׯ,YueZhuangZhen,370323104,35706,4982,23522,17129,46905,23398,7205,24127,47525,24371,47893
,XiLiZhen,370323105,32385,5185,22113,14865,43798,22103,6974,22325,44428,22431,44544
ׯ,DaZhangZhuangZhen,370323106,26235,4349,17655,13727,35196,17626,4875,17708,35334,17804,35459
ׯ,ZhongZhuangZhen,370323107,21046,3260,14229,9826,28338,14096,4200,13986,28082,14277,28506
ż,ZhangJiaPoZhen,370323108,17976,2558,12174,8155,24085,12169,3898,12239,24408,12258,24432
,YanYaZhen,370323109,20336,3102,13481,9696,27065,13480,3750,13706,27186,13707,27188
ʯ,ShiQiaoZhen,370323110,20389,2915,13716,9446,27157,13707,4081,13652,27359,13669,27385
ׯ,XuJiaZhuangXiang,370323200,15133,2501,10030,7163,19887,10028,2433,10037,20065,10037,20067
,SanChaXiang,370323206,14770,2196,9379,6954,19086,9379,2259,9846,19225,9846,19225
Ľֵֽ´,ZhongXinJieJieDaoBanShiChu,370402001,30412,3295,20042,13285,28442,19931,6713,20220,40151,20378,40420
ֵ´,GeTaBuJieDaoBanShiChu,370402002,40519,3212,25016,17946,38742,24716,7085,25034,49750,25800,50816
ֵ´,KuangQuJieDaoBanShiChu,370402003,17175,4609,12624,8781,21074,12623,3266,12419,25042,12426,25050
Ļ·ֵ´,WenHuaLuJieDaoBanShiChu,370402004,61556,6664,40725,26098,66600,40500,13151,40021,80521,40646,81371
ɽ·ֵ´,LongShanLuJieDaoBanShiChu,370402005,28909,4105,19514,13566,26188,19472,6068,19513,38985,19568,39082
·ֵ´,GuangMingLuJieDaoBanShiChu,370402006,45363,4162,29980,19614,39901,29900,11323,30719,60619,30868,60848
˰,ShuiGuoZhen,370402101,31646,3929,22222,13144,42270,22158,9581,22774,44932,22934,45156
ׯ,MengZhuangZhen,370402102,21804,2846,14843,8241,28378,14641,5534,15060,29701,15341,30184
,QiCunZhen,370402103,53600,5996,35346,18558,57928,31434,12431,32129,63563,36681,72027
,YongAnXiang,370402201,36088,3648,24887,13952,42314,24576,9686,24342,48918,24535,49422
ׯ,XiWangZhuangXiang,370402202,30569,3735,20203,11738,39281,20115,6835,20787,40902,20936,41139
ٳǽֵ´,LinChengJieDaoBanShiChu,370403001,64812,6308,41002,24989,74369,37759,13740,39356,77115,43858,84860
ʽֵ´,XingRenJieDaoBanShiChu,370403002,49311,3294,29801,17987,35817,26863,9805,28096,54959,32609,62410
˳ǽֵ´,XingChengJieDaoBanShiChu,370403003,19818,2525,13414,8184,25365,13395,5063,13877,27272,13992,27406
ɳ,ShaGouZhen,370403101,32718,5431,22785,13984,42974,22722,8524,23791,46513,23888,46673
Ӫ,ZhouYingZhen,370403102,37089,5353,24748,14110,47734,23423,9149,24852,48275,26843,51591
,ZouWuZhen,370403103,28118,4495,19122,12597,33971,18597,6489,19301,37898,19980,39102
ׯ,TaoZhuangZhen,370403104,50701,8094,31938,20462,64221,30899,9458,31614,62513,36315,68253
ׯ,ChangZhuangZhen,370403106,52215,5752,32943,18904,55897,30012,11186,31750,61762,36210,69153
ŷ,ZhangFanZhen,370403107,23319,3533,15611,9490,28810,15581,5150,16270,31851,16391,32002
̳ɽֵ,TanShanJieDao,370404001,48540,4164,31834,19500,57448,30580,12817,33101,63681,33687,65521
ֵֽ,WuLinJieDao,370404002,23448,3237,16435,10231,30806,16423,7241,17443,33866,17491,33926
,GuShaoZhen,370404100,47252,5781,31345,18854,63063,30892,13079,34065,64957,34767,66112
ƽ,YinPingZhen,370404101,33607,5310,22825,15019,46424,22198,8717,23885,46083,24809,47634
׸,DiGeZhen,370404102,28553,3919,19114,12924,37422,18579,7633,20056,38635,20991,40105
԰,LiuYuanZhen,370404103,41875,5501,27392,17497,49677,26069,9112,28261,54330,29096,56488
ɽ,EShanZhen,370404104,37882,5631,25694,16757,51170,25621,10939,28651,54272,28758,54452
˺ӽֵ´,YunHeJieDaoBanShiChu,370405001,31976,2774,20106,13019,34750,19242,7258,20593,39835,21902,42008
ׯ,PiZhuangZhen,370405100,19497,2354,13083,7665,23760,13066,5119,13787,26853,13887,26970
ɽ,ZhangShanZiZhen,370405101,29847,4673,19405,13173,38134,19151,6312,20627,39778,21427,40832
๵,NiGouZhen,370405102,38848,5655,27067,17657,51304,27002,12030,29326,56328,29466,56533
ͷ,JianTouJiZhen,370405103,38616,5910,25808,16962,50077,25644,9105,27641,53285,27823,53631
,MaLanTunZhen,370405104,43432,5693,28397,18464,52890,28241,10375,30933,59174,31103,59500
ɽǽֵ´,ShanChengJieDaoBanShiChu,370406001,72849,7954,45748,22735,91729,40352,18442,44406,84758,53497,99245
,DianZiZhen,370406101,22914,2871,14912,8557,29592,14883,5515,16338,31221,16388,31300
,XiJiZhen,370406102,20700,3426,14483,8492,27016,14206,5442,14626,28832,15085,29568
ɣ,SangCunZhen,370406103,41827,5919,26476,16199,54708,25486,8805,28428,53914,30075,56551
ׯ,BeiZhuangZhen,370406104,27213,4045,18705,11218,36084,18326,7569,19418,37744,20122,38827
ͷ,ChengTouZhen,370406105,29775,4639,19824,11812,39124,19284,6929,20618,39902,21519,41343
ׯ,XuZhuangZhen,370406106,33320,6079,23895,14370,46133,23862,9946,25379,49241,25450,49345
ˮȪ,ShuiQuanZhen,370406107,27492,4706,18463,11130,37821,18273,7214,20636,38909,20949,39412
î,FengMaoZhen,370406108,37010,5162,24235,13700,48301,23723,9063,26281,50004,27000,51235
,FuChengXiang,370406200,19480,3432,13635,8007,26647,12962,5066,13350,26312,14343,27978
ӽֵ,JingHeJieDao,370481001,98616,8568,60731,42409,89054,59668,20623,64900,124568,67076,127807
Ȫֵ,LongQuanJieDao,370481002,127726,10419,74985,42290,106422,61057,22753,65720,126777,85913,160898
ֵ,BeiXinJieDao,370481003,93114,7751,52977,32819,87850,49310,16058,52604,101914,63946,116923
Ͻֵ,ShanNanJieDao,370481004,19562,1918,11821,6498,18048,10374,3696,10933,21307,13355,25176
ɳ,DongShaHeZhen,370481100,36729,4841,23465,14306,47111,23244,7452,25208,48452,25557,49022
,HongXuZhen,370481101,28050,3839,17617,10585,34991,17241,5199,18583,35824,19471,37088
ɳ,NanShaHeZhen,370481102,33232,4414,21306,12185,43251,21293,6643,22977,44270,22983,44289
,DaWuZhen,370481103,60343,8888,38741,22731,78757,37266,12177,39881,77147,42667,81408
,BinHuZhen,370481104,70570,10803,45187,27369,91529,44427,14490,47512,91939,50676,95863
,JiSuoZhen,370481105,61341,8196,38028,22245,79303,37070,11120,40192,77262,42629,80657
,XiGangZhen,370481106,76389,10041,48028,32396,98504,46233,15180,47889,94122,53582,101610
,JiangTunZhen,370481107,57344,8021,37139,23160,75480,37119,11471,39532,76651,39697,76836
,BaoGouZhen,370481108,61508,7944,38412,22108,79323,37727,11567,40957,78684,42607,81019
,ZhangWangZhen,370481109,63373,8077,38818,24610,80068,37684,12107,41319,79003,44739,83557
,GuanQiaoZhen,370481110,47116,7478,30147,20268,59249,29354,7709,30345,59699,32156,62303
,ChaiHuDianZhen,370481111,25900,4014,16675,11199,32850,16608,4509,17133,33741,17748,34423
ׯ,YangZhuangZhen,370481112,49114,8292,32185,21478,64742,31694,9349,33788,65482,34570,66755
ľʯ,MuShiZhen,370481113,33887,4501,21495,13171,42312,21172,5846,22211,43383,22739,44234
,JieHeZhen,370481114,49152,6575,31924,20445,64311,31449,10247,33368,64817,34050,65974
,LongYangZhen,370481115,49127,6684,31412,19354,64422,31251,9823,33617,64868,34222,65634
,DongGuoZhen,370481116,74624,10144,48468,28109,97420,47709,17415,52025,99734,53715,102183
Ļֵ´,WenHuiJieDaoBanShiChu,370502001,99988,7786,59614,38654,65776,49988,15990,48628,98616,64150,123764
ƺ·ֵ´,HuangHeLuJieDaoBanShiChu,370502002,81380,7711,52966,39107,62898,51084,16685,50310,101394,52810,105776
ǽֵ´,DongChengJieDaoBanShiChu,370502003,90274,4181,55713,34268,58631,46477,17970,47213,93690,56712,112425
ֵ´,XinDianJieDaoBanShiChu,370502004,104264,11516,67862,49397,100032,65344,21364,64010,129354,69282,137144
ʤֵ´,ShengLiJieDaoBanShiChu,370502005,93921,9599,60809,45180,74273,58995,19130,57757,116752,61841,122650
ʤ԰ֵ´,ShengYuanJieDaoBanShiChu,370502006,13591,1852,8783,6301,12589,8416,2918,8283,16699,9578,18361
ţׯ,NiuZhuangZhen,370502102,24970,4375,17585,13146,32802,17549,5676,17172,34721,17436,35021
,LiuHuZhen,370502103,11791,1739,8132,5710,14721,8074,2689,7899,15973,8087,16219
ʷ,ShiKouZhen,370502104,25249,4103,17010,11745,31656,16751,5149,16365,33116,17491,34501
,LongJuZhen,370502105,23735,3417,16068,9680,31372,16063,4782,15764,31827,15866,31934
Ӫÿ,DongYingJingJiKaiFaQuLei,370502106,16014,502,7981,4225,4187,5929,2365,5963,11892,10900,18881
ӿڽֵ,HeKouJieDao,370503001,59885,6672,38975,28624,61943,36301,11914,35812,72113,39496,78471
Ͻֵ,LiuHeJieDao,370503002,23400,2170,14995,10931,18238,14771,4906,15011,29782,15481,30476
,YiHeZhen,370503100,14846,2471,10176,7005,19216,10100,2998,9820,19920,10139,20315
ɺ,XianHeZhen,370503101,35425,2015,22343,16826,33788,21782,8213,21755,43537,23310,45653
µ,GuDaoZhen,370503102,34819,3886,22876,17751,32581,22389,7363,22032,44421,23192,46068
»,XinHuZhen,370503103,15418,2592,10476,7826,19936,10392,3076,10084,20476,10610,21086
ӿھÿ,HeKouJingJiKaiFaQu,370503400,1486,19,521,322,15,351,123,396,747,1107,1628
Ӫ۾ÿ,DongYingGangJingJiKaiFaQu,370503500,3549,59,1299,807,187,993,290,1102,2095,2599,3898
ֵ´,KenLiJieDaoBanShiChu,370521001,42397,4959,27205,17522,35063,24829,7695,24117,48946,27846,55051
¡ֵ´,XingLongJieDaoBanShiChu,370521002,10737,1043,6662,4873,4341,6563,1626,6442,13005,6744,13406
ʤ,ShengTuoZhen,370521101,41947,5708,27955,17346,48273,27304,9454,27176,54480,29154,57109
¼,HaoJiaZhen,370521102,11548,2041,8068,5612,14388,7944,2652,7834,15778,8173,16241
,YongAnZhen,370521104,12626,2162,8897,6234,16497,8689,2648,8142,16831,8539,17436
ƺӿ,HuangHeKouZhen,370521105,16953,2739,11903,7992,22096,11891,3691,11454,23345,11480,23383
,DongJiZhen,370521106,12988,2159,9171,6152,16444,9044,3317,8924,17968,9293,18464
缶,KaiFaQuLeiSiXiangJiDan,370521400,2756,41,1476,756,938,1055,492,1006,2061,1813,3289
ܻ缶,SheGuanHuiLeiSiXiangJiDan,370521401,26610,2076,17235,11754,17427,15863,5821,15593,31456,17272,34507
缶λ,HongGuangLeiSiXiangJiDanWei,370521402,1338,70,433,305,646,396,110,442,838,1085,1518
Ѷ缶λ,KenDongLeiSiXiangJiDanWei,370521403,1616,64,844,739,0,819,208,922,1741,1044,1888
ֵ´,LiJinJieDaoBanShiChu,370522001,23103,4065,16087,9979,27416,15612,4542,14891,30503,15623,31710
˳ǽֵ´,FengHuangChengJieDaoBanShiChu,370522002,16063,2048,10743,6418,15585,9913,3087,9640,19553,10455,21198
,BeiSongZhen,370522101,25269,3861,17118,10811,33378,17070,5179,17012,34082,17191,34309
,YanWoZhen,370522102,50682,7532,34345,20354,67019,34300,10340,34067,68367,34209,68554
ׯ,ChenZhuangZhen,370522103,37361,5327,25353,15507,46126,24077,7708,23639,47716,25043,50396
͡,TingLuoZhen,370522104,20774,3387,14449,9004,27751,14344,4750,14286,28630,14462,28911
,MingJiXiang,370522201,11337,1979,7928,5504,15472,7928,2577,7869,15797,7965,15893
,DiaoKouXiang,370522206,1628,89,810,585,590,715,217,782,1497,1124,1934
ί,ChengQuGuanWeiHuiLeiSiXiang,370522207,21872,1860,14420,9601,17753,12980,4615,12547,25527,13927,28347
Ľֵ´,GuangRaoJieDaoBanShiChu,370523001,76834,8957,50848,31356,80383,47398,16231,46432,93830,51174,102022
ְֵ´,LeAnJieDaoBanShiChu,370523002,36845,4556,23855,14477,40384,22465,7713,22269,44734,25259,49114
,DaiWangZhen,370523101,72567,9779,47638,29867,83936,45161,16196,45608,90769,50904,98542
ׯ,DaoZhuangZhen,370523102,54852,7873,35245,23862,60539,33029,10879,33359,66388,38359,73604
ׯ,DingZhuangZhen,370523104,30289,4163,20916,15405,38480,20593,7562,20328,40921,21098,42014
ȵ,LiQueZhen,370523106,25011,4040,16982,10745,33284,16846,5621,17167,34013,17690,34672
ͷ,DaMaTouZhen,370523107,31571,5570,22060,16092,42488,21988,7016,21862,43850,22097,44157
,HuaGuanZhen,370523108,27721,3426,18935,12943,36973,18863,7033,19076,37939,19245,38180
¹,ChenGuanXiang,370523208,14339,2195,10269,7708,19369,10226,3722,9822,20048,9987,20256
㱱ũܳ,GuangBeiNongChangZongChang,370523400,3415,916,2452,2060,3966,2410,631,2329,4739,2510,4962
ֵ,XiangYangJieDao,370602001,47675,6995,28633,19113,46964,24867,4449,23496,48363,30486,59119
ɽֵ,DongShanJieDao,370602002,52033,8827,35788,23066,56163,32258,7367,28828,61086,32439,68227
ع諶ֵ,YuHuangDingJieDao,370602003,63242,10309,41591,27745,66412,37741,8447,35152,72893,40407,81998
ֵͨ,TongShenJieDao,370602004,25852,3096,15992,12174,23075,15716,3628,15533,31249,16584,32576
ֵ̨,FengHuangTaiJieDao,370602005,47561,4108,29327,20278,42826,26985,7929,26814,53799,30271,59598
ɽֵ,QiShanJieDao,370602006,50604,7485,33299,24179,50670,32760,6817,31004,63764,31607,64906
ʯֵ,BaiShiJieDao,370602007,43065,6431,27698,20057,40045,26533,5328,25355,51888,27126,54824
֥ֵ,ZhiFuDaoJieDao,370602008,19177,1616,9171,6594,11635,8448,1995,8475,16923,13617,22788
ֵ,HuangWuJieDao,370602009,50839,4522,30864,22416,36920,28713,8264,28552,57265,32761,63625
ֵֻ,ZhiChuJieDao,370602010,48106,4475,29871,21996,38818,28920,8123,28632,57552,30833,60704
Ңֵ,ShiHuiYaoJieDao,370602011,73167,3439,45523,23842,45458,31509,9990,30658,62167,41073,86596
Ҹֵ,XingFuJieDao,370602012,139637,10884,85661,66158,105115,82234,24572,85647,167881,89432,175093
ֵ,QingYangJieDao,370611001,83857,7230,51816,38107,65362,49294,13880,48604,97898,53151,104967
½ֵ,FuXinJieDao,370611002,49455,2777,29107,17847,25652,22735,7401,23004,45739,30526,59633
ֵֽ̨,GuXianJieDaoYanTaiKai,370611003,84739,3591,39818,10555,24401,13832,3159,13639,27471,51671,91489
󼾼ҽֵ̨,DaJiJiaJieDaoYanTai,370611004,24856,4261,16401,12372,27521,15114,3378,14738,29852,16094,32495
˽ǽֵ̨,BaJiaoJieDaoYanTaiKai,370611005,20106,2041,10964,6159,14549,8302,1854,8048,16350,13037,24001
ֵ´,DongTingJieDaoBanShiChu,370611006,8663,1718,5614,4484,10286,5596,952,5652,11248,5719,11333
¥ֵ´,MenLouJieDaoBanShiChu,370611007,37019,7031,24138,18344,44826,23799,4373,23601,47400,24285,48423
,GaoTuanZhen,370611102,15921,3648,10592,8780,20242,10592,1590,10551,21143,10567,21159
Ÿׯ,ZhangGeZhuangZhen,370611103,10824,2678,7345,6157,14130,7316,1170,7220,14536,7327,14672
,HuiLiZhen,370611104,20716,4244,13725,10961,26440,13687,2511,13626,27313,13746,27471
�,HaiHeSheQuGuanLiChu,370611400,73058,4418,42115,26184,39132,33562,10177,33220,66782,45538,87653
�,ChangJiangSheQuGuanLiChu,370611401,64902,3016,37129,24340,31485,29730,9254,31125,60855,40043,77172
ֵ,NingHaiJieDao,370612001,77179,6841,49070,33763,72794,44164,12281,43430,87594,47231,96301
Ļֵ,WenHuaJieDao,370612002,57672,5955,36709,27249,62037,35311,9467,35020,70331,36385,73094
�ֵ,YangMaDaoJieDao,370612003,4823,805,3133,2375,5428,3072,656,2936,6008,3151,6284
ֵ,WuNingJieDao,370612004,25186,3682,15927,11684,24421,15174,3359,15306,30480,16300,32227
Ҥֵ,DaYaoJieDao,370612005,24591,3791,15506,11662,25527,14359,2760,14258,28617,15636,31142
ׯֵ,JiangGeZhuangJieDao,370612006,27891,7338,18966,15993,35740,18809,2562,18556,37365,18825,37791
ˮ,GuanShuiZhen,370612101,38843,7564,24732,19015,48987,24655,3970,25516,50171,25645,50377
Ȫ,LongQuanZhen,370612105,18019,4593,11901,10076,23219,11858,1542,12114,23972,12253,24154
ֵ,YuLinDianZhen,370612106,13466,3122,8821,6588,17151,8794,1321,8982,17776,9088,17909
ˮ,ShuiDaoZhen,370612107,22538,4885,14115,11053,27517,13581,2241,13836,27417,15549,29664
ׯ,JuGeZhuangZhen,370612108,12950,3177,8639,6951,16472,8623,1266,8704,17327,8754,17393
,GaoLingZhen,370612109,24953,5377,16163,11408,31201,16096,2575,16596,32692,16742,32905
ׯ,WangGeZhuangZhen,370612110,14177,3120,8603,7154,16890,8448,1369,9108,17556,10063,18666
ƺ·ֵ,HuangHaiLuJieDao,370613001,78339,4168,46654,20075,34306,26727,6956,25411,52138,42809,89463
ҽֵ,ChuJiaJieDao,370613002,49782,4081,30987,20518,32290,26494,8004,26040,52534,30880,61867
·ֵ,BinHaiLuJieDao,370613003,48876,2473,27612,12754,21445,16162,4643,15955,32117,28380,55992
ׯֵ´,JieJiaZhuangJieDaoBanShiChu,370613004,14607,3036,9511,7824,17109,9446,1700,9504,18950,9832,19343
ɽֵ´,LaiShanJieDaoBanShiChu,370613005,32769,4767,21060,15530,33125,20409,4589,20115,40524,21065,42125
Ժׯֵ´,YuanGeZhuangJieDaoBanShiChu,370613006,12235,2684,7991,6651,15333,7970,1281,8188,16158,8209,16200
ɽֵ´,MaShanJieDaoBanShiChu,370613007,38477,3104,23196,8941,19237,11655,2733,11301,22956,21118,44314
ϳɽֵ´,NanChangShanJieDaoBanShiChu,370634001,19099,2424,12229,9269,19371,11954,2891,11531,23485,12185,24414
,TuoJiZhen,370634101,5126,1062,3461,2470,6411,3338,570,3133,6471,3297,6758
ɽ,BeiChangShanXiang,370634201,2907,435,1714,1433,2419,1671,432,1856,3527,2060,3774
ɽ,HeiShanXiang,370634202,1294,230,742,618,1222,667,144,692,1359,926,1668
յ,DaQinDaoXiang,370634203,2752,587,1845,1435,3414,1829,462,1853,3682,1956,3801
Сյ,XiaoQinDaoXiang,370634204,480,128,327,275,580,318,50,302,620,331,658
,NanHuangChengXiang,370634205,832,92,534,324,786,429,150,432,861,540,1074
,BeiHuangChengXiang,370634206,1412,285,883,677,1593,836,181,877,1713,995,1878
ֵ,DongLaiJieDao,370681001,87504,9930,56866,41572,81502,55519,15020,53822,109341,55588,112454
۽ֵ,LongGangJieDao,370681002,114112,12593,71884,53724,110137,70251,18435,69432,139683,73256,145140
¼νֵ,XinJiaJieDao,370681003,18554,2320,11554,8198,17834,10886,2607,10716,21602,11927,23481
츣ֵ´,XuFuJieDaoBanShiChu,370681004,45236,4388,24019,13513,30151,17587,4301,17607,35194,29906,53925
ֵ´,DongJiangJieDaoBanShiChu,370681005,53544,5400,31617,18367,43937,26330,6428,25932,52262,33755,65372
ɽ,HuangShanGuanZhen,370681102,8376,1630,5450,4305,10035,5327,1038,5183,10510,5594,11044
,BeiMaZhen,370681103,43117,6940,28308,21340,49956,27512,6029,26823,54335,27778,56086
«ͷ,LuTouZhen,370681104,24190,3257,15456,11522,25269,15078,3683,15112,30190,15674,31130
¶,XiaDingJiaZhen,370681106,12246,1681,7640,4990,14342,7473,1607,7402,14875,7894,15534
߼,QiJiaZhen,370681107,18265,2991,12047,8757,24160,12046,3057,12263,24309,12266,24313
ʯ,ShiLiangZhen,370681108,41985,6947,27942,20006,52844,26800,6430,26489,53289,27420,55362
,LanGaoZhen,370681109,32766,5387,21284,15396,39880,20880,4490,20836,41716,21359,42643
ɹ,ZhuYouGuanZhen,370681110,39398,6827,26196,19823,47701,25955,5546,25403,51358,25575,51771
ֵ,ChengXiangJieDao,370682001,136145,13399,85654,57190,121350,77797,22813,76170,153967,86703,172357
ֵ,GuLiuJieDao,370682002,40339,4978,26158,17219,41257,25395,6907,25356,50751,26066,52224
ׯֵ,LongWangZhuangJieDao,370682003,28445,4180,18913,10900,30353,16267,3795,16416,32683,17507,36420
ׯֵ,FengGeZhuangJieDao,370682004,24640,3831,16247,10069,30863,16122,4084,16154,32276,16308,32555
ׯֵ´,BoLinZhuangJieDaoBanShiChu,370682005,25118,3708,15905,9003,26653,14054,3908,14285,28339,16829,32734
ԡ,MuYuDianZhen,370682101,47743,8434,30876,20506,60457,29995,6953,30980,60975,32254,63130
,TuanWangZhen,370682102,47519,7883,31156,20563,61399,31143,7748,31925,63068,31994,63150
Ѩ,XueFangZhen,370682103,42223,7122,27926,18699,54851,27679,7094,28219,55898,28513,56439
,YangJunZhen,370682104,19054,3453,12668,9333,24853,12614,3096,12886,25500,12935,25603
,JiangTuanZhen,370682105,40381,6894,26077,16897,51711,25394,6010,26455,51849,27208,53285
,WanDiZhen,370682106,44250,8652,28854,20662,57438,28709,5830,29632,58341,29878,58732
ׯ,ZhaoWangZhuangZhen,370682107,38059,6240,24715,15594,49080,24640,5681,25153,49793,25265,49980
̷ׯ,TanGeZhuangZhen,370682108,34166,6502,22529,17204,45086,22321,5139,22832,45153,23278,45807
,HeLuoZhen,370682110,16994,2775,11115,7175,21399,11056,2719,11263,22319,11373,22488
ׯ,LvGeZhuangZhen,370682111,19438,3535,12825,8468,25017,12636,3169,12917,25553,13317,26142
߸ׯ,GaoGeZhuangZhen,370682112,22582,3909,14625,10191,29390,14620,3431,15236,29856,15297,29922
,DaKuangZhen,370682113,22707,4136,14549,9987,29381,14358,3032,15030,29388,15326,29875
ɽǰ,ShanQianDianZhen,370682114,21144,3767,13730,9900,26793,13510,2837,13847,27357,14018,27748
Ĳ·ֵ,WenChangLuJieDao,370683001,74336,8926,48732,33088,64941,45711,12565,43865,89576,47095,95827
·ֵ,YongAnLuJieDao,370683002,43471,5634,27938,17872,38905,25651,6853,24846,50497,28020,55958
ɽֵ,SanShanDaoJieDao,370683003,53344,10717,34313,25741,60598,33610,6327,33927,67537,36075,70388
Ǹ·ֵ,ChengGangLuJieDao,370683004,53265,9225,34339,24948,50735,32193,7248,32602,64795,35399,69738
ķ·ֵ,WenFengLuJieDao,370683005,17117,3077,11100,8041,17726,10889,2560,11014,21903,11654,22754
ɳ,ShaHeZhen,370683101,76569,13911,50492,35204,92453,49398,12255,50283,99681,52243,102735
,ZhuQiaoZhen,370683102,44119,9997,29946,24014,55085,29566,5610,29037,58603,29780,59726
ҵ,GuoJiaDianZhen,370683103,37539,7193,24963,18243,49712,24929,5812,25421,50350,25581,50544
,JinChengZhen,370683104,26062,4823,15750,12688,27527,15322,3119,15391,30713,18254,34004
ƽ,PingLiDianZhen,370683105,30955,7019,20879,15475,37335,20307,3570,19782,40089,20665,41544
,YiDaoZhen,370683106,34998,7319,23243,17899,45805,23209,4365,23298,46507,23439,46682
̹,ChengGuoZhen,370683107,36772,6785,24093,16991,39101,22233,5082,22644,44877,24546,48639
ͷ,HuTouYaZhen,370683108,35388,8325,23704,17712,44332,23235,4743,23930,47165,24752,48456
,ZhaCunZhen,370683109,31031,5875,20501,14760,38179,20247,5594,20825,41072,21999,42500
,XiaQiuZhen,370683110,28845,4919,18741,14220,33008,18524,5183,19130,37654,20206,38947
ɽ,TuShanZhen,370683111,41501,7763,26588,18253,50043,25534,6190,25659,51193,28866,55454
ݽֵ,DengZhouJieDao,370684001,54851,5915,36017,26753,55530,35560,10173,34436,69996,34922,70939
Ͼɽֵ,ZiJingShanJieDao,370684002,29268,3181,19083,12677,26821,17000,4750,16277,33277,18116,37199
¸۽ֵ,XinGangJieDao,370684003,18872,2748,11865,9014,19532,10735,2332,10915,21650,12087,23952
ֵ,PengLaiGeJieDao,370684004,14280,1695,9432,6167,13069,8299,2035,7986,16285,8578,18010
ֵ,NanWangJieDao,370684005,16192,3120,10536,8369,19505,10391,2028,10630,21021,10804,21340
ҹ,LiuJiaGouZhen,370684102,21655,4136,14191,11666,26436,13914,2756,14106,28020,14356,28547
ˮ,ChaoShuiZhen,370684103,20543,4038,13463,10951,25288,13187,2433,12954,26141,13551,27014
,DaLiuXingZhen,370684105,18244,3267,11792,9292,22212,11487,2811,11513,23000,12530,24322
Сż,XiaoMenJiaZhen,370684106,26684,4776,17598,13104,34232,17116,3644,17174,34290,17506,35104
,DaXinDianZhen,370684107,51207,9744,33441,26954,65459,32669,6502,33243,65912,34012,67453
Ｏ,CunLiJiZhen,370684108,31028,5817,20311,16027,41094,19797,4528,20368,40165,21062,41373
,BeiGouZhen,370684109,42297,7843,27492,21468,52738,27017,5716,26938,53955,28364,55856
޷ֵ,LuoFengJieDao,370685001,53697,5831,34727,25236,50130,33434,9646,32703,66137,34447,69174
Ȫɽֵ,QuanShanJieDao,370685002,35474,3039,23164,16312,31682,22930,7355,22457,45387,22704,45868
ֵ֥,MengZhiJieDao,370685003,20140,2235,13209,9617,19000,13141,4028,13062,26203,13194,26403
Ȫֵ,WenQuanJieDao,370685004,39146,4296,25318,17199,34448,23550,7336,22781,46331,25460,50778
ؼҽֵ´,DaQinJiaJieDaoBanShiChu,370685005,21566,3775,13585,9780,24437,12734,3197,12857,25591,14953,28538
ׯ,XinZhuangZhen,370685101,24682,6023,17374,14478,32274,17355,3391,16577,33932,16722,34096
ׯ,CanZhuangZhen,370685102,21356,4973,14731,11947,26431,14507,2757,13842,28349,14355,29086
,JinLingZhen,370685103,27108,6078,18887,13749,35930,18826,4023,18197,37023,18322,37209
Ϲ,BiGuoZhen,370685104,22432,5030,15364,12574,29462,14918,3383,15044,29962,15481,30845
,LingLongZhen,370685105,21047,3692,14005,9631,25930,13611,3149,13071,26682,13883,27888
,ZhangXingZhen,370685106,43724,9113,29945,22467,56078,29307,6726,28689,57996,29618,59563
ĵ,XiaDianZhen,370685108,28509,6025,19256,15459,37819,19243,4648,19709,38952,19926,39182
ɽ,FuShanZhen,370685109,37650,6359,22959,18497,43334,22862,5740,23415,46277,26790,49749
ɽ,QiShanZhen,370685110,27470,5996,18730,14975,36298,18535,4399,18765,37300,19135,37865
ֵ,CuiPingJieDao,370686001,42215,5054,26984,20213,38626,25886,6726,25883,51769,27011,53995
ׯ԰ֵ,ZhuangYuanJieDao,370686002,44896,4808,28642,21888,35130,27619,7434,27250,54869,28496,57138
ɽֵ,SongShanJieDao,370686003,28926,5007,18220,13702,34398,17068,3445,17686,34754,19158,37378
,GuanLiZhen,370686101,25236,4568,16131,11631,32463,15647,3218,16050,31697,16891,33022
Ѳ,SheWoBoZhen,370686102,43665,8725,28608,22688,56973,28519,5772,29337,57856,29554,58162
ƼҲ,TangJiaBoZhen,370686103,18886,3744,12129,9932,24291,12127,2371,12861,24988,12872,25001
Ҵ,TaoCunZhen,370686104,60848,10889,39146,31519,73276,38211,7421,38370,76581,40012,79158
ͤ,TingKouZhen,370686105,22860,4995,14812,11990,27598,14445,2545,14962,29407,15588,30400
갼ׯ,ZangJiaZhuangZhen,370686106,56340,10186,35407,28103,67218,34357,6338,34540,68897,37457,72864
¿,SiKouZhen,370686107,14847,2774,9638,7665,19093,9610,2085,10003,19613,10068,19706
ռҵ,SuJiaDianZhen,370686108,24521,4286,16035,12154,31724,15833,3835,16377,32210,16607,32642
,YangChuZhen,370686109,18677,3519,12257,9339,23441,11805,2619,12202,24007,12558,24815
,XiChengZhen,370686110,14485,2596,9271,7265,17999,9042,2023,9427,18469,9833,19104
ٵ,GuanDaoZhen,370686111,21576,3888,13878,10816,27776,13819,2976,14439,28258,14562,28440
,MiaoHouZhen,370686113,13490,2765,8776,7511,16943,8729,1540,8897,17626,9019,17795
Բֵ,FangYuanJieDao,370687001,57812,6827,37387,27732,58967,36781,10142,36489,73270,37394,74781
ֵ,DongCunJieDao,370687002,61346,8136,39315,29751,55754,37286,9557,37483,74769,39724,79039
ǽֵ,FengChengJieDao,370687003,29581,4325,18753,12487,27070,15344,3871,15411,30755,19024,37777
ׯ,LiuGeZhuangZhen,370687102,45398,8697,29086,20928,53690,28138,5323,27763,55901,30332,59418
ʯ,PanShiDianZhen,370687103,20385,4725,13370,11055,26716,13197,2462,13705,26902,14202,27572
,GuoChengZhen,370687104,24043,5605,16249,14226,31380,16235,3244,16572,32807,16643,32892
ҵ,XuJiaDianZhen,370687105,33254,5738,21470,16428,40765,20796,4562,21400,42196,22084,43554
,FaChengZhen,370687106,29506,5532,19006,14793,38029,18942,3639,19616,38558,19671,38677
С,XiaoJiZhen,370687107,33687,7692,22303,18290,44360,22288,4279,23290,45578,23355,45658
д,XingCunZhen,370687108,32080,7544,22247,18546,42272,22193,4647,21848,44041,22024,44271
,XinAnZhen,370687109,33245,7059,22602,18059,44008,22585,4724,22364,44949,22426,45028
ʮ,ErShiLiDianZhen,370687110,21599,4744,14532,10664,28074,14519,3059,14808,29327,14870,29402
ּ,DaYanJiaZhen,370687111,20199,4160,13336,10868,25325,13124,2792,13155,26279,13815,27151
,ZhuWuZhen,370687112,25706,6019,17039,14718,34063,17006,3607,18173,35179,18293,35332
͹ҵӹ,WaiXiangXingGongYeJiaGongQu,370687401,14968,1036,9259,5536,9612,6758,2173,6875,13633,8918,18177
ǹؽֵ´,ChengGuanJieDaoBanShiChu,370702001,33603,3960,20067,14417,29937,19445,5054,18797,38242,22550,42617
Ϲؽֵ´,NanGuanJieDaoBanShiChu,370702002,44331,4312,28414,16814,31761,24250,7240,24226,48476,27469,55883
ؽֵ´,XiGuanJieDaoBanShiChu,370702003,55720,5204,35003,23521,45540,32892,10275,33477,66369,36196,71199
ؽֵ´,BeiGuanJieDaoBanShiChu,370702004,61746,6203,41286,26207,46447,37184,12215,36708,73892,38878,80164
ںӽֵ´,YuHeJieDaoBanShiChu,370702005,52861,6916,34562,21521,61574,34167,11041,34816,68983,36256,70818
ֵ´,WangLiuJieDaoBanShiChu,370702006,74124,7421,46945,22735,72755,38758,12892,39096,77854,47492,94437
ֵͤ´,HanTingJieDaoBanShiChu,370703001,74882,8842,46533,30649,74135,44747,13672,44249,88996,50863,97396
Ԫֵ´,KaiYuanJieDaoBanShiChu,370703002,24429,3396,15330,9917,25296,14945,4632,14907,29852,17127,32457
̵ֵ̽,GuDiJieDao,370703003,38653,7794,27230,18474,52263,27199,7606,26731,53930,26823,54053
ӽֵ,YangZiJieDao,370703004,15650,1834,8903,5542,15996,8082,2688,7720,15802,11269,20172
ݽֵ´,DaJiaWaJieDaoBanShiChu,370703005,58619,6675,37139,25273,64044,34850,11165,34355,69205,39320,76459
ֵ´,GaoLiJieDaoBanShiChu,370703006,59956,10440,41247,27151,79399,40619,12465,40801,81420,41614,82861
ֵ´,ZhuLiJieDaoBanShiChu,370703007,43725,6909,30429,17910,58072,30402,10074,30178,60580,30279,60708
˽ֵ´,FengHuangJieDaoBanShiChu,370704003,44484,3215,26891,16145,36154,23904,8484,24157,48061,29292,56183
ֵ´,FangAnJieDaoBanShiChu,370704004,34983,4753,23438,14983,45500,23418,7886,24142,47560,24184,47622
ǽֵ´,FangChengJieDaoBanShiChu,370704005,67694,9719,44515,28731,79558,43618,13583,43424,87042,46481,90996
ֵ´,JiuLongJieDaoBanShiChu,370704006,50466,7133,34570,20987,66011,34498,12728,35616,70114,35757,70327
챤ֵ´,HuangQiBaoJieDaoBanShiChu,370704007,34384,5071,23695,15130,45163,23671,8383,24122,47793,24143,47838
̫ׯ,TaiBaoZhuangZhen,370704108,94266,16561,66178,40613,124639,64571,20704,63535,128106,65353,131531
Ը,ZhaoGeZhen,370704109,47622,7721,33842,20860,63847,33820,12321,33755,67575,33822,67664
ؽֵ´,DongGuanJieDaoBanShiChu,370705001,62733,8350,39981,26692,63487,37033,9641,36645,73678,40743,80724
ݽֵ´,DaYuJieDaoBanShiChu,370705002,93083,6796,57273,35564,67069,48394,14428,48051,96445,57034,114307
԰ֵ´,LiYuanJieDaoBanShiChu,370705003,38686,3299,24302,16293,31243,23940,8666,23607,47547,26349,50651
إﱤֵ´,NianLiBaoJieDaoBanShiChu,370705004,25839,2644,17007,10284,26179,16563,5771,16158,32721,17247,34254
Ϋ·ֵ´,WeiZhouLuJieDaoBanShiChu,370705005,52961,6571,33064,21268,48946,30930,9378,29883,60813,35846,68910
Էֵ´,BeiYuanJieDaoBanShiChu,370705006,26691,2235,15598,10531,21702,14634,4281,14836,29470,17609,33207
Ľֵ´,GuangWenJieDaoBanShiChu,370705007,56149,5080,34076,18094,52343,27321,8822,26045,53366,35975,70051
³ǽֵ´,XinChengJieDaoBanShiChu,370705009,147667,8878,84168,43548,94460,63716,22001,62716,126432,94378,178546
ؽֵ´,QingChiJieDaoBanShiChu,370705010,47017,5952,30758,17853,50699,27349,9024,27239,54588,31235,61993
ǹؽֵ´,ChengGuanJieDaoBanShiChu,370724001,145238,14593,91989,47364,145502,73765,30376,75680,149445,98218,190207
ǽֵ´,DongChengJieDaoBanShiChu,370724002,81390,10298,53605,30322,96569,50478,17751,51493,101971,55834,109439
微,WuJingZhen,370724101,44383,7278,29397,18247,58192,27769,8599,27654,55423,30863,60260
ұԴ,YeYuanZhen,370724103,73564,10590,48193,26824,92701,44535,13782,45149,89684,49743,97936
ͷ,SiTouZhen,370724104,42318,6465,28043,18412,55084,27535,7506,27308,54843,28246,56289
ɽ,JiuShanZhen,370724105,33187,4315,22300,14745,42264,22216,6918,21995,44211,22120,44420
կ,XinZhaiZhen,370724107,74456,10438,49832,31610,96409,48771,15274,48779,97550,50336,100168
,LongGangZhen,370724112,46688,7634,30756,18895,60281,29847,8873,30945,60792,32439,63195
ɽ,LiuShanZhen,370724113,25250,4065,16634,10915,33475,16528,4677,17167,33695,17358,33992
ɽ,YiShanZhen,370724116,60233,7570,38749,24115,76670,37707,10605,37994,75701,39659,78408
ǹؽֵ´,ChengGuanJieDaoBanShiChu,370725001,83121,6497,51873,32707,59707,46685,16306,47213,93898,54051,105924
ǽֵ´,BaoChengJieDaoBanShiChu,370725002,49159,5400,30616,17343,49228,26783,8915,27191,53974,32858,63474
ֵ´,ZhuLiuJieDaoBanShiChu,370725003,25488,3485,16657,10475,31027,16473,4952,16727,33200,17268,33925
Ͻֵ´,ChengNanJieDaoBanShiChu,370725004,19172,2851,13105,8407,24502,13006,4524,13250,26256,13442,26547
ͼֵ´,WuTuJieDaoBanShiChu,370725005,21529,3043,14509,9244,28379,14471,4719,14644,29115,14782,29291
ǹ,QiaoGuanZhen,370725107,60910,8939,40671,24511,80511,40561,12618,41488,82049,41796,82467
,TangWuZhen,370725108,70121,10629,46415,27727,91898,46255,12510,46577,92832,46845,93260
,HongHeZhen,370725110,66415,9248,44151,25833,84748,42830,12795,42726,85556,44307,88458
Ӫ,YingQiuZhen,370725116,69257,9980,45587,27993,89224,45148,13327,45843,90991,46977,92564
�ֵ´,WangFuJieDaoBanShiChu,370781001,101657,12754,67913,36452,110200,55169,18829,54022,109191,65327,133240
涼ֵ´,YiDouJieDaoBanShiChu,370781002,79913,9866,51618,27713,81587,43415,15291,43112,86527,53452,105070
ɽֵ´,YunMenShanJieDaoBanShiChu,370781006,78559,8885,52278,32023,73260,50266,15722,49545,99811,50888,103166
¥ֵ´,HuangLouJieDaoBanShiChu,370781007,59610,8645,40121,22145,78322,40121,11800,39934,80055,39934,80055
ֺ,MiHeZhen,370781100,36519,6010,24711,14337,48435,24618,7016,24695,49313,24834,49545
,WangFenZhen,370781101,36068,5520,23633,14725,47217,23626,6464,24402,48028,24419,48052
,MiaoZiZhen,370781103,28481,4454,18767,12414,37493,18766,5212,19379,38145,19380,38147
ׯ,ShaoZhuangZhen,370781105,48298,8146,33200,20439,64494,33181,10284,33495,66676,33528,66728
,GaoLiuZhen,370781109,48828,8196,33274,20815,64657,32751,10315,33562,66313,34065,67339
ι,HeGuanZhen,370781111,54267,8033,36279,21993,70820,36188,11170,36907,73095,37191,73470
,DongXiaZhen,370781113,63049,9116,42061,24196,80113,41223,11918,41033,82256,42022,84083
̷,TanFangZhen,370781115,68179,9787,45439,27392,89767,45161,13494,45785,90946,46021,91460
ݽֵ´,MiZhouJieDaoBanShiChu,370782001,162000,16154,107089,61706,164884,98949,36098,98755,197704,107163,214252
ֵ´,LongDouJieDaoBanShiChu,370782002,113310,11057,74154,42901,107749,69424,25776,70070,139494,75989,150143
˴ֵ´,ShunWangJieDaoBanShiChu,370782003,99836,12208,65867,34914,111970,60979,22846,61782,122761,69023,134890
׹,ZhiGouZhen,370782101,30903,4956,21341,12384,40590,21154,7293,21539,42693,21811,43152
,JiaYueZhen,370782102,68444,11196,46304,28596,89846,46205,13588,46761,92966,46924,93228
ʯ,ShiQiaoZiZhen,370782105,41893,7569,28929,17301,56594,28904,9076,29444,58348,29609,58538
,XiangZhouZhen,370782108,43541,7707,30682,18062,57232,30245,10500,30514,60759,31066,61748
,ChangChengZhen,370782110,44639,7144,31756,17706,59515,31573,11425,31212,62785,31452,63208
ٳߺ,BaiChiHeZhen,370782111,30237,5539,21254,13176,40825,21198,7137,21504,42702,21659,42913
,XinXingZhen,370782112,26621,4637,18995,11201,35577,18840,6942,18925,37765,19205,38200
ּҴ,LinJiaCunZhen,370782114,62088,12233,43211,27474,85359,43182,14188,45110,88292,45298,88509
ʻ,HuangHuaZhen,370782117,47019,8352,32249,20589,62443,32200,10275,33250,65450,33397,65646
,TaoLinZhen,370782118,22800,4594,15315,10169,29866,14586,4401,15576,30162,16480,31795
ʥǽֵ´,ShengChengJieDaoBanShiChu,370783001,204049,12488,121017,75322,140514,102235,34847,105201,207436,130367,251384
ļҽֵ´,WenJiaJieDaoBanShiChu,370783003,43578,5560,28582,15567,50169,27556,9174,27991,55547,29730,58312
ųǽֵ´,GuChengJieDaoBanShiChu,370783004,45080,6188,28889,17469,52167,27573,8881,27723,55296,31260,60149
ǽֵ´,LuoChengJieDaoBanShiChu,370783005,78828,11735,52106,28841,96717,49243,16093,49899,99142,54550,106656
Ҽֵ´,SunJiaJiJieDaoBanShiChu,370783006,41469,6118,28416,16119,54416,28147,9681,28510,56657,28852,57268
,HuaLongZhen,370783100,38412,5692,26015,15546,49707,25532,8556,25801,51333,26645,52660
Ӫ,YingLiZhen,370783103,41251,8125,28529,18094,53118,27968,7715,26619,54587,28562,57091
̨ͷ,TaiTouZhen,370783104,43469,7246,29650,18315,55986,29320,9639,29498,58818,30704,60354
,TianLiuZhen,370783106,49122,8529,33711,21893,64103,32796,9514,32394,65190,33454,67165
Ͽ,ShangKouZhen,370783108,47453,8341,32966,19866,62601,32411,9976,32113,64524,32804,65770
,HouZhen,370783109,69872,12092,48195,30736,91250,47214,14773,45907,93121,48542,96737
̨,JiTaiZhen,370783111,37176,5642,25572,14986,49038,25331,9326,26009,51340,26572,52144
,DaoTianZhen,370783112,68038,10819,46241,27635,87956,45702,14871,46442,92144,47487,93728
,YangKouZhen,370783115,45892,5965,28996,21150,49010,28245,8179,28068,56313,31040,60036
˰ֵ´,XingAnJieDaoBanShiChu,370784001,169055,17503,110636,69132,163349,104060,38126,106484,210544,114048,224684
°ֵ,XinAnJieDao,370784003,104328,12329,68384,38614,122808,64424,22867,65568,129992,71140,139524
֥,JingZhiZhen,370784100,92387,13870,63116,37045,123252,62396,20446,62728,125124,63587,126703
,LingHeZhen,370784103,72773,10669,48824,27451,96912,47747,15627,48655,96402,50245,99069
ׯ,GuanZhuangZhen,370784104,37677,5851,25104,14672,49137,24759,7298,25195,49954,25722,50826
ʢ,DaShengZhen,370784107,24500,3522,15438,9146,31195,15147,3775,15888,31035,16359,31797
ʯ,ShiBuZiZhen,370784111,43214,7447,28763,18530,56561,28607,7672,29203,57810,29570,58333
ʯ,ShiDuiZhen,370784112,25586,3590,17329,10075,33839,17315,6191,18017,35332,18038,35367
ɽ,ZheShanZhen,370784118,21391,3101,13846,9375,27858,13785,3841,14371,28156,14487,28333
,HuiQuZhen,370784119,44158,7638,28855,18396,57825,28670,7527,30230,58900,30468,59323
ɽ,WuShanZhen,370784120,25711,4061,16594,10529,33326,16537,4109,17176,33713,17287,33881
ڣ,JinZhongZiZhen,370784121,28397,4141,19229,11440,37829,19053,6516,19534,38587,19825,39054
ֵ,ZhaoYangJieDao,370785001,86772,11200,59176,35500,92261,55727,20348,55890,111617,59144,118320
Ȫֵ,LiQuanJieDao,370785002,85211,10921,56222,34115,87164,52521,16228,52001,104522,56138,112360
ˮֵ,MiShuiJieDao,370785003,122250,13080,80852,48395,119432,75441,25976,75349,150790,80454,161306
س,BaiChengZhen,370785100,54752,9389,38383,20940,72996,35822,13094,35501,71323,38852,77235
ׯ,XiaZhuangZhen,370785103,64063,11272,44622,24994,83627,43184,13375,42597,85781,44088,88710
ׯ,JiangZhuangZhen,370785104,51840,9184,36503,21371,68734,35362,11429,35083,70445,35950,72453
Ĳ,DaMouJiaZhen,370785106,33650,6513,23906,14264,46306,23763,7406,23449,47212,23663,47569
ۼ,KanJiaZhen,370785109,54228,8656,37960,20554,72156,36217,12785,35374,71591,37709,75669
,JingGouZhen,370785111,44723,8030,31556,18829,60822,31074,10164,30703,61777,31361,62917
,ChaiGouZhen,370785114,56121,10025,39164,23708,75464,38166,12897,37673,75839,39879,79043
۽ֵ´,KuiJuJieDaoBanShiChu,370786001,78691,9118,52215,30563,76910,44521,15782,44147,88668,51376,103591
ֵ´,DouChangJieDaoBanShiChu,370786002,74852,10790,49563,30048,79461,44566,14267,44384,88950,50346,99909
Χӽֵ´,WeiZiJieDaoBanShiChu,370786003,71298,12163,48335,28216,92564,47580,15111,46990,94570,50237,98572
,LiuTuanZhen,370786101,35254,6656,24392,14543,45772,22959,6559,21971,44930,24077,48469
,LongChiZhen,370786102,19137,3680,12476,7978,23157,11931,3106,11465,23396,13447,25923
ׯ,BuZhuangZhen,370786104,39092,7262,26864,17237,50640,26275,7120,25476,51751,26610,53474
,YinMaZhen,370786108,60154,9923,41554,24589,79577,40565,13795,40713,81278,42318,83872
,BeiMengZhen,370786109,47225,8618,33375,20969,64701,33302,10434,32801,66103,32902,66277
Ӫ,XiaYingZhen,370786112,17289,2952,11716,6948,22331,11174,3154,10369,21543,11679,23395
Żֵ´,GuHuaiJieDaoBanShiChu,370802001,46336,6976,31577,19492,47367,27001,8818,26106,53107,30553,62130
ֵ´,JiYangJieDaoBanShiChu,370802002,28592,4034,18801,13351,27897,18166,5449,18178,36344,19274,38075
Žֵ´,FuQiaoJieDaoBanShiChu,370802003,95152,12329,62927,42353,95012,60227,17445,58735,118962,61999,124926
Խӽֵ´,YueHeJieDaoBanShiChu,370802004,22677,3254,15366,11179,20770,15016,4671,14642,29658,15236,30602
ֵ´,GuanYinGeJieDaoBanShiChu,370802006,50687,4320,32312,22228,35721,31670,10593,31767,63437,33288,65600
Էֵ´,NanYuanJieDaoBanShiChu,370802008,30186,3179,19953,13057,23280,19211,6611,18908,38119,20023,39976
ӽֵ´,AnJuJieDaoBanShiChu,370802009,51793,6860,35134,20919,67793,35125,11643,35142,70267,35162,70296
ƿڽֵ´,TangKouJieDaoBanShiChu,370802010,61318,7253,41256,23721,79775,40263,14620,40975,81238,41935,83191
,YuTunZhen,370802102,54231,7007,35953,21352,71346,35852,12827,36571,72423,38112,74065
ׯֵ´,XuZhuangJieDaoBanShiChu,370811002,46992,3659,29842,13577,34914,21961,7712,21586,43547,28521,58363
нֵ´,LiuXingJieDaoBanShiChu,370811003,28317,1947,17366,10136,22485,16202,6266,16280,32482,19164,36530
ӽֵ´,HuangHeJieDaoBanShiChu,370811004,23877,1822,15388,10694,16559,15086,5153,15035,30121,15464,30852
Ӫֵ´,LiYingJieDaoBanShiChu,370811005,68451,6423,42791,23726,58811,37653,13472,37823,75476,45555,88346
Žֵ´,NanZhangJieDaoBanShiChu,370811006,47485,5126,29748,19682,47787,28949,9916,29653,58602,32779,62527
Ӫֵ´,XianYingJieDaoBanShiChu,370811007,42453,3294,25749,12551,26702,17173,6248,17140,34313,26246,51995
ǽֵ´,JinChengJieDaoBanShiChu,370811008,68547,4951,42261,27543,43525,38060,14058,37982,76042,45295,87556
إֵ̽´,NianLiPuJieDaoBanShiChu,370811009,34772,4382,22624,15192,43781,22569,7491,23052,45621,24021,46645
ׯֵ´,JieZhuangJieDaoBanShiChu,370811010,47998,5731,32078,18200,60654,31213,10783,31045,62258,32434,64512
,ChangGouZhen,370811102,40482,5640,27524,17811,54854,27510,10936,29348,56858,29534,57058
ʯ,ShiQiaoZhen,370811109,33805,4809,22490,14201,44719,22039,8051,22585,44624,24175,46665
żö´,YanKuangJiTuanJiDongXinCun,370811400,16630,836,10143,7535,17680,10100,3636,10516,20616,10959,21102
ֵ´,XiaZhenJieDaoBanShiChu,370826001,84969,7915,45249,30460,81000,44641,15787,49047,93688,63422,108671
ֵ´,ZhaoYangJieDaoBanShiChu,370826002,33700,4229,21317,12232,39437,19502,7387,21248,40750,23999,45316
ׯ,HanZhuangZhen,370826101,41019,6502,28120,17289,53872,28042,9821,28929,56971,29222,57342
,HuanChengZhen,370826102,63409,7505,39824,25819,80411,39510,13142,43048,82558,44232,84056
,NanYangZhen,370826103,17123,2930,11784,6322,23247,11408,4414,11975,23383,12683,24467
³,LuQiaoZhen,370826104,32444,4503,21260,13151,42469,21028,7378,22056,43084,23065,44325
,FuCunZhen,370826105,30983,3460,19567,12168,39213,19060,6606,20710,39770,21482,41049
ׯ,LiuZhuangZhen,370826106,35654,4811,23724,14239,47815,23716,9921,26580,50296,26662,50386
,LiangChengZhen,370826107,42439,6704,29076,17578,58748,28951,11115,30853,59804,31182,60258
,MaPoZhen,370826108,38452,5610,25889,15898,52191,25857,9093,27191,53048,27266,53155
΢ɽ,WeiShanDaoXiang,370826200,8055,1678,6101,4169,11366,6099,2293,5921,12020,5925,12026
¥,GaoLouXiang,370826206,11947,1780,7936,4694,15942,7931,2644,8416,16347,8435,16371
¥,ZhangLouXiang,370826207,10325,1387,6931,3962,12941,6919,2332,7060,13979,7113,14044
,ZhaoMiaoXiang,370826209,10069,1225,6665,3644,12957,6441,2151,6477,12918,6780,13445
ƽ,XiPingXiang,370826210,6150,893,4150,2729,7881,4146,1403,4268,8414,4296,8446
ֵͤ´,GuTingJieDaoBanShiChu,370827001,27689,3724,17811,8930,32951,15573,5829,16237,31810,19431,37242
ֵ´,BinHuJieDaoBanShiChu,370827002,36913,4194,23378,10975,40083,18050,7603,18720,36770,25332,48710
,QingHeZhen,370827101,29169,4155,19631,10363,39464,18975,6774,19229,38204,20467,40098
,YuChengZhen,370827102,28526,4280,19223,10658,37303,18243,6179,18767,37010,19762,38985
³,WangLuZhen,370827103,29426,4029,19395,10805,36308,18445,6755,19106,37551,20815,40210
Ż,ZhangHuangZhen,370827104,41541,5388,26469,14513,52798,25946,9166,26592,52538,29626,56095
,WangMiaoZhen,370827105,40104,6094,26855,14561,53761,26472,8756,27239,53711,28099,54954
,LiGeZhen,370827106,27286,4018,18347,10294,36918,18142,6026,18630,36772,18983,37330
,TangMaZhen,370827107,22166,2972,15058,7784,26081,13695,4866,13742,27437,14946,30004
,LaoZhaiZhen,370827108,18259,2713,12329,6644,24175,12236,3621,12105,24341,12264,24593
,LuoTunXiang,370827204,21250,3031,14027,7846,28379,13708,4644,14123,27831,14898,28925
ֵ´,JinXiangJieDaoBanShiChu,370828001,73712,7268,46544,27331,76504,43085,15038,43890,86975,49474,96018
ɽ,YangShanZhen,370828101,35909,4777,24475,15026,48951,24377,9508,25567,49944,25719,50194
,HuJiZhen,370828102,42072,6146,28611,17137,55943,28196,11286,29670,57866,30893,59504
Ф,XiaoYunZhen,370828103,33551,5105,21982,14101,43943,21413,7241,22238,43651,23915,45897
,JiShuZhen,370828104,43051,5967,28573,18871,56606,28243,9811,29305,57548,30256,58829
ا,WangPiZhen,370828106,14964,2236,10078,6766,19996,10068,3303,10387,20455,10425,20503
˾,SiMaZhen,370828107,21149,3420,14391,9149,28331,14358,4630,14659,29017,14808,29199
ɽ,YuShanZhen,370828108,42484,4671,27468,16864,46163,25277,8829,25950,51227,28516,55984
,MaMiaoZhen,370828109,37826,5491,25895,16982,50958,25655,9445,26307,51962,26867,52762
,HuaYuZhen,370828110,33314,4332,22301,12488,44875,22241,8152,23363,45604,23497,45798
ߺ,GaoHeZhen,370828111,23790,3173,15830,10575,31498,15824,5283,16374,32198,16416,32246
,BuJiXiang,370828201,29478,4163,20322,12700,40561,20185,8087,21231,41416,21406,41728
¡,XingLongXiang,370828203,27027,3924,17995,11660,35913,17987,5649,18578,36565,18605,36600
ֵ´,JiaXiangJieDaoBanShiChu,370829001,79832,6891,52228,29450,78481,46647,21684,49219,95866,56179,108407
ֽ,ZhiFangZhen,370829101,53272,7288,38432,23550,72659,37365,18517,39602,76967,40645,79077
,LiangBaoSiZhen,370829102,45561,5960,30119,17063,58986,29326,13423,30924,60250,34825,64944
ɽ,WoLongShanZhen,370829103,43795,5852,32040,18627,60709,32016,15921,33443,65459,33528,65568
,TuanLiZhen,370829104,62260,8204,43291,25176,83543,43285,20016,46755,90040,47189,90480
,MaCunZhen,370829105,27264,3950,20053,11560,38644,20045,10145,21259,41304,21306,41359
,JinTunZhen,370829106,40752,5705,29161,17918,57310,29161,12510,29803,58964,29806,58967
¥,DaZhangLouZhen,370829107,24574,3347,17762,9815,34799,17752,8746,18891,36643,18905,36667
ɮ,LaoSengTangXiang,370829200,26119,3631,18850,11507,37487,18849,8708,19605,38454,19608,38458
,HuangGaiXiang,370829201,19752,3324,15025,8712,28628,15023,7745,15795,30818,15796,30821
,WanZhangXiang,370829204,27293,3560,19305,10923,38994,19303,9150,20698,40001,20698,40003
�,MaJiXiang,370829207,25562,3336,18204,11103,34897,18204,8628,19321,37525,19322,37526
,ManDongXiang,370829208,21723,3184,15541,9200,30823,15541,7090,16456,31997,16456,31997
ɽ,ZhongShanXiang,370829209,37190,5595,27727,18174,54468,27702,13378,28366,56068,28436,56163
Ϲü,MengGuJiXiang,370829210,25998,3578,18394,11019,36823,18392,8175,19352,37744,19357,37751
жֵ´,ZhongDouJieDaoBanShiChu,370830001,53978,5131,34631,21205,60720,33410,11344,34508,67918,35822,70453
Ͻֵ´,WenShangJieDaoBanShiChu,370830002,38308,3282,24367,13455,43344,21620,7762,21847,43467,24985,49352
վ,NanZhanZhen,370830101,50635,6878,34800,20726,68887,34439,12573,34408,68847,35286,70086
,NanWangZhen,370830102,36853,4598,25319,13555,50122,25317,11001,27088,52405,27133,52452
,CiQiuZhen,370830103,51136,7314,35619,18616,70018,35143,12112,33826,68969,34943,70562
,YinSiZhen,370830104,30907,4256,21461,11159,42185,21268,7345,20239,41507,21047,42508
¥,GuoLouZhen,370830105,28340,4068,20618,11211,38872,20210,7372,18473,38683,19162,39780
,KangYiZhen,370830106,50901,5635,33224,18509,68592,33143,12655,35817,68960,35967,69191
Էׯ,YuanZhuangZhen,370830107,22360,2949,16365,8992,31133,16359,5920,14815,31174,14864,31229
,YiQiaoZhen,370830108,29216,4195,20875,11779,40182,20542,7454,19177,39719,19990,40865
,GuoCangZhen,370830109,22173,3017,16249,8987,31053,16097,5877,14526,30623,14818,31067
ʯ,BaiShiZhen,370830110,24945,3333,16740,9129,32919,16563,5410,16305,32868,16948,33688
¥,LiuLouXiang,370830202,23454,3184,16761,9365,32181,16559,6791,16581,33140,16668,33429
,YangDianXiang,370830204,20803,2867,14731,8487,28452,14635,5283,13915,28550,14222,28953
,JunTunXiang,370830205,15038,2066,10923,6537,20829,10909,3898,10047,20956,10079,21002
ӽֵ´,SiHeJieDaoBanShiChu,370831001,40047,4581,26552,16576,41139,24808,8877,24632,49440,26953,53505
úӽֵ´,JiHeJieDaoBanShiChu,370831002,43603,5394,29270,19212,48310,28372,10148,28741,57113,29875,59145
Ȫ,QuanLinZhen,370831101,40045,6095,28172,18409,54811,27704,10073,27272,54976,28041,56213
Ǵ,XingCunZhen,370831102,31432,4889,21868,14048,42490,21798,7815,22091,43889,22268,44136
Ϲ,ZheGouZhen,370831103,21072,3244,14916,10019,28180,14736,5431,14489,29225,14831,29747
ׯ,JinZhuangZhen,370831104,34273,5121,23125,14990,45385,22865,7894,23625,46490,24163,47288
,MiaoGuanZhen,370831105,31503,5257,21970,14586,43188,21547,7940,21867,43414,22730,44700
в,ZhongCeZhen,370831106,21680,3439,14959,10163,29222,14680,5171,14774,29454,15331,30290
,YangLiuZhen,370831107,24615,3882,16623,9899,32833,16302,5109,16354,32656,16983,33606
,SiZhangZhen,370831108,29654,4595,20140,13772,39796,19888,6909,20501,40389,21018,41158
ʥˮ,ShengShuiYuZhen,370831109,26119,4363,18513,12789,36125,18416,6853,18585,37001,18822,37335
,GaoYuZhen,370831110,26265,3656,18597,12134,35420,18470,7493,18544,37014,18817,37414
ƹ,DaiHuangGouXiang,370831205,15384,2453,10677,6999,20772,10580,3713,10681,21261,10873,21550
ˮֵ´,ShuiBoJieDaoBanShiChu,370832001,61030,6512,39844,25795,67859,39381,14797,41223,80604,42495,82339
ɽֵ´,LiangShanJieDaoBanShiChu,370832002,59367,6290,38887,22453,62312,34591,14758,36690,71281,41528,80415
С·,XiaoLuKouZhen,370832101,30433,5019,22650,13852,43298,22457,9635,21793,44250,22437,45087
,HanGangZhen,370832102,38630,5533,27537,15467,53797,27039,10979,26466,53505,27605,55142
ȭ,QuanPuZhen,370832104,77463,10591,53886,29169,105426,53204,23660,56193,109397,57828,111714
Ӫ,YangYingZhen,370832105,37393,5726,26412,16701,50210,26213,10507,26724,52937,27214,53626
,HanGaiZhen,370832106,38545,4992,26653,14686,53427,26498,11334,27516,54014,28218,54871
,GuanYiZhen,370832107,32333,4060,23471,13845,44592,23293,10520,23139,46432,23442,46913
Сɽ,XiaoAnShanZhen,370832108,33546,4510,24369,14875,47037,23868,10704,23403,47271,24391,48760
ż,ShouZhangJiZhen,370832109,23200,3446,17012,10204,31920,16738,7816,16889,33627,17450,34462
ڻ,HeiHuMiaoZhen,370832110,19915,3082,14162,9083,28227,13895,5822,14000,27895,14657,28819
Ӫ,MaYingXiang,370832211,21655,3361,15317,9453,29359,15250,5900,15551,30801,15599,30916
Ԉض,ZhaoGuDuiXiang,370832215,18399,2812,13178,8184,25889,13178,5488,13521,26699,13521,26699
·,DaLuKouXiang,370832217,21466,3158,15502,9276,29970,15502,6265,15387,30889,15387,30889
³ǽֵ´,LuChengJieDaoBanShiChu,370881001,125455,11042,83009,43137,114317,68634,22565,67663,136297,76053,159062
Ժֵ´,ShuYuanJieDaoBanShiChu,370881002,25358,3212,17138,9220,32976,17090,5315,16624,33714,16747,33885
ʱׯֵ´,ShiZhuangJieDaoBanShiChu,370881003,39996,4974,26912,15523,46906,26884,8614,26559,53443,26672,53584
Сѩֵ´,XiaoXueJieDaoBanShiChu,370881004,32281,4262,21843,12252,42298,21822,6835,21439,43261,21535,43378
,WuCunZhen,370881101,24636,3751,16836,9910,32870,16825,4867,16410,33235,16418,33254
Ҧ,YaoCunZhen,370881102,28648,4307,19740,11463,38523,19735,6080,19294,39029,19295,39035
,LingChengZhen,370881103,46439,5147,31182,14993,52311,26864,8673,26271,53135,29077,60259
,NanXinZhen,370881105,34558,5302,23681,14002,46885,23673,7817,23947,47620,23996,47677
ׯ,WangZhuangZhen,370881108,32881,4713,22229,12570,44015,22206,7074,22402,44608,22439,44668
Ϣ,XiZouZhen,370881109,35188,4732,23505,12955,46791,23496,7444,23817,47313,23859,47364
ׯ,DongZhuangXiang,370881201,29411,4809,20434,12416,38260,19526,5826,19002,38528,19612,40046
ɽ,FangShanXiang,370881204,27574,4233,19211,11838,36370,19202,6479,19031,38233,19075,38286
¥ֵ´,GuLouJieDaoBanShiChu,370882001,73959,9232,50426,32807,68315,48106,15445,46169,94275,48210,98636
Žֵ´,LongQiaoJieDaoBanShiChu,370882003,29572,2379,18578,11186,21011,17731,6130,17044,34775,19503,38081
Žֵ´,JiuXianQiaoJieDaoBanShiChu,370882006,25840,3394,16400,11180,23509,16264,4757,15806,32070,17591,33991
ֵ´,WangYinJieDaoBanShiChu,370882007,45057,5911,29051,18094,55576,28665,9052,28422,57087,30969,60020
ͽֵ´,HuangTunJieDaoBanShiChu,370882008,17941,2320,12039,7406,22753,11995,3799,11770,23765,12021,24060
,DaAnZhen,370882101,62075,8959,41670,25348,76114,41310,12819,41527,82837,42183,83853
,XinYiZhen,370882102,34497,4681,22915,12656,44711,22851,7587,22936,45787,23850,46765
յ,YanDianZhen,370882103,43253,6566,29674,18953,57721,29659,9453,29553,59212,29598,59272
,XinYanZhen,370882105,39006,4526,25388,15039,41201,24540,7973,24552,49092,26117,51505
,CaoHeZhen,370882107,21079,3107,14286,8553,28081,14280,4473,14310,28590,14373,28659
¡ׯ,XingLongZhuangZhen,370882110,43402,5774,29156,18446,54286,29050,8869,28052,57102,28889,58045
С,XiaoMengZhen,370882111,26202,3643,17720,10124,34670,17716,5662,17780,35496,17787,35507
ɽֵ´,GangShanJieDaoBanShiChu,370883001,93999,10864,58716,38861,87375,56942,18151,56432,113374,64298,123014
ǧȪֵ´,QianQuanJieDaoBanShiChu,370883002,70663,6054,45577,27766,59085,43435,14903,43658,87093,46043,91620
ɽֵ´,FuShanJieDaoBanShiChu,370883003,48424,5017,31213,21383,40703,29798,9325,29850,59648,31553,62766
,XiangChengZhen,370883101,50953,8105,33872,18765,68473,33710,10673,35457,69167,35859,69731
ǰ,ChengQianZhen,370883102,52158,7871,34940,21922,70049,34926,11436,36419,71345,36525,71465
,DaShuZhen,370883103,54019,8134,35407,20953,71185,35115,11261,37333,72448,38007,73414
,BeiSuZhen,370883104,82312,9003,50180,29881,96727,48064,15647,48521,96585,56782,106962
ĵ,ZhongXinDianZhen,370883105,61506,7143,39238,22853,76754,38446,12201,38300,76746,41612,80850
ƴ,TangCunZhen,370883106,27002,3559,17945,11245,33616,17417,5885,17339,34756,18501,36446
̫ƽ,TaiPingZhen,370883107,82687,11202,53472,30169,106714,50455,17103,51225,101680,57520,110992
ʯǽ,ShiQiangZhen,370883109,52176,7872,33816,19112,67881,33211,10050,35126,68337,36282,70098
ɽ,YiShanZhen,370883110,35805,5153,23589,14200,46585,23431,6762,23736,47167,24131,47720
ׯ,KanZhuangZhen,370883111,22825,3862,15750,9599,30655,15442,4773,15142,30584,15710,31460
ׯ,ZhangZhuangZhen,370883112,45662,6708,29759,17713,60669,29627,9552,31850,61477,32163,61922
,TianHuangZhen,370883113,25955,4229,17636,9897,34369,17632,5493,17989,35621,18041,35677
,GuoLiZhen,370883114,30990,4951,20416,12555,41865,20174,6614,21526,41700,22139,42555
ֵ´,DaiMiaoJieDaoBanShiChu,370902001,100996,12575,68725,45716,69260,63577,21594,60733,124310,66440,135165
Դֵ´,CaiYuanJieDaoBanShiChu,370902002,131212,11947,81491,52752,88348,72334,21506,70399,142733,83174,164665
̩ǰֵ´,TaiQianJieDaoBanShiChu,370902003,131627,12613,78602,37949,81061,53349,17438,51430,104779,83076,161678
ϸֵ߽´,ShangGaoJieDaoBanShiChu,370902004,95738,6990,60252,32137,47571,46791,18858,47280,94071,61334,121586
¥ֵ´,XuJiaLouJieDaoBanShiChu,370902005,31161,2736,20500,13267,23729,19995,7551,19848,39843,20948,41448
ʡׯ,ShengZhuangZhen,370902100,46005,6506,31346,18089,54127,29790,10030,29269,59059,31195,62541
ҵ,QiuJiaDianZhen,370902101,45194,7193,31531,19443,58989,31511,9639,30409,61920,30495,62026
,DaJinKouXiang,370902202,7796,1367,5496,3567,10457,5485,1773,5415,10900,5440,10936
ֵ,ZhouDianJieDao,370911001,80938,6025,50231,27044,51007,39677,13721,38337,78014,50453,100684
ƽֵ,TianPingJieDao,370911002,27061,3193,19553,9948,25764,15934,5305,15597,31531,16006,35559
°´,BeiJiPoBanShiChu,370911003,66445,6789,44842,21155,58419,32519,10637,32286,64805,39029,83871
ɽ,ShanKouZhen,370911100,36827,5414,25200,14994,48087,24140,7997,23741,47881,25038,50238
ף,ZhuYangZhen,370911101,38892,5967,26076,15802,51746,25638,7759,25697,51335,26542,52618
,FanZhen,370911102,40586,6193,28154,16762,54337,27770,8865,26963,54733,27490,55644
,JiaoYuZhen,370911103,22040,3938,15022,10050,29771,14704,4307,14701,29405,15263,30285
,CuLaiZhen,370911104,40285,6457,27465,17310,54125,26988,8174,26753,53741,27451,54916
ׯ,ManZhuangZhen,370911106,50466,7794,34450,21417,61482,33837,10986,33656,67493,34796,69246
,XiaZhangZhen,370911107,44455,6749,30242,17585,59505,29679,9524,29681,59360,30486,60728
,DaoLangZhen,370911108,22771,3745,15730,10262,30299,15265,4828,15001,30266,15614,31344
ǰ,HuangQianZhen,370911109,23243,4030,15730,10075,31475,15498,4669,15827,31325,16212,31942
,DaWenKouZhen,370911110,54681,8209,37444,22038,72289,35492,12096,34360,69852,37542,74986
ׯ,MaZhuangZhen,370911111,34450,4857,23649,13942,46616,23311,7965,22841,46152,23623,47272
,FangCunZhen,370911112,39770,5809,27054,16618,53562,26762,9160,27115,53877,27685,54739
ׯ,LiangZhuangZhen,370911113,50996,6918,34936,21121,69283,34644,12072,34565,69209,35050,69986
¸,XiaGangXiang,370911200,27896,4843,19060,11926,38362,19054,5941,19604,38658,19620,38680
,HuaMaWanXiang,370911201,23846,3820,16333,11390,32304,16310,4976,16282,32592,16309,32642
ֵ´,WenMiaoJieDaoBanShiChu,370921001,69889,6250,43788,23316,65401,34735,14033,33769,68504,46384,90172
Žֵ´,BaXianQiaoJieDaoBanShiChu,370921002,31093,3172,20928,12028,31923,18790,7312,18223,37013,20649,41577
,SiDianZhen,370921101,29537,3968,20318,11894,37173,20251,6414,19411,39662,19601,39919
,DongShuZhen,370921102,39451,5827,27621,16543,52386,27178,8611,25285,52463,26268,53889
ɽ,FuShanZhen,370921103,42255,5766,29640,17376,55900,28882,9285,26451,55333,27666,57306
,GangChengZhen,370921105,52217,7022,36492,22673,67458,36472,11625,34193,70665,34372,70864
,JiangJiZhen,370921107,32109,4329,22092,13646,42184,21897,6702,20802,42699,21048,43140
Ҥ,CiYaoZhen,370921109,64479,7706,41887,24550,81154,39365,12737,38607,77972,43035,84922
,HuaFengZhen,370921110,64917,9275,43579,28151,84525,42031,13797,39490,81521,44410,87989
ʯ,GeShiZhen,370921111,41227,6038,28736,18028,55130,28720,8850,27302,56022,27379,56115
ׯ,DongZhuangZhen,370921112,38948,5785,27010,17456,52075,26927,8726,26295,53222,26449,53459
ɽ,HeShanXiang,370921201,31660,4831,23015,14176,43499,22992,7735,21113,44105,21211,44226
,XiangYinXiang,370921206,23073,3358,15634,9833,30338,15625,4638,15427,31052,15435,31069
ƽضƽֵ´,DongPingXianDongPingJieDaoBanShiChu,370923001,109890,12538,73870,42997,136338,70069,24669,68091,138160,73227,147097
ݳǰ´,ZhouChengBanShiChu,370923002,39800,6034,27369,15041,52205,26531,7865,25178,51709,26330,53699
ɳվ,ShaHeZhanZhen,370923101,40625,5673,27232,14171,54207,27115,8316,26951,54066,27382,54614
�,PengJiZhen,370923102,43822,6694,30553,16778,58213,29419,10116,27444,56863,30079,60632
Ϻ,LaoHuZhen,370923106,44307,7468,30765,16230,60139,30170,9025,29286,59456,30035,60800
ɽ,YinShanZhen,370923107,41689,5135,27498,15608,55487,26954,9372,27554,54508,28698,56196
,BanJiuDianZhen,370923108,32391,4894,22019,13053,43695,21731,6944,21594,43325,22210,44229
ɽ,JieShanZhen,370923109,41722,6264,28683,16597,54860,28134,8208,26763,54897,27511,56194
,DaYangZhen,370923110,23757,3986,16090,9204,31678,16048,4523,16026,32074,16176,32266
,TiMenZhen,370923111,28140,4603,18368,10348,35391,18136,5435,17427,35563,19810,38178
º,XinHuXiang,370923204,34796,4655,23719,13449,46654,23702,7686,23344,47046,23418,47137
ׯ,ShangLaoZhuangXiang,370923206,21383,2594,14705,8772,29067,14621,5481,14538,29159,14753,29458
,DaiMiaoXiang,370923207,26566,3608,17567,10158,35351,17230,5900,17666,34896,18507,36074
,JiuXianXiang,370923208,18260,3078,12660,7624,24625,12639,3654,12279,24918,12332,24992
ƽֵ´,QingYunJieDaoBanShiChu,370982001,177625,17282,112012,69408,194440,97827,36010,98812,196639,118905,230917
ֵ´,XinWenJieDaoBanShiChu,370982002,78490,11292,50915,35425,94155,48129,14801,46308,94437,53668,104583
,DongDouZhen,370982101,38862,5769,26666,19541,49916,26612,8626,26499,53111,26591,53257
СЭ,XiaoXieZhen,370982102,32612,4812,22498,16510,42037,22332,7393,21846,44178,22319,44817
,ZhaiZhen,370982103,45298,5234,30177,21354,56081,30103,10716,30427,60530,31071,61248
Ȫ,QuanGouZhen,370982104,36657,4273,22856,15600,46300,21330,7581,21930,43260,25655,48511
,YangLiuZhen,370982105,68231,9363,46552,33379,92059,46007,15990,45938,91945,47032,93584
,GuoDouZhen,370982106,24243,3616,17032,12242,32675,17021,5735,16532,33553,16562,33594
ׯ,XiZhangZhuangZhen,370982107,27801,3840,18846,13346,36975,18840,6234,19019,37859,19029,37875
챦,TianBaoZhen,370982108,50156,7913,36612,24513,70329,36588,12961,34321,70909,34418,71030
¥,LouDeZhen,370982110,50512,7041,34430,22719,65236,33668,10300,32600,66268,33423,67853
,YuCunZhen,370982111,35091,5439,24762,15398,47204,24736,7950,23694,48430,23718,48480
,GongLiZhen,370982112,37014,5437,26094,18640,50395,26063,8709,25008,51071,25066,51160
,GuLiZhen,370982113,35836,4830,24537,17364,48256,24472,8414,24428,48900,24543,49080
ʯ,ShiLaiZhen,370982114,44305,5194,29599,20381,59849,29593,10592,30443,60036,30492,60091
ų,FangChengZhen,370982115,22266,2575,14708,10389,29512,14707,4885,15017,29724,15018,29726
,LiuDuZhen,370982116,21282,2685,14031,9806,28254,14030,4525,14455,28485,14461,28492
,WenNanZhen,370982117,81256,11088,53604,36414,107025,52037,18186,53488,105525,56926,110530
͢,LongTingZhen,370982119,41799,5892,28473,20284,57033,28421,9858,29021,57442,29076,57549
ׯ,YueJiaZhuangXiang,370982203,25329,2886,16663,12002,33312,16660,5350,16899,33559,16902,33565
³ǽֵ´,XinChengJieDaoBanShiChu,370983001,131234,11094,87616,57800,125004,85656,30574,83419,169075,85286,172902
ϳǽֵ´,LaoChengJieDaoBanShiChu,370983002,49885,6746,32801,21560,61039,30868,9426,29595,60463,33256,66057
ϵֵ´,WangGuaDianJieDaoBanShiChu,370983003,61598,8188,41683,26660,73312,41563,12279,40293,81856,40382,82065
Ȫ,ChaoQuanZhen,370983101,16299,2462,10799,6726,21438,10797,3193,11149,21946,11155,21954
԰,TaoYuanZhen,370983103,37773,5146,25711,15561,49798,25435,7719,24626,50061,24927,50638
ׯ,WangZhuangZhen,370983104,38976,5434,26638,15813,51669,26525,7929,25419,51944,25701,52339
,HuTunZhen,370983105,55913,6167,36418,24302,69469,36279,10758,35096,71375,36420,72838
ʯ,ShiHengZhen,370983106,61043,7417,40143,26523,75000,39811,12055,39184,78995,40372,80515
վ,AnLinZhanZhen,370983107,37937,5234,26408,16622,50079,26400,7795,24509,50909,24558,50966
ﲮ,SunBoZhen,370983108,20410,3115,14389,8692,27591,14289,4347,13256,27545,13483,27872
ׯ,AnJiaZhuangZhen,370983109,57192,6841,39182,23692,74809,39148,12202,37009,76157,37053,76235
,WenYangZhen,370983110,55621,6524,37732,23098,72713,37705,11266,35564,73269,35679,73411
Ժ,BianYuanZhen,370983111,54294,7639,38021,23092,72002,37682,11540,35013,72695,35452,73473
,YiYangZhen,370983112,34413,4525,22608,13447,42019,21911,6424,21866,43777,22754,45362
¥ֵ´,HuanCuiLouJieDaoBanShiChu,371002001,36619,4243,22691,16266,29483,20886,5136,20046,40932,23307,45998
԰ֵ´,JingYuanJieDaoBanShiChu,371002002,47924,6467,32022,22846,46631,31127,7424,28404,59531,29793,61815
񵺽ֵ´,ZhuDaoJieDaoBanShiChu,371002003,69897,5487,43768,30794,64160,41913,12631,41187,83100,44247,88015
԰ֵ´,YiYuanJieDaoBanShiChu,371002004,120330,6337,71033,36284,71868,49472,15829,48634,98106,71463,142496
ͽֵ´,TianHeJieDaoBanShiChu,371002007,73795,4165,45154,29411,59875,40781,14637,40574,81355,47443,92597
ʹڽֵ´,HuangGuanJieDaoBanShiChu,371002008,52884,3639,32192,20619,39617,27122,9364,26827,53949,33695,65887
ֵֽ´,FengLinJieDaoBanShiChu,371002009,43123,1741,26876,14780,22816,18878,6993,19452,38330,24981,51857
Էֵ´,XiYuanJieDaoBanShiChu,371002010,20617,1364,11621,8407,13520,10383,3206,10928,21311,13566,25187
Ŵ,ZhangCunZhen,371002100,47786,3375,28297,17542,24905,22965,7456,23146,46111,30320,58617
ͤ,YangTingZhen,371002101,24580,4169,14578,10888,21602,13378,2369,13502,26880,16540,31118
Ȫ,WenQuanZhen,371002102,26877,2783,17467,11596,19019,14916,3826,14911,29827,16019,33486
ɽ,GuShanZhen,371002103,19867,2650,11348,8101,14909,10325,2317,10612,20937,13486,24834
,SunJiaTuanZhen,371002104,12874,1520,8486,5279,9571,7405,2101,7143,14548,8009,16495
,BoYuZhen,371002105,16347,3940,11005,8892,20306,10974,1730,10945,21919,11012,22017
ͷ,QiaoTouZhen,371002106,21555,4977,14019,11448,25659,13429,1813,13800,27229,14326,28345
,CaoMiaoZiZhen,371002107,16308,3012,10292,7393,18239,9890,1838,9919,19809,10866,21158
,ChuCunZhen,371002108,29385,3333,17464,8361,17532,9714,1670,9985,19699,16924,34388
ɽ·ֵ´,LongShanLuJieDaoBanShiChu,371081001,42721,4023,27347,18911,41789,25951,7469,25564,51515,26866,54213
츣·ֵ´,TianFuLuJieDaoBanShiChu,371081002,49743,4979,32703,21490,42827,28359,7686,27636,55995,29705,62408
ɽ·ֵ´,HuanShanLuJieDaoBanShiChu,371081003,58157,5050,37426,26550,57150,35858,11176,34983,70841,36957,74383
ĵӪ,WenDengYingZhen,371081100,25508,4599,15606,10044,24451,12731,2173,13217,25948,16674,32280
ˮ,DaShuiBoZhen,371081101,26698,6465,17397,13917,33132,16513,2187,16860,33373,17953,35350
żҲ,ZhangJiaChanZhen,371081102,16965,4711,11441,9124,21269,10960,1364,11088,22048,11599,23040
ߴ,GaoCunZhen,371081103,19572,5523,13125,11405,25124,12934,1508,13291,26225,13478,26603
,ZeKuZhen,371081104,18086,4371,12187,9951,20379,12115,2083,11977,24092,12353,24540
,HouJiaZhen,371081105,16222,4747,10973,9163,21033,10718,1241,10752,21470,11237,22210
δ,SongCunZhen,371081106,27688,7194,18615,14684,35189,18594,2499,18743,37337,18766,37381
ͷ,ZeTouZhen,371081107,25474,6443,16790,13793,32127,16434,1870,16599,33033,16997,33787
С,XiaoGuanZhen,371081108,27829,6555,17187,15325,32579,16556,2322,18047,34603,19519,36706
,GeJiaZhen,371081109,38029,8933,24998,19247,48011,24836,3392,25026,49862,25356,50354
ɽ,MiShanZhen,371081110,19226,4354,12354,9194,22947,11702,1848,12029,23731,13074,25428
ʯ,JieShiZhen,371081111,21344,5631,14293,11378,26796,13429,2033,13637,27066,14715,29008
,WangTuanZhen,371081112,17754,4435,11756,9936,20793,11152,1872,11589,22741,12305,24061
ɽ,QingShanZhen,371081113,30614,4522,19834,13647,29367,18221,4691,18864,37085,19993,39827
ĵǾÿ,WenDengJingJiKaiFaQu,371081400,25219,1784,15943,9950,20428,13310,4271,13322,26632,15331,31274
ڸ۹ίԱ,BuKouGangGuanLiWeiYuanHui,371081401,8360,1749,5276,4154,9068,5005,663,4911,9916,5496,10772
ֵ´,NingJinJieDaoBanShiChu,371082001,16226,3980,11210,9150,21116,11184,1811,10776,21960,10807,22017
ֵ´,GangWanJieDaoBanShiChu,371082002,50716,5225,31813,24354,48344,30816,8404,30615,61431,32532,64345
԰ֵ´,TaoYuanJieDaoBanShiChu,371082003,10018,1579,6650,4909,9334,6183,1537,6031,12214,6484,13134
ֵ´,WangLianJieDaoBanShiChu,371082004,12212,3020,8173,7054,14763,8046,1298,8234,16280,8357,16530
ɽֵ´,DongShanJieDaoBanShiChu,371082005,12511,3313,8465,7113,14518,8130,1204,8102,16232,8563,17028
ɽֵ´,ChiShanJieDaoBanShiChu,371082006,28304,4533,18237,13864,28558,17482,4139,17267,34749,18739,36976
ͷֵ´,YaTouJieDaoBanShiChu,371082007,110588,9858,69777,50150,108090,65757,19547,64906,130663,70216,139993
ֵ´,ChengXiJieDaoBanShiChu,371082008,14453,2725,9496,7687,14771,9212,1946,9495,18707,9628,19124
Ѱɽֵ´,XunShanJieDaoBanShiChu,371082009,23840,3257,14046,9030,19305,10983,2459,11033,22016,15510,29556
ɽֵ´,LaoShanJieDaoBanShiChu,371082010,13941,3159,9374,7534,16505,9256,1489,9082,18338,9215,18589
ٵ,LiDaoZhen,371082101,32650,5878,19153,15356,29808,17637,3609,17726,35363,22984,42137
ɽ,ChengShanZhen,371082102,33031,5708,21666,16793,32815,19782,4528,19686,39468,21601,43267
,BuLiuZhen,371082103,14570,4492,9813,9398,18484,9727,884,9952,19679,10133,19946
,GangXiZhen,371082104,15342,2601,10532,6881,11632,7684,1303,7668,15352,8714,19246
ׯ,XiaZhuangZhen,371082105,8566,2051,5527,4866,10613,5526,790,5861,11387,5880,11407
,YaXiZhen,371082106,12961,3384,8509,7667,16241,8439,1230,8795,17234,9066,17575
,YinZiZhen,371082107,8672,2566,5792,5484,10931,5788,676,6060,11848,6122,11914
,TengJiaZhen,371082108,20300,5115,13502,11139,23264,12407,1701,12517,24924,13614,27116
,DaTuanZhen,371082109,11393,3159,7592,6806,13997,7535,966,7729,15264,7926,15518
ׯ,ShangZhuangZhen,371082110,16670,4554,11309,9815,20478,10836,1666,11096,21932,11581,22890
ɽ,HuShanZhen,371082111,28235,6803,19190,15528,32451,17856,3141,17856,35712,18989,38179
˺,RenHeZhen,371082112,50334,10326,33813,28031,55005,32778,7208,32669,65447,34055,67868
ֵ´,ChengQuJieDaoBanShiChu,371083001,117897,10059,74283,53395,113940,70430,18598,67774,138204,72271,146554
Ĵ,XiaCunZhen,371083100,29777,5930,19126,15954,35479,19075,3085,19574,38649,19666,38792
ɽ,RuShanKouZhen,371083101,24891,4717,15271,12237,27501,14851,2378,14872,29723,16715,31986
,HaiYangSuoZhen,371083102,22385,5384,14862,12321,26909,14771,2082,14673,29444,14989,29851
ɳ̲,BaiShaTanZhen,371083103,36698,7303,24346,16950,34909,20103,2864,20417,40520,22519,46865
ɽ,DaGuShanZhen,371083104,17965,4562,11807,10067,22514,11508,1601,11896,23404,12321,24128
ϻ,NanHuangZhen,371083105,17616,4395,11672,9677,21875,11352,1489,11509,22861,11828,23500
,FengJiaZhen,371083106,22553,5081,14711,11706,27856,14135,2152,14470,28605,15075,29786
³,XiaChuZhen,371083107,20475,4579,13146,11320,25384,13131,1809,13572,26703,13717,26863
缫,WuJiZhen,371083108,17572,3950,11320,9567,21931,11128,1559,11415,22543,11761,23081
,YuLiZhen,371083109,20343,4950,13614,11607,26403,13574,2136,13711,27285,13815,27429
,YaZiZhen,371083110,28417,6053,18105,14172,36104,17431,2695,18060,35491,19060,37165
,ZhuWangZhen,371083111,29721,5716,18450,13336,37144,17242,3120,17960,35202,20107,38557
ɽկ,RuShanZhaiZhen,371083112,23028,5837,15215,12970,29427,15069,1834,15260,30329,15484,30699
,XuJiaZhen,371083114,12737,3342,8441,7254,16266,8225,1146,8498,16723,8784,17225
սֵ,RiZhaoJieDao,371102001,168649,14228,110858,74142,137245,103164,38570,103939,207103,110589,221447
ʯʽֵ,ShiJiuJieDao,371102002,64726,5354,41171,29527,42663,38259,12818,38056,76315,41727,82898
ɽֵ´,KuiShanJieDaoBanShiChu,371102003,32120,4743,22078,14862,39393,22019,7189,21777,43796,21974,44052
¥ֵ,QinLouJieDao,371102004,158956,8830,94983,46852,84196,64725,24167,64624,129349,96970,191953
·ֵ´,BeiJingLuJieDaoBanShiChu,371102007,63656,5357,41034,28625,48532,39973,14327,41274,81247,42306,83340
ɽ,HeShanZhen,371102100,20640,3469,14178,10460,27028,14106,4675,14466,28572,14606,28784
,LiangChengZhen,371102101,27322,4827,19126,13148,36363,19092,6104,18907,37999,19127,38253
,TaoLuoZhen,371102102,44557,7665,31170,21387,57806,30647,9630,30044,60691,30682,61852
,XiHuZhen,371102106,21339,4307,14788,11796,28917,14765,4332,15108,29873,15190,29978
,ChenTuanZhen,371102107,17735,3478,12135,9923,23655,12111,3493,12507,24618,12571,24706
Ϻ,NanHuZhen,371102108,44269,7867,30140,22043,58749,30124,8898,30826,60950,30894,61034
ׯ,SanZhuangZhen,371102109,37239,7661,25612,20638,50528,25269,7314,26234,51503,26602,52214
ɽͷֵ´,LanShanTouJieDaoBanShiChu,371103001,28376,3218,18028,11865,30024,17705,5334,17719,35424,18900,36928
ֵ´,AnDongWeiJieDaoBanShiChu,371103002,36161,3538,23137,15028,35006,21880,8197,22529,44409,24759,47896
,BeiKuoZhen,371103100,32353,5743,22469,17123,41543,22357,7443,22393,44750,23070,45539
ɽ,HuShanZhen,371103101,49152,6166,29611,20026,54483,29443,10307,31052,60495,36014,65625
޷,JuFengZhen,371103102,49677,9140,34465,24665,65342,33631,10055,33562,67193,34407,68872
,GaoXingZhen,371103103,23949,4217,16490,10984,31538,16304,4709,16129,32433,16385,32875
,HouCunZhen,371103104,38727,6920,26632,19478,51980,26617,7886,26849,53466,26901,53533
ƶ,HuangDunZhen,371103105,32111,6257,21883,16888,43316,21869,5882,22355,44224,22367,44250
ǰ,QianSanDaoXiang,371103200,3484,324,2175,1428,3534,2162,741,2181,4343,2374,4549
ֵ´,HongNingZhenJieDaoBanShiChu,371121001,118762,11804,77682,56108,124721,74389,27493,76047,150436,80377,158059
ͷ,JieTouZhen,371121102,39703,7201,26919,20853,50242,26478,7956,27470,53948,27941,54860
,ChaoHeZhen,371121103,22430,4117,15232,11086,29062,15094,4629,15505,30599,15944,31176
,XuMengZhen,371121104,37045,6739,25282,18409,49388,25101,7524,25755,50856,26026,51308
,YuLiZhen,371121105,28064,5032,19323,14489,36768,18984,5583,18951,37935,19356,38679
,WangHuZhen,371121106,14648,3019,10263,7955,19473,10260,2894,10227,20487,10298,20561
ߵ,KouGuanZhen,371121107,18487,3730,12815,9284,24239,12535,3546,12604,25139,12948,25763
,ZhongZhiZhen,371121108,16811,3384,11541,9240,22509,11539,3141,11792,23331,11795,23336
,GaoZeZhen,371121109,22304,4185,15270,11835,29174,15161,4315,15339,30500,15534,30804
ɰ,SongBaiZhen,371121110,11573,2151,7849,5820,14794,7819,2233,8040,15859,8108,15957
ʯ,ShiChangXiang,371121201,12781,2354,8619,6656,17027,8616,2517,9029,17645,9033,17652
,HuBuXiang,371121202,11803,2547,8162,6052,15923,8120,2378,8492,16612,8566,16728
ֵ´,ChengYangJieDaoBanShiChu,371122001,123885,11598,81967,54606,121362,73558,31061,75680,149238,84577,166544
,ZhaoXianZhen,371122102,43189,6549,29805,22017,57986,29785,10485,30384,60169,30418,60223
ׯ,YanZhuangZhen,371122103,25907,4104,17974,13199,34357,17892,6030,17978,35870,18067,36041
ׯ,XiaZhuangZhen,371122104,36922,6666,26897,21563,51192,26863,9941,26527,53390,26632,53529
ׯ,LiuGuanZhuangZhen,371122105,41758,6788,29716,22248,54982,29594,11006,29653,59247,29836,59552
ɽ,QiaoShanZhen,371122106,34102,5879,24322,18718,46985,24304,9243,24825,49129,24902,49224
С,XiaoDianZhen,371122107,32557,6276,23293,18506,45386,23261,8013,23452,46713,23553,46846
¥,ZhongLouZhen,371122108,33344,5709,23824,18789,46647,23804,9652,24768,48572,24881,48705
ɽ,LongShanZhen,371122109,24501,4696,17526,14363,33661,17503,6056,17673,35176,17727,35253
ݸ,DongGuanZhen,371122110,22078,4088,15212,11329,29429,15172,4801,15535,30707,15755,30967
ɽ,FuLaiShanZhen,371122111,37092,5350,25470,18273,45929,24108,8993,24638,48746,25965,51435
,LingYangZhen,371122112,26233,4217,18651,14266,34605,18536,7241,18867,37403,19040,37691
Ӽ,DianZiJiZhen,371122113,25527,4100,17781,13314,33760,17668,6111,17721,35389,17957,35738
,ChangLingZhen,371122114,23867,3774,16904,13117,32674,16904,6251,16988,33892,16988,33892
ׯ,AnZhuangZhen,371122115,17850,3003,13015,10286,24736,12893,5277,12941,25834,13115,26130
ɽ,QiShanZhen,371122116,42711,7716,30136,23004,58006,30093,9503,29584,59677,29794,59930
,LuoHeZhen,371122117,28213,3899,19113,14070,37704,19104,6826,19769,38873,19825,38938
կ,ZhaiLiHeZhen,371122118,20319,3763,14867,11654,28131,14862,5638,14794,29656,14853,29720
ɣ԰,SangYuanZhen,371122119,31676,5356,22578,17509,43628,22547,8128,22516,45063,22582,45160
ׯ,GuoZhuangXiang,371122204,20059,2792,14049,10644,27220,14042,5509,14295,28337,14311,28360
ɽ,KuShanXiang,371122206,15346,3037,10827,8416,20790,10813,3291,10791,21604,10847,21674
ǽֵ´,FengChengJieDaoBanShiChu,371202001,156511,12779,102727,61523,143936,83663,37398,83422,167085,103961,206688
żݽֵ´,ZhangJiaWaJieDaoBanShiChu,371202002,54797,5842,35769,23743,51120,32657,11875,32106,64763,36745,72514
ׯֵ´,GaoZhuangJieDaoBanShiChu,371202003,61325,9379,41824,29857,75337,41077,12645,40259,81336,41525,83349
Ȫֵ´,PengQuanJieDaoBanShiChu,371202004,67158,6043,42908,26571,49639,37579,13911,37961,75540,44204,87112
,KouZhen,371202100,56875,9439,39431,27380,74399,37979,11917,37549,75528,38800,78231
,YangLiZhen,371202101,39198,6637,27230,20476,52347,27220,8688,27197,54417,27293,54523
,FangXiaZhen,371202102,42418,7161,29289,19686,56015,28004,8795,26924,54928,29085,58374
ţȪ,NiuQuanZhen,371202103,47144,8957,32900,24511,63955,32203,9880,31972,64175,33081,65981
ɽ,MiaoShanZhen,371202105,33963,6359,23287,19266,46269,23271,6873,23792,47063,23908,47195
ѩҰ,XueYeZhen,371202106,30121,5047,20697,16434,40807,20686,6461,20870,41556,20932,41629
ׯ,DaiWangZhuangZhen,371202107,28517,5479,20207,14870,39428,20185,6135,19843,40028,19924,40131
կ,ZhaiLiZhen,371202108,38985,7056,27112,19362,51573,26451,7560,25827,52278,26489,53601
ׯ,YangZhuangZhen,371202109,31162,5946,22043,15113,42286,21942,5938,20759,42701,21003,43046
ҵ,ChaYeKouZhen,371202110,24972,4011,16616,12593,33244,16616,4602,16969,33585,16969,33585
ׯ,HeZhuangZhen,371202111,17457,2803,11614,8705,23345,11589,3316,11841,23430,11962,23576
ɽֵ´,AiShanJieDaoBanShiChu,371203001,60202,6573,38981,26206,67901,34670,14038,35635,70305,41832,80813
ׯ,YanZhuangZhen,371203100,40757,6154,27294,18777,50540,26257,8111,25728,51985,27728,55022
ׯ,HuangZhuangZhen,371203101,50200,5671,33169,25293,41631,32827,10475,32430,65257,33177,66346
,LiXinZhen,371203102,44792,5698,28870,20196,52319,25615,9479,26498,52113,31099,59969
ׯ,XinZhuangZhen,371203103,34957,5034,23167,15893,45977,22842,6853,23037,45879,23677,46844
ɽֵ,LanShanJieDao,371302001,217515,13208,136414,77305,142692,114053,47453,118785,232838,141762,278176
ȸɽֵ,YinQueShanJieDao,371302002,133609,9305,86129,53986,108772,77367,32539,79038,156405,89324,175453
ȸɽֵ,JinQueShanJieDao,371302003,135464,11821,86118,55292,105918,78239,28605,78250,156489,89772,175890
Ϸֵ,NanFangJieDao,371302004,73562,7088,48046,28697,78450,44264,18037,44758,89022,50641,98687
ɳ,BaiShaBuZhen,371302101,45272,5680,30382,19650,59961,30336,11428,31892,62228,31998,62380
湵ͷ,ZaoGouTouZhen,371302102,49705,6170,33498,21217,64009,33309,12265,34224,67533,34642,68140
,BanChengZhen,371302103,48462,5731,31951,21460,57096,30154,12093,31397,61551,34335,66286
,YiTangZhen,371302105,65508,5456,39535,20631,57348,32375,14293,33400,65775,45722,85257
�,MaChangHuZhen,371302106,41827,4738,27201,17478,48913,26238,9942,27201,53439,29306,56507
,LiGuanZhen,371302107,30393,4738,20677,15242,40866,20656,6904,21308,41964,21358,42035
챣,ZhuBaoZhen,371302108,37770,3908,23658,13889,39044,21288,8692,22316,43604,26712,50370
ׯֵ,LuoZhuangJieDao,371311001,71611,6133,44345,26180,70465,39872,16889,42318,82190,50288,94633
ׯֵ,FuZhuangJieDao,371311002,33616,4183,22356,14408,42288,22277,8087,23422,45699,23530,45886
ʢׯֵ,ShengZhuangJieDao,371311003,48426,4346,32093,21600,47268,31938,12936,33155,65093,33615,65708
ׯֵ,TangZhuangJieDao,371311004,17931,2311,12180,7844,22607,12177,4895,12949,25126,12957,25137
˫ºֵ,ShuangYueHuJieDao,371311005,60309,4128,38039,23954,47129,35211,14563,37197,72408,40961,79000
ɽֵ,CeShanJieDao,371311006,41050,5544,27462,17200,53348,27445,9344,28367,55812,28476,55938
߶ֵ,GaoDouJieDao,371311007,36194,4293,23441,14976,44508,23035,7672,23704,46739,24718,48159
ֵ,LuoXiJieDao,371311008,35133,4119,23599,15458,44215,23541,9535,25040,48581,25188,48787
,YiTangZhen,371311100,32459,4327,22831,14715,45650,22831,10911,24863,47694,24866,47697
ֵ,JiuQuJieDao,371312001,76958,6390,49162,31562,74543,47033,18689,49528,96561,52875,102037
֥սֵ,ZhiMaDunJieDao,371312002,46510,5142,30157,18628,56940,28452,11188,29389,57841,32683,62840
÷ֵ,MeiBuJieDao,371312003,30202,3775,20901,13528,40965,20877,8431,21341,42218,21507,42408
๫ֵ,XiangGongJieDao,371312004,48181,6333,32701,21561,63790,32113,13081,33968,66081,34894,67595
̫ƽֵ,TaiPingJieDao,371312005,32752,4996,22972,15900,44398,22947,8837,23553,46500,23613,46585
ͷֵ,TangTouJieDao,371312006,41402,5925,28616,20141,52801,27101,9719,27547,54648,28430,57046
ֵ,FengHuangLingJieDao,371312007,25846,3229,17799,12191,34862,17755,7842,19046,36801,19118,36917
عֵ,ZhongGouJieDao,371312008,32192,4743,22568,15651,44232,22525,9403,23613,46138,23770,46338
,TangHeZhen,371312104,34984,5069,24542,16919,48522,24540,10127,25636,50176,25638,50180
˺,BaHuZhen,371312107,22833,3361,15986,11091,31393,15963,6626,16825,32788,16834,32820
֣,ZhengWangZhen,371312108,39655,6471,28510,20878,56224,28469,11757,29285,57754,29373,57883
,LiuDianZiXiang,371312201,21723,3253,15164,10973,30108,15135,5897,15638,30773,15709,30873
ֵ,JieHuJieDao,371321001,128407,11788,86945,55320,133246,75379,34601,76432,151811,87851,174796
,AnDiZhen,371321101,23588,5974,18304,14992,34111,18249,5516,16621,34870,16774,35078
,SunZuZhen,371321102,23618,4585,16693,13042,32756,16674,5198,16630,33304,16708,33401
˫ܩ,ShuangHouZhen,371321103,24379,4387,17950,13612,34563,17875,7034,17669,35544,17850,35800
,QingTuoZhen,371321104,37930,6361,27115,20071,53198,27013,10877,27849,54862,28053,55168
ׯ,ZhangZhuangZhen,371321105,27999,5084,19917,15715,38405,19880,7046,20063,39943,20212,40129
ש,ZhuanBuZhen,371321106,23318,4378,16592,13038,32743,16581,5836,16900,33481,16940,33532
,GeGouZhen,371321107,21938,4263,15907,12905,30724,15856,5674,15863,31719,15968,31875
,YangJiaPoZhen,371321108,17451,3429,12782,10434,24492,12762,4598,12643,25405,12696,25478
ׯ,DaZhuangZhen,371321109,39163,6472,27464,20432,52264,26462,9861,26285,52747,28032,55496
,XinJiZhen,371321110,35205,6151,25174,19461,48736,25099,9381,25404,50503,25563,50737
,PuWangZhen,371321111,31595,5876,23181,18530,43961,23142,8700,22808,45950,22990,46171
ͷ,HuTouZhen,371321112,29745,4891,20992,16413,40903,20958,7849,21357,42315,21493,42485
մ,SuCunZhen,371321113,32310,5555,23209,17937,43760,23191,8501,23108,46299,23157,46366
ͭ,TongJingZhen,371321114,36208,6149,25374,19504,49250,25328,8732,25626,50954,25715,51089
,YiWenZhen,371321115,28601,5499,20365,15646,40020,20356,7037,20737,41093,20772,41137
,MaMuChiXiang,371321201,16801,3492,12070,9582,23593,12000,3696,11799,23799,11919,23989
۰ǽֵ,TanChengJieDao,371322001,147176,16336,97638,57776,168448,89905,33702,91320,181225,99576,197214
ͷ,MaTouZhen,371322101,53281,7218,37160,22697,71854,36960,14267,37460,74420,37606,74766
ط,ZhongFangZhen,371322102,30001,4942,20624,11186,41294,20544,6612,20752,41296,20931,41555
ׯ,LiZhuangZhen,371322103,35004,5193,23545,15672,46725,23529,7757,24373,47902,24409,47954
Ҷ,ChuDunZhen,371322104,39724,4562,25574,15678,52108,25542,8489,27174,52716,27201,52775
,YangJiZhen,371322105,31261,4911,21880,13105,42407,21383,7505,21789,43172,21797,43677
ɽ,HuangShanZhen,371322106,33155,4506,22093,14652,43543,22019,7711,23200,45219,23279,45372
,GangShangZhen,371322107,28404,3612,19352,10758,39398,19342,7653,20290,39632,20317,39669
߷ͷ,GaoFengTouZhen,371322108,31038,4547,21379,12965,41278,21364,7103,21267,42631,21309,42688
ɽ,MiaoShanZhen,371322109,32739,4725,22331,12016,44835,21982,7892,22247,44229,23025,45356
ɳ,ShaDunZhen,371322110,35211,4559,23089,14478,46838,23010,7394,23892,46902,24075,47164
컨,HongHuaZhen,371322111,43407,6011,29222,17131,58366,29216,9974,30107,59323,30170,59392
ʤ,ShengLiZhen,371322112,29935,4332,20710,11791,40414,20620,7109,20544,41164,20666,41376
´,XinCunXiang,371322201,24402,3307,16511,9420,32821,16506,5941,17130,33636,17139,33650
԰,HuaYuanXiang,371322202,31600,4427,21737,12378,43813,21736,8436,22720,44456,22726,44463
,GuiChangXiang,371322203,23675,3526,16546,10405,32962,16531,5931,16580,33111,16586,33132
ȪԴ,QuanYuanXiang,371322205,33246,4693,22617,13706,45504,22509,8024,23142,45651,23346,45963
ˮֵ,YiShuiJieDao,371323001,131426,14381,87824,61546,133943,82958,29728,83321,166279,87711,175535
վ,MaZhanZhen,371323101,45245,5943,30052,21027,58742,29997,8862,29925,59922,29998,60050
,GaoQiaoZhen,371323102,41492,5747,27923,20337,54798,27919,8794,28067,55986,28110,56033
Һ,XuJiaHuZhen,371323103,58686,8477,39929,29736,67356,38362,12814,38310,76672,40048,79977
ɽ,HuangShanPuZhen,371323104,30796,5257,21395,16164,41627,21364,6294,20873,42237,20952,42347
Ҧ,YaoDianZiZhen,371323105,26784,4778,18633,14547,36645,18629,5779,18664,37293,18708,37341
,ZhuGeZhen,371323106,45408,7914,31522,24039,61358,31096,9231,30450,61546,31031,62553
޼,CuiJiaYuZhen,371323107,19335,3574,13732,10095,26205,13698,3775,12839,26537,12952,26684
ʮﱤ,SiShiLiPu,371323108,39524,6612,28333,21816,54240,28244,9824,27413,55657,27627,55960
ׯ,YangZhuangZhen,371323109,39783,5976,26960,19318,53112,26846,8744,27066,53912,27543,54503
ε,XiaWeiZhen,371323110,32590,5618,22048,16217,43381,22030,5903,21959,43989,22063,44111
ɳ,ShaGouZhen,371323111,38405,6342,26522,20097,51309,26514,7745,25878,52392,25970,52492
ׯ,GaoZhuangZhen,371323112,32126,5213,21850,15910,42707,21745,6183,21613,43358,21672,43522
Ժͷ,YuanDongTouZhen,371323113,16452,3339,11506,9087,22604,11483,3341,11585,23068,11626,23132
Ȧ,LongJiaQuanZhen,371323114,44854,5870,30151,20326,49005,26835,9020,26479,53314,29593,59744
ׯ,FuGuanZhuangZhen,371323115,25046,4733,17711,13270,34390,17660,5313,17261,34921,17381,35092
,DaoTuoZhen,371323116,23106,3733,15936,12519,31204,15926,5042,15917,31843,15945,31881
Ȫׯ,QuanZhuangZhen,371323117,20443,3842,14088,10621,28041,14084,3948,14138,28222,14145,28233
Ȧ,QuanLiXiang,371323201,21936,3246,14559,11003,28818,14536,3959,14495,29031,14582,29141
ׯֵ,BianZhuangJieDao,371324001,153339,15292,108859,61870,184563,104773,54531,109770,214543,114303,223162
ٴ,DaZhongCunZhen,371324101,56848,7718,39419,23710,80448,39043,17175,41600,80643,42322,81741
,LanLingZhen,371324102,62558,9226,46201,24494,94919,45824,25319,49115,94939,50902,97103
,ChangChengZhen,371324103,34505,4368,24682,12752,46879,24238,11626,25046,49284,25817,50499
ĥɽ,MoShanZhen,371324104,45768,5632,31962,19467,60332,31948,14291,33691,65639,33729,65691
ɽ,ShenShanZhen,371324105,35584,4171,24932,14713,47021,24925,12119,26885,51810,26942,51874
,CheWangZhen,371324106,33950,5499,24182,16051,47340,24152,10526,25726,49878,25793,49975
,ShangYanZhen,371324107,27390,4784,19180,12089,38837,19152,7834,20697,39849,20828,40008
,XiangChengZhen,371324108,35777,5395,25749,15655,50510,25673,12125,27443,53116,27548,53297
,XinXingZhen,371324109,25928,3576,19083,10609,35626,19066,10244,20565,39631,20665,39748
,NanQiaoZhen,371324110,38017,5758,28178,13200,53160,28130,13957,29419,57549,29554,57732
ɽ,CengShanZhen,371324111,31633,4037,22356,11914,43262,22343,9586,22854,45197,22900,45256
ׯ,ZhuangWuZhen,371324112,27571,3560,18724,10768,37298,18711,7128,19516,38227,19535,38259
³,LuChengZhen,371324114,24493,3804,17299,10884,34977,17202,8146,18555,35757,19144,36443
,KuangKengZhen,371324115,23104,3184,16086,10510,32118,16081,6912,17105,33186,17114,33200
ׯ,JiaZhuangXiang,371324200,31028,4741,22577,13885,45099,22568,11088,24170,46738,24280,46857
´,XiaCunXiang,371324202,26524,4336,18902,12472,37549,18902,8109,20058,38960,20067,38969
,SanHeXiang,371324204,21340,3660,16274,9874,30690,16256,8192,16838,33094,16918,33192
,XingMingXiang,371324205,23500,3776,17235,9557,32025,17231,8322,18335,35566,18363,35598
,ErMiaoXiang,371324206,29021,3764,21637,11013,41632,21537,10543,21511,43048,21691,43328
ѳǽֵ,FeiChengJieDao,371325001,139826,14869,89389,56441,143769,82334,28920,84587,166921,94226,183615
ұ,ShangYeZhen,371325101,39299,5602,26563,17341,53036,26551,9586,27909,54460,27924,54487
Ѧׯ,XueZhuangZhen,371325102,37443,5715,25131,17138,50025,25118,8603,26578,51696,26630,51761
,FangChengZhen,371325103,33018,4869,22518,15772,44802,22501,8301,23625,46126,23670,46188
,WangGouZhen,371325104,45327,5947,30836,21183,61133,30777,12280,32593,63370,32718,63554
̽,TanYiZhen,371325105,38661,5228,26100,16439,49431,25212,10719,26604,51816,28508,54608
,ZhuTianZhen,371325106,36622,6212,24637,16527,49406,24626,7789,25940,50566,25986,50623
,LiangQiuZhen,371325107,57995,8411,39011,25430,78602,38985,13380,40720,79705,40775,79786
ׯ,XinZhuangZhen,371325108,33192,4896,23453,15538,45400,23445,9508,24120,47565,24143,47596
ׯ,MaZhuangZhen,371325109,22268,3357,15145,10238,29663,15126,5958,16399,31525,16438,31583
,XinQiaoZhen,371325110,40130,5014,27573,17682,54908,27573,11569,29138,56711,29140,56713
ׯ,LiuZhuangZhen,371325111,21932,2916,14996,9917,29198,14990,6207,16044,31034,16059,31055
,HuYangZhen,371325112,29000,4135,19500,13492,39250,19426,7084,20524,39950,20719,40219
ʯ,ShiJingZhen,371325113,23064,3569,15434,9659,31381,15434,5050,16249,31683,16249,31683
Ǳ,ChengBeiZhen,371325114,20500,3230,14064,9745,27421,14028,4868,14448,28476,14534,28598
ׯ,DaTianZhuangXiang,371325200,13021,1998,9021,6566,17636,9009,3108,9089,18098,9106,18127
ׯ,NanZhangZhuangXiang,371325201,24149,3270,16091,10312,32437,16089,5722,17038,33127,17050,33141
ҩɽ,ShaoYaoShanXiang,371325204,13861,2611,9759,6869,19287,9754,3666,10358,20112,10379,20138
ƽؽֵ,PingYiJieDao,371326001,166327,17759,109963,73244,170673,103983,39181,106763,210746,113304,223267
ٴ,ZhongCunZhen,371326101,48761,8115,33950,22889,65376,33930,10631,33529,67459,33557,67507
̨,WuTaiZhen,371326102,23137,3697,16388,10649,31782,16382,5787,16208,32590,16233,32621
̫,BaoTaiZhen,371326103,47053,7622,33020,21622,64899,32974,12112,33545,66519,33767,66787
,BoLinZhen,371326104,29884,5156,21094,13165,41292,21070,7235,21095,42165,21181,42275
,BianQiaoZhen,371326105,27683,4437,18785,12177,37088,18726,6126,19263,37989,19461,38246
ط,DiFangZhen,371326106,44133,7125,29674,20124,58771,29609,9961,31389,60998,31545,61219
ͭʯ,TongShiZhen,371326107,48319,7442,32600,22149,64441,32484,11197,34084,66568,34358,66958
ˮ,WenShuiZhen,371326108,21618,3465,14722,9976,28749,14719,4655,14998,29717,15016,29738
,LiuYuZhen,371326109,33113,5317,22428,14860,44913,22421,7703,23700,46121,23705,46133
֣,ZhengChengZhen,371326110,24729,3750,16712,11026,33506,16678,5860,17568,34246,17627,34339
,BaiYanZhen,371326111,48817,7716,33387,21428,66813,33245,12597,35494,68739,35743,69130
ٽ,LinJianZhen,371326112,25732,4800,18741,12719,36387,18740,7011,18800,37540,18802,37543
,FengYangZhen,371326113,21899,4211,15532,11199,30383,15506,5330,15847,31353,15908,31440
,ZiQiuZhen,371326114,21476,3956,15398,10633,29145,15388,5497,15490,30878,15531,30929
κׯ,WeiZhuangXiang,371326201,15098,2936,10999,7485,21244,10868,4001,10888,21756,11036,22035
ʮ·ֵ,ShiZiLuJieDao,371327001,138901,14770,91796,65155,151176,85789,31540,87841,173630,93415,185211
,TuanLinZhen,371327101,26093,4379,18210,13973,36185,18199,6786,19000,37199,19048,37258
,DaDianZhen,371327102,48013,7860,32949,25198,65500,32387,10957,32836,65223,33881,66830
ǰ,FangQianZhen,371327103,26411,5553,19128,16065,37059,18990,6018,18594,37584,18854,37982
ƺ,PingShangZhen,371327104,40281,6570,27888,20900,52873,26649,8807,26698,53347,27770,55658
ۡ,XiangDiZhen,371327105,22057,3898,15173,12196,30005,15164,4647,15395,30559,15429,30602
Ȫ,BanQuanZhen,371327106,49116,7886,33939,25414,67468,33807,11306,34184,67991,34369,68308
䨱,ZhuBianZhen,371327107,31998,5671,22234,18255,44372,22225,7419,22840,45065,22854,45088
,WenTuanZhen,371327108,24984,5252,18139,15220,35281,18121,5755,17780,35901,17852,35991
׳,ZhuangGangZhen,371327109,26371,4872,18893,15092,36400,18873,6332,18597,37470,18682,37575
͡ˮ,TingShuiZhen,371327110,15975,2658,11249,8904,21733,11229,3755,11074,22303,11139,22388
ʯ,ShiLianZiZhen,371327111,27457,4601,19048,15004,37741,18883,6215,18878,37761,19225,38273
Ȫ,LingQuanZhen,371327112,25561,5017,18230,14966,35459,18195,5699,17961,36156,18047,36277
۱,YanBinZhen,371327113,30184,5258,20904,16502,41441,20880,6656,21143,42023,21194,42098
,LaoPoZhen,371327114,34572,6069,24034,19405,47498,24007,7863,24404,48411,24470,48504
«,ZhuLuZhen,371327115,22118,3997,15246,12230,29990,15234,4564,15379,30613,15433,30679
,DaoKouXiang,371327200,22714,3767,15567,12078,30931,15553,4900,15809,31362,15814,31381
๵,XiangGouXiang,371327201,25703,4066,17841,14256,35670,17829,6504,18377,36206,18432,36273
ֵ,MengYinJieDao,371328001,115815,14047,79350,53168,130582,75215,31238,77600,152815,81750,161100
·,ChangLuZhen,371328101,21193,3641,14938,11172,29057,14935,5394,15286,30221,15290,30228
,DaiGuZhen,371328102,30389,6126,21382,16399,41833,21343,6275,21346,42689,21408,42790
̹,TanBuZhen,371328103,17285,3718,12812,9632,24072,12765,3850,11966,24731,12041,24853
ׯ,DuoZhuangZhen,371328104,20295,3874,14783,10181,27812,14765,4769,14088,28853,14155,28938
߶,GaoDouZhen,371328105,20060,3393,14082,10717,27563,14082,4959,14328,28410,14330,28412
Ұ,YeDianZhen,371328106,21334,3855,15140,11564,29553,15140,4941,14971,30111,14990,30130
,TaoXuZhen,371328107,26934,5008,19117,12796,36950,19079,6504,19288,38367,19329,38446
,JiePaiZhen,371328108,20523,4092,14923,10523,28526,14861,4889,14465,29326,14581,29504
,LianChengZhen,371328109,29752,4893,21143,15154,40936,20978,7879,21025,42003,21381,42524
կ,JiuZhaiXiang,371328201,23355,4164,16254,11386,31416,16254,5093,16358,32612,16358,32612
ֵ,LinShuJieDao,371329001,112394,9810,74062,50275,109886,70287,29823,72912,143199,77965,152027
֣ɽֵ,ZhengShanJieDao,371329002,28297,3903,19499,14195,34278,19347,8009,20282,39629,20710,40209
,JiaoLongZhen,371329101,25652,4059,17790,11840,35223,17788,7001,18913,36701,18922,36712
,DaXingZhen,371329102,39170,6403,28273,18788,54591,28066,11051,27689,55755,28351,56624
ʯ,ShiMenZhen,371329103,32128,5130,24041,16403,44706,24025,10569,23725,47750,23786,47827
ׯ,CaoZhuangZhen,371329104,31503,5529,22365,15444,44024,22364,8182,22847,45211,22849,45214
Ϲ,NanGuZhen,371329105,34106,5772,23871,16954,46770,23518,8870,24293,47811,24877,48748
,BaiMaoZhen,371329107,26519,4381,18595,13728,36495,18585,7183,19453,38038,19488,38083
,QingYunZhen,371329108,31558,5414,22252,16854,43660,22097,7909,22300,44397,22629,44881
ɽ,YuShanZhen,371329109,17084,3077,12516,9768,23995,12512,4753,12375,24887,12398,24914
ͷ,DianTouZhen,371329110,27848,4885,20747,13916,39345,20741,8167,20145,40886,20153,40900
,ZhuCangXiang,371329200,28236,5000,20050,14813,39661,20050,7706,20823,40873,20892,40942
ºֵ,XinHuJieDao,371402001,87388,9788,53877,38169,98378,52098,14483,52316,104414,57782,111659
»ֵ,XinHuaJieDao,371402002,68946,6078,44722,30721,68763,44550,14837,44921,89471,45139,89861
ֵ,TianQuJieDao,371402003,41575,2973,26703,17493,39308,26624,9029,26750,53374,26874,53577
˺ӽֵ,YunHeJieDao,371402005,65682,6628,43454,28394,65091,42131,14455,41944,84075,43311,86765
㴨ֵ,GuangChuanJieDao,371402006,80194,6128,50290,28860,87581,41438,13409,41673,83111,49441,99731
ӽֵ,ChangHeJieDao,371402007,41835,1468,19730,8520,17206,12957,4994,12915,25872,28567,48297
ιͽֵ,SongGuanTunJieDao,371402008,33008,2180,20450,12092,27629,17565,6569,17491,35056,21307,41757
,ErTunZhen,371402100,10906,1289,7293,4587,14044,7243,2503,7289,14532,7405,14698
ƺ,HuangHeYaZhen,371402101,36472,4239,24301,16026,48069,24279,8539,24832,49111,24949,49250
Ի,ZhaoHuZhen,371402106,28098,4046,19292,12005,37576,19213,6820,19593,38806,19672,38964
̧ͷ,TaiTouSiZhen,371402107,18312,1915,12222,7356,23514,12177,4160,12091,24268,12165,24387
Ԭ,YuanQiaoZhen,371402108,15466,1686,10387,6311,19603,10383,3437,10194,20577,10202,20589
½ֵ,AnDeJieDao,371421001,35014,2934,22371,12763,31258,19122,7223,19282,38404,22800,45171
ֵ,LinQiJieDao,371421002,102907,10904,67362,40601,121685,65138,22890,66088,131226,69339,136701
֣կ,ZhengJiaZhaiZhen,371421101,31981,4141,21409,11075,42986,20368,7471,20308,40676,22184,43593
,MiZhen,371421102,35201,4296,24111,13844,47621,24099,8406,23773,47872,23792,47903
μ,SongJiaZhen,371421103,28237,3323,19157,11159,38314,19141,7051,19395,38536,19454,38611
ׯ,HuiWangZhuangZhen,371421104,30871,4564,20929,12282,42011,19306,6942,18820,38126,21448,42377
ͷ,ShenTouZhen,371421105,37955,4531,25701,16146,51357,25701,9011,25796,51497,25796,51497
,ZiZhen,371421106,26279,3223,17653,9695,33455,17218,5824,16982,34200,17673,35326
ǰ,QianSunZhen,371421107,20456,2932,14007,9019,27973,13375,4848,12990,26365,14229,28236
,BianLinZhen,371421108,19697,2394,13178,8373,26063,13129,4384,13167,26296,13297,26475
ɿ,YiDuKouZhen,371421109,24600,3047,16710,9830,33306,16463,5790,16277,32740,16727,33437
ׯ,DingZhuangZhen,371421110,13615,1636,8949,5785,17856,8945,2759,9058,18003,9061,18010
ڼ,YuJiXiang,371421202,16135,1844,10735,6406,21582,10734,3691,10934,21668,10935,21670
ǽֵ,NingChengJieDao,371422001,26878,2890,17624,9523,32907,16828,5430,16854,33682,17574,35198
ǽֵ,JinChengJieDao,371422002,49730,4977,32508,19324,58359,30646,10507,30661,61307,32706,65214
,ChaiHuDianZhen,371422101,38417,4952,26209,14967,51301,25905,8852,25514,51419,26012,52221
,ZhangGuanZhen,371422102,26876,3022,18536,10504,37506,18357,8158,19245,37602,19520,38056
ż,DuJiZhen,371422103,38548,4880,25584,14480,51095,25310,8801,25885,51195,26645,52229
,BaoDianZhen,371422104,25407,3457,17264,9490,33538,16719,5606,16356,33075,17206,34470
,DaLiuZhen,371422105,21911,2453,14207,7426,28257,13424,4596,13604,27028,14753,28960
,DaCaoZhen,371422106,25566,3131,17161,9510,33241,17161,5508,17043,34204,17044,34205
,XiangYaZhen,371422107,17803,2355,11830,6884,23241,11648,3715,11799,23447,12043,23873
ʱ,ShiJiZhen,371422108,21650,2621,14213,7760,28119,13384,4611,13316,26700,14669,28882
Ŵׯ,ZhangDaZhuangZhen,371422109,26943,2931,17017,9137,35328,15760,5587,16482,32242,18444,35461
Ӫ,LiuYingWuXiang,371422201,15649,2058,10265,5923,20646,9356,3415,9475,18831,10857,21122
·ֵ,BoHaiLuJieDao,371423001,47810,4371,29950,18159,48292,26077,10379,27527,53604,32610,62560
,QingYunZhen,371423100,26717,2939,17583,10874,34752,17583,6479,18547,36130,18552,36135
,ChangJiaZhen,371423101,34412,4265,22915,14996,45373,22906,8124,23870,46776,23886,46801
,ShangTangZhen,371423102,42253,4920,27806,16587,56143,27521,10068,29062,56583,29435,57241
޿,CuiKouZhen,371423103,10261,1347,6641,4158,13310,6630,2139,7077,13707,7106,13747
,YanWuXiang,371423200,14757,1877,9812,5947,19499,9766,3079,9782,19548,9901,19713
,DongXinDianZhen,371423201,16805,2339,11688,6765,22526,11658,4256,11655,23313,11712,23400
ж,ZhongDingXiang,371423202,13561,1833,9371,6044,18492,9367,3676,9692,19059,9699,19070
԰,XuYuanZiXiang,371423203,11728,1511,7849,5474,15471,7840,2778,8155,15995,8168,16017
϶ֵ,XingDongJieDao,371424001,65721,6834,43713,28990,73169,43017,14945,43543,86560,43787,87500
Դֵ,HengYuanJieDao,371424002,27878,2164,17651,8601,25975,15127,5487,15245,30372,17878,35529
ֵ̽,LinPanJieDao,371424003,57627,7266,38957,24982,72033,38751,13340,38407,77158,39276,78233
,LinYiZhen,371424100,34017,3803,22944,12714,43861,22941,7847,22719,45660,22723,45667
,LinNanZhen,371424102,30276,4324,20755,11466,41952,20639,7832,21047,41686,21677,42432
ƽ,DePingZhen,371424103,36753,5118,25736,16148,49820,25578,8784,24487,50065,24919,50655
,LinZiZhen,371424104,15878,1918,10973,7182,21264,10918,4016,10789,21707,10839,21812
¡,XingLongZhen,371424105,27301,3800,19150,10963,37380,19139,7133,19051,38190,19084,38234
,MengSiZhen,371424106,29048,4382,20102,11561,40291,19929,7630,20449,40378,20958,41060
Լ,ZhaiJiaZhen,371424107,15150,2012,10966,7378,20672,10861,3771,9830,20691,9967,20933
,LiHeWuZhen,371424108,19022,2164,12902,6901,25434,12899,4388,12652,25551,12672,25574
ް,SuAnXiang,371424202,17218,2096,11892,7005,23066,11888,4162,11561,23449,11584,23476
̳ǽֵ,YanChengJieDao,371425001,63590,6265,40206,26148,66116,39096,12606,39188,78284,42255,82461
ֵ̱,YanBeiJieDao,371425002,46611,4944,29621,16842,56230,29096,9930,29413,58509,31864,61485
,BiaoBaiSiZhen,371425101,19928,2819,13284,7681,26882,13263,4225,13618,26881,13688,26972
,JiaoMiaoZhen,371425102,37261,5227,25436,14557,50134,25414,8102,25077,50491,25154,50590
Թ,ZhaoGuanZhen,371425103,23923,3240,15466,8958,30107,15460,4433,16126,31586,16130,31596
ף,ZhuAZhen,371425104,43722,5524,29149,16013,57205,29084,8749,28648,57732,28846,57995
Ｏ,RenLiJiZhen,371425105,35595,5207,23767,14459,47542,23762,6988,24020,47782,24023,47790
˵,PanDianZhen,371425106,35944,5158,24301,14825,47820,24301,7444,24245,48546,24245,48546
,HuGuanTunZhen,371425107,25900,4004,17772,10595,34994,17754,5438,17459,35213,17570,35342
,XuanZhangTunZhen,371425108,16420,2499,11150,6388,22323,11098,3587,11207,22305,11356,22506
�,MaJiZhen,371425109,22576,3050,14909,8215,28504,14864,4582,14425,29289,15299,30208
,HuaDianXiang,371425200,17377,2566,11887,7473,23576,11886,3741,11797,23683,11797,23684
ͷ,AnTouXiang,371425201,15835,2311,10668,6074,21395,10614,3463,10801,21415,10941,21609
,LiuQiaoXiang,371425203,25521,3668,17339,9497,34293,17331,5460,17264,34595,17310,34649
,DaiHuangXiang,371425204,19528,2704,13156,7294,26400,13155,4377,13451,26606,13453,26609
Žֵ,LongMenJieDao,371426001,65560,6832,42447,25602,70896,36902,13401,36194,73096,43346,85793
԰ֵ,TaoYuanJieDao,371426002,20654,2732,13994,9266,27395,13837,4486,13666,27503,13878,27872
¥,WangFengLouZhen,371426101,38118,4838,25746,15791,51149,24744,9003,24466,49210,26213,51959
ǰ,QianCaoZhen,371426102,35653,4908,23867,13726,47510,22927,7348,22546,45473,24042,47909
,EnChengZhen,371426103,38738,5599,26729,16626,53564,25952,9767,26036,51988,27375,54104
,WangMiaoZhen,371426104,24282,3436,16871,11045,33154,16855,5622,16443,33298,16469,33340
,WangGaoPuZhen,371426105,20720,2921,13906,9477,27915,13604,4892,13974,27578,14627,28533
Ż,ZhangHuaZhen,371426106,18332,2626,12613,7845,24902,12328,4237,12166,24494,12582,25195
վ,YaoZhanZhen,371426107,19292,2453,13238,7947,26148,12980,4675,12705,25685,13182,26420
,WangDaGuaZhen,371426108,16590,2302,11088,6874,21903,10588,3538,10462,21050,11342,22430
,FangZiXiang,371426200,13968,1847,9369,6082,18610,8914,3198,8938,17852,9644,19013
,SanTangXiang,371426202,15215,1745,10061,6355,20084,9941,3420,10097,20038,10319,20380
ǽֵ,YinChengJieDao,371427001,60759,7068,41313,22423,70628,35780,16163,36106,71886,42677,83990
ǽֵ,BeiChengJieDao,371427002,31966,3147,21996,13740,35800,21110,10128,21738,42848,23245,45241
ϳ,NanChengZhen,371427100,28826,3905,19508,11339,38238,18859,6776,18912,37771,19999,39507
ׯ,SuLiuZhuangZhen,371427101,32722,4949,22906,14122,46454,22111,9294,22578,44689,24059,46965
ʢ,XinShengDianZhen,371427102,34857,5424,25223,15867,49255,24228,10275,23907,48135,25333,50556
׼,LeiJiZhen,371427103,26351,3705,18858,10948,37116,18404,7574,18116,36520,18772,37630
֣,ZhengBaoTunZhen,371427104,16594,1929,11396,6113,21861,10970,4898,11072,22042,12025,23421
,BaiMaHuZhen,371427105,22275,2625,15229,9398,30133,14785,6109,15049,29834,15780,31009
,DongLiGuanTun,371427106,19129,2985,13504,8749,26556,13500,4941,13548,27048,13551,27055
¥,SongLouZhen,371427107,22582,2797,15263,9257,30251,14833,5432,14864,29697,15548,30811
ׯ,XiangZhaoZhuangZhen,371427108,17781,2560,12196,7739,24359,11721,4534,11725,23446,12679,24875
˫,ShuangMiaoZhen,371427109,17862,2269,11956,7371,24332,11499,4464,11709,23208,12639,24595
ɿ,DuKouYiXiang,371427200,12606,1651,8804,5464,17406,8802,3533,8976,17778,8986,17790
ׯ,TianZhuangXiang,371427204,11396,2269,8365,5122,16523,7905,3404,7879,15784,8704,17069
˽ֵ,GuangYunJieDao,371428001,55887,5161,35714,18813,56803,29353,12230,29430,58783,37564,73278
,WuChengZhen,371428100,41597,6371,28352,16291,56344,26420,9154,25982,52402,28770,57122
ϳ,LaoChengZhen,371428101,28809,3815,18958,11012,37460,17516,5929,17456,34972,19595,38553
³Ȩ,LuQuanTunZhen,371428103,62904,7856,42314,23350,83130,41652,14667,41803,83455,43113,85427
ׯ,HaoWangZhuangZhen,371428104,30198,3923,20111,13114,39931,19989,6567,20379,40368,20577,40688
ׯ,YangZhuangZhen,371428105,16123,1931,10779,6583,20659,10241,3860,10638,20879,11135,21914
Ӫ,JiaMaYingZhen,371428106,23174,3021,15841,9687,31538,15783,5623,15912,31695,15977,31818
һ,LiJiaHuXiang,371428201,19566,3011,13491,8737,27035,13042,4686,13074,26116,13772,27263
нֵ,ShiZhongJieDao,371481001,82865,6920,51306,29843,73859,46460,15934,48732,95192,54413,105719
ҽֵ,HuJiaJieDao,371481002,18363,2062,11207,5610,23744,10199,3695,10279,20478,12913,24120
ƺֵ,YunHongJieDao,371481003,21822,2645,14429,7619,26356,14299,4957,14793,29092,14995,29424
ҽֵ,GuoJiaJieDao,371481004,12175,1318,7734,4193,13162,6654,2217,6699,13353,7976,15710
,YangAnZhen,371481100,35822,3861,23148,10647,42665,20513,7691,21197,41710,24226,47374
켯,ZhuJiZhen,371481101,42125,4687,27151,12689,55410,25495,8989,26582,52077,28650,55801
Ƽ,HuangJiaZhen,371481102,42591,5427,27123,14690,56887,24983,9066,26092,51075,29961,57084
,DingWuZhen,371481103,29077,3085,16609,8855,33915,15819,5411,16882,32701,20964,37573
԰,HuaYuanZhen,371481104,31900,3981,21010,10610,42857,19825,7352,20166,39991,22223,43233
֣,ZhengDianZhen,371481105,44182,5180,29665,16966,55395,29183,9948,28560,57743,29645,59310
¥,HuaLouZhen,371481106,28123,2818,18104,9372,34253,17380,5976,17288,34668,18813,36917
,KongZhen,371481107,36862,3904,23636,12448,46395,22196,7420,22578,44774,24550,48186
Ӫ,TieYingZhen,371481108,18531,2415,12276,6087,25303,11671,4485,12139,23810,13155,25431
,XiDuanXiang,371481200,17658,2257,11880,6334,23975,11365,4345,11864,23229,12380,24260
,DaSunXiang,371481201,16109,1845,10969,5618,22246,10453,4575,10695,21148,11560,22529
կͷ,ZhaiTouBaoXiang,371481203,14551,1791,9871,6085,19358,9870,3402,9872,19742,9873,19744
нֵ,ShiZhongJieDao,371482001,114611,11735,76381,43781,129634,72083,25095,70275,142358,75060,151441
,LunZhen,371482100,25534,4076,18070,11546,35013,18037,5935,17365,35402,17475,35545
,FangSiZhen,371482101,48880,7462,33382,19295,66162,32325,10353,31538,63863,33313,66695
ׯ,ZhangZhuangZhen,371482102,15138,2252,10442,6698,20161,10432,3240,10130,20562,10188,20630
,XinDianZhen,371482103,23204,3124,15995,9606,31236,15990,5476,15772,31762,15809,31804
,AnRenZhen,371482104,20725,3008,14637,8204,28515,14605,4936,14005,28610,14032,28669
կ,XinZhaiZhen,371482105,29082,4066,20024,12012,39295,19831,6588,19369,39200,19712,39736
,LiangJiaZhen,371482106,29642,4307,19817,10947,39343,19296,6198,19356,38652,20330,40147
ʮ,ShiLiWangZhen,371482107,22704,2624,15015,8283,25939,14039,4601,13703,27742,14914,29929
,LiTunXiang,371482200,15816,2176,10849,6503,21432,10847,3557,10696,21543,10700,21549
,JuZhenXiang,371482202,17564,2491,11882,7041,23674,11878,3831,11991,23869,12004,23886
¥ֵ,GuLouJieDao,371502001,85180,8774,56163,35068,83818,53964,19908,54333,108297,57699,113862
԰ֵ,LiuYuanJieDao,371502002,110708,9124,67439,34852,89340,53253,17428,52675,105928,69821,137260
ֵ,XinQuJieDao,371502003,112650,9573,71871,47432,110436,69340,23185,70559,139899,73537,145408
ֵ,HuXiJieDao,371502004,30844,2376,18881,11477,30979,17829,6931,18252,36081,21270,40151
ֵ̽,DaoKouPuJieDao,371502005,24342,2908,16627,10839,32023,16605,6640,17202,33807,17263,33890
½ֵ,YanSiJieDao,371502006,33175,3681,22106,14281,42107,22105,7890,22638,44743,22640,44746
˽ֵ,FengHuangJieDao,371502007,27992,3637,18636,12059,35286,18527,6160,18983,37510,19153,37789
ǽֵ,BeiChengJieDao,371502008,28229,3078,18983,11574,36757,18750,6994,18897,37647,19318,38301
ǽֵ,DongChengJieDao,371502009,35515,2152,23475,14439,25666,23428,8557,22686,46114,22749,46224
ͽֵ,JiangGuanTunJieDao,371502010,25168,2802,16734,11196,32604,16512,6375,17062,33574,17611,34345
Ӫ,HouYingZhen,371502100,32711,3719,21848,13504,43583,21847,8051,22632,44479,22633,44481
ɳ,ShaZhenZhen,371502101,61269,7947,42125,26782,83096,42076,16515,43454,85530,43606,85731
,TangYiZhen,371502102,24928,2896,17023,10333,32710,16975,6322,17074,34049,17123,34146
ˮ,LiangShuiZhen,371502103,45364,5524,30667,19034,60655,30652,11173,31374,62026,31394,62061
,DouHuTunZhen,371502104,30253,3392,19890,11710,39758,19322,7145,19709,39031,20900,40790
֣,ZhengJiaZhen,371502105,33089,3491,23254,15473,42925,23204,11292,24427,47631,24618,47872
¯,ZhangLuJiZhen,371502106,24139,2910,16381,10976,32558,16380,6317,16984,33364,16985,33366
ڼ,YuJiZhen,371502107,28519,3802,18901,11349,37782,18891,5833,19248,38139,19253,38154
Ӫ,XuYingZhen,371502108,27921,3534,17893,11208,35606,17498,5842,18473,35971,19404,37297
ׯ,ZhuLaoZhuangZhen,371502109,25698,3387,17585,11010,34904,17585,6681,18180,35765,18181,35766
˹,GuGuanTunZhen,371502110,25904,3852,17326,11423,34345,17012,5453,17279,34291,17883,35209
ƽ,GuangPingXiang,371502202,21221,2765,14200,8842,28610,14044,4897,14410,28454,14683,28883
,HanJiXiang,371502203,20634,2463,13763,8415,27381,13735,5059,14346,28081,14393,28156
㽭ί,XiangJiangGuanWei,371502400,4693,27,2701,2198,507,2696,1160,3153,5849,3179,5880
Žֵ,BoJiQiaoJieDao,371521001,57667,5045,36376,21038,54387,31345,11482,32624,63969,37818,74194
ֵ,QiaoRunJieDao,371521002,47709,4735,29943,15892,52074,23951,9494,24750,48701,31995,61938
ʨ¥ֵ,ShiZiLouJieDao,371521003,30910,2808,19373,12184,28900,18097,6459,19129,37226,20804,40177
¥,YanLouZhen,371521101,36873,4582,24196,14473,48961,23727,7830,24290,48017,25089,49285
,AChengZhen,371521103,45635,6234,30544,17039,61412,30340,9783,30546,60886,31108,61652
߼,QiJiZhen,371521104,26491,3805,18041,10878,35760,17976,5912,18056,36032,18167,36208
,AnLeZhen,371521105,26193,3467,17292,10594,34161,16902,5604,16702,33604,17972,35264
ˮ,DingShuiZhen,371521106,19205,2431,13114,8704,26072,13090,4620,13110,26200,13142,26256
ʯ,ShiFoZhen,371521107,25175,3359,16928,10484,33720,16698,5853,16837,33535,17459,34387
̨,LiTaiZhen,371521108,25387,3332,17485,9608,34516,17341,7095,18026,35367,18329,35814
,ShouZhangZhen,371521109,48385,6478,32353,17947,63690,31666,10573,31921,63587,33083,65436
ʮ԰,ShiWuLiYuan,371521111,30639,4147,20893,12268,41494,20212,7485,20380,40592,21378,42271
,ZhangQiuZhen,371521112,31992,4427,21522,12581,43414,21372,7266,21893,43265,22163,43685
,GuoDianTunZhen,371521113,19448,3237,13155,8294,26240,12802,4167,12877,25679,13697,26852
,XiHuZhen,371521114,27311,3043,17940,11317,36045,17119,6828,17821,34940,19242,37182
,DaBuXiang,371521203,24618,3148,16468,11026,33159,16224,5895,16662,32886,17193,33661
,GaoMiaoWangXiang,371521206,27210,3426,18480,10782,37294,17682,7297,18218,35900,19453,37933
Ӫ,JinDouYingXiang,371521207,20961,2607,13879,7343,27768,13749,4962,14335,28084,14651,28530
ֵ,YanTaJieDao,371522001,54403,4448,34066,16697,59892,24418,10660,25909,50327,35445,69511
ݷֵͤ,ShenTingJieDao,371522002,26798,2638,17339,10945,31850,16163,6273,16680,32843,18370,35709
ݷݽֵ,ShenZhouJieDao,371522003,21026,2359,13378,7688,24061,11174,4630,11666,22840,14637,28015
³ֵ,DongLuJieDao,371522004,28504,2261,17364,8559,28060,12295,5381,13064,25359,18782,36146
³,ZhangLuZhen,371522101,33633,4505,23636,15535,45128,23414,10027,24087,47501,24529,48165
,ChaoChengZhen,371522102,36328,4489,24173,13971,47583,22956,8480,23672,46628,25124,49297
۳,GuanChengZhen,371522103,25005,3204,16820,10184,33163,16698,5533,16671,33369,16922,33742
ų,GuChengZhen,371522104,37450,4296,24221,13588,48876,23025,7904,23590,46615,25429,49650
ż,DaZhangJiaZhen,371522105,27202,3641,18270,11438,35946,18082,5967,18087,36169,18540,36810
,GuYunZhen,371522106,38576,4222,24720,13449,45906,24296,7919,25312,49608,25997,50717
ʮ,ShiBaLiPu,371522107,27634,3678,19006,12867,37899,19000,7939,20232,39232,20245,39251
,YanDianZhen,371522109,26972,3018,18521,12538,35808,18323,7762,18920,37243,19231,37752
ׯ,DongDuZhuangZhen,371522110,21077,2569,14512,9021,28514,14508,6094,15211,29719,15228,29740
,WangFengZhen,371522111,30899,4056,21514,13550,41651,21221,8659,21513,42734,22100,43614
ӣ԰,YingTaoYuanZhen,371522112,42732,4602,27204,14858,55318,26784,9598,29069,55853,29728,56932
ӵ,HeDianZhen,371522113,24612,2771,16736,11353,33152,16454,6503,16561,33015,17150,33886
ڣ,MeiZhongZhen,371522114,33257,4366,22984,15369,45486,22695,8961,23010,45705,23600,46584
κׯ,WeiZhuangZhen,371522115,27675,3288,19157,12697,37621,19114,7522,19233,38347,19328,38485
կ,ZhangZhaiZhen,371522116,31586,4194,21750,13575,42793,21395,8216,21457,42852,22246,43996
կ,DaiWangZhaiXiang,371522203,24103,3040,17287,10862,32650,17271,8211,18003,35274,18067,35354
޵,ZuDianXiang,371522207,14827,1849,10259,6554,20212,10192,4255,10568,20760,10672,20931
ׯ,XuZhuangXiang,371522210,23111,2447,15326,8014,29547,15032,5416,15034,30066,15648,30974
ׯ,WangZhuangJiXiang,371522212,24297,3256,16922,9939,32805,16919,5668,16282,33201,16299,33221
԰,ShiZiYuanXiang,371522214,22958,2605,14867,8512,29947,14860,4782,15468,30328,15478,30345
˽ֵ,ZhenXingJieDao,371523001,84096,7538,54706,35080,77017,50630,17961,51427,102057,54889,109595
ŷֵ,XinFaJieDao,371523002,28023,2910,18830,11654,30142,17294,6822,17199,34493,18925,37755
³½ֵ,WenChenJieDao,371523003,29277,4504,19991,13076,39482,19439,6513,19398,38837,20303,40294
ƽ,LePingPuZhen,371523101,35395,5214,23894,14595,46810,23571,7503,23529,47100,24218,48112
,FengGuanTunZhen,371523102,30979,4457,21132,13408,40954,20508,6774,20153,40661,21078,42210
,CaiTunZhen,371523103,18719,2784,12585,8901,25258,12486,4031,12717,25203,12949,25534
ƽ,BoPingZhen,371523104,36760,5171,24876,15608,46785,23532,7585,23518,47050,24640,49516
ɿ,DuLangKouZhen,371523105,23207,3041,15432,9830,30577,15171,4953,15288,30459,15769,31201
,HanTunZhen,371523106,21616,3242,14534,9575,28683,14211,4516,14111,28322,14840,29374
,HuTunZhen,371523107,16697,2661,11429,7750,22426,10935,3892,11081,22016,11821,23250
կ,JiaZhaiXiang,371523207,17516,2849,12474,8710,23554,12448,4376,12165,24613,12267,24741
,YangGuanTunXiang,371523208,10586,1587,7270,5145,14224,7246,2609,7462,14708,7512,14782
,HongGuanTunXiang,371523209,16220,2070,10714,6736,21364,10710,3569,11135,21845,11145,21859
Фׯ,XiaoZhuangXiang,371523210,15891,2606,10814,7674,21183,10784,3296,10837,21621,10979,21793
ͭǽֵ,TongChengJieDao,371524001,61033,6890,39819,25262,59516,37435,11618,37620,75055,39722,79541
³ǽֵ,XinChengJieDao,371524002,28874,3071,18717,12604,27623,18616,5784,18823,37439,19012,37729
,LiuJiZhen,371524101,44043,6771,30000,19272,58770,29972,8947,29657,59629,29761,59761
ţǵ,NiuJiaoDianZhen,371524102,30990,5237,21807,13484,41878,21793,6478,20856,42649,20898,42705
,DaQiaoZhen,371524103,13415,2194,9116,5847,17574,9007,2619,8947,17954,9112,18228
߼,GaoJiZhen,371524104,15450,2895,11201,7751,21104,11156,3424,10519,21675,10568,21769
¥,JiangLouZhen,371524105,18946,3055,12687,8270,25146,12642,3730,12789,25431,13044,25731
Ҧկ,YaoZhaiZhen,371524107,20884,3272,14312,9278,27733,14301,4097,13932,28233,13941,28253
ɽ,YuShanZhen,371524108,15836,2776,11283,7713,21629,11275,3363,10678,21953,10692,21975
¼,ChenJiXiang,371524205,12221,2011,8362,5611,16127,8325,2706,8403,16728,8576,16938
Ȫֵ,QingQuanJieDao,371525001,57540,5773,36689,21705,66291,33173,12401,34875,68048,39025,75714
Ľֵ,ChongWenJieDao,371525002,39782,3810,25305,12589,47591,19776,9682,20972,40748,27969,53274
ׯֵ,YanZhuangJieDao,371525003,29840,2975,19425,11406,38878,19063,6678,19394,38457,20068,39493
,JiaZhen,371525101,28230,2786,19198,11670,37120,18796,7736,19159,37955,19554,38752
ɣ,SangAZhen,371525102,44034,5431,29824,18682,60158,29114,11019,29453,58567,30660,60484
,LiuLinZhen,371525103,37268,3862,24107,14051,48764,23275,8246,23847,47122,25269,49376
ˮ,QingShuiZhen,371525104,26152,2362,16553,10867,33797,16552,5889,17845,34397,17850,34403
ų,DongGuChengZhen,371525105,50555,4899,34429,19092,66721,34396,15125,36052,70448,36150,70579
,BeiGuanTaoZhen,371525106,25784,2330,17289,9281,35430,17281,7756,18574,35855,18581,35870
,DianZiZhen,371525107,21562,2439,14308,9594,28726,14246,5187,14737,28983,14880,29188
б,XieDianXiang,371525200,25833,2692,16874,9236,33526,16789,5925,17476,34265,17576,34450
,LiangTangXiang,371525201,24122,2781,15559,8879,32022,15558,5334,16678,32236,16678,32237
Զկ,DingYuanZhaiXiang,371525202,25227,2767,16462,10271,32649,16323,5601,16767,33090,17133,33595
,XinJiXiang,371525203,31968,3549,21325,12899,42168,21324,7257,21447,42771,21449,42774
կ,FanZhaiXiang,371525204,24306,2748,15968,10055,32024,15741,5305,16070,31811,16391,32359
ʹ,GanGuanTunXiang,371525205,31611,3012,20638,12208,41608,20637,7496,21478,42115,21481,42119
,LanWoXiang,371525206,23405,2668,15121,10065,30928,14825,5273,15545,30370,16225,31346
,WanShanXiang,371525209,20742,2370,14077,9175,28137,14073,5739,14771,28844,14774,28851
ֵ,YuQiuHuJieDao,371526001,53384,4948,33994,22316,42843,32457,11330,32380,64837,35668,69662
νֵ,HuiXinJieDao,371526002,28999,3790,19574,12309,30473,19441,6484,19534,38975,19699,39273
˺ͽֵ,RenHeJieDao,371526003,40007,4098,26355,17504,29964,24968,8844,24981,49949,26594,52949
,LiangCunZhen,371526101,27165,4034,18564,11330,35597,18530,5440,17986,36516,18075,36639
,YinJiZhen,371526102,22810,3426,15610,10668,29929,15596,4918,15503,31099,15544,31154
ƽ,QingPingZhen,371526103,28982,4550,20043,13207,39093,20027,6726,20164,40191,20215,40258
̺,GuHeZhen,371526104,25563,3920,17455,10886,34104,17296,5258,16885,34181,17286,34741
ʮ,SanShiLiPu,371526105,17839,2408,12147,7783,23221,12123,4430,12489,24612,12530,24677
,LiuLiSiZhen,371526106,22223,3605,15953,9846,30500,15755,5616,15210,30965,15491,31444
կ,ZhaoZhaiZiZhen,371526107,23718,3975,16341,9993,31029,16206,5108,16219,32425,16460,32801
,JiangDianZhen,371526108,27881,4316,19084,11999,35830,19072,5633,18706,37778,18746,37830
,YangTunXiang,371526203,31164,4458,21077,13034,41284,21037,6372,20815,41852,20917,41994
·ֵ,QingNianLuJieDao,371581001,64233,7361,41874,25822,73061,39880,12539,40413,80293,42259,84133
»·ֵ,XinHuaLuJieDao,371581002,82271,8103,53366,34158,86893,52371,16837,52459,104830,53845,107211
ȷ·ֵ,XianFengLuJieDao,371581003,43840,4967,28602,16754,53430,26319,8618,26469,52788,28823,57425
ׯֵ,DaXinZhuangJieDao,371581004,26044,2783,17335,10136,33384,17280,6426,17715,34995,17918,35253
,SongLinZhen,371581101,24154,2859,15922,10367,31354,15922,5185,16276,32198,16276,32198
ׯ,LaoZhaoZhuangZhen,371581102,30720,3439,20102,12508,40198,20102,6430,20487,40589,20487,40589
ׯ,KangZhuangZhen,371581103,42940,5438,28362,18522,55115,27554,9258,28508,56062,29274,57636
κ,WeiWanZhen,371581104,16324,2582,11422,7829,22360,11407,3859,11256,22663,11343,22765
,LiuGaiZiZhen,371581105,20527,2463,13629,8578,27114,13627,4597,13956,27583,13958,27587
˲·,BaChaLuZhen,371581107,23577,2462,15482,9324,30476,15463,5800,16198,31661,16357,31839
ׯ,PanZhuangZhen,371581108,26691,2265,16404,9105,30968,16393,6028,18513,34906,18580,34984
̵,YanDianZhen,371581109,30947,2464,19111,10710,34804,18959,7301,21226,40185,21601,40712
԰,TangYuanZhen,371581110,28008,2415,17199,10088,35866,17190,6008,19213,36403,19232,36431
ׯ,JinHaoZhuangZhen,371581111,36594,4969,25236,16512,48527,25229,9306,25613,50842,25633,50869
,DaiWanZhen,371581112,22883,2442,14920,9362,30172,14798,5119,15303,30101,15524,30444
е,ShangDianZhen,371581113,21952,2240,14469,9054,28560,14467,5343,15065,29532,15066,29535
нֵ,ShiZhongJieDao,371602001,46442,6473,31466,18036,53759,25137,9237,24103,49240,30686,62152
ֵ,ShiXiJieDao,371602002,53232,4655,35443,22701,48232,32656,10710,31222,63878,33154,68597
ֵ,BeiZhenJieDao,371602003,34104,3144,22563,15755,30034,21769,7028,21020,42789,21713,44276
жֵ,ShiDongJieDao,371602004,40898,4120,26392,18127,33644,24722,8094,23985,48707,26720,53112
ֵ,PengLiJieDao,371602005,59174,4112,37263,21015,43820,29619,9564,28542,58161,35587,72850
СӪֵ,XiaoYingJieDao,371602007,26627,3566,18095,11275,33204,17501,5771,17198,34699,17869,35964
�ֵ,BinBeiJieDao,371602008,51851,6487,34592,21669,61257,33069,10767,33058,66127,34513,69105
Žֵ,LiangCaiJieDao,371602009,23590,3178,16150,10144,29492,16102,5218,15708,31810,15836,31986
ŵֵ,DuDianJieDao,371602010,43455,2817,27096,14576,32363,21738,7511,21362,43100,26687,53783
ɳӽֵ,ShaHeJieDao,371602011,14218,1792,9769,5671,19027,9768,3206,9442,19210,9447,19216
ֵ,LiZeJieDao,371602012,32129,4396,21833,13338,42940,21796,7057,21638,43434,21749,43582
ֵ,QingTianJieDao,371602013,18784,3347,13316,8641,25363,13301,4136,12913,26214,12951,26267
Ӻ,SanHeHuZhen,371602105,30003,4399,20677,12614,41088,20628,7067,20744,41372,20792,41469
ѩ,YangLiuXueZhen,371602106,29280,4593,20067,13022,38623,20019,6251,19923,39942,20057,40124
ػ̨,QinHuangTaiXiang,371602203,14723,2309,10151,7009,19597,10103,3202,9910,20013,10083,20234
ֵ,SunWuJieDao,371621001,69828,8286,47031,27017,77034,43572,13870,41945,85517,44953,91984
䶨ֵ,WuDingFuJieDao,371621002,8829,1123,5702,3113,10655,5635,1816,5530,11165,6066,11768
ʯ,ShiMiaoZhen,371621101,36705,6185,26088,14987,51154,26081,8900,25689,51770,25702,51790
ɣ,SangLuoShuZhen,371621102,18027,3171,12770,7870,24889,12745,4094,12464,25209,12522,25292
ͽ,ZiJiaoZhen,371621103,22575,3317,14624,7266,29923,14352,4292,14515,28867,15560,30184
,HuJiZhen,371621104,40246,6028,27514,16548,54194,27458,8903,27549,55007,27663,55177
ׯ,LiZhuangZhen,371621105,38581,5215,26547,15013,51311,26520,8661,25835,52355,25910,52457
,MaDianZhen,371621107,19966,3175,13767,8243,27068,13750,4614,13785,27535,13988,27755
κ,WeiJiZhen,371621108,22193,2873,14892,8370,29500,14831,4864,14846,29677,15038,29930
,QingHeZhen,371621109,23380,3243,15733,8884,31138,15709,4986,15824,31533,15876,31609
¥,JiangLouZhen,371621111,39234,5492,26551,14649,52567,26545,8375,26534,53079,26550,53101
η,HeFangZhen,371621112,26276,3980,17989,10581,35001,17965,5669,17878,35843,17936,35925
,XinDianZhen,371621113,32397,4952,22258,13075,43688,22146,6985,21793,43939,22076,44334
,DaNianChenZhen,371621114,22339,3364,15602,8515,30434,15590,5158,15223,30813,15259,30861
�,ZaoHuLiXiang,371621204,22406,3315,15010,7869,29824,14758,4603,14850,29608,15314,30324
ųǽֵ,XinChengJieDao,371622001,35787,3174,23061,13833,34229,20416,6836,19859,40275,22736,45797
ֵ,JinYangJieDao,371622002,28080,3549,18851,11866,37935,18849,6758,19533,38382,19536,38387
̵,ShangDianZhen,371622101,34010,4945,22309,13059,45764,21792,7048,22263,44055,23694,46003
µ,WenDianZhen,371622102,27880,3779,19023,10675,39062,18709,7552,19473,38182,20188,39211
,HeLiuZhen,371622103,29046,3282,19276,10704,38281,18801,6634,19216,38017,19686,38962
,ZhaiWangZhen,371622104,24975,3545,17059,10736,33597,17038,5813,17198,34236,17274,34333
,LiuPoWuZhen,371622105,27118,4199,18873,11740,38022,18867,7078,19520,38387,19522,38395
ˮ,ShuiLuoPoZhen,371622106,40135,6335,27556,18135,55415,27535,9214,28094,55629,28128,55684
͵,LaoDianXiang,371622200,30444,4602,20593,12943,41840,20173,6965,20387,40560,21418,42011
,YangHuXiang,371622204,34546,4670,24380,14474,47561,24343,9015,23782,48125,23851,48231
馷ֵ,DiFengJieDao,371623001,19182,2350,12511,8748,21913,12011,4674,12346,24357,13695,26206
ֵ,HaiFengJieDao,371623002,60739,6600,40577,26479,64930,37107,14113,37494,74601,40875,81452
ˮ,ShuiWanZhen,371623101,35568,5486,23555,17826,47029,23345,7481,24576,47921,24980,48535
ʯɽ,JieShiShanZhen,371623102,16562,2713,11339,8289,21462,11186,3695,11387,22573,11631,22970
Сͷ,XiaoBoTouZhen,371623103,25665,4394,17908,13327,33689,17895,6063,18113,36008,18214,36122
,ChengKouZhen,371623104,17627,2024,11540,8658,19701,11454,4299,11723,23177,12410,23950
ɽ,MaShanZiZhen,371623105,20561,2241,12311,8845,23610,12023,4158,12475,24498,14649,26960
,CheWangZhen,371623106,31140,4834,21831,15785,41509,21801,7904,21887,43688,22047,43878
,LiuBaoZhen,371623107,21773,3038,14705,10897,28252,14560,5308,14961,29521,15414,30119
,XinYangXiang,371623200,21710,3325,14738,10907,28425,14669,5036,15206,29875,15333,30071
С,XiXiaoWangXiang,371623203,14519,1937,9568,7080,18488,9374,3248,9659,19033,10136,19704
ܼ,SheJiaXiangXiang,371623204,20414,3775,14348,11193,28123,14326,4531,14319,28645,14372,28720
ֵ,FuGuoJieDao,371624001,49666,5376,31832,19637,52883,29209,8922,28807,58016,32132,63964
Դֵ,FuYuanJieDao,371624002,32082,4137,20447,13288,37131,19347,6139,19306,38653,21911,42358
,XiaWaZhen,371624101,36000,5693,24722,19244,47074,24666,7323,23579,48245,24294,49016
ų,GuChengZhen,371624102,17726,2944,12000,8351,23441,11996,3428,12053,24049,12098,24098
,FengJiaZhen,371624103,38869,5527,25860,18523,50782,25819,7030,25430,51249,25566,51426
ͷ,BoTouZhen,371624104,21057,3366,14534,10126,27398,14283,4329,13908,28191,14218,28752
,DaGaoZhen,371624105,26441,4367,18004,12495,35471,17408,5394,16948,34356,18198,36202
,HuangShengZhen,371624106,15986,2934,11104,7922,21359,11057,2936,10685,21742,10752,21856
,BinHaiZhen,371624107,6953,791,3592,2459,6251,3353,895,3265,6618,5047,8639
º,XiaHeXiang,371624203,9804,1494,6783,4590,12826,6735,1940,6402,13137,6455,13238
,LiGuoXiang,371624204,8463,1384,5976,4073,11443,5973,1982,5815,11788,5853,11829
´,HaiFangBanShiChu,371624205,257,20,119,154,152,119,17,170,289,175,294
Ƕֵ,ChengDongJieDao,371625001,32225,4048,21294,12819,36233,19957,7502,19673,39630,22481,43775
ֵ,JinQiuJieDao,371625002,42337,6359,29581,18584,49985,28778,10057,28410,57188,29172,58753
ֵ,BoChangJieDao,371625003,42816,3297,27182,16844,31738,24257,9345,24172,48429,28276,55458
,CaoWangZhen,371625101,27107,4263,18841,11249,36599,18794,6940,19306,38100,19469,38310
˸,XingFuZhen,371625102,27739,3847,18717,10345,33620,18056,8032,18885,36941,20901,39618
»,ChenHuZhen,371625103,30354,4091,20355,14142,37262,20275,6435,19850,40125,20525,40880
,HuBinZhen,371625104,30888,4847,21376,12790,39889,20559,8008,21246,41805,22367,43743
,DianZiZhen,371625106,30506,5036,21067,13336,41394,20997,7970,21899,42896,22445,43512
,LvYiZhen,371625107,32540,4275,22270,14284,44036,22167,8028,22317,44484,22573,44843
,ChunHuaZhen,371625108,16809,2445,11589,8000,22072,11564,3818,11334,22898,11483,23072
Ӽ,PangJiaZhen,371625109,17746,3125,12674,8037,23965,12570,3967,12057,24627,12164,24838
ׯ,QiaoZhuangZhen,371625110,22330,3533,15236,9684,29669,15178,4451,14976,30154,15078,30314
Ϫֵ,DaiXiJieDao,371626001,62737,6715,41361,25066,58519,37595,12464,36712,74307,40555,81916
ɽֵ,HuangShanJieDao,371626002,37142,3720,24153,13211,29682,21513,7343,20846,42359,24052,48205
½ֵ,GaoXinJieDao,371626003,80535,4176,46390,24218,38982,37488,13838,37091,74579,52159,98549
ֵ,HaoShengJieDao,371626004,25076,3309,16716,10239,28629,16170,5158,15911,32081,16827,33543
ɽ,ChangShanZhen,371626101,49837,7857,33519,21023,63945,32644,10171,32680,65324,34346,67865
κ,WeiQiaoZhen,371626102,68131,7462,45519,25912,78251,43028,14712,42405,85433,44786,90305
,XiDongZhen,371626103,26648,4189,17856,10902,35353,17645,5155,17770,35415,18136,35992
ٳ,LinChiZhen,371626105,21183,3500,14031,10120,24719,13709,4119,13711,27420,14771,28802
,JiaoQiaoZhen,371626108,26211,4232,17924,11065,35003,17601,5740,17541,35142,18259,36183
,HanDianZhen,371626109,29649,3764,20383,11581,38114,20325,6720,19533,39858,19750,40133
,SunZhenZhen,371626110,26057,4048,18195,10889,36093,18138,6251,18086,36224,18161,36356
Ż,JiuHuZhen,371626111,27749,4267,19694,10923,38639,19497,6905,18965,38462,19227,38921
,QingYangZhen,371626112,26048,3111,17090,9222,33642,16966,5785,17593,34559,17854,34944
,MingJiZhen,371626113,25440,3801,17683,9928,34262,17082,6046,16772,33854,17604,35287
̨,TaiZiZhen,371626114,20816,3627,15205,9464,29571,15176,5567,14738,29914,14805,30010
ͷ,MaTouZhen,371626115,30530,4588,20709,12617,41107,20619,6648,20715,41334,21057,41766
ǽֵ,DongChengJieDao,371702001,55057,4559,35324,21225,57282,34220,11842,35300,69520,36134,71458
ǽֵ,XiChengJieDao,371702002,45454,3847,29433,15680,35107,25435,8830,25386,50821,28698,58131
ϳǽֵ,NanChengJieDao,371702003,49982,4650,30656,18322,53787,29532,9944,30034,59566,33920,64576
ǽֵ,BeiChengJieDao,371702004,38150,3648,24316,13337,35202,22021,7485,22400,44421,24967,49283
ĵֵ,MuDanJieDao,371702005,44018,5271,30203,15562,59096,30100,11776,30807,60907,30862,61065
ֵ,DanYangJieDao,371702006,78221,6885,50799,30970,71126,49099,16560,49933,99032,50867,101666
ֵ̽,YueChengJieDao,371702007,43836,5024,29122,16337,55778,28349,10084,28630,56979,29822,58944
軧ͽֵ,DianHuTunJieDaoBan,371702008,32759,3659,22021,13117,43524,22020,8202,22593,44613,22599,44620
¥ֵ,HeLouJieDao,371702009,51409,6069,34583,18321,69511,34567,12879,35734,70301,35774,70357
򸣽ֵ,WanFuJieDao,371702010,32758,3785,22159,11342,42668,21488,7994,21892,43380,22378,44537
ɳ,ShaTuZhen,371702100,59027,7761,41846,23046,83331,41815,18218,43086,84901,43160,85006
,WuDianZhen,371702101,35100,4104,23990,13265,48431,23986,9366,24566,48552,24580,48570
,WangHaoTunZhen,371702102,32542,4684,23840,14205,47676,23771,11004,24283,48054,24390,48230
ƈ,HuangGangZhen,371702103,45325,6469,33368,18513,64618,33368,14356,32780,66148,32782,66150
˾,DouSiZhen,371702104,21573,3423,15958,9858,31350,15957,6445,15483,31440,15483,31441
ׯ,GaoZhuangZhen,371702105,40238,5172,27893,15699,56184,27893,11066,28583,56476,28583,56476
С,XiaoLiuZhen,371702106,33270,4412,23443,13560,47436,23435,9918,24136,47571,24157,47600
,LiCunZhen,371702107,36047,5140,27308,15325,52345,27307,11681,25554,52861,25560,52868
,MaLingGangZhen,371702108,59100,8088,41969,23548,84422,41897,17919,42889,84786,43138,85107
,AnXingZhen,371702109,27845,4203,20754,11237,39875,20753,8846,20125,40878,20140,40894
Ƽ,DaiHuangJiZhen,371702110,29605,3770,20971,11390,42665,20952,9581,21945,42897,21985,42956
,LvLingZhen,371702111,36966,4893,25880,14769,51502,25868,10108,26075,51943,26087,51967
,HuJiZhen,371702112,24342,3274,16827,9744,34032,16827,6781,17570,34397,17570,34397
,HuangZhenXiang,371702202,21029,3094,15397,8793,30165,15396,6295,15020,30416,15021,30418
ǹؽֵ,ChengGuanJieDao,371721001,67873,6561,43294,16761,68689,28202,13567,28847,57049,44707,88001
ʯֵ,PanShiJieDao,371721002,67534,5915,44196,19531,60937,33095,15846,34250,67345,45099,89295
ʰ´,QingHeBanShiChu,371721003,43635,5038,30576,16908,59560,28718,14187,30375,59093,32284,62860
ׯկ,ZhuangZhaiZhen,371721101,46213,5008,32509,17433,65399,31380,17323,34283,65663,36035,68544
,PuLianJiZhen,371721102,22508,3143,17497,10204,33271,17361,8263,16230,33591,16417,33914
̼,QingGuJiZhen,371721103,57291,8525,42300,23548,81942,41223,18621,40483,81706,42137,84437
Դ,TaoYuanJiZhen,371721104,46644,5318,33353,18630,68082,32634,16880,34262,66896,35489,68842
,HanJiZhen,371721105,33203,4546,24082,14723,48015,23720,10873,24077,47797,24540,48622
ש,ZhuanMiaoZhen,371721106,22561,2717,15770,9333,31364,15399,7081,16017,31416,16589,32359
Ӫ,GuYingJiZhen,371721107,48774,6639,36436,21811,71603,36008,17394,35589,71597,36371,72807
κ,WeiWanZhen,371721108,38341,5085,29145,18034,57342,28913,16235,30070,58983,30516,59661
,HouJiHuiZu,371721109,22557,3636,17721,10747,34073,17571,8505,16771,34342,16977,34698
ռ,SuJiZhen,371721110,44824,7762,35296,22136,66661,35072,15912,32841,67913,33202,68498
ϼ,SunLaoJiaZhen,371721111,29638,4696,22644,12535,43465,21582,10004,20064,41646,21694,44338
ֵ¥,YanDianLouZhen,371721112,32316,4698,24054,13530,47344,22919,11132,22281,45200,24092,48146
ͷ,LiangDiTouZhen,371721113,26153,4060,19195,10566,37595,18990,8027,18717,37707,19045,38240
¥,AnCaiLouZhen,371721114,33156,5254,25266,15750,48299,24854,11844,24336,49190,24988,50254
ׯ,CaoXianShaoZhuang,371721115,32412,4695,23402,12643,46461,23028,10013,23032,46060,23718,47120
,CaoXianWangJi,371721116,18793,3207,14631,9478,28343,14208,6718,13313,27521,14087,28718
,CaoXianQingGang,371721117,29523,5121,23413,15354,44530,22953,11231,21634,44587,22462,45875
֣ׯ,CaoXianZhengZhuang,371721118,35497,4970,25226,12811,50159,24144,10261,23838,47982,25502,50728
س,CaoXianChangLe,371721201,25165,3185,18520,11989,36391,18520,9362,19187,37707,19192,37712
߼,CaoXianNiJi,371721202,25819,3440,18891,11613,36713,18662,8629,18564,37226,18997,37888
¥ׯ,CaoXianLouZhuang,371721203,22084,2567,16596,9524,32081,16596,8877,16932,33528,16932,33528
ش,CaoXianDaJi,371721206,23676,3790,17770,9729,34912,17763,7724,17375,35138,17420,35190
,CaoXianZhuHong,371721207,17786,2737,12833,6991,25735,12833,5374,13064,25897,13064,25897
¥,CaoXianWuLou,371721208,19188,3533,15236,9390,29033,15227,6782,14250,29477,14267,29503
ǽֵ,BeiChengJieDao,371722001,47194,5363,28723,13438,46619,21740,7567,22776,44516,31401,60124
ϳǽֵ,NanChengJieDao,371722002,72286,6195,42551,23366,66082,37277,12535,38909,76186,48465,91016
԰սֵ,YuanYiJieDao,371722003,38862,1881,22553,6726,17896,10772,4066,10947,21719,22256,44809
ǽֵ,DongChengJieDao,371722004,18991,2519,12652,8165,25306,12607,4595,12968,25575,13453,26105
,GuoCunZhen,371722101,45690,6695,32762,19179,59349,30341,12210,29498,59839,31833,64595
Ƹ,HuangGangZhen,371722102,46226,7289,33078,20059,64696,32805,13025,32258,65063,33462,66540
,ZhongXingZhen,371722103,45916,8088,32943,20279,65369,32271,11955,31886,64157,33016,65959
Τׯ,GaoWeiZhuangZhen,371722105,26091,3938,18746,10216,36398,18376,7721,17917,36293,19004,37750
կ,XuZhaiZhen,371722106,42061,6062,28679,17878,56187,28186,9930,28498,56684,29374,58053
,CaiTangZhen,371722107,28789,4890,21849,14035,40832,21845,8781,20604,42449,20611,42460
켯,ZhuJiZhen,371722108,19471,3594,14370,9159,27445,14116,5389,13654,27770,14084,28454
ׯ,LiXinZhuangZhen,371722109,24155,3739,16849,11276,33042,16808,6116,16665,33473,17161,34010
,FuGangZhen,371722110,37965,6472,27594,14686,54636,27594,10655,27498,55092,27498,55092
,LaiHeZhen,371722111,33695,4721,23514,14229,46242,23106,8986,23181,46287,23888,47402
ʱ¥,ShiLouZhen,371722112,25971,4439,18153,11503,35948,18119,6688,18026,36145,18945,37098
¥,YangLouZhen,371722113,29570,5126,21666,13299,42896,21091,8740,20414,41505,21770,43436
ż,ZhangJiZhen,371722114,28139,4874,20347,13606,40555,20344,7642,20295,40639,20308,40655
,LongWangMiaoZhen,371722115,34058,5044,24212,13808,46746,23636,8983,23426,47062,23873,48085
л,XieJiZhen,371722116,37404,5578,26010,15752,50102,25495,8975,25171,50666,25947,51957
¥,LiTianLouZhen,371722117,30415,5031,21302,13234,41631,20584,7621,20852,41436,21765,43067
ϼ,GaoLaoJiaXiang,371722201,35746,5899,26608,16631,51058,26372,10814,25437,51809,25851,52459
ׯ,CaoZhuangXiang,371722202,16191,3026,12230,7341,23343,12060,4900,11654,23714,11887,24117
ֵͤ,WenTingJieDao,371723001,33642,3840,22241,12202,37833,20604,7954,20949,41553,23195,45436
ֵ,YongChangJieDao,371723002,44019,4416,29543,15666,46538,25823,10137,26338,52161,29029,58572
Ｏ,DaTianJiZhen,371723101,49923,6950,34951,22195,71075,34951,15070,36991,71942,36992,71943
칬,TianGongMiaoZhen,371723102,26601,3687,19415,10609,37569,19414,8062,18934,38348,18935,38350
ϼ,WenShangJiZhen,371723103,41248,6079,31389,20039,60327,31376,14265,30130,61506,30203,61592
³,NanLuJiZhen,371723104,28021,3845,20362,12156,40737,20362,9202,20706,41068,20706,41068
ּ,BoLeJiZhen,371723105,34004,4756,24737,14362,48650,24729,10757,24769,49498,24780,49517
弯,GouCunJiZhen,371723106,24780,3268,17426,11064,34493,17421,7140,17756,35177,17762,35188
׸ͼ,BaiFuTuZhen,371723107,29620,3957,20584,12387,41230,20579,8534,21491,42070,21527,42111
,SunSiZhen,371723108,33740,4889,24759,14250,48495,24711,10174,23943,48654,24044,48803
Ů,JiuNvJiZhen,371723109,38259,5790,28537,17516,55485,28532,11992,27490,56022,27504,56041
,DangJiZhen,371723110,22966,3333,16195,10074,32230,16195,6258,16361,32556,16362,32557
¥,ZhangLouZhen,371723111,21007,2905,15224,10060,30270,15224,6926,15614,30838,15614,30838
˽ֵ,FengHuangJieDao,371724001,50541,4564,31923,13977,51772,22400,9934,23053,45453,33116,65039
ֵ,YongFengJieDao,371724002,68011,7657,44754,22674,80433,33978,16450,34385,68363,47364,92118
,LongGuZhen,371724101,36700,5902,26790,18165,51559,26290,12351,25968,52258,28163,54953
,DaYiZhen,371724102,41584,6743,31634,20688,60787,30699,13215,28357,59056,29908,61542
,LiuLinZhen,371724103,32920,6021,26648,17314,49339,26264,11966,23373,49637,24259,50907
·,ZhangFengZhen,371724104,23506,4190,18074,12501,34691,17496,7907,16370,33866,17529,35603
л,DaXieJiZhen,371724105,39603,4971,27473,16732,55374,26920,12501,28355,55275,29602,57075
ɽ,DuShanZhen,371724106,36420,5797,27526,18325,54042,27117,12922,26690,53807,27613,55139
,QiLinZhen,371724107,37077,6191,28560,19096,54497,27794,12879,25865,53659,27587,56147
԰,HeTaoYuanZhen,371724108,18658,2863,13450,8977,26428,13357,5967,13855,27212,14038,27488
ׯ,TianZhuangZhen,371724109,31926,5433,23553,14948,45770,23020,9671,22323,45343,23477,47030
̫ƽ,TaiPingZhen,371724110,29041,4421,20523,13377,41835,20233,8990,21612,41845,21929,42452
,WanFengZhen,371724111,39820,6267,29837,19968,58197,29228,12947,27843,57071,29197,59034
,TaoMiaoZhen,371724112,23875,3273,17154,10641,34552,16910,8391,17912,34822,18385,35539
,DongGuanTunZhen,371724113,33541,6030,26066,17276,49518,25639,10845,23238,48877,24350,50416
,TianQiaoZhen,371724114,25310,3708,18003,11576,34684,17592,7633,17865,35457,18648,36651
Ӫ,YingLiZhen,371724115,21958,3877,16529,11224,32784,16222,7613,16137,32359,16919,33448
۩ݽֵ,YunZhouJieDao,371725001,99959,10395,63219,32387,99919,49257,22382,52768,102025,69517,132736
ֵ,TangTaJieDao,371725002,38737,4365,25379,14149,50421,21607,10043,23068,44675,27766,53145
ư,HuangAnZhen,371725101,38780,5473,26894,18680,54948,26893,11914,29268,56161,29273,56167
ׯ,YangZhuangJiZhen,371725102,32196,6078,25429,15961,48847,25416,11771,24565,49981,24616,50045
ʼ,HouYanJiZhen,371725103,35214,6795,27594,19380,52806,26833,12249,25373,52206,26664,54258
䰲,WuAnZhen,371725104,44164,7162,30135,18369,61146,29262,12319,30480,59742,33510,63645
,GuoTunZhen,371725105,21649,3863,16081,10562,31051,15846,7509,15595,31441,16940,33021
ﳤ,DingLiChangZhen,371725106,24458,4313,18534,12183,35064,18215,8104,17796,36011,18341,36875
,YuHuangMiaoZhen,371725107,30112,5567,23557,16591,44214,22481,11030,20881,43362,23152,46709
,ChengTunZhen,371725108,28553,5615,22881,15569,43893,21965,10084,20206,42171,21371,44252
,SuiGuanTunZhen,371725109,31720,5604,23852,15727,45309,22312,11038,21722,44034,24510,48362
Ӫ,ZhangYingZhen,371725110,34407,5932,26080,15588,49627,25820,11881,24520,50340,26140,52220
˶,PanDuZhen,371725111,28468,5710,23489,16595,43991,22443,11268,20270,42713,21957,45446
˫,ShuangQiaoZhen,371725112,30900,6025,23989,16148,47152,23320,11123,22620,45940,24059,48048
¥,NanZhaoLouZhen,371725113,23576,3595,16578,10934,32104,15954,7880,15784,31738,18473,35051
ƶѼ,HuangDuiJiZhen,371725114,21734,4029,17474,11491,33929,16885,8693,16179,33064,16982,34456
,TangMiaoXiang,371725201,30426,5012,22823,15551,45456,22814,11525,24129,46943,24140,46963
Ƽ,HuangJiXiang,371725205,25263,4785,19607,14111,38168,19607,8690,19131,38738,19131,38738
,LiJiXiang,371725206,30199,4873,23167,14700,44118,23162,10524,22393,45555,22429,45596
³,ZhangLuJiXiang,371725207,19283,4335,16860,13220,31320,16857,8621,15362,32219,15379,32239
ˮ,ShuiBaoXiang,371725208,11688,2411,10292,7381,19150,10221,5489,9113,19334,9296,19588
,ChenPoXiang,371725209,14541,2933,11745,9412,22894,11661,5656,11216,22877,11385,23130
ֵ,ChenWangJieDao,371726001,22546,1731,14891,7168,21693,11808,5459,11939,23747,14845,29736
Ȫֵ,GuQuanJieDao,371726002,60090,6694,40189,22960,67331,36183,15478,36736,72919,42073,82262
ʲ,ShenJiZhen,371726101,37710,5096,26464,17194,53738,26287,11218,27131,53418,27560,54024
촬,HongChuanZhen,371726102,19935,4018,14817,10460,30286,14299,6401,14364,28663,15537,30354
ɳ,JiuChengZhen,371726103,37015,5987,27587,15962,54952,27513,12026,27311,54824,27441,55028
ʲ,YanShenZhen,371726104,33792,5190,24402,16097,49202,24188,10436,24530,48718,25016,49418
ɽ,JiShanZhen,371726105,29628,5281,23898,15125,46523,23814,11688,22499,46313,22699,46597
ʿ,LiJinShiTangZhen,371726106,16811,2799,12192,7476,24531,12182,4979,12332,24514,12397,24589
,DongKouZhen,371726107,35712,5783,26710,15892,53085,26432,11784,25786,52218,26569,53279
,LinPuZhen,371726108,22616,3365,16631,10351,32323,16630,6744,16087,32717,16094,32725
¥,PengLouZhen,371726109,36087,5947,26506,17385,52319,26503,10507,26008,52511,26035,52541
,FengHuangZhen,371726110,23163,3699,17410,10927,34328,17273,7896,17073,34346,17348,34758
֣Ӫ,ZhengYingZhen,371726111,34095,4868,24419,15338,50165,24347,11483,25870,50217,26027,50446
Ӫ,ZuoYingXiang,371726200,26933,4655,19905,12604,40101,19560,8632,19588,39148,20315,40220
,DaNianXiang,371726201,18044,3234,13538,8564,26806,13484,5625,13230,26714,13365,26903
,YinMaXiang,371726202,17400,3281,13993,10513,27508,13946,6927,13334,27280,13615,27608
,FuChunXiang,371726207,21168,3055,15639,9929,31168,15583,7187,15724,31307,15771,31410
нֵ,TianZhongJieDao,371727001,42044,4630,27519,15671,49620,25492,9821,26645,52137,28976,56495
ӽֵ,BinHeJieDao,371727002,42709,4977,28557,16167,52336,26485,10223,27258,53743,29352,57909
¼,ChenJiZhen,371727101,42005,5672,28410,16759,57060,26856,10264,26962,53818,29531,57941
Ƚ,RanGuZhen,371727102,51874,8376,36466,22037,75031,35020,15013,36504,71524,38797,75263
,ZhangWanZhen,371727103,31479,4860,22174,13870,44710,21588,8636,21910,43498,22801,44975
Ƶ,HuangDianZhen,371727104,41000,6608,30687,20690,59804,30684,13232,30143,60827,30153,60840
Ϻ,MengHaiZhen,371727105,24387,3802,17944,11662,34795,17887,7112,17275,35162,17357,35301
�,MaJiZhen,371727106,31382,5105,22388,14612,45184,21544,8817,21497,43041,22916,45304
ɽ,FangShanZhen,371727107,32098,4537,23042,14406,46366,22367,10004,22609,44976,23597,46639
,BanDiZhen,371727108,24703,3515,17355,10799,34204,17004,6155,16470,33474,17018,34373
,NanWangDianXiang,371727202,16538,2900,12582,9052,24028,12568,5076,11893,24461,11932,24514
,DuTangXiang,371727204,17757,2925,13312,9334,25811,13310,5557,12926,26236,12927,26239
ǹؽֵ,ChengGuanJieDao,371728001,67799,6313,44581,24572,79611,41845,18493,44122,85967,48024,92605
ֵֽ,YuWoJieDao,371728002,24764,2942,17068,9362,34940,17068,8012,18650,35718,18650,35718
,DongMingJiZhen,371728101,36548,4243,25645,13381,52755,25612,12341,27394,53006,27487,53132
¥,LiuLouZhen,371728102,28142,3676,21431,11389,41008,21374,10620,20843,42217,21007,42438
½Ȧ,LuQuanZhen,371728103,51577,6720,36993,22095,68402,36894,16709,37512,74406,38013,75006
ͷ,MaTouZhen,371728104,24809,2899,18322,10282,36263,18223,9957,19080,37303,19343,37665
,SanChunJiZhen,371728105,23835,2766,18068,9604,35803,18068,10091,18624,36692,18624,36692
,DaTunZhen,371728106,27079,3398,19785,12005,39489,19697,10036,20495,40192,20728,40513
ʤ,WuShengQiaoZhen,371728107,30183,4012,22053,12772,43458,22031,9617,21655,43686,21759,43812
԰,CaiYuanJiXiang,371728201,29036,3547,20773,10648,41081,20771,9216,21014,41785,21026,41799
С,XiaoJingXiang,371728202,29199,4111,22155,13053,44463,21698,11821,22090,43788,22976,45131
ɳ,ShaWoXiang,371728203,42497,5282,31977,16996,61784,31958,15759,31475,63433,31561,63538
˼,ChangXingJiXiang,371728204,40242,5334,29382,14146,57648,29240,14276,30117,59357,30470,59852
԰,JiaoYuanXiang,371728205,28237,3536,21464,11246,42790,21443,11406,21629,43072,21715,43179
ɽկֵ´,LinShanZhaiJieDaoBanShiChu,410102001,50944,6604,29715,17106,42208,25554,7670,24325,49879,35503,65218
·ֵ´,JianSheLuJieDaoBanShiChu,410102002,30249,3428,18917,9478,22681,13687,3790,12983,26670,18550,37467
޷·ֵ´,MianFangLuJieDaoBanShiChu,410102003,27088,6371,19371,13399,29762,19060,3476,17497,36557,17564,36935
·ֵ´,QinLingLuJieDaoBanShiChu,410102004,23645,4272,16040,11762,20130,15891,3702,15015,30906,15579,31619
ͩ·ֵ´,TongBaiLuJieDaoBanShiChu,410102005,66988,7310,44049,31187,52346,43642,14354,43371,87013,44603,88652
ֵ´,SanGuanMiaoJieDaoBanShiChu,410102006,42033,5237,27601,18378,31965,25578,7281,24912,50490,26950,54551
̶ֵ´,LvDongCunJieDaoBanShiChu,410102007,47486,6630,30924,21063,36418,29111,8652,28482,57593,31844,62768
·ֵ´,RuHeLuJieDaoBanShiChu,410102008,70177,6759,45238,33169,47093,44273,14146,44162,88435,45844,91082
·ֵ´,HangHaiXiLuJieDaoBanShiChu,410102009,57847,2325,34964,25681,21849,30969,12055,33670,64639,37263,72227
ԭ·ֵ´,ZhongYuanXiLuJieDaoBanShiChu,410102010,27038,1917,16339,13266,13962,15729,5056,16913,32642,17672,34011
ֵ´,XiLiuHuJieDaoBanShiChu,410102011,64230,3805,38150,21520,31757,30277,12056,32091,62368,41941,80091
ˮֵ´,XuShuiJieDaoBanShiChu,410102012,34970,3088,21571,10798,29772,18538,6196,18779,37317,22683,44254
ʯ,ShiFoZhen,410102160,131101,4631,70381,35112,57839,46120,17590,50620,96740,82941,153322
,GouZhaoXiang,410102360,40620,3863,26885,13226,44423,24419,8811,23710,48129,26409,53294
·ֵ´,HuaiHeLuJieDaoBanShiChu,410103001,41821,4769,27525,17526,35183,25112,7294,24693,49805,26359,53884
·ֵ´,JieFangLuJieDaoBanShiChu,410103002,384,32,192,138,142,156,53,178,334,277,469
·ֵ´,MingGongLuJieDaoBanShiChu,410103003,18223,1798,11649,8318,10321,11260,3369,11202,22462,11741,23390
һ·ֵ´,YiMaLuJieDaoBanShiChu,410103004,2913,331,1716,913,1060,1203,278,1152,2355,1806,3522
۷Žֵ´,MiFengZhangJieDaoBanShiChu,410103005,19490,3062,12869,8423,18180,12159,2891,11679,23838,12574,25443
ﱤֵ´,WuLiBaoJieDaoBanShiChu,410103006,47080,6323,32090,22298,40413,30148,7773,27532,57680,29086,61176
ѧ·ֵ´,DaXueLuJieDaoBanShiChu,410103007,42986,5807,27746,16327,35538,23791,6307,22082,45873,27354,55100
нֵֽ´,JianZhongJieJieDaoBanShiChu,410103008,54804,6372,35358,21500,41623,30957,8685,29558,60515,34503,69861
ֵֽ´,FuHuaJieJieDaoBanShiChu,410103009,52984,7658,35082,24785,46521,34943,8983,34335,69278,34543,69625
»ֵֽ´,DeHuaJieJieDaoBanShiChu,410103010,2959,200,1849,1237,1078,1671,482,1611,3282,1792,3641
ɽ·ֵ´,SongShanLuJieDaoBanShiChu,410103011,57375,3675,36373,23540,34609,33627,13503,34504,68131,38180,74553
·ֵ´,JingGuangLuJieDaoBanShiChu,410103012,49083,2092,28596,12291,18471,18139,7054,18349,36488,29633,58229
·ֵ´,ChangJiangLuJieDaoBanShiChu,410103013,67971,2437,39954,29748,21409,34459,12643,36178,70637,43097,83051
կ,MaZhaiZhen,410103100,40060,2193,22247,6802,21901,12499,4434,12849,25348,24440,46687
կ,HouZhaiXiang,410103201,67651,4238,36135,15666,49904,29391,12126,30506,59897,47880,84015
½ֵֽ´,BeiXiaJieJieDaoBanShiChu,410104001,26154,2616,16477,10755,17061,15105,3935,14045,29150,16228,32705
ֵֽ´,XiDaJieJieDaoBanShiChu,410104002,17991,1499,11626,7616,9569,10516,3388,10284,20800,11252,22878
Ϲؽֵ´,NanGuanJieDaoBanShiChu,410104003,45732,3556,29790,19836,24200,27269,8199,26287,53556,27697,57487
Ƕ·ֵ´,ChengDongLuJieDaoBanShiChu,410104004,28284,2683,18793,12849,18295,18250,5637,16987,35237,17811,36604
ֵֽ´,DongDaJieJieDaoBanShiChu,410104005,26549,2490,16711,11085,15019,14640,4454,14222,28862,16782,33493
ڽֵ´,ErLiGangJieDaoBanShiChu,410104006,31786,2500,19929,14646,19072,19309,6464,19867,39176,20821,40750
¤·ֵ´,LongHaiLuJieDaoBanShiChu,410104007,37528,4316,24965,16656,29274,24102,7055,23142,47244,23934,48899
Ͼɽ·ֵ´,ZiJingShanNanLuJieDaoBanShiChu,410104008,55926,3463,35386,24002,25255,34174,13703,35966,70140,37706,73092
·ֵ´,HangHaiDongLuJieDaoBanShiChu,410104009,40488,1570,26550,16577,25097,23810,9912,23957,47767,25420,51970
ʮ,ShiBaLiHeZhen,410104100,36746,2170,21316,13030,26132,19137,8547,22063,41200,26147,47463
ϲ,NanCaoXiang,410104201,29670,2714,19315,10187,31751,18631,8441,19954,38585,21510,40825
,PuTianXiang,410104202,43514,2122,22306,13271,20013,20353,9495,22279,42632,32825,55131
ü�ֵ´,JingJiJiShuKaiFaQuMingHuJieDaoBanShiChu,410104560,54511,1751,28439,20204,20420,23281,9824,27068,50349,37647,66086
ü�ӽֵ´,JingJiJiShuKaiFaQuChaoHeJieDaoBanShiChu,410104561,14868,1495,9751,4315,17639,9094,4416,9424,18518,11028,20779
ü��ֵ´,JingJiJiShuKaiFaQuJingHangJieDaoBanShiChu,410104562,12893,1217,8030,3631,14594,7416,3660,8012,15428,9740,17770
·ֵ´,JingBaLuJieDaoBanShiChu,410105001,58410,9715,41221,26108,55708,39105,11087,36459,75564,37991,79212
԰·ֵ´,HuaYuanLuJieDaoBanShiChu,410105002,30965,5896,22233,14084,31274,21667,5975,20080,41747,20603,42836
·ֵ´,RenMinLuJieDaoBanShiChu,410105003,28202,4858,19539,12989,27995,19003,4756,17792,36795,18277,37816
ֵֽ´,DuLingJieJieDaoBanShiChu,410105004,13809,1537,9972,5142,8662,7281,1993,6882,14163,7367,17339
ʯŽֵ´,DaShiQiaoJieDaoBanShiChu,410105005,28328,3449,19411,12582,24072,18228,5868,17151,35379,18234,37645
·ֵ´,NanYangLuJieDaoBanShiChu,410105006,55317,6940,36238,25036,52273,35939,9722,34997,70936,35741,71979
´ֵ´,NanYangXinCunJieDaoBanShiChu,410105007,80016,8150,52995,35424,66477,51766,17236,50584,102350,52407,105402
Ļ·ֵ´,WenHuaLuJieDaoBanShiChu,410105008,83657,6909,49858,29009,47060,37611,10721,35681,73292,51429,101287
·ֵ´,FengChanLuJieDaoBanShiChu,410105009,112094,7982,67323,53443,54443,59461,16065,59942,119403,68818,136141
·ֵ´,DongFengLuJieDaoBanShiChu,410105010,121003,4566,71133,38419,56068,48971,17783,49537,98508,72219,143352
·ֵ´,BeiLinLuJieDaoBanShiChu,410105011,87312,2890,47096,30614,36051,33146,10309,36362,69508,53415,100511
δ·ֵ´,WeiLaiLuJieDaoBanShiChu,410105012,58314,3783,35275,29234,32423,33629,8751,33955,67584,35573,70848
ֵ̨´,FengHuangTaiJieDaoBanShiChu,410105013,23524,1062,13970,9297,12150,13232,4938,13571,26803,15554,29524
Ӻֵ´,LongZiHuJieDaoBanShiChu,410105014,81181,2323,46624,7592,29926,15581,7277,15357,30938,44157,90781
·ֵ´,JiChengLuJieDaoBanShiChu,410105015,95688,5696,57719,35847,68893,54567,23154,55234,109801,66819,124538
,LiuLinZhen,410105101,156212,3946,84561,84787,48143,74143,22851,86801,160944,98448,183009
,MiaoLiZhen,410105102,190629,3319,100452,79847,40463,73585,22548,82337,155922,116044,216496
Դ·ֵ´,JiYuanLuJieDaoBanShiChu,410106001,29972,3815,19868,13897,25691,19124,5519,18685,37809,19438,39306
·ֵ´,ZhongXinLuJieDaoBanShiChu,410106002,25634,3117,17304,12345,21716,17275,5504,16884,34159,16951,34255
°·ֵ´,XinAnLuJieDaoBanShiChu,410106003,9205,1953,6421,4975,8227,6386,1790,6334,12720,6527,12948
ҵ·ֵ´,GongYeLuJieDaoBanShiChu,410106004,4174,591,2846,1510,5107,2810,719,2561,5371,2638,5484
ɽֵ´,KuangShanJieDaoBanShiChu,410106005,1409,282,962,800,1591,961,200,918,1879,929,1891
Ͽ,XiaWoZhen,410106100,28193,3821,18872,10700,31821,18721,5651,18266,36987,18793,37665
³ǽֵ´,XinChengJieDaoBanShiChu,410108001,23100,2292,14780,7894,25626,14411,5376,14238,28649,15988,30768
կֵ´,LiuZhaiJieDaoBanShiChu,410108002,31214,2106,19910,15589,17227,19772,6596,19790,39562,20006,39916
ѻ½ֵ´,LaoYaChenJieDaoBanShiChu,410108003,15359,1561,10132,5138,17231,9657,3305,9665,19322,10093,20225
·ֵ´,ChangXingLuJieDaoBanShiChu,410108004,48711,2045,27263,21797,20558,24501,9849,28167,52668,33342,60605
ӭ·ֵ´,YingBinLuJieDaoBanShiChu,410108005,42418,1572,29887,6004,15043,10221,4252,10127,20348,18355,48242
·ֵ´,DaHeLuJieDaoBanShiChu,410108006,13935,1558,9120,5009,16981,8735,2928,8612,17347,9301,18421
԰,HuaYuanKouZhen,410108100,15465,1582,10414,5185,18002,9956,4212,9983,19939,10845,21259
,GuYingZhen,410108101,23672,2380,15507,7334,25815,13307,4091,13102,26409,14636,30143
·ֵ´,QingNianLuJieDaoBanShiChu,410122001,55372,3976,35158,16495,42069,26256,10931,26716,52972,35121,70279
·ֵ´,DongFengLuJieDaoBanShiChu,410122002,32736,2495,21654,12651,30261,20567,10093,21458,42025,23670,45324
ݽֵֽ´,GuangHuiJieJieDaoBanShiChu,410122003,23850,1679,14382,5414,20122,10604,5146,10998,21602,16293,30675
,HanSiZhen,410122101,24097,2383,16850,8697,34431,16849,8712,18338,35187,18342,35192
ٶ,GuanDuZhen,410122102,35131,4068,25754,13699,51218,25742,13112,26537,52279,26557,52311
ǳǸ,LangChengGangZhen,410122103,25713,2999,18648,9062,36835,18647,9286,19346,37993,19350,37998
̲,WanTanZhen,410122104,17908,2173,12695,6372,25959,12692,6185,13567,26259,13571,26266
ɳ,BaiShaZhen,410122105,29218,3201,20399,9985,38205,19829,10282,20723,40552,22302,42701
֣,ZhengAnZhen,410122106,21432,2998,15795,8470,31187,15789,7884,16478,32267,16519,32314
ׯ,ZhangZhuangZhen,410122108,20838,2871,15016,7652,30687,15005,7343,16000,31005,16036,31052
Ƶ,HuangDianZhen,410122109,24374,3584,17806,9512,36202,17806,8485,18637,36443,18637,36443
,DaMengZhen,410122110,31208,3912,22695,11453,45748,22689,11550,23945,46634,23975,46670
,JiuLongZhen,410122111,20962,2871,15170,7872,29972,15066,7927,16211,31277,16590,31760
,LiuJiZhen,410122112,27365,3267,19577,9819,39865,19512,9983,20797,40309,21038,40615
˸,BaGangZhen,410122113,18463,2699,13241,6689,27069,13241,6401,14322,27563,14322,27563
,YanMingHuZhen,410122114,15936,2021,11289,5489,22803,11284,5471,12129,23413,12139,23428
,SanGuanMiaoXiang,410122206,35477,5649,26466,13698,52956,26446,12525,27119,53565,27185,53651
,DiaoJiaXiang,410122208,21018,3017,15849,8172,31597,15809,8305,16486,32295,16491,32340
Ҧ,YaoJiaXiang,410122209,21078,2695,14665,7640,30236,14663,7085,16184,30847,16193,30858
»·ֵ´,XinHuaLuJieDaoBanShiChu,410181001,39650,3167,25636,15644,35371,24697,8156,24147,48844,25337,50973
Ÿ·ֵ´,DuFuLuJieDaoBanShiChu,410181002,44867,3363,28565,15802,41295,26947,8890,26640,53587,28555,57120
·ֵ´,YongAnLuJieDaoBanShiChu,410181003,1883,252,1292,700,2387,1292,515,1358,2650,1358,2650
Тֵ´,XiaoYiJieDaoBanShiChu,410181004,33947,3376,21201,10841,34260,19419,5706,19240,38659,21828,43029
Ͼ·ֵ´,ZiJingLuJieDaoBanShiChu,410181005,22655,1223,13996,5064,14063,9039,2864,8679,17718,12746,26742
׺,MiHeZhen,410181100,34233,4428,22583,12946,43005,22211,6934,22637,44848,23012,45595
,XinZhongZhen,410181101,12633,2139,8453,5709,16725,8394,2623,8617,17011,8942,17395
С,XiaoGuanZhen,410181102,23818,3377,15917,9506,29042,15160,4619,15127,30287,15897,31814
,ZhuLinZhen,410181103,7779,1017,5263,3024,9476,5233,1645,5096,10329,5178,10441
,DaYuGouZhen,410181104,26677,3696,16560,10866,30280,16420,5362,16791,33211,19175,35735
,HeLuoZhen,410181105,22201,3935,15065,9639,28476,14973,4357,15003,29976,15428,30493
վ,ZhanJieZhen,410181106,17456,2329,11428,6545,20819,10992,2972,10844,21836,11329,22757
,KangDianZhen,410181108,32319,5015,21583,11539,41893,21511,6284,21807,43318,22035,43618
ɽ,BeiShanKouZhen,410181110,27478,3111,18023,8609,30703,16339,5910,16273,32612,18476,36499
,XiCunZhen,410181111,43139,5378,28635,14311,55175,27972,9953,28302,56274,29835,58470
֥,ZhiTianZhen,410181112,35027,4137,23129,11434,44454,22733,7740,23489,46222,23775,46904
ع,HuiGuoZhen,410181113,88954,9080,53782,21744,87728,49667,15776,51737,101404,60028,113810
³ׯ,LuZhuangZhen,410181114,46677,6285,31331,15912,62386,31114,11146,32396,63510,32777,64108
н,JiaJinKouZhen,410181115,18213,2221,11838,6506,21612,11766,4286,11860,23626,12882,24720
,SheCunZhen,410181116,26202,3350,18034,10708,34958,17960,6911,18294,36254,18429,36463
ԥҵ԰ί,YuLianGongYeYuanQuGuanWeiHui,410181400,6908,633,4242,2214,6995,3931,1034,3708,7639,4333,8575
ӽֵ´,SuoHeJieDaoBanShiChu,410182001,43695,3832,28559,17020,31695,26761,9445,26763,53524,28413,56972
ǽֵ´,JingChengJieDaoBanShiChu,410182002,66582,4540,42896,26187,48136,40608,15381,40472,81080,43607,86503
¥,QiaoLouZhen,410182101,29976,3690,19415,10316,35124,17922,5860,18456,36378,20111,39526
ԥ,YuLongZhen,410182102,39112,4288,25313,11998,44968,22758,8385,22902,45660,26472,51785
,GuangWuZhen,410182103,64992,7165,43100,21699,85706,43078,14374,43310,86388,43431,86531
,WangCunZhen,410182104,35872,5374,23811,13962,46973,23805,6642,24016,47821,24077,47888
ˮ,SiShuiZhen,410182105,14337,2584,10006,6046,19227,9948,2777,9627,19575,9692,19698
ɽ,GaoShanZhen,410182106,17449,3299,11854,7564,23313,11849,3093,11983,23832,11987,23841
,LiuHeZhen,410182108,15262,2606,10231,6381,20294,10211,3025,10644,20855,10662,20893
,CuiMiaoZhen,410182109,32402,4457,21266,12243,42550,21004,7332,22104,43108,22925,44191
,JiaYuZhen,410182110,34690,4476,23642,13023,46619,23550,9904,25239,48789,25428,49070
ǹ,ChengGuanXiang,410182200,28749,3444,18710,10092,35972,18657,5677,18958,37615,19160,37870
ߴ,GaoCunXiang,410182201,32842,4944,21785,12925,43176,21781,6218,22206,43987,22219,44004
կ,JinZhaiHuiZuXiang,410182204,3503,511,2519,1364,4831,2519,1018,2511,5030,2513,5032
ֵֽ´,QingPingJieJieDaoBanShiChu,410183001,75280,3709,48635,29618,50539,45741,19129,46590,92331,49483,98118
»·ֵ´,XinHuaLuJieDaoBanShiChu,410183002,39887,2810,23147,14200,30697,21926,8006,22788,44714,27556,50703
ֵֽ´,XiDaJieJieDaoBanShiChu,410183003,19901,1310,11923,4588,17273,8865,3227,8934,17799,12515,24438
ǹ,ChengGuanZhen,410183100,24096,2569,15105,7513,25836,13834,4652,14726,28560,16212,31317
״,MiCunZhen,410183101,24798,2979,16746,8704,32255,16719,6031,17023,33742,17062,33808
ţ,NiuDianZhen,410183102,30931,3811,21665,11402,41929,21663,9187,22256,43919,22264,43929
ƽİ,PingMoZhen,410183103,27542,3303,18399,9537,36317,18373,6477,18849,37222,18923,37322
,ChaoHuaZhen,410183104,47745,6061,32017,16582,63938,31974,12082,33679,65653,33871,65888
,GouTangZhen,410183105,32963,5076,22789,12273,46185,22774,9331,24558,47332,24581,47370
,DaWeiZhen,410183106,39746,5280,26329,13798,52703,26295,9175,27733,54028,27872,54201
կ,LiuZhaiZhen,410183107,31463,3925,20811,10666,39939,19855,7054,20741,40596,21631,42442
կ,BaiZhaiZhen,410183108,39954,5165,27948,13791,55909,27856,12191,29109,56965,29362,57310
,YueCunZhen,410183109,24938,3508,16842,9394,32584,16765,6245,17618,34383,17849,34691
,LaiJiZhen,410183110,36172,4600,23807,12608,46253,22831,8023,24069,46900,24988,48795
Ԭׯ,YuanZhuangXiang,410183200,16202,2105,10910,5898,19593,10458,4021,10986,21444,11418,22328
,QuLiangXiang,410183202,36478,4500,24757,12953,48579,24559,9505,24958,49517,25726,50483
п´,XinMiShiKuangQuBanShiChu,410183400,23759,1513,12702,9204,20055,12437,4744,12953,25390,17314,30016
ɽ羰ίԱ,JianShanFengJingQuGuanLiWeiYuanHui,410183401,5045,1092,3657,2266,7181,3620,1237,3659,7279,3717,7374
֣ҵίԱ,ZhengZhouQuLiangChanYeJiJuQuGuanLiWeiYuanHui,410183402,11850,1390,8161,4091,15939,7934,3483,8300,16234,8562,16723
½·ֵ´,XinJianLuJieDaoBanShiChu,410184001,27066,2200,18005,10552,22323,17064,6839,17207,34271,18100,36105
»·ֵ´,XinHuaLuJieDaoBanShiChu,410184002,48921,3250,29398,16892,47037,27499,10232,28625,56124,33005,62403
ֵ̽´,XinYanJieDaoBanShiChu,410184003,30405,1554,18816,6740,10714,9675,3154,9759,19434,16297,35113
´,XinCunZhen,410184101,42603,2730,26426,8700,30492,15413,6241,16067,31480,25148,51574
,XinDianZhen,410184102,52859,7116,35214,19440,68912,34766,12995,36113,70879,37756,72970
,GuanYinSiZhen,410184103,30660,4302,21096,11854,41861,21084,8141,21930,43014,22007,43103
,LiHeZhen,410184104,21148,2859,14128,8118,27426,14110,4844,14639,28749,14723,28851
ׯ,HeZhuangZhen,410184105,27659,3468,18455,9644,36769,18384,7464,19450,37834,20136,38591
Ѧ,XueDianZhen,410184106,24387,2626,16014,8100,29648,15303,6905,16386,31689,17904,33918
ׯ,MengZhuangZhen,410184107,25185,3034,16922,8126,34342,16795,7070,18154,34949,18367,35289
,GuoDianZhen,410184108,35911,3799,23307,11957,45735,22781,9820,24014,46795,26223,49530
,LongHuZhen,410184109,100968,4710,60401,15505,59313,30427,13475,31911,62338,58752,119153
ǹ,ChengGuanXiang,410184200,21928,2629,14049,7725,27072,13873,4593,14540,28413,15101,29150
ǧ,BaQianXiang,410184202,36378,4196,23450,11180,43625,21947,9008,23545,45492,26132,49582
,LongWangXiang,410184203,14697,2039,10172,5360,20606,10162,4387,10902,21064,10951,21123
¸۰´,XinGangBanShiChu,410184400,28866,3349,18872,9122,36782,17910,7460,19257,37167,20803,39675
֣۰´,ZhengGangBanShiChu,410184401,8448,893,5851,2611,10808,5587,2657,5914,11501,6147,11998
ֵ´,SongYangJieDaoBanShiChu,410185001,83349,4535,52467,27355,81774,48255,20426,48378,96633,55843,108310
ֵֽ´,ShaoLinJieDaoBanShiChu,410185002,28168,1117,9636,3761,14540,7483,3157,7546,15029,22806,32442
ֵ´,ZhongYueJieDaoBanShiChu,410185003,16264,1865,10950,5956,19674,10889,4300,10877,21766,11479,22429
,DaJinDianZhen,410185100,40307,4456,27646,14588,54583,27643,12251,29347,56990,29368,57014
ӱ,YingYangZhen,410185101,32973,3507,23389,11439,46061,23386,10737,23805,47191,23828,47217
¬,LuDianZhen,410185102,18229,1980,12101,6458,22636,11939,4211,12227,24166,12319,24420
,GaoChengZhen,410185103,33589,3321,22691,11872,43533,22059,9313,22816,44875,23532,46223
,YangChengQuZhen,410185104,9440,847,5870,3085,11046,5772,2387,6013,11785,6804,12674
ұ,DaYeZhen,410185105,53234,5777,34608,19705,64839,34228,13182,35362,69590,37585,72193
,XuanHuaZhen,410185106,13872,2040,9988,5841,19335,9902,4542,10244,20146,10466,20454
ׯ,XuZhuangZhen,410185107,19293,2365,13245,7098,26778,13184,6264,14203,27387,14677,27922
,DongHuaZhen,410185108,39453,4112,25621,13228,51250,25543,11611,27231,52774,29555,55176
ƺ,BaiPingXiang,410185202,9343,1167,6605,3628,12908,6582,3110,6922,13504,7015,13620
,JunZhaoXiang,410185203,25678,3017,17453,9260,35045,17445,7561,18466,35911,18803,36256
ʯ,ShiDaoXiang,410185204,27155,3211,19173,9294,37563,18939,8936,19951,38890,20129,39302
ׯ,TangZhuangXiang,410185205,27894,3385,19006,9982,37270,18456,7234,19025,37481,19507,38513
ͱ,SongBiaoKuangQu,410185400,9959,1108,6808,3531,12601,6711,3405,7031,13742,7664,14472
ֵ´,BeiShuDianJieDaoBanShiChu,410202001,8112,1166,5685,3485,8538,5121,1374,4739,9860,4967,10652
糯Žֵ´,WuChaoMenJieDaoBanShiChu,410202002,6386,937,4259,2983,5077,4164,1146,3911,8075,4210,8469
˽ֵ´,DaXingJieDaoBanShiChu,410202003,7753,1349,5312,3702,7826,5050,1185,4819,9869,4975,10287
Žֵ´,BeiDaoMenJieDaoBanShiChu,410202005,14021,2432,9684,6435,14147,8742,1915,8383,17125,8684,18368
,BeiJiaoXiang,410202201,36445,3390,24685,11546,26773,20379,7252,19798,40177,22402,47087
԰,LiuYuanKouXiang,410202202,23510,2574,16269,8050,31377,16268,6837,16651,32919,16652,32921
ƽֵ,QingPingJieDao,410203001,11042,1674,7718,5081,11902,7682,1965,6909,14591,6963,14681
ֵ,TieTaJieDao,410203002,15720,2252,10350,5897,15578,8180,1885,7765,15945,9507,19857
Žֵ,CaoMenJieDao,410203003,10157,1783,7007,4921,11920,6987,1634,6534,13521,6567,13574
Žֵ,SongMenJieDao,410203004,23380,4609,16172,11474,25773,16119,3732,15427,31546,15549,31721
ҵֵ,GongYeJieDao,410203005,34696,6935,24069,17660,39344,23644,5741,22496,46140,23303,47372
ƻ԰ֵ,PingGuoYuanJieDao,410203006,28970,4015,19152,13408,30581,19142,4618,18437,37579,18451,37603
,DongJiaoXiang,410203200,31561,3412,21790,10476,39989,21788,8136,21313,43101,21319,43109
ظ,TuBaiGangXiang,410203201,17729,2001,11865,6174,23342,11849,4649,12481,24330,12514,24379
½ֵ,XiangGuoSiJieDao,410204001,3833,681,2614,1895,4248,2602,503,2391,4993,2403,5017
»ֵ,XinHuaJieDao,410204002,13530,2135,9137,6341,14412,9069,2037,8436,17505,8565,17702
ֵ,WoLongJieDao,410204003,11098,1795,7481,5288,11803,7452,1778,7093,14545,7190,14671
Žֵ,ZhouQiaoJieDao,410204004,16788,2738,11418,7976,15946,11270,2469,10474,21744,10577,21995
˾Žֵ,XiSiMenJieDao,410204005,18043,3682,12845,9114,18510,12406,2831,11482,23888,11711,24556
Էֵ,NanYuanJieDao,410204006,9224,942,6620,3022,12006,6571,2980,6445,13016,6526,13146
һֵ,WuYiJieDao,410204007,25451,3455,17190,12115,21736,17081,4666,16287,33368,16382,33572
ׯֵ,XianRenZhuangJieDao,410204008,8596,906,5953,2994,11941,5838,3014,6353,12191,6563,12516
ﱤֵ,SanLiBaoJieDao,410205001,15602,2759,10807,7885,15816,10713,2456,9948,20661,10010,20817
Źؽֵ,XinMenGuanJieDao,410205002,18331,2509,11984,8618,19342,11972,2933,11746,23718,11789,23773
ֵ,FanTaJieDao,410205003,9730,1809,6641,4774,9819,6641,1588,6483,13124,6486,13127
ٷֵ,GuanFangJieDao,410205004,10632,1746,7277,5407,10994,7096,1628,6650,13746,6729,14006
нֵ,CaiShiJieDao,410205005,11144,1696,7742,5160,12993,7413,2433,7009,14422,7531,15273
Ͻ,NanJiaoXiang,410205200,16395,1742,11230,6801,17391,11203,4167,11024,22227,11074,22304
,WangTunXiang,410205201,15435,1496,10311,5163,20282,10206,4373,10574,20780,10993,21304
ֵ,ChengXiJieDao,410211001,41897,5387,28705,18801,38095,27960,8103,26029,53989,26682,55387
Էֵ,LiangYuanJieDao,410211002,26212,2394,13256,8829,20454,12724,3640,12370,25094,18990,32246
ӻӪ,XingHuaYingZhen,410211100,13856,1296,9920,4868,19975,9858,5421,10490,20348,10653,20573
,XiJiaoXiang,410211201,59943,2106,32340,7824,20800,13600,4662,13266,26866,34371,66711
ˮ,ShuiDaoXiang,410211207,20079,2173,14273,6628,28184,14269,6503,14465,28734,14482,28755
ӻӪũ,XingHuaYingNongChang,410211400,8677,899,6286,3019,12658,6253,3371,6626,12879,6661,12947
,KaiFaQu,410211560,33663,3211,22789,13194,30264,22038,8765,21413,43451,22850,45639
ǹ,ChengGuanZhen,410221100,55936,4115,34709,16231,60580,28853,12600,31206,60059,37942,72651
,WuLiHeZhen,410221101,42128,4043,27486,14120,56937,26766,11067,28996,55762,29752,57238
,FuJiZhen,410221102,36677,3781,25145,13677,51408,25080,11357,26600,51680,26670,51815
,YuZhenZhen,410221103,41059,4649,26560,14658,53597,25236,10283,28149,53385,29431,55991
,GaoYangZhen,410221104,48508,5379,32485,16112,67344,32334,13586,34771,67105,34988,67473
,GeGangZhen,410221105,42564,5174,29358,16804,61164,29358,13686,32066,61424,32066,61424
,YangGuZhen,410221106,30934,3392,21330,11481,44020,17661,9883,16783,34444,22879,44209
Ͽ,XingKouZhen,410221107,31422,3248,20993,11571,43831,20983,9415,23081,44064,23092,44085
,PeiCunDianXiang,410221200,33632,3988,24448,13276,48597,24448,11420,24592,49040,24592,49040
ڵ,ZongDianXiang,410221202,18536,2316,13565,7841,27253,13562,6676,13955,27517,13963,27528
ľ,BanMuXiang,410221203,20213,3019,15856,9366,30958,15856,7830,15205,31061,15206,31062
,ZhuLinXiang,410221204,17925,2208,13175,7784,26656,13175,6673,13631,26806,13631,26806
ׯ,GuanZhuangXiang,410221205,24207,2798,17349,9073,34755,17349,7987,17643,34992,17643,34992
,HuGangXiang,410221206,23489,3046,17724,9875,34992,17720,8700,17508,35228,17511,35235
ľ,SuMuXiang,410221207,28898,3475,20434,11890,41806,20434,9668,21607,42041,21607,42041
ɳ,ShaWoXiang,410221208,22419,3181,16353,9558,32896,16353,7537,16784,33137,16784,33137
ƽ,PingChengXiang,410221209,37485,4962,29031,15806,58144,29031,16080,29493,58524,29496,58527
๵,NiGouXiang,410221210,26356,3439,20872,12110,41088,20871,11586,20508,41379,20509,41381
Ԫ,ShiYuanXiang,410221211,35291,4208,25624,14977,52503,25624,13151,27026,52650,27026,52650
կ,XiZhaiXiang,410221212,25776,2569,18405,10019,37485,18397,9583,19512,37909,19523,37928
ǽ,ChengJiaoXiang,410221213,22091,2416,14645,8463,30758,14633,6813,16639,31272,16675,31320
ǹ,ChengGuanZhen,410222100,61323,5542,41262,21422,67703,36422,17526,38593,75015,43129,84391
,ShuGangZhen,410222101,27173,3051,19535,10638,39340,19529,9516,20199,39728,20205,39740
,YuHuangMiaoZhen,410222102,34570,4223,24982,13892,50814,24982,12149,25960,50942,25960,50942
¥,SiSuoLouZhen,410222103,37774,4564,27414,15365,55698,27409,13753,28673,56082,28677,56091
ɰ,ZhuShaZhen,410222104,42990,5512,31048,16569,63195,31043,15048,32493,63536,32502,63550
,ChangZhiZhen,410222105,29322,3583,20795,11161,42528,20795,9684,21794,42589,21794,42589
ׯ,FengZhuangXiang,410222200,21986,2779,15982,8344,32216,15970,7964,16715,32685,16747,32729
Ӫ,SunYingXiang,410222201,26895,3033,19136,10493,39444,19136,9801,20587,39723,20593,39729
,DaGangLiXiang,410222202,28703,3349,20688,11046,42194,20680,10420,21769,42449,21784,42472
ۡ,DiGeXiang,410222203,24781,2931,18072,9451,37086,18072,9428,19067,37139,19068,37140
,LianChengXiang,410222204,28198,3315,19932,9961,40747,19931,9372,20950,40881,20953,40885
ׯ,LiZhuangXiang,410222205,25711,3015,18110,9456,37213,18102,8511,19109,37211,19127,37237
ǹ,ChengGuanZhen,410223100,62845,4012,38839,20361,64970,30444,13987,32963,63407,42005,80844
䢴,WeiChuanZhen,410223101,41351,5138,28293,13519,56128,27009,12205,28814,55823,30401,58694
,ZhuQuZhen,410223102,32159,4201,23234,11422,45955,23141,10144,23103,46244,23270,46504
ׯ,CaiZhuangZhen,410223103,39201,4428,27208,12832,55382,27208,11865,28285,55493,28286,55494
,YongXingZhen,410223104,49073,5048,32942,16308,67169,32942,13567,34745,67687,34746,67688
,ZhangShiZhen,410223105,33475,3366,22691,11497,46270,22691,9736,23879,46570,23886,46577
ʮ,ShiBaLiZhen,410223106,40858,3822,28104,14210,56415,27708,12434,28687,56395,29010,57114
ˮ,ShuiPoZhen,410223107,34613,4110,24831,13114,49834,24686,11645,25322,50008,25537,50368
ׯ,XingZhuangXiang,410223200,34606,3698,24353,11340,49494,24353,12015,25966,50319,25966,50319
ׯͷ,ZhuangTouXiang,410223201,33650,4251,24259,11834,49232,24216,12378,25953,50169,26020,50279
Ӫ,DaYingXiang,410223202,33671,4207,23353,11371,48610,23353,10940,25465,48818,25465,48818
,DaMaXiang,410223203,30018,4051,21141,10475,43996,21141,10459,23383,44524,23387,44528
,GangLiXiang,410223204,39276,5005,27324,13423,56307,27324,12808,29765,57089,29765,57089
¥,MenLouRenXiang,410223205,24968,3308,17981,8711,36436,17941,8442,18685,36626,18737,36718
,DaQiaoXiang,410223206,34840,3700,23909,11529,48830,23672,10963,25314,48986,25594,49503
ϲ,NanCaoXiang,410223207,35061,4073,25022,12267,51108,25022,12060,26172,51194,26172,51194
С,XiaoChenXiang,410223208,20456,2056,13787,6650,27757,13787,5470,14195,27982,14195,27982
ǹ,ChengGuanZhen,410224100,38265,2863,25711,11564,29587,19953,9323,20225,40178,24740,50451
,ChenLiuZhen,410224101,40624,4843,28489,14628,54550,27364,12251,28216,55580,29229,57718
¥,ChouLouZhen,410224102,36073,4672,26078,13788,53154,26056,12843,27395,53451,27510,53588
,BaLiWanZhen,410224103,34069,4292,24539,12612,48668,24538,10846,24661,49199,24668,49207
,QuXingZhen,410224104,23191,2797,16422,8700,32715,16417,7276,16798,33215,16842,33264
,ZhuXianZhen,410224106,22704,2487,15893,8244,31092,15598,7135,16151,31749,16433,32326
µ,BanPoDianXiang,410224200,31560,3968,23167,12303,46008,23156,11963,24281,47437,24324,47491
,LuoWangXiang,410224202,32164,4206,23430,12886,47051,23419,11217,24118,47537,24157,47587
,LiuDianXiang,410224203,25355,3015,17858,9120,35492,17804,8405,18809,36613,18917,36775
Ԭ,YuanFangXiang,410224204,29302,3110,19664,9752,39152,19279,9162,20773,40052,21910,41574
,DuLiangXiang,410224205,40176,4622,28429,14222,57614,28426,13963,30330,58756,30332,58761
¡,XingLongXiang,410224206,28686,3227,20186,10220,40289,20183,9349,21052,41235,21076,41262
կ,XiJiangZhaiXiang,410224208,39632,4668,28157,14368,57893,28148,14286,30380,58528,30429,58586
¡,WanLongXiang,410224210,34923,3813,25080,12703,51751,25075,13669,27293,52368,27325,52405
,FanCunXiang,410224211,26250,2613,17989,8972,37281,17957,8941,19655,37612,19815,37804
ǹ,ChengGuanZhen,410225100,50790,4084,32744,15405,50235,28207,11777,28976,57183,33907,66651
,GuYangZhen,410225101,40663,4764,31214,15514,60915,30936,15777,29585,60521,29990,61204
,NanZhangZhen,410225102,34829,4444,26475,14663,52966,26464,14158,26896,53360,26956,53431
žĹ,ZhangJunMuZhen,410225103,43396,5515,31079,18624,59488,29665,13140,29693,59358,30972,62051
,HongMiaoZhen,410225104,33986,4305,24769,12792,50571,24157,12419,24836,48993,25941,50710
ǹ,ChengGuanXiang,410225200,48407,5090,35101,18601,62747,35046,16136,34315,69361,34532,69633
կ,SanYiZhaiXiang,410225201,32278,4306,24623,13145,47788,24614,12019,23945,48559,23980,48603
ͷ,BaTouXiang,410225202,18176,2579,14007,7676,27032,13923,6348,12948,26871,13096,27103
צӪ,ZhaoYingXiang,410225203,17225,2820,14911,8800,28070,14911,8161,13295,28206,13295,28206
Ӫ,GuYingXiang,410225204,19772,2885,16750,9405,30724,16749,8311,14218,30967,14218,30968
С,XiaoSongXiang,410225205,25858,3684,21773,11494,41631,21768,12240,19986,41754,20009,41782
կ,MengZhaiXiang,410225206,16045,2303,13311,7314,25693,13254,7436,12389,25643,12473,25784
,XuHeXiang,410225207,15618,2303,12016,6962,23348,12016,5741,11646,23662,11646,23662
Ѽ,PuTaoJiaXiang,410225208,15361,2178,12173,7213,23912,12173,6403,11769,23942,11769,23942
¥,YanLouXiang,410225209,14757,2272,12593,7176,23660,12576,6855,11216,23792,11291,23884
Ƿ,YiFengXiang,410225210,26687,3680,20478,11775,39975,20478,9845,19734,40212,19734,40212
ؽֵ´,XiGuanJieDaoBanShiChu,410302001,22161,3713,15263,10718,19815,15246,4252,14829,30075,14863,30126
ֵ´,XiNanYuJieDaoBanShiChu,410302002,6289,1191,4286,3150,5802,4247,1052,4052,8299,4246,8532
ֵ´,XiBeiYuJieDaoBanShiChu,410302003,14691,1684,10180,6733,12272,9654,3739,9391,19045,9934,20114
ֵ´,DongNanYuJieDaoBanShiChu,410302004,5210,1022,3563,2485,5057,3563,862,3531,7094,3531,7094
ֵ´,DongBeiYuJieDaoBanShiChu,410302005,13904,1623,9840,5854,8705,8340,2519,8032,16372,8206,18046
Ϲؽֵ´,NanGuanJieDaoBanShiChu,410302006,4300,601,2971,2018,2713,2971,909,2839,5810,2839,5810
ֵֽ´,LuoPuJieDaoBanShiChu,410302007,17249,1602,11245,6402,13753,11019,3148,10542,21561,10754,21999
ɽ,MangShanZhen,410302100,38113,3542,25919,13726,38831,25813,9800,25216,51029,25536,51455
·ֵ´,WangChengLuJieDaoBanShiChu,410303001,44558,6786,30457,20748,44722,29922,8248,28538,58460,29135,59592
԰ֵ´,JinGuYuanJieDaoBanShiChu,410303002,45303,6898,31048,21280,43856,30554,8503,29078,59632,29656,60704
�ֵ´,XiGongJieDaoBanShiChu,410303003,33625,5916,23242,15653,36962,22883,6242,21772,44655,22541,45783
·ֵ´,MangLingLuJieDaoBanShiChu,410303004,8261,1472,6237,3487,6996,4495,1144,4174,8669,4640,10877
·ֵ´,DaoBeiLuJieDaoBanShiChu,410303005,29644,3233,18716,13586,21667,18409,5762,18352,36761,19923,38639
ƹ·ֵ´,TangGongLuJieDaoBanShiChu,410303006,16970,3882,12351,8525,18232,12159,3125,11505,23664,11626,23977
·ֵ´,HanTunLuJieDaoBanShiChu,410303007,25249,2042,9509,6171,13831,8753,2363,8316,17069,20145,29654
·ֵ´,KaiXuanDongLuJieDaoBanShiChu,410303008,19532,2792,13419,8512,18180,12331,3434,11790,24121,12339,25758
山,LuoBeiXiang,410303200,37273,1850,22913,18274,15654,22291,7723,22904,45195,23933,46846
ɽ,HongShanXiang,410303201,23259,2587,15552,8120,27621,15326,5265,14977,30303,15559,31111
ؽֵ´,DongGuanJieDaoBanShiChu,410304001,16607,2025,11175,6624,13011,9682,2821,9433,19115,10278,21453
eֵ´,ChanXiJieDaoBanShiChu,410304002,13557,1971,8970,6174,10503,8396,2484,8353,16749,9042,18012
·ֵ´,WuGuLuJieDaoBanShiChu,410304003,28413,4206,18487,12711,31788,18039,4449,17629,35668,18581,37068
Ҥֵ´,BeiYaoJieDaoBanShiChu,410304004,21486,2498,12460,8153,19661,11596,2995,11541,23137,14519,26979
ֵ´,TaWanJieDaoBanShiChu,410304005,11857,1849,7539,5719,14038,7378,1817,7504,14882,7984,15523
Ľֵ´,YangWenJieDaoBanShiChu,410304006,9453,1039,6010,4130,10556,5754,1641,5208,10962,6123,12133
ֵֽ´,HuaLinJieDaoBanShiChu,410304007,4327,628,2962,2200,1899,2933,847,2825,5758,2840,5802
eӻ,ChanHeHuiZuXiang,410304200,32910,2785,20596,10205,31628,18873,5274,17512,36385,20373,40969
·ֵ´,HuBeiLuJieDaoBanShiChu,410305001,35190,4993,23107,13810,30164,19616,5098,18536,38152,22174,45281
·ֵ´,TianJinLuJieDaoBanShiChu,410305002,30809,4595,21107,14517,29217,20950,6779,20659,41609,21076,42183
·ֵ´,ChangChunLuJieDaoBanShiChu,410305003,26146,3788,17899,12533,24683,17736,5418,17322,35058,17453,35352
ϲ·ֵ´,NanChangLuJieDaoBanShiChu,410305004,33929,5411,23298,16269,32285,23093,6462,22211,45304,22504,45802
·ֵ´,ChangAnLuJieDaoBanShiChu,410305005,36012,9633,25977,18248,43235,25355,5849,24353,49708,25517,51494
·ֵ´,ChongQingLuJieDaoBanShiChu,410305006,13920,3721,9939,7383,16609,9922,2221,9873,19795,9923,19862
֣·ֵ´,ZhengZhouLuJieDaoBanShiChu,410305007,57786,5560,33258,21795,47137,30345,8222,30726,61071,38310,71568
人·ֵ´,WuHanLuJieDaoBanShiChu,410305008,22000,3428,14752,10322,20472,14290,4076,14201,28491,14752,29504
Ӫֵ´,XuJiaYingJieDaoBanShiChu,410305009,7157,1138,5069,3860,8569,4991,1614,4658,9649,4840,9909
齭·ֵ´,ZhuJiangLuJieDaoBanShiChu,410305010,30814,4200,20393,13234,24386,18381,4845,17842,36223,19466,39859
ɽ·ֵ´,ZhouShanLuJieDaoBanShiChu,410305011,13557,2210,8997,6330,13503,8795,2440,8714,17509,9210,18207
,XinDianZhen,410305160,31614,3902,21697,11729,40183,21660,7916,21644,43304,21735,43432
ũ,GongNongXiang,410305200,76984,5730,48088,35157,43404,46492,15933,47498,93990,50559,98647
,SunQiTunXiang,410305360,29567,2973,20298,10694,31584,19980,7856,19334,39314,20098,40396
ҵ·ֵ´,ChuangYeLuJieDaoBanShiChu,410305560,21564,1841,13745,10011,12929,13576,4320,13748,27324,13980,27725
·ֵ´,DaQingLuJieDaoBanShiChu,410306001,22186,2819,14867,11121,24426,14427,4648,13841,28268,14786,29653
,JiLiXiang,410306200,29292,3215,19881,11374,31705,19769,6916,19142,38911,19542,39423
ֵֽ´,AnLeJieDaoBanShiChu,410311001,20951,867,14163,3042,5116,4203,1311,4203,8406,8966,23129
Ԫ·ֵ´,KaiYuanLuJieDaoBanShiChu,410311002,16940,1276,11231,6738,12702,10655,3857,10156,20811,10842,22073
ʯֵ߽´,LongMenShiKuJieDaoBanShiChu,410311003,23799,2412,16669,8154,30408,16618,7049,16505,33123,16591,33260
,GuanLinZhen,410311100,53886,5483,36105,20776,55384,34855,12784,34470,69325,36048,72153
,LongMenZhen,410311101,22637,2238,15089,7599,26977,14643,5472,14155,28798,15258,30347
,AnLeZhen,410311102,31708,3014,21377,10571,37166,21342,7411,20668,42010,20756,42133
,BaiMaSiZhen,410311103,23548,2684,15543,8360,26257,15292,5200,15100,30392,15889,31432
,ZhuGeZhen,410311104,37999,3851,25981,12921,50264,25892,10782,26372,52264,26651,52632
,LiCunZhen,410311105,47283,5433,33102,16675,64042,32427,13410,32420,64847,33024,66126
¥,LiLouXiang,410311200,38087,4242,24941,13021,45628,24384,7521,24430,48814,24909,49850
ų,GuChengXiang,410311201,75776,4379,46305,17967,60622,33837,13153,32495,66332,47003,93308
·ֵ´,ZhenBeiLuJieDaoBanShiChu,410311560,5594,233,3575,2262,235,3333,1456,3533,6866,3708,7283
ǹ,ChengGuanZhen,410322100,62113,6067,42472,23642,62747,38864,16805,37571,76435,42513,84985
,HuiMengZhen,410322101,33488,5397,23759,14446,43622,23209,7497,22137,45346,22623,46382
ƽ,PingLeZhen,410322102,32708,4261,22293,12576,41540,21807,7306,21416,43223,21982,44275
ׯ,SongZhuangZhen,410322103,18560,2278,12319,7239,22989,12087,4043,11820,23907,12562,24881
׺,BaiHeZhen,410322104,38879,5035,25095,14349,47619,24858,8624,23715,48573,27443,52538
,ZhaoYangZhen,410322105,29071,3836,20626,11227,39188,20573,7774,19908,40481,20055,40681
С˵,XiaoLangDiZhen,410322106,19994,3185,14688,8963,28022,14644,5815,14215,28859,14306,28994
,MaTunZhen,410322107,27365,3271,19228,10155,34995,18916,7860,18883,37799,19268,38496
ˮ,HengShuiZhen,410322108,21282,2549,14160,8149,27491,14080,5566,14148,28228,15237,29397
,ChangDaiXiang,410322201,17484,2169,11842,6264,23330,11820,4355,12055,23875,12166,24008
ǹ,ChengGuanZhen,410323100,74618,5681,50032,26220,74972,43456,19562,43241,86697,49829,99861
ʯ,ShiSiZhen,410323101,25825,2546,16543,9673,32342,16225,6900,16727,32952,18728,35271
ͷ,WuTouZhen,410323102,33116,4399,23431,12274,46331,23426,9988,24051,47477,24072,47503
Ž,CiJianZhen,410323103,31742,4051,22257,11695,43383,22161,9413,22706,44867,22949,45206
,TieMenZhen,410323104,48752,4990,33338,18878,61701,33128,14737,33793,66921,35141,68479
,NanLiCunZhen,410323105,19528,2731,14527,7859,28085,14515,6920,14543,29058,14652,29179
ұ,BeiYeZhen,410323106,21818,3058,15689,9432,30342,15620,6945,15929,31549,16132,31821
ͷ,CangTouZhen,410323107,15000,1943,10893,6339,20740,10819,5030,10936,21755,11080,21973
,ZhengCunXiang,410323108,25631,2651,16224,8603,31159,16027,7041,16623,32650,19099,35323
ʯ,ShiJingXiang,410323109,14931,2090,10857,6813,20996,10643,5022,10739,21382,11186,22043
ܴ,CaoCunXiang,410323205,10923,1611,7545,4674,15431,7473,3268,8076,15549,8257,15802
²ҵίԱ,LuoYangShiLuoXinChanYeJiJuQuGuanLiWeiYuanHui,410323400,13610,1075,8051,3725,12375,6961,3052,6955,13916,9686,17737
ǹ,ChengGuanZhen,410324100,51244,2418,33117,19612,34517,32143,14039,33226,65369,34584,67701
,ChiTuDianZhen,410324101,9205,971,5973,3125,11832,5891,2389,6296,12187,6592,12565
,HeYuZhen,410324102,12694,1499,8311,5181,16896,8275,3360,9131,17406,9242,17553
̶ͷ,TanTouZhen,410324103,23119,2669,15133,8524,30363,14278,6219,15431,29709,16874,32007
,SanChuanZhen,410324104,17027,1562,10742,6107,22075,10586,4106,11499,22085,11953,22695
ˮ,LengShuiZhen,410324105,16026,1200,9801,5309,19162,9461,3964,10095,19556,11389,21190
,TaoWanZhen,410324106,22240,1923,14134,7564,28525,13983,5406,14909,28892,15435,29569
ʯ,ShiMiaoZhen,410324107,12732,1168,8388,4505,16615,8376,3389,8867,17243,8901,17289
,MiaoZiZhen,410324108,20466,2295,13378,7958,25770,12911,4963,13739,26650,14346,27724
ﴨ,LuanChuanXiang,410324200,27751,2111,17854,9628,29638,16920,7100,17909,34829,19108,36962
,QiuBaXiang,410324203,6968,894,4419,2998,9332,4348,1766,4961,9309,5209,9628
ʨ,ShiZiMiaoXiang,410324204,13871,1442,8801,5355,18231,8727,3510,9822,18549,10022,18823
,BaiTuXiang,410324205,10514,1064,6733,4215,13410,6648,2842,7274,13922,7687,14420
к,JiaoHeXiang,410324206,10691,1232,7002,4674,14278,6939,2799,7573,14512,7720,14722
ǹ,ChengGuanZhen,410325100,53125,4313,37477,21127,58993,35662,17693,36029,71691,37654,75131
,TianHuZhen,410325101,31079,4160,25740,13981,48103,25723,14048,23529,49252,23547,49287
,JiuXianZhen,410325102,16147,1581,11417,6420,22484,11357,5928,12067,23424,12239,23656
,CheCunZhen,410325103,34952,4282,23842,14341,48481,22538,10985,24106,46644,26377,50219
ׯ,YanZhuangZhen,410325104,26919,2875,19671,9939,38229,19657,10265,20312,39969,20388,40059
ͤ,DeTingZhen,410325105,25460,2769,18382,10478,36581,18303,9788,19436,37739,19635,38017
,DaZhangZhen,410325106,17242,1998,13534,7677,25530,13533,7331,13037,26570,13037,26571
ƺ,DaPingXiang,410325201,20444,2206,14523,7423,29022,14508,6988,15040,29548,15115,29638
,KuQuXiang,410325202,23967,2526,18723,9301,30194,17430,9136,16524,33954,16906,35629
δ,HeCunXiang,410325203,17042,2037,13235,7353,24860,13218,7163,12930,26148,13007,26242
ֽ,ZhiFangXiang,410325206,21255,2394,14959,7769,29216,14465,7161,15283,29748,15851,30810
,FanPoXiang,410325207,15315,1875,11095,6182,21204,10951,5675,11299,22250,11770,22865
ŵ,JiuDianXiang,410325208,11193,1954,9401,5571,17787,9369,5449,9149,18518,9195,18596
ׯ,HuangZhuangXiang,410325209,11299,1940,9741,6118,18169,9727,5552,8997,18724,9050,18791
ľֲ,MuZhiJieXiang,410325210,6339,1037,4677,3463,9283,4658,2356,5009,9667,5055,9732
׺,BaiHeXiang,410325211,7879,1156,5200,3440,10791,5192,2418,6145,11337,6253,11453
մֳ,TaoCunLinChang,410325400,71,0,38,37,1,38,9,42,80,42,80
ֳ,WuMaSiLinChang,410325401,163,0,38,55,0,25,1,48,73,126,164
çկֳ,WangMangZhaiLinChang,410325402,98,7,44,11,66,24,7,22,46,68,112
ǹ,ChengGuanZhen,410326100,49369,4583,35667,18115,57560,33133,18379,33950,67083,36664,72331
ϵ,ShangDianZhen,410326101,20218,2891,15680,9431,29111,15671,8819,16192,31863,16248,31928
,FuDianZhen,410326102,9664,1287,6808,4069,13876,6791,3516,7516,14307,7659,14467
С,XiaoDianZhen,410326103,29201,3321,21742,11123,41544,21696,11239,21893,43589,22019,43761
,BaiShuXiang,410326200,15067,1898,11248,5846,22745,11243,6329,12000,23243,12046,23294
ʮ,ShiBaPanXiang,410326202,11342,1618,8161,5029,16316,8130,3791,8494,16624,8590,16751
,JinCunXiang,410326203,7013,994,5206,3222,10531,5184,3001,5698,10882,5802,11008
ƺ,WangPingXiang,410326204,7537,1191,5581,3164,11268,5581,3166,6311,11892,6313,11894
,SanTunXiang,410326205,20263,2865,15697,8591,31136,15694,8972,16333,32027,16403,32100
,LiuDianXiang,410326206,19692,2429,14843,7630,28990,14803,8007,15090,29893,15285,30128
Ӫ,TaoYingXiang,410326207,19773,2711,15778,7871,29786,15702,8858,15454,31156,15564,31342
ڲ,NeiBuXiang,410326208,13822,1985,10809,5856,20731,10798,5661,10599,21397,10659,21468
̵,CaiDianXiang,410326209,30512,3884,22625,11049,43531,21963,10950,22007,43970,22721,45346
󰲹ҵ԰,DaAnGongYeYuanQu,410326400,14755,1698,11061,5639,20776,10966,5738,10763,21729,11130,22191
ǹ,ChengGuanZhen,410327100,42902,4192,29306,16018,45553,26804,12527,27234,54038,30315,59621
,FengLiZhen,410327101,34136,3279,23867,11556,47418,23867,10811,24359,48226,24359,48226
Ȫ,LiuQuanZhen,410327102,37115,3998,27221,13616,54229,27170,13722,27491,54661,27614,54835
,HanChengZhen,410327103,28511,2839,20551,10820,39635,20116,9440,19834,39950,20239,40790
,BaiYangZhen,410327104,26301,3580,20471,10318,39482,20430,10505,19797,40227,19915,40386
Ѱ,XunCunZhen,410327105,47354,4547,32223,15168,56926,29881,13693,30852,60733,33371,65594
,JinPingZhen,410327106,25724,2848,18168,9454,34421,18138,8175,18437,36575,18579,36747
,SanXiangZhen,410327107,20826,2188,15470,8129,29927,15437,7542,15020,30457,15086,30556
,YanZhenXiang,410327203,41846,5152,30625,15777,61507,30556,15337,31586,62142,31710,62335
ߴ,GaoCunXiang,410327204,30133,3399,21818,11297,42808,21687,10336,21851,43538,22050,43868
,ZhangWuXiang,410327207,20850,1986,15425,8119,30328,15384,7756,15100,30484,15167,30592
²,MuCeXiang,410327208,2616,290,1851,1041,3802,1826,963,1968,3794,2018,3869
Ϲ,ShangGuanXiang,410327209,3667,474,2679,1597,5467,2651,1536,2916,5567,2998,5677
ׯ,LianZhuangXiang,410327210,19182,2169,13908,7232,27001,13861,6524,13872,27733,13967,27875
Ա,ZhaoBaoXiang,410327211,20068,2471,14886,7817,29108,14652,7399,14850,29502,15052,29938
ׯ,DongWangZhuangXiang,410327212,19380,2321,14415,7121,29135,14411,7826,15110,29521,15112,29527
,FanCunXiang,410327213,16801,2011,13089,6159,25268,13085,7243,12906,25991,12966,26055
ǹ,ChengGuanZhen,410328100,28020,1956,19336,10164,25592,17585,8419,17405,34990,19059,38395
�,WangFanHuiZuZhen,410328101,19616,1251,13567,7205,19706,13562,6106,13393,26955,13406,26973
ϸ,ShangGeZhen,410328102,10183,946,6685,3825,14145,6600,3068,7233,13833,7512,14197
,XiaYuZhen,410328103,10629,890,6895,3865,14340,6806,3243,7559,14365,7867,14762
ӵ,HeDiZhen,410328104,26604,3209,20230,10255,38488,20023,9824,19051,39074,19407,39637
˻,XingHuaZhen,410328105,14039,1158,9095,4889,19072,8861,3939,9555,18416,10041,19136
ǽ,ChengJiaoXiang,410328200,24062,2034,17937,9387,31076,17260,8033,15875,33135,16192,34129
,DongSongXiang,410328203,25031,2509,17914,9528,35417,17908,8347,17961,35869,17973,35887
С,XiaoJieXiang,410328205,15979,1776,10901,6246,22497,10704,4901,11271,21975,11755,22656
,MaDianXiang,410328207,15364,1519,10579,5876,21167,10310,4429,10144,20454,10733,21312
ˮ,ChangShuiXiang,410328208,8119,868,5634,3275,11273,5580,2455,5651,11231,5808,11442
,LuoLingXiang,410328209,6570,545,4266,2250,8820,4109,1809,4410,8519,4658,8924
,GuXianXiang,410328210,4448,455,2937,1708,5993,2880,1178,3019,5899,3144,6081
,DiZhangXiang,410328213,12741,1292,8819,5016,17812,8566,4144,8900,17466,9358,18177
ɽ,ShanDiXiang,410328214,12582,1104,8335,4686,16621,8227,3729,8491,16718,9080,17415
Դ,ZhaoCunXiang,410328215,29333,2179,20266,11015,40882,20207,9820,20826,41033,21066,41332
,ChenWuXiang,410328216,21610,1644,15565,8015,30358,15565,7236,14925,30490,14925,30490
,JianKouXiang,410328217,13778,1060,10664,5859,20061,10642,5479,9588,20230,9653,20317
ǹ,ChengGuanZhen,410329100,93039,6914,64337,30505,105563,59606,29743,61092,120698,65359,129696
,MingGaoZhen,410329101,43620,4570,30558,14500,59811,30065,13985,30868,60933,31617,62175
ˮկ,ShuiZhaiZhen,410329102,20261,1960,14685,7320,27369,14606,7691,15097,29703,15227,29912
,PengPoZhen,410329103,41774,3976,29557,14885,58762,29538,13865,29921,59459,30058,59615
ɳ,BaiShaZhen,410329104,48356,5029,35570,17367,67505,34680,17819,34487,69167,35634,71204
,JiangZuoZhen,410329105,33877,3131,23350,11170,46596,23336,10568,24173,47509,24226,47576
ɽ,GaoShanZhen,410329106,30913,3440,23084,10910,45816,23082,11876,23139,46221,23145,46229
ѻ,YaLingXiang,410329200,47500,4808,34096,15175,68581,34051,17323,35417,69468,35535,69631
ƽ,PingDengXiang,410329203,33403,3497,24273,10784,48039,24267,12776,25377,49644,25403,49676
ƺ,JiuHouXiang,410329204,23342,2720,17158,8445,33530,17097,8501,17296,34393,17405,34563
կ,GeZhaiXiang,410329205,22813,2830,17515,9045,33312,17507,8981,17090,34597,17109,34624
Ԫ,BaiYuanXiang,410329206,34104,3617,24807,12585,49580,24799,12154,25056,49855,25068,49875
,BanPoXiang,410329208,11161,962,7720,3523,15630,7715,3761,8085,15800,8164,15884
,LvDianXiang,410329210,39623,3914,27454,14264,55124,27354,12472,28444,55798,28555,56009
ǹ,ChengGuanZhen,410381100,99812,10136,66913,38904,104601,63090,23492,62211,125301,66527,133440
ɽ,ShouYangShanZhen,410381101,33801,4503,23014,11828,43294,22347,8179,22803,45150,23469,46483
ׯ,DianZhuangZhen,410381102,28271,3480,18936,10202,37337,18833,6249,18926,37759,19064,38000
,ZhaiZhen,410381103,27776,3448,18691,9757,36285,18371,7077,19296,37667,19610,38301
̲,YueTanZhen,410381104,28471,3295,18884,9152,37161,18699,6818,19463,38162,19700,38584
,GuXianZhen,410381105,40311,5006,26611,13205,53073,26446,9441,27857,54303,28147,54758
,GouShiZhen,410381106,40828,5415,27676,14816,53551,27123,10195,28097,55220,28762,56438
,FuDianZhen,410381107,37111,5058,25825,13365,49992,25635,10810,26538,52173,27154,52979
,GaoLongZhen,410381108,23963,2885,16291,8468,30869,15655,6057,16143,31798,16614,32905
ܵ,KouDianZhen,410381109,23427,2839,15991,8478,31766,15919,6203,16350,32269,16478,32469
Ӵ,PangCunZhen,410381110,27317,2946,18388,9323,36734,18133,7133,18705,36838,19008,37396
ɽ,ShanHuaXiang,410381200,28628,4699,20068,11912,37961,19829,6439,19347,39176,19698,39766
,MangLingXiang,410381201,18949,3491,13900,8289,25974,13849,4768,13154,27003,13308,27208
,DaKouXiang,410381203,26924,3975,18763,10695,36337,18736,7070,19144,37880,19206,37969
ֵֽ,ShuGuangJieJieDao,410402001,35476,3424,22403,13621,25498,19521,6281,19825,39346,22778,45181
·ֵ,GuangMingLuJieDao,410402002,30058,3415,19280,12691,32947,19089,6160,19505,38594,20353,39633
·ֵ,ZhongXingLuJieDao,410402003,16686,1651,10930,6749,16267,9897,3155,9651,19548,10562,21492
·ֵ,KuangGongLuJieDao,410402004,31418,4304,20704,13545,32012,20536,6058,20891,41427,21076,41780
гֵ,XiShiChangJieDao,410402005,28595,2875,16829,9287,28053,13896,4948,14746,28642,19589,36418
½ֵֽ,XinXinJieJieDao,410402006,23274,2260,14541,9313,26590,13958,5044,14937,28895,16037,30578
ʯɽֵ,QingShiShanJieDao,410402007,6312,570,4029,2520,7025,4027,1656,4480,8507,4509,8538
տӱ·,ZhanHeBeiLu,410402008,15820,2041,10534,6990,16383,10353,2777,10023,20376,10104,20638
·ֵ,HuBinLuJieDao,410402009,30711,948,13877,4019,10976,7313,3078,6975,14288,20860,34737
߻ʽֵ,XiGaoHuangJieDao,410402010,8241,692,5340,3279,7482,5313,1942,5284,10597,5535,10875
,JiaoDianZhen,410402100,11874,1312,8468,4288,13733,8394,3571,8210,16604,8289,16757
,ZhiYangZhen,410402101,19028,2386,13136,6668,25333,13132,5247,13521,26653,13525,26661
ɽί,XiangShanGuanWei,410402400,19223,1903,11247,6998,21381,10924,4570,11725,22649,14449,25696
ί,BinHuGuanWei,410402401,16613,641,11229,2035,7784,4192,1703,4096,8288,7728,18957
Ӧί,YingBinGuanWei,410402402,8526,926,6098,3168,11388,6089,2473,5789,11878,5827,11925
·ֵ,DongAnLuJieDao,410403001,25916,2410,16371,11730,27602,16236,4829,16644,32880,16784,33155
Խ·ֵ,YouYueLuJieDao,410403002,23600,2991,15905,10410,21443,15215,4361,14868,30083,15047,30952
һ·ֵ,WuYiLuJieDao,410403003,26635,3540,17464,11096,29025,16855,4807,16865,33720,17518,34982
·ֵ,JianSheLuJieDao,410403004,32697,3048,21504,14530,26902,20640,6650,20128,40768,20891,42395
·ֵ,DongHuanLuJieDao,410403005,29932,3015,18865,12797,30687,18646,6109,19712,38358,20191,39056
,DongGongRenZhen,410403006,10910,1482,7044,4651,12699,7007,2139,7345,14352,7487,14531
⻪·ֵ,GuangHuaLuJieDao,410403007,13246,1109,8126,5399,15363,8117,2712,8925,17042,8941,17067
ӥֵ,HongYingJieDao,410403008,25822,1945,16163,10767,21457,16123,5323,16635,32758,16927,33090
ֵ̨,HuangTaiJieDao,410403009,6346,620,4061,2740,5383,3999,1425,4075,8074,4330,8391
·ֵ,BeiHuanLuJieDao,410403010,16776,1629,10911,6502,16081,10896,3974,11419,22315,11468,22379
߻,DongGaoHuangXiang,410403200,19374,2272,13266,7387,23034,13213,4959,13210,26423,13339,26605
ׯֵ,GaoZhuangJieDao,410404001,17065,1036,8877,3539,19252,5299,2741,5565,10864,11965,20842
˽ֵ,LongXingJieDao,410404002,8884,708,5052,2664,9035,3981,1696,4103,8084,6236,11288
·ֵ,RenMinLuJieDao,410404003,11339,882,6703,3737,11465,5519,2465,6000,11519,7983,14686
ӽֵ,LongHeJieDao,410404004,6282,451,3668,2156,6756,3454,1363,3729,7183,4428,8096
ׯֵ,MaZhuangJieDao,410411001,31148,3039,19436,12002,27245,17027,5805,17385,34412,20556,39992
ϻ·ֵ,NanHuanLuJieDao,410411002,28688,2898,18741,13145,19431,18668,5990,18715,37383,18835,37576
ҦϽֵ,YaoMengJieDao,410411003,14572,2060,9622,6419,18289,9560,2672,9571,19131,9682,19304
ɽֵ,JiuLiShanJieDao,410411004,36990,2574,22141,11961,23526,16833,5790,17494,34327,23213,45354
Ṥ·ֵ,QingGongLuJieDao,410411005,30686,1652,19212,12387,19821,18062,6620,18266,36328,19746,38958
·ֵ,GaoYangLuJieDao,410411006,5872,591,4069,2123,7062,3853,1494,3745,7598,3888,7957
,BeiDuZhen,410411100,34096,3722,22376,11808,38735,22130,7886,22263,44393,23328,45704
,CaoZhenXiang,410411200,36371,4940,25520,12904,48287,25488,10505,26241,51729,26296,51816
·ֵ,TieLuJieDao,410421001,4930,596,2997,2275,5690,2977,1015,3032,6009,3544,6541
ǹ,ChengGuanZhen,410421100,43905,3225,27776,15619,35405,24300,9021,24544,48844,28375,56151
ׯ,ZhouZhuangZhen,410421101,26583,3524,18267,9969,34518,18032,7332,18725,36757,19172,37439
ֵ,NaoDianZhen,410421102,24601,3607,17433,10102,34692,17428,7499,18250,35678,18274,35707
ʯ,ShiQiaoZhen,410421103,28436,4158,19554,11342,39543,19540,7580,20553,40093,20620,40174
̾,ShangJiuWuZhen,410421104,27646,3743,19000,10703,37690,18608,8498,19766,38374,20887,39887
Ӫ,DaYingZhen,410421105,44432,5600,30603,16105,60735,29755,13596,31169,60924,33025,63628
Ű,ZhangBaQiaoZhen,410421106,23377,2877,15681,8597,31400,15666,6118,16660,32326,16691,32372
ׯ,YangZhuangZhen,410421107,39794,4380,26610,16002,46396,26537,10296,27762,54299,27860,54470
Ф,XiaoQiXiang,410421200,24197,3416,16616,9596,33869,16614,7142,18065,34679,18139,34755
ׯ,ZhaoZhuangXiang,410421201,24187,3018,17344,8888,34593,17175,8272,17866,35041,18133,35477
ǰӪ,QianYingXiang,410421202,18745,2355,13148,7410,25557,13129,6150,14067,27196,14102,27250
ׯ,LiZhuangXiang,410421203,18276,2785,12942,7588,25383,12911,5357,13433,26344,13476,26418
,KunYangZhen,410422100,39222,3485,24896,14408,39331,22393,7730,23176,45569,25541,50437
ε,RenDianZhen,410422101,42426,6284,28834,15714,58783,28808,11038,30832,59640,30914,59748
,BaoAnZhen,410422102,22756,2983,15641,8648,30932,15515,6437,16275,31790,16535,32176
̨,XianTaiZhen,410422103,35509,6190,25061,14960,50088,25043,9222,25798,50841,25860,50921
񻯵,ZunHuaDianZhen,410422104,22960,2614,15142,7967,29619,15103,5192,15510,30613,15624,30766
Ҷ,YeYiZhen,410422105,41268,6065,28279,14978,55301,27202,11150,29094,56296,30204,58483
,LianCunZhen,410422106,38508,5991,27318,15509,54300,27303,10241,27393,54696,27422,54740
ǹ,ChengGuanXiang,410422200,51567,5962,33358,18111,50672,30839,11478,32378,63217,35649,69007
,XiaLiXiang,410422201,28343,4644,19595,11553,39616,19547,7932,21231,40778,21324,40919
,ChangCunXiang,410422202,24009,4651,17733,10888,34876,17641,8033,18787,36428,18960,36693
ׯ,MaZhuangHuiZu,410422203,7635,885,5311,2622,10192,5304,2354,5559,10863,5563,10874
ׯ,TianZhuangXiang,410422204,25441,3894,17752,10529,35717,17730,6957,18452,36182,18540,36292
,GongDianXiang,410422205,37661,5054,24856,12810,50584,24849,8136,25940,50789,25995,50851
,XinDianXiang,410422206,32766,4817,22639,12041,46170,22425,9694,24233,46658,24638,47277
Ȫ,LongQuanXiang,410422207,31438,4396,21509,11612,44328,21429,8820,23000,44429,23145,44654
ˮկ,ShuiZhaiXiang,410422208,21267,3477,14933,8152,30551,14914,6035,15805,30719,15846,30779
ׯ,HongZhuangYangXiang,410422209,23112,3316,16132,9192,32774,16112,6869,17108,33220,17165,33297
,DengLiXiang,410422210,26829,4475,19485,11632,38157,19465,7985,19743,39208,19804,39289
¶ֵ,LuFengJieDao,410423001,20197,1818,14660,7806,25897,14626,7011,14330,28956,14366,29026
ֵ̨,QinTaiJieDao,410423002,27228,2804,19225,10102,31830,18145,8718,18023,36168,19525,38750
³ֵ,LuYangJieDao,410423003,19752,2129,14363,7326,24721,13892,6854,13891,27783,14372,28735
Դֵ,HuiYuanJieDao,410423004,19514,1429,12806,6171,20722,11602,5460,11739,23341,13597,26403
,XiaTangZhen,410423101,20227,2462,13984,7788,29003,13937,6970,15588,29525,15675,29659
,LiangWaZhen,410423102,22066,2333,14932,8130,28333,14905,6328,15662,30567,15795,30727
ŹӪ,ZhangGuanYingZhen,410423103,35366,5375,25399,14473,50516,25387,11476,26760,52147,26818,52217
,ZhangLiangZhen,410423104,30458,4383,21931,11983,43212,21925,10181,23081,45006,23091,45022
Ңɽ,YaoShanZhen,410423105,12191,1753,8214,5017,17079,8154,3698,9334,17488,9428,17642
Դ,ZhaoCunXiang,410423200,16812,2171,11436,6899,23873,11353,5329,12748,24101,12876,24312
Ŀ,SiKeShuXiang,410423201,9281,1241,6370,3919,13213,6259,3106,6991,13250,7258,13628
ų,TuanChengXiang,410423202,8249,1171,5583,3466,11403,5557,2732,6476,12033,6569,12152
ܱ,XiongBeiXiang,410423203,12297,1813,8654,5095,17401,8646,4125,9549,18195,9581,18235
ú,RangHeXiang,410423204,29021,4145,20739,12432,40581,20286,9757,21614,41900,22184,42923
,WaWuXiang,410423205,16541,2820,12703,7550,25179,12585,7007,13368,25953,13665,26368
,GuanYinSiXiang,410423206,13200,2038,9880,5807,19736,9818,5200,10423,20241,10558,20438
ƽ̨,ZhaoPingTaiKu,410423207,18115,2185,12678,6824,25729,12597,6129,13619,26216,13751,26429
,BeiZiXiang,410423208,12722,2354,9393,5925,18990,9371,4796,10384,19755,10479,19872
ͷ,CangTouXiang,410423209,15404,2020,11250,6472,22042,11117,6342,12270,23387,12516,23766
,DongZhouXiang,410423210,28402,3926,20590,11563,40635,20257,10362,21429,41686,22100,42690
ŵ,ZhangDianXiang,410423211,23041,2695,16512,8814,32532,16474,8576,17749,34223,17800,34312
,XinJiXiang,410423212,35362,4611,24812,13024,47743,23581,11235,24744,48325,26396,51208
Ӫ,GunZiYingXiang,410423213,39067,5841,28163,15759,55206,28052,12997,29567,57619,29742,57905
¥,MaLouXiang,410423214,51741,6959,37931,20618,74447,37921,18782,39496,77417,39551,77482
ɽֵ,LongShanJieDao,410425001,56751,4839,37814,19850,59139,34943,15226,36156,71099,39002,76816
ǽֵ,DongChengJieDao,410425002,11585,1003,7736,4743,8239,7568,3606,8135,15703,8458,16194
ڣͷ,ZhongTouZhen,410425101,32268,5193,22987,13275,46795,22467,10186,23699,46166,24660,47647
,AnLiangZhen,410425102,35983,5025,25515,14386,52848,24910,13068,27465,52375,28561,54076
ý,TangJieZhen,410425103,30818,4563,21678,12615,44420,21401,9674,22789,44190,23377,45055
Ѧ,XueDianZhen,410425104,42465,5582,31455,17120,65176,31455,17413,34001,65456,34005,65460
,ChangQiaoZhen,410425105,36057,4729,24556,13128,51941,23912,11324,26357,50269,27554,52110
İ,CiBaZhen,410425106,31084,4952,22351,12247,45799,22142,10771,23881,46023,24456,46807
Ƶ,HuangDaoZhen,410425107,11954,1493,8389,4692,16737,8208,4570,9200,17408,9628,18017
,WangJiXiang,410425200,26426,3843,18840,10822,38989,18415,9171,19947,38362,20600,39440
,LiKouXiang,410425201,16453,2611,11759,7203,23505,11715,5253,12417,24132,12558,24317
Ҧׯ,YaoZhuangHuiZu,410425202,4965,680,3491,2007,7038,3380,1619,3618,6998,3773,7264
,BaiMiaoXiang,410425203,21608,3225,15260,9055,31139,15243,6864,16428,31671,16437,31697
,GuangKuoTianDi,410425204,9601,1295,6781,3733,13620,6781,3106,7206,13987,7221,14002
Ԫ,ZhaYuanXiang,410425205,22526,2878,15600,7980,29261,14228,7218,15608,29836,17022,32622
ڽֵ,YaKouJieDao,410481001,15270,1672,10042,6893,18125,9922,3270,9912,19834,10170,20212
½ֵ,SiPoJieDao,410481002,20820,2981,13675,9664,21379,13226,3926,13072,26298,14052,27727
ֵ,ZhuLanJieDao,410481003,19008,1993,12555,8015,18593,11392,4442,11343,22735,12888,25443
Ժֵ,YuanLingJieDao,410481004,9059,1102,5841,4109,7337,5636,1947,5786,11422,6267,12108
󽨽ֵ,KuangJianJieDao,410481005,3349,631,2320,1426,4270,2229,849,2309,4538,2509,4829
е,ShangDianZhen,410481100,26828,4041,18541,10842,37781,18183,8356,20040,38223,20684,39225
̨,BaTaiZhen,410481101,18434,3268,12883,7800,25898,12715,4764,13283,25998,13583,26466
,YinJiZhen,410481102,16180,3104,10986,7699,22741,10974,4135,12260,23234,12433,23419
,ZaoLinZhen,410481103,32792,5980,22613,14116,46015,22324,8038,23880,46204,24197,46810
,MiaoJieXiang,410481202,10013,1657,6793,3852,14247,6628,2759,7347,13975,7636,14429
ɽ,TieShanXiang,410481203,16311,2447,10822,5546,21850,9557,3859,9941,19498,11795,22617
书,WuGongXiang,410481204,17469,3218,11656,6935,23759,10762,4051,11758,22520,13082,24738
ׯ,YangZhuangXiang,410481205,17951,2967,12043,7369,24623,11919,4887,13399,25318,13762,25805
úɽֵ,MeiShanJieDao,410482001,39678,3392,26769,14902,35846,26372,11353,27236,53608,27654,54423
Ѩ·ֵ,FengXueLuJieDao,410482002,27753,2338,18107,8977,26050,16389,6568,16873,33262,18552,36659
¥ֵ,ZhongLouJieDao,410482003,27647,2907,18778,10235,31115,18705,7798,19374,38079,19574,38352
ϴӽֵ,XiErHeJieDao,410482004,30335,2727,19505,9164,33734,17684,7727,18259,35943,21284,40789
Ͻֵ,RuNanJieDao,410482005,24220,2768,16868,8521,34241,16674,8315,18027,34701,18435,35303
,JiLiaoZhen,410482101,37165,4453,25636,13828,51595,25588,11364,27287,52875,27346,52982
Ȫ,WenQuanZhen,410482102,33904,3711,25013,11847,49380,24840,13138,25457,50297,25740,50753
,LinRuZhen,410482103,39225,4156,29350,12878,56259,29245,15428,29311,58556,29459,58809
С,XiaoTunZhen,410482104,57596,6382,41161,21221,78758,41093,20963,42916,84009,43780,84941
¥,YangLouZhen,410482105,37002,4234,27530,14323,54594,27449,14609,28181,55630,28315,55845
,MangChuanZhen,410482106,37711,4720,27598,14032,53347,27532,15047,29649,57181,29880,57478
կ,WangZhaiXiang,410482202,27690,3900,20533,11346,40258,20533,10458,21515,42048,21515,42048
ͷ,LingTouXiang,410482203,28100,3845,21602,10366,42021,21590,11693,22026,43616,22036,43638
,MiaoXiaXiang,410482204,43470,4381,31491,14437,61314,31478,16025,32346,63824,32385,63876
ֽ,ZhiFangXiang,410482205,40568,5844,30094,16513,59044,29677,14379,30326,60003,30697,60791
ׯ,ShangZhuangXiang,410482206,27435,4487,20565,11890,40370,20560,9402,20727,41287,20759,41324
,QiLingXiang,410482207,28437,3125,20280,10033,39574,20229,9754,20888,41117,21036,41316
,DaYuXiang,410482208,13826,2253,9744,5545,20126,9734,4602,10868,20602,10937,20681
ĵ,XiaDianXiang,410482209,18021,2203,13509,6350,26657,13509,7231,13946,27455,13946,27455
,JiaoCunXiang,410482210,13335,2151,10048,5973,19857,10040,4985,10390,20430,10423,20471
ֵֽ´,DongDaJieJieDaoBanShiChu,410502001,4995,877,3511,2291,6516,3510,1020,3380,6890,3381,6892
ͷֵ´,TouErSanJieDaoBanShiChu,410502002,7030,1123,4994,3448,7136,4954,1613,4703,9657,4772,9766
ˮֵ´,TianShuiJingJieDaoBanShiChu,410502003,7772,1087,5485,3642,6998,5478,1774,5148,10626,5148,10633
ؽֵ´,DongGuanJieDaoBanShiChu,410502004,27976,2487,17965,11634,23897,17835,5954,17474,35309,18452,36417
Ϲؽֵ´,NanGuanJieDaoBanShiChu,410502005,40186,3363,26979,15305,37056,24196,8817,24033,48229,25387,52366
ֵֽ´,XiDaJieJieDaoBanShiChu,410502006,5629,1016,3981,2833,5777,3954,1106,3758,7712,3770,7751
ֵֽ´,BeiDaJieJieDaoBanShiChu,410502008,4468,789,3247,2238,4106,3142,1020,2983,6125,3030,6277
ؽֵ´,XiGuanJieDaoBanShiChu,410502011,14262,1575,9604,6389,12003,9583,3162,9368,18951,9395,18999
ޱֵ´,ZiWeiDaDaoJieDaoBanShiChu,410502012,31716,3324,21315,13384,29319,21023,7391,20734,41757,21116,42431
⻪·ֵ´,GuangHuaLuJieDaoBanShiChu,410502013,22941,1854,15443,9411,18443,15020,5576,14882,29902,14928,30371
·ֵ´,YongMingLuJieDaoBanShiChu,410502014,9252,855,6218,3475,7369,6037,2125,5862,11899,6014,12232
л·ֵ´,ZhongHuaLuJieDaoBanShiChu,410502015,15217,1099,10274,6092,16438,10249,4676,10485,20734,10718,20992
,BaoLianSiZhen,410502101,35566,3012,24420,12250,46070,24406,11080,25229,49635,25238,49658
ׯ,GaoZhuangXiang,410502200,37834,3152,26174,12862,49121,26114,12455,26849,52963,27267,53441
Ҵֵֽ´,KaiFaQuEMeiDaJieJieDaoBanShiChu,410502563,30402,1318,17037,7053,15948,11365,4411,11337,22702,19094,36131
Ӵֵֽ´,KaiFaQuYinXingDaJieJieDaoBanShiChu,410502564,17167,1221,11294,6760,13643,11151,4429,11190,22341,11523,22817
̴ֵֽ´,KaiFaQuShangSongDaJieJieDaoBanShiChu,410502565,23637,427,16364,2063,6435,3799,1647,3721,7520,9347,25711
·ֵ´,HongQiLuJieDaoBanShiChu,410503001,26995,3734,18703,11134,31418,17887,5540,17194,35081,17566,36269
·ֵ´,JieFangLuJieDaoBanShiChu,410503003,12899,1834,8355,5237,12372,8170,2124,7817,15987,8502,16857
·ֵ´,DengTaLuJieDaoBanShiChu,410503004,21997,3093,15445,9166,23250,15249,5480,14795,30044,15125,30570
Ӫֵ´,DouFuYingJieDaoBanShiChu,410503005,32074,3896,22016,14423,28010,21759,7419,21049,42808,21373,43389
䡱ֵ´,HuanBeiJieDaoBanShiChu,410503006,13701,1568,9795,5815,12780,8692,3011,8437,17129,8485,18280
öֵ´,ZhangDongJieDaoBanShiChu,410503008,19528,1805,13128,7123,21669,13122,5079,13256,26378,13284,26412
ñֵ´,ZhangBeiJieDaoBanShiChu,410503009,21059,2002,14146,8505,23673,14115,5302,14178,28293,14217,28363
·ֵ´,MinHangLuJieDaoBanShiChu,410503010,7092,997,4879,3056,4908,4435,1338,4318,8753,4548,9427
·ֵ´,ShuGuangLuJieDaoBanShiChu,410503011,17869,1308,12260,6847,13495,10522,3951,10426,20948,10868,23128
з֯ҵίԱ,AnYangShiFangZhiChanYeJiJuQuGuanLiWeiYuanHui,410503012,9726,774,6417,3259,10697,5701,2429,6001,11702,6512,12929
÷԰ׯֵ´,MeiYuanZhuangJieDaoBanShiChu,410505001,48900,5361,31636,23680,54122,31069,10283,32077,63146,32908,64544
ֵ´,LiZhenJieDaoBanShiChu,410505002,3632,533,1433,1535,4279,1410,362,1788,3198,3094,4527
糧·ֵ´,DianChangLuJieDaoBanShiChu,410505003,5142,906,3240,2531,6212,3113,812,3369,6482,3620,6860
ɴ·ֵ´,ShaChangLuJieDaoBanShiChu,410505004,10316,1831,7287,4943,11790,7272,2002,6845,14117,6862,14149
·ֵ´,TieXiLuJieDaoBanShiChu,410505005,32126,3290,21453,13378,24945,20562,6853,20290,40852,20816,42269
ˮұֵ´,ShuiYeJieDaoBanShiChu,410505006,5895,586,3487,2481,6734,3224,1229,3226,6450,4223,7710
ֵֽ´,QingFengJieJieDaoBanShiChu,410505007,15052,1763,10077,6520,14334,10077,3173,9908,19985,9911,19988
ɽֵ´,BeiMengJieDaoBanShiChu,410505008,19151,1888,12731,6933,22935,12649,4809,12819,25468,13117,25848
ֵ̨´,XiangTaiJieDaoBanShiChu,410505009,15789,1184,10160,6053,15222,10105,3949,10686,20791,10762,20922
,XiJiaoXiang,410505200,27170,2315,18072,9619,32557,18056,7572,18906,36962,18985,37057
ֵ´,TianCunJieDaoBanShiChu,410506001,6943,611,4784,2403,8908,4784,2029,4799,9583,4799,9583
ֵ´,ZhangWuJieDaoBanShiChu,410506002,16996,1410,10786,6304,20466,10750,4439,11487,22237,12059,22845
Ĳֵ´,WenChangDaDaoJieDaoBanShiChu,410506003,15086,1064,9708,5760,11273,9595,3529,9684,19279,9971,19679
ֵ´,WenMingDaDaoJieDaoBanShiChu,410506004,5226,700,3504,2496,5131,3504,1073,3495,6999,3495,6999
̫Сֵ´,TaiHangXiaoQuJieDaoBanShiChu,410506005,13226,1510,8876,6088,11403,8860,2961,8808,17668,8821,17697
·ֵ´,ZhongZhouLuJieDaoBanShiChu,410506006,1592,177,1061,756,1214,1061,364,1069,2130,1072,2133
Ȫ,LongQuanZhen,410506100,23079,2139,14395,8056,27822,14394,5395,15084,29478,16218,30613
,DongFengXiang,410506201,41277,3057,27284,14557,46661,27252,10829,27795,55047,27879,55163
Ͷ,MaTouJianXiang,410506202,36546,3206,23811,13222,47267,23811,9992,25920,49731,25933,49744
ˮұ,ShuiYeZhen,410522101,65497,5258,42678,24289,72447,41048,16274,42688,83736,44351,87029
ͭұ,TongYeZhen,410522102,26030,2098,16855,9124,30676,16663,7250,17050,33713,18523,35378
Ӧ,ShanYingZhen,410522103,16703,1592,11850,7171,22862,11850,5475,11919,23769,11920,23770
ׯ,BaiZhuangZhen,410522105,27380,2150,18366,11312,31045,18328,7612,18725,37053,18776,37142
,BaiBiZhen,410522106,47809,4178,33758,17327,56705,30422,13905,29405,59827,32134,65892
,QuGouZhen,410522107,42051,3609,28259,15668,53624,27535,11580,28431,55966,28981,57240
,LvCunZhen,410522108,37914,4053,31808,16352,53394,31440,14934,24719,56159,25093,56901
,LunZhangZhen,410522109,21836,2378,16308,9594,29437,16269,7106,14926,31195,15012,31320
,JiangCunXiang,410522200,27971,2627,18793,12061,34790,18656,7799,19401,38057,19604,38397
,DouLiXiang,410522202,13712,1206,9348,5104,17568,9339,3891,9437,18776,9461,18809
ڿ,LeiKouXiang,410522203,13349,1393,10151,6061,18014,10044,4354,8689,18733,8945,19096
ҹ,XuJiaGouXiang,410522204,25563,2082,17742,10224,32968,17731,7900,17700,35431,17803,35545
,MaJiaXiang,410522205,16252,1440,12517,7540,22038,12517,5279,10454,22971,10454,22971
޼,CuiJiaQiaoZhen,410522209,30163,3144,23984,12055,40973,22740,11340,19849,42589,20663,44647
,AnFengXiang,410522210,31581,3643,25010,14955,44606,25003,11712,21845,46848,21926,46936
,HongHeTunXiang,410522211,23979,2706,17193,10238,31253,17175,6436,15891,33066,15928,33121
,HanLingXiang,410522212,16015,1925,13456,7382,22853,13390,6544,11024,24414,11028,24484
,YongHeXiang,410522213,26787,2946,21693,11293,37731,21660,10334,18308,39968,18374,40067
ߵ,WaDianXiang,410522214,24456,2583,21120,11712,35876,20985,10843,16571,37556,16762,37882
,BeiGuoXiang,410522216,26913,3001,22718,11428,38796,22718,10338,17534,40252,17534,40252
,XinCunXiang,410522217,32608,3856,31122,15495,51235,31109,15714,21030,52139,21056,52178
ǹ,ChengGuanZhen,410523100,52912,4547,35947,19881,56571,32837,14587,33453,66290,36099,72046
԰,CaiYuanZhen,410523101,30845,3773,24559,12717,42195,24549,11221,21243,45792,21280,45839
ι,RenGuZhen,410523102,30712,3473,24490,12297,41764,24462,12516,22163,46625,22211,46701
,WuLingZhen,410523103,25143,3138,20133,10907,34913,20125,9678,17776,37901,17826,37959
˹,YiGouZhen,410523104,38610,3992,27259,14638,50893,27256,12297,27605,54861,27640,54899
ׯ,HanZhuangXiang,410523200,31225,2668,21486,10420,37780,20522,9427,20924,41446,21834,43320
Ӫ,BaiYingXiang,410523201,23038,2338,16528,8859,29820,16519,7466,16278,32797,16314,32842
,GuXianXiang,410523202,18744,2208,14723,7717,25879,14720,6836,13030,27750,13065,27788
߸,WaGangXiang,410523203,18363,2531,16148,9045,26289,16147,7873,12558,28705,12619,28767
,FuDaoXiang,410523204,27584,3118,20463,11061,36958,20409,9940,19988,40397,20179,40642
,DaoKouZhen,410526100,49290,4487,32578,16403,52598,29404,11804,29595,58999,33003,65581
ǹ,ChengGuanZhen,410526101,60864,5300,43019,21364,72193,39569,19478,40537,80106,42623,85642
׵,BaiDaoKouZhen,410526102,45417,4820,31799,16816,62932,31437,14131,32309,63746,32569,64368
,LiuGuZhen,410526103,53704,6484,37294,20818,75039,37293,15563,38451,75744,38457,75751
Ϲ,ShangGuanZhen,410526104,48273,6116,36052,19954,69799,35328,17931,35770,71098,36268,72320
ţ,NiuTunZhen,410526105,47357,5884,34757,18907,65963,34730,16066,34454,69184,34550,69307
,WanGuZhen,410526106,37434,4515,27357,17102,54462,27353,13683,28252,55605,28275,55632
ƽ,GaoPingZhen,410526107,38809,5327,30548,18292,58421,30545,16217,29803,60348,29805,60353
ׯ,WangZhuangZhen,410526108,40214,4545,29481,16241,56701,29420,13732,28917,58337,29010,58491
ϵ,LaoDianZhen,410526109,49034,5818,35993,20006,69096,35993,17684,36542,72535,36543,72536
,ZaoCunXiang,410526200,28574,3146,20984,11300,41049,20984,10201,20935,41919,20937,41921
ļ䷿,SiJianFangXiang,410526201,28111,3744,19432,10642,38493,19424,7355,19765,39189,19778,39210
Ӫ,BaLiYingXiang,410526202,43006,5094,31645,18552,61583,31599,14675,31052,62651,31130,62775
Ӫ,ZhaoYingXiang,410526203,25271,2909,18236,10286,35807,18090,8816,18595,36685,18760,36996
կ,DaZhaiXiang,410526204,30694,3732,22510,12387,43322,22505,10768,22660,45165,22684,45194
ɣ,SangCunXiang,410526205,24349,2979,18681,10417,36355,18675,9688,18315,36990,18335,37016
ү,LaoYeMiaoXiang,410526206,38475,4480,28587,16299,56331,28030,14849,28838,56868,29217,57804
կ,CiZhouZhaiXiang,410526208,34364,4462,24871,14435,50120,24785,12393,26260,51045,26348,51219
߸կ,WaGangZhaiXiang,410526209,25413,3407,18563,10178,36393,18561,8693,18948,37509,18950,37513
,JiaoHuXiang,410526210,36391,4919,26705,15600,52659,26674,12218,26801,53475,26823,53528
µ,BanPoDianXiang,410526211,29739,5016,24553,14010,44567,24497,11435,21575,46072,21637,46190
С,XiaoPuXiang,410526212,30940,3246,21848,12062,42686,21837,10206,22528,44365,22544,44392
ίԱ,HuaXianXinQuGuanLiWeiYuanHui,410526400,21402,1639,14819,6842,20112,13517,6509,13617,27134,14731,29550
ǹ,ChengGuanZhen,410527100,76141,6449,51022,21981,85775,46307,23921,48999,95306,55489,106511
ׯ,DongZhuangZhen,410527101,35236,4926,27332,14537,48633,27325,11899,24720,52045,24729,52061
,JingDianZhen,410527102,28134,3196,19115,10384,37062,19013,7760,19900,38913,19975,39090
ׯ,LiangZhuangZhen,410527103,27910,3213,18667,10266,37886,18667,8122,20578,39245,20578,39245
,HouHeZhen,410527104,29574,2905,20164,10934,38813,20144,9847,22089,42233,22162,42326
,ChuWangZhen,410527105,23434,2623,16614,7403,31876,15744,7721,16005,31749,17164,33778
,TianShiZhen,410527106,31543,3377,22832,10038,43109,22819,11082,23147,45966,23170,46002
,ZhangLongXiang,410527200,20744,2601,15844,8718,30033,15742,7705,15103,30845,15206,31050
,MaShangXiang,410527201,29545,3370,21468,10915,41520,21467,10996,22443,43910,22443,43911
ߵ,GaoDiXiang,410527202,22839,2791,17300,9357,33192,17300,8234,16564,33864,16564,33864
,BoChengXiang,410527203,30054,3428,21447,12173,43144,21446,9991,22026,43472,22026,43473
,ErAnXiang,410527204,27973,3081,19455,10303,38462,19429,8603,20179,39608,20202,39657
,LiuCunXiang,410527205,19444,2526,14210,9068,26672,14205,5996,13752,27957,13756,27966
,ZhongZhaoXiang,410527206,19378,2530,13968,8193,26167,13968,6292,14225,28193,14232,28200
δ,SongCunXiang,410527207,20725,2248,15134,7637,29146,15128,7129,14961,30089,14968,30102
ʯ,ShiPanTunXiang,410527209,20937,2452,14913,7055,29126,14906,6139,14596,29502,14615,29528
,DouGongXiang,410527210,18843,2267,13703,7388,26092,13703,5624,13029,26732,13031,26734
Ԫֵ´,KaiYuanJieDaoBanShiChu,410581001,33046,1853,21048,11921,29259,19533,7948,20092,39625,21799,42847
ֵֽ´,ZhenLinJieDaoBanShiChu,410581002,29985,1552,18666,10809,30474,17805,6817,18875,36680,19688,38354
ɽֵ´,LongShanJieDaoBanShiChu,410581003,20014,1349,12488,7632,23796,12446,4571,13385,25831,13446,25934
԰ֵ´,GuiYuanJieDaoBanShiChu,410581004,23516,1305,14828,8673,22938,14799,5699,15625,30424,15692,30520
Ͻ,HeJianZhen,410581101,31182,4621,27577,17177,43106,27566,10190,18294,45860,18416,45993
,LinQiZhen,410581102,43371,5887,40844,22298,63269,39930,18693,25784,65714,27107,67951
Ҧ,DongYaoZhen,410581103,26217,3740,23862,14127,35946,23613,8133,14001,37614,14228,38090
ˮ,HengShuiZhen,410581104,41230,5080,37022,22614,55678,36858,14623,23575,60433,23911,60933
˳,HeShunZhen,410581105,32963,3814,28163,15896,43253,27512,10625,18578,46090,19239,47402
δ,RenCunZhen,410581106,21295,2791,18705,11839,28769,18670,6875,11994,30664,12256,30961
Ҧ,YaoCunZhen,410581107,51789,5231,41795,21569,65891,41193,17187,31487,72680,32412,74207
,LingYangZhen,410581108,16978,1455,11139,6416,20171,11103,3973,11029,22132,11267,22406
ԭ,YuanKangZhen,410581109,18475,2901,16118,10114,26030,16021,6272,11338,27359,11530,27648
,WuLongZhen,410581110,27419,3703,26858,14787,40560,26846,12967,17201,44047,17231,44089
ɣ,CaiSangZhen,410581111,20888,3080,21338,12064,30445,21325,8403,10969,32294,11033,32371
,DongGangZhen,410581112,22114,2957,20533,12180,30862,20531,8227,12739,33270,12765,33298
,GuiLinZhen,410581113,18835,3100,17894,10680,27548,17873,7149,11079,28952,11190,29084
ǽ,ChengJiaoXiang,410581200,49810,5840,40927,22968,62554,40803,14636,29130,69933,29359,70286
,ChaDianXiang,410581202,13682,2711,14221,8518,20932,14212,5433,7579,21791,7605,21826
ʯ,ShiBanYanXiang,410581203,3783,646,3051,2054,5291,2911,1073,2239,5150,2451,5502
бֵ,ZhongBeiJieDao,410602001,10206,1790,6432,3678,13268,6432,1526,6605,13037,7090,13522
ɽ·ֵ,ZhongShanLuJieDao,410602002,12373,2092,8164,5365,16267,8164,2207,8506,16670,8508,16672
»ֵֽ,XinHuaJieJieDao,410602003,5294,633,3329,2561,6587,3329,1105,3703,7032,3703,7032
ɽֵֽ,HeShanJieJieDao,410602004,8400,1067,4921,3071,8750,4905,1340,5177,10082,5886,10807
ſ㳡ֵ,JiuKuangGuangChangJieDao,410602005,2583,211,1100,809,2381,1100,344,1246,2346,2038,3138
ױڼ,HeBiJiZhen,410602100,48520,3478,31301,16890,59371,31301,11734,32431,63732,32431,63732
ɽ,JiJiaShanXiang,410602201,12894,1121,8097,4246,13184,7972,2503,8238,16210,8421,16518
ֵ,HongQiJieDao,410603001,41848,4433,27505,17194,47444,26451,8762,26585,53036,27538,55043
·ֵ,ChangFengZhongLuJieDao,410603002,20432,1840,12948,8400,20654,12939,4380,13697,26636,13704,26652
ɽ·ֵ,ShanChengLuJieDao,410603003,17026,2290,11354,7006,21983,11317,3727,11637,22954,11689,23043
ӽֵֽ,TangHeJieJieDao,410603004,13257,1980,8804,5404,14732,8507,2739,8711,17218,9172,17976
¹¥ֵ,LuLouJieDao,410603005,11464,1101,6585,4352,12215,6461,2182,6775,13236,8162,14747
ʯ,ShiLinZhen,410603100,31602,2315,20535,10135,40014,20048,9066,21252,41300,22448,42983
¹¥,LuLouXiang,410603201,37935,2586,24462,11665,46974,24353,10003,25388,49741,26062,50524
ɽ´,JinShanBanShiChu,410611001,9390,789,6201,3129,11489,6170,2759,6378,12548,6737,12938
,DaLaiDianZhen,410611100,17171,1453,12347,5985,23742,12347,6519,12796,25143,12796,25143
,JuQiaoZhen,410611101,27815,2213,19414,9428,38934,19146,10307,20719,39865,20921,40335
,ShangYuXiang,410611200,6154,779,4090,2529,7872,4088,1631,4468,8556,4474,8564
ӽ,DaHeJianXiang,410611201,10398,946,6756,3700,12330,6747,2664,7180,13927,7252,14008
·ֵ,JiuZhouLuJieDao,410611560,66634,5447,44238,24843,72664,40910,15659,41496,82406,43502,87740
·ֵ,LiYangLuJieDao,410611561,32711,2970,21645,13470,31260,21495,8667,21814,43309,22703,44348
·ֵ,ChangJiangLuJieDao,410611562,13074,1681,9463,4921,14079,9001,4059,8933,17934,9351,18814
·´,HaiHeLuBanShiChu,410611563,5826,436,4427,1697,6429,3450,2531,3504,6954,4366,8793
·´,BoHaiLuBanShiChu,410611564,4296,201,2558,975,3222,1851,949,1975,3826,2888,5446
´,DongYangBanShiChu,410611565,4282,330,2998,1474,5491,2991,1591,3182,6173,3205,6203
ǹ,ChengGuanZhen,410621100,39437,3545,26445,12919,49649,23653,10884,24556,48209,27421,53866
,ShanTangZhen,410621101,64900,6811,46851,25245,94176,46845,25210,49999,96844,50070,96921
,TunZiZhen,410621102,54343,5161,39306,18919,78259,39248,20348,40437,79685,40546,79852
,XinZhenZhen,410621104,57960,5587,41162,20088,82263,40953,19773,41840,82793,42158,83320
С,XiaoHeZhen,410621105,50590,4835,35625,17296,70852,35621,17757,37546,73167,37557,73182
,LiYangZhen,410621106,65663,5743,46436,22429,89908,46055,24281,49002,95057,49251,95687
,WeiXianZhen,410621107,42582,3978,30686,15201,60561,30661,16591,32398,63059,32465,63151
ׯ,WangZhuangXiang,410621200,49401,5173,35867,18520,72236,35830,18942,37594,73424,37649,73516
,BaiSiXiang,410621201,30773,3072,22320,10866,43287,22028,11998,23202,45230,23523,45843
,ZhaoGeZhen,410622100,37497,3121,26334,13927,43234,26267,13181,27305,53572,27465,53799
ߴ,GaoCunZhen,410622101,32712,2712,23061,11657,44203,23039,12183,24471,47510,24546,47607
,BeiYangZhen,410622102,27280,2351,19612,9655,37871,19551,11207,21026,40577,21226,40838
,XiGangZhen,410622103,35234,3352,24844,12446,48039,24841,12736,26472,51313,26478,51322
,MiaoKouZhen,410622104,21399,1911,15283,7686,29032,15275,8108,16112,31387,16135,31418
,QiaoMengXiang,410622200,23404,1994,16736,8559,30779,16644,9206,17770,34414,17868,34604
ƶ,HuangDongXiang,410622202,6973,962,4694,2876,9305,4694,1626,4859,9553,4867,9561
ֵֽ´,XiJieJieDaoBanShiChu,410702001,12003,1704,8070,5798,10493,7965,1915,7452,15417,7552,15622
ֵֽ´,DongJieJieDaoBanShiChu,410702002,19667,2680,13273,9102,20176,13176,3760,12681,25857,12834,26107
ֵ´,QuDongJieDaoBanShiChu,410702003,32909,3567,21341,14117,30662,21140,6582,21053,42193,21717,43058
Ļֵֽ´,WenHuaJieJieDaoBanShiChu,410702007,24388,3447,17040,10365,28855,16868,5635,16288,33156,16430,33470
Сֵ´,XiangYangXiaoQuJieDaoBanShiChu,410702009,25743,2781,17065,11345,25897,16854,5400,16596,33450,16859,33924
,HongMenZhen,410702100,96201,4670,58960,17854,45611,29689,11271,29922,59611,53182,112142
С,XiaoDianZhen,410702101,20637,2221,14383,6783,28009,14365,6404,14793,29158,14879,29262
ص,KaiFaQuGuanDiXiang,410702360,28168,2740,19902,8683,37964,19860,9265,20145,40005,20271,40173
繤ҵ԰,XinXiangGongYeYuanQu,410702400,12413,966,7745,3159,13419,6764,3380,6925,13689,9014,16759
ֵ´,KaiFaQuJieDaoBanShiChu,410702560,31240,2497,20534,13550,16890,20458,7036,20008,40466,20239,40773
ʤ·ֵ´,ShengLiLuJieDaoBanShiChu,410703001,9780,1015,6323,4285,9137,6114,1911,6228,12342,6383,12706
·ֵ´,JieFangLuJieDaoBanShiChu,410703002,14440,1560,9431,4509,12221,6750,1910,6321,13071,8479,17910
ֵֽͬ´,ZhongTongJieJieDaoBanShiChu,410703003,12965,1900,8694,5636,14090,8489,2485,8441,16930,8656,17350
·ֵ´,JianKangLuJieDaoBanShiChu,410703004,15788,2598,11440,7051,19137,11396,3606,10529,21925,10552,21992
·ֵ´,ZiYouLuJieDaoBanShiChu,410703007,8027,1217,5419,3589,8645,5381,1488,5035,10416,5313,10732
Žֵ´,NanQiaoJieDaoBanShiChu,410703008,29386,3908,19866,13038,32118,19800,6265,19646,39446,19693,39559
ֵ´,TieXiJieDaoBanShiChu,410703009,18284,2801,12047,8767,18886,12015,3037,11798,23813,12075,24122
ƽԭ,PingYuanXiang,410703200,35264,3626,24777,11932,45361,24731,10245,24240,48971,24358,49135
ֵ´,BaoXiJieDaoBanShiChu,410704001,20227,1548,9303,6381,14519,9171,3356,9306,18477,15828,25131
ֵ´,BaoDongJieDaoBanShiChu,410704002,3391,588,2230,1712,3736,2228,560,2304,4532,2309,4539
,DaKuaiZhen,410704100,36063,3191,25080,10801,47884,24974,11879,25876,50850,26053,51133
º,LuWangFenXiang,410704200,18893,1988,12809,6375,25448,12806,5219,13288,26094,13291,26100
,GengHuangXiang,410704201,27519,2786,18404,9237,35898,18399,7090,18977,37376,18991,37395
ɵֵ´,DongGanDaoJieDaoBanShiChu,410711001,47766,4581,33092,12845,31072,18311,4922,17558,35869,24177,57269
У·ֵ´,RongXiaoLuJieDaoBanShiChu,410711002,21489,3090,14316,8463,20530,12853,3580,12262,25115,13843,28159
ɵֵ´,BeiGanDaoJieDaoBanShiChu,410711003,31231,5008,17013,11857,35194,16965,4656,16548,33513,23882,40895
԰ֵ´,HuaYuanJieDaoBanShiChu,410711004,20098,3330,13927,9423,23567,13925,3758,13235,27160,13259,27186
ֵ´,WeiBeiJieDaoBanShiChu,410711005,15184,3629,10781,7627,18043,10756,2559,10509,21265,10591,21372
»·ֵ´,XinHuiLuJieDaoBanShiChu,410711006,20445,2986,13673,9388,21556,13643,3936,13630,27273,13694,27367
ƽ·ֵ´,HePingLuJieDaoBanShiChu,410711007,8993,746,5923,2880,10822,5908,2656,5905,11813,6472,12395
,WangCunZhen,410711100,25588,2670,17172,8642,26939,16980,6655,17188,34168,17741,34913
Ұ,MuYeXiang,410711201,37866,3851,26264,12677,46535,26135,10760,25944,52079,26213,52477
һѧԴҵ԰,GuoJiaHuaXueYuWuLiDianYuanChanYeYuan,410711400,11462,1116,7920,3577,15584,7916,3383,8036,15952,8041,15961
,ZhaiPoZhen,410721101,27005,2727,18727,8419,34990,18208,8073,18624,36832,19078,37805
С,XiaoJiZhen,410721102,29664,2997,20347,9795,36119,20143,8850,20956,41099,21164,41511
Ӫ,QiLiYingZhen,410721103,67127,7429,45820,20202,90696,45336,20024,48350,93686,48760,94580
ʹ,LangGongMiaoZhen,410721104,40194,4287,28239,12666,55039,28201,13613,29727,57928,29855,58094
Źկ,GuGuZhaiZhen,410721105,26763,2687,18892,8438,36814,18883,9022,19564,38447,19580,38472
Ӫ,DaZhaoYingZhen,410721107,13857,1364,9710,4345,18238,9694,4205,9661,19355,9716,19426
Ϻ,HeHeXiang,410721200,22898,2527,16254,7743,31682,16254,7482,16652,32906,16653,32907
羭ÿ,XinXiangJingJiKaiFaQu,410721560,12325,1046,8499,3945,12117,7727,3776,7922,15649,8648,17147
ǹ,ChengGuanZhen,410724100,35425,3211,24431,16036,40768,24315,10927,24930,49245,25132,49563
վ,ZhaoJingZhen,410724101,23566,2849,16838,8204,32379,16832,7300,16857,33689,16877,33715
Ƶ,HuangDiZhen,410724102,14770,1550,10421,4900,20801,10417,5065,10962,21379,10964,21385
к,ZhongHeZhen,410724103,17465,2352,13089,6083,24485,13076,6308,13023,26099,13036,26125
Ӫ,XuYingZhen,410724104,21652,2678,16046,7315,30998,16046,7674,15958,32004,15958,32004
ׯ,FengZhuangZhen,410724105,28195,3174,19798,9377,39433,19791,8740,20301,40092,20311,40109
,KangCunZhen,410724106,30134,3343,21388,9831,41269,21388,9631,21716,43104,21720,43108
ʷׯ,ShiZhuangZhen,410724107,29276,3357,20734,9926,39732,20728,9125,21010,41738,21024,41758
λׯ,WeiZhuangXiang,410724200,19567,2019,14001,6723,24286,13978,6728,14286,28264,14313,28314
ׯ,DaXinZhuangXiang,410724203,27026,2990,19510,8744,38110,19510,9071,19577,39087,19577,39087
̫ɽ,TaiShanXiang,410724204,27112,2951,19352,8721,38167,19352,9153,19863,39215,19864,39216
ίԱ,XiGongQuGuanLiWeiYuanHui,410724560,6247,699,4224,2571,7796,4211,1620,4328,8539,4342,8566
ǹ,ChengGuanZhen,410725100,38589,3432,25002,12000,44593,23906,10069,25679,49585,27088,52090
ԭ,YuanWuZhen,410725101,16243,1827,11596,5022,23318,11543,5792,12144,23687,12266,23862
ʦկ,ShiZhaiZhen,410725102,28861,3637,21463,9893,41754,21460,10672,21695,43155,21707,43170
,QiJieZhen,410725103,32458,3734,23138,11146,46198,22687,10429,23116,45803,23483,46621
̫ƽ,TaiPingZhen,410725104,26493,3099,18788,8551,38061,18667,8916,19404,38071,19720,38508
,FuNingJiZhen,410725105,29005,3560,20945,10060,42189,20943,10166,21780,42723,21786,42731
𲺿,GeBuKouXiang,410725200,34338,4141,24148,11776,44607,23934,11304,25385,49319,25635,49783
ף¥,ZhuLouXiang,410725203,19648,1906,13948,5675,27340,13882,6602,14124,28006,14208,28156
ű,QiaoBeiXiang,410725204,19501,2086,14315,6235,27284,14133,7206,14150,28283,14478,28793
ׯ,HanDongZhuangXiang,410725205,20694,2473,15507,6805,30543,15423,8395,15976,31399,16055,31562
ׯ,JiangZhuangXiang,410725206,20032,2668,15802,6773,29749,15798,8836,15730,31528,15734,31536
ٳ,GuanChangXiang,410725207,21897,3070,18225,8653,33928,18221,10049,16778,34999,16791,35016
,DaBinXiang,410725209,22087,3054,16540,8245,33146,16540,8205,16801,33341,16806,33346
,DouMenXiang,410725211,36568,5109,26919,12612,53632,26919,12771,27522,54441,27529,54448
·կ,LuZhaiXiang,410725215,22095,2813,16355,8566,32459,16355,7986,16538,32893,16539,32894
,YangAXiang,410725216,20151,3025,16504,8246,31170,16504,8310,14976,31480,14982,31486
,JinTangXiang,410725218,29745,3955,21796,10660,43410,21685,10907,22691,44376,22811,44607
ű,QiaoBeiXinZhen,410725400,7424,796,5343,2376,10420,5343,2551,5428,10771,5428,10771
ǹ,ChengGuanZhen,410726100,50394,3308,32416,14598,53419,27984,12933,30044,58028,34219,66635
,DongTunZhen,410726101,23076,2237,16105,7613,32080,16105,7453,16659,32764,16661,32766
ׯ,FengZhuangZhen,410726102,22587,2838,16304,8492,32065,16302,7121,16240,32542,16242,32546
ɮ,SengGuXiang,410726200,23447,2536,16701,8209,33218,16700,8365,17630,34330,17647,34348
ʯŹ,ShiPoGuXiang,410726201,30798,3376,22240,11005,45433,22233,11831,23757,45990,23765,46005
λ,WeiQiuXiang,410726202,31137,3490,22085,10782,45065,21893,10503,22843,44736,23045,45130
˾կ,SiZhaiXiang,410726203,26379,3337,18978,9780,38311,18921,9163,19755,38676,19901,38879
¥,WangLouXiang,410726204,19590,2530,14890,7734,28593,14877,7219,14407,29284,14449,29339
ׯ,MaZhuangXiang,410726205,30307,3540,22263,11198,44530,22180,11141,22616,44796,22725,44988
ѳ,ZuoChengXiang,410726206,22688,2610,16575,8443,33630,16574,8632,17355,33929,17355,33930
,YuLinXiang,410726207,19186,2070,13711,6523,27652,13707,7032,14566,28273,14577,28288
С̶,XiaoTanXiang,410726208,24504,2536,17725,8470,35762,17725,9386,18700,36425,18701,36426
ǹ,ChengGuanZhen,410727100,42985,3250,28361,14142,56447,27807,13250,30239,58046,31124,59485
,HuangLingZhen,410727101,24923,2735,17660,8665,35556,17647,7954,17920,35567,17952,35612
Ƶ,HuangDeZhen,410727102,21307,3057,15834,8245,31355,15834,7429,15954,31788,15959,31793
Ӧ,YingJuZhen,410727103,32429,4065,22779,11881,46498,22772,10785,24470,47242,24500,47279
,ChenQiaoZhen,410727104,31061,3742,21817,10811,43858,21817,9966,22952,44769,22952,44769
Ը,ZhaoGangZhen,410727105,36548,4424,25350,12912,52338,25262,11698,27036,52298,27320,52670
,LiuGuangXiang,410727106,31569,3860,22602,11049,45676,22592,10602,23385,45977,23429,46031
˵,PanDianXiang,410727107,36890,4216,25788,13086,52545,25786,11641,26957,52743,26959,52747
ǹ,ChengGuanXiang,410727200,34701,3931,24170,12354,48124,24169,10996,25453,49622,25458,49628
,HuiZuXiang,410727201,3617,384,2494,1126,5107,2494,1214,2716,5210,2721,5215
,WangCunXiang,410727202,29234,3151,20607,10497,41726,20606,9952,21729,42335,21730,42337
¹,ChenGuXiang,410727203,25110,2998,18181,9241,37006,18181,9022,18948,37129,18949,37130
,JuXiangXiang,410727204,19520,2102,13991,7603,28418,13990,6988,14610,28600,14619,28610
³,LuGangXiang,410727205,24658,3212,17821,9163,35574,17821,8034,18081,35902,18083,35904
,JingGongXiang,410727206,40177,4379,27177,13297,56331,27177,11852,29231,56408,29231,56408
ܸ,CaoGangXiang,410727208,21474,2549,15302,7780,31412,15301,7524,16239,31540,16245,31547
ׯ,LiZhuangXiang,410727210,17050,2274,12145,6245,24760,12145,5602,12780,24925,12781,24926
,YinGangXiang,410727211,18179,1981,12826,6467,25874,12725,6102,13272,25997,13436,26262
,FengCunXiang,410727212,23931,3061,17654,9124,35200,17654,8492,17830,35484,17830,35484
ֵ´,PuXiJieDaoBanShiChu,410728001,41452,2769,26160,10449,40030,20098,9588,21125,41223,27649,53809
Ѷֵ´,PuDongJieDaoBanShiChu,410728002,55023,4691,36734,16069,53620,32248,14537,33561,65809,37517,74251
ѽֵ´,NanPuJieDaoBanShiChu,410728003,35087,4559,25094,12376,50740,25094,11900,26451,51545,26452,51546
ѱֵ´,PuBeiJieDaoBanShiChu,410728004,15112,1792,10798,5527,21736,10794,5509,11599,22393,11615,22413
,DingLuanZhen,410728101,30697,3477,21971,11637,44917,21958,11364,23537,45495,23567,45538
,FanXiangZhen,410728102,28413,4009,20879,10980,42048,20879,10161,21704,42583,21704,42583
κׯ,WeiZhuangZhen,410728103,57868,6265,39261,19532,81582,39242,18252,43051,82293,43124,82385
,NaoLiZhen,410728104,36534,3827,24942,10987,52172,24607,11895,26879,51486,27314,52256
,ChangCunZhen,410728105,28364,3925,21274,11174,40647,21262,9070,20070,41332,20085,41359
Ե,ZhaoDiZhen,410728106,19488,2364,15700,8062,29128,15693,7335,13448,29141,13487,29187
ϸ,MengGangZhen,410728107,22754,3295,17945,9813,33093,17944,7474,15573,33517,15578,33523
,ManCunZhen,410728108,26809,2790,18089,8869,37517,18086,8125,19603,37689,19635,37724
կ,MiaoZhaiXiang,410728109,26980,3340,20972,10569,39190,20972,8922,18270,39242,18270,39242
կ,ZhangSanZhaiXiang,410728110,21965,3122,15815,7844,32868,15815,7792,17064,32879,17064,32879
«,LuGangXiang,410728202,29922,4085,23717,12398,43301,23716,9798,20043,43759,20088,43805
,FangLiXiang,410728205,25939,3311,20980,10941,39305,20973,10448,18675,39648,18718,39698
,WuQiuXiang,410728206,26537,3764,22765,11482,41119,22749,11117,18608,41357,18653,41418
ܼ,SheJiaXiang,410728208,32401,3301,22683,12431,45913,22676,10217,23199,45875,23236,45919
ˮ,JiShuiZhen,410781100,38382,3644,25727,13624,37719,23740,8911,23791,47531,25210,50937
̫,TaiGongZhen,410781101,19816,1807,13719,7138,27544,13712,6641,14542,28254,14545,28264
Ӵ,SunXingCunZhen,410781102,16531,1670,12068,5997,22941,12067,5545,11660,23727,11678,23746
,HouHeZhen,410781103,23401,2435,16717,8049,33315,16416,8232,16984,33400,17351,34068
Դ,LiYuanTunZhen,410781104,36738,3476,26843,13212,53469,26843,13910,27281,54124,27281,54124
ׯ,TangZhuangZhen,410781105,29154,2691,20565,10685,40857,20565,10366,21643,42208,21646,42211
ִ,ShangLeCunZhen,410781106,24317,2091,17190,8638,35323,17190,9120,18338,35528,18338,35528
ʨͷ,ShiBaoTouXiang,410781201,8838,1449,6282,3857,12269,6282,2122,6123,12405,6127,12409
,AnDouXiang,410781203,25601,2190,17514,8455,35151,17498,8145,18370,35868,18422,35936
ٷ,DunFangDianXiang,410781204,23587,2107,16154,8215,32833,16152,7462,16988,33140,17002,33156
ׯ,LiuZhuangXiang,410781205,20992,2012,14227,7146,28465,14223,6069,14832,29055,14846,29073
կ,PangZhaiXiang,410781206,17425,1818,12546,6464,24900,12545,6128,12820,25365,12825,25371
ǽ,ChengJiaoXiang,410781208,67218,6933,45229,21415,75981,36476,14579,36233,72709,43501,88730
ԭֳ,YuanZhongChang,410781400,325,3,200,99,293,200,102,230,430,230,430
ũ,DongFengNongChang,410781401,606,21,444,216,846,444,248,431,875,431,875
ũ,NongKeSuo,410781403,241,22,167,87,109,167,74,170,337,170,337
ũ,WuSiNongChang,410781404,374,32,253,165,549,253,143,296,549,296,549
ǹؽֵ´,ChengGuanJieDaoBanShiChu,410782001,57195,4403,37704,19783,55988,35290,13777,35349,70639,37671,75375
Žֵ´,HuQiaoJieDaoBanShiChu,410782002,27429,2208,17330,8624,29407,16084,5704,16591,32675,18011,35341
,BaoBiZhen,410782101,27468,2823,18168,10030,36195,18163,6275,18382,36545,18398,36566
,YuHeZhen,410782102,28388,4069,20934,11898,39047,20553,7325,18074,38627,18848,39782
Ȫ,BaiQuanZhen,410782103,69090,4602,44286,23795,61841,42551,16036,43829,86380,45442,89728
ׯ,MengZhuangZhen,410782104,47938,4480,31919,15490,59681,31226,12601,32188,63414,33100,65019
,ChangCunZhen,410782105,30298,3249,20048,11580,39091,20048,7389,20888,40936,20888,40936
,WuCunZhen,410782106,34354,4170,26970,14248,49501,26830,11635,23038,49868,23189,50159
ϴ,NanCunZhen,410782107,18350,1801,12313,7003,24342,12313,4196,12032,24345,12034,24347
կ,NanZhaiZhen,410782108,12989,1558,8442,5296,17315,8441,2788,8893,17334,8893,17335
ϰ,ShangBaLiZhen,410782109,11196,1311,7552,4581,14860,7552,2601,7555,15107,7556,15108
,BeiYunMenZhen,410782110,33324,3436,22844,12014,45194,22844,8645,22561,45405,22561,45405
ռ,ZhanChengZhen,410782111,22471,2702,15988,9153,30372,15982,5513,14693,30675,14698,30686
ˮ,HuangShuiXiang,410782200,5077,896,3861,2688,7296,3861,1413,3525,7386,3525,7386
ʯͷ,PaiShiTouXiang,410782201,4559,961,3236,2436,6296,3235,800,3084,6319,3084,6320
ׯ,GaoZhuangXiang,410782202,26792,2874,17885,10689,34664,17879,5541,17316,35195,17322,35207
Ŵ,ZhangCunXiang,410782203,9922,1126,6547,3711,12993,6545,2104,6602,13147,6605,13152
,JiTunXiang,410782204,28646,3683,21397,11622,39369,21356,7693,18510,39866,18625,40022
Թ,ZhaoGuXiang,410782205,29826,3032,19955,10619,38975,19955,7210,20113,40068,20113,40068
ƽ,XiPingLuoXiang,410782206,9885,1059,7009,4720,13225,6922,2518,6361,13283,6453,13462
,HongZhouXiang,410782207,7800,668,5110,2545,9945,5021,1841,5061,10082,5199,10309
ɳҤ,ShaYaoXiang,410782208,6730,940,4164,2789,8629,4164,1052,4558,8722,4558,8722
ֵ´,MinShengJieDaoBanShiChu,410802001,29879,3344,18191,9960,33489,15915,4785,15139,31054,19817,38008
ֵ´,MinZhuJieDaoBanShiChu,410802002,27852,2855,19084,11490,24593,17793,5795,17269,35062,17418,36502
»ֵ´,XinHuaJieDaoBanShiChu,410802003,18066,2117,12075,7382,18073,12058,3547,11631,23689,11655,23730
ֵ´,JiaoXiJieDaoBanShiChu,410802004,18844,2254,12044,8043,19923,12027,3385,12161,24188,12439,24483
Ͻֵ´,JiaoNanJieDaoBanShiChu,410802005,34149,4891,23435,14577,39811,23358,7016,22492,45850,22621,46056
ֵ´,JiaoBeiJieDaoBanShiChu,410802006,10942,1482,7339,4441,12041,7288,2321,6971,14259,7406,14745
߰ټֵ´,QiBaiJianJieDaoBanShiChu,410802007,18568,2033,12126,7285,17533,11532,3258,11154,22686,11733,23859
ϰֵ´,ShangBaiZuoJieDaoBanShiChu,410802008,22501,2264,13835,7585,20031,13333,4726,13470,26803,15656,29491
ҽֵ´,WangChuJieDaoBanShiChu,410802009,45827,3852,26241,14910,39065,26202,9142,26014,52216,32580,58821
ֵ´,LiFengJieDaoBanShiChu,410803001,12839,1642,8766,5126,13384,8558,2712,8272,16830,8427,17193
ֵ´,WangFengJieDaoBanShiChu,410803002,10213,1623,7066,4231,11325,7059,2109,6863,13922,6879,13945
ֵ´,ZhuCunJieDaoBanShiChu,410803003,4471,737,3112,1850,5310,3112,950,3046,6158,3046,6158
ֵ´,FengFengJieDaoBanShiChu,410803004,1088,122,661,492,1268,639,219,680,1319,768,1429
ֵ´,LongDongJieDaoBanShiChu,410803005,910,227,579,570,1102,578,123,625,1203,681,1260
ɽֵ´,YueShanJieDaoBanShiChu,410803006,1159,173,535,460,1123,526,87,578,1104,884,1419
ӽֵ´,DanHeJieDaoBanShiChu,410803007,0,0,0,0,0,0,0,0,0,0,0
ֵ´,XuHengJieDaoBanShiChu,410803008,23777,2794,16078,7945,29114,16070,5605,16036,32106,16098,32176
ǽֵ´,FuChengJieDaoBanShiChu,410803009,19517,2186,13357,7119,24315,13334,5484,13740,27074,13830,27187
ֵ´,LongXiangJieDaoBanShiChu,410803010,3771,532,2563,1602,4938,2563,994,2733,5296,2734,5297
ֵ´,MaCunJieDaoBanShiChu,410804001,19798,2239,12631,6907,21719,12577,4208,12530,25107,13614,26245
ɽֵ´,BeiShanJieDaoBanShiChu,410804002,1536,344,1085,690,1695,1076,424,1072,2148,1219,2304
Ӫֵ´,FengYingJieDaoBanShiChu,410804003,13226,805,6732,4193,11237,6671,2915,6840,13511,10214,16946
ɽֵ´,JiuLiShanJieDaoBanShiChu,410804004,5355,698,2474,1588,4690,2464,997,2511,4975,4576,7050
ֵ´,DaiWangJieDaoBanShiChu,410804005,26939,2767,18370,8732,31428,18176,7461,18594,36770,18797,37167
ǽֵ´,AnYangChengJieDaoBanShiChu,410804006,17319,1740,12099,5671,22884,12095,5543,12476,24571,12503,24602
ֵ´,YanMaJieDaoBanShiChu,410804007,18039,1708,12160,5733,22861,12131,5472,12797,24928,13059,25219
ֵ´,DongFangHongJieDaoBanShiChu,410811001,32827,4630,22265,12947,39771,22220,6330,21436,43656,21522,43787
ֵ´,JiaoDongJieDaoBanShiChu,410811002,16818,1678,11049,6812,16241,10834,3657,10810,21644,11104,22153
ټ䷿ֵ´,BaiJianFangJieDaoBanShiChu,410811003,4183,586,2870,1931,3801,2870,920,2816,5686,2819,5689
̫нֵ´,TaiHangJieDaoBanShiChu,410811004,19970,2074,12937,7561,17235,12864,4068,12863,25727,13175,26112
½ֵ´,YiXinJieDaoBanShiChu,410811005,27505,3211,18632,11127,30847,18435,5994,17741,36176,18078,36710
ǽֵ´,GuangYaJieDaoBanShiChu,410811006,22407,1409,14754,7186,14515,10674,3331,10587,21261,12393,27147
ͽֵ´,DingHeJieDaoBanShiChu,410811007,19940,1803,13086,8361,16927,13063,4157,12788,25851,12814,25900
ǽֵ´,ZhongXingJieDaoBanShiChu,410811008,19788,2052,13159,6645,21447,13011,4899,13131,26142,13580,26739
³ǽֵ´,XinChengJieDaoBanShiChu,410811009,45972,3037,29777,12799,36804,22745,8804,23047,45792,28036,57813
ֵ´,LiWanJieDaoBanShiChu,410811060,32384,1049,13623,4565,16574,8323,3480,8619,16942,23290,36913
Էֵ´,WenYuanJieDaoBanShiChu,410811061,11666,809,6793,2719,11028,6085,2683,6117,12202,8365,15158
ǹ,ChengGuanZhen,410821100,40843,3810,27393,14718,48267,27287,11355,28157,55444,28615,56008
ׯ,FangZhuangZhen,410821101,26778,2059,17041,9029,32314,16978,8040,17978,34956,19836,36877
ۨ,XunFengZhen,410821102,43886,5040,30228,14712,58762,30131,13264,31691,61822,31962,62190
ߴ,GaoCunXiang,410821202,36427,4124,25027,12462,49141,24952,10851,26135,51087,26375,51402
ׯ,ZhouZhuangXiang,410821203,15756,1662,10732,5027,21079,10732,4496,11182,21914,11182,21914
Դ,WuLiYuanXiang,410821204,26689,2841,18305,8755,35562,18278,8280,19476,37754,19505,37810
,AnShangXiang,410821205,2392,181,1617,747,2870,1559,696,1540,3099,1652,3269
,XiCunXiang,410821206,11105,1381,7553,4069,14303,7543,2916,7788,15331,7849,15402
СӪó,XiaoYingGongMaoQu,410821400,2090,257,1419,732,2653,1394,595,1471,2865,1523,2942
廯,BoAiXianQingHuaZhen,410822100,71367,6160,47681,23906,80970,47252,19245,48666,95918,49091,96772
ذɽ,BoAiXianBaiShanZhen,410822101,27615,2528,18364,8993,34497,18360,7618,19383,37743,19397,37761
ɽ,BoAiXianYueShanZhen,410822102,33816,2488,21956,9891,37201,19638,8801,20915,40553,23149,45105
,BoAiXianXuLiangZhen,410822103,34306,3057,23127,11350,44232,22956,10557,24640,47596,24793,47920
,BoAiXianYangMiaoZhen,410822104,25230,2413,16826,7916,32394,16489,7047,17529,34018,17864,34690
ĥͷ,BoAiXianMoTouZhen,410822105,21317,1764,14428,6863,27347,13968,6199,14492,28460,14852,29280
Т,BoAiXianXiaoJingZhen,410822106,32311,3723,22500,11165,43562,22500,9768,23301,45801,23302,45802
կ,BoAiXianZhaiHuoXiang,410822200,9530,943,6408,3412,12401,6407,2535,6596,13003,6600,13008
ؽ,BoAiXianJinChengXiang,410822203,36865,3993,25236,12337,49525,25231,10360,25973,51204,25982,51218
ռ,BoAiXianSuJiaZuoXiang,410822204,22700,2269,15702,7658,30868,15702,6970,16237,31939,16237,31939
Ӫũ,GuoYingBoAiNongChang,410822400,2076,323,1419,855,2524,1419,425,1405,2824,1405,2824
ľ,MuChengZhen,410823100,22914,1821,15511,7845,25232,14670,6863,15483,30153,16087,31598
ղ,ZhanDianZhen,410823101,29770,2931,21527,9778,42040,21397,10497,21530,42927,21671,43198
,XiTaoZhen,410823102,34288,3581,23854,10828,47123,23825,10754,24723,48548,24769,48623
лӪ,XieQiYingZhen,410823103,47998,4972,33996,14825,66798,33991,15424,34373,68364,34398,68394
,DaFengZhen,410823104,54542,5959,37675,16805,75493,37667,16190,38981,76648,39016,76691
,NingGuoZhen,410823105,21290,2223,14948,7049,29242,14912,6855,15346,30258,15420,30368
Դ,LongYuanZhen,410823106,62179,4736,40274,17068,50909,33700,14902,35269,68969,41543,81817
Ӧ,JiaYingGuanXiang,410823200,41059,3822,28943,13417,56227,28481,13714,29599,58080,29652,58595
,QiaoMiaoXiang,410823201,33982,3304,23556,10140,47340,23457,10581,24087,47544,24311,47867
ٵ,GeDangDianXiang,410823202,31463,3136,22268,9999,43605,21775,10836,22763,44538,23167,45435
,SanYangXiang,410823203,30130,3353,21346,9523,41564,21346,9861,21998,43344,21998,43344
С,XiaoDongXiang,410823204,30695,3263,21309,10439,42526,21290,9482,22065,43355,22131,43440
,DaHongQiaoXiang,410823205,40177,4501,28011,13173,55524,28010,12285,28952,56962,28952,56963
,BeiGuoXiang,410823206,26039,2811,18330,8677,36727,18329,8604,19123,37452,19124,37454
ũ,WuZhiNingGuoNongChang,410823598,136,6,58,44,145,58,16,77,135,100,158
Ȫ,WenQuanZhen,410825100,77154,5675,49764,23395,85206,45166,18112,45615,90781,51177,100941
,XiangYunZhen,410825101,35010,4225,24417,12710,47685,24407,9479,24232,48639,24297,48714
,FanTianZhen,410825102,33664,4156,22910,11670,44729,22734,7712,22450,45184,22622,45532
ׯ,HuangZhuangZhen,410825104,37351,4586,25785,12922,50566,25731,9667,25726,51457,25819,51604
,WuDeZhen,410825105,31051,3431,21519,10050,42683,21493,8717,21563,43056,21680,43199
Ա,ZhaoBaoZhen,410825106,30409,2992,20459,9742,40366,20402,8084,20727,41129,21026,41485
Ǽ,NanZhangQiangZhen,410825107,18711,1890,12606,6000,24729,12591,4620,12599,25190,12615,25221
,YueCunXiang,410825200,18076,1808,12116,5919,21449,12021,4489,12095,24116,12257,24373
,ZhaoXianXiang,410825201,14100,1707,9967,5340,19311,9931,3926,9727,19658,9766,19733
,BeiLengXiang,410825203,15331,1707,10558,5044,20673,10554,3885,10334,20888,10365,20923
Ӫũ,GuoYingWenXianNongChang,410825400,69,1,25,18,34,22,1,27,49,46,71
ֵ,QinHuaiJieDao,410882001,20623,1876,13767,6394,20967,12720,4555,12622,25342,13287,27054
ֵ,HuaiQingJieDao,410882002,21457,2167,14627,7320,23711,14614,5570,14514,29128,14567,29194
̫нֵ,TaiHangJieDao,410882003,26320,1626,16749,7448,21026,14004,5531,14158,28162,16728,33477
԰ֵ,QinYuanJieDao,410882004,30099,2065,19666,10409,24420,18691,6996,18367,37058,19494,39160
,ChongYiZhen,410882100,21420,2681,14921,8052,28370,14910,5084,14249,29159,14264,29185
,XiXiangZhen,410882101,41872,3786,28165,13380,54783,28095,11098,28411,56506,28591,56756
,XiWanZhen,410882102,26427,2109,17649,8546,33064,17612,7650,18235,35847,18537,36186
,BaiXiangZhen,410882103,41236,4059,27456,13725,53240,27254,9323,26830,54084,27162,54618
ɽׯ,ShanWangZhuangZhen,410882104,20477,1816,13810,6817,26289,13802,5948,14375,28177,14431,28241
,ZiLingZhen,410882105,18796,2133,12682,6586,24490,12680,4366,12607,25287,12613,25295
ƽ,ChangPingXiang,410882200,5825,458,4000,1975,7628,3998,1803,4062,8060,4086,8086
,WangZhaoXiang,410882201,31093,3516,21837,11217,42017,21802,8908,21628,43430,21680,43517
,WangQuXiang,410882202,27470,2727,18533,8976,35731,18529,6735,18377,36906,18399,36932
󶨽ֵ,DaDingJieDao,410883001,31086,3379,20380,9884,37297,17739,6434,17448,35187,20519,40899
ֵ,HuiChangJieDao,410883002,40967,3922,26669,13257,46404,23557,8567,23247,46804,26787,53456
Ӻֵ,HeYongJieDao,410883003,18275,1500,11994,6265,17703,11152,3758,10850,22002,11539,23533
ֵ,HeYangJieDao,410883004,22714,2492,15208,7498,26272,14353,4683,14020,28373,14681,29889
,HuaGongZhen,410883100,25556,3091,17422,9118,33950,17206,6434,17305,34511,17659,35081
ׯ,NanZhuangZhen,410883101,29330,3452,20050,9656,39051,19891,7493,19852,39743,20225,40275
ǲ,ChengBoZhen,410883102,23422,3019,15952,8067,30761,15806,5315,15474,31280,15804,31756
ȵ,GuDanZhen,410883103,18795,2569,12741,6872,24513,12653,4152,12382,25035,12775,25516
Ժ,ZhaoHeZhen,410883104,25400,3047,17026,9107,33142,16948,5388,16613,33561,16809,33835
,XiGuoZhen,410883105,24473,2776,16297,8884,31276,15915,5834,15788,31703,16786,33083
,HuaiShuXiang,410883201,14922,1998,9912,5607,18844,9607,2870,9571,19178,9878,19790
ԭ·ֵ´,ZhongYuanLuJieDaoBanShiChu,410902001,25187,1189,16191,10038,17540,15986,6720,16398,32384,16905,33096
ʤ·ֵ´,ShengLiLuJieDaoBanShiChu,410902002,29853,1326,19281,11408,21265,18333,8065,19076,37409,19963,39244
·ֵ´,JianSheLuJieDaoBanShiChu,410902003,30644,1733,20091,11546,21730,18060,8037,18538,36598,20323,40414
·ֵ´,RenMinLuJieDaoBanShiChu,410902004,21555,2317,14681,9776,22718,14467,5470,14456,28923,14661,29342
·ֵ´,DaQingLuJieDaoBanShiChu,410902005,25722,971,16742,10325,15146,15480,6689,15593,31073,16640,33382
ƺ·ֵ´,HuangHeLuJieDaoBanShiChu,410902006,32588,1999,21207,12589,27361,19764,8177,20003,39767,21557,42764
·ֵ´,RenQiuLuJieDaoBanShiChu,410902007,6765,176,4226,2933,3529,4207,1630,4332,8539,4345,8571
·ֵ´,ChangQingLuJieDaoBanShiChu,410902008,16347,525,10174,6961,7152,10085,3709,10357,20442,10407,20581
·ֵ´,KunWuLuJieDaoBanShiChu,410902060,19798,1419,12992,7201,21749,12420,5091,12924,25344,13316,26308
ʸֵ´,HuangFuJieDaoBanShiChu,410902061,15141,1293,10163,3606,9978,5804,2266,5909,11713,8537,18700
,YueCunXiang,410902202,27720,3064,19818,10512,37397,19816,8679,19632,39448,19645,39463
,MengKeXiang,410902203,22337,2248,15195,7353,26104,14697,6439,14878,29575,15829,31024
,HuCunXiang,410902360,40656,4732,28626,14087,54670,28595,12738,29245,57840,29500,58126
,WangZhuXiang,410902361,32234,3777,22168,10932,43361,22090,9597,23213,45303,23440,45608
ϰ,XinXiXiang,410902362,35292,3986,24922,12395,49605,24919,11484,25832,50751,25840,50762
ԭֵ´,ZhongYuanYouTianJieDaoBanShiChu,410902400,85838,11291,57358,39112,100505,55573,15539,53592,109165,55310,112668
ֵ´,KaiFaQuJieDaoBanShiChu,410902560,19828,838,12398,8246,11163,12028,4955,12767,24795,13223,25621
ǹ,ChengGuanZhen,410922100,41679,3758,28311,14679,41326,25430,10347,25634,51064,27473,55784
ׯ,MaZhuangQiaoZhen,410922101,17617,2200,12025,7610,17334,11568,4153,11579,23147,11945,23970
ͷ,WaWuTouZhen,410922102,35976,3728,24554,13896,45780,24093,10855,25258,49351,26005,50559
,LiuTaXiang,410922200,23415,3040,17016,9842,32722,16996,7518,16923,33919,16957,33973
ׯ,XianZhuangXiang,410922201,29505,3410,20934,11532,42635,20927,10220,22190,43117,22201,43135
Ӫ,GongYingXiang,410922202,23321,2706,16515,8946,33420,16515,7644,17156,33671,17156,33671
,MaCunXiang,410922203,27033,3006,19173,10533,37973,19173,8639,19504,38677,19505,38678
߱,GaoBaoXiang,410922204,24959,2845,17314,8671,34645,17314,7391,17881,35195,17881,35195
ų,GuChengXiang,410922205,23326,3359,17430,8726,33591,17402,7257,16458,33860,16512,33942
,DaLiuXiang,410922206,20545,2714,15603,7711,30040,15603,7243,14899,30502,14899,30502
,HanCunXiang,410922207,24869,3114,17849,9393,34590,17755,7525,17587,35342,17659,35508
,DaTunXiang,410922208,23340,3226,16939,9138,32957,16939,7029,16656,33595,16656,33595
̳,GuChengXiang,410922209,23344,2576,16329,7659,32303,16329,6790,16381,32710,16381,32710
,LiuGeXiang,410922211,25429,2900,18787,9239,35429,18787,8426,17967,36754,17968,36755
˫,ShuangMiaoXiang,410922212,24069,2813,17382,9521,33770,17382,7645,17145,34527,17145,34527
ֽ,ZhiFangXiang,410922213,26676,3328,19628,10673,37220,19628,8503,18873,38501,18879,38507
,YangShaoXiang,410922214,30255,3406,22348,10888,42595,22348,11255,22567,44915,22568,44916
ǹ,ChengGuanZhen,410923100,40913,3328,27843,12968,41513,23874,10821,23667,47541,27219,55062
,HanZhangZhen,410923101,20171,2575,15901,7734,29898,15901,7439,14284,30185,14284,30185
Ԫ,YuanCunZhen,410923102,28266,3618,22817,10351,40764,22696,9536,18436,41132,18603,41420
,YangCunXiang,410923200,18838,2251,14137,7143,27387,14136,6413,13365,27501,13365,27502
Ź,ZhangGuoTunXiang,410923201,21812,2880,16587,9036,32107,16586,7650,15755,32341,15755,32342
ǧ,QianKouXiang,410923202,23642,3202,19307,10703,35754,19274,9888,17326,36600,17425,36732
,FuKanXiang,410923203,28094,2984,20961,10541,41268,20961,10917,21034,41995,21034,41995
Ƚ¥,GuJinLouXiang,410923204,22929,2660,16638,8290,32901,16638,7448,16398,33036,16399,33037
,XiShaoXiang,410923205,26357,3085,20799,10193,39608,20797,10441,19077,39874,19084,39883
ׯ,SiZhuangXiang,410923206,30897,4041,24466,11751,46066,24442,11759,22149,46591,22231,46697
,LiangCunXiang,410923207,29459,3151,22179,9888,41680,22173,10396,20823,42996,20827,43006
¹,JinDeGuXiang,410923208,20971,2982,16082,8427,30206,16079,6673,14540,30619,14544,30626
ǹ,ChengGuanZhen,410926100,32917,2426,20853,11817,36268,18725,8039,20454,39179,22529,43382
姳,PuChengZhen,410926101,39010,3947,27683,16002,48348,27630,11510,26587,54217,26784,54467
ׯ,XinZhuangXiang,410926200,29799,3355,22548,11123,44495,22517,11456,21999,44516,22062,44610
,YangJiXiang,410926201,30901,3677,23153,11925,45524,22918,11238,22216,45134,22663,45816
ׯ,ChenZhuangXiang,410926202,22794,3097,17517,9887,34430,17514,8775,17148,34662,17149,34666
¸,BaiYiGeXiang,410926203,25997,2711,18309,9404,35457,17438,8537,18061,35499,18936,37245
¥,WangLouXiang,410926204,21018,2323,15132,7739,30245,15110,7442,15463,30573,15651,30783
մ,YanCunPuXiang,410926205,21288,2929,16163,8839,31873,16162,7962,16016,32178,16016,32179
ׯ,LongWangZhuangXiang,410926207,29238,3753,22415,13030,43740,22390,10973,21470,43860,21549,43964
½,LuJiXiang,410926208,19658,2605,16851,8917,31780,16848,9607,15017,31865,15019,31870
ׯ,ZhangZhuangXiang,410926209,22940,2901,17693,9572,34220,17691,9285,17414,35105,17433,35126
ͷ,GaoMaTouXiang,410926210,24214,2999,17516,9916,35038,17314,8553,17957,35271,18250,35766
ǹ,ChengGuanZhen,410927100,36275,3080,23499,11600,40075,20655,9642,21708,42363,25498,48997
,HouMiaoZhen,410927101,34982,3353,25052,12570,47714,25048,12474,25755,50803,25757,50809
,HouFangXiang,410927200,20684,2392,15402,8314,30308,15401,7776,15447,30848,15450,30852
ˮ,QingShuiHeXiang,410927201,20368,2412,14564,7690,29131,14564,6973,15189,29753,15189,29753
¥,MaLouXiang,410927202,30701,3823,22398,11354,44698,22398,10955,23079,45477,23081,45479
,SunKouXiang,410927203,19201,2083,13910,8086,26564,13747,6751,13763,27510,14125,28035
,DaYuChenXiang,410927204,29681,4331,22902,12786,44149,22902,11136,22244,45146,22246,45148
к,JiaHeXiang,410927205,17716,2635,13845,7683,26527,13784,6620,13022,26806,13126,26971
,WuBaXiang,410927206,17065,2430,13263,7107,25518,13258,6585,12803,26061,12817,26080
ǹ,ChengGuanZhen,410928100,79847,7016,52100,24106,77540,45298,18131,47096,92394,52894,104994
,PuYangXianLiuTunZhen,410928101,57752,5884,38957,21881,74849,38705,15915,40085,78790,40594,79551
,PuYangXianWenLiuZhen,410928102,50510,5066,35197,18889,66239,34972,15910,35734,70706,36289,71486
,PuYangXianQingZuZhen,410928103,38619,4431,27795,13813,54125,27588,12613,27745,55333,27868,55663
ذ˹,PuYangXianBaGongQiaoZhen,410928104,40486,4186,27381,13752,56027,27381,11985,29275,56656,29276,56657
,PuYangXianXuZhenZhen,410928106,36174,3490,25066,13229,47748,24850,11802,26047,50897,26400,51466
ػկ,PuYangXianHuBuZhaiXiang,410928201,32562,3787,23313,12295,43881,23313,10387,23423,46736,23423,46736
ͷ,PuYangXianQingHeTouXiang,410928202,33077,3502,22597,10747,43418,22507,9161,23045,45552,23143,45740
³,PuYangXianLuHeXiang,410928203,32087,3841,24485,12315,47157,24483,12227,23670,48153,23670,48155
ׯ,PuYangXianLiangZhuangXiang,410928204,30880,3742,22497,11804,44194,22496,10734,22855,45351,22859,45356
ƹ,PuYangXianWangChengGuXiang,410928205,28328,4207,23527,11927,43255,23305,12062,20428,43733,21070,44597
ذ,PuYangXianBaiGangXiang,410928206,22401,2933,16036,7890,32197,16035,7338,16625,32660,16636,32672
԰,PuYangXianLiYuanXiang,410928207,23867,3384,18722,9454,35962,18721,9612,18140,36861,18141,36863
,PuYangXianWuXingXiang,410928208,31313,2892,21413,10150,42848,21410,9469,22259,43669,22261,43674
Ӱ,PuYangXianZiAnXiang,410928209,35108,3808,24049,11182,48796,23845,10170,24722,48567,25037,49086
غ״,PuYangXianHuZhuangXiang,410928210,34448,3699,24261,12299,48046,24247,10779,24635,48882,24665,48926
,LangZhongXiang,410928211,34264,4128,25180,12953,49903,24683,12635,25064,49747,25847,51027
غͨ,PuYangXianHaiTongXiang,410928212,33973,3989,24586,12807,48847,24570,11670,25022,49592,25046,49632
,PuYangXianQuCunXiang,410928213,27213,3303,21045,10568,40267,20826,10546,19701,40527,20017,41062
ϰ,PuYangXianXiChengXiang,410928214,28852,3312,21505,10116,42449,21505,11147,21805,43310,21806,43311
ֵ´,XiDaJieDaoBanShiChu,411002001,18861,1310,11023,4656,8124,7047,2321,6810,13857,11469,22492
ֵ´,DongDaJieDaoBanShiChu,411002002,14155,1924,9484,6034,12182,8892,2356,8538,17430,8951,18435
ؽֵ´,XiGuanJieDaoBanShiChu,411002003,32563,3822,21110,13144,25143,18334,4618,17454,35788,19893,41003
Ϲؽֵ´,NanGuanJieDaoBanShiChu,411002004,29555,3006,19204,8996,24201,14210,4178,13557,27767,17535,36739
ֵ´,BeiDaJieDaoBanShiChu,411002005,35057,3815,22617,12454,31316,19336,5927,19259,38595,22182,44799
һ·ֵ´,WuYiLuJieDaoBanShiChu,411002006,47193,3517,27762,13850,43332,20168,5909,20255,40423,28857,56619
Ӫֵ´,GaoQiaoYingJieDaoBanShiChu,411002007,13548,1458,9332,4522,15536,8346,3283,8367,16713,8957,18289
ׯֵ´,DingZhuangJieDaoBanShiChu,411002008,16527,1576,10704,6188,15342,10516,3321,10412,20928,10720,21424
ֵ´,QiLiDianJieDaoBanShiChu,411002009,37877,3190,23257,12480,37544,19638,6776,19612,39250,24586,47843
ķֵ´,WenFengJieDaoBanShiChu,411002010,49040,4239,31042,17694,49410,27346,8916,26920,54266,31153,62195
˽ֵ´,XinXingJieDaoBanShiChu,411002011,42411,4382,27866,16961,39677,25267,7780,25190,50457,26707,54573
غӽֵ´,BanJieHeJieDaoBanShiChu,411002012,52830,2274,31617,10425,21431,17298,6322,16814,34112,29809,61426
ÿ,XuChangJingJiKaiFaQu,411002560,9414,718,6454,3006,6208,5097,1956,5009,10106,5634,12088
ί,DongChengQuGuanWeiHui,411002570,125,1,86,58,14,86,36,76,162,76,162
ٳ,JiangGuanChiZhen,411023100,62096,5671,40915,22257,52513,38595,15392,40070,78665,42244,83159
Ů,WuNvDianZhen,411023101,32257,4119,22284,12521,44554,22271,8856,22914,45185,22948,45232
м,ShangJiZhen,411023102,33897,3666,23107,12406,45922,23068,9620,24007,47075,24076,47183
,SuQiaoZhen,411023103,37717,4960,25371,13938,51818,25352,9940,27141,52493,27246,52617
,JiangLiJiZhen,411023104,36380,4390,24627,13122,49790,24614,9649,25730,50344,25792,50419
,ZhangPanZhen,411023105,30101,3722,20195,10938,41433,20194,7667,21293,41487,21295,41490
龮,LingJingZhen,411023106,39227,4682,25535,14877,51850,25365,10945,27328,52693,29319,54854
²,ChenCaoXiang,411023200,43495,5830,30057,16360,60570,30039,11479,30687,60726,30747,60804
ׯ,DengZhuangXiang,411023201,37188,4277,24932,13662,51063,24932,10057,26588,51520,26590,51522
С,XiaoZhaoXiang,411023202,33866,4235,23093,12594,47259,23072,9388,24195,47267,24396,47489
ӽ,HeJieXiang,411023203,30817,3520,20342,10920,40675,20074,7706,21510,41584,21701,42043
,GuiCunXiang,411023204,19573,3341,14258,8607,28656,14254,6349,14954,29208,15005,29263
驽,ZhenJianXiang,411023205,43715,4987,28839,16035,55592,26954,10965,28947,55901,30828,59667
,YuLinXiang,411023206,32502,4264,23208,13383,46528,23202,10192,23685,46887,23750,46958
,ChangCunZhangXiang,411023207,30975,3523,21165,11341,41254,21049,8350,21508,42557,21683,42848
ׯ,AiZhuangHuiZuXiang,411023208,8290,1259,5685,3298,11708,5682,2352,6194,11876,6216,11901
,AnLingZhen,411024100,57309,3404,30018,12906,52034,22762,9809,24581,47343,40504,70522
,MaLanZhen,411024101,47154,4775,29447,14130,54932,27121,12060,28183,55304,34542,63989
,BaiLiangZhen,411024102,39612,4371,28128,13799,44619,24302,12173,23542,47844,28028,56156
»,ChenHuaDianZhen,411024103,24547,2668,15407,8038,28156,13944,5880,13803,27747,17688,33095
,WangTianZhen,411024104,24923,3412,17557,10400,36283,17532,8189,18886,36418,18967,36524
,ZhangQiaoXiang,411024200,31797,4438,23379,13616,46713,23375,10505,23340,46715,23361,46740
,NanWuXiang,411024201,19399,3014,13973,8682,28894,13937,6510,14910,28847,14950,28923
ճ,TaoChengXiang,411024202,28978,4519,21996,13473,44823,21990,11357,22854,44844,22858,44854
ֻ,ZhiLeXiang,411024203,29989,4310,21435,12487,43504,21435,9618,22471,43906,22482,43917
,DaMaXiang,411024204,23014,3371,17044,10002,34076,17044,7859,17200,34244,17200,34244
,PengDianXiang,411024205,29898,4447,22788,12866,45186,22788,11087,22644,45432,22644,45432
�,MaFangXiang,411024206,32634,4568,23347,13437,45974,23157,10013,23371,46528,23868,47215
ǹ,ChengGuanZhen,411025100,40240,4407,25984,13713,36900,22544,7920,22627,45171,26583,52567
Ż,YingQiaoHuiZuZhen,411025101,4446,775,3321,2048,6216,3319,1395,3271,6590,3295,6616
,MaiLingZhen,411025102,22986,3773,18293,11257,35939,18267,10026,18399,36666,18492,36785
,YingYangZhen,411025103,27683,4240,20530,12925,40340,20513,9418,20757,41270,20811,41341
,WangLuoZhen,411025104,28703,4990,21873,13828,43449,21853,10308,22076,43929,22128,44001
,ZiYunZhen,411025105,26729,3788,18582,11130,36828,18505,8012,19799,38304,19947,38529
տ,ZhanBeiXiang,411025200,17732,2436,12289,7260,24711,12281,5205,12922,25203,13084,25373
ɽͷ,ShanTouDianXiang,411025201,30277,4810,22701,13133,44786,22692,10453,22810,45502,22839,45540
Ĺ,CiGouXiang,411025202,46672,5828,31814,18172,43608,31010,12909,32622,63632,33595,65409
Ӫ,DingYingXiang,411025203,23536,4162,17997,11070,35110,17861,8722,18209,36070,18423,36420
ׯ,JiangZhuangXiang,411025204,24276,3913,18695,11450,36906,18695,9289,18783,37478,18783,37478
,FanHuXiang,411025205,37549,6069,29589,18177,58152,29584,15448,29473,59057,29477,59066
˫,ShuangMiaoXiang,411025206,23900,3858,17817,11317,35035,17794,7858,17754,35548,17799,35616
ڳ,FenChenXiang,411025207,23810,4118,17278,11329,35016,17267,7515,18120,35387,18165,35443
ʮ,ShiLiPuXiang,411025208,33281,5656,25496,15814,50716,25479,12504,25854,51333,25945,51441
ׯ,KuZhuangXiang,411025209,44013,5181,29573,15138,43474,25682,10496,26915,52597,30117,59690
򣴨ֵ´,YingChuanJieDaoBanShiChu,411081001,52023,4372,33821,15137,43171,25470,12218,25988,51458,34792,68613
Ķֵ´,XiaDouJieDaoBanShiChu,411081002,45666,3700,28970,14364,32596,23665,10338,24541,48206,30734,59704
ǽֵ´,HanChengJieDaoBanShiChu,411081003,18982,2188,12979,7817,16845,12915,5089,13162,26077,13280,26259
ֵ̨´,JunTaiJieDaoBanShiChu,411081004,46348,3945,27397,12398,32914,20934,8528,21009,41943,31424,58821
,HuoLongZhen,411081100,35653,4637,24546,13673,49190,24473,11031,26488,50961,26775,51321
˳,ShunDianZhen,411081101,48791,7000,34439,18453,68941,34421,15344,36576,70997,36696,71135
ɽ,FangShanZhen,411081102,27212,3677,18124,10104,35675,18035,7553,19511,37546,20318,38442
,ShenHouZhen,411081103,28811,3186,18609,10003,35909,18428,8339,20141,38569,21727,40336
賩,HongChangZhen,411081104,33881,4950,24157,14196,47516,24031,11276,25375,49406,25950,50107
,LiangBeiZhen,411081105,32179,4105,21326,12367,41107,21202,8643,22687,43889,23601,44927
ų,GuChengZhen,411081106,31009,4250,21143,11629,42974,21140,8645,22722,43862,22761,43904
,WuLiangZhen,411081107,24680,3761,17124,9392,34037,17086,7080,18318,35404,18397,35521
,WenShuZhen,411081108,30079,4420,21380,12220,41820,20837,10153,22390,43227,23272,44652
ɽ,JiuShanZhen,411081109,21522,3327,15242,8606,30647,15153,6977,16316,31469,16584,31826
Һ,ChuHeXiang,411081110,45291,6164,30813,16704,62921,30753,12821,33359,64112,33463,64276
,ZhuGeXiang,411081200,27005,4037,18705,10815,37916,18701,7728,20059,38760,20065,38770
ׯ,ChangZhuangXiang,411081201,21006,3319,14840,8279,29611,14840,6517,15989,30829,16002,30842
ʯ,HuaShiXiang,411081202,36118,5020,25619,14140,51315,25616,12431,27928,53544,27950,53569
ĥ,MoJieXiang,411081204,16192,1747,11186,5428,21868,10990,5638,11747,22737,12391,23577
ŵ,ZhangDeXiang,411081205,31614,5563,22950,13952,46157,22933,9967,24104,47037,24194,47144
С,XiaoLvXiang,411081206,23641,4531,18047,11555,35524,18033,8578,18652,36685,18703,36750
,FanPoXiang,411081207,32969,5634,24038,15169,48596,24019,10819,25347,49366,25384,49422
,GuoLianXiang,411081209,35181,4917,24309,12983,49880,24309,10187,25976,50285,25976,50285
ɽ,ShanHuoHuiZuXiang,411081210,6634,1049,4713,2694,9195,4711,2047,4999,9710,5017,9730
ǳ,QianJingXiang,411081211,18908,3315,13568,8014,26945,13567,5888,14526,28093,14543,28111
,FangGangXiang,411081212,23151,3464,16386,9571,32807,16375,7237,17391,33766,17466,33852
·ֵ´,JianSheLuJieDaoBanShiChu,411082001,34481,2567,22090,13069,39200,20704,7864,21521,42225,22822,44912
·ֵ´,ChangXingLuJieDaoBanShiChu,411082002,17814,1152,11559,6260,16174,10885,4766,11413,22298,12173,23732
·ֵ´,ChangSheLuJieDaoBanShiChu,411082003,28770,2505,19070,11427,31350,18821,7277,19223,38044,19482,38552
·ֵ´,JinQiaoLuJieDaoBanShiChu,411082004,17577,1301,11603,7035,14650,11462,4973,11945,23407,12248,23851
,HeShangQiaoZhen,411082100,32267,3761,21784,10617,40818,20469,8420,21502,41971,22664,44448
º,PoHuZhen,411082101,35003,5034,24347,13162,48953,24336,10125,25734,50070,25815,50162
,HouHeZhen,411082102,33631,4644,23047,12161,46113,23035,8962,24105,47140,24190,47237
ʯ,ShiGuZhen,411082103,28531,3724,19595,10579,39403,19595,8056,20716,40311,20716,40311
ϳ,LaoChengZhen,411082104,38096,4689,26169,13630,52855,26168,11469,28081,54249,28085,54254
ϯ,NanXiZhen,411082105,27706,4415,20717,11368,40245,20707,9495,20816,41523,20899,41616
,DaZhouZhen,411082106,46311,5586,32715,15463,66442,32539,16451,35304,67843,35633,68348
,DongCunZhen,411082107,36064,4580,25055,12629,51329,25041,11494,26976,52017,27083,52138
,ZengFuMiaoXiang,411082200,19349,2762,13430,7286,26127,13403,5253,13821,27224,13934,27364
ͤ,GuanTingXiang,411082201,28796,3988,19869,10641,40222,19855,8467,21219,41074,21382,41251
ʯ,ShiXiangXiang,411082202,31992,4204,22614,11732,45473,22613,9737,23315,45928,23319,45933
,GuQiaoXiang,411082203,29077,4127,21237,10980,42217,21165,9817,21639,42804,21784,43021
Ͻֵֽ,LaoJieJieDao,411102001,12033,1505,7986,4578,12319,7185,2308,7019,14204,7860,15846
·ֵֽ,MaLuJieJieDao,411102002,24194,3063,15826,9306,26834,13614,4062,13244,26858,15493,31319
˳ӽֵֽ,ShunHeJieJieDao,411102003,25247,3826,16888,8959,28401,13941,4403,13537,27478,16588,33476
ɺӳ½ֵ,GanHeChenJieDao,411102004,77063,6114,51177,26724,56709,43107,14995,42710,85817,46995,98172
,DaLiuZhen,411102100,23630,3507,15942,8670,32767,15471,5794,16217,31688,16989,32931
,YinYangZhaoZhen,411102101,30867,4276,20976,11128,41965,20714,7303,21133,41847,21470,42446
ڣ,KongZhongGuoZhen,411102102,33167,3878,21628,10545,44167,20300,7544,21303,41603,22961,44589
ʮ,WenShiXiang,411102202,17878,2738,12101,6626,25085,11839,4559,12618,24457,13074,25175
ɳֵ´,ShaBeiJieDaoBanShiChu,411103001,65501,5410,41728,23877,62772,37518,13040,37494,75012,42223,83951
ǹ,ChengGuanZhen,411103100,65279,4767,40865,20751,58331,33958,12743,34675,68633,41924,82789
,MengMiaoZhen,411103101,43972,5209,27445,13143,56765,25055,9827,26294,51349,31563,59008
,ShangQiaoZhen,411103102,29890,4584,20157,10175,37279,17609,7121,18028,35637,21438,41595
,PeiChengZhen,411103103,32197,4884,22163,11922,44914,21596,8551,22162,43758,23469,45632
µ,XinDianZhen,411103104,31868,4666,21378,11283,43435,19704,7825,20261,39965,22981,44359
,LongChengZhen,411103105,45517,5953,28885,14536,56712,26511,9749,28005,54516,32334,61219
̶,HeiLongTanXiang,411103201,26098,3170,17384,8589,35807,16859,6634,17715,34574,18518,35902
,LiJiXiang,411103202,27397,4296,18932,10575,38877,18588,7532,19543,38131,20293,39225
Žֵֽ,TianQiaoJieJieDao,411104001,28801,3754,19147,13176,31680,19046,5249,18532,37578,18657,37804
ׯ´,ZhaiZhuangBanShiChu,411104002,24341,2147,16029,9369,23731,15587,5474,15578,31165,15933,31962
,ZhaoLingZhen,411104100,55205,6571,37571,17965,74269,36719,14994,38310,75029,39199,76770
,DengXiangZhen,411104101,27013,3562,18846,9770,38166,18841,8104,19818,38659,19833,38679
,WanJinZhen,411104102,46762,5819,32544,16161,66193,32279,14529,33852,66131,34566,67110
,LaoWoZhen,411104103,42770,5725,30121,16433,59725,30031,12444,30720,60751,30818,60939
л,HouXieXiang,411104201,50579,4554,33587,18321,52447,32095,11894,32317,64412,33440,67027
ʯ,JiShiXiang,411104202,27475,3333,18524,8977,37395,18471,7112,19215,37686,19396,37920
,QingNianCunXiang,411104203,41909,4717,27860,14132,58277,27257,12503,30334,57591,31269,59129
Ȫ,WuQuanZhen,411121100,56272,5826,35938,18920,64567,30653,11665,30681,61334,37825,73763
,WuChengZhen,411121101,28444,5219,19794,11119,39422,19327,6483,19501,38828,20352,40146
,BeiWuDuZhen,411121102,18197,2981,12943,7066,24367,12224,4771,12337,24561,13006,25949
,LianHuaZhen,411121103,26030,4561,19039,10244,37710,18889,7226,18485,37374,18778,37817
,XinAnZhen,411121104,23414,4426,16138,9264,32939,15653,5281,15848,31501,16983,33121
կ,MengZhaiZhen,411121105,27604,4527,19077,10343,38822,18651,6933,19245,37896,19987,39064
̫ξ,TaiWeiZhen,411121106,16761,2560,12027,6498,24200,11974,5026,12263,24237,12320,24347
ķ,WenFengXiang,411121200,23936,4553,16999,9924,33871,16480,6046,16741,33221,17536,34535
,BaoHeXiang,411121201,31034,5440,21748,12127,44439,21495,8139,22271,43766,22865,44613
,MaCunXiang,411121202,22671,3736,15834,8979,32288,15651,6139,16291,31942,16712,32546
,HouJiXiang,411121203,30640,4549,20984,11475,42694,20609,8205,21517,42126,22410,43394
,JiangDianXiang,411121204,23633,4570,16769,9593,33829,16321,5699,16067,32388,17133,33902
Ž,JiuJieXiang,411121205,29181,4949,20580,11620,41570,20580,7496,21046,41626,21046,41626
»,ZhangHuaXiang,411121206,23543,3715,16111,8941,33462,15845,6366,16875,32720,17513,33624
ǹ,ChengGuanZhen,411122100,115577,10216,73105,35180,126142,66023,22914,69370,135393,75602,148707
,FanChengZhen,411122101,39175,5271,26780,13956,54456,26257,10743,27293,53550,28409,55189
,DuQuZhen,411122102,49928,6412,33307,17077,62906,31719,12599,33350,65069,35632,68939
,WangGangZhen,411122103,36897,5260,26041,14419,54143,25680,12317,27535,53215,28433,54474
̨,TaiChenZhen,411122104,38769,5147,26935,14097,54184,26866,10685,27529,54395,27666,54601
,JuLingZhen,411122105,29280,3847,19868,10391,40810,19634,7735,20600,40234,20994,40862
ߵ,WaDianZhen,411122106,27303,3880,18868,10135,38090,18738,7429,19346,38084,19744,38612
ҵ,SanJiaDianZhen,411122107,23068,3400,16020,8369,33159,15746,6717,16549,32295,17165,33185
ѳ,WoChengZhen,411122108,19353,2833,13675,7635,28093,13675,5986,14496,28171,14497,28172
,DaGuoXiang,411122200,30755,4490,21682,12096,45027,21561,9987,23158,44719,23550,45232
ʵ,HuangDiMiaoXiang,411122201,21049,2776,14057,7450,28974,13920,5333,14775,28695,15101,29158
,GuXiangXiang,411122202,21077,2795,14047,7696,28913,14013,5107,14782,28795,14932,28979
ʯ,ShiQiaoXiang,411122203,17061,2507,11628,6442,23789,11441,4508,11994,23435,12448,24076
ׯ,ChenZhuangXiang,411122204,16885,2475,11357,5996,23563,11161,4406,11915,23076,12409,23766
,WangMengXiang,411122205,26465,3607,17543,9308,36667,17298,6821,18682,35980,19350,36893
ֵ,HuBinJieDao,411202001,25813,4411,17070,11808,26423,16289,4462,15515,31804,17616,34686
ǰֵ,QianJinJieDao,411202002,30662,3689,19388,12900,33212,18226,5027,17852,36078,19990,39378
վֵ,CheZhanJieDao,411202003,34442,3904,22648,15087,32455,21875,6759,21653,43528,22457,45105
ӽֵ,JianHeJieDao,411202004,59449,5134,36794,22233,63916,32367,10913,32555,64922,38702,75496
󰲽ֵ,DaAnJieDao,411202005,269,29,140,142,284,120,37,164,284,195,335
˽ֵ,HuiXingJieDao,411202006,14854,1492,9494,5543,14914,9123,3162,9334,18457,10014,19508
µ׽ֵ,YaDiJieDao,411202007,36462,1928,22964,18224,20310,22574,8245,22843,45417,23671,46635
,JiaoKouXiang,411202201,14472,1690,9363,5401,18105,9224,2725,9345,18569,9524,18887
,CiZhongXiang,411202202,6089,735,3955,2359,7675,3950,1152,4002,7952,4021,7976
,GaoMiaoXiang,411202203,4504,930,3278,2379,6511,3277,1127,3272,6549,3283,6561
Ͽÿ,HeNanSanMenXiaJingJiKaiFaQu,411202560,24342,1863,15367,9098,22300,13611,4856,13612,27223,15694,31061
ǹ,ChengGuanZhen,411221100,57923,5010,39014,20454,59541,33797,14970,33230,67027,38889,77903
Ӣ,YingHaoZhen,411221101,22934,3165,15489,8612,29985,14870,5446,14688,29558,16056,31545
Ŵ,ZhangCunZhen,411221102,17975,2104,11697,6597,22305,10714,4238,10875,21589,12620,24317
,HongYangZhen,411221103,14107,1731,9897,5251,19221,9589,4223,9663,19252,10164,20061
,TianChiZhen,411221104,28203,3561,20035,10137,39273,19702,8873,20012,39714,20602,40637
,YangShaoXiang,411221201,30209,2875,19669,9578,34527,17863,6676,17655,35518,20091,39760
ʴ,RenCunXiang,411221203,11325,1474,7729,4901,15441,7729,3212,8282,16011,8282,16011
԰,GuoYuanXiang,411221206,25695,3011,18182,9547,35231,17972,7699,17807,35779,18223,36405
´,ChenCunXiang,411221207,25005,2813,16577,9982,32388,16506,6095,17079,33585,17336,33913
ͷ,PoTouXiang,411221208,9761,1158,6541,3945,13140,6541,2718,7096,13637,7096,13637
δ,DuanCunXiang,411221209,4934,572,3150,2155,6711,3150,1264,3620,6770,3620,6770
ϴ,NanCunXiang,411221210,3915,521,2652,1806,5386,2619,1039,2743,5362,2823,5475
Ӫ,DaYingZhen,411222100,50325,4113,29497,16949,45394,27327,8530,27736,55063,33471,62968
ԭ,YuanDianZhen,411222101,28155,2750,16795,10269,30075,14218,4253,14972,29190,18363,35158
Ŵ,XiZhangCunZhen,411222102,36535,4797,23240,13984,47168,22749,6327,23438,46187,24419,47659
,GuanYinTangZhen,411222103,29758,3700,18668,11774,36098,17905,6116,19237,37142,20906,39574
,ZhangBianXiang,411222200,8646,1184,5564,3751,11144,5552,1547,5780,11332,5813,11377
,ZhangWanXiang,411222201,19467,2212,12334,6886,24454,11981,3550,12285,24266,12895,25229
԰,CaiYuanXiang,411222203,25936,3459,16213,9328,33318,15785,4395,16787,32572,17577,33790
é,ZhangMaoXiang,411222205,14695,1755,9288,5114,18809,8922,2817,9413,18335,9979,19267
Һ,WangJiaHouXiang,411222206,12511,1675,8508,4621,17115,8413,3312,8680,17093,8990,17498
ʯ,XiaShiXiang,411222207,9269,1038,5901,3017,12171,5514,2319,5639,11153,6725,12626
,XiLiCunXiang,411222210,15468,2266,10790,6232,21641,10790,4194,11138,21928,11138,21928
ǰ,GongQianXiang,411222211,9574,1282,6281,3591,12873,6247,2204,6680,12927,6779,13060
,DianZiXiang,411222212,2580,404,1673,1080,3475,1645,561,1784,3429,1872,3545
ǹ,ChengGuanZhen,411224100,34544,2536,22552,14170,31108,21410,7548,21052,42462,22076,44628
Ź,DuGuanZhen,411224101,11957,1412,7673,4838,16051,7616,2909,8509,16125,8605,16278
ﴨ,WuLiChuanZhen,411224102,13129,1553,8777,5313,17676,8769,3589,9454,18223,9494,18271
ٵ,GuanDaoKouZhen,411224103,15535,1550,9425,5488,20056,9229,3038,10314,19543,10698,20123
,ZhuYangGuanZhen,411224104,10651,1016,6940,4204,14463,6929,2904,7607,14536,7631,14571
,GuanPoZhen,411224105,18703,2166,12001,6901,25063,11928,4335,13052,24980,13203,25204
,FanLiZhen,411224106,25678,2178,15768,9630,33105,15720,5494,17510,33230,17582,33350
,DongMingZhen,411224107,24613,1976,15121,8201,25630,13309,4431,13623,26932,15899,31020
,WenYuXiang,411224200,19185,2202,12459,7840,25411,12458,4344,13264,25722,13272,25731
ὧ,HengJianXiang,411224201,20320,2223,12975,8145,26443,12974,4384,13952,26926,13952,26927
ĥ,MoGouKouXiang,411224202,8639,1088,5667,3615,11781,5667,2270,6330,11997,6330,11997
˫,ShuangHuaiShuXiang,411224203,7982,1018,5346,3326,11100,5308,2220,5773,11081,5874,11220
,TangHeXiang,411224204,7233,979,4729,3196,9928,4729,1777,5260,9989,5260,9989
Ҥ,WaYaoGouXiang,411224205,9592,923,6088,3686,12956,6052,2552,6895,12947,6979,13067
ʨƺ,ShiZiPingXiang,411224206,7619,809,4642,2880,9996,4640,1612,5398,10038,5398,10040
ɳ,ShaHeXiang,411224207,10155,1068,6367,3896,13096,6341,2143,6945,13286,6999,13366
,XuJiaWanXiang,411224208,5864,893,3939,2478,8074,3917,1475,4249,8166,4293,8232
˺,PanHeXiang,411224209,8157,1036,5345,4004,10909,5321,1907,5719,11040,5755,11100
ľͩ,MuTongXiang,411224210,5406,708,3370,2142,7074,3338,1221,3807,7145,3965,7335
ǧ·ֵ,QianQiuLuJieDao,411281001,30916,2883,20124,12681,37309,19063,6380,18930,37993,20055,40179
·ֵ,ZhaoYangLuJieDao,411281002,7774,1596,4939,3476,10286,4899,1303,4960,9859,5734,10673
ֵֽ,XinYiJieJieDao,411281003,21531,1867,10572,7340,25310,9944,2899,10756,20700,15725,26297
·ֵ,ChangCunLuJieDao,411281004,8497,963,5354,3868,10365,5353,1245,5346,10699,5351,10705
̩ɽ·ֵ,TaiShanLuJieDao,411281005,6781,434,4727,2736,7456,4671,1954,4314,8985,4442,9169
ֵ,XinQuJieDao,411281006,22527,2043,15363,8477,25490,15257,5889,14934,30191,15096,30459
ֵ,DongQuJieDao,411281007,12625,1519,8719,4940,14942,8709,3153,8557,17266,8578,17297
ǹ,ChengGuanZhen,411282100,6525,642,4012,2057,7620,3845,1154,4023,7868,4309,8321
ׯ,YinZhuangZhen,411282101,36078,3935,22719,11956,44553,22370,6243,23010,45380,23537,46256
,ZhuYangZhen,411282102,33312,3249,20514,11791,41360,20389,6811,22452,42841,22858,43372
ƽ,YangPingZhen,411282103,58746,6083,36191,17565,72198,34371,10711,35692,70063,39349,75540
,GuXianZhen,411282104,31142,3200,19328,9974,39105,18664,5867,19801,38465,20881,40209
ԥ,YuLingZhen,411282105,48257,4607,29794,13751,59628,28526,9724,29426,57952,32794,62588
,DaiWangZhen,411282106,42852,5692,28006,15821,55617,27993,7523,28025,56018,28061,56067
,YangDianZhen,411282107,40813,5700,26335,14415,50339,24427,6802,24937,49364,26980,53315
ȹ,HanGuGuanZhen,411282108,18139,2228,11499,6289,23383,11145,3352,11631,22776,12220,23719
,JiaoCunZhen,411282109,39642,4818,24685,13182,49370,23594,5653,24055,47649,25428,50113
,ChuanKouXiang,411282200,20803,2732,12894,6788,26355,12048,3138,12533,24581,13779,26673
º,SiHeXiang,411282201,4962,502,2922,1808,6136,2843,908,3285,6128,3450,6372
մ,SuCunXiang,411282202,19320,2165,11972,6729,24963,11937,3730,13154,25091,13243,25215
Ķ,WuMuXiang,411282203,26510,3560,16581,8655,34498,15921,4622,17008,32929,18111,34692
,XiYanXiang,411282204,38156,4779,24145,12356,48633,23441,6728,24273,47714,25518,49663
鱦԰ճ,LingBaoShiYuanYiChang,411282400,445,46,247,81,554,73,63,118,191,307,554
ί,JianDongQuGuanWeiHui,411282401,52650,2972,32901,20232,56362,29686,10542,30476,60162,33263,66164
ί,JianXiQuGuanWeiHui,411282402,41970,2974,26013,13945,43051,21124,7272,21287,42411,26203,52216
ؽֵ´,DongGuanJieDaoBanShiChu,411302001,36417,5369,24511,15705,32126,23724,8514,23170,46894,25789,50300
»ֵ´,XinHuaJieDaoBanShiChu,411302002,20705,3234,14510,8960,16906,12615,4459,12115,24730,13888,28398
ұֵ´,HanYeJieDaoBanShiChu,411302003,46858,4003,29172,17039,17864,26455,10583,26182,52637,32272,61444
پֵ´,ZhongJingJieDaoBanShiChu,411302004,41194,3296,27239,16530,14433,25485,9564,25010,50495,26815,54054
׺ӽֵ´,BaiHeJieDaoBanShiChu,411302005,32906,2925,23278,12545,30573,22236,10919,22399,44635,23472,46750
ֵֽ´,ZaoLinJieDaoBanShiChu,411302006,66579,4157,40859,21890,28902,32752,13760,33167,65919,43637,84496
ׯ,GuanZhuangZhen,411302102,74731,9605,52028,31543,93660,51941,19893,51945,103886,52201,104229
ߵ,WaDianZhen,411302103,34383,4657,24022,13178,47033,23372,10168,24414,47786,25186,49208
,HongNiWanZhen,411302104,52975,6296,37226,20148,74462,36936,18082,39579,76515,40127,77353
̨,HuangTaiGangZhen,411302105,34554,4509,23665,13085,48198,23600,10167,25475,49075,25565,49230
,LiHeXiang,411302301,33373,3866,23870,12466,47093,23780,11120,24303,48083,24489,48359
ڣ,HanZhongXiang,411302302,30309,3820,20977,11687,43378,20780,9457,22308,43088,22609,43586
,JinHuaXiang,411302303,31125,3916,21596,11184,43702,21558,9547,22953,44511,22992,44588
,ChaAnXiang,411302304,27872,3433,19932,11052,41042,19888,10023,21236,41124,21396,41328
,GaoMiaoXiang,411302305,30348,3893,20922,10909,42926,20557,9505,22169,42726,22824,43746
µ,XinDianXiang,411302306,41400,5262,29264,15444,58429,28771,13503,29773,58544,30901,60165
һֵ´,QiYiJieDaoBanShiChu,411303002,43801,5677,30779,15344,53126,23884,11172,22877,46761,29871,60650
ڽֵ´,WoLongGangJieDaoBanShiChu,411303003,42069,2619,28258,12099,37807,18774,7684,18777,37551,24114,52372
ֵ´,WuHouJieDaoBanShiChu,411303004,51679,3071,33264,9655,50084,14503,6009,14451,28954,27495,60759
÷Ϫֵ´,MeiXiJieDaoBanShiChu,411303005,29068,3805,20184,11532,31728,19275,6825,18660,37935,19514,39698
վֵ´,CheZhanJieDaoBanShiChu,411303006,26431,2829,17066,11504,26030,17006,5847,17730,34736,18041,35107
ֵ´,GuangWuJieDaoBanShiChu,411303007,39463,4101,26674,17881,29056,26530,10674,27321,53851,27564,54238
ڽֵ´,JinGangJieDaoBanShiChu,411303008,11762,1252,9180,4015,16946,7884,4921,7703,15587,8755,17935
źֵ´,ZhangHengJieDaoBanShiChu,411303060,33094,2550,21692,13357,15106,20742,8892,20718,41460,22844,44536
ɽֵ´,BaiLiXiJieDaoBanShiChu,411303061,40157,4428,27820,17664,36550,27244,10945,26858,54102,27710,55530
ʯ,ShiQiaoZhen,411303101,26450,2696,18538,9535,36464,18196,8452,18660,36856,19060,37598
ʺ,LiaoHeZhen,411303102,41385,4632,28496,14951,57553,26988,12872,28619,55607,30393,58889
,AnGaoZhen,411303103,23865,2782,16578,8942,34417,16519,7984,17966,34485,18053,34631
ɽ,PuShanZhen,411303104,58500,5869,40489,21327,78682,40380,19886,42297,82677,43766,84255
½Ӫ,LuYingZhen,411303105,34518,5074,26102,14940,52502,26100,13360,26841,52941,26850,52952
໪,QingHuaZhen,411303106,33046,5245,24966,15372,51048,24630,13006,25642,50272,26331,51297
Ӣׯ,YingZhuangZhen,411303107,35940,5538,26086,15076,52439,25589,11510,26115,51704,26902,52988
԰,QiLiYuanXiang,411303300,17987,1966,13017,6467,22025,12429,5742,11810,24239,12678,25695
лׯ,XieZhuangXiang,411303305,26344,3141,18626,9622,38463,18527,9195,19915,38442,20054,38680
,WangCunXiang,411303306,20531,2409,14428,7715,29116,14338,6617,15011,29349,15129,29557
,LongXingXiang,411303307,12271,1579,8858,4771,18195,8830,4469,9401,18231,9461,18319
�羰´,LongWangGouFengJingQuBanShiChu,411303400,12688,1451,9192,4535,18279,9189,4753,9689,18878,9700,18892
ǹ,ChengGuanZhen,411321100,39570,3080,26411,15277,33357,25629,11744,27001,52630,27983,54394
ɽ,LiuShanZhen,411321101,20022,2299,14285,8055,28353,14284,7641,15665,29949,15677,29962
,YunYangZhen,411321102,38940,4713,27489,15751,49435,27128,12885,28445,55573,29049,56538
·,HuangLuDianZhen,411321103,32842,3741,23101,13453,47222,23079,11165,24588,47667,24647,47748
Ϻӵ,NanHeDianZhen,411321104,27355,3170,19933,11328,38739,19927,10880,21454,41381,21472,41405
ɽƺ,BanShanPingZhen,411321105,16253,2032,10932,6612,23483,10932,5880,13227,24159,13233,24165
Ƕ,QiaoDuanZhen,411321106,9938,1362,6808,3985,14158,6808,3501,7992,14800,7993,14801
,BaiTuGangZhen,411321107,28544,3284,19132,10882,38972,18982,9688,21990,40972,22384,41516
ǽ,ChengJiaoXiang,411321300,27001,2424,17955,9237,28769,16645,8383,18500,35145,19853,37808
С,XiaoDianXiang,411321301,20711,2799,14637,8551,28859,14618,7449,16299,30917,16322,30959
ʺ,HuangHouXiang,411321302,18076,2323,12629,7314,25386,12629,6327,14097,26726,14097,26726
̫ɽ,TaiShanMiaoXiang,411321303,17685,2336,12920,7871,26006,12872,6600,13630,26502,13701,26621
ʯ,ShiMenXiang,411321304,20232,2464,14579,8090,29494,14574,7694,15790,30364,15811,30390
Ŀ,SiKeShuXiang,411321305,18624,2403,12917,7539,26687,12917,6850,14960,27877,14960,27877
ƺ,MaShiPingXiang,411321308,12316,1729,8577,5365,17074,8568,4618,10061,18629,10086,18663
ׯ,CuiZhuangXiang,411321310,22750,2820,15321,9258,32535,15299,7818,18001,33300,18067,33388
Ϻе,HeNanHongYangJiXieChang,411321400,4856,840,3164,2581,5973,3063,819,3044,6107,3351,6515
򶫻е,HeNanXiangDongJiXieChang,411321401,2669,600,1867,1450,3505,1867,449,1851,3718,1851,3718
Ϻе,HeNanHongYuJiXieChang,411321402,1765,331,1229,991,2347,1214,436,1266,2480,1303,2532
Ӫе,GuoYingDongFengJiXieChang,411321403,861,233,575,451,1237,550,181,630,1180,700,1275
Ӫе,GuoYingZhangJiangJiXieChang,411321404,76,64,73,75,152,73,12,79,152,79,152
ǹ,ChengGuanZhen,411322100,69155,6683,46491,25017,68598,43659,17970,44010,87669,47317,93808
,DuShuZhen,411322101,47434,6566,35188,19626,68567,34253,18314,35526,69779,37126,72314
,BoWangZhen,411322102,60634,8178,44634,24281,89387,43815,22953,45028,88843,47131,91765
պ,GuaiHeZhen,411322103,23987,3793,18025,10236,35969,17803,9626,18996,36799,19381,37406
Сʷ,XiaoShiDianZhen,411322104,41694,6092,31960,18596,63678,31388,18141,32713,64101,33967,65927
Ժ,ZhaoHeZhen,411322105,51902,7586,38264,21772,76724,37264,18808,38043,75307,40032,78296
,GuangYangZhen,411322106,43011,5193,31107,17973,63137,30833,16007,32564,63397,33104,64211
ȯ,QuanQiaoXiang,411322300,34855,4780,25206,14698,51381,24964,12385,26516,51480,26814,52020
,YangJiXiang,411322301,37729,4738,27289,14175,48508,25154,13442,26110,51264,28620,55909
,ErLangMiaoXiang,411322302,25765,3389,18997,10729,38551,18718,10136,19807,38525,20293,39290
ׯ,GuZhuangDianXiang,411322303,36312,5616,29046,17307,57009,28903,16741,29377,58280,29623,58669
¥,YangLouXiang,411322304,36199,5979,28583,17935,58180,28455,16674,30035,58490,30269,58852
,QingHeXiang,411322306,33821,4903,25626,15636,51453,25620,13500,26592,52212,26598,52224
,LiuHeXiang,411322309,22579,3645,18034,11018,36181,17917,10479,18450,36367,18669,36703
,SiLiDianXiang,411322310,27435,4428,22284,13232,43181,22267,13962,23476,45743,23541,45825
Ԭ,YuanDianHuiZuXiang,411322311,8764,1271,6836,4220,13490,6767,3927,6981,13748,7126,13962
ϻе,HeNanZhongNanJiXieChang,411322400,4007,492,2373,1902,4086,2228,663,2525,4753,2789,5162
Ǵֳ,FangChengDaSiLinChang,411322401,124,0,30,124,84,30,0,94,124,94,124
ֵ´,BaiYuJieDaoBanShiChu,411323001,25754,1588,17142,10795,19109,16912,7722,17645,34557,17922,35064
Ͻֵ´,ZiJinJieDaoBanShiChu,411323002,20992,1354,13430,7413,11713,11839,4601,11821,23660,13517,26947
ֵ´,LianHuaJieDaoBanShiChu,411323003,14042,798,8960,4844,4471,7597,3046,7802,15399,8926,17886
ˮ,DanShuiZhen,411323101,24055,3644,17191,10600,34459,16956,7731,17836,34792,18239,35430
ƺ,XiPingZhen,411323102,22251,2642,15630,9061,30716,15418,7605,16423,31841,16868,32498
˫,ShuangLongZhen,411323103,12942,1926,9017,5227,18566,8801,4475,10087,18888,10326,19343
س,HuiCheZhen,411323104,25106,3314,17335,9703,34398,17122,8014,18671,35793,19099,36434
,DingHeZhen,411323105,22916,2879,15618,9288,31429,15608,7042,17203,32811,17219,32837
ɣƺ,SangPingZhen,411323106,15738,1592,10917,6128,23152,10917,5944,12356,23273,12357,23274
ƺ,MiPingZhen,411323107,15165,1687,10015,5702,21220,9967,4658,11395,21362,11495,21510
,WuLiQiaoZhen,411323108,40064,3798,26695,13872,45460,24683,11128,26025,50708,28295,54990
,ChongYangZhen,411323109,18053,2388,12495,7258,25666,12357,5864,13597,25954,13810,26305
̫ƽ,TaiPingZhen,411323110,6855,893,4674,2687,9699,4597,2239,5154,9751,5313,9987
,TianGuanXiang,411323300,13354,1958,9102,5951,18893,9061,4013,10141,19202,10223,19325
,YangChengXiang,411323301,8148,1476,5736,3735,11861,5646,2722,6388,12034,6610,12346
կ,ZhaiGenXiang,411323307,5248,689,3401,2124,7189,3346,1525,3950,7296,4061,7462
ʯ,ShiJieHeXiang,411323309,7064,720,4785,2645,9811,4728,2183,5070,9798,5182,9967
,JunMaHeXiang,411323311,10309,1429,7034,4103,14710,6966,3278,7780,14746,7982,15016
ƺ,ErLangPingXiang,411323313,5240,763,3629,2174,7442,3559,1790,3988,7547,4164,7793
ֵ´,NieYangJieDaoBanShiChu,411324001,79179,5135,49954,23599,82123,37904,18961,40240,78144,53321,103275
ѩֵ´,XueFengJieDaoBanShiChu,411324002,21980,2172,14648,8191,25407,14032,6705,15524,29556,16209,30857
񶼽ֵ´,YuDouJieDaoBanShiChu,411324003,33144,3506,22276,12368,41510,21751,10746,24357,46108,25120,47396
ʯ,ShiFoSiZhen,411324101,40055,3987,26946,15916,48753,26912,14506,31525,58437,31602,58548
,ChaoBeiZhen,411324102,27270,3620,19891,11817,40222,19877,10470,21449,41326,21469,41360
,JiaSongZhen,411324103,33617,4646,23410,12920,48338,23343,10477,25258,48601,25330,48740
,HouJiZhen,411324104,31850,4730,23705,13963,47076,23115,12191,24496,47611,25066,48771
ׯ,LaoZhuangZhen,411324105,20632,2852,14832,8380,30660,14823,7817,16417,31240,16469,31301
¬ҽ,LuYiZhen,411324106,16481,2953,12743,8090,25655,12739,6742,13416,26155,13433,26176
ɽ,ZheShanZhen,411324107,20980,2423,14824,8058,31010,14824,7663,16239,31063,16242,31066
,GaoQiuZhen,411324108,33011,4838,23268,13497,50416,23260,12746,27290,50550,27327,50595
,QuTunZhen,411324109,15453,2554,11818,6948,23875,11817,6102,12289,24106,12291,24109
԰,ZaoYuanZhen,411324110,23079,3163,16375,9019,33962,16307,7991,17784,34091,17858,34233
Ӫ,YangYingZhen,411324111,31514,4226,22363,12709,46457,22362,11505,24874,47236,24882,47245
Ȫ,LiuQuanPuXiang,411324301,18718,2655,13732,7866,27823,13732,7096,14736,28468,14737,28469
,ErLongXiang,411324303,7187,1063,5228,3242,11442,5228,3207,6228,11456,6229,11457
,WangGangXiang,411324306,14757,2137,10236,6031,21909,10234,5447,12098,22332,12105,22341
ׯ,MaZhuangXiang,411324309,16517,2265,11677,6728,24313,11665,5677,12773,24438,12782,24459
,ZhangLinXiang,411324310,32968,4885,24399,14160,50004,24399,12329,25782,50181,25783,50182
Ӫ,AnZiYingZhen,411324313,29629,4026,21784,12466,44317,21761,11273,23093,44854,23144,44928
Ӫ,PengYingXiang,411324314,30770,3954,22689,12303,45941,22686,11516,23543,46229,23551,46240
ׯ,GuoZhuangHuiZuXiang,411324315,4937,765,3845,2461,7452,3764,2114,3866,7630,3971,7816
ǹ,ChengGuanZhen,411325100,38328,3457,26236,15331,40457,23325,10862,23154,46479,26411,52647
Ĺ,XiaGuanZhen,411325101,16298,2054,11431,6482,23309,11303,5783,12358,23661,12704,24135
ʦ,ShiGangZhen,411325102,32329,4685,26021,14317,51289,26007,14771,25700,51707,25764,51785
ɽ,MaShanKouZhen,411325103,33651,4855,25041,14714,50566,24506,13237,25718,50224,26702,51743
Ķ,TuanDongZhen,411325104,41906,4598,29455,16201,50999,28050,13940,28868,56918,30989,60444
ü,ChiMeiZhen,411325105,27164,3962,20113,12287,39779,19685,9833,20312,39997,20846,40959
ͤ,WaTingZhen,411325106,16034,2301,13005,7344,25800,12856,7877,12945,25801,13207,26212
,WangDianZhen,411325107,29379,4064,21662,12561,43792,21586,11424,23032,44618,23205,44867
,GuanZhangZhen,411325108,30014,4299,22266,12792,43350,21973,10733,22168,44141,22780,45046
Ϫ,TaoXiZhen,411325109,17578,2258,12875,6947,26605,12771,7213,13961,26732,14174,27049
峡,BanChangXiang,411325300,6513,1120,4686,2855,9604,4622,2413,5156,9778,5360,10046
,DaQiaoXiang,411325301,19011,2534,14445,7921,27874,14436,7427,14502,28938,14527,28972
Ե,ZhaoDianXiang,411325302,27080,3877,19786,11269,39452,19637,9546,20403,40040,20717,40503
ƺ,QiLiPingXiang,411325306,10457,1512,7522,4338,15162,7423,3774,8039,15462,8221,15743
,YuGuanXiang,411325307,19463,3205,14811,8886,29459,14705,7778,15332,30037,15635,30446
,ZhaQuXiang,411325308,15172,2509,12021,7176,23567,12004,6932,12539,24543,12592,24613
ǽֵ´,LongChengJieDaoBanShiChu,411326001,31314,2194,21049,12152,32783,20427,9413,21232,41659,21872,42921
ʥֵ´,ShangShengJieDaoBanShiChu,411326002,34148,2001,23056,12708,26452,19900,10667,20680,40580,23760,46816
Ϲ,JingZiGuanZhen,411326101,31949,3502,23580,12175,46667,23478,12046,23783,47261,23917,47497
ϳ,LaoChengZhen,411326102,19113,2384,14455,7607,28829,14370,7611,14531,28901,14653,29108
㻨,XiangHuaZhen,411326103,29959,2855,21910,10612,43218,21889,11792,22629,44518,22696,44606
,HouPoZhen,411326104,46263,5712,36215,18216,72494,36057,20802,36288,72345,36562,72777
,DanYangZhen,411326105,38020,3570,27717,13284,56537,27699,15188,29043,56742,29061,56778
ʢ,ShengWanZhen,411326106,27634,3900,20177,11216,41070,20174,10537,21888,42062,21894,42071
,JinHeZhen,411326107,29243,2989,19582,9885,35783,18112,9328,20235,38347,21978,41560
,SiWanZhen,411326108,23409,2823,17323,8832,34841,17267,8673,17481,34748,17582,34905
ַ,CangFangZhen,411326109,7437,913,5324,2804,10809,5264,2667,5573,10837,5693,11017
ϼ,ShangJiZhen,411326110,47278,4976,32845,16696,62908,32079,16728,35138,67217,36137,68982
,MaDengZhen,411326111,27825,3015,21075,10348,41103,20827,11746,21234,42061,21511,42586
,XiHuangXiang,411326301,12584,1892,9387,5828,19316,9381,5067,10128,19509,10156,19543
ë,MaoTangXiang,411326302,16623,2233,11694,6586,24587,11672,6192,13313,24985,13354,25048
ʯ,DaShiQiaoXiang,411326303,12864,2095,9924,5962,19630,9892,5107,10021,19913,10142,20066
Ϻ,TaoHeXiang,411326304,25898,3251,19251,10754,38583,19245,10253,20144,39389,20151,39402
޵,SheDianZhen,411327100,46184,4681,29556,16227,50438,25540,9392,26265,51805,30701,60257
ͷ,QiaoTouZhen,411327101,28933,3851,20278,11073,41302,19724,8835,20319,40043,21341,41619
,RaoLiangZhen,411327103,39075,4833,26670,13257,56185,26001,12314,28456,54457,29552,56222
¡,XingLongZhen,411327104,15472,2199,11365,6249,23166,11360,5604,11902,23262,11910,23275
ׯ,JinZhuangZhen,411327105,21497,2544,14911,7312,30508,14748,6594,15425,30173,15724,30635
,LiDianZhen,411327106,37250,4613,25883,12738,53566,25195,11881,26658,51853,27861,53744
,MiaoDianZhen,411327107,23194,3010,16859,8332,34698,16480,8553,17307,33787,17898,34757
կ,HaoZhaiZhen,411327108,39201,4140,27023,13980,55755,26817,12813,28869,55686,29131,56154
켯,ZhuJiZhen,411327109,35378,5190,26256,13537,53686,25743,13583,27009,52752,27895,54151
,XiaWaZhen,411327110,28221,3620,21585,11035,44332,21274,12995,22642,43916,23251,44836
ǽ,ChengJiaoXiang,411327300,34286,3979,23093,12014,43692,22021,9319,23088,45109,24491,47584
Ӫ,DaFengYingXiang,411327301,25796,3176,18051,9521,36554,18047,7621,18493,36540,18542,36593
̫,TaiHeXiang,411327304,17214,2778,13235,7398,26475,13181,6578,13291,26472,13335,26570
İ,MoBeiXiang,411327312,21775,2865,16525,8736,33102,16525,9118,17233,33758,17233,33758
ׯ,TangZhuangXiang,411327313,22915,2839,16236,9280,33195,16199,7877,17242,33441,17395,33631
ӽֵ´,BinHeJieDaoBanShiChu,411328001,79537,6991,51485,24126,71780,38110,19006,38460,76570,54049,105534
ķֵ´,WenFengJieDaoBanShiChu,411328002,81542,6127,50677,22493,62939,36885,18839,37699,74584,55831,106508
Դ̶,YuanTanZhen,411328101,55832,7890,38762,21070,77322,37489,17031,40381,77870,41991,80753
ŵ,ZhangDianZhen,411328102,62597,8308,42266,24499,86388,41508,17170,44805,86313,45809,88075
̲,GuoTanZhen,411328103,46248,7446,32985,18069,68169,32094,15298,34451,66545,36007,68992
,HuYangZhen,411328104,42777,5594,27974,15052,57882,26982,10015,28925,55907,30412,58386
,HeiLongZhen,411328105,32171,4894,22581,13436,46439,22385,9810,23780,46165,24294,46875
,DaHeTunZhen,411328106,43024,6797,31426,16299,65167,30792,15515,32623,63415,33910,65336
̶,LongTanZhen,411328107,28335,4108,19390,10918,40359,19163,8282,20866,40029,21335,40725
ͩկ,TongZhaiPuZhen,411328108,46951,6561,34146,18313,67889,33790,15589,34289,68079,34955,69101
̨,CangTaiZhen,411328109,28422,4057,20330,10379,41331,20212,9772,21589,41801,21921,42251
,ShangTunZhen,411328110,42761,6447,30092,16934,61524,30057,13063,32078,62135,32179,62271
ϵ,BiDianZhen,411328111,35938,5270,26254,14788,53064,25715,12813,26906,52621,27767,54021
ٰ,ShaoBaiSiZhen,411328112,29462,4001,20636,10961,42516,20082,9875,21877,41959,22702,43338
ǽ,ChengJiaoXiang,411328300,46676,5998,32269,17879,64675,31857,13339,33270,65127,33744,66013
ͩ,TongHeXiang,411328301,23066,3219,15936,8562,32756,15574,6904,16611,32185,17253,33189
ø,ZanGangXiang,411328306,43033,6363,30558,17336,62282,30071,13196,31220,61291,32034,62592
,QiYiXiang,411328307,26582,3827,18248,10311,38163,17784,7890,19299,37083,20051,38299
,MaZhenFuXiang,411328308,31163,4216,21978,11960,44697,21352,10004,22617,43969,23405,45383
ų,GuChengXiang,411328309,40245,5597,28377,15884,57823,28188,12073,29218,57406,29538,57915
,DongWangJiXiang,411328311,32197,4044,22164,12104,46278,22038,10464,24373,46411,24541,46705
ǽֵ´,HanChengJieDaoBanShiChu,411329001,50142,4558,32847,19354,49115,30217,12311,30857,61074,34164,67011
ֵ´,HanHuaJieDaoBanShiChu,411329002,41097,3202,26311,15390,35599,24537,9872,25845,50382,27860,54171
ׯ,WangZhuangZhen,411329101,15198,2415,11437,7505,23372,11429,5950,12043,23472,12126,23563
ɳ,ShaYanZhen,411329102,25080,3993,19482,11335,37671,19482,10019,19607,39089,19610,39092
µ,XinDianPuZhen,411329103,31757,4175,23042,13495,44909,23038,9646,22475,45513,22536,45578
ʩ,ShiAnZhen,411329104,32659,4518,23498,13482,46954,23495,11516,25166,48661,25195,48693
,WaiZiZhen,411329105,34120,5604,26935,15850,52430,26932,15044,27827,54759,27833,54768
,WuXingZhen,411329106,26620,4124,19802,12499,39729,19801,9472,20412,40213,20414,40216
,LiHePuZhen,411329107,31846,4372,23012,12620,46994,22999,11283,24431,47430,24489,47501
,WangJiZhen,411329108,24520,4144,19123,11277,37816,19010,10177,19598,38608,19718,38841
ǽ,ChengJiaoXiang,411329300,24796,3133,17487,9717,34960,17484,7833,18267,35751,18275,35762
ǰ,QianGaoMiaoXiang,411329303,19785,3614,15708,9537,32039,15708,8728,16417,32125,16419,32127
,FanJiXiang,411329305,16004,2525,12537,7115,24150,12536,6238,12230,24766,12230,24767
ׯ,ShangZhuangXiang,411329307,23253,4291,19245,11779,36803,19242,11029,19303,38545,19328,38573
ϸ,ShangGangXiang,411329309,26736,3043,19166,9980,37397,17751,8768,18762,36513,19381,38547
ǹ,ChengGuanZhen,411330100,53750,4733,35898,22302,56343,34779,14834,36205,70984,37419,73317
º,YueHeZhen,411330101,18053,2506,12656,7841,25874,12655,5686,13575,26230,13589,26245
,WuChengZhen,411330102,16906,2090,11947,6970,24286,11867,5962,12948,24815,13011,24958
,GuXianZhen,411330103,14776,1741,10623,6376,21141,10623,5485,11377,22000,11379,22002
ë,MaoJiZhen,411330104,24962,2486,18230,9987,34580,18135,10357,19437,37572,19575,37805
,DaHeZhen,411330105,7330,1100,5468,3311,10448,5236,2883,5529,10765,5845,11313
,BuJiangZhen,411330106,24244,2748,16692,10880,30090,16644,7233,17369,34013,17533,34225
ƽ,PingShiZhen,411330107,13334,2052,10222,6081,19707,9905,5208,9925,19830,10372,20594
Դ,HuaiYuanZhen,411330108,12352,1791,9315,5777,17869,9301,4818,9536,18837,9646,18961
Ƹ,HuangGangZhen,411330109,11066,1280,8207,4810,15219,8100,5115,8363,16463,9254,17461
,AnPengZhen,411330110,20615,2337,14669,8202,28283,14389,7906,15402,29791,16189,30858
ǽ,ChengJiaoXiang,411330300,19917,2118,13883,7916,22926,12748,6343,13350,26098,14495,28378
,HuiLongXiang,411330301,5343,658,3938,2216,8168,3888,2260,4263,8151,4323,8261
ׯ,ZhuZhuangXiang,411330303,7773,824,5529,3359,10370,5444,2991,5836,11280,6059,11588
,ChengWanXiang,411330305,7158,1238,5334,3436,10852,5304,2738,5735,11039,5800,11134
¼,XinJiXiang,411330306,10751,1599,8228,4953,16361,8150,4492,8501,16651,8614,16842
ųǽֵ´,GuChengJieDaoBanShiChu,411381001,72071,5772,44636,23226,66981,38082,15907,39800,77882,49114,93750
޽ֵ´,HuaZhouJieDaoBanShiChu,411381002,105882,7258,61579,30239,74809,46984,20567,48660,95644,72128,133707
ĺӽֵ´,TuanHeJieDaoBanShiChu,411381003,41557,3552,29006,13669,49894,26450,12466,28110,54560,28569,57575
ׯ,LuoZhuangZhen,411381102,30449,4423,22586,12135,45607,21684,11218,21705,43389,23504,46090
̲,JiTanZhen,411381103,32960,4891,24527,13931,49375,24502,12003,25295,49797,25327,49854
𦶫,RangDongZhen,411381104,48705,6025,33665,17450,68496,31360,15881,32567,63927,36946,70611
¥,MengLouZhen,411381105,20197,2001,14012,6640,27554,13596,6941,14417,28013,15127,29139
ְ,LinBaZhen,411381106,28089,3143,20237,10344,39480,19609,10878,20276,39885,21873,42110
,GouLinZhen,411381107,54393,5729,39757,20581,80289,38828,21931,41127,79955,42296,82053
ʮ,ShiLinZhen,411381108,35578,4639,26499,14129,53092,26120,13317,26528,52648,27035,53534
Ŵ,ZhangCunZhen,411381109,37855,4298,28324,14285,55655,28172,15027,28621,56793,28856,57180
˾,DouSiZhen,411381110,25155,2914,18696,9856,39053,18406,11095,19862,38268,20468,39164
Լ,ZhaoJiZhen,411381111,34800,4949,25605,14315,52452,25596,13200,27323,52919,27344,52949
,LiuJiZhen,411381112,45353,4630,30853,15313,60964,29745,14276,31825,61570,33406,64259
ɣׯ,SangZhuangZhen,411381113,29264,3571,22444,11930,44375,22417,12930,23303,45720,23321,45765
,PengQiaoZhen,411381114,25163,2665,18419,9416,36099,18177,10579,18474,36651,19988,38407
¥,ZhangLouXiang,411381301,25403,2900,17340,8917,35694,17143,7733,18260,35403,18696,36036
ţ,BaiNiuXiang,411381302,27478,3642,18902,10346,38991,18397,8218,19543,37940,20436,39338
ļ,XiaJiXiang,411381304,42513,5227,29868,15110,61267,29846,13662,31488,61334,31534,61402
Ӫ,PeiYingXiang,411381305,57053,5969,38222,19167,78224,36959,18658,39685,76644,43458,81680
,WenQuXiang,411381310,31156,4232,23726,11939,47641,22848,12801,23044,45892,24463,48189
߼,GaoJiXiang,411381311,35003,3766,25686,13314,51723,25654,13597,26616,52270,26680,52366
Ӫ,TaoYingXiang,411381313,23420,2833,17650,9771,36817,17217,10673,18607,35824,19276,36926
СӪ,XiaoYangYingXiang,411381316,20842,2597,15675,8488,31692,15516,8604,16121,31637,16368,32043
,YaoDianXiang,411381318,26641,3495,20421,11058,40261,20411,11529,21217,41628,21244,41665
,LongYanXiang,411381319,24202,2999,18949,10426,36755,18830,10776,18939,37769,19028,37977
,JiuLongXiang,411381320,22910,2570,17502,8842,35012,17357,10127,17878,35235,18105,35607
лţַ,NanYangShiHuangNiuLiangZhongFanYuChang,411381400,122,22,80,57,161,80,23,87,167,87,167
ɽι,XingShanLvYouGuanLiQu,411381560,5594,663,4259,2274,8281,4160,2357,4189,8349,4355,8614
ǰֵ,QianJinJieDao,411402001,23710,1923,16080,10465,27165,16023,6064,15571,31594,15617,31697
ֵ,ChangZhengJieDao,411402002,32061,3419,20817,13405,37623,20736,6449,20986,41722,21112,41929
˰˽ֵ,BaBaJieDao,411402003,25854,3032,17069,10791,28273,16556,4987,16427,32983,16804,33873
ֵ,DongFengJieDao,411402004,22536,3053,15096,9484,24116,14197,4342,14132,28329,14835,29931
ݽֵ,ZhongZhouJieDao,411402005,24068,1991,15367,8531,25693,15176,5133,15664,30840,15825,31192
ƽֵ,BaiYunJieDao,411402006,38439,3593,25407,16645,34640,25323,8394,24907,50230,25019,50426
ƽԭֵ,PingYuanJieDao,411402007,37177,1962,24406,10283,27288,17035,6050,17079,34114,20783,45189
ֵ,JianSheJieDao,411402008,32731,3472,20866,11635,38556,20726,6224,20323,41049,21561,42427
ƽֵ̨´,PingTaiJieDaoBanShiChu,411402009,27421,1802,16713,5593,23811,11630,4047,11896,23526,16557,33270
ƽֵ´,PingAnJieDaoBanShiChu,411402010,28959,2293,17545,6917,29688,14915,5337,15041,29956,19044,36589
л,XieJiZhen,411402100,34237,3304,22797,11168,46432,22797,9036,23779,46576,23780,46577
˫,ShuangBaZhen,411402101,38141,3866,24592,11404,50449,24591,8635,26047,50638,26050,50642
Ÿ,ZhangGeZhen,411402102,25600,2723,16561,8616,34406,16559,6122,17883,34442,17884,34445
ܼ,ZhouJiXiang,411402200,21472,2288,14230,7200,29038,14230,5434,14964,29194,14964,29194
ˮ,ShuiChiPuXiang,411402201,27586,3088,18207,8797,36946,18193,7247,19674,37867,19714,37921
,GuanTangXiang,411402202,30086,3372,20497,9277,38837,20496,8485,21440,41936,21446,41943
¥,WangLouXiang,411402203,26930,2471,17158,9911,35995,17147,6636,18817,35964,18879,36037
ׯ,LiZhuangXiang,411402204,43084,4149,29014,13863,57073,29014,11047,29266,58280,29266,58280
︣,SunFuJiXiang,411402205,30412,3196,20628,10453,41776,20628,8461,21441,42069,21441,42069
,LiuKouXiang,411402206,25644,2929,16756,7918,34046,16749,5780,17542,34291,17597,34353
ųǽֵ´,GuChengJieDaoBanShiChu,411403001,31720,4349,21502,11659,35921,19638,6566,19911,39549,21133,42635
Ļֵ´,WenHuaJieDaoBanShiChu,411403002,14038,1686,9342,5540,15016,8875,2971,8965,17840,9353,18695
ֵ´,DongFangJieDaoBanShiChu,411403003,23312,2088,15026,10019,24302,15022,4948,15315,30337,15322,30348
³ǽֵ´,XinChengJieDaoBanShiChu,411403004,59051,4330,35756,21519,49027,35132,12401,36591,71723,40026,75782
μ,SongJiZhen,411403100,23312,2985,17070,10095,33567,16827,7907,16905,33732,17134,34204
,GuoCunZhen,411403101,34316,4702,25325,14141,49624,25309,11979,25646,50955,25672,50997
,LiKouZhen,411403102,30211,4165,21798,11890,43551,21783,9378,21948,43731,21956,43754
,GaoXinZhen,411403103,28548,3748,20617,12492,40023,20599,8971,20629,41228,20650,41267
ǽ,WuQiangZhen,411403104,27978,3753,20206,13020,41059,20177,9495,20972,41149,21020,41226
,GuSongXiang,411403200,43435,3914,27734,14399,52745,26452,11028,27190,53642,30643,58377
Ƽ,YanJiXiang,411403201,34195,3854,23143,12700,47120,23142,9205,24106,47248,24111,47254
,FengQiaoXiang,411403202,17673,2669,13974,8897,25666,13870,6952,13169,27039,13320,27294
,BaoGongMiaoXiang,411403204,21047,3091,15223,9540,30423,15194,6376,15246,30440,15291,30514
¦,LouDianXiang,411403205,23547,2781,16261,8371,32965,16261,6701,16768,33029,16768,33029
ë̶,MaoGuDuiXiang,411403206,28108,3910,21146,12105,41594,21136,9878,20736,41872,20750,41896
·,LuHeXiang,411403207,31652,4023,23031,13217,45734,23031,10177,22821,45852,22821,45852
,LeMaXiang,411403208,32996,4096,23723,13644,47066,23714,10793,24140,47854,24162,47885
ٺӵ,LinHeDianXiang,411403209,25601,3477,18204,10739,37227,18172,8321,19160,37332,19195,37399
ǹ,ChengGuanZhen,411421100,87939,8019,55923,31289,102139,50630,17691,53031,103661,57726,113649
˺,RenHeZhen,411421101,31600,3717,22866,12269,45236,22866,10479,22930,45796,22930,45796
,LongTangZhen,411421102,30116,3937,22759,14182,44325,22753,10447,21728,44481,21741,44500
,BeiGuanZhen,411421103,34822,4531,26540,16363,51974,26539,12702,25515,52054,25515,52055
ׯ,ChengZhuangZhen,411421104,43727,5953,33491,19309,63563,33487,15796,31950,65437,31985,65476
ׯկ,WangZhuangZhaiZhen,411421105,18988,2746,14647,8067,27347,14647,5832,12919,27566,12919,27566
,SunLiuZhen,411421106,20117,2513,14283,8604,28678,14268,6248,14571,28839,14595,28878
,BoDangXiang,411421200,10816,1474,8048,4680,15667,8048,3418,7660,15708,7660,15708
԰,HuaYuanXiang,411421201,14332,1779,10565,6916,20589,10564,4676,10203,20767,10222,20787
,YinDianXiang,411421202,30791,3435,22151,13715,44082,22147,10177,22244,44391,22252,44403
Ұ,YeGangXiang,411421204,26141,3082,19214,12210,37827,19214,9234,19239,38453,19243,38457
˫,ShuangTaXiang,411421205,19550,2178,13626,8240,27674,13626,6077,14179,27805,14179,27805
,LinQiXiang,411421206,19737,2403,14273,8715,28007,14273,6154,14021,28294,14021,28294
,HuJiXiang,411421207,10023,1133,7163,4445,14079,7163,3131,7123,14286,7124,14287
,ZheMiaoXiang,411421208,21276,2219,14793,8538,30128,14742,6733,15295,30037,15435,30228
ռ,LaoYanJiXiang,411421210,20094,2470,15814,8929,29919,15814,7650,14400,30214,14400,30214
˳,ShunHeXiang,411421211,18702,2316,14284,7965,27568,14284,6595,13329,27613,13329,27613
,WangQiaoXiang,411421212,28494,3514,21589,12417,41680,21589,9954,20373,41962,20373,41962
ũ,ShangQiuShiNongChang,411421400,2168,256,1540,842,2730,1540,601,1485,3025,1485,3025
ֳ,ShangQiuShiLinChang,411421401,2073,158,1276,792,2675,1276,494,1449,2725,1449,2725
,ChangGangZhen,411422100,19792,2477,14505,8687,29430,14496,7252,14984,29480,15016,29521
ƽ,PingGangZhen,411422101,23781,3107,17026,9635,34362,17019,7552,17396,34415,17414,34440
,ZhouTangZhen,411422102,19544,2575,14625,9041,28206,14616,6176,13652,28268,13670,28295
ޤ,LiaoDiZhen,411422103,26457,3389,19188,12138,38507,19187,8884,19541,38728,19542,38730
,XiLingSiZhen,411422104,25741,3350,18823,12042,37479,18783,8711,18933,37716,18979,37802
ǹ,ChengGuanZhen,411422105,44266,3913,29521,14794,45070,26849,11099,27601,54450,29757,59278
ׯ,ChaoZhuangZhen,411422106,20022,2474,14752,8712,29824,14752,7355,15099,29851,15099,29851
,ShangTunZhen,411422107,25013,3096,18059,10756,35962,18045,7924,17945,35990,17974,36033
̨,HouTaiXiang,411422200,13835,1677,10099,6494,20220,10099,4773,10186,20285,10186,20285
Ӽ,HeJiXiang,411422202,26330,3848,20353,12709,39204,20346,9149,18946,39292,18974,39327
կ,SunJuZhaiXiang,411422203,27322,3621,19083,10298,38566,19070,7683,19522,38592,19543,38626
¥,BaiLouXiang,411422204,17821,2558,13549,8369,26650,13545,6401,13220,26765,13231,26780
ӵ,HeDiXiang,411422205,19986,2838,16054,10077,30448,16050,7716,14465,30515,14486,30540
,BaiMiaoXiang,411422206,19949,2700,14340,8827,28403,14332,6115,14407,28739,14424,28764
,HuTangXiang,411422207,11601,1747,9176,5857,17447,9176,4181,8353,17529,8353,17529
ȼ,YouJiTunXiang,411422208,19645,3297,15233,9730,29204,15221,6572,14247,29468,14281,29514
,DongDianXiang,411422210,33636,4534,24452,14526,48523,24449,10913,24628,49077,24631,49083
,JianGangXiang,411422211,21909,2795,16131,9968,32060,16130,7727,16295,32425,16300,32431
,KuangChengXiang,411422213,29449,3819,21996,13016,44155,21996,10960,22232,44228,22232,44228
ǽ,ChengJiaoXiang,411422214,46755,3867,30777,13736,42758,22873,9457,22493,45366,29302,60079
ǹ,ChengGuanZhen,411423100,36443,3108,24150,11522,44814,23177,9704,24136,47313,25105,49255
Ź,ZhangGongZhen,411423101,21248,3071,16779,10804,32555,16738,8244,15732,32470,15784,32563
,LiuHeZhen,411423102,34167,4162,24473,13413,47957,24386,10312,24044,48430,24168,48641
߸,LuoGangZhen,411423103,27851,2944,19486,11802,39520,19484,9124,20427,39911,20433,39919
ʯ,ShiQiaoZhen,411423104,28421,3462,20798,12021,40509,20798,8782,19867,40665,19867,40665
Ƹ,HuangGangXiang,411423200,19360,2713,16150,9915,30419,16148,8427,14349,30497,14350,30500
,HuaBaoXiang,411423201,30340,4130,23534,13668,46072,23534,11642,22578,46112,22578,46112
¥,LiuLouXiang,411423203,24330,3047,17739,9620,35163,17738,7857,17493,35231,17495,35234
¥,ChengLouXiang,411423204,20560,3114,15586,9843,30287,15584,6853,14940,30524,14941,30527
¥,QiaoLouXiang,411423205,25722,3755,18668,10543,36775,18668,7879,18688,37356,18688,37356
ǽ,ChengJiaoXiang,411423206,25276,2403,16988,8596,28320,14621,6087,14440,29061,16778,33766
,YangYiXiang,411423207,28665,3395,20221,12806,40985,20221,8935,20774,40995,20774,40995
׼,KongJiXiang,411423209,18953,2987,14276,9287,27848,14276,6009,13673,27949,13673,27949
Դ,ZhaoCunXiang,411423210,19746,3157,15333,9652,29887,15327,7018,14571,29898,14588,29921
ϳسǹ,ZheChengXianChengGuanZhen,411424100,51696,3985,31694,19471,59593,30840,11635,34201,65041,35622,67316
༯,ChenQingJiZhen,411424101,22685,3547,17006,11403,33645,17006,7432,16658,33664,16658,33664
̨,QiTaiZhen,411424102,23550,3593,17223,11667,34523,17138,7473,17113,34251,17393,34616
,HuXiangZhen,411424103,21695,3392,16772,11020,33085,16772,8118,16430,33202,16433,33205
ʥ,CiShengZhen,411424104,26246,3662,19963,12581,39368,19838,9557,19325,39163,19502,39465
ƽ,AnPingZhen,411424105,31114,5064,24428,15732,48405,24428,12303,24052,48480,24053,48481
Զ,YuanXiangZhen,411424106,19651,3097,15711,10662,30879,15711,8161,15198,30909,15198,30909
Ԫ,ShaoYuanXiang,411424200,24479,2926,17246,10030,30537,15890,6645,15246,31136,16804,34050
,ZhangQiaoXiang,411424201,20520,3093,15874,9876,30662,15874,7091,14829,30703,14830,30704
ׯ,LiangZhuangXiang,411424202,33961,3264,22327,12523,40443,20091,8218,20404,40495,23116,45443
,HongEnXiang,411424203,16035,2753,12649,8216,24587,12649,5833,11972,24621,11972,24621
,LaoWangJiXiang,411424204,18263,3045,14642,9417,27868,14642,6887,13553,28195,13553,28195
,DaWuXiang,411424205,22712,3303,16293,11044,33084,16293,7094,16816,33109,16816,33109
�,MaJiXiang,411424206,17597,2694,14488,8982,27750,14488,7459,13262,27750,13262,27750
ţ,NiuChengXiang,411424207,27759,3628,19216,11925,37905,18788,7565,19372,38160,19736,38952
ݼ,HuiJiXiang,411424208,25580,3700,20061,11996,38833,20061,9976,19187,39248,19195,39256
,BoGangXiang,411424210,27385,4084,22083,13689,41946,22083,10512,19898,41981,19898,41981
,GangWangXiang,411424211,27982,4363,21592,12666,41587,21592,9555,20307,41899,20308,41900
,ShenQiaoXiang,411424212,23213,3712,18582,11861,36340,18582,9507,17850,36432,17850,36432
ԭ,LiYuanXiang,411424213,25125,3396,18059,11038,36460,18030,8002,18322,36352,18464,36523
ʼ,HuangJiXiang,411424214,21259,3101,15979,9511,31464,15979,7226,15607,31586,15607,31586
ǹ,ChengGuanZhen,411425100,46260,3507,28580,14349,45301,23882,8909,25167,49049,30096,58676
繵,JieGouZhen,411425101,22660,3705,16622,11655,33631,16622,7322,17065,33687,17065,33687
Ӫ,YingGuoZhen,411425102,13983,2168,10833,7632,21125,10833,5185,10503,21336,10503,21336
ż,DuJiZhen,411425103,26253,3810,19941,12405,39560,19941,9513,19634,39575,19635,39576
,GuShuZhen,411425104,20121,2734,14760,8733,29260,14756,6543,14599,29355,14638,29398
,DaYangJiZhen,411425105,17222,2135,12783,8653,25044,12782,5766,12334,25116,12340,25123
կ,JiaZhaiZhen,411425106,31658,3847,22861,12828,44819,22850,9364,22002,44852,22008,44869
,LiMinZhen,411425107,31738,4074,23254,13263,44718,23254,9701,22259,45513,22259,45513
ż,ZhangJiZhen,411425108,23811,2996,16906,10087,34076,16906,7312,17213,34119,17213,34119
վ,ZhanJiZhen,411425109,24943,3234,17756,11276,36213,17744,8378,18759,36503,18799,36555
ڣ,HuangZhongXiang,411425200,28337,3557,20155,12182,41090,20155,9264,21003,41158,21003,41158
ɳ,ShaJiXiang,411425201,16679,2897,13423,9144,26395,13423,7142,13295,26718,13295,26718
꼯,DianJiXiang,411425202,20874,3420,16239,10963,31559,16232,7710,15734,31966,15765,32004
ż,WenJiXiang,411425204,23574,3330,17930,12238,35613,17930,8722,17696,35626,17696,35626
â,MangZhongQiaoXiang,411425205,24117,3067,16972,9211,34243,16972,7079,17291,34263,17291,34263
,LiuDianXiang,411425207,30788,4283,22293,14690,45078,22284,10386,23145,45429,23164,45457
,DaHouXiang,411425208,32398,4117,22530,15241,45845,22530,9613,23598,46128,23598,46128
ǽ,ChengJiaoXiang,411425210,42366,3410,28008,13598,47616,24828,10055,24834,49662,27823,55831
֣,ZhengJiXiang,411425211,18822,2170,13666,7827,26214,13665,5429,12755,26420,12755,26421
ϼ,LiLaoJiaXiang,411425212,32264,3729,22114,12597,44804,22114,8864,22743,44857,22743,44857
Ը,ShaoGangXiang,411425213,41432,4535,27922,15987,57822,27917,11929,29969,57886,29974,57896
,ZhenLiGuXiang,411425214,14077,2143,10899,7242,21133,10879,5024,10293,21172,10345,21244
,GuWangJiXiang,411425215,21035,2367,14278,8048,28980,14278,5693,14817,29095,14817,29095
,LiuJiXiang,411425219,26370,3235,18924,10224,36886,18903,8467,19124,38027,19148,38072
Ǽ,QiaoJiXiang,411425220,19404,2217,13410,8399,27348,13404,5730,13934,27338,13941,27351
,TianMiaoXiang,411425221,15849,2213,12191,7031,23186,12191,5750,11621,23812,11621,23812
ǹ,ChengGuanZhen,411426100,59118,4601,38040,22110,66540,36357,15214,39107,75464,40893,78933
ͤ,HuiTingZhen,411426101,29229,4222,21215,14324,42196,21209,9278,21514,42723,21514,42729
ͷ,MaTouZhen,411426102,20891,3951,15677,11292,31540,15677,7031,16191,31868,16196,31873
,JiYangZhen,411426103,18499,3010,13856,9929,27765,13856,6318,13971,27827,13971,27827
,LiJiZhen,411426104,39509,5246,28178,18465,56570,28178,12090,28667,56845,28667,56845
վ,CheZhanZhen,411426105,34291,4156,23695,14895,46748,23695,8579,23331,47026,23331,47026
,YangJiZhen,411426106,23856,3862,17994,11775,35318,17994,7761,17485,35479,17485,35479
,HanDaoKouZhen,411426107,26402,4038,20043,12050,39037,20041,8960,19354,39395,19357,39400
ܼ,CaoJiXiang,411426200,35929,3703,24504,13838,36612,22378,8919,23320,45698,24047,48551
,HuQiaoXiang,411426201,23216,3875,17865,12541,34571,17865,7618,16844,34709,16844,34709
,QiHeXiang,411426202,20016,3810,16009,11212,30522,16008,6936,14753,30761,14753,30762
,GuoDianXiang,411426203,23399,3734,17526,11921,34149,17526,7082,16689,34215,16689,34215
ҵ,YeMiaoXiang,411426204,28412,4868,21435,13866,42723,21435,9821,21666,43101,21666,43101
з,ZhongFengXiang,411426205,16586,2585,12705,8072,24984,12705,6117,12583,25288,12583,25288
ׯ,LuoZhuangXiang,411426206,16862,3305,13229,9665,26202,13210,6311,13238,26448,13249,26478
ɣ,SangGuXiang,411426207,25663,3867,18910,12425,36934,18909,7939,18558,37467,18559,37469
Ӫ,HeYingXiang,411426208,16900,2719,12905,9141,24957,12904,5511,12216,25120,12225,25130
,WangJiXiang,411426210,21148,3223,14991,9793,30138,14991,5998,15378,30369,15378,30369
꼯,LiuDianJiXiang,411426211,18535,2781,13569,8795,26883,13569,5706,13453,27022,13453,27022
漯,LuoJiXiang,411426212,20719,3912,16375,11652,32339,16375,7739,15995,32370,15995,32370
̫ƽ,TaiPingXiang,411426213,29379,4830,22359,15340,44067,22358,9990,21840,44198,21840,44199
ׯ,KongZhuangXiang,411426214,25874,4725,19503,13004,38876,19502,8554,19643,39145,19650,39153
,HuoDianXiang,411426215,24734,4483,19207,12143,37800,19168,8894,18855,38023,18904,38111
,BeiZhenXiang,411426216,25592,4299,19280,13275,37823,19279,8361,18966,38245,18972,38252
ݼ,YanJiZhen,411481100,110875,7354,68188,39816,102794,58468,24651,62832,121300,74692,142880
ǹ,ChengGuanZhen,411481101,81530,5893,51496,25875,82173,47997,19721,51509,99506,55648,107144
âɽ,MangShanZhen,411481102,28207,4671,21217,13553,40654,20828,9192,20608,41436,20853,42070
ׯ,GaoZhuangZhen,411481103,31089,4707,21337,13152,43605,21305,9685,22796,44101,24144,45481
,CuoChengZhen,411481104,24812,4542,19781,12884,37649,19776,8829,18396,38172,18402,38183
,PeiQiaoZhen,411481105,27433,4654,23542,14739,43880,23538,12325,20866,44404,20870,44412
,MaQiaoZhen,411481106,28004,4485,23764,13278,43014,23631,13164,21653,45284,21889,45653
Ѧ,XueHuZhen,411481107,43568,7925,33132,21874,65735,33130,14486,32844,65974,32847,65979
,JiangKouZhen,411481108,29201,5716,22244,13977,44008,22243,9580,22252,44495,22253,44497
¼,ChenJiZhen,411481109,36017,5978,26137,16111,51593,26119,11607,26948,53067,27465,53602
ʮ,ShiBaLiZhen,411481110,16648,2666,12388,7691,24362,12388,5409,12334,24722,12335,24723
̫,TaiQiuZhen,411481111,15899,3362,12349,8445,24192,12349,5274,12186,24535,12186,24535
կ,LiZhaiZhen,411481112,20378,2790,15448,8886,30283,15448,7703,15414,30862,15423,30871
,MiaoQiaoXiang,411481113,18608,3523,13852,8871,27329,13852,6591,14362,28214,14870,28722
˳,ShunHeXiang,411481114,21478,4399,16471,10265,32446,16471,7095,16501,32972,16501,32972
,HuiCunXiang,411481115,21512,3871,16042,9761,31336,16036,6790,16115,32151,16131,32173
,ChengXiangXiang,411481200,22257,3404,16541,10982,32641,16540,7205,16321,32861,16325,32866
,HouLingXiang,411481201,29190,4479,21941,13400,42713,21924,10151,21825,43749,21879,43820
ƿ,HuangKouXiang,411481202,20712,3374,16377,9556,31646,16183,8466,15803,31986,16175,32552
,XinQiaoXiang,411481203,24823,3639,18743,10891,37408,18730,9793,19004,37734,19512,38255
˫,ShuangQiaoXiang,411481204,23702,4202,19346,11490,36861,19346,10147,18705,38051,18705,38051
,WangJiXiang,411481205,13434,3187,12391,8810,22797,12389,6650,10864,23253,10880,23271
,WoLongXiang,411481207,17384,3150,14163,9607,27313,14110,7288,13476,27586,13659,27822
,LongGangXiang,411481208,24099,4994,18963,12621,37403,18951,8517,18631,37582,18647,37610
,MaMuXiang,411481209,20749,4017,16164,10770,31551,16083,7227,15757,31840,15829,31993
,CuoYangXiang,411481210,24757,4546,19582,13067,38229,19582,9389,19109,38691,19110,38692
,TiaoHeXiang,411481217,25058,4798,19842,12137,38934,19653,9575,19147,38800,19589,39431
,LiuHeXiang,411481218,23137,4338,17441,10962,34395,17437,7879,17691,35128,17913,35354
¹ׯ,ChenGuanZhuangXiang,411481219,11005,2104,8337,5263,16591,8337,3659,8431,16768,8431,16768
ϳǽֵ´,LaoChengJieDaoBanShiChu,411502001,29868,3928,20339,14030,31364,20121,6071,19309,39430,19528,39867
Ȩֵ´,MinQuanJieDaoBanShiChu,411502002,29817,3226,21914,10008,19436,13992,4058,13422,27414,15187,37101
վֵ´,CheZhanJieDaoBanShiChu,411502003,25140,3183,16275,11608,20690,15858,4550,15871,31729,16598,32873
սֵ´,WuLiDunJieDaoBanShiChu,411502004,32009,3988,21289,15022,23752,21098,6051,20510,41608,20759,42048
ǽֵ´,WuXingJieDaoBanShiChu,411502005,65271,4368,43629,21595,26565,31691,11549,31144,62835,37559,81188
ֵ´,HuDongJieDaoBanShiChu,411502006,33528,2493,21620,12279,15087,17261,5492,17108,34369,19893,41513
ֵ´,NanWanJieDaoBanShiChu,411502007,17089,1972,11035,6901,14779,10016,3498,9970,19986,11524,22559
ţɽֵ´,JinNiuShanJieDaoBanShiChu,411502008,26021,1903,17539,7670,12918,11114,3959,11223,22337,14344,31883
˫ֵ´,ShuangJingJieDaoBanShiChu,411502009,9490,968,6309,3588,12414,6304,2364,6492,12796,6513,12822
կ,LiJiaZhaiZhen,411502100,14975,2656,11020,7840,20488,10963,4630,10935,21898,11241,22261
ҵ,WuJiaDianZhen,411502101,23002,2907,16585,10295,32916,16580,8174,17467,34047,17498,34083
˫,DongShuangHeZhen,411502102,22849,3108,15688,10224,30415,15456,5680,15721,31177,15949,31637
Һ,DongJiaHeZhen,411502103,20158,2707,13924,9099,27687,13914,5884,14810,28724,14825,28749
Ӹ,ShiHeGangZhen,411502104,19011,2324,12866,7828,26149,12849,5265,13723,26572,13734,26600
κ,YouHeXiang,411502203,30352,3437,20815,12309,41035,20805,8847,21775,42580,21821,42636
̷Һ,TanJiaHeXiang,411502206,15716,2394,10977,7223,21785,10966,4362,11448,22414,11495,22472
,LiuLinXiang,411502207,11633,1787,8088,5866,15115,8006,3140,8174,16180,8472,16560
ʮ,ShiSanLiQiaoXiang,411502208,20259,2574,13331,8018,26453,13308,4706,14199,27507,14208,27539
ɽֵ´,YangShanJieDaoBanShiChu,411503001,18405,3299,12535,9472,17445,12396,2934,11980,24376,12103,24638
ǰֵ´,QianJinJieDaoBanShiChu,411503002,29925,1543,19900,8347,10965,13227,5572,13367,26594,17140,37040
Ͼ·´,NanJingLuBanShiChu,411503003,14666,1061,9628,6353,4659,9597,3765,9806,19403,9864,19492
ƽŽֵ´,PingQiaoJieDaoBanShiChu,411503004,43977,3441,28371,18850,34134,27470,10660,27648,55118,29707,58078
ʰֵ´,GanAnJieDaoBanShiChu,411503005,12964,1592,9418,5676,17326,9417,4201,9339,18756,9339,18757
ֵ´,WuLiDianJieDaoBanShiChu,411503006,12311,1466,8752,5598,15005,8705,3900,8809,17514,8925,17677
,MingGangZhen,411503101,69034,7005,47049,28818,84067,45781,19380,46470,92251,48370,95419
,WuLiZhen,411503102,8815,1399,6922,4529,12967,6908,3376,6644,13552,6668,13590
ϼ,XingJiZhen,411503103,15086,2598,11791,7642,22960,11789,6258,12149,23938,12151,23942
ƽ,PingChangZhen,411503105,27314,3945,20832,13078,38825,20342,10687,20629,40971,21114,41946
,YangHeZhen,411503106,11297,1851,8771,5826,15130,8656,3958,8182,16838,8335,17106
Ф,XiaoWangXiang,411503201,12445,2010,9924,6619,18785,9905,5142,9641,19546,9673,19597
,LongJingXiang,411503202,9365,1585,7473,4856,13746,7464,3718,7165,14629,7195,14668
,HuDianXiang,411503203,18058,2756,13696,8822,26129,13677,6884,13960,27637,14002,27698
,PengJiaWanXiang,411503205,9130,1298,6873,4539,12708,6871,2942,6483,13354,6497,13370
̨,ChangTaiXiang,411503206,15332,1911,10682,6440,20248,10421,4378,10663,21084,10939,21621
Ф,XiaoDianXiang,411503207,12295,1626,9291,5179,17101,9290,4513,9116,18406,9143,18434
,WangGangXiang,411503209,10363,1831,8247,5350,15887,8237,4482,8394,16631,8429,16676
,GaoLiangDianXiang,411503210,8458,1517,6754,4816,12793,6750,3885,7004,13754,7106,13860
ɽ,ChaShanXiang,411503211,13607,1864,10149,6279,19472,10137,5188,10474,20611,10510,20659
ݰ´,TianTiBanShiChu,411503400,6360,749,4352,2616,8055,4334,1899,4599,8933,4656,9008
۹ҵ,MingGangGongYeGuanLiQu,411503401,6846,1274,5798,3867,10207,5788,3382,5646,11434,5704,11502
ɽ羰,ZhenLeiShanFengJingGuanLiJu,411503402,6459,878,4449,2895,8001,4441,1727,4558,8999,4615,9064
ƽŹҵ԰,PingQiaoGongYeYuan,411503403,4754,439,3197,1870,5801,3173,1225,3159,6332,3221,6418
ַ,ChengYangChengZhiBaoHuQu,411503404,4099,588,3045,1935,5779,3045,1318,2953,5998,2960,6005
ɽ´,LongFeiShanBanShiChu,411503405,6260,615,4126,2619,7273,4089,1756,4209,8298,4505,8631
羰,BeiHuFengJingGuanLiQu,411503406,4206,500,2879,1772,5515,2876,1063,2883,5759,2890,5769
Ƕ´,ChengDongBanShiChu,411503407,11740,1403,8100,5034,15355,8070,3229,8154,16224,8272,16372
ũĸ﷢չۺ,NongCunGaiGeFaZhanZongHeShiYanHeXinQu,411503408,2843,439,2133,1325,3928,2130,884,2014,4144,2033,4166
ƽֵ´,PingXiJieDaoBanShiChu,411503409,19216,1048,11678,7200,10462,10537,4184,10624,21161,12770,24448
ǹ,ChengGuanZhen,411521100,44674,4057,29769,18700,45481,28464,11113,28594,57058,30075,59844
ܵ,ZhouDangZhen,411521101,20613,3923,16407,10422,30599,16037,8160,15747,31784,16289,32696
,ZhuGanZhen,411521102,23085,3063,17528,10506,34072,17505,8987,17524,35029,17607,35135
ɽ,LingShanZhen,411521103,10410,1836,7853,5339,15335,7583,3807,7817,15400,8200,16053
·,ZiLuZhen,411521104,22341,3296,16176,9878,32470,16042,7193,16402,32444,16654,32830
骸,NanGanZhen,411521105,21112,2683,15035,8791,27060,13994,6298,13908,27902,15058,30093
ɽ,QingShanZhen,411521106,9814,1973,7608,5404,14173,7588,3689,7784,15372,7868,15476
,PanXinZhen,411521107,12073,2600,9391,6383,18275,9210,4655,9657,18867,9937,19328
,PengXinZhen,411521108,16033,3599,13215,9029,24598,13096,7024,13190,26286,13441,26656
ç,MangZhangZhen,411521109,18444,2923,14565,9032,26403,13996,6942,13191,27187,13744,28309
ɽ,LongShanXiang,411521200,33845,2807,20183,12070,27750,19605,8823,20055,39660,25292,45475
,DongBuXiang,411521201,19926,2497,14846,8915,28757,14846,7287,14864,29710,14864,29710
,MiaoXianXiang,411521202,14925,2182,11274,6602,22054,11232,5315,11048,22280,11148,22422
Զ,DingYuanXiang,411521204,11887,2582,10367,6813,18603,10345,5963,9993,20338,10065,20432
ɽ,ShanDianXiang,411521205,7541,1668,6409,4504,12083,6381,3574,6338,12719,6374,12783
,TiePuXiang,411521206,5316,1235,4150,3125,8183,4149,1823,4219,8368,4224,8374
,ZhuTangXiang,411521207,11417,1942,8307,5906,17031,8300,4020,9011,17311,9072,17379
ȵ,YouDianXiang,411521208,14986,2114,10851,6733,21405,10846,4722,10929,21775,10971,21822
ߵ,GaoDianXiang,411521209,17940,2629,13464,8380,26734,13436,6426,13359,26795,13531,26995
ʡһũ,HeNanShengWuYiNongChang,411521400,1972,435,1398,1222,2444,1398,358,1360,2758,1367,2765
ɽֵ´,XianShanJieDaoBanShiChu,411522001,47099,4546,31540,18126,63607,31517,14094,34120,65637,34199,65739
ˮֵ´,ZiShuiJieDaoBanShiChu,411522002,42113,3583,29003,16606,48365,28967,13835,30424,59391,30528,59531
ʮ,ShiLiZhen,411522101,17956,1905,12500,6820,24121,12499,5964,13289,25788,13325,25825
կ,ZhaiHeZhen,411522102,23231,2954,16866,9691,34084,16863,8216,17526,34389,17535,34401
,SunTiePuZhen,411522103,25789,3682,19715,11462,39086,19709,10255,19998,39707,20011,39726
,MaFanZhen,411522104,15589,3172,12989,8447,23702,12913,7375,13037,25950,13147,26136
,PoBeiHeZhen,411522105,24717,4433,19842,12310,38618,19825,10936,20225,40050,20244,40086
ȸ԰,BaiQueYuanZhen,411522106,26629,4311,20273,11893,40983,20273,10911,21566,41839,21578,41851
ש,ZhuanQiaoZhen,411522107,15574,2093,10549,5907,22043,10549,4408,11526,22075,11526,22075
ɾ,XianJuXiang,411522201,14404,2558,11808,7095,22473,11805,6160,11304,23109,11314,23122
,BeiXiangDianXiang,411522203,12840,2384,9911,6318,19325,9902,4835,10143,20045,10148,20059
޳,LuoChenXiang,411522204,10755,2132,8347,5307,16611,8346,4192,8728,17074,8732,17079
,YinPengXiang,411522206,5595,1329,4830,3328,9518,4828,2944,5022,9850,5038,9868
,NanXiangDianXiang,411522207,13677,3088,11043,7411,22486,11042,6166,11886,22928,11888,22931
̺,YanHeXiang,411522208,19958,4241,16947,10607,32786,16934,9861,17062,33996,17113,34060
ͤ,LiangTingXiang,411522210,10187,1693,7588,4855,15390,7552,3825,8012,15564,8117,15705
ɽ,HuShanXiang,411522212,23587,3179,16923,9256,33876,16916,8214,18047,34963,18057,34980
,HuaiDianXiang,411522213,17034,2469,12329,7363,24024,12295,5964,13076,25371,13138,25467
,WenShuXiang,411522215,16750,3439,12875,8228,26487,12874,6523,13829,26703,13837,26712
¼,XinJiZhen,411523100,69033,5711,47348,28566,64669,44705,21618,45849,90554,49014,96362
ɳ,ShaWoZhen,411523101,11021,2155,9268,6262,17371,9178,5378,8983,18161,9286,18554
º,WuChenHeZhen,411523103,11117,2121,8901,5667,16750,8775,4564,8675,17450,8901,17802
պ,SuHeZhen,411523104,10428,1945,7898,5437,15118,7866,3887,8254,16120,8362,16260
,BaLiFanZhen,411523105,10126,2042,8778,5936,15705,8730,4786,8068,16798,8176,16954
ܺ,ZhouHeXiang,411523201,4921,1042,3697,2864,7176,3613,1721,3763,7376,3987,7684
ɽ,DouShanHeXiang,411523202,9610,1723,7849,5215,14922,7798,4368,7712,15510,7852,15701
,HuWanXiang,411523203,7929,1338,6167,4145,11199,6072,3123,6011,12083,6223,12390
ǧ,QianJinXiang,411523204,12839,2607,10195,6890,19310,9989,5221,10110,20099,10472,20667
,KaFangXiang,411523205,3718,672,2664,2172,5168,2643,1096,2732,5375,2822,5486
Һ,GuoJiaHeXiang,411523206,4408,791,3481,2391,6691,3431,1771,3384,6815,3489,6970
µ,ChenDianXiang,411523207,7062,1337,5413,3583,10653,5343,2618,5494,10837,5604,11017
,JianChangHeXiang,411523208,8744,1273,6512,4315,12194,6415,3229,6584,12999,6734,13246
,SiDianXiang,411523209,7274,1219,5271,3547,9679,5236,2201,5297,10533,5423,10694
,TianPuXiang,411523210,3835,558,2718,1845,5091,2677,1124,2702,5379,2799,5517
ǹ,ChengGuanZhen,411524100,25637,3594,17748,11134,30017,17439,6241,17329,34768,17724,35472
ʯ,ShangShiQiaoZhen,411524101,32257,5458,25932,16993,50088,25135,15222,25473,50608,27005,52937
۳,YanGangZhen,411524102,16055,4060,14553,9165,27950,14251,8360,13307,27558,13922,28475
˫,ShuangChunPuZhen,411524103,21456,4289,18095,10933,34113,17916,9455,16866,34782,17105,35200
,WangQiaoZhen,411524104,21947,3418,18323,10487,33646,17923,9526,16023,33946,16568,34891
༯,YuJiZhen,411524105,20992,3331,18276,10712,33653,18268,10389,16428,34696,16436,34712
Ȩ,DaQuanDianZhen,411524106,12524,2580,10379,6705,19586,9785,5858,9871,19656,10583,20962
Ἧ,FengJiXiang,411524107,17247,2994,13751,8215,22483,12934,7134,12595,25529,13624,27375
ӷ,HeFengQiaoXiang,411524203,12818,3172,11749,7537,22532,11708,7181,11285,22993,11422,23171
,LiJiXiang,411524204,12495,2629,10577,6802,20442,10445,5991,10351,20796,10538,21115
̨,JinGangTaiXiang,411524206,9430,2008,8116,5298,14345,7676,4427,7184,14860,7749,15865
ʯ,SuXianShiXiang,411524207,5615,1101,4606,3091,9232,4592,2769,4852,9444,4879,9485
,WangGangXiang,411524208,9226,1982,7802,5104,15274,7683,4601,7790,15473,8007,15809
ɽ,FuShanXiang,411524209,9090,2201,8106,5875,15558,8068,5059,8187,16255,8244,16350
ɽ,NianYuShanXiang,411524210,30142,2976,20797,10770,28636,19113,8543,18337,37450,20864,41661
,GuanMiaoXiang,411524211,14713,2969,12698,7483,22767,11907,6554,10590,22497,11538,24236
,WuHeXiang,411524212,12006,2097,10323,6185,19004,10089,5818,9273,19362,9598,19921
,FengDianXiang,411524213,8486,1901,7235,5011,14121,7227,4105,7219,14446,7257,14492
԰,ChangZhuYuanXiang,411524215,13032,2809,11057,7512,21712,10999,6426,10961,21960,11210,22267
Ȫع�,TangQuanChiGuanLiChu,411524400,851,78,586,262,702,409,201,435,844,544,1130
ǹ,ChengGuanZhen,411525100,78251,8676,54616,33351,78247,52874,23588,53534,106408,55899,110515
,ChenLinZiZhen,411525101,19688,4217,15907,11268,32270,15905,9137,17130,33035,17135,33042
輯,LiJiZhen,411525102,27357,5886,22445,15026,43877,22432,12692,23443,45875,23490,45935
,JiangJiZhen,411525103,16281,4692,13616,9212,27130,13040,6307,12764,25804,13664,27280
,WangLiuZhen,411525104,21151,3550,16986,10332,32283,16986,9212,16927,33913,16927,33913
½̲,GuoLuTanZhen,411525105,21187,4017,17748,11687,34475,17735,10239,17685,35420,17695,35443
,HuZuPuZhen,411525106,31664,4981,25206,15942,49806,25206,14767,26202,51408,26206,51412
,FangJiZhen,411525107,13337,2703,11217,7361,21813,11200,6867,11663,22863,11690,22907
Ӽ,SanHeJianZhen,411525108,19859,2626,15066,8299,29641,15066,7736,15155,30221,15155,30221
μ,DuanJiZhen,411525109,13998,2409,11104,7178,21930,11094,6591,11846,22940,11894,22998
,WangPengXiang,411525110,23450,4452,18615,12350,37662,18603,10051,19260,37863,19338,37953
Ź,ZhangGuangMiaoXiang,411525111,14537,3909,12255,9032,23879,12247,6502,12660,24907,12693,24948
ǽ,ChengJiaoXiang,411525200,62756,5684,42366,22859,48576,35851,18763,37190,73041,44837,87203
鲺,HongBuXiang,411525201,21388,4486,17932,12048,34030,17851,9335,17129,34980,17277,35209
,YangJiXiang,411525202,15461,3157,13077,8714,25428,13071,7707,13242,26313,13248,26325
,MaGangJiXiang,411525203,16980,2871,13964,9197,26736,13947,7927,13775,27722,13814,27778
�,CaoMiaoJiXiang,411525204,12261,2432,10681,7012,20892,10658,6809,10760,21418,10821,21502
ϴ,NanDaQiaoXiang,411525206,10604,2729,9105,6792,18016,9099,5270,9480,18579,9498,18603
Ը,ZhaoGangXiang,411525208,9223,2091,7501,4874,15081,7434,4053,7772,15206,7866,15367
�,WuMiaoJiXiang,411525209,9845,2113,7937,5709,16234,7935,4517,8530,16465,8538,16475
ʦ,ZuShiMiaoXiang,411525210,12383,2461,10275,7075,20997,10275,6260,10827,21102,10829,21104
ϲ,ZhangLaoBuXiang,411525211,9417,2910,8196,6460,16550,8189,4499,8630,16819,8630,16826
ʯ,ShiFoDianXiang,411525212,10071,3371,9285,7232,17973,9255,5156,9250,18505,9313,18598
Ȫ,QuanHePuXiang,411525214,14759,3308,11339,8297,23298,11307,5635,12266,23573,12363,23702
ˮͤ,FenShuiTingXiang,411525215,19598,4285,14903,9908,30453,14884,6951,15904,30788,15931,30834
ɳ,ShaHePuXiang,411525216,20974,4565,16457,11252,32130,16121,8008,16565,32686,17090,33547
¼,ChenJiXiang,411525217,14758,4162,12561,9908,25009,12531,6776,12997,25528,13135,25696
켯,XuJiXiang,411525218,16464,3849,13821,9491,27506,13702,7469,13775,27477,13961,27782
,LiDianXiang,411525221,17891,2945,12950,7558,26674,12950,5996,13882,26832,13882,26832
,FengGangXiang,411525222,23209,4647,18873,11485,37121,18830,9888,18784,37614,18871,37744
,LiuShuDianXiang,411525223,9753,2569,8195,5933,16464,8186,4351,8458,16644,8478,16673
,GuanTangXiang,411525224,12444,2039,9673,5750,19049,9635,5079,9819,19454,9889,19562
ֵ´,ChunShenJieDaoBanShiChu,411526001,56309,5800,39351,23918,50113,38456,16462,38259,76715,39220,78571
ǽֵ´,DingChengJieDaoBanShiChu,411526002,42692,3952,28680,16729,30779,27508,10986,28045,55553,28950,57630
ֵ߮´,YiYangJieDaoBanShiChu,411526003,27977,2106,18961,8908,21425,15079,8839,14898,29977,19961,38922
ϳǽֵ´,LaoChengJieDaoBanShiChu,411526004,14897,1631,10974,6571,14291,10823,4967,10406,21229,10521,21495
˫,ShuangLiuShuZhen,411526101,21605,3272,17091,9571,32125,16582,8533,15431,32013,16319,33410
ɡ,SanBeiZhen,411526102,16496,2205,12263,7238,23545,12260,5549,11984,24244,11987,24250
,BuTaJiZhen,411526103,15459,1650,10552,5972,21624,10552,4563,11120,21672,11120,21672
ʺ,RenHeZhen,411526105,14570,2624,12096,7696,22186,12082,6099,11187,23269,11197,23293
,FuDianZhen,411526106,18758,2008,12577,7282,25490,12541,5174,13303,25844,13363,25940
,XueZiZhen,411526107,9695,1807,8277,5327,15745,8277,4408,7633,15910,7633,15910
,TaoLinPuZhen,411526108,17423,2441,12660,7404,24779,12635,5884,12974,25609,13088,25748
¸,HuangSiGangZhen,411526109,17278,2455,13065,7625,24955,13024,6127,12694,25718,12795,25860
Ҽ,JiangJiaJiZhen,411526110,15867,2612,13164,7717,24659,13161,6742,12049,25210,12057,25221
,ChuanLiuDianXiang,411526201,15288,2385,11651,7213,22288,11602,5091,11030,22632,11113,22764
κ,WeiGangXiang,411526202,22324,2901,16071,9556,31973,16004,7648,16714,32718,16802,32873
ż,ZhangJiXiang,411526203,15225,2228,11907,7234,23091,11898,6091,11619,23517,11637,23544
,LaiLongXiang,411526204,21054,2918,16626,9275,31940,16596,8284,15550,32146,15630,32256
¡,LongGuXiang,411526205,10419,1449,7640,4762,15054,7633,3662,7867,15500,7890,15530
̸,TanDianXiang,411526206,19506,2786,14198,8207,28365,14134,6467,14301,28435,14561,28759
͸,ShangYouGangXiang,411526207,13333,2071,9959,6038,19258,9950,4460,9889,19839,9905,19864
׵,BaiDianXiang,411526209,19185,2928,14722,8798,28762,14612,7273,14464,29076,14664,29386
ƺũ,HuangHuNongChang,411526400,875,101,610,451,1088,605,269,630,1235,635,1245
ʡ괨ü�,HeNanShengHuangChuanJingJiJiShuKaiFaQu,411526560,4602,209,2973,1906,2777,2944,1422,3179,6123,3260,6233
ǹ,ChengGuanZhen,411527100,49848,4858,34215,19361,56561,33757,14415,34483,68240,34906,69121
�,MaJiZhen,411527101,16071,2495,12039,6651,23299,12039,5486,12006,24045,12013,24052
,LanGanZhen,411527102,35530,2332,23094,9537,32493,18496,8490,18804,37300,23258,46352
,FangHuZhen,411527103,24057,3980,19125,10314,36647,19125,9084,17995,37120,17996,37121
,XinLiZhen,411527104,18195,3560,15198,7887,28551,15191,7289,13845,29036,13846,29044
˼,QiSiZhen,411527105,15083,2210,12214,7283,23451,12190,6949,11938,24128,12028,24242
Լ,ZhaoJiZhen,411527106,16619,2477,14042,7112,25903,14018,7163,12155,26173,12217,26259
̨ͷ,TaiTouXiang,411527200,22322,2685,16080,8921,32184,16080,7216,16143,32223,16143,32223
Ҹ,WangJiaGangXiang,411527201,23861,2607,18351,9166,35784,18350,9445,17562,35912,17562,35913
̳,GuChengXiang,411527202,26625,3457,19534,9823,38913,19532,9012,19542,39074,19560,39094
,SanKongQiaoXiang,411527203,20366,3193,16676,8582,31417,16675,8480,15362,32037,15363,32039
,ZhangLiXiang,411527204,14041,2899,11725,6391,22022,11725,5601,10816,22541,10816,22541
,DengWanXiang,411527206,13905,2266,11135,6087,21861,11135,5749,10783,21918,10785,21920
ׯ,ZhangZhuangXiang,411527207,15831,2413,12049,6833,23723,12040,5746,11914,23954,11941,23990
,WangDianXiang,411527208,20367,2541,14527,7903,29712,14466,6917,15205,29671,15298,29825
ȶ,GuDuiXiang,411527209,28161,3618,21774,11452,42681,21769,11205,21209,42978,21210,42984
«,LuJiXiang,411527212,20788,3182,17376,9381,32578,17376,9507,16077,33453,16101,33477
ǹ,ChengGuanZhen,411528100,61304,5670,40943,21924,68767,39806,17113,41492,81298,43144,84087
,BaoXinZhen,411528101,28678,4119,20673,11200,40482,20413,9145,20761,41174,21269,41942
ׯ,XiaZhuangZhen,411528102,27422,2603,18892,9093,34615,18721,8315,19101,37822,19448,38340
,DongYueZhen,411528103,34770,4185,24812,11456,49621,23741,11739,23799,47540,25882,50694
,XiangDianZhen,411528104,26010,3265,18269,9088,37268,18226,8727,18837,37063,19733,38002
С,XiaoHuiDianZhen,411528105,38940,5412,29974,14906,57127,29947,14788,29088,59035,29166,59140
ǽ,ChengJiaoXiang,411528200,49135,3999,32083,16271,40184,30515,12657,31575,62090,33708,65791
,SunMiaoXiang,411528201,15794,1907,11274,7673,22310,11274,5417,11844,23118,11844,23118
·,LuKouXiang,411528202,24677,2993,17904,9838,35789,17903,8519,18282,36185,18285,36189
,PengDianXiang,411528203,19555,2544,14457,8055,28492,14457,7012,14654,29111,14654,29111
,YangDianXiang,411528204,22886,2920,16133,8009,32602,16132,7253,16921,33053,16926,33059
,ZhangTaoXiang,411528205,23402,3531,17672,9678,34733,17500,9029,17815,35315,18290,35962
,BaiTuDianXiang,411528206,23352,2525,17236,8881,34174,17234,9032,17670,34904,17673,34909
,GangLiDianXiang,411528207,25374,4028,20180,11034,39270,20179,10706,19926,40105,19928,40108
,ChangLingXiang,411528208,15432,2081,12683,7039,24325,12675,7206,12035,24710,12036,24719
,ChenPengXiang,411528209,11715,1769,10358,5442,19626,10309,6645,9656,19965,9771,20129
ٺ,LinHeXiang,411528210,15269,2613,12440,6923,24502,12367,7209,12505,24872,12651,25091
ص,GuanDianXiang,411528211,24625,3276,19802,10796,39144,19802,11818,19917,39719,19917,39719
ܻ,CaoHuangLinXiang,411528213,19323,2554,15200,8478,29572,15173,9105,15731,30904,15782,30982
,BaLiChaXiang,411528214,23294,2697,18175,9322,35023,18175,10473,18283,36458,18289,36464
ؿ,DiKuangJu,411528400,4336,470,3005,1621,5704,2959,1440,3130,6089,3241,6246
ݻֵ´,ChenZhouHuiZuJieDaoBanShiChu,411602001,34241,3300,22689,14309,38836,22488,8001,22557,45045,22853,45542
һ·ֵ´,QiYiLuJieDaoBanShiChu,411602002,53666,4466,36295,20368,55087,32910,12793,33118,66028,34630,70925
ɻֵ´,HeHuaJieDaoBanShiChu,411602003,52437,4750,35038,20622,59385,34836,13027,34555,69391,35176,70214
˺ͽֵ´,RenHeJieDaoBanShiChu,411602004,21226,2725,14630,8593,23277,14542,4971,14205,28747,14292,28922
СŽֵ´,XiaoQiaoJieDaoBanShiChu,411602005,19907,2057,12998,6949,21014,12469,4527,12439,24908,13493,26491
ϰ´,ChengNanBanShiChu,411602006,11424,1124,8174,4181,14213,8095,3881,8120,16215,8255,16429
Ǳ´,ChengBeiBanShiChu,411602007,20786,1866,14180,6657,25439,13092,6094,13394,26486,14566,28746
Ĳ´,WenChangBanShiChu,411602008,23153,956,16080,3917,13664,7560,3405,7768,15328,11434,27514
ڰ´,BanKouBanShiChu,411602009,28839,2780,20397,10603,39153,19705,9259,20027,39732,20481,40878
·´,JinHaiLuBanShiChu,411602010,23421,1933,15343,6740,21817,13627,6068,13679,27306,16079,31422
̫·´,TaiHaoLuBanShiChu,411602011,33532,2163,20740,9521,28005,17834,8179,18446,36280,23134,43874
·´,HuaiHeLuBanShiChu,411602012,22618,2004,15155,7011,27523,13611,6402,14651,28262,15869,31024
,LiBuKouXiang,411602200,29037,3730,21193,10973,42849,21189,10423,21994,43183,21997,43190
ǹ,ChengGuanZhen,411621100,40918,3810,26604,14607,42751,23541,10603,24704,48245,28727,55331
,CuiQiaoZhen,411621101,29439,3725,21133,12193,41972,21120,9123,21088,42208,21154,42287
,JiangCunZhen,411621102,37484,4614,26760,14436,53961,26458,12289,26757,53215,27627,54387
̶,BaiTanZhen,411621103,27544,3826,19723,11235,39702,18978,8813,19020,37998,20460,40183
԰,JiuYuanZhen,411621104,29240,4187,21312,12563,41454,20784,9369,20843,41627,21484,42796
,LianSiZhen,411621105,29876,4083,21191,11726,43511,21188,9951,22691,43879,22719,43910
,DaXinZhen,411621106,23996,2806,17232,9696,34769,17119,8366,17705,34824,17936,35168
,BaoTunZhen,411621107,29098,3214,20216,11542,39979,19323,9144,20257,39580,21240,41456
,BianGangZhen,411621108,28317,3335,19794,10739,40313,19369,8833,20065,39434,20691,40485
,CaoLiXiang,411621200,24147,3282,17314,10312,34549,17285,7477,17531,34816,17592,34906
,ChaiGangXiang,411621201,24540,3760,17445,10304,34933,17438,6977,17793,35231,17832,35277
̳,GuChengXiang,411621202,22824,3745,17305,10046,34872,17101,8626,17566,34667,17890,35195
̶,LvTanXiang,411621203,31181,3386,21517,11900,43312,21241,9428,22250,43491,22478,43995
ׯ,DaLiZhuangXiang,411621204,21837,2092,15617,6576,24717,11683,5325,12077,23760,13637,29254
ǽ,ChengJiaoXiang,411621205,33803,3317,22082,9833,36240,18669,8015,19529,38198,23053,45135
Ӫũ,GuoYingNongMuChang,411621500,4341,421,2965,1638,5706,2965,1292,3089,6054,3089,6054
洳ǽֵ´,WaChengJieDaoBanShiChu,411622001,18161,1501,12121,7254,22325,12096,5007,12508,24604,12548,24669
ֵ̨´,JiZiTaiJieDaoBanShiChu,411622002,26727,1592,16621,7378,24185,12475,5166,13080,25555,16864,33485
ɽֵ´,KunShanJieDaoBanShiChu,411622003,13657,1127,9141,5044,17614,9139,3859,9499,18638,9502,18643
ͤ,XiXiaTingZhen,411622101,34420,4400,24989,13041,50441,24989,12279,26110,51099,26110,51099
ң,XiaoYaoZhen,411622102,26090,3704,19000,10482,37759,18591,9073,19526,38117,19867,38867
ĸ,FengMuZhen,411622103,33118,4803,24038,13620,49534,24038,11620,25503,49541,25503,49541
컨,HongHuaJiZhen,411622104,35675,4307,25666,13609,51722,25664,11741,26057,51721,26057,51723
,NieDuiZhen,411622105,26576,3366,19655,10950,39323,19646,9886,20160,39806,20173,39828
ͤ,DongXiaTingZhen,411622106,22120,2418,16072,9363,31998,16072,7902,16368,32440,16368,32440
Ӫ,XiHuaYingZhen,411622107,36524,3561,26385,13987,53305,26382,13457,27117,53499,27157,53542
ַ,ZhiFangZhen,411622108,20596,3066,14960,8281,30045,14954,6607,15303,30257,15309,30269
,TianKouXiang,411622200,19364,2105,13114,6953,27263,13114,5917,14168,27282,14272,27386
,QingHeYiXiang,411622201,23314,2246,16582,7938,33816,16582,8293,17271,33853,17271,33853
ƤӪ,PiYingXiang,411622202,21333,2376,15779,8551,32010,15779,8303,16232,32011,16233,32012
Ӫ,DongWangYingXiang,411622203,18894,2043,13259,6906,26966,13259,6209,13887,27146,13887,27146
ׯ,DaiWangZhuangXiang,411622204,21216,2347,14703,7758,29930,14696,6768,15596,30292,15628,30331
ׯ,LiDaZhuangXiang,411622205,27006,3004,19333,9374,38575,19333,9786,20435,39768,20463,39796
Ҷ,YeBuKouXiang,411622206,25849,4208,19579,10952,39653,19570,9974,20406,39976,20452,40031
Ӫ,ChiYingXiang,411622207,27844,2801,19481,9975,39112,19378,9412,20473,39851,20576,40057
,HuangTuQiaoXiang,411622208,19100,2356,13413,7390,27287,13413,6135,14178,27591,14178,27591
,AiGangXiang,411622209,21322,3177,15775,8738,31917,15758,7469,16154,31912,16193,31968
Ʒũ,HuangFanQuNongChang,411622405,17990,3460,12923,8556,23706,12739,4632,12868,25607,13159,26082
ũ,WuErNongChang,411622406,6394,633,1884,1436,3288,1879,532,1877,3756,5675,7559
³ǽֵ´,XinChengJieDaoBanShiChu,411623001,28681,1858,17753,8624,26525,14163,6443,15316,29479,19229,36982
ǽֵ´,DongChengJieDaoBanShiChu,411623002,20472,1619,13376,6582,23099,12071,5255,12815,24886,13970,27346
ϳǽֵ´,LaoChengJieDaoBanShiChu,411623003,16032,1264,10166,4458,14713,7775,3519,8410,16185,10649,20815
կ,HuangZhaiZhen,411623101,32421,5315,24874,14740,48242,24859,11301,24077,48936,24163,49037
,LianJiZhen,411623102,28550,3407,20960,11051,42312,20957,10536,21526,42483,21533,42493
κ,WeiJiZhen,411623103,31088,4712,26534,14591,48935,26534,14866,24132,50666,24132,50666
ǽ,GuQiangZhen,411623104,40164,5219,33103,18057,61664,33103,18556,30835,63938,30836,63939
,BaiSiZhen,411623105,25767,3181,19511,10196,38649,19313,10474,19557,38870,19911,39422
ʹ,BaCunZhen,411623106,25981,3752,20745,11629,40532,20743,11419,20369,41112,20407,41152
̷ׯ,TanZhuangZhen,411623107,34208,4640,27304,14924,51101,27202,14954,26368,53570,26498,53802
˳,DengChengZhen,411623108,31805,4564,24434,14018,48776,24429,12697,24620,49049,24632,49066
,HuJiZhen,411623109,25220,3319,20240,10711,38974,20220,11704,19974,40194,20003,40243
ǹ,ChengGuanXiang,411623200,17895,2384,13979,7655,25479,13399,6634,12704,26103,12934,26913
ƽ,PingDianXiang,411623202,24469,3900,20763,11978,38070,20372,11798,18912,39284,19404,40167
Ԭ,YuanLaoXiang,411623203,26066,3598,21683,11981,41710,21683,12397,20378,42061,20378,42061
,HuaHeXiang,411623204,22768,2746,17925,9479,34656,17925,9389,16977,34902,16978,34903
Ҧ,YaoJiXiang,411623205,32256,4834,27849,15187,51901,27848,16396,25623,53471,25637,53486
ׯ,ShuZhuangXiang,411623206,15667,2879,15199,9073,26926,15199,9468,12815,28014,12815,28014
,DaWuXiang,411623207,22460,3632,19986,11046,37488,19897,11925,17881,37778,18031,38017
,ZhangMingXiang,411623208,24901,3781,20896,11498,39988,20844,11944,19621,40465,19730,40626
¸,HaoGangXiang,411623209,20287,3249,16582,9746,32110,16460,8861,15638,32098,15815,32397
ׯ,ZhangZhuangXiang,411623210,30731,3811,22914,12284,45148,22270,11386,22323,44593,23014,45928
ׯ,TangZhuangXiang,411623211,24970,3324,18877,10285,37213,18876,9443,18858,37734,18860,37737
ˮũ,ShangShuiXianNongChang,411623500,3691,456,2760,1585,5391,2760,1433,2818,5578,2820,5580
ǰ´,DongChengBanShiChu,411624001,8645,1176,6357,3465,12358,6357,2978,6441,12798,6442,12799
ǰ´,BeiChengBanShiChu,411624002,23668,2701,16111,7878,31314,16111,6633,16870,32981,16891,33002
,HuaiDianHuiZuZhen,411624100,82856,7055,51990,26227,87811,46633,17061,48888,95521,54982,106972
ׯ,LiuZhuangDianZhen,411624101,34953,4667,28718,15782,53825,28684,14380,25217,53901,25282,54000
�,LiuFuJiZhen,411624102,23246,3801,19781,11814,37111,19781,10306,17572,37353,17572,37353
ϳ,LaoChengZhen,411624103,29956,4761,23697,13324,45440,23694,11206,22214,45908,22226,45923
ԵӪ,ZhaoDeYingZhen,411624104,37547,6226,29193,16215,56674,29193,13075,27655,56848,27655,56848
,FuJingZhen,411624105,35626,6668,30091,16888,54798,29933,13369,25298,55231,25572,55663
ֽ,ZhiDianZhen,411624106,23862,3498,17204,9928,34217,17076,7172,17238,34314,17328,34532
°,XinAnJiZhen,411624107,24676,4226,19431,11271,38095,18905,10004,18449,37354,19475,38906
׼,BaiJiZhen,411624108,34928,4609,26335,14592,51727,26305,12667,25805,52110,25869,52204
,LiuWanZhen,411624109,19080,2791,14336,8085,28177,14336,6868,14402,28738,14403,28739
,LianChiXiang,411624200,28411,3795,20552,10514,40891,20552,8815,20469,41021,20469,41021
ʯۼ,ShiCaoJiXiang,411624201,30522,4487,23041,13024,44780,23026,9933,21891,44917,21901,44942
Ӫ,FanYingXiang,411624202,29169,5289,25695,14876,47817,25695,13439,22202,47897,22202,47897
ׯ,LiLaoZhuangXiang,411624203,28442,4298,23861,12624,45054,23859,12420,21297,45156,21299,45160
ׯ,DaXingZhuangXiang,411624204,15121,2566,12322,6849,23783,12322,6146,11511,23833,11511,23833
Ӫ,FengYingXiang,411624205,31362,5198,25130,15369,48315,25129,12391,23821,48950,23821,48951
Ӫ,ZhouYingXiang,411624206,24239,3639,18154,9331,35770,18139,8215,17772,35911,17939,36093
ɽ,HongShanXiang,411624207,33527,4463,26501,14029,51676,26501,14684,26172,52673,26173,52674
,BeiYangJiXiang,411624208,30680,3786,21642,11362,44822,20969,10428,21928,42897,23252,44894
·,BianLuKouXiang,411624209,27299,3361,21032,11558,41029,21032,10517,20145,41177,20145,41177
ϰ´,MingNanBanShiChu,411625001,55298,1692,34275,15646,58365,30220,12260,30950,61170,34975,69250
´,MingBeiBanShiChu,411625002,23336,1446,14885,6998,24266,12908,5650,13619,26527,15547,30432
³ǰ´,XinChengBanShiChu,411625003,19091,1354,12387,5533,17598,10191,5003,10571,20762,13061,25448
̨,WuTaiZhen,411625101,30336,4524,25774,16396,47359,25773,13189,22274,48047,22275,48049
Ϸ,NanFengZhen,411625102,29544,3684,21414,11772,42649,21414,10557,22370,43784,22371,43785
,BaiMaZhen,411625103,33204,4986,26957,17116,51199,26955,14118,25341,52296,25351,52308
ƽ,NingPingZhen,411625104,29159,4636,23586,14373,45684,23566,12531,22695,46261,22740,46326
·,YiLuZhen,411625105,33314,4816,25723,15480,50283,25723,12557,24964,50687,24964,50687
Ǯ,QianDianZhen,411625106,37813,5725,29400,17162,56631,29398,13785,27899,57297,27923,57323
ڣ,JiZhongZhen,411625107,39028,5652,30073,16679,59415,30073,15166,29773,59846,29773,59846
ʯ,ShiCaoZhen,411625108,30341,4429,22748,12279,45010,22748,10911,22933,45681,22933,45681
ǽ,ChengJiaoXiang,411625200,24327,2817,18298,9916,35769,18298,9057,17902,36200,17903,36201
ͷ,HuTouGangXiang,411625201,29853,4385,24299,14081,45572,24299,12743,22682,46981,22682,46981
ˮ,JiShuiXiang,411625202,30357,5149,23271,15083,46503,23271,11314,23549,46820,23549,46820
꼯,ZhangWanJiXiang,411625203,29820,4147,23589,13671,46592,23589,13333,23711,47300,23711,47300
,DingCunXiang,411625204,27348,3754,21351,13205,42054,21351,11414,21165,42516,21165,42516
˫¥,ShuangLouXiang,411625205,21970,3267,16925,11514,33587,16922,8516,16804,33726,16828,33753
,QiuQuXiang,411625206,26871,4718,21094,13867,41786,21093,10589,21081,42174,21084,42178
,DongFengXiang,411625207,20930,3000,14875,9464,29995,14875,6478,15533,30408,15533,30408
ͼ,BaJiXiang,411625208,28432,4509,22443,14381,43135,22432,10743,21208,43640,21241,43684
¥,LiLouXiang,411625209,31901,4146,24786,12580,48161,24779,12365,23599,48378,23626,48412
,HuJiXiang,411625210,25206,3323,21259,12933,39386,21259,11772,19042,40301,19042,40301
ҵί,GongYeQuGuanWeiHui,411625211,12014,902,7890,3765,14687,7262,3305,7724,14986,8331,16221
ǹػ,ChengGuanHuiZuZhen,411626100,106333,8125,66875,27769,96239,51005,20113,51615,102620,67696,134571
վ,XinZhanZhen,411626101,35296,5644,27682,16004,53736,27682,12899,26157,53839,26157,53839
³̨,LuTaiZhen,411626102,40337,5088,31103,15275,59269,31102,15178,29498,60600,29500,60603
ͨ,SiTongZhen,411626103,27525,3780,21373,12093,38927,21364,11187,21115,42479,21119,42492
ٲ,LinCaiZhen,411626104,31296,4567,24269,13396,48057,24269,12306,23900,48169,23900,48169
,AnLingZhen,411626105,39397,5933,31187,17490,60356,31187,15830,29973,61160,29973,61160
¥,BaiLouZhen,411626106,32120,4272,24689,14576,47467,24689,11527,23230,47919,23230,47919
켯,ZhuJiXiang,411626200,36159,5196,28897,15065,55663,28857,15053,27479,56336,27511,56408
,DouMenXiang,411626201,26821,3832,19926,11105,38196,19925,9018,19743,39668,19745,39671
,FengTangXiang,411626202,39615,6080,33984,18461,64473,33984,19060,30771,64755,30771,64755
,LiuZhenTunXiang,411626203,33886,5310,26889,14761,52720,26889,13806,26113,53002,26113,53002
,WangDianXiang,411626204,33255,5840,26988,17307,51953,26968,13257,25309,52277,25364,52352
,DaLianXiang,411626205,40961,5775,32018,16983,60844,32018,15466,30184,62202,30184,62202
,GeDianXiang,411626206,35369,5421,27331,14311,53273,27331,13130,26589,53920,26589,53920
Ƽ,HuangJiXiang,411626207,24608,4110,20567,11338,39328,20567,11023,19173,39740,19174,39741
,QiLaoXiang,411626209,36080,4857,27820,15913,54214,27820,13742,26858,54678,26859,54679
֣,ZhengJiXiang,411626210,35871,5321,28660,15739,55237,28660,14408,26936,55596,26940,55600
ܺ,CaoHeXiang,411626211,30078,3679,23485,12953,45708,23485,12354,22626,46111,22626,46111
,XuWanXiang,411626213,42369,5665,31844,16633,62437,31844,14471,30661,62505,30661,62505
ǹػ,ChengGuanHuiZuZhen,411627100,71465,5220,46498,21287,68017,38508,16363,40286,78794,46550,93048
Ӫ,ChangYingZhen,411627101,33619,4095,25131,15158,49147,25125,12464,25036,50161,25047,50178
ѷĸ,XunMuKouZhen,411627102,32741,4199,26011,15946,50161,26011,13578,24506,50517,24507,50518
ڣ,LaoZhongZhen,411627103,36570,5585,28631,15552,55484,28625,13910,27390,56015,27434,56065
,ZhuKouZhen,411627104,46567,5662,33862,20324,68806,33774,16960,35223,68997,35327,69189
ͷ,MaTouZhen,411627105,45828,6112,33635,20639,68307,33617,16427,34696,68313,34732,68367
,LongQuZhen,411627106,20888,2750,15244,8960,30683,15237,7282,15655,30892,15676,30920
,BanQiaoZhen,411627107,28257,3455,21543,12966,41743,21527,10852,20984,42511,21021,42564
¥,FuCaoLouZhen,411627108,26332,4207,21139,12556,41069,21137,10983,20381,41518,20383,41522
�,MaChangZhen,411627109,42304,5898,32539,18975,63997,32539,16139,31802,64341,31802,64341
ëׯ,MaoZhuangZhen,411627110,35564,3500,25142,13351,46624,23330,10702,23632,46962,24624,49766
ż,ZhangJiZhen,411627111,32246,3896,23881,12544,47947,23881,12081,24342,48223,24342,48223
ǽ,ChengJiaoXiang,411627200,19928,2540,14414,8283,28450,14401,6348,14348,28749,14402,28816
,YangMiaoXiang,411627201,27234,3474,20714,12815,41404,20709,10849,20836,41545,20843,41557
,WangJiXiang,411627202,28809,3888,22577,12944,43676,22570,11908,22015,44585,22028,44605
,GaoXianXiang,411627203,26603,3281,20022,12280,40062,20022,10398,20254,40276,20260,40282
֥,ZhiMaWaXiang,411627204,30670,3109,21962,12321,44027,21962,10303,22120,44082,22120,44082
弯,QingJiXiang,411627205,25847,3457,19967,12170,38488,19961,10136,19453,39414,19473,39440
,DuTangXiang,411627206,23315,2679,17206,10312,34257,17206,8531,17304,34510,17319,34525
կ,DaXuZhaiXiang,411627207,28674,3586,22416,13414,43686,22413,11824,21657,44070,21668,44084
,WuLiKouXiang,411627208,22730,3355,17495,10853,34927,17495,9111,17701,35196,17701,35196
,GaoLangXiang,411627210,30651,3929,22668,14510,45312,22668,11248,23160,45828,23160,45828
ת¥,ZhuanLouXiang,411627211,25647,3779,19931,12496,39125,19931,10410,19905,39836,19905,39836
Դ´,ZhenYuanBanShiChu,411628001,20278,2511,12676,7633,25815,12668,3541,13583,26251,13654,26330
´,GuYangBanShiChu,411628002,21124,2102,15093,7699,28336,14451,6500,14102,28553,14633,29726
´,WeiZhenBanShiChu,411628003,28119,2102,18472,7784,30065,14959,6244,15012,29971,17993,36465
¹´,MingLuBanShiChu,411628004,22601,2325,15782,7602,28669,15725,6694,15769,31494,15838,31620
б,WoBeiZhen,411628100,18543,2621,14967,9095,27295,14628,7160,13001,27629,13357,28324
,XuanWuZhen,411628101,28036,4485,24841,13925,45260,24836,13090,20747,45583,20770,45611
κ,SongHeZhen,411628102,26734,3659,19999,12025,38926,19999,9456,19850,39849,19850,39849
̫幬,TaiQingGongZhen,411628103,20532,2907,16333,8961,30906,16333,7492,14597,30930,14598,30931
Ƥ,WangPiLiuZhen,411628104,31299,4270,22823,13075,45133,22819,9663,22406,45225,22409,45232
,ShiLiangZhen,411628105,24110,3989,22669,13749,40570,22669,12473,17902,40571,17903,40572
,XinJiZhen,411628106,22462,3651,20309,11206,37359,20294,11415,17146,37440,17219,37528
,MaPuZhen,411628107,26640,4152,21045,12160,40880,21045,10224,19971,41016,19971,41016
̲,JiaTanZhen,411628108,30741,5269,26576,17120,49885,26576,13882,23316,49892,23316,49892
,YangHuKouZhen,411628109,34384,5522,29907,18015,55550,29907,16084,26083,55990,26083,55990
ŵ,ZhangDianZhen,411628110,32287,3816,26076,14353,49867,26064,14306,24254,50318,24333,50409
,GuanTangXiang,411628111,22899,3770,18279,11035,35085,18279,8642,17032,35311,17032,35311
֣Ҽ,ZhengJiaJiXiang,411628200,15865,2246,13313,7206,25046,13196,6964,11500,24696,11762,25075
ڣ,ShengTieZhongXiang,411628202,23144,3900,20587,11816,38165,20587,11156,17613,38200,17613,38200
Դ,ZhaoCunXiang,411628204,26808,4041,22921,14258,42649,22920,12191,20119,43039,20119,43040
μ,RenJiXiang,411628205,28313,3617,22703,14290,43700,22690,12099,21282,43972,21326,44029
Ƽ,TangJiXiang,411628206,16826,2778,14774,8955,27437,14771,8045,12872,27643,12875,27649
߼,GaoJiXiang,411628207,20488,3824,19275,11110,34787,19271,10600,15574,34845,15637,34912
,QiuJiXiang,411628208,20963,3234,18886,10335,34015,18886,10082,15393,34279,15393,34279
µ,MuDianXiang,411628209,23936,4040,19892,13079,38187,19892,10285,18369,38261,18369,38261
԰´,HuaYuanBanShiChu,411681001,36393,1574,21238,7348,24643,13400,6091,14169,27569,22820,44058
ˮկ´,ShuiZhaiBanShiChu,411681002,91869,4588,57671,29805,82481,51421,23594,55166,106587,62380,120051
´,DongFangBanShiChu,411681003,15127,1227,9947,4945,17363,9947,4267,10674,20621,10674,20621
´,LianHuaBanShiChu,411681004,10660,1160,7003,3839,13393,7003,2757,7571,14574,7574,14577
ǧ´,QianFoGeBanShiChu,411681005,29322,2629,19291,10186,28739,19253,7866,20503,39756,20526,39817
´,GuangWuBanShiChu,411681006,26347,2041,16803,8028,23378,16661,6434,17770,34431,18019,34822
϶,NanDunZhen,411681100,36533,5049,27005,14539,52940,27003,11778,26353,53356,26355,53360
,SunDianZhen,411681101,38706,5583,28034,15786,55913,28034,12093,28348,56382,28348,56382
կ,LiZhaiZhen,411681102,34460,4896,26242,14421,50891,26166,11951,24925,51091,25065,51307
,JiaLingZhen,411681103,35932,5332,28044,15410,52997,27953,12454,25511,53464,25674,53718
,GaoSiZhen,411681104,30633,4645,23941,13781,45591,23941,10552,21887,45828,21889,45830
,XinQiaoZhen,411681105,33824,5416,28627,15373,53285,28627,14519,25132,53759,25132,53759
,FuJiZhen,411681106,24383,4308,20159,10933,37205,20155,8786,17310,37465,17318,37477
ٻ,GuanHuiZhen,411681107,34289,5308,27669,14914,52208,27665,12688,24613,52278,24616,52285
,DingJiZhen,411681108,29237,4570,22772,12516,43467,22762,9945,20967,43729,20980,43752
֣,ZhengGuoZhen,411681109,33752,4612,23999,12900,46897,23999,9059,23424,47423,23424,47423
,MoLingZhen,411681110,35446,4668,26111,13870,50249,25796,11324,25000,50796,25327,51438
,WangMingKouZhen,411681111,32688,5946,25934,13985,50420,25927,11878,24559,50486,24578,50512
,FanJiXiang,411681112,31958,5246,25317,15703,49404,25317,12223,24110,49427,24110,49427
,YongFengXiang,411681200,33789,5033,25738,14270,50473,25738,11795,24878,50616,24879,50617
,SanDianXiang,411681202,20365,3785,17689,11036,32013,17689,8315,14776,32465,14776,32465
ֵ´,RenMinJieDaoBanShiChu,411702001,36741,2977,22078,11732,38565,17185,6373,17153,34338,24013,46091
ֵ´,DongFengJieDaoBanShiChu,411702002,34307,2936,20374,11179,33431,17343,6815,17514,34857,23684,44058
԰ֵ´,XiYuanJieDaoBanShiChu,411702003,37929,4241,25025,11977,42558,17097,8562,16328,33425,25707,50732
»ֵ´,XinHuaJieDaoBanShiChu,411702004,23190,2192,14814,7094,23368,10015,4039,9940,19955,14607,29421
Ϻ·ֵ´,NanHaiLuJieDaoBanShiChu,411702005,17592,1738,11333,7669,16084,11086,3793,11467,22553,11790,23123
Ͻֵֽ´,LaoJieJieDaoBanShiChu,411702006,38577,2727,24908,14482,33347,21275,8097,21484,42759,24493,49401
ֵֽ´,XiangLinJieDaoBanShiChu,411702007,45686,3372,29091,16300,37026,24332,9386,24271,48603,29353,58444
ѩɽֵ´,XueSongJieDaoBanShiChu,411702008,23874,2195,15540,9971,24064,14480,5204,14543,29023,15733,31273
˳ӽֵ´,ShunHeJieDaoBanShiChu,411702009,20075,2311,13806,7464,28240,13667,6187,14617,28284,14767,28573
ֵ´,LiuGeJieDaoBanShiChu,411702010,15946,1948,11085,5829,21702,10928,5263,11651,22579,12072,23157
ɽֵ´,XiangShanJieDaoBanShiChu,411702011,11275,1260,7707,4316,15411,7701,3338,8094,15795,8166,15873
ˮ,ShuiTunZhen,411702100,43457,5933,31111,15820,63235,31080,14498,32729,63809,32777,63888
,ZhuShiXiang,411702203,23168,3250,16125,8443,32628,16119,6765,17046,33165,17058,33183
Ŷ,ZhuGuDongXiang,411702204,17046,2502,12967,7142,25813,12964,7092,13654,26618,13673,26640
,HuMiaoXiang,411702205,26768,3582,19716,10525,40155,19653,10433,20982,40635,21067,40783
ų,GuChengXiang,411702206,23399,3097,17303,9208,34610,17259,8835,17889,35148,18028,35331
,GuanWangMiaoXiang,411702360,22233,2702,15336,7900,29376,14782,6183,15192,29974,15782,31118
ũ,WuSanNongChang,411702400,4824,369,814,354,1545,418,145,452,870,4524,5338
ӽֵ´,JinHeJieDaoBanShiChu,411702560,36062,2111,22594,14720,25703,22151,8547,22347,44498,24126,46720
Žֵ´,JinQiaoJieDaoBanShiChu,411702561,14595,1546,10365,5389,19884,10333,4810,10505,20838,10586,20951
ɽֵ´,JinShanJieDaoBanShiChu,411702562,5843,744,4135,2130,7320,4109,1659,4059,8168,4111,8246
Դֵ´,KaiYuanJieDaoBanShiChu,411702563,6760,747,4601,2363,9226,4601,1872,4778,9379,4778,9379
سǽֵ´,BaiChengJieDaoBanShiChu,411721001,64760,7018,42103,22297,67694,35470,14496,36072,71542,44171,86274
ֵͤ´,BaiTingJieDaoBanShiChu,411721002,21439,2022,13900,6036,19046,10459,4521,10801,21260,14082,27982
幵Ӫ,WuGouYingZhen,411721101,23535,4173,17394,10033,34488,17389,7341,17629,35018,17655,35049
Ȩկ,QuanZhaiZhen,411721102,19279,3623,14811,9294,28505,14783,6142,14212,28995,14233,29044
ʦ,ShiLingZhen,411721103,20287,4643,16358,10737,30665,16344,6361,14893,31237,14933,31291
ɽ,ChuShanZhen,411721104,23965,5071,17384,11178,35328,17359,6836,18289,35648,18488,35872
Ң,PenYaoZhen,411721105,30274,5286,22418,13149,44133,22372,9178,22279,44651,22320,44738
,HuanChengXiang,411721200,21256,2994,14820,7856,29432,14795,5864,15234,30029,15294,30114
,ZhongQuXiang,411721201,21735,3693,16271,9458,32251,16156,7174,16142,32298,16331,32602
˺,RenHeXiang,411721203,28783,3897,19157,10267,39310,18952,7164,20351,39303,20687,39844
μ,SongJiXiang,411721204,21014,3432,15496,9169,30742,15495,6869,15790,31285,15819,31315
̷,TanDianXiang,411721205,23645,4127,17719,10429,34999,17488,7411,17083,34571,17464,35183
,LvDianXiang,411721206,23195,4464,16669,9940,33262,16525,6058,16818,33343,17048,33717
«,LuMiaoXiang,411721208,22543,4778,16466,10747,33515,16378,6455,17122,33500,17310,33776
ׯ,YangZhuangXiang,411721209,21269,3825,15184,9359,30394,15176,5793,15619,30795,15703,30887
ר̽,ZhuanTanXiang,411721210,32231,5126,23551,13972,47085,23542,10125,23923,47465,23931,47482
,ErLangXiang,411721211,24571,4209,18330,11123,36985,18191,8718,18905,37096,19168,37498
կ,CaiZhaiHuiZuXiang,411721212,7887,1396,5854,3702,11718,5853,2560,5988,11841,5989,11843
ׯ,JiaoZhuangXiang,411721213,15569,3178,12681,8288,24291,12643,6019,11970,24613,12085,24766
ũ,LaoWangPoNongChang,411721500,4789,879,3582,2133,6917,3580,1471,3545,7125,3557,7139
ҵ,ChanYeJiJuQu,411721501,9337,1421,7002,3864,13204,6927,2978,6601,13528,6734,13736
̶ֵ´,CaiDouJieDaoBanShiChu,411722001,41021,3500,27274,11264,45232,20011,11849,20678,40689,29096,56370
«ڽֵ´,LuGangJieDaoBanShiChu,411722002,40492,3522,26833,11859,44254,20720,11041,21633,42353,28222,55055
ֵ´,ChongYangJieDaoBanShiChu,411722003,32487,2383,20124,8645,33494,15535,7914,16240,31775,22660,42784
ֵ´,WoLongJieDaoBanShiChu,411722004,31446,3010,20402,7756,31092,15018,7706,15346,30364,21760,42162
Ʋ,HuangBuZhen,411722101,20451,3360,15744,9590,31300,15403,8120,15574,30977,16187,31931
,YangJiZhen,411722102,30653,3882,23009,12886,46322,22524,11932,22660,45184,23458,46467
䨺,ZhuHuZhen,411722103,28366,4695,22023,12224,42620,21995,10526,21497,43492,21564,43587
,DangDianZhen,411722104,27912,4493,22180,12399,42440,21692,11469,20627,42319,21694,43874
,ZhuLiZhen,411722105,32940,4450,25855,14908,50593,25764,13865,25232,50996,25400,51255
,HuaBeiZhen,411722106,28158,4856,24323,14088,46185,23804,13774,21433,45237,22465,46788
,TaQiaoZhen,411722107,33443,5752,28505,16408,53971,27607,15858,24846,52453,26548,55053
,DongHongZhen,411722108,34636,5932,29570,16936,56817,29121,16985,26930,56051,27983,57553
·,DaLuLiXiang,411722201,18630,3349,15830,10080,30433,15830,8956,15105,30935,15105,30935
,WuLiangSiXiang,411722202,18020,3234,14668,9375,28478,14667,7832,14411,29078,14418,29086
۵,ShaoDianXiang,411722203,36433,5062,28050,15195,55328,28048,14497,27938,55986,27942,55992
,WuLongXiang,411722204,13015,2126,10570,6255,20294,10341,5517,9687,20028,10088,20658
,YangTunXiang,411722205,12915,2082,10582,6099,20195,10471,5576,9737,20208,9991,20573
͵,HeDianXiang,411722206,35197,5379,28802,16021,54762,28544,15908,27137,55681,27682,56484
̹,CaiGouXiang,411722207,26805,4218,22951,13860,43911,22928,13426,21380,44308,21498,44449
뺣,QiHaiXiang,411722209,16799,2894,14611,8580,27477,14604,8223,13252,27856,13305,27916
,ChongLiXiang,411722210,22792,3469,19596,11239,37817,19595,12306,18965,38560,18971,38567
կ,HanZhaiXiang,411722211,21796,3222,18142,10322,34625,18113,10177,16984,35097,17053,35195
,DongAnXiang,411722212,20664,3917,19501,12502,36292,19407,12475,17441,36848,17555,37056
С,XiaoYueSiXiang,411722215,15440,2590,14607,8895,26682,14576,8921,12231,26807,12344,26951
,XiHongXiang,411722216,22333,4072,21304,12594,38066,21268,12512,17545,38813,17613,38917
ٳ,BaiChiXiang,411722217,30439,4850,24456,14499,47940,24438,13263,23968,48406,24096,48552
Żֵ´,GuHuaiJieDaoBanShiChu,411723001,50455,3799,31480,16768,51152,26165,9363,27984,54149,32137,63617
ӽֵ´,QingHeJieDaoBanShiChu,411723002,32656,2365,20386,8861,31931,16325,6429,17040,33365,21064,41450
ʽֵ´,DongHuangJieDaoBanShiChu,411723003,27457,3295,18552,10272,37750,18552,7280,19479,38031,19480,38032
,YangBuZhen,411723101,31848,4303,23441,13222,46745,23305,10598,23035,46340,23308,46749
͵,DongHeDianZhen,411723102,28999,4369,21936,12723,43011,21936,9817,21246,43182,21249,43185
,MiaoWanZhen,411723103,29723,4902,23551,13286,44981,23520,10553,21571,45091,21627,45178
,SheQiaoZhen,411723104,36478,4383,26146,13148,52932,26145,12412,27126,53271,27127,53273
,XiYangDianZhen,411723105,37676,5055,26618,17013,54039,26618,11997,28110,54728,28110,54728
,YangChengZhen,411723106,32222,5185,23835,14272,48283,23833,10984,24553,48386,24556,48391
¥,GuoLouZhen,411723107,24359,3081,17198,10364,34392,17198,7066,17308,34506,17308,34506
,LiTunZhen,411723108,21494,3053,14920,8501,30122,14902,5763,15309,30211,15390,30310
,WanJinDianZhen,411723109,23664,3408,17166,10856,34926,17165,7960,17866,35031,17866,35032
,GaoYangDianXiang,411723201,24743,4161,20192,12867,37809,20192,8996,17707,37899,17708,37900
ʮ·,ShiZiLuXiang,411723202,15655,3169,13358,9029,25721,13348,6925,12358,25706,12391,25749
ڣ,WanZhongXiang,411723204,27890,4218,20507,11900,40926,20503,9045,20597,41100,20646,41153
,YuHuangMiaoXiang,411723205,22860,3362,17172,10071,33811,17167,7629,16660,33827,16679,33851
,LaoWangGangXiang,411723208,16688,3603,13594,8738,26356,13594,6095,12789,26383,12792,26386
,XinDianXiang,411723209,16698,2904,12687,8438,25146,12687,5573,12488,25175,12488,25175
˫,ShuangMiaoXiang,411723211,14913,2631,12145,7546,23648,12141,6189,11577,23718,11588,23733
,ZhenYangZhen,411724100,68537,6307,45259,24418,73765,42809,17215,44328,87137,46800,92059
,HanDongZhen,411724101,23800,3824,19344,11905,36761,19268,9231,17355,36623,17511,36855
ϲ,RuNanBuZhen,411724102,32239,4438,24919,13820,48658,24598,12199,23402,48000,23957,48876
ͭ,TongZhongZhen,411724103,21098,2506,14600,8137,29613,14596,6419,15419,30015,15423,30023
,DouGouZhen,411724104,24374,2947,17353,9709,34876,17278,8075,17923,35201,18043,35396
կ,XiongZhaiZhen,411724105,15628,2073,11982,6878,23663,11982,6073,11792,23774,11792,23774
,DaLinZhen,411724106,24442,2930,17822,10637,35904,17818,8936,18408,36226,18486,36308
,YongXingZhen,411724107,14784,2162,12260,7222,23286,12245,6602,11200,23445,11288,23548
ˮ,ShenShuiXiang,411724200,31794,3633,22803,11762,39419,20337,9448,19344,39681,22072,44875
կ,FuZhaiXiang,411724201,17798,2671,13993,8194,26638,13983,6684,13112,27095,13160,27153
Ԭկ,YuanZhaiXiang,411724202,20487,2672,16347,9226,31045,16339,8009,14799,31138,14821,31168
,XinRuanDianXiang,411724203,13077,1839,11238,6816,20783,11234,6034,9691,20925,9712,20950
ͷ,YouFangDianXiang,411724204,19558,2796,15992,9511,30492,15988,8396,14739,30727,14758,30750
կ,LeiZhaiXiang,411724207,24906,3354,19947,11849,37855,19945,10214,18527,38472,18527,38474
,WangWuQiaoXiang,411724208,16411,2104,13141,7375,25045,13031,6918,12184,25215,12292,25433
,LvHeXiang,411724210,14497,2294,12098,7802,22334,12086,6169,10827,22913,10862,22960
Ƥ,PiDianXiang,411724212,18472,2534,13561,8248,27206,13561,6479,13924,27485,13924,27485
,PengQiaoXiang,411724213,14420,2050,10329,6492,20722,10327,4657,10777,21104,10798,21127
,LanQingXiang,411724214,18102,2567,14378,8865,27667,14374,7151,13423,27797,13442,27820
,PanLongZhen,411725100,35211,3480,23910,13731,32406,20303,8317,19814,40117,23098,47008
,ZhuGouZhen,411725101,14294,2244,11716,7381,22962,11701,7251,12030,23731,12073,23789
ε,RenDianZhen,411725102,21243,3915,18571,12808,34344,18432,10777,16988,35420,17364,35935
°,XinAnDianZhen,411725103,23309,3862,20343,13442,39153,20343,12436,19264,39607,19264,39607
ׯ,LiuZhuangZhen,411725104,23076,4079,20716,12922,39547,20699,13099,19412,40111,19538,40254
,LiuDianZhen,411725105,21642,3863,20137,13168,36174,20134,11338,16690,36824,16706,36843
Ϸ,YiFengZhen,411725106,10949,1670,8665,5466,17239,8638,5270,9110,17748,9224,17889
߸,WaGangZhen,411725107,11734,1924,9889,6530,19142,9885,5958,9708,19593,9727,19616
˫,ShuangHeZhen,411725108,24914,3503,20032,12387,38301,19814,11012,19098,38912,19397,39429
ʯ,ShiGunHeZhen,411725109,10441,1492,8668,5230,17204,8662,5533,8744,17406,8798,17466
µ,LiXinDianZhen,411725110,11810,1955,9752,6115,19028,9730,5594,9480,19210,9607,19359
,SanLiHeXiang,411725200,33196,4519,25438,15342,42942,25202,12319,24206,49408,24596,50034
ջ,PuHuiSiXiang,411725209,10729,2268,10103,7060,18559,10092,5795,8552,18644,8689,18792
ˮ,MiShuiZhen,411726100,54839,4127,36765,19690,56839,31813,16771,33442,65255,38972,75737
ɳӵ,ShaHeDianZhen,411726101,19152,2758,14117,8193,28970,14112,7340,15119,29231,15133,29250
,YangCeZhen,411726102,30063,4738,21986,13686,45909,21986,11289,24099,46085,24104,46090
,MaGuTianZhen,411726103,23827,3170,16796,10207,34010,16540,8758,18118,34658,18959,35755
,BanQiaoZhen,411726104,21283,4184,16844,10644,33993,16825,9309,17845,34670,17932,34776
ˮ,ChunShuiZhen,411726105,19007,3638,14645,8801,30097,14576,8185,16054,30630,16185,30830
ׯ,GuanZhuangZhen,411726106,28489,4404,20576,12392,42858,20576,10082,22399,42975,22399,42975
,SheWanZhen,411726107,25422,3978,17519,10744,36869,17519,7613,19384,36903,19494,37013
ߵ,GaoDianXiang,411726200,17380,2245,12155,7026,25288,11760,5804,12662,24422,13274,25429
̹,PanGuXiang,411726201,21969,3330,15713,9929,32363,15704,7280,16726,32430,16866,32579
,GaoYiXiang,411726202,13146,2603,9802,6200,20319,9786,5087,11006,20792,11034,20836
,WangDianXiang,411726203,22359,3430,16279,9250,33909,16273,8284,17731,34004,17794,34073
ͭɽ,TongShanXiang,411726204,14154,2229,10674,6579,22127,10672,6336,11979,22651,12045,22719
Ϻ,LaoHeXiang,411726205,14448,2787,11669,8020,24318,11663,7305,12841,24504,12871,24540
±,XiaBeiSiXiang,411726206,10403,2365,8339,5571,17185,8338,4646,9039,17377,9075,17414
,XiangHeXiang,411726207,14977,2894,11514,7097,23929,11467,6542,12621,24088,12899,24413
ׯ,FuZhuangXiang,411726208,15815,2719,11989,7245,24627,11989,6170,12715,24704,12715,24704
¥,JiaLouXiang,411726209,10156,1583,7250,4467,15594,7250,3878,8367,15617,8367,15617
ɽ,HuangShanKouXiang,411726210,8427,2159,6804,4829,14439,6799,3969,7745,14544,7751,14555
,GuoJiXiang,411726211,21501,3332,15688,9687,32634,15415,8009,16791,32206,17154,32842
̩ɽ,TaiShanMiaoXiang,411726212,22876,4110,17429,11200,35885,17421,9113,18627,36048,18670,36099
Ҽ,YangJiaJiXiang,411726214,21912,3441,15580,9383,32593,15580,7497,17219,32799,17270,32850
˫,ShuangMiaoJieXiang,411726215,17390,3286,12846,7398,26359,12844,5949,13698,26542,13779,26625
԰,HuaYuanXiang,411726217,57014,4926,35691,18274,47692,32250,13362,34865,67115,39611,75302
ҵ԰ί,GongYeYuanQuGuanWeiHui,411726400,8731,6,6203,0,287,0,0,0,0,2534,8737
ʯĿί,ShiCaiKaiFaQuGuanWeiHui,411726401,8619,21,725,0,1643,0,9,0,0,7924,8649
ֵ´,RuNingJieDaoBanShiChu,411727001,87082,8410,55838,26318,59198,49532,15983,51341,100873,55637,111475
բֵ´,SanMenZhaJieDaoBanShiChu,411727002,37459,4569,26214,14454,45707,26176,11089,26707,52883,26903,53117
ֵ´,GuTaJieDaoBanShiChu,411727003,52411,4289,33519,16803,47885,33041,12485,34986,68027,35666,69185
,WangGangZhen,411727101,27862,3615,20018,10877,40511,20015,9406,20853,40868,20865,40883
ף,LiangZhuZhen,411727102,24286,3503,18083,11467,36349,18055,9161,18711,36766,18867,36950
Т,HeXiaoZhen,411727103,20368,3139,14814,8276,30448,14757,7114,15666,30423,15807,30621
Ͼ,LaoJunMiaoZhen,411727104,29567,3859,20930,11633,41597,20916,8981,21390,42306,21477,42407
,LiuPenZhen,411727105,34230,4289,23865,14126,48904,23820,10485,25076,48896,25139,49004
,JinPuZhen,411727106,26733,4024,20593,12041,40314,20496,10411,20434,40930,20575,41168
ׯ,DongGuanZhuangZhen,411727107,29388,4021,20772,11706,42237,20759,9321,21923,42682,21958,42730
,SanQiaoXiang,411727202,36666,5092,27795,15802,54896,27762,13547,27463,55225,27510,55305
,NanYuDianXiang,411727204,14116,1778,9986,5551,20360,9973,4777,10675,20648,10685,20671
,ChangXingXiang,411727206,30671,4775,23190,14224,46844,23162,12064,24222,47384,24320,47510
ׯ,HanZhuangXiang,411727209,22336,3202,16225,9102,32950,16211,7758,17029,33240,17071,33296
޵,LuoDianXiang,411727210,31157,4584,22465,13301,45805,22434,10426,23599,46033,23702,46167
¥,ZhangLouXiang,411727211,16151,2795,13056,8574,25676,13033,7170,12999,26032,13060,26116
,BanDianXiang,411727212,14211,2611,11521,8343,23320,11496,6568,11823,23319,11869,23390
ֵ´,QuYangJieDaoBanShiChu,411728001,35136,3564,23028,12264,38918,20249,7446,20341,40590,23118,46146
վֵ´,CheZhanJieDaoBanShiChu,411728002,20788,2803,14307,8026,27100,14190,5339,14365,28555,14623,28930
ֵ´,LianHuaHuJieDaoBanShiChu,411728003,27635,2652,17821,8635,27358,15083,5528,14879,29962,17994,35815
ɽ,YuShanZhen,411728102,16649,2964,12246,7711,24159,12243,4716,12077,24320,12083,24329
ɽ,ChaYaShanZhen,411728103,13137,2852,9738,6533,19595,9721,3870,10037,19758,10121,19859
ʯկ,ShiZhaiPuZhen,411728104,18740,2854,13428,7848,27027,13395,5731,13828,27223,13897,27325
ׯ,ChangZhuangXiang,411728200,26119,4489,19817,11341,38607,19812,8807,19562,39374,19598,39415
,HeXingXiang,411728202,39217,6304,28918,17041,56543,28900,11810,28365,57265,28413,57331
կ,ShenZhaiXiang,411728203,26150,5276,20172,13093,39433,20012,8380,19441,39453,19634,39806
,HuaiShuXiang,411728204,16905,3530,12510,8263,25121,12504,4875,12751,25255,12800,25310
,YangFengXiang,411728206,21753,3499,15442,9401,30965,15433,6124,15828,31261,15934,31376
ׯ,HuaZhuangXiang,411728207,18167,2718,12599,7131,26171,12595,5402,13617,26212,13688,26287
ĳ,WenChengXiang,411728209,16147,2833,12072,7772,24440,11973,5711,12389,24362,12619,24691
,ChuTangXiang,411728211,13442,2224,9468,5773,19154,9459,3609,9772,19231,9807,19275
ҵ԰,GongYeYuanQu,411728400,35221,21,8615,48,145,87,30,79,166,26657,35272
ɽ羰,ChaYaShanFengJingQu,411728500,4540,586,2773,1393,5028,2396,1078,2550,4946,3431,6204
ȷ羰,FengMingGuFengJingQu,411728501,4865,520,3000,1462,5197,2548,1174,2820,5368,3559,6559
,GuLvZhen,411729100,76085,6279,49217,23621,75938,44679,16686,46027,90706,49833,99050
ש,ZhuanDianZhen,411729101,16575,2348,12159,7137,23989,12148,5544,12290,24438,12308,24467
µ,ChenDianZhen,411729102,18097,3261,13902,8032,27451,13853,6274,13661,27514,13730,27632
,FoGeSiZhen,411729103,24367,4099,18103,10428,36211,18103,8302,18665,36768,18665,36768
,LianCunZhen,411729104,28692,4800,23994,13907,45103,23993,12210,21704,45697,21708,45702
Ĵ,TangCunZhen,411729105,23239,3593,19513,11376,37810,19480,11709,18999,38479,19028,38541
,HanJiZhen,411729106,22009,3835,18262,11637,35466,18262,9804,17386,35648,17386,35648
,LongKouZhen,411729107,25438,4175,21330,11724,41564,21318,12259,20518,41836,20542,41872
Ż,LiQiaoHuiZuZhen,411729108,13349,2071,10614,5986,20918,10610,5712,10503,21113,10518,21132
¥,HuangLouZhen,411729109,23853,3779,18441,9595,35915,18441,9149,18340,36781,18340,36781
,SunZhaoZhen,411729110,24057,4355,19100,11099,37482,18795,9371,18192,36987,18683,37783
ʮ,ShiLiPuXiang,411729200,32473,3767,22257,11605,39888,20277,8607,20196,40473,22590,44847
,YuDianXiang,411729202,31292,5950,26266,16108,50367,26208,13442,24241,50449,24418,50684
,HeWuXiang,411729204,17988,2947,13756,7717,26956,13756,6242,13421,27177,13421,27177
ؽ,GuanJinXiang,411729205,27090,4758,21201,12274,41487,21165,10221,20814,41979,20868,42069
θ,SongGangXiang,411729206,16317,3465,13718,8604,26429,13658,6994,12930,26588,13058,26776
ٸ,DunGangXiang,411729207,19351,3908,16903,9753,31242,16903,8298,14653,31556,14654,31557
ͷ,JianTouXiang,411729208,29384,4626,22696,13481,44593,22696,10613,21927,44623,21927,44623
ׯ,YangZhuangHuXiang,411729209,15699,3416,13980,8210,25848,13980,7602,12736,26716,12737,26717
ׯ,HuaZhuangXiang,411729210,29530,4657,23125,13861,45807,23111,11953,22991,46102,23015,46140
ݳ,LiChengXiang,411729211,23034,4103,18642,11198,35274,18509,9223,17576,36085,17718,36360
,MiTuoSiXiang,411729213,17897,2656,14583,8842,28974,14583,8483,14453,29036,14453,29036
Դ԰ֵ´,JiYuanShiQinYuanJieDaoBanShiChu,419001001,63875,3248,37860,18359,37134,30088,11300,30240,60328,40563,78423
Դмˮֵ´,JiYuanShiJiShuiJieDaoBanShiChu,419001002,36462,2318,23616,13555,32052,22860,8548,22638,45498,23712,47328
Դбֵ´,JiYuanShiBeiHaiJieDaoBanShiChu,419001003,37066,2550,24028,13724,31501,23569,8755,24121,47690,24343,48371
Դֵ̳´,JiYuanShiTianTanJieDaoBanShiChu,419001004,27438,1762,16955,9050,25375,16255,6091,16579,32834,18336,35291
ԴȪֵ´,JiYuanShiYuQuanJieDaoBanShiChu,419001005,25257,2409,16200,8002,28450,15275,5064,15331,30606,16530,32730
Դп˾,JiYuanShiKeJingZhen,419001100,44401,3861,28555,14317,54520,27636,10337,28468,56104,30044,58599
Դ,JiYuanShiWuLongKouZhen,419001101,35909,4028,23207,12371,45143,22780,7120,22688,45468,23850,47057
Դ,JiYuanShiZhiChengZhen,419001102,56371,5692,36425,18790,68670,35181,11189,35570,70751,36827,73252
Դг,JiYuanShiChengLiuZhen,419001103,40811,4426,26113,14660,51211,25400,7862,26305,51705,26986,53099
Դԭ,JiYuanShiShaoYuanZhen,419001104,24777,1976,17117,9602,34136,17112,8586,18217,35329,18222,35339
Դͷ,JiYuanShiPoTouZhen,419001105,16692,2163,11323,6379,22110,11087,3906,10979,22066,11438,22761
Դ,JiYuanShiLiLinZhen,419001106,27594,2876,18473,10124,36183,18473,6583,18578,37051,18580,37053
Դд,JiYuanShiDaYuZhen,419001107,18538,1806,12119,6992,24551,11998,4957,12828,24826,13182,25301
Դ˼,JiYuanShiSiLiZhen,419001108,20448,1854,13103,6737,24743,12633,4145,12788,25421,13344,26447
Դ,JiYuanShiWangWuZhen,419001109,20240,1595,13206,7267,27030,13128,5766,14308,27436,14395,27601
Դұ,JiYuanShiXiaYeZhen,419001110,19319,1746,13086,7604,26805,13086,6040,14017,27103,14019,27105
Ϻְ´,ShangHaiJieBanShiChu,420102001,20027,3488,13142,9355,13769,12075,1910,11286,23361,12283,25425
ǽְ´,DaZhiJieBanShiChu,420102002,29262,3440,17974,12448,17128,15257,2385,14590,29847,17113,35087
һԪְ´,YiYuanJieBanShiChu,420102003,20111,3053,12654,7887,12654,10383,1663,9772,20155,12173,24827
վְ´,CheZhanJieBanShiChu,420102004,20078,2896,12789,10082,15338,12503,2095,11668,24171,12280,25069
Ψְ´,SiWeiJieBanShiChu,420102005,25704,3415,16406,11631,18070,15750,3115,14927,30677,15828,32234
ְ´,YongQingJieBanShiChu,420102006,14670,1864,9466,6990,12710,9252,2011,8875,18127,9079,18545
ְ´,XiMaJieBanShiChu,420102007,49677,7151,31202,22158,42373,29510,4767,29269,58779,30393,61595
򳡽ְ´,QiuChangJieBanShiChu,420102008,21369,2742,12771,9275,14726,11958,2028,11488,23446,13368,26139
Ͷְ´,LaoDongJieBanShiChu,420102009,55692,9372,36947,26569,47013,35837,6846,33302,69139,34963,71910
ְ߽´,ErQiJieBanShiChu,420102010,64608,8079,41363,30291,42012,40051,8625,37681,77732,39949,81312
´ְ´,XinCunJieBanShiChu,420102011,54850,7698,34246,23926,41958,33602,6368,33009,66611,34670,68916
ˮؽְ´,DanShuiChiJieBanShiChu,420102012,46212,6052,28326,20659,30463,27262,5504,27632,54894,29442,57768
ְ̨´,TaiBeiJieBanShiChu,420102014,31033,4438,19468,14849,24453,18794,3060,18256,37050,19063,38531
Žְ´,HuaQiaoJieBanShiChu,420102015,105732,11387,65347,49626,57578,61514,14110,61277,122791,65882,131229
ȼ�ְ´,ChenJiaJiJieBanShiChu,420102016,14574,722,8449,2462,6339,3609,901,3667,7276,7748,16197
ְ´,HouHuJieBanShiChu,420102017,118950,5016,65828,38245,31700,47034,13313,49295,96329,71451,137279
ٲͤ԰,BaiBuTingHuaYuan,420102400,34089,3575,22246,14781,20748,22203,6230,21585,43788,21648,43894
ְ´,MinZuJieBanShiChu,420103001,26837,2894,14655,10673,19995,13752,2482,14028,27780,17558,32213
¥ְ´,HuaLouJieBanShiChu,420103002,2121,105,1019,1185,524,921,128,803,1724,1335,2354
ˮְ´,ShuiTaJieBanShiChu,420103003,16108,1821,9333,5898,12807,8380,1497,7868,16248,10093,19426
Ȩְ´,MinQuanJieBanShiChu,420103004,29564,3984,18474,14199,23679,17930,2839,17351,35281,17913,36387
ְ´,ManChunJieBanShiChu,420103005,20162,1680,11862,8688,11002,11204,2036,11165,22369,12016,23878
ְ´,MinYiJieBanShiChu,420103006,29247,3088,18066,11901,19032,16834,3358,16285,33119,17627,35693
»ְ´,XinHuaJieBanShiChu,420103007,33057,4697,20712,13860,27349,18694,3011,17939,36633,20053,40765
ɽְ´,WanSongJieBanShiChu,420103008,66575,9719,42180,28347,54551,39008,6746,36850,75858,40860,83040
ƼҶսְ´,TangJiaDunJieBanShiChu,420103009,88370,7360,52793,39021,37016,50460,11882,51498,101958,54819,107612
ְ´,BeiHuJieBanShiChu,420103010,30609,4001,19067,12148,20544,16675,3158,16212,32887,18701,37768
ǰְ´,QianJinJieBanShiChu,420103011,23927,2742,14733,11019,19703,14057,2341,13675,27732,14277,29010
ְ´,ChangQingJieBanShiChu,420103012,72515,5078,41684,28754,32365,38446,9289,39824,78270,45198,86882
˽ְ´,HanXingJieBanShiChu,420103013,126714,8159,73553,49031,46827,64627,15798,66936,131563,77118,150671
׼Ҷսֵ´,YiJiaDunJieDaoBanShiChu,420104001,69374,8743,43026,29962,48299,40094,8510,39931,80025,43601,86627
Ҷսֵ´,HanJiaDunJieDaoBanShiChu,420104002,76169,8068,46003,31635,40465,43762,10103,43815,87577,48337,94340
ڹؽֵ´,ZongGuanJieDaoBanShiChu,420104003,52062,6181,31064,22587,31890,29911,6406,30303,60214,33585,64649
ˮŽֵ´,HanShuiQiaoJieDaoBanShiChu,420104004,58103,7048,36190,25070,42279,33304,6625,32173,65477,35586,71776
ֵ´,BaoFengJieDaoBanShiChu,420104005,46049,6144,29497,16376,37766,22954,4454,21696,44650,27150,56647
ٻֵ´,RongHuaJieDaoBanShiChu,420104006,40939,5153,25928,18153,27719,24187,4500,22931,47118,24664,50592
ʽֵ´,ChongRenJieDaoBanShiChu,420104007,30105,3314,18527,12159,19253,15367,2606,15058,30425,17498,36025
нֵ´,HanZhongJieDaoBanShiChu,420104008,25122,2174,14720,8728,15092,11611,2301,11499,23110,14877,29597
ֵ´,HanZhengJieDaoBanShiChu,420104009,97689,5695,55699,38423,36665,49819,10591,51975,101794,58276,113975
ֵͤ´,LiuJiaoTingJieDaoBanShiChu,420104010,38882,3486,23098,15260,17697,19916,3917,19489,39405,23187,46285
ֵ´,ChangFengJieDaoBanShiChu,420104011,161819,4649,86797,41221,14090,53535,12684,57187,110722,92355,179152
΢ְ´,CuiWeiJieBanShiChu,420105001,35492,5180,22423,15786,34830,22074,3857,21627,43701,22106,44529
Žְ´,JianQiaoJieBanShiChu,420105002,37418,5898,23973,17316,32088,22942,3644,21840,44782,22987,46960
ºְ´,YueHuJieBanShiChu,420105003,19447,669,6591,2894,12805,3820,828,3881,7701,14353,20944
紨ְ´,QingChuanJieBanShiChu,420105004,13706,2125,8654,5910,9159,7845,1307,7710,15555,8484,17138
Ľְ´,YingWuJieBanShiChu,420105005,42559,4576,25123,17692,35669,24575,4810,24396,48971,26822,51945
ͷְ´,ZhouTouJieBanShiChu,420105006,31922,3727,19014,13728,26960,18741,3239,19212,37953,19874,38888
սְ´,WuLiDunJieBanShiChu,420105007,70674,8279,42466,30544,46648,40846,8393,41479,82325,44880,87346
ٶϿڽְ´,QinDuanKouJieBanShiChu,420105008,54536,5270,32634,24750,33840,32086,7102,32879,64965,34274,66908
Žְ´,JiangHanErQiaoJieBanShiChu,420105009,61227,7694,37288,28211,44764,36468,7080,37230,73698,38713,76001
ְ´,YongFengJieBanShiChu,420105010,92120,5226,49112,25743,35558,37156,9136,38705,75861,57370,106482
ְ̽´,JiangDiJieBanShiChu,420105011,20178,1875,11176,7661,13766,10795,2443,10846,21641,13320,24496
µί,SiXinDiQuGuanWeiHui,420105012,1994,185,1110,913,1780,1077,282,1078,2155,1351,2461
Žְ´,JiYuQiaoJieBanShiChu,420106001,48140,6363,30047,22253,37442,29519,5820,29155,58674,30276,60323
԰ְ´,YangYuanJieBanShiChu,420106002,88812,10689,50197,36000,67727,46829,9984,47334,94163,59288,109485
ְ´,XuJiaPengJieBanShiChu,420106003,103203,10167,61413,37464,82376,50950,10548,50733,101683,62505,123918
ְ´,LiangDaoJieBanShiChu,420106005,51869,6492,32759,22032,42205,28645,6343,27603,56248,31945,64704
л·ְ´,ZhongHuaLuJieBanShiChu,420106006,35106,5095,22511,16899,31997,21649,4061,20906,42555,21751,44262
ƺ¥ְ´,HuangHeLouJieBanShiChu,420106007,49530,6800,32448,20275,45831,26155,4579,25125,51280,28461,60909
ְ´,ZiYangJieBanShiChu,420106008,49157,6499,29900,23722,35529,29125,5479,29518,58643,31235,61135
ɳ޽ְ´,BaiShaZhouJieBanShiChu,420106009,61960,6969,37781,28283,43546,35912,7297,36854,72766,38445,76226
·ְ´,ShouYiLuJieBanShiChu,420106010,55774,7492,34774,22057,47990,30324,6296,29755,60079,34788,69562
·ְ´,ZhongNanLuJieBanShiChu,420106011,180462,18580,103154,70677,148276,85147,17174,85064,170211,113062,216216
ˮְ´,ShuiGuoHuJieBanShiChu,420106012,144382,18256,88282,53365,132328,73952,15990,72684,146636,90346,178628
ɽְ´,LuoJiaShanJieBanShiChu,420106013,68971,3909,34777,8575,53037,11671,2248,11321,22992,40351,75128
ʯְ´,ShiDongJieBanShiChu,420106014,4718,1355,3396,2829,5792,3286,591,3125,6411,3268,6664
Ϻְ´,NanHuJieBanShiChu,420106015,41939,2878,25995,19875,20312,25788,7779,26026,51814,26601,52596
羰ֵ,DongHuFengJingQuJieDaoWuChang,420106092,12596,1010,8643,3276,7343,4420,925,4369,8789,5888,14531
·ֵ´,HongWeiLuJieDaoBanShiChu,420107001,66530,9110,38210,27149,55360,34558,6697,35297,69855,44127,82337
ұֵ´,YeJinJieDaoBanShiChu,420107002,62097,8722,39328,26390,59281,38318,8068,37596,75914,39559,78887
¹Žֵ´,XinGouQiaoJieDaoBanShiChu,420107003,42060,7669,27965,19713,38681,27098,5203,26192,53290,26967,54932
ֳǽֵ´,HongGangChengJieDaoBanShiChu,420107004,29501,5235,18708,12430,24577,17447,3256,16955,34402,19284,37992
˴ֵ´,GongRenCunJieDaoBanShiChu,420107005,11885,836,5897,4590,4987,5692,1420,6293,11985,8244,14141
ɽֵ´,QingShanZhenJieDaoBanShiChu,420107006,16892,2207,8927,7106,13428,8463,1692,9044,17507,11864,20791
ǰֵ´,ChangQianJieDaoBanShiChu,420107007,7750,1065,4549,3423,5850,4380,1146,4833,9213,5412,9961
䶫ֵ´,WuDongJieDaoBanShiChu,420107008,19707,3151,11901,9257,17881,11600,2396,11973,23573,13353,25254
ɽֵ´,BaiYuShanJieDaoBanShiChu,420107009,29013,4788,18031,13737,21894,17798,3902,18629,36427,19672,37703
ֵֻ´,GangHuaCunJieDaoBanShiChu,420107010,59482,10207,39079,24872,63340,38868,7533,37806,76674,38143,77222
ֶ԰ί,GangDouHuaYuanGuanWeiHui,420107011,33216,3085,20108,12829,33634,20075,3618,19762,39837,19811,39919
ί,BeiHuGuanWeiHui,420107012,3626,2151,3123,2581,4507,3104,410,2922,6026,3064,6187
ֳ,WuGangChangQu,420107400,279,2,5,35,0,5,0,37,42,276,281
Ͻֵ,LuoNanJieDao,420111001,200772,13920,107527,53622,126130,66437,15891,66543,132980,123056,230583
ɽֵ,GuanShanJieDao,420111002,277550,15615,144170,57116,197699,75351,20931,76796,152147,169926,314096
ʨɽֵ,ShiZiShanJieDao,420111003,90619,4219,44923,13453,52456,17696,4417,17754,35450,54332,99255
żֵ,ZhangJiaWanJieDao,420111004,23078,2097,12816,6529,13254,8493,1853,8806,17299,14212,27028
԰ֵֽ,LiYuanJieJieDao,420111005,18228,2011,10874,8659,11277,10699,2145,11084,21783,11510,22384
ɽֵ´,HongShanJieDaoBanShiChu,420111007,146520,4454,78131,54918,34941,56641,14018,60677,117318,86861,164992
ƽֵ´,HePingJieDaoBanShiChu,420111008,88792,5762,51420,38345,26251,50372,13257,53238,103610,56391,107811
羰ֵɽ,DongHuFengJingQuJieDaoHongShan,420111092,46452,3149,27447,10533,20855,14776,3509,15142,29918,25663,53110
ɽ,DongHuKaiFaQuHuaShanZhen,420111100,17309,2371,10466,7055,18950,10350,2576,10942,21292,11790,22256
,DongHuKaiFaQuZuoLingZhen,420111101,20489,3326,13346,10231,23443,13243,3865,13918,27161,14334,27680
,QingLingXiang,420111201,72086,2794,38648,13382,29625,19064,5033,19984,39048,41265,79913
人,WuHanHuaGongQuJianSheXiang,420111204,23563,2921,13943,9068,18071,13235,3323,13777,27012,15864,29807
,TianXingXiang,420111205,2559,403,1688,851,3004,1681,406,1674,3355,1680,3368
ŷ,DongHuKaiFaQuJiuFengXiang,420111282,9861,1167,5679,3721,8582,5521,1498,5814,11335,6847,12526
人̶´,WuHanHuaGongQuQingTanHuBanShiChu,420111460,4866,770,3109,2072,5456,3089,802,3274,6363,3329,6438
ضְ´,DongHuKaiFaQuGuanDongJieBanShiChu,420111480,165867,4766,86753,55898,45533,63911,18363,68903,132814,102243,188996
ɽֵ´,WuJiaShanJieDaoBanShiChu,420112001,93185,5688,56194,37220,59006,54260,16194,54862,109122,58873,115067
Ȫ´,BaiQuanBanShiChu,420112002,6981,1478,4690,3228,7912,4617,943,4590,9207,4712,9402
·ֵ´,JiangJunLuJieDaoBanShiChu,420112004,34037,2171,19897,13655,9128,18872,6051,20069,38941,22362,42259
Ȼݽֵ´,CiHuiJieDaoBanShiChu,420112005,13330,1478,7730,4817,6666,6752,1565,7032,13784,8643,16373
ֵ´,ZouMaLingJieDaoBanShiChu,420112006,20987,2696,12595,8868,15982,11744,3061,12349,24093,14149,26744
ӽֵ´,JingHeJieDaoBanShiChu,420112007,29643,2133,17936,11638,14551,17551,5161,18230,35781,19001,36937
ֵ´,ChangQingJieDaoBanShiChu,420112008,34788,1582,19387,12763,11139,16950,5278,18363,35313,22261,41648
ɰ´,XinAnDuBanShiChu,420112011,9166,2096,6173,4686,9563,5958,1358,6144,12102,6447,12620
ɽ´,DongShanBanShiChu,420112012,10600,2028,7256,5242,11830,7180,1818,7010,14190,7190,14446
໨԰ίԱ,ChangQingHuaYuanXinQuGuanLiWeiYuanHui,420112013,44354,4081,26412,15471,11594,22570,6918,21747,44317,28941,55353
¹ֵ´,XinGouZhenJieDaoBanShiChu,420112014,13674,2292,8667,6676,12592,8371,1873,8439,16810,9172,17839
ֵ´,JinYinHuJieDaoBanShiChu,420112015,49250,3235,27931,17188,8787,23672,6406,24073,47745,30960,58891
̨̹ҵ԰ίԱ,TaiShangGongYeYuanQuGuanLiWeiYuanHui,420112016,3456,439,2158,1511,2415,2106,579,2206,4312,2316,4474
ɴñֵ´,ShaMaoJieDaoBanShiChu,420113001,57767,5206,34416,23509,52833,33471,8751,34425,67896,37308,71724
Ͻֵ´,DengNanJieDaoBanShiChu,420113002,10505,1827,6435,4141,12180,6315,1358,6919,13234,7255,13690
ֵ´,DongJingJieDaoBanShiChu,420113003,11086,1457,6599,3935,11419,6148,1420,6619,12767,7364,13963
ڽֵ´,XiangKouJieDaoBanShiChu,420113004,12404,1413,7465,4979,13568,7344,1776,7785,15129,8128,15593
̵ְ´,CaiDianJieBanShiChu,420114001,116222,13771,69921,47061,112920,68331,16145,68275,136606,76217,146138
Lɽְ´,ZhaShanJieBanShiChu,420114002,35523,4713,22530,14153,38063,21706,5772,22103,43809,23478,46008
ְ´,YongAnJieBanShiChu,420114003,20337,3178,13313,8125,24367,13210,3474,13364,26574,13676,26989
٪ְ´,ZhuRuJieBanShiChu,420114004,34999,5376,22889,14504,43322,22693,6951,24093,46786,24437,47326
󼯽ְ´,DaJiJieBanShiChu,420114005,23154,3127,14216,8669,24454,13854,3251,13804,27658,15316,29532
ְ´,ZhangWanJieBanShiChu,420114006,21846,3495,14232,9467,25432,14169,3333,14276,28445,14442,28674
ڽְ´,DunKouJieBanShiChu,420114070,155487,7806,86979,44420,79630,61570,18282,64246,125816,94596,181575
ɽְ´,JunShanJieBanShiChu,420114071,21090,2546,11677,7061,19447,10975,2895,11099,22074,14854,26531
,SuoHeZhen,420114100,16024,2527,10823,6798,19447,10765,2993,10606,21371,10721,21544
,YuXianZhen,420114101,11865,1910,7586,4911,13390,7470,1642,7609,15079,7831,15417
,XiaoSiXiang,420114200,10193,1456,6331,4308,12134,6277,1602,6821,13098,6920,13251
ͩ´,TongHuBanShiChu,420114400,1713,280,1119,846,1960,1110,321,1153,2263,1195,2314
鱱ί,HongBeiGuanWeiHui,420114401,2895,310,1685,1193,2650,1546,380,1728,3274,1900,3585
̵龭ÿڰ´,CaiDianJingJiKaiFaQuDunKouBanShiChu,420114402,12178,242,5797,2075,560,2550,719,2885,5435,7342,13139
̵龭ÿ�´,CaiDianJingJiKaiFaQuChangFuBanShiChu,420114403,5656,548,3345,1845,5545,3028,762,3003,6031,3621,6966
̵龭ÿ´,CaiDianJingJiKaiFaQuWenLingBanShiChu,420114404,677,42,383,286,0,375,108,404,779,444,827
̵龭ÿҦɽ´,CaiDianJingJiKaiFaQuYaoJiaShanBanShiChu,420114405,7381,768,4470,2692,4527,4011,1029,3949,7960,4708,9178
ְֽ´,ZhiFangJieBanShiChu,420115001,152871,10871,93560,55428,104402,80756,25548,81475,162231,95730,189290
ڽְ´,JinKouJieBanShiChu,420115002,39059,6805,26175,19644,46394,25686,6696,25512,51198,26385,52560
Ȫְ´,WuLongQuanJieBanShiChu,420115003,23663,3544,15247,11451,27232,15039,4328,15839,30878,16288,31535
ְ֣´,ZhengDianJieBanShiChu,420115005,28359,2963,17418,11424,25829,16874,5647,18153,35027,19551,36969
�ְ´,DongHuKaiFaQuLiuFangJieBanShiChu,420115006,10765,1439,6879,4937,12379,6649,2132,7088,13737,7457,14336
ְ´,WuLiJieJieBanShiChu,420115007,22632,1330,12302,4491,11432,6303,1811,6532,12835,13471,25773
ˮ´,JinShuiBanShiChu,420115008,4002,761,2739,1940,4926,2734,674,2659,5393,2698,5437
ݳ°´,DongHuKaiFaQuDaWuChenBanShiChu,420115009,9273,1264,5792,4300,11136,5784,1527,6218,12002,6272,12064
´,DongHuKaiFaQuFoZuLingBanShiChu,420115086,86647,2102,44380,12753,23282,17300,5541,18864,36164,49910,94290
ʰ´,DongHuKaiFaQuBaoXieBanShiChu,420115087,18336,2573,11587,8350,22161,11477,3683,12330,23807,13005,24592
,FaSiZhen,420115100,12299,2284,8383,6117,15894,8341,2399,8509,16850,8599,16982
ɽ,AnShanZhen,420115101,9768,1545,6486,4906,12141,6439,1990,6693,13132,6817,13303
,HuSiZhen,420115103,9775,1762,6499,4651,12708,6444,2132,7046,13490,7170,13669
ɽ,ShanPoXiang,420115204,21556,3131,14111,10017,26070,13527,4461,14067,27594,15037,29148
氲,ShuAnXiang,420115206,6597,1153,4333,3472,8392,4331,1159,4571,8902,4576,8909
ľÿɽ´,JiangXiaJingJiKaiFaQuMiaoShanBanShiChu,420115401,50782,1000,27025,4773,7674,6819,2138,7197,14016,26895,53920
ľÿ´,JiangXiaJingJiKaiFaQuCangLongDaoBanShiChu,420115402,93756,969,48920,6522,20002,8918,2749,9533,18451,48554,97474
ľÿ´,JiangXiaJingJiKaiFaQuDaQiaoXinQuBanShiChu,420115403,60435,2017,32202,8411,25771,12914,3635,13168,26082,33885,66087
ľÿӺ羰´,JiangXiaJingJiKaiFaQuLiangZiHuFengJingQuBanShiChu,420115404,2948,388,1790,1190,3457,1743,443,1865,3608,1989,3779
ǰֵ,QianChuanJieDao,420116001,153164,15798,95561,54324,162041,87836,22016,88971,176807,95417,190978
ֵ,QiJiaWanJieDao,420116002,47946,7928,31827,20199,61984,31820,8354,32359,64179,32401,64228
ֵ,HengDianJieDao,420116003,40597,5846,26039,15938,50544,24253,6545,24520,48773,26949,52988
޺½ֵ,LuoHanSiJieDao,420116004,36800,6264,24724,16773,48401,24592,6729,24740,49332,25069,49793
ܿڽֵ,SheKouJieDao,420116005,34869,2953,19108,11500,31638,18163,5163,19052,37215,23877,42985
ֵָ,LiuZhiJieDao,420116006,47457,6994,30963,18292,60084,30359,8057,30681,61040,31545,62508
ӽֵ,TianHeJieDao,420116007,20598,2276,13010,6930,20578,11029,2884,11064,22093,12748,25758
Һӽֵ,WangJiaHeJieDao,420116008,33566,5890,22623,14230,43968,22575,5764,22503,45078,22597,45220
ֵ,ChangXuanLingJieDao,420116009,23951,3829,15755,10531,29048,15027,4379,15303,30330,16404,32159
Ҽֵ,LiJiaJiJieDao,420116010,53763,7175,34183,19637,67458,33110,9259,34634,67744,36014,70197
ҦҼֵ,YaoJiaJiJieDao,420116011,24524,4077,16411,11372,32189,16372,5068,17117,33489,17258,33669
̼եֵ,CaiJiaZhaJieDao,420116012,19274,3441,13114,8975,25609,13103,3513,13081,26184,13114,26228
ֵ,WuHuJieDao,420116013,28241,3055,16755,10443,27650,16034,4335,15949,31983,18876,35631
,SanLiZhen,420116105,12029,1535,7580,5346,14574,7452,2167,7876,15328,8151,15731
̵,CaiDianXiang,420116200,23943,4153,15883,10746,31580,15487,4669,15966,31453,16882,32765
ľ,MuLanXiang,420116201,21970,3712,14828,10505,29019,14752,4357,15104,29856,15211,30039
ľɽ羰,MuLanShanFengJingQu,420116401,1162,200,765,659,1330,736,202,759,1495,799,1564
̶´,DaTanBanShiChu,420116402,2387,375,1670,1295,2921,1668,528,1613,3281,1620,3290
Ǿÿ,PanLongChengJingJiKaiFaQu,420116403,50446,2847,28847,12197,32566,20204,5914,20151,40355,30360,59207
ۥǽֵ´,ZhuChengJieDaoBanShiChu,420117001,126753,12040,77632,45655,131714,72370,22835,76752,149122,83996,161628
ֵ߽´,YangLuoJieDaoBanShiChu,420117002,127897,9960,74072,41852,130253,66597,18301,71364,137961,82086,156158
ֲֵ´,CangBuJieDaoBanShiChu,420117003,52504,6481,32593,19310,63817,31474,8511,33475,64949,34903,67496
�ֵ´,WangJiJieDaoBanShiChu,420117004,50719,6968,32334,18494,63728,31641,8813,33004,64645,34166,66500
ֵ´,LiJiJieDaoBanShiChu,420117005,35363,5179,22745,14497,45362,22701,5941,23570,46271,23738,46483
ֵ´,SanDianJieDaoBanShiChu,420117006,52351,6441,32509,18355,65447,32486,9040,35262,67748,35323,67832
ֵ´,PanTangJieDaoBanShiChu,420117007,22613,2906,14041,7216,27927,12911,3540,13305,26216,15018,29059
ɽֵֽ´,JiuJieJieDaoBanShiChu,420117008,49290,5894,30844,17933,59299,29848,8666,31639,61487,33006,63850
˫ֵ´,ShuangLiuJieDaoBanShiChu,420117009,38640,4545,23902,15034,47251,23869,6179,25236,49105,25462,49364
,XinChongZhen,420117100,41470,5223,27044,14538,52508,26597,8387,27198,53795,28036,55080
,XuGuZhen,420117101,23112,3415,14863,9058,29375,14753,4540,15872,30625,16204,31067
,FengHuangZhen,420117102,17421,2497,11338,7119,22178,11290,3270,11699,22989,11850,23188
ۺӷ羰ι�,DaoGuanHeFengJingLvYouGuanLiChu,420117400,3740,388,2280,1227,4220,2109,655,2247,4356,2503,4783
Ƕɺũ,ZhangDuHuNongChang,420117401,5917,711,3801,2001,7223,3751,1036,3770,7521,3863,7664
ũ,LongWangJuNongChang,420117403,2535,410,1623,1055,3232,1619,421,1734,3353,1743,3366
߿,YangLuoKaiFaQu,420117405,12650,749,5982,2817,9976,4769,1325,4944,9713,8742,14724
ԭֳ,XinZhouYuanZhongChang,420117406,374,78,267,166,511,267,66,251,518,251,518
Ӫֵ´,ShenJiaYingJieDaoBanShiChu,420202001,38858,3482,25186,10484,28753,15603,4065,15616,31219,21219,46405
ʯ۽ֵ´,HuangShiGangJieDaoBanShiChu,420202002,43506,5057,27965,18710,39719,27348,7268,27100,54448,27866,55831
Žֵ´,HongQiQiaoJieDaoBanShiChu,420202003,31863,4122,20573,13563,30447,20018,4634,19490,39508,20046,40619
ʤ۽ֵ´,ShengYangGangJieDaoBanShiChu,420202004,36174,4763,23977,14713,33775,23055,5712,22152,45207,22672,46649
ֵ´,HuaHuJieDaoBanShiChu,420202070,25475,1738,14780,8990,18025,12880,4001,13390,26270,16434,31214
,JiangBeiGuanLiQu,420202400,2825,291,1757,1096,3168,1721,480,1798,3519,1839,3596
ٽֵ´,LinJiangJieDaoBanShiChu,420203001,21642,2995,13930,9684,20212,13732,3628,14072,27804,14335,28265
Ȫֵ´,BaQuanJieDaoBanShiChu,420203002,21444,2282,13646,9267,16944,13604,3966,13881,27485,14046,27692
¼ֵ´,ChenJiaWanJieDaoBanShiChu,420203003,42078,4237,26163,17370,36211,25390,6814,25868,51258,26966,53129
½ֵ´,ChengYueJieDaoBanShiChu,420203004,46158,5668,29111,19453,41753,27858,7558,28620,56478,30273,59384
˼ֵ´,HuangSiWanJieDaoBanShiChu,420203005,26771,4397,17033,12596,28839,16905,3428,17183,34088,17563,34596
ɽֵ´,XiSaiShanJieDaoBanShiChu,420203006,9747,1135,5879,3638,9824,5776,1859,6068,11844,6862,12741
ӿ,HeKouZhen,420203100,12900,1532,8505,4899,15288,8461,3247,8895,17356,9174,17679
ұũ,YeGangNongChang,420203400,167,40,91,133,41,91,15,131,222,131,222
½ֵ´,XinXiaLuJieDaoBanShiChu,420204001,44350,6622,27434,19051,47808,26527,6942,27436,53963,30480,57914
½ֵ´,LaoXiaLuJieDaoBanShiChu,420204002,29612,3539,18282,12073,27864,17195,5105,18075,35270,19974,38256
ɽֵ´,DongFangShanJieDaoBanShiChu,420204003,11370,979,7095,4388,8423,6917,2406,7384,14301,7660,14755
ųɽֵ´,TuanChengShanJieDaoBanShiChu,420204070,56049,3111,30735,15102,32104,23281,6529,23316,46597,34954,65689
ֱϽ,QuZhiXiaXuNiZhen,420205198,43243,7168,27922,19627,47485,27215,6916,27742,54957,29405,57327
˹,XingGuoZhen,420222100,105592,7588,65843,37200,99136,61987,24232,66256,128243,71569,137412
,FuChiZhen,420222101,24168,2273,15371,8227,28645,14275,6380,15596,29871,17450,32821
,HuangSangKouZhen,420222102,24122,2553,15997,8163,30400,15882,6223,16585,32467,16901,32898
ΤԴ,WeiYuanKouZhen,420222103,20301,2014,13378,6881,25578,13320,5115,13875,27195,14052,27430
̫,TaiZiZhen,420222104,25527,2924,17851,10558,34351,17665,8155,18239,35904,18755,36606
,DaiWangZhen,420222105,28165,3035,19354,9943,37931,19171,8300,19779,38950,20146,39500
ո,TaoGangZhen,420222106,20460,1946,13514,6657,26902,13286,5646,14125,27411,14538,28052
ɳ,BaiShaZhen,420222107,61016,6115,40833,21831,76896,40193,17751,42673,82866,44049,84882
,FuTuZhen,420222108,52378,4859,35425,18375,67199,34771,15976,36337,71108,37788,73213
Ϫ,SanXiZhen,420222109,26773,2734,18123,9909,35539,18053,8280,19499,37552,19664,37787
,LongGangZhen,420222110,52430,5843,39006,20738,77422,37706,21470,38382,76088,40737,79743
,YangGangZhen,420222111,20871,2249,15363,8197,29066,15307,8044,15624,30931,15801,31164
,PaiShiZhen,420222112,22723,2496,16320,8442,32070,16072,8561,16885,32957,17460,33780
ľ,MuGangZhen,420222113,30589,2831,20631,10666,39800,20465,9028,21465,41930,21817,42448
,FengLinZhen,420222114,26357,2713,17875,8878,35768,17751,7808,18707,36458,19003,36878
Ӣ,WangYingZhen,420222115,22909,3220,16915,9845,32368,16755,8976,17916,34671,18190,35105
ۺũ,ZongHeNongChang,420222450,8025,842,5085,2700,7010,4439,1506,4653,9092,5288,10373
ũ,LvZhouNongChang,420222451,6972,1092,5038,3186,9212,5017,2065,5046,10063,5091,10129
ɽũ,BanBiShanNongChang,420222452,2632,357,1820,1053,3368,1715,680,1723,3438,1849,3669
ͷɽũ,JingTouShanNongChang,420222453,3126,428,2041,1121,4079,2028,608,2092,4120,2121,4162
ԭֳ,YangXinYuanZhongChang,420222454,676,124,524,322,792,524,222,494,1018,498,1022
𺣿,JinHaiKaiFaQu,420222455,6322,591,4053,2338,7883,4036,1644,4449,8485,4504,8557
·ֵ´,DongYueLuJieDaoBanShiChu,420281001,78503,5698,48299,30321,61570,46446,17658,50573,97019,53560,101859
ֵ´,JinHuJieDaoBanShiChu,420281003,63193,6058,38450,22354,67361,36941,13800,41650,78591,44601,83051
޼Žֵ´,LuoJiaQiaoJieDaoBanShiChu,420281004,43522,3752,26729,15129,46482,24760,10182,27735,52495,30727,57456
ɽֵ´,JinShanJieDaoBanShiChu,420281070,25182,2642,16165,9490,30114,15888,6006,17310,33198,17665,33830
ţ,JinNiuZhen,420281100,44332,5631,29821,18373,56682,29412,11770,31388,60800,31912,61733
,BaoAnZhen,420281101,46742,5224,29966,16210,56269,29707,10156,31316,61023,32156,62122
,LingXiangZhen,420281102,37014,3741,23244,14011,44068,22884,9060,25475,48359,26571,49815
ɽ,JinShanDianZhen,420281103,31458,4299,19767,13850,38402,19611,7209,21964,41575,23199,42966
,HaiDiQiaoZhen,420281104,67824,7359,41376,24394,81141,40578,12959,45522,86100,46766,88142
,YinZuZhen,420281105,25338,2862,17233,10134,33958,17105,7426,18126,35231,18393,35626
ʰ,LiuRenBaZhen,420281107,25727,2564,16669,9247,32547,16589,7155,18540,35129,18777,35446
¹,ChenGuiZhen,420281108,40724,4697,26193,15630,50181,25496,10497,28230,53726,29725,55918
,DaJiPuZhen,420281109,41322,4160,26665,13606,50486,26275,10887,28731,55006,29704,56369
,WangRenZhen,420281170,28977,3346,18617,10468,35269,18447,6455,19797,38244,20161,38778
ɽ,MingShanXiang,420281200,25191,2950,17055,9446,32747,17010,7262,18260,35270,18348,35403
ұÿ,DaYeJingJiKaiFaQu,420281400,53234,2370,31710,19404,28261,29981,12087,32975,62956,35981,67691
ũ,DongFengNongChangGuanLiQu,420281401,2091,160,1299,847,2278,1295,467,1403,2698,1419,2718
Ĺբ�,SiGuZhaGuanLiChu,420281402,612,55,376,255,547,376,134,409,785,425,801
䵱·ֵ´,WuDangLuJieDaoBanShiChu,420302001,37158,2393,22991,16120,24995,21597,7925,22344,43941,24485,47476
ֵ߽´,ErYanJieDaoBanShiChu,420302002,100635,5465,61184,35564,65989,47590,16798,50041,97631,61714,122898
ֵ߽´,WuYanJieDaoBanShiChu,420302003,109763,6980,67419,44523,91807,61706,20166,62542,124248,69490,136909
˿˽ֵ´,BaiLangKaiFaQuBaiLangJieDaoBanShiChu,420302004,39394,3261,24111,16921,29503,23523,7906,24823,48346,26450,50561
,DaChuanZhen,420302100,2240,335,1385,931,2668,1376,345,1504,2880,1535,2920
é,MaoTaXiang,420302200,2893,493,1815,1138,3565,1806,488,1995,3801,2059,3874
ԧ,YuanYangXiang,420302400,26776,1908,15203,10456,19573,14397,4726,15446,29843,18207,33410
С,XiaoChuanXiang,420302401,1015,232,673,459,1299,666,154,697,1363,728,1401
ֵ´,HuaGuoJieDaoBanShiChu,420303001,38348,4244,23113,16548,36599,22057,6435,22961,45018,25914,49027
ֵ´,HongWeiJieDaoBanShiChu,420303002,68813,4835,37195,25954,39083,33737,11980,35482,69219,48433,85628
·ֵ´,CheChengLuJieDaoBanShiChu,420303003,94916,8690,59527,43930,73931,55289,18301,57158,112447,62380,121907
·ֵ´,HanJiangLuJieDaoBanShiChu,420303004,60985,4712,37133,24650,44113,34559,11862,35614,70173,40426,77559
,HuangLongZhen,420303100,10814,1748,6510,4571,11088,6394,1729,6697,13091,7781,14291
,BoLinZhen,420303101,6622,700,4318,2758,5535,4030,1367,4129,8159,4371,8689
̲,FangTanXiang,420303200,2358,642,1646,1251,3213,1613,442,1706,3319,1796,3442
,XiGouXiang,420303201,2491,496,1611,1196,3059,1608,358,1730,3338,1734,3345
ǿ,XiChengKaiFaQu,420303400,3156,304,1950,1317,2194,1943,630,2004,3947,2140,4090
ؼƺֳ,QinJiaPingLinChang,420303500,174,44,100,111,209,99,11,127,226,129,229
ɽ賡,FengHuangShanChaChang,420303501,204,43,120,74,261,120,17,144,264,144,264
ǹ,ChengGuanZhen,420321100,106949,7696,65208,30370,98013,48999,18369,50182,99181,67806,133014
,AnYangZhen,420321101,17822,2907,11068,6089,21925,10235,2510,10831,21066,12171,23239
Ϫ,YangXiPuZhen,420321102,12312,1618,7768,4744,15813,7713,2109,8178,15891,8271,16039
,QingQuZhen,420321103,18668,2444,11299,6517,23840,11099,3003,12286,23385,12816,24115
ɣ,BaiSangGuanZhen,420321104,17828,2815,12045,7000,23850,11926,4289,12493,24419,12887,24932
ϻ,NanHuaTangZhen,420321105,33130,4344,22378,13293,45414,22223,8841,23649,45872,23937,46315
,BaiLangZhen,420321106,7073,895,4968,2660,9839,4886,2129,4972,9858,5129,10097
,LiuDongZhen,420321107,10133,1599,7202,3754,14394,7081,3086,7389,14470,7616,14818
̷ɽ,TanShanZhen,420321108,20235,2531,14425,7667,28716,14299,7157,15267,29566,15498,29923
÷,MeiPuZhen,420321109,19577,2340,12913,6770,26577,12865,5209,14089,26954,14213,27126
ɽ,QingShanZhen,420321110,9133,1250,5612,3446,11626,5462,1370,5976,11438,6141,11753
,ChaDianZhen,420321111,21831,1749,12333,6475,22760,11372,3442,11776,23148,14689,27022
,LiuBeiZhen,420321112,45415,4072,25840,12557,51671,23480,7242,24699,48179,30889,56729
Ͽ,BaoXiaZhen,420321113,20715,2593,12613,7516,25017,12478,4284,14054,26532,14979,27592
Ӫ,HuJiaYingZhen,420321114,12760,2009,8693,5361,16957,8580,3512,9294,17874,9588,18281
̷,TanJiaWanZhen,420321115,18038,1685,11151,5949,17330,9441,3287,9836,19277,11859,23010
,DaLiuXiang,420321200,8722,1322,5410,3344,11493,5325,1718,6126,11451,6352,11762
,WuFengXiang,420321201,16024,2677,10521,6734,21715,10349,3632,11412,21761,11812,22333
Ҷ,YeDaXiang,420321202,6593,1243,4548,3335,9119,4506,1733,4900,9406,5021,9569
ұֳ,HongYanBeiLinChang,420321400,469,139,316,252,648,316,78,347,663,370,686
ǹ,ChengGuanZhen,420322100,72932,6135,46582,28241,70081,43915,14738,44023,87938,47223,93805
,TuMenZhen,420322101,18771,2152,11311,6637,23806,11310,3227,12838,24148,12839,24150
Ͻ,ShangJinZhen,420322102,22788,2083,13853,7137,27111,13076,3942,13993,27069,14960,28813
,DianZiZhen,420322103,18787,2267,11142,6081,23869,11094,3273,13081,24175,13185,24327
к,JiaHeZhen,420322104,21804,2744,14197,7843,29142,14164,5698,15841,30005,16049,30246
β,YangWeiZhen,420322105,14215,1791,9122,5361,18654,9083,3112,9907,18990,9996,19118
,GuanYinZhen,420322106,24502,3310,15403,8883,29521,14346,4323,15329,29675,16732,32135
�,MaAnZhen,420322107,17612,2584,11110,6553,23600,11093,3580,12514,23607,12666,23776
Ӽ,HeJiaZhen,420322108,19213,2943,11709,7537,24937,11471,3105,13065,24536,13552,25261
,XiangKouXiang,420322200,17018,2241,10579,6715,21946,10474,3273,11650,22124,11953,22532
ط,GuanFangXiang,420322201,12590,1461,7790,4404,16327,7633,2831,8797,16430,9092,16882
ڻ,HuBeiKouHuiZuXiang,420322202,15925,1955,9886,5691,21023,9874,3545,11490,21364,11539,21425
,JingYangXiang,420322203,21139,2530,13184,7175,27632,13143,4754,15036,28179,15239,28423
,LiuLangXiang,420322204,18900,2194,11899,6765,25492,11838,4496,13486,25324,13691,25590
,JianChiXiang,420322205,10711,1745,7059,4690,14376,7053,2053,7436,14489,7450,14509
,AnJiaXiang,420322206,7662,1016,4493,2890,9511,4406,1034,5007,9413,5219,9712
,HuaiShuLinXiang,420322207,3001,538,1981,1383,4103,1968,711,2208,4176,2269,4250
ٶ,SanGuanDongXiang,420322208,1864,378,1132,968,2407,1125,286,1355,2480,1396,2528
ǹ,ChengGuanZhen,420323100,50062,3870,31141,18970,45654,29544,10319,30760,60304,33110,64251
ˮ,YiShuiZhen,420323101,24004,2804,14486,8862,30419,14423,4490,16635,31058,16812,31298
Ҷ,MaJiaDuZhen,420323102,21506,2718,13297,7980,27489,13226,4431,15071,28297,15358,28655
,BaoFengZhen,420323103,40119,5156,26422,17270,51789,26119,10126,28193,54312,28979,55401
޹,LeiGuZhen,420323104,17941,2762,11730,8034,24241,11622,4331,12941,24563,13304,25034
ع,QinGuZhen,420323105,17518,2298,10771,6832,22512,10662,3684,12408,23070,12729,23500
ʤ,DeShengZhen,420323106,18240,2602,11080,7159,24332,10858,3881,13125,23983,13643,24723
ӹ,ShangYongZhen,420323107,11239,1400,6863,3883,14371,6416,2245,7284,13700,8021,14884
ٶ,GuanDuZhen,420323108,11219,1605,7078,4125,14809,6845,2376,7705,14550,8122,15200
˿,PanKouXiang,420323200,13707,1497,8066,4471,15758,7873,2585,8890,16763,9723,17789
ƺ,ZhuPingXiang,420323201,17807,3203,10898,6335,24477,10415,3720,12887,23302,13832,24730
,DaMiaoXiang,420323202,8696,1256,5372,3536,11919,5303,2076,6445,11748,6656,12028
˫̨,ShuangTaiXiang,420323203,11899,1811,7174,4803,15058,7108,2398,8593,15701,8934,16108
¥̨,LouTaiXiang,420323204,18292,2414,10937,5875,23589,10316,3543,12519,22835,13312,24249
ķ,WenFengXiang,420323205,10634,1578,6253,3615,13488,6105,1809,7307,13412,7768,14021
,ShenHeXiang,420323206,8286,1140,4859,3050,10643,4800,1561,5959,10759,6128,10987
,LiuLinXiang,420323207,9681,1592,6285,3950,13029,6209,2118,6877,13086,7106,13391
Żֳ,JiuHuaLinChang,420323208,602,111,397,246,808,395,117,429,824,433,830
ǹ,ChengGuanZhen,420324100,49511,4259,32522,20064,58052,32224,11789,32500,64724,33037,65559
,JiangJiaYanZhen,420324101,23952,2613,15419,8652,32186,15206,6314,17280,32486,17460,32879
з,ZhongFengZhen,420324102,23667,2468,14851,8476,30621,14721,5171,16207,30928,16455,31306
ˮƺ,ShuiPingZhen,420324103,36073,3974,21527,12031,41991,19751,6512,22405,42156,25032,46559
غ,XianHeZhen,420324104,13394,1726,7903,4630,17178,7574,2504,8976,16550,9721,17624
ȪϪ,QuanXiZhen,420324105,8006,1184,4687,2807,10320,4506,1312,5506,10012,5815,10502
Ϫ,FengXiZhen,420324106,8444,1201,5052,3075,10866,4966,1546,5894,10860,6139,11191
,LongBaXiang,420324200,12053,1534,7367,4292,15930,7233,2498,8489,15722,8718,16085
,XinZhouXiang,420324201,14773,1845,8583,5219,18859,8218,2566,10020,18238,10601,19184
Ӫ,BingYingXiang,420324202,7416,1252,4292,3210,9518,3888,964,4642,8530,5340,9632
ƺ,EPingXiang,420324203,5340,851,3089,1877,6812,3010,832,3704,6714,3934,7023
,HuiWanXiang,420324204,10123,1461,6093,4156,13415,6033,1957,7344,13377,7448,13541
챦,TianBaoXiang,420324205,10921,1619,6525,3770,14304,6348,2007,7550,13898,8022,14547
Դ,TaoYuanXiang,420324206,4536,858,2851,1922,6070,2777,865,3272,6049,3408,6259
,XiangBaXiang,420324207,5437,562,3315,1845,6812,3295,1077,3691,6986,3761,7076
賡,LongWangYaChaChang,420324500,126,20,74,73,91,74,17,89,163,89,163
ӪϪۺũ,GuoYingZhuXiZongHeNongChang,420324501,389,90,254,160,527,253,75,300,553,300,554
ԭֳ,YuanZhongChang,420324502,263,47,208,147,297,205,83,179,384,185,393
ֳ,YuZhongChang,420324503,14,6,13,10,19,13,3,10,23,10,23
,ZhongChuChang,420324504,52,6,36,28,35,36,13,35,71,35,71
ֳ,BiaoHuLinChang,420324506,145,35,88,94,197,88,27,117,205,119,207
˫ֳ,ShuangZhuLinChang,420324507,534,168,360,301,723,347,92,384,731,434,794
ɽֳ,BaGuaShanLinChang,420324508,169,41,113,85,231,113,33,129,242,130,243
Դïֳ,YuanMaoLinChang,420324509,763,163,524,356,1054,518,190,579,1097,592,1116
ֳ,DaiWangGouLinChang,420324510,71,43,37,86,106,37,2,79,116,79,116
ֳ,WangFuZuoLinChang,420324511,126,21,66,43,163,66,16,97,163,97,163
ֳ,TianChiYaLinChang,420324512,99,35,56,60,117,52,9,71,123,87,143
ֳ,JiuLiGangLinChang,420324513,40,10,21,25,42,21,9,38,59,38,59
ϪʮﳤϿ,ZhuXiXianShiBaLiChangXiaGuanLiJu,420324514,1660,263,1051,723,2165,1044,324,1174,2218,1196,2247
ǹ,ChengGuanZhen,420325100,66113,10382,45138,27043,62431,40594,13403,39665,80259,44760,89898
,JunDianZhen,420325101,24575,3487,15653,8291,27677,13860,4284,14496,28356,16693,32346
,HuaLongYanZhen,420325102,14547,2563,9907,5684,18639,9428,3053,9385,18813,10256,20163
,TuChengZhen,420325103,12063,2304,7479,4932,15080,7161,2037,8183,15344,8925,16404
ľ,DaMuChangZhen,420325104,19500,2961,12624,7466,25316,12299,4367,13603,25902,14204,26828
,QingFengZhen,420325105,20581,2976,12737,8812,25913,12587,3674,13834,26421,14494,27231
Ź,MenGuSiZhen,420325106,20361,2696,12024,6533,25753,11868,3431,14080,25948,14464,26488
Ұ˹,YeRenGuZhen,420325108,6851,1643,4351,2992,9195,4286,1144,5016,9302,5287,9638
,HongTaXiang,420325200,23370,3509,15438,9763,29618,14971,4488,15083,30054,15929,31367
׺,BaiHeZhen,420325201,22307,2593,13298,7840,27366,13140,3535,14710,27850,15137,28435
Ҥ,YaoHuaiXiang,420325202,7592,1541,5197,3758,10062,5122,1630,5162,10284,5566,10763
Ҧƺ,YaoPingXiang,420325203,9349,1298,5905,3702,12470,5865,2361,6911,12776,7103,13008
ƿ,LangKouXiang,420325204,5264,962,3460,2381,6785,3349,1035,3399,6748,3801,7261
ɳ,ShaHeXiang,420325205,5311,954,3145,2280,7047,3105,932,3913,7018,4052,7197
,WanYuHeXiang,420325206,5148,790,3169,2154,6845,3116,979,3570,6686,3748,6917
,ShangKanXiang,420325208,6661,1250,3848,1938,8519,3241,801,4023,7264,4864,8712
а,ZhongBaXiang,420325209,5079,977,3318,2349,6820,3264,1074,3648,6912,3812,7130
ŵ,JiuDaoXiang,420325210,6426,1164,4094,2609,8517,4055,1085,4488,8543,4581,8675
,HuiLongXiang,420325211,2185,493,1379,992,2950,1331,344,1513,2844,1643,3022
Ӫ̨ɽҵܳ,GuoYingWuTaiShanLinYeZongChang,420325500,2421,464,1475,1070,3042,1442,383,1569,3011,1793,3268
Ӫɽֳ,GuoYingYangChaShanLinChang,420325501,1023,278,665,521,1430,663,173,797,1460,809,1474
Ӫſɽֳ,GuoYingJiuKouShanLinChang,420325502,667,181,435,373,901,435,96,496,931,509,944
Ӫëɽֳ,GuoYingMaoJiaShanLinChang,420325503,86,26,59,53,124,59,13,66,125,66,125
Ӫֳ,GuoYingDaiDongHeLinChang,420325504,220,69,134,116,308,133,30,178,311,185,319
᳡,FangXianXiHaoQiChang,420325505,114,21,68,52,146,68,16,76,144,83,151
԰ճ,FangXianYuanYiChang,420325506,1444,259,973,657,1863,973,260,990,1963,990,1963
̷ˮ,TanJiaWanShuiKuGuanYangSuo,420325507,294,72,210,137,409,194,71,206,400,227,437
Ȫ羰,WenQuanFengJingQu,420325508,218,50,146,106,303,146,48,170,316,170,316
غֳ,FangXianHanLiangLiangZhongChang,420325509,359,79,275,191,478,275,73,236,511,236,511
·ֵ´,JunZhouLuJieDaoBanShiChu,420381001,42253,3852,27653,19657,34497,27486,9143,27250,54736,27595,55248
·ֵ´,DaBaLuJieDaoBanShiChu,420381002,36349,4470,24056,18098,31064,23905,7406,23792,47697,24169,48225
·ֵ´,DanZhaoLuJieDaoBanShiChu,420381003,31079,2102,19763,12443,17110,16849,5910,17013,33862,19328,39091
ٵֵ´,SanGuanDianJieDaoBanShiChu,420381005,16719,1698,10284,6846,17347,9823,2929,10068,19891,11062,21346
,TuGuanYaZhen,420381100,7794,1070,4929,3078,9744,4881,1544,5293,10174,5479,10408
˺,LangHeZhen,420381101,10441,1413,6860,5024,12449,6803,2293,7062,13865,7287,14147
Ӫ,DingJiaYingZhen,420381102,10333,1110,6679,3977,12101,6449,2087,6527,12976,6851,13530
ƺ,LiuLiPingZhen,420381103,36004,3610,22706,14265,41163,22586,7534,23912,46498,24442,47148
γغ,YanChiHeZhen,420381104,4665,939,3093,2538,6179,3081,948,3430,6511,3459,6552
,JunXianZhen,420381105,15589,1671,9445,5244,19748,9315,2656,10256,19571,10471,19916
ϰҵ,XiJiaDianZhen,420381106,22953,2514,14057,7682,28046,12739,4429,13497,26236,15839,29896
ƺ,HaoPingZhen,420381107,6857,882,4439,2622,8793,4112,1328,4204,8316,4628,9067
ʯ,ShiGuZhen,420381108,6789,921,4336,2958,8541,4288,1339,4570,8858,4713,9049
ˮ,LiangShuiHeZhen,420381109,15084,2153,9234,5598,19018,9162,2310,10117,19279,10313,19547
ɽ,GuanShanZhen,420381110,8318,1109,4388,2933,8630,4206,1266,4687,8893,6305,10693
̨,TuTaiXiang,420381201,6929,976,4479,3131,8763,4422,1271,4525,8947,4697,9176
¸۾ÿ�,XinGangJingJiKaiFaGuanLiChu,420381400,9983,461,6289,4146,5836,6212,2432,6350,12562,6587,12876
ţҵ,NiuHeLinYeKaiFaGuanLiQu,420381401,4334,651,2736,1773,5443,2736,639,2888,5624,2888,5624
ƺҵ,BaiYangPingLinYeKaiFaGuanLiQu,420381402,1417,289,836,646,1853,829,203,1033,1862,1073,1909
ҵ,DaGouLinYeKaiFaGuanLiQu,420381403,3911,423,2366,1335,4713,2351,802,2656,5007,2770,5136
䵱ɽ,WuDangShanTeQu,420381450,42931,3209,26943,17066,42134,25520,9031,25967,51487,28228,55171
ֵ,XiLingJieDao,420502001,88545,7275,49473,25088,64945,34321,8953,33749,68070,55300,104773
ѧԺֵ,XueYuanJieDao,420502002,56348,7385,36134,25323,52001,34321,7407,33226,67547,35006,71140
Ƽֵ,YunJiJieDao,420502003,58282,6643,33818,19839,45589,26747,6670,26030,52777,37777,71595
ӽֵ,XiBaJieDao,420502004,31698,5531,20745,15352,33650,20315,5253,19778,40093,21737,42482
ްӽֵ,GeZhouBaJieDao,420502005,29541,5472,20496,14859,30822,19931,5098,18252,38183,19615,40111
ҹֵ,YeMingZhuJieDao,420502006,47445,7849,33030,23565,47911,31715,8943,29516,61231,31207,64237
˲ί,YiChangKaiFaQuGuanWeiHui,420502071,68998,4960,41906,28655,45514,39252,11403,39135,78387,43455,85361
Ҥ,YaoWanXiang,420502201,23530,1758,13985,8758,13417,12862,3604,12848,25710,14907,28892
Ͽڷ羰,XiaKouFengJingQu,420502401,2796,294,1744,989,2644,1607,393,1503,3110,1739,3483
Žֵ´,DaGongQiaoJieDaoBanShiChu,420503001,29096,3999,18964,13114,26995,18059,4378,17471,35530,18509,37473
Žֵ´,WanShouQiaoJieDaoBanShiChu,420503002,34420,4084,21615,15575,24791,20096,4369,19710,39806,21258,42873
ӽֵ´,BaoTaHeJieDaoBanShiChu,420503003,32655,3275,20249,14743,25411,19975,5184,19859,39834,20865,41114
Ҹڽֵ´,WuJiaGangJieDaoBanShiChu,420503004,36612,2740,22654,15993,30643,21149,5601,21063,42212,22299,44953
,WuJiaXiang,420503201,39050,3055,22432,14583,22444,21261,5676,22390,43651,25349,47781
ֵ´,DianJunJieDaoBanShiChu,420504001,27705,3084,16817,9875,25867,15576,3322,15176,30752,17294,34111
,AiJiaZhen,420504101,6615,828,4112,2537,7168,3885,905,3912,7797,4236,8348
ű,QiaoBianZhen,420504102,20473,2905,12993,8071,24570,12859,2954,13051,25910,13339,26332
,LianPengXiang,420504201,10920,1527,6837,4002,12550,6582,1502,6730,13312,7112,13949
,TuChengXiang,420504202,15713,3054,10018,7375,19920,9763,2189,10564,20327,10938,20956
ϱֵ´,GuLaoBeiJieDaoBanShiChu,420505001,26424,2569,14606,8421,19714,12525,3280,12429,24954,17667,32273
ֵ´,HuYaJieDaoBanShiChu,420505002,10534,1397,6621,3872,10479,6244,1459,6209,12453,6769,13390
Ƴؽֵ´,YunChiJieDaoBanShiChu,420505003,12575,1552,7101,4154,11398,6519,1440,6486,13005,8466,15567
СϪֵ,XiaoXiTaJieDaoBan,420506001,105870,10532,67187,42725,92193,60569,17302,59241,119810,66517,133704
꾭ÿ,YiLingJingJiKaiFaQu,420506002,24138,1931,14586,8164,18109,12756,3542,12538,25294,15025,29611
ƺ,ZhangCunPingZhen,420506101,18443,2463,10216,7474,20567,9675,2436,10711,20386,13126,23342
ɺ,WuDuHeZhen,420506102,26323,3653,14863,10701,30865,14512,3098,16173,30685,18211,33074
,FenXiangZhen,420506103,28130,4003,17332,11312,34779,16943,3628,17820,34763,18429,35761
̫ƽϪ,TaiPingXiZhen,420506104,18468,2596,11556,8201,22754,11505,2915,12182,23687,12423,23979
ƺ,SanDouPingZhen,420506105,22789,3627,14180,9733,27398,13781,3078,14645,28426,15314,29494
Ϫ,LeTianXiZhen,420506106,19060,2668,12129,8612,21963,12000,3251,12434,24434,12850,24979
Ȫ,LongQuanZhen,420506107,39809,5126,24627,14872,45378,23821,5330,24200,48021,25638,50265
ѻȵ,YaQueLingZhen,420506108,44376,6409,27645,18182,51519,27346,5304,27904,55250,28444,56089
±ƺ,XiaBaoPingXiang,420506201,15767,2778,9642,7298,19895,9523,2069,10751,20274,10972,20614
˴,DengCunXiang,420506202,18846,2948,11501,8633,23855,11490,2726,12888,24378,13019,24520
ƻ,HuangHuaXiang,420506203,25938,4025,15620,10230,30134,15018,3291,15698,30716,17634,33254
Ͽ,SanXiaBaQu,420506401,1431,24,456,820,0,362,45,688,1050,1044,1500
,MingFengZhen,420525101,44552,4084,27611,18659,42119,24488,7202,24316,48804,28227,55838
,HuaLinSiZhen,420525102,11181,1859,6928,5093,13161,6515,1362,6901,13416,7474,14402
,JiuXianZhen,420525103,16118,2332,10187,6995,19489,10016,2415,10390,20406,10678,20865
ƺ,YangPingZhen,420525104,22391,3452,14534,10168,28233,14166,3879,14301,28467,15188,29722
éƺ,MaoPingChangZhen,420525105,19913,2509,10877,7280,21292,10348,2375,11049,21397,13920,24797
ɻ,HeHuaZhen,420525106,19931,2815,11351,8351,22750,11085,2504,12401,23486,13899,25250
ӿ,HeKouXiang,420525201,10680,1494,6288,4230,12812,6179,1484,6924,13103,7370,13658
ŷ,GuFuZhen,420526101,33055,3821,20849,14204,34669,19682,5549,19977,39659,21576,42425
Ѿ,ZhaoJunZhen,420526102,17881,2335,10715,9869,18954,10616,2593,11774,22390,12094,22809
Ͽ,XiaKouZhen,420526103,19501,2732,11776,7727,23351,11489,2349,12026,23515,12806,24582
,NanYangZhen,420526104,8772,1522,5335,3518,10910,5154,901,5684,10838,5860,11195
,HuangLiangZhen,420526105,17231,2652,10386,6614,21012,9957,1981,10737,20694,11478,21864
ˮ,ShuiYueSiZhen,420526106,17253,2590,10254,6600,20432,9709,2344,10588,20297,11933,22187
,GaoQiaoXiang,420526201,11436,1735,6826,4280,14112,6733,1397,7562,14295,7742,14568
,ZhenZiXiang,420526202,8664,1197,5097,3396,10368,5046,1139,5688,10734,5903,11000
éƺ,MaoPingZhen,420527101,79830,8982,51424,29989,78985,43628,12808,42525,86153,50196,101620
,GuiZhouZhen,420527102,20048,2824,12781,8624,23399,12412,3283,12953,25365,13374,26155
ԭ,QuYuanZhen,420527103,12743,2310,8054,6594,16306,8051,1786,8762,16813,8785,16839
ɳϪ,ShaZhenXiZhen,420527104,24316,3524,15015,9627,30055,14801,3156,15486,30287,15981,30996
ӿ,LiangHeKouZhen,420527105,18130,3278,11277,8254,22881,11235,2241,12212,23447,12372,23649
Ұ,GuoJiaBaZhen,420527106,36005,5091,22248,15162,44329,22002,5612,23748,45750,24460,46708
,YangLinQiaoZhen,420527107,20378,3542,12118,8917,25417,12105,2162,13886,25991,13964,26082
Ϫ,JiuWanXiZhen,420527108,17516,2969,10616,7337,22057,10450,2172,11729,22179,12041,22657
ˮ,ShuiTianBaXiang,420527201,24170,3660,14964,10266,30167,14769,3350,15511,30280,16216,31180
й̲,XieTanXiang,420527202,9747,1428,5885,4361,12319,5852,1411,6639,12491,6701,12586
÷Һ,MeiJiaHeXiang,420527203,13490,1972,8215,5664,16843,8196,1805,8975,17171,9052,17267
ĥƺ,MoPingXiang,420527204,8845,1476,5169,3714,11020,5160,1047,6155,11315,6199,11368
ƺ,LongZhouPingZhen,420528101,68240,9195,44733,28566,73168,39354,12244,38411,77765,44946,89679
߼,GaoJiaYanZhen,420528102,15545,2531,9683,6095,19484,9292,2514,10255,19547,10907,20590
ĥ,MoShiZhen,420528103,22759,3916,14080,8685,28892,13196,3157,14040,27236,15752,29832
,DouZhenWanZhen,420528104,38325,6454,23666,14364,48737,23223,4976,25288,48511,26089,49755
,ZiQiuZhen,420528105,29427,4319,17631,11978,35944,17160,3905,19499,36659,20020,37651
Ͽ,YuXiaKouZhen,420528106,25278,4351,16173,10465,32650,15624,3895,16569,32193,17351,33524
ƺ,LangPingZhen,420528107,29859,4613,18556,11560,38191,17911,4876,19928,37839,20792,39348
ؼƺ,HeJiaPingZhen,420528108,20999,3240,12750,8272,25904,12669,2931,14139,26808,14420,27170
,DaYanXiang,420528201,25218,4374,15431,10278,31830,15398,3247,17300,32698,17408,32839
Ѽӿ,YaZiKouXiang,420528202,15323,2986,9279,6387,19635,9268,1778,10801,20069,10808,20087
ƺ,HuoShaoPingXiang,420528203,5853,807,3691,2656,7009,3690,1093,4056,7746,4062,7753
,WuFengZhen,420529101,29236,3983,18095,12800,34249,17693,4527,18991,36684,19651,37746
ƺ,ChangLePingZhen,420529102,17262,2937,10764,7179,21932,10718,2301,11664,22382,11736,22500
,YuYangGuanZhen,420529103,35563,5511,22272,14713,43042,21756,5071,23029,44785,23873,46145
ʺƺ,RenHePingZhen,420529104,13520,3159,9010,6555,18332,8982,2200,9815,18797,9869,18879
̶,WanTanZhen,420529105,12671,1962,8032,4997,16255,7998,2110,8599,16597,8711,16743
,FuJiaYanXiang,420529201,11797,2154,7373,5359,15289,7281,1616,8060,15341,8194,15567
ţׯ,NiuZhuangXiang,420529202,5693,951,3537,2450,7344,3494,852,3895,7389,3959,7496
ɻ,CaiHuaXiang,420529203,17919,3072,11411,7939,23320,11392,2856,12301,23693,12436,23847
½ǽֵ´,LuChengJieDaoBanShiChu,420581001,71034,9407,46096,31506,75467,43688,10408,41962,85650,44753,90849
컨,HongHuaTaoZhen,420581100,21110,3499,14149,7799,23543,12128,2444,11856,23984,12904,27053
߰,GaoBaZhouZhen,420581101,19484,3678,12916,8110,24009,12857,2698,12680,25537,12944,25860
Һ,NieJiaHeZhen,420581102,12914,2631,7936,5332,15756,7853,1302,8602,16455,8911,16847
ľƺ,SongMuPingZhen,420581103,22546,3421,13989,9041,27809,13973,2586,14476,28449,14564,28553
֦,ZhiChengZhen,420581104,69883,10448,43355,28265,84765,42033,8604,42614,84647,45580,88935
Ҧҵ,YaoJiaDianZhen,420581105,18741,3289,12106,7476,21068,11864,2262,11887,23751,12186,24292
Ȫ,WuYanQuanZhen,420581106,16630,3391,10812,6838,21079,10777,1877,10971,21748,11086,21898
˼,PanJiaWanTuJiaZuXiang,420581200,11603,2268,7011,4815,14729,6957,1186,7932,14889,8046,15057
,WangJiaFanXiang,420581201,22528,4517,14238,9034,29109,14151,2702,15267,29418,15509,29747
˿ίԱ,SongYiKuangQuGuanLiWeiYuanHui,420581400,12235,1452,6692,5272,15135,6424,1820,7048,13472,8815,15507
ֵ´,YuYangJieDaoBanShiChu,420582001,82745,9155,52539,35501,73621,49704,12668,47933,97637,52029,104568
ֵ´,BaLingJieDaoBanShiChu,420582002,42946,5447,27087,16693,41417,25870,5991,26037,51907,27297,54384
Ȫֵ´,YuQuanJieDaoBanShiChu,420582003,36146,4282,22361,14027,36102,22033,4962,22427,44460,23029,45390
,LiangHeZhen,420582101,25652,3777,16063,10061,30412,15759,2983,15917,31676,16349,32412
,HeRongZhen,420582102,40679,5559,25241,15846,47124,24498,5101,25360,49858,26098,51339
Ϫ,YuXiZhen,420582103,39604,5232,24716,15460,45247,23028,5369,23125,46153,25489,50205
ǰ,MiaoQianZhen,420582104,29897,3342,18005,10921,34521,17710,3678,18424,36134,18912,36917
,WangDianZhen,420582105,30963,4714,19344,12731,34156,19167,3804,19845,39012,20137,39481
,BanYueZhen,420582106,26096,3319,16066,10333,28801,15740,3334,16269,32009,16683,32749
ݲ,CaoBuHuZhen,420582107,16130,2752,10416,7261,19929,10214,1966,10160,20374,10432,20848
ҵֵ,MaJiaDianJieDao,420583001,107066,10178,67414,39809,106765,54471,15502,53099,107570,65332,132746
,AnFuSiZhen,420583101,40931,6893,25956,15965,47836,23495,4960,23430,46925,26828,52784
,BaiYangZhen,420583102,28962,5110,18533,11054,34044,17374,3372,17296,34670,18911,37444
˼ҵ,GuJiaDianZhen,420583103,19766,3961,13150,8154,24926,12817,2576,12765,25582,13153,26303
,DongShiZhen,420583104,43151,6049,26830,17060,46978,23652,5530,23876,47528,27900,54730
Ů,XianNvZhen,420583105,25242,3952,15812,9933,28521,14971,2980,15304,30275,16362,32174
ʰ,WenAnZhen,420583106,32508,5089,20210,13657,37843,19901,3616,20615,40516,21003,41213
̨,QiXingTaiZhen,420583107,34264,5118,21580,13862,40910,21266,4096,21345,42611,21898,43478
,BaiLiZhouZhen,420583108,58539,10066,37837,23701,71998,35292,6518,34345,69637,37286,75123
�ֵ´,WangFuJieDaoBanShiChu,420602001,58410,4916,38137,20469,37563,27623,7934,26147,53770,33123,71260
ֵ´,ZhaoMingJieDaoBanShiChu,420602002,48155,4658,29643,18638,39264,26424,7607,25695,52119,30777,60420
ӹֵ´,PangGongJieDaoBanShiChu,420602003,52059,6950,34171,22120,36316,31223,9182,30142,61365,34020,68191
̴Ϫֵ´,TanXiJieDaoBanShiChu,420602004,44530,5430,27820,17305,42041,23062,7802,23131,46193,29942,57762
¡нֵ´,LongZhongJieDaoBanShiChu,420602005,40408,1644,23064,5526,16804,7892,2335,7613,15505,21323,44387
Һֵ´,YuJiaHuJieDaoBanShiChu,420602006,16145,2333,10873,6916,20348,10840,3371,10882,21722,10976,21849
ŷ,OuMiaoZhen,420602100,49192,7082,32810,19410,64239,32656,10301,33484,66140,33765,66575
,WoLongZhen,420602101,54663,6160,34544,20100,68562,34226,9850,35668,69894,36129,70673
,YinJiXiang,420602200,9365,1034,6087,3493,10950,6073,1686,5962,12035,5998,12085
ֵ´,HanJiangJieDaoBanShiChu,420606001,59727,5284,36769,25924,43228,34985,9503,33852,68837,37745,74514
կֵ´,WangZhaiJieDaoBanShiChu,420606002,59063,5171,38269,24832,31289,34645,11158,34391,69036,37123,75392
ԭֵ´,ZhongYuanJieDaoBanShiChu,420606003,76892,6346,48322,33001,43018,44977,13787,45168,90145,48703,97025
Žֵ´,DingZhongMenJieDaoBanShiChu,420606004,20485,1952,12954,8028,9543,10803,2730,10144,20947,12213,25167
ӿڽֵ´,QingHeKouJieDaoBanShiChu,420606005,36084,3847,23193,15969,22221,22175,6890,22064,44239,23628,46821
Žֵ´,PingXiangMenJieDaoBanShiChu,420606006,52595,4793,33895,21078,35049,29909,8966,28972,58881,32459,66354
׹ֵ´,MiGongJieDaoBanShiChu,420606007,64888,6836,42218,28052,44589,39690,11310,38452,78142,40816,83034
ֵ̽´,ShiPuJieDaoBanShiChu,420606008,21682,2097,14378,7199,25820,13622,4634,13354,26976,14035,28413
差ֵ´,XiangFanGaoXinQuZiZhenJieDaoBanShiChu,420606070,18069,1925,11313,8286,15169,11016,3523,10509,21525,12204,23517
差ӽֵ´,XiangFanGaoXinQuQiLiHeJieDaoBanShiChu,420606071,24350,1424,14918,10236,10340,13774,4402,13672,27446,15258,30176
ţ,NiuShouZhen,420606100,56503,5709,36562,19702,71653,36365,11954,37256,73621,37604,74166
̫ƽ,TaiPingDianZhen,420606101,44876,6083,30957,18745,59842,30823,10655,30313,61136,30657,61614
差ɽ,XiangFanGaoXinQuTuanShanZhen,420606170,39350,3021,24526,14738,29943,22020,7695,22422,44442,25540,50066
差ׯ,XiangFanGaoXinQuMiZhuangZhen,420606171,30632,1920,18995,12593,25545,18478,6544,18972,37450,20101,39096
ÿ,FanChengQuJingJiKaiFaQu,420606400,11782,1058,7671,5419,14548,7584,2344,7446,15030,7513,15184
差޿,XiangFanYuLiangZhouKaiFaQu,420606480,9944,635,6202,4272,2272,5935,2154,5989,11924,6531,12733
差繫˾差,XiangFanGaoXinQuDongFengGongSiXiangFanJiDi,420606570,14773,875,8587,6331,13877,7466,2611,8062,15528,9672,18259
,ZhangWanZhen,420607100,124697,8775,74702,41452,107321,64845,23159,65982,130827,81929,156631
,LongWangZhen,420607101,39112,4334,26687,15205,52194,26643,10190,26843,53486,26949,53636
ʯ,ShiQiaoZhen,420607102,50422,5597,34194,18447,69204,34083,14112,35832,69915,35937,70131
Ƽ,HuangJiZhen,420607103,52376,5380,34420,18709,65634,33874,11533,34239,68113,34869,69289
,HuoPaiZhen,420607104,39621,4368,25123,12778,49928,23339,6987,23740,47079,25853,50976
,GuYiZhen,420607105,46866,4474,31431,17661,63285,31298,12610,32203,63501,32519,63950
켯,ZhuJiZhen,420607106,45036,6076,31240,14693,62818,27673,12052,28269,55942,31924,63164
̺,ChengHeZhen,420607107,40668,5247,28130,14281,56401,27820,11078,28283,56103,28863,56993
˫,ShuangGouZhen,420607108,64506,6353,41765,21622,79161,39365,13493,40391,79756,42587,84352
żҼ,ZhangJiaJiZhen,420607109,37894,3817,24696,13536,49882,24646,8655,25557,50203,25670,50366
,HuangLongZhen,420607110,31303,3437,19953,11908,40383,19896,6371,20986,40882,21158,41111
ɽ,YuShanZhen,420607111,37060,4610,23725,14130,47739,23157,6900,23712,46869,24845,48570
,DongJinZhen,420607112,72754,8098,47372,25009,94104,46157,14936,46918,93075,48416,95788
ǹ,ChengGuanZhen,420624100,125353,12029,79064,41288,138863,66998,19801,66250,133248,78119,157183
䰲,WuAnZhen,420624101,79418,9089,50139,27835,98823,46953,12594,47866,94819,50962,101101
ż,JiuJiZhen,420624102,64691,7944,41638,24469,81470,41428,11108,41768,83196,42105,83743
,LiMiaoZhen,420624103,18882,3065,11508,7029,24184,11478,3033,13370,24848,13472,24980
ƺ,ChangPingZhen,420624104,12605,2096,7513,4793,15952,7490,1724,8825,16315,8912,16425
Ѧƺ,XuePingZhen,420624105,22157,3892,13202,8964,28964,12859,3102,15392,28251,15949,29151
,BanQiaoZhen,420624106,13491,2377,8101,5463,17376,8016,1983,9486,17502,9750,17851
Ѳ,XunJianZhen,420624107,22772,3314,14020,8391,28470,13722,3220,14732,28454,15286,29306
,DongGongZhen,420624108,25886,3295,15574,9640,31588,15386,3874,16979,32365,17481,33055
Ф,XiaoYanZhen,420624109,21433,3471,13388,8277,27031,13082,3248,14215,27297,14764,28152
ӹ,QingHeGuanLiQu,420624500,9799,1244,6392,3458,11984,6271,1671,6200,12471,6322,12714
ǹ,ChengGuanZhen,420625100,137487,12903,90242,46830,150495,75380,28600,72720,148100,88748,178990
ʯ,ShiHuaZhen,420625101,81886,8317,53917,29015,101690,49520,18550,49134,98654,54836,108753
ʢ,ShengKangZhen,420625102,41091,5711,28419,15341,54023,26422,9780,25859,52281,28163,56582
̲,MiaoTanZhen,420625103,30359,4887,21108,12824,41001,20355,6938,20316,40671,21076,42184
ɽ,WuShanZhen,420625104,18909,3106,13805,9041,25349,13451,4917,12666,26117,13127,26932
ĺ,CiHeZhen,420625105,12325,2039,8123,4595,15797,7112,2186,7185,14297,8427,16550
Ϻ,NanHeZhen,420625106,12642,2039,8513,5076,16931,7917,2766,8093,16010,8934,17447
Ͻ,ZiJinZhen,420625107,12973,2221,8090,5786,16609,7658,2333,8559,16217,9437,17527
伯,LengJiZhen,420625108,34691,4901,23722,13847,45316,22884,7696,22457,45341,23566,47288
,ZhaoWanXiang,420625200,6925,1386,4326,3030,9389,4220,1256,4949,9169,5241,9567
ޯɽֳ,XieShanLinChang,420625500,1295,277,864,666,1710,854,215,905,1759,923,1787
ǹ,ChengGuanZhen,420626100,42928,4538,27070,16928,46119,24739,7581,24931,49670,27977,55047
Ʊ,HuangBaoZhen,420626101,16213,3169,9869,6516,21025,9665,2267,11414,21079,11780,21649
ƺ,HouPingZhen,420626102,7424,1312,4545,2907,9577,4432,1132,5141,9573,5323,9868
ƺ,LongPingZhen,420626103,6597,1274,3976,2752,8618,3889,1017,4625,8514,4912,8888
,DianYaZhen,420626104,10800,1726,6936,4934,13716,6865,1745,7169,14034,7335,14271
,MaLiangZhen,420626105,24583,3139,14858,8998,30477,14509,3264,15554,30063,16128,30986
Ъ,XieMaZhen,420626106,33344,4440,20471,12233,41369,19882,4968,21443,41325,22281,42752
,MaQiaoZhen,420626107,21570,3014,13308,8351,26799,13114,3450,14298,27412,14726,28034
ƺ,SiPingZhen,420626108,18515,2928,11769,6792,23773,11475,3096,12190,23665,12770,24539
,GuoDuWanZhen,420626109,6981,1503,4480,3116,9025,4396,1014,4829,9225,5018,9498
,LiangYuXiang,420626200,7043,1171,4214,2924,8832,4209,850,4808,9017,4850,9064
⻯ֵ´,GuangHuaJieDaoBanShiChu,420682001,51471,5476,34126,20429,56455,33322,10370,32430,65752,33191,67317
ֵ´,ZanYangJieDaoBanShiChu,420682002,74002,8097,50018,29963,72429,47301,15049,44691,91992,47130,97148
¥,MengLouZhen,420682100,22438,2282,15889,7905,29357,15806,7248,15948,31754,16079,31968
,ZhuLinQiaoZhen,420682101,25741,2589,17299,8855,34544,17280,6692,17661,34941,17723,35022
Ѧ,XueJiZhen,420682102,30788,2952,20985,9964,41481,20873,8798,21370,42243,21553,42538
ż,ZhangJiZhen,420682103,30586,3153,20400,10181,39835,20307,7476,20585,40892,20815,41215
˶,XianRenDuZhen,420682104,26496,3219,18097,9973,33850,18018,6327,17712,35730,17945,36042
ɽ,HongShanZuiZhen,420682105,38544,4616,24571,14329,48468,23866,7517,24908,48774,26106,50677
¥,LiLouZhen,420682106,27994,3199,18765,9688,34777,18745,6260,18571,37316,18688,37453
Ԭ,YuanChongXiang,420682200,23828,2241,15620,7671,30663,15477,6033,16252,31729,16482,32102
ǽֵ´,BeiChengJieDaoBanShiChu,420683001,57348,4699,37534,19266,51574,27091,12096,26507,53598,36609,74143
ϳǽֵ´,NanChengJieDaoBanShiChu,420683002,107228,9031,68694,39928,96102,61537,21675,61335,122872,69240,137934
ǽֵ´,HuanChengJieDaoBanShiChu,420683003,39336,4737,25645,13786,47680,22799,7921,23309,46108,26349,51994
,JuWanZhen,420683100,50371,5325,32551,18181,64999,32509,11077,34063,66572,34222,66773
߷,QiFangZhen,420683101,64393,7500,41697,23613,84092,41372,13967,43472,84844,44163,85860
,YangDangZhen,420683102,48581,5893,31627,16728,64300,31208,11467,33482,64690,34314,65941
̫ƽ,TaiPingZhen,420683103,59606,8567,39530,23740,79549,39269,13078,41168,80437,41721,81251
,XinShiZhen,420683104,35483,4986,23526,14412,46966,23318,7893,24380,47698,24836,48362
¹ͷ,LuTouZhen,420683105,40323,5483,27346,15490,53777,26956,9861,27627,54583,28321,55667
,LiuShengZhen,420683106,25339,3146,16584,10499,33279,16563,5560,17371,33934,17461,34045
¡,XingLongZhen,420683107,41594,4481,26820,16754,52310,26552,8762,27464,54016,28017,54837
,WangChengZhen,420683108,31353,3780,19995,12285,40412,19826,5831,20722,40548,20969,40964
,WuDianZhen,420683109,62427,7476,40159,25519,76772,38777,10811,39207,77984,40555,80714
ܼ,XiongJiZhen,420683110,32323,3923,20516,13796,41354,20505,5556,21259,41764,21286,41802
ƽ,PingLinZhen,420683111,19499,2379,12206,7307,25052,12149,3285,12890,25039,12957,25163
�ÿ,ZaoYangJingJiKaiFaQu,420683402,33927,2566,21873,14131,17589,21690,7653,21703,43393,22273,44146
ũ,SuiYangNongChang,420683500,5128,599,3502,2066,6661,3493,1156,3361,6854,3381,6883
ũ,CheHeNongChang,420683501,6363,828,4106,2540,7991,4106,1071,4155,8261,4156,8262
۳ǽֵ´,YanChengJieDaoBanShiChu,420684001,106283,9772,66661,38931,106588,61450,17822,60058,121508,67216,133877
Ӫֵ´,NanYingJieDaoBanShiChu,420684002,32426,3773,20908,10497,40759,20827,5861,21008,41835,21152,42060
֣,ZhengJiZhen,420684102,52219,7459,34372,18780,67255,34317,9491,34664,68981,34797,69169
С,XiaoHeZhen,420684103,39179,5136,25325,13717,48723,24531,6607,24484,49015,25597,50922
,LiuHouZhen,420684104,24245,2935,15620,9012,30447,15466,4627,15893,31359,16187,31807
,KongWanZhen,420684105,14772,1989,9710,5558,18419,9511,2753,9546,19057,9804,19514
ˮ,LiuShuiZhen,420684106,38872,4529,24338,14563,46483,23281,6431,24140,47421,25494,49832
,BanQiaoZhen,420684107,31588,3153,19661,10566,38690,18255,5650,19104,37359,20730,40391
,WangJiZhen,420684108,25176,3446,16956,9094,33040,16928,5636,17230,34158,17302,34258
׺,LeiHeZhen,420684109,27704,3913,18070,11491,32553,17682,4881,17872,35554,18428,36498
㹤ҵ԰,DaYanGongYeYuanQu,420684450,3308,266,2047,1061,3856,1751,628,1737,3488,2155,4202
̫,TaiHeZhen,420702100,33541,3143,21714,10899,43203,21054,8789,22782,43836,23759,45473
,DongGouZhen,420702101,15860,1743,9954,5744,20385,9763,3257,10652,20415,10906,20860
,LiangZiZhen,420702102,11907,1283,7714,4176,14209,7282,2854,7890,15172,8330,16044
Ϳ,TuJiaNaoZhen,420702103,19868,2471,12469,7105,25867,12429,4037,13834,26263,13907,26376
ɽ,ZhaoShanZhen,420702104,23900,2690,16552,9363,32883,16528,7265,17227,33755,17303,33855
,HuaRongZhen,420703100,44844,5116,27864,15179,54433,24216,8441,26125,50341,30537,58401
,GeDianZhen,420703101,48940,5301,30092,17447,59533,27159,7932,28125,55284,32081,62173
,MiaoLingZhen,420703102,22847,2489,14072,8565,28180,13467,4754,14466,27933,16018,30090
ε,DuanDianZhen,420703103,26621,3699,15885,8955,32080,15172,4281,16861,32033,18716,34601
ٽ,LinJiangXiang,420703200,22415,3187,14161,8256,28446,13866,4454,15201,29067,15895,30056
,PuTuanXiang,420703201,14558,1915,9074,5854,18603,8930,2978,9908,18838,10377,19451
꿪,GeDianKaiFaQu,420703400,2399,22,995,240,703,316,140,344,660,1566,2561
˽ֵ,FengHuangJieDao,420704001,111211,6860,66001,36903,98222,52550,19961,57124,109674,72031,138032
¥ֵ,GuLouJieDao,420704002,99680,6974,61285,40288,90536,56520,20946,60648,117168,66315,127600
ɽֵ,XiShanJieDao,420704003,53066,5909,31920,22993,57387,30719,9792,34111,64830,36847,68767
,ZeLinZhen,420704100,37991,4741,23819,14874,43852,22708,7468,24788,47496,26381,50200
ɽ,DuShanZhen,420704101,14591,1917,8955,5217,18286,8690,2473,9492,18182,10026,18981
,XinMiaoZhen,420704102,14894,2055,9486,5627,18383,9372,3184,10124,19496,10647,20133
ʯ,BiShiZhen,420704103,19340,1993,11811,7052,23955,11797,3646,13126,24923,13168,24979
͡,TingZuZhen,420704104,39806,3913,24024,13631,48495,23318,7662,26071,49389,27357,51381
,YanJiZhen,420704105,29519,4009,18997,11075,38147,18983,6758,21135,40118,21289,40286
Ҷ,YangYeZhen,420704106,16622,1887,10770,6346,21466,10654,4097,11621,22275,11836,22606
,HuaHuZhen,420704107,26833,2415,16191,9459,26581,15546,5386,17381,32927,18443,34634
,ChangGangZhen,420704108,9943,1235,6385,3646,12658,5832,2095,6132,11964,6888,13273
ɳ,ShaWoXiang,420704200,20185,2478,12342,6842,25707,11907,4179,13667,25574,14500,26842
ݾÿ,EZhouJingJiKaiFaQu,420704400,23445,2992,14770,8715,26300,13643,4576,14649,28292,16243,31013
Ȫֵ,LongQuanJieDaoBan,420802001,75170,6012,47215,33670,57992,42832,11098,42610,85442,45065,92280
Ȫڽֵ,QuanKouJieDaoBan,420802002,81929,5100,48829,32413,52039,40465,11883,40505,80970,50083,98912
Ϫ,LiXiZhen,420802100,14293,1818,8210,5206,16208,7968,1668,8612,16580,9569,17779
,ZiLingZhen,420802101,32068,4008,19943,12409,34856,19748,4461,20247,39995,20594,40537
ĺ,ZhangHeZhen,420802102,27329,3469,16765,10617,31273,16355,3557,16751,33106,17590,34355
,MaHeZhen,420802103,6949,786,3939,2524,7033,3880,844,4052,7932,4640,8579
ʯ,ShiQiaoYiZhen,420802104,21786,3218,13270,8555,25496,13102,3011,13556,26658,14745,28015
¥,PaiLouZhen,420802105,16081,1631,9965,5545,17286,9644,2409,9902,19546,10156,20121
ɾ,XianJuXiang,420802200,15575,2485,10042,6437,19854,9988,2346,10214,20202,10364,20406
޵ʯֵ´,DuoDaoShiJieDaoBanShiChu,420804001,99075,4627,59689,32955,44993,48143,15586,48336,96479,59599,119288
ֵ´,BaiMiaoJieDaoBanShiChu,420804002,68926,6854,43098,31288,52256,40812,11822,41811,82623,44504,87602
,TuanLinPuZhen,420804100,32830,4343,20363,12472,38949,20326,4399,21095,41421,21209,41572
,MaChengZhen,420804101,18333,2232,11278,7734,19264,11235,2943,11995,23230,12230,23508
,XinShiZhen,420821100,118215,9396,71511,42193,120459,59439,15575,59538,118977,71675,143186
,YongXingZhen,420821101,16736,2346,10053,6038,19064,9299,2220,9689,18988,11249,21302
,CaoWuZhen,420821102,24028,2839,14668,8038,29519,14427,3184,15154,29581,15383,30051
޵,LuoDianZhen,420821103,47973,6399,30766,19019,61528,30394,8132,31094,61488,31738,62504
κ,SongHeZhen,420821104,37620,4428,23649,14200,44905,22111,5534,22407,44518,23933,47582
ƺ,PingBaZhen,420821105,10990,2115,8076,5632,15340,8035,2587,7527,15562,7616,15692
,SanYangZhen,420821106,19165,2840,12839,8565,25058,12768,3730,12747,25515,12896,25735
,LuLinZhen,420821107,7307,1052,4729,3047,9294,4713,1281,4859,9572,4911,9640
,YangJiZhen,420821108,10035,1284,6248,3495,12411,6236,1439,6490,12726,6510,12758
,SunQiaoZhen,420821109,27731,3105,16594,9223,31760,15539,3758,15928,31467,18000,34594
ʯ,ShiLongZhen,420821110,19539,2021,11972,6881,23451,11901,2862,12350,24251,12450,24422
¡,YongLongZhen,420821111,38120,4883,24071,13790,47636,23844,5814,24369,48213,24746,48817
ſ,YanMenKouZhen,420821112,29829,3482,18522,10693,35814,18223,4710,18999,37222,19499,38021
Ǯ,QianChangZhen,420821113,25124,3127,15895,10852,30554,15650,4453,16233,31883,16809,32704
ɽÿ,JingShanJingJiKaiFaQu,420821170,17551,999,10241,5006,14211,7757,2493,7880,15637,10802,21043
ɽԭֳ,JingShanXianYuanZhongChang,420821198,2140,231,1282,900,2344,1280,286,1363,2643,1375,2657
̫ɽֹܾ,TaiZiShanLinGuanJu,420821450,1648,309,1075,801,1831,1067,253,1109,2176,1135,2210
޺°´,LuoHanSiBanShiChu,420821451,3772,524,2444,1413,4708,2444,619,2471,4915,2471,4915
̲´,ChangTanBanShiChu,420821452,5955,828,3850,2469,7299,3850,989,3922,7772,3922,7772
μ´,HeJiBanShiChu,420821453,8391,1272,5532,3485,10539,5530,1487,5593,11123,5618,11150
´,QuJiaLingBanShiChu,420821454,8037,1133,5145,3674,9808,5145,1350,5374,10519,5375,10520
׼´,YiJiaLingBanShiChu,420821455,23290,2792,14700,10402,28589,14203,3419,14346,28549,14801,29501
ɳ,ShaYangZhen,420822100,48299,4160,29502,17290,43996,26396,6699,25745,52141,29656,59158
,WuLiPuZhen,420822101,35443,4127,21393,12723,41442,20928,4255,21821,42749,22432,43825
ʮ,ShiLiPuZhen,420822102,27469,3102,16849,10004,31692,16833,3591,17277,34110,17313,34162
ɽ,JiShanZhen,420822103,18516,2259,11725,6978,22052,11659,2768,11703,23362,11818,23543
ʰ,ShiHuiQiaoZhen,420822104,32336,4010,20237,11821,38556,20182,4689,20669,40851,20798,41035
,HouGangZhen,420822105,54789,6543,34813,19704,65193,33235,8636,33445,66680,35155,69968
ë,MaoLiZhen,420822106,28819,3449,18200,9595,36352,18119,4562,18489,36608,18630,36830
ٵ,GuanDangZhen,420822107,27856,2952,17248,9378,34285,16993,4005,17247,34240,17565,34813
,LiShiZhen,420822108,29339,3245,18617,10144,36260,18603,4653,18580,37183,18620,37237
,MaLiangZhen,420822109,27746,3490,17304,10412,34349,17056,3674,17254,34310,17606,34910
,GaoYangZhen,420822110,31184,3746,19134,11135,37724,19087,4207,19907,38994,20003,39137
,ShenJiZhen,420822111,26437,3538,16631,9839,32140,16163,3672,16302,32465,17016,33647
,CengJiZhen,420822112,35754,4527,21984,13180,43136,21689,4346,22317,44006,22643,44627
,XuNiDiQu,420822450,40212,5283,14909,12905,39954,14517,3056,14055,28572,33642,48551
۫нֵ´,YingZhongJieDaoBanShiChu,420881001,154862,12019,96260,47678,131355,74291,23266,72682,146973,93887,190147
,YangZiZhen,420881100,41463,5233,25756,13987,50262,24463,5770,25128,49591,26710,52466
,ChangShouZhen,420881101,22333,2541,13863,7759,26175,13001,3159,13282,26283,14170,28033
,FengLeZhen,420881102,50013,6533,31922,16208,63314,30622,7985,31110,61732,32609,64531
,HuJiZhen,420881103,100420,11625,63018,33988,118534,57786,15541,58309,116095,64568,127586
˫,ShuangHeZhen,420881104,30403,3574,18692,10374,35984,18239,4182,18822,37061,19467,38159
׿,LinKuangZhen,420881105,32286,4664,20435,10367,39540,18388,4460,18359,36747,20975,41410
ļ,WenJiZhen,420881106,30677,4707,19981,10980,38889,19554,4902,19789,39343,20305,40286
ˮ,LengShuiZhen,420881107,35771,4358,22262,11497,43885,22230,5244,23050,45280,23111,45373
ʯ,ShiPaiZhen,420881108,66044,7935,41566,19969,82324,40867,10322,41824,82691,42735,84301
ɿ,JiuKouZhen,420881109,76779,8604,47904,23957,92922,43541,10973,43501,87042,48452,96356
,ChaiHuZhen,420881110,69330,7988,47576,21851,92967,47023,17851,46916,93939,47593,95169
̲,ChangTanZhen,420881111,14603,1860,8972,5202,17277,8401,1848,8737,17138,9339,18311
,DongQiaoZhen,420881112,19552,2258,11990,6494,23258,11750,2483,11987,23737,12303,24293
͵,KeDianZhen,420881113,10624,1262,6421,3832,12668,6381,1377,6767,13148,6842,13263
ż,ZhangJiZhen,420881114,17607,2320,10772,6088,21559,10344,2107,10663,21007,11262,22034
,JiuLiXiang,420881200,13721,1648,8338,4425,15954,7964,1794,8314,16278,8825,17163
йׯ,ZhongXiangShiGuanZhuangHuGuanLiQu,420881450,9486,1432,6443,3580,12339,5816,1771,5719,11535,6246,12689
Ϻԭֳ,NanHuYuanZhongChang,420881451,5780,693,3606,1839,6834,3442,780,3478,6920,3647,7253
޺,LuoHanSiZhongChuChang,420881452,1843,203,1198,611,2064,1045,258,1007,2052,1106,2304
Ͽˮ,WenXiaShuiKu,420881458,847,85,464,422,701,463,83,540,1003,551,1015
ʯˮ,ShiMenShuiKu,420881459,192,50,118,129,74,117,13,137,254,137,255
ˮ,HuangPoShuiKu,420881460,93,14,51,51,0,50,10,57,107,66,117
Ժְ´,ShuYuanJieBanShiChu,420902001,58572,6365,34283,26981,49753,31954,9075,33530,65484,39729,74012
»ְ´,XinHuaJieBanShiChu,420902002,58909,5126,38576,20974,47272,28296,8624,28696,56992,34083,72659
㳡ְ´,GuangChangJieBanShiChu,420902003,126755,10152,79817,49712,107407,68806,20741,69265,138071,77831,157648
վֵ´,CheZhanJieDaoBanShiChu,420902004,31836,2846,19897,13970,22779,18938,5539,19081,38019,20324,40221
,XinPuZhen,420902100,20014,2971,13139,8580,24051,13042,4005,13614,26656,13851,26990
,XiHeZhen,420902101,14298,2610,10076,6530,19411,9863,3377,9748,19611,10209,20285
,YangDianZhen,420902102,33637,6300,25072,17582,46129,25022,8643,23325,48347,23508,48580
,DouGangZhen,420902103,27217,3806,18262,10907,36234,17917,6291,18338,36255,19052,37314
Ф,XiaoGangZhen,420902104,51431,7821,34924,21318,67250,32127,11052,32323,64450,35380,70304
ë,MaoChenZhen,420902105,26953,3681,17547,10855,31693,16989,4804,17336,34325,17891,35438
,SanChaZhen,420902106,26023,4035,17333,11189,33747,16864,5575,17262,34126,18300,35633
ףվ,ZhuZhanZhen,420902107,17637,3285,12638,8665,23704,12609,3841,11996,24605,12125,24763
,PengXingXiang,420902200,26758,3692,17052,10658,32769,17030,5094,18378,35408,18492,35544
,WoLongXiang,420902201,33525,4442,20919,12257,38531,20028,5617,21883,41911,22665,43584
ɼ,MinJiXiang,420902202,17204,2153,10569,5403,20733,10438,2844,10943,21381,11632,22201
ТÿίԱ,XiaoNanQuJingJiKaiFaQuGuanLiWeiYuanHui,420902400,18266,1995,11397,6059,18586,10750,3004,11033,21783,11868,23265
Тũ,XiaoNanQuZhuHuNongChang,420902450,12859,2003,8289,5799,15683,8207,2057,8422,16629,8630,16919
Тɽͷԭֳ,XiaoNanQuDongShanTouYuanZhongChang,420902500,4068,685,2661,1849,4804,2594,690,2639,5233,2782,5443
Тп´,XiaoGanKaiFaQuDanYangBanShiChu,420902570,66746,8138,41408,26997,50690,37498,10461,37976,75474,43937,85345
ТпТ´,XiaoGanKaiFaQuXiaoTianBanShiChu,420902571,16226,1928,10667,6105,18181,9981,3242,10288,20269,10729,21396
Тп´,XiaoGanKaiFaQuHuaiYinBanShiChu,420902572,8344,871,4901,2894,8854,4815,1507,5114,9929,5821,10722
԰,HuaYuanZhen,420921100,82339,7463,52089,28507,88291,48836,17907,51251,100087,55620,107709
ɽ,FengShanZhen,420921101,16869,2245,11555,6505,21997,11530,3986,11497,23027,11545,23100
,ZhouXiangZhen,420921102,40357,4535,26371,14167,53564,26353,9269,27725,54078,27790,54161
С,XiaoHeZhen,420921103,28916,3349,18644,9582,38806,18633,6716,20292,38925,20337,38981
,WangDianZhen,420921104,28896,3626,19144,9746,39318,18453,7463,19540,37993,20841,39985
,WeiDianZhen,420921105,20301,2515,13441,6895,27163,13354,4768,13915,27269,14143,27584
ɳ,BaiShaZhen,420921106,32715,3657,20510,10570,42705,20483,6722,22518,43001,22584,43094
޸,ZouGangZhen,420921107,43684,5204,28474,14922,56756,28389,9267,29487,57876,29681,58155
С,XiaoWuXiang,420921200,11285,1644,7875,4759,15365,7851,3094,8078,15929,8148,16023
,JiDianXiang,420921201,33702,3627,21354,11015,44810,20985,7665,22991,43976,23640,44994
,HuaXiXiang,420921202,32028,3613,20354,10572,42003,20312,6852,22056,42368,22139,42493
ɽ,DouShanXiang,420921203,36412,3780,23352,11736,47594,23091,7987,24076,47167,24827,48179
Тؿ,XiaoChangXianKaiFaQu,420921400,17203,1465,10875,5343,18689,9821,3557,10131,19952,11350,22225
̬Ļζɼ,GuanYinHuShengTaiWenHuaLvYouDuJiaQu,420921450,9525,1211,6261,3261,12436,6209,2324,6614,12823,6799,13060
˫ɽζɼ,ShuangFengShanLvYouDuJiaQu,420921500,6328,949,4409,2420,8563,4364,1646,4445,8809,4514,8923
ǹ,ChengGuanZhen,420922100,104884,8300,66307,35334,103865,55537,20604,55255,110792,67481,133788
ƽ,YangPingZhen,420922101,15083,1798,9339,5371,18890,8940,2947,9824,18764,10489,19828
,FangFanZhen,420922102,24585,3068,16138,7990,32323,15842,5246,16292,32134,16761,32899
³,XinChengZhen,420922103,32835,3739,20682,11713,43086,20105,7457,22399,42504,23349,44031
ĵ,XiaDianZhen,420922104,21894,2831,14271,7905,28427,13570,4734,14310,27880,15188,29459
,LiuJiZhen,420922105,20702,2496,12745,6890,26211,12555,3384,13338,25893,13837,26582
ӿ,HeKouZhen,420922106,18611,1796,11456,6435,22958,11322,3586,12240,23562,12537,23993
Ĺ,SiGuZhen,420922107,16765,2156,10860,5618,22818,10593,3937,11716,22309,11998,22858
,LvWangZhen,420922108,18841,2297,12462,7029,25545,12247,5181,13525,25772,13857,26319
վ,HuangZhanZhen,420922109,10818,1378,7374,4068,14676,6771,2938,7032,13803,7760,15134
,XuanHuaDianZhen,420922110,40464,4815,26711,14566,52733,25982,9834,27654,53636,28402,55113
,FengDianZhen,420922111,22288,2627,14508,7757,29794,14428,5344,15569,29997,15751,30259
,DaXinZhen,420922112,24190,2539,15516,8948,31537,15330,5419,16331,31661,16632,32148
,SanLiZhen,420922113,16902,2558,11663,7631,22736,11163,3713,10687,21850,11510,23173
ߵ,GaoDianXiang,420922200,27661,3130,17366,9295,35758,17223,5963,18841,36064,19388,36754
,PengDianXiang,420922201,23962,2859,15319,8349,31517,15251,5192,16522,31773,16694,32013
,DongXinXiang,420922202,23061,2638,14645,7764,30241,14598,4852,15801,30399,15906,30551
ǹ,ChengGuanZhen,420923100,111909,9229,65662,36051,101061,57116,16735,60811,117927,72211,137873
,YiTangZhen,420923101,30377,3792,19447,10679,39559,19176,6011,20382,39558,20733,40180
,CengDianZhen,420923102,23783,2794,14559,8021,30813,14132,4482,15576,29708,16500,31059
,WuPuZhen,420923103,21193,2927,13470,8100,27245,13098,4279,14094,27192,14929,28399
,WuLuoZhen,420923104,26341,3716,16755,9121,34376,15539,4949,16750,32289,18251,35006
,XiaXinDianZhen,420923105,36314,4791,22648,11883,47383,22574,6765,24818,47392,25222,47870
,DaoQiaoZhen,420923106,16516,2565,10504,6104,21215,9953,2897,10806,20759,11474,21978
̶,GePuTanZhen,420923107,39455,4833,24593,13965,50596,23238,6849,24788,48026,26544,51137
,HuJinDianZhen,420923108,20920,2554,13106,7262,26963,12628,3965,13605,26233,14333,27439
,DaoDianXiang,420923200,21620,2082,12450,6549,26795,11808,3520,12673,24481,14772,27222
ɳ,ShaHeXiang,420923201,23789,3040,15014,8467,30488,14726,4412,15674,30400,16227,31241
,QingMingHeXiang,420923202,19071,2203,12132,6682,24462,12116,3423,12534,24650,12565,24697
ؾÿ,YunMengXianJingJiKaiFaQu,420923450,16532,1452,9971,5833,16831,9792,2714,10368,20160,10727,20698
нֵ´,ChengZhongJieDaoBanShiChu,420981001,106060,11451,65995,45675,93072,63542,16499,65021,128563,68015,134010
Ǳֵ´,ChengBeiJieDaoBanShiChu,420981002,33700,4918,21101,12270,40160,18309,5167,18483,36792,22684,43785
ֵ´,SiLiPengJieDaoBanShiChu,420981003,19235,2392,11444,5899,22212,8405,2811,8683,17088,12994,24438
�ֵ´,DongMaFangJieDaoBanShiChu,420981004,31653,3533,19832,13241,37627,18989,5498,19747,38736,20852,40684
ֵ´,ChangJiangBuJieDaoBanShiChu,420981005,17755,2524,11423,8484,21261,11293,3225,11814,23107,12081,23504
,TianDianZhen,420981100,11082,1643,7207,4641,14036,7127,1845,7191,14318,7363,14570
,YangHeZhen,420981101,27589,4355,18802,12765,35494,18440,5454,18212,36652,18596,37398
,SanHeZhen,420981102,21948,2933,13761,7604,27967,13547,3687,14328,27875,14807,28568
ɾ,LangJunZhen,420981103,39731,4993,24004,13236,49915,23966,5796,26427,50393,26516,50520
̲,HuangTanZhen,420981104,35192,4498,21786,12763,44781,20873,5635,22143,43016,23539,45325
,TianEZhen,420981105,20276,2780,12689,7005,26339,12039,3756,13100,25139,14123,26812
,YiHeZhen,420981106,14045,1884,8946,5577,18653,8688,2993,9496,18184,9976,18922
º,ChenHeZhen,420981107,32886,4477,20431,12283,42582,20322,5837,22448,42770,22769,43200
,YangLingZhen,420981108,21379,3110,13379,8249,26251,12895,3372,13846,26741,14482,27861
,TangChiZhen,420981109,10311,1334,6356,3722,12037,5704,1709,6174,11878,6998,13354
Ӧоü�,YingChengShiJingJiJiShuKaiFaQu,420981400,13477,1037,8462,5183,8137,8080,2690,8184,16264,8742,17204
ֳ,NanYuanLiangZhongChang,420981500,2842,331,1729,959,3424,1725,484,1912,3637,1928,3657
ǽֵ´,FuChengJieDaoBanShiChu,420982001,105731,9396,65609,38734,106166,56030,17359,55564,111594,66877,132486
ϳǽֵ´,NanChengJieDaoBanShiChu,420982002,16767,2153,10512,5884,20752,10059,2815,10235,20294,11223,21735
,ZhaoPengZhen,420982100,21355,3726,14374,8473,28895,13295,4330,13313,26608,15037,29411
,LiDianZhen,420982101,16879,2066,10874,6747,21986,10747,3221,11121,21868,11292,22166
Ѳ,XunDianZhen,420982102,31839,3688,19615,10126,40213,17849,4811,18773,36622,20723,40338
,TangDiZhen,420982103,19628,2735,12841,7244,24545,12177,3215,11693,23870,12737,25578
׹,LeiGongZhen,420982104,22669,3294,14940,9359,29468,14220,4437,14073,28293,15460,30400
,WangYiZhenZhen,420982105,19512,3004,12793,7789,25381,12402,3411,12367,24769,13134,25927
̵,YanDianZhen,420982106,28057,3848,18277,9632,36109,18242,4364,17952,36194,17992,36269
,BeiFanZhen,420982107,18095,3225,12401,8401,24262,12173,3445,11960,24133,12364,24765
ˮ,FuShuiZhen,420982108,22094,3308,14325,8247,27830,13274,3710,13327,26601,14787,29112
µ,ChenDianXiang,420982200,21761,2973,13894,8978,28156,13776,4074,14573,28349,14914,28808
ե,XinZhaXiang,420982201,21010,3219,14190,7900,27971,13917,4562,13889,27806,14601,28791
ľ,MuZiXiang,420982202,14885,2056,9770,5746,19458,9658,2720,9731,19389,9891,19661
ӹ,JieGuanXiang,420982203,16687,2660,10633,5836,21903,9872,2710,10163,20035,11424,22057
½п,AnLuShiKaiFaQu,420982400,41436,2332,25513,14659,31144,22293,7318,22163,44456,25573,51086
Ůɽֵ´,XianNvShanJieDaoBanShiChu,420984001,129514,12269,78695,48468,127394,72160,23447,77340,149500,86535,165230
,MaKouZhen,420984100,63815,6860,40207,19805,63938,32458,9158,33681,66139,39626,79833
,MaiWangZhen,420984101,24060,3337,15399,9179,30190,14543,5017,15707,30250,17015,32414
,ChengHuangZhen,420984102,40961,4826,25726,12731,49646,23494,6625,25372,48866,26686,52412
ˮ,FenShuiZhen,420984103,46067,5610,29017,14801,58914,28477,9368,31636,60113,32028,61045
,ChenHuZhen,420984104,44836,4769,28253,15119,57027,28099,10737,31775,59874,32089,60342
,TianErHeZhen,420984105,29566,3489,18588,9894,38498,18013,6360,20204,38217,20827,39415
,HuiLongZhen,420984106,24656,2959,15417,7716,32122,14999,5462,16926,31925,17660,33077
,XinYanZhen,420984107,23876,3323,15262,10228,30902,14926,5256,16570,31496,17193,32455
V,DongZhongZhen,420984108,14202,1917,8832,4928,18065,8820,2468,9700,18520,9755,18587
,MaHeZhen,420984109,24284,3049,15103,8937,31370,15071,4768,16909,31980,16998,32101
Ҹ,LiuJiaGeZhen,420984110,31226,3683,19469,10324,39635,19261,5533,20664,39925,20973,40442
º,XinHeZhen,420984111,49309,5401,29788,16387,55727,28003,7386,29634,57637,32308,62096
ͷ,MiaoTouZhen,420984112,23006,3052,14731,8075,29382,14600,4196,15396,29996,15523,30254
ֹ,YangLinGouZhen,420984113,26442,3517,16805,9580,35205,16682,5548,18631,35313,18702,35507
,XiJiangXiang,420984200,29955,3814,18846,9792,39346,18805,6092,20896,39701,21015,39861
̶,WanTanXiang,420984201,14063,2428,9362,5302,19180,8951,3043,9525,18476,10172,19534
Ϻ,NanHeXiang,420984202,28672,3767,18355,9150,36668,17899,5479,18815,36714,19563,37918
�,MaAnXiang,420984203,21429,2972,13643,7356,26406,13258,3564,13855,27113,14322,27965
̶,LiTanXiang,420984204,18453,2256,11686,6532,24466,11660,4215,13209,24869,13238,24924
,HanJiXiang,420984205,26891,3057,16148,8487,34853,16147,5098,18896,35043,18898,35046
Ӫũ,GuoYingZhongZhouNongChang,420984450,9583,1529,6484,4376,12559,6483,2107,6721,13204,6735,13219
ũ,HuaYanNongChang,420984500,8249,1305,5479,3287,10974,5364,1814,5799,11163,5889,11368
޻ԭֳ,DiaoDongMianHuaYuanZhongChang,420984501,6807,967,4318,2593,7955,4013,1238,4279,8292,4694,9012
ԭֳ,SanXingYuanYuanZhongChang,420984502,3096,382,1881,1056,3933,1871,500,2072,3943,2097,3978
ֳ,DiaoChaHuYangZhiChang,420984503,7551,792,4664,2682,9224,4659,1466,5129,9788,5145,9809
оü�,HanChuanShiJingJiJiShuKaiFaQu,420984504,6017,501,3607,2006,5596,3498,1129,3635,7133,4040,7647
ؿܹ˾,ChenHuJiDiKaiFaZongGongSi,420984505,13,1,10,2,7,4,2,5,9,6,16
ɽֵ´,ZhongShanJieDaoBanShiChu,421002001,45952,6265,29087,21033,46359,28433,5349,27756,56189,28479,57566
Ľֵ´,ChongWenJieDaoBanShiChu,421002002,41819,4860,25042,15884,28195,21210,4529,20349,41559,26166,51208
Žֵ´,JieFangJieDaoBanShiChu,421002003,68213,8382,41993,30446,57622,40990,8989,40972,81962,43591,85584
ʤֵ´,ShengLiJieDaoBanShiChu,421002004,60245,6536,37604,26907,58076,36549,8221,36430,72979,37398,75002
ֵ´,ZhaoYangJieDaoBanShiChu,421002005,47351,4774,29455,20410,45586,28894,6709,28599,57493,29379,58834
Ͻֵ´,LianHeJieDaoBanShiChu,421002033,72725,5467,43185,30617,52660,41385,10116,42057,83442,45123,88308
ೡ,LuoChangZhen,421002100,7964,847,4868,2486,8694,4738,1116,4758,9496,5059,9927
᯺,CenHeZhen,421002101,37437,4302,23170,12795,43071,22857,5382,23549,46406,23951,47121
,GuanYinDangZhen,421002102,25107,4081,16906,10518,30870,16699,4822,16588,33287,17104,34010
ؾ,GuanJuZhen,421002103,12908,1159,7681,4848,12988,7312,1774,7574,14886,8160,15841
,LiXinXiang,421002200,47626,2274,25223,15859,21290,20807,5605,21918,42725,30282,55505
᯺ԭֳ,CenHeYuanZhongChang,421002500,6286,751,3866,2509,6562,3776,891,3847,7623,4062,7928
ɳũ,ShaShiNongChang,421002571,10731,1319,6420,4138,10492,6180,1446,6386,12566,7076,13496
ǽֵ´,XiChengJieDaoBanShiChu,421003001,40186,4229,26169,14052,34195,19405,4358,18474,37879,22604,48773
ǽֵ´,DongChengJieDaoBanShiChu,421003002,61781,6694,37661,23530,46966,32191,7976,31111,63302,38790,76451
Ͻֵ´,ChengNanJieDaoBanShiChu,421003003,122215,7155,66409,29868,60187,42010,10842,41656,83666,73803,140212
,JiNanZhen,421003100,40729,5101,26084,15805,46219,25890,6885,26322,52212,26631,52715
,ChuanDianZhen,421003101,22207,3028,13970,9378,26679,13889,3169,14261,28150,14434,28404
ɽ,MaShanZhen,421003102,19003,2676,11958,8041,22767,11742,2586,12046,23788,12307,24265
ɽ,BaLingShanZhen,421003103,21116,3230,13636,8899,25076,13588,3407,13950,27538,14117,27753
,LiBuZhen,421003104,16977,2697,11164,7610,20649,11091,2561,10941,22032,11071,22235
,MiShiZhen,421003105,44486,7370,29841,19935,56227,28843,6856,28019,56862,28871,58712
۫,YingChengZhen,421003106,34745,2680,20860,12028,28937,19047,4967,19287,38334,21532,42392
̫۹,TaiHuGangGuanLiQu,421003450,17209,2598,11215,6698,18539,10617,2684,10593,21210,11276,22491
Ǻ,LingJiaoHuGuanLiQu,421003451,7068,1224,4701,3326,8940,4594,1061,4550,9144,4652,9353
,BuHeZhen,421022100,64095,8194,41024,22653,78190,40973,9076,40239,81212,40341,81365
,DouHuDiZhen,421022101,117907,10573,73220,43626,106023,67416,17668,65614,133030,72928,146148
԰,JiaZhuYuanZhen,421022102,30581,4813,20278,12374,38599,20245,4830,19837,40082,19946,40224
բ,ZhaKouZhen,421022103,36305,4233,22944,11263,40390,20784,5407,20599,41383,23001,45945
ҳ,YangJiaChangZhen,421022104,34831,3934,21863,11536,42357,21791,4803,21608,43399,21705,43568
,MaHaoKouZhen,421022105,43398,5262,27299,14194,53915,27139,6572,27728,54867,27933,55232
ź,OuChiZhen,421022106,30337,3711,19358,11394,36034,18412,4728,18464,36876,19418,38776
ɽͷ,HuangShanTouZhen,421022107,26816,3140,16877,9925,32364,16817,4149,17124,33941,17228,34105
ϼϪ,MengJiaXiZhen,421022108,28223,3994,18603,10762,35781,18564,4789,18314,36878,18403,37006
ƽ,NanPingZhen,421022109,35027,4659,22997,15237,37925,20922,5831,20146,41068,22520,45517
ׯ,ZhangZhuangPuZhen,421022110,44397,5728,28649,15737,54717,28018,7111,27963,55981,28587,57236
ʨӿ,ShiZiKouZhen,421022111,41921,6196,27148,15048,52246,27010,6249,26997,54007,27218,54366
,BanZhuDangZhen,421022112,49137,7240,31609,15948,60426,31030,6684,30883,61913,31452,63061
ëҸ,MaoJiaGangZhen,421022113,47006,7019,30629,17158,59416,30608,6720,30086,60694,30116,60745
ʼҳ,GanJiaChangXiang,421022200,28588,3866,18466,10189,36415,18000,4840,18190,36190,18828,37294
,ZhangTianSiXiang,421022201,31548,4009,20123,10153,39489,20113,4983,20395,40508,20417,40540
ݳ,RongChengZhen,421023100,114397,12440,71429,45390,122560,69129,19194,71178,140307,74602,146031
,ZhuHeZhen,421023101,53953,8893,37083,21737,68322,35945,13640,37920,73865,39403,76486
¹,XinGouZhen,421023102,53998,7536,35065,19011,68713,32274,11145,34185,66459,37614,72679
,GongChangZhen,421023103,22663,4241,15774,10180,30460,15479,5854,16709,32188,16984,32758
,ZhouLaoZuiZhen,421023104,39862,5713,25979,13788,52070,25594,8637,27656,53250,28233,54212
Ъ,HuangXieKouZhen,421023105,41401,4832,26110,14088,52694,26057,8256,28312,54369,28379,54489
,WangQiaoZhen,421023106,41613,5767,28007,16274,54638,27706,10107,29014,56720,29480,57487
̼,ChengJiZhen,421023107,26274,4753,18452,11951,36830,18424,6696,19219,37643,19271,37723
,FenYanZhen,421023108,32121,4516,20950,11751,43587,20926,7899,23560,44486,23586,44536
ë,MaoShiZhen,421023109,29993,4933,21268,12050,41504,20905,9288,22813,43718,22946,44214
,FuTianSiZhen,421023110,23524,3325,15851,9043,30416,15475,6919,17602,33077,17917,33768
ϳ,ShangCheWanZhen,421023111,20863,3640,14757,8579,28944,14272,5957,15284,29556,15703,30460
,BianHeZhen,421023112,32220,5209,22164,13234,43137,21876,8971,23893,45769,24236,46400
߰,ChiBaZhen,421023113,37860,6475,27248,14586,53227,24283,10882,26291,50574,27969,55217
,BaiLuoZhen,421023114,29930,3932,20553,10378,37362,20340,8887,21792,42132,22196,42749
,WangShiZhen,421023115,26677,4884,18952,11492,34903,18702,7489,20018,38720,20098,39050
,SanZhouZhen,421023116,17214,3104,12344,8153,23905,12291,5301,13177,25468,13275,25619
,QiaoShiZhen,421023117,31908,4916,21299,10809,40993,20473,8717,22944,43417,24242,45541
,HongChengXiang,421023200,57827,8280,40041,22811,77629,37699,15191,40061,77760,41257,81298
,QiPanXiang,421023201,20146,3892,14228,8417,27587,13803,6218,15481,29284,16028,30256
ľ,ZheMuXiang,421023202,41721,5177,27578,13130,57521,27445,12170,31316,58761,31490,59068
,RenMinDaYuanGuanLiQu,421023450,24888,4625,17052,11858,32506,16691,4556,16626,33317,17017,34069
ĺ,HuangHuGuanLiQu,421023451,13665,2287,9217,5421,18035,9096,2708,9309,18405,9443,18660
,ZiShiZhen,421024100,16924,2581,11116,6615,21585,10699,2756,10660,21359,11145,22261
̲,TanQiaoZhen,421024101,16943,2090,10963,6552,20193,10783,2755,10623,21406,10825,21788
ܺ,XiongHeZhen,421024102,29793,3519,19338,10831,37529,19296,5377,19290,38586,19351,38689
,BaiMaSiZhen,421024103,31863,4541,20613,11780,40406,20555,5066,20763,41318,20857,41470
ɳ,ShaGangZhen,421024104,30397,4062,20111,11093,39146,19915,5877,19995,39910,20225,40336
ռ,PuJiZhen,421024105,24497,3053,15679,8249,30713,14867,4179,15111,29978,16050,31729
Ѩ,HaoXueZhen,421024106,36147,2939,22248,12523,28680,17916,5014,17824,35740,21852,44100
կ,MaJiaZhaiXiang,421024200,27091,3652,17801,10261,34563,17754,4657,17546,35300,17599,35400
,QinShiXiang,421024201,17370,2257,11273,6393,22556,10798,3440,11257,22055,11794,23067
,XuNiDiQu,421024450,9529,1048,3591,3194,5238,3527,792,3624,7151,7778,11369
,SanHuGuanLiQu,421024500,9574,1535,6265,3920,11959,5687,1348,5651,11338,6192,12457
,LiuHeYuanGuanLiQu,421024501,6603,1093,4369,2474,8415,4367,982,4306,8673,4309,8678
ֵֽ´,XiuLinJieDaoBanShiChu,421081001,59074,5640,38212,23008,56907,37380,10681,36199,73579,37183,75395
ʼɽֵ´,BiJiaShanJieDaoBanShiChu,421081002,65825,5737,41456,25790,62434,38281,11506,37653,75934,41612,83068
³,XinChangZhen,421081100,28893,3207,18252,9566,34090,17676,4242,17521,35197,18090,36342
ṵ,HengGouShiZhen,421081101,28220,3399,18106,9630,35047,17907,4432,17719,35626,17945,36051
,DaYuanZhen,421081102,38387,5061,24400,12684,46972,23861,5872,24118,47979,24920,49320
Сӿ,XiaoHeKouZhen,421081103,20361,2729,13346,7869,25958,13291,4188,13728,27019,13932,27278
һɽ,TaoHuaShanZhen,421081104,16739,1979,10563,5567,20751,10046,3130,10698,20744,11285,21848
,DiaoGuanZhen,421081105,29957,3817,19280,10859,34480,19243,5127,19567,38810,19621,38901
,DongShengZhen,421081106,41117,5392,26215,15971,48173,26051,6675,26754,52805,26969,53184
߻,GaoJiMiaoZhen,421081107,27305,3397,17260,9717,33619,16954,4535,17643,34597,17977,35237
Ͽ,NanKouZhen,421081108,21334,2500,13492,7106,26439,13181,3418,13408,26589,13760,27252
,GaoLingZhen,421081109,23171,2825,14732,8229,28394,14709,3780,14986,29695,15044,29776
ɽ,TuanShanSiZhen,421081110,22523,2942,14409,7848,28288,13709,3580,13896,27605,14636,29045
ú,JiuHeYuanXiang,421081200,19476,2492,12145,6670,24314,12130,2740,12544,24674,12563,24708
޿,TianEZhouKaiFaQu,421081500,7204,931,4887,2786,9238,4887,1482,4727,9614,4730,9617
µֵ̽´,XinDiJieDaoBanShiChu,421083001,99889,12275,61008,37939,114265,56245,15875,59458,115703,67031,128039
ֵ´,BinHuJieDaoBanShiChu,421083002,17918,2539,11512,7278,21431,11441,3563,12392,23833,12508,24020
ɽ,LuoShanZhen,421083100,25383,3210,16333,8445,33792,16291,5817,17973,34264,18077,34410
,WuLinZhen,421083101,34537,4389,21759,11534,43340,21726,6975,24103,45829,24142,45901
,LongKouZhen,421083102,32344,3460,19498,10984,41089,19462,5621,21882,41344,21927,41425
,YanWoZhen,421083103,25795,3435,16301,10342,33370,16291,4769,17656,33947,17698,33999
̲,XinTanZhen,421083104,27915,3625,17347,9643,33968,17262,3956,17908,35170,18149,35496
,FengKouZhen,421083105,59045,8315,37030,20315,69994,36261,11718,40710,76971,42048,79078
,CaoShiZhen,421083106,37347,5431,23086,12135,46687,23061,6650,26277,49338,26342,49428
,FuChangZhen,421083107,12217,1846,7740,4302,15652,7729,2317,8624,16353,8640,16380
ҳ,DaiJiaChangZhen,421083108,34997,5466,22245,11383,44783,22115,6709,24765,46880,24927,47172
ļ,QuJiaWanZhen,421083109,10671,1351,6594,3500,13390,6542,2025,7365,13907,7453,14047
ɳ,ShaKouZhen,421083110,33678,4429,20656,10697,42360,20496,5890,23141,43637,23341,43997
ȫ,WanQuanZhen,421083111,47544,6728,29837,14852,59617,28836,8751,31977,60813,33186,63023
,ChaHeZhen,421083112,36002,4549,22251,12014,45771,22214,6702,24944,47158,25002,47253
Ƽҿ,HuangJiaKouZhen,421083113,25865,3437,15811,9160,32432,15713,4166,17435,33148,17657,33468
,LaoWanXiang,421083200,7877,1215,5333,3528,10623,5316,1919,5657,10973,5678,11011
С۹,XiaoGangGuanLiQu,421083450,9297,1207,5805,3337,11538,5800,1402,6087,11887,6101,11906
ͬ,DaTongHuGuanLiQu,421083451,21329,3133,13458,8260,26512,13417,3216,14148,27565,14220,27678
ɳ,DaShaHuGuanLiQu,421083452,24524,3314,16032,9211,29980,15902,3877,15566,31468,15683,31715
½,XinJiangKouZhen,421087100,106621,11943,68897,35285,113624,51242,17359,49332,100574,67026,135923
Ϻ,NanHaiZhen,421087101,44248,6927,28762,16656,55803,26746,6472,26677,53423,28885,57647
˱,BaBaoZhen,421087102,53787,8071,34779,19272,64518,34023,7124,33553,67576,34203,68982
,WanShiZhen,421087103,38355,5421,24233,13251,47276,24177,5002,24414,48591,24545,48778
ϳ,LaoChengZhen,421087104,34474,5220,22107,12667,42951,21962,4704,22134,44096,22291,44398
µ,ChenDianZhen,421087105,25420,4420,16522,9966,32419,16146,3710,16416,32562,17028,33550
,WangJiaQiaoZhen,421087106,34775,5546,21873,12989,43509,21845,4459,22808,44653,22907,44780
˹ҳ,SiJiaChangZhen,421087107,20247,3064,13253,7089,25358,13235,3343,13349,26584,13401,26654
,YangLinShiZhen,421087108,32362,4403,20523,11057,40886,20430,4980,21050,41480,21222,41745
ֽ,ZhiChangHeZhen,421087109,27090,3843,17437,9727,33531,16436,4062,16375,32811,17558,34995
ֺ,JieHeShiZhen,421087110,27580,4458,18074,10559,34998,17739,4312,17950,35689,18276,36350
Σˮ,WeiShuiZhen,421087111,49629,7656,33107,19185,63322,33071,8898,32931,66002,33076,66183
ҳ,LiuJiaChangZhen,421087112,42100,6560,27886,16775,52693,25661,8001,25193,50854,28775,56661
ɳ,ShaDaoGuanZhen,421087113,25758,3531,16405,9861,30508,16358,3461,16260,32618,16345,32750
,WanJiaXiang,421087200,18077,2460,11635,6077,22563,11340,2985,11466,22806,11887,23522
жƺ,XieJiaPingTuJiaZuXiang,421087201,9475,1562,6192,3513,12610,6073,1956,6559,12632,6801,12993
ڽֵ´,ChiBiJieDaoBanShiChu,421102001,121483,12233,79096,50209,115684,71728,22295,71835,143563,76915,156011
ֵ´,DongHuJieDaoBanShiChu,421102002,17828,1507,10678,4993,16915,8296,2604,8660,16956,11261,21939
ֵ´,YuWangJieDaoBanShiChu,421102003,17515,2401,10583,6434,19568,10325,3061,10995,21320,12394,22977
Ϻֵ´,NanHuJieDaoBanShiChu,421102004,15177,665,6823,1742,5625,2559,751,2514,5073,9770,16593
·,LuKouZhen,421102100,15872,2651,10486,6562,19605,9802,3027,10195,19997,11064,21550
³,DuChengZhen,421102101,18945,3156,12367,8720,24566,12186,3315,12750,24936,13049,25416
²¥,ChenCeLouZhen,421102102,19006,3195,12532,7613,24859,12495,3655,13214,25709,13324,25856
յ,TaoDianXiang,421102200,14444,2563,9596,6577,18588,9522,2647,9939,19461,10058,19654
վ,HuoCheZhanKaiFaQu,421102450,3485,512,2230,1471,3050,2167,756,2170,4337,2523,4753
ƸԾÿ,HuangGangJingJiKaiFaQu,421102470,45936,1718,25173,9003,28953,12850,4366,13389,26239,26847,52020
ŷ,TuanFengZhen,421121100,54978,6705,34051,20741,59169,32000,9502,33580,65580,37134,71185
ɽ,LinShanHeZhen,421121101,43567,5928,27267,16161,55723,27004,7688,29454,56458,29916,57183
ƺ,FangGaoPingZhen,421121102,17047,2798,10851,7039,22089,10719,2966,11747,22466,11960,22811
ɽ,HuiLongShanZhen,421121103,24414,3992,15399,9604,31493,14690,3728,15912,30602,16735,32134
,MaCaoMiaoZhen,421121104,14704,2542,9302,6464,18773,9231,2394,10233,19464,10338,19640
ϰͺ,ShangBaHeZhen,421121105,22315,3385,14132,8992,28723,13576,4127,14766,28342,15695,29827
·,ZongLuJuZhen,421121106,18425,2688,11588,7297,22881,10923,2950,11603,22526,12475,24063
,DanDianZhen,421121107,30557,4659,19721,12288,39690,19565,6010,21162,40727,21505,41226
,JiaMiaoXiang,421121200,14832,2186,8830,5473,18552,8604,2099,9743,18347,10287,19117
Ƥ,DuPiXiang,421121201,14441,2002,8737,5105,18432,8481,2373,9566,18047,10079,18816
ƺũ,HuangHuNongChang,421121400,988,110,233,243,1080,232,39,255,487,904,1137
ũ,JinLuoGangNongChang,421121401,1143,150,741,370,1385,656,177,647,1303,729,1470
ǹ,ChengGuanZhen,421122100,90615,8799,59673,37628,90879,55013,20011,54786,109799,59752,119425
ƺ,QiLiPingZhen,421122101,61222,6558,38753,22099,79716,37176,13018,39665,76841,42045,80798
,HuaHeZhen,421122102,31686,4627,20947,13208,43050,20552,7491,21581,42133,22857,43804
,ErChengZhen,421122103,30739,3462,19273,10879,37647,17591,5457,18247,35838,20385,39658
¼,ShangXinJiZhen,421122104,26890,3042,16785,9413,34788,16073,5515,17585,33658,18662,35447
,GaoQiaoZhen,421122105,38862,4763,25236,15668,50658,24930,7258,25114,50044,25647,50883
ٶ,MiErZhen,421122106,24851,3346,15538,9464,31547,14887,3948,15394,30281,16607,32145
,BaLiZhen,421122107,23825,2747,15110,9712,29641,14699,4067,14905,29604,15529,30639
̫ƽ,TaiPingQiaoZhen,421122108,18219,2520,11461,7304,22935,11195,2693,11395,22590,11971,23432
,YongHeZhen,421122109,43260,5390,27104,15886,55513,26038,7394,26193,52231,28940,56044
ӻ,XingHuaXiang,421122200,65535,6361,41630,22583,74748,36486,14583,38033,74519,44849,86479
賡,HuoLianFanChaChang,421122500,1459,258,981,711,1913,907,332,911,1818,1068,2049
̨ɽο�,TianTaiShanLvYouKaiFaGuanLiChu,421122501,1020,109,650,396,1256,625,216,671,1296,695,1345
ɽ,FengShanZhen,421123100,90258,8825,55245,35816,104385,52679,15807,55407,108086,59645,114890
,LuoTuoAoZhen,421123101,26042,2898,15561,8597,31007,14116,4192,15320,29436,17571,33132
Ӱ,DaHeAnZhen,421123102,23528,3119,14531,8542,30425,14040,4178,15314,29354,16294,30825
ʺ,JiuZiHeZhen,421123103,23351,2828,13923,8273,29874,13547,3862,15452,28999,16118,30041
ʤ,ShengLiZhen,421123104,44578,4423,27508,16186,58816,27099,10218,30798,57897,31711,59219
,HePuZhen,421123105,38931,4086,23390,13515,50689,23176,7806,26921,50097,27433,50823
,SanLiFanZhen,421123106,43829,5256,27300,17319,56890,26495,8895,29162,55657,30680,57980
,BaiLianHeXiang,421123200,15026,1815,9271,5567,19298,9212,2744,9990,19202,10314,19585
,KuangHeXiang,421123201,45978,5799,27696,15841,59136,27006,7493,29930,56936,31574,59270
,BaiMiaoHeXiang,421123202,22832,2964,13463,8111,28928,12919,3408,14611,27530,15741,29204
ƽ,PingHuXiang,421123203,15397,1996,9240,5282,20153,8786,2890,10065,18851,11043,20283
,DaQiXiang,421123204,26881,3609,16878,9552,35339,15475,5428,17626,33101,19040,35918
ֳ̦,QingTaiGuanLinChang,421123500,681,91,424,339,865,417,111,441,858,459,883
կֳ,TianTangZhaiLinChang,421123501,894,128,553,403,1110,551,136,605,1156,605,1158
ֳ,BaoDaoFengLinChang,421123502,840,121,544,370,1122,538,184,592,1130,601,1145
ʨկֳ,HuangShiZhaiLinChang,421123503,218,29,126,94,294,126,47,157,283,168,294
Ȫ,WenQuanZhen,421124100,93414,9920,59806,35915,112649,57451,18335,59029,116480,61863,121669
Ϻ,NanHeZhen,421124101,11575,1902,7961,5239,15830,7952,2550,8007,15959,8066,16027
ɽ,HongShanZhen,421124102,14465,2456,9604,6298,19113,9204,2810,9466,18670,10127,19731
,JinJiaPuZhen,421124103,15702,2678,10860,7693,21387,10783,3685,11052,21835,11205,22065
ʯͷ,ShiTouJuZhen,421124104,24061,3818,15731,9390,31938,14495,4533,14961,29456,16681,32412
̵,CaoPanDiZhen,421124105,13065,2463,8886,5547,17885,8468,2580,8500,16968,9222,18108
׼ҵ,LeiJiaDianZhen,421124106,23211,4869,15517,9533,31048,13742,4199,13885,27627,16762,32279
,YangLiuWanZhen,421124107,30049,5992,21219,14697,40897,20312,6284,19956,40268,21106,42325
Ҿ,FangJiaJuXiang,421124200,18056,3478,12203,7445,24615,11670,3511,11987,23657,12842,25045
׼ҷ,KongJiaFangXiang,421124201,12966,3294,9695,6383,18627,9055,3058,8548,17603,9623,19318
ռҺ,TaoJiaHeXiang,421124202,5320,1176,3579,2326,7335,3214,981,3260,6474,3898,7477
һֳ,TaoHuaChongLinChang,421124400,319,62,202,153,383,193,45,195,388,224,426
ɽֳ,WuJiaShanLinChang,421124401,252,55,159,143,294,158,26,164,322,174,333
ɽֳ,WuFengShanLinChang,421124402,54,13,41,33,79,41,14,40,81,40,81
Ȫ,QingQuanZhen,421125100,149887,15232,95741,59769,176110,91418,28869,92610,184028,98247,193988
ͺ,BaHeZhen,421125101,83751,12016,55450,31991,111191,52921,17589,54138,107059,57906,113356
,ZhuWaZhen,421125102,50295,6407,32581,18321,65849,31517,10158,32739,64256,34279,66860
,WangGangZhen,421125103,35783,5770,24494,14361,48415,23743,8232,24242,47985,25291,49785
,TuanBeiZhen,421125104,58719,7748,38546,22930,77247,37934,12458,39168,77102,40379,78925
ؿ,GuanKouZhen,421125105,49735,10532,35245,22412,70231,32920,11585,33401,66321,36607,71852
,BaiLianZhen,421125106,10521,1697,7398,5057,14456,7336,2667,7319,14655,7487,14885
̺,CaiHeZhen,421125107,25523,4666,17731,9767,35147,16632,5373,16706,33338,17831,35562
ϴ,XiMaZhen,421125108,36409,5045,24685,13723,48392,23985,7858,23562,47547,24627,49312
˾,DingSiDangZhen,421125109,26129,3734,17678,11000,35218,17202,6059,17547,34749,18244,35922
ɢ,SanHuaZhen,421125110,44544,5463,29637,17525,58964,28866,10648,30021,58887,31018,60655
Ϫ,LanXiZhen,421125111,37651,4047,23072,12104,48178,21323,7094,22387,43710,25720,48792
ˮÿ,XiShuiJingJiKaiFaQu,421125170,17064,1354,10684,6310,15765,9659,3428,9260,18919,11162,21846
,LvYangXiang,421125200,16465,2224,10815,6360,21558,10687,3525,10990,21677,11399,22214
ߺֳ,CeHuYangZhiChang,421125400,4936,649,3287,1908,6533,3280,1126,3416,6696,3424,6711
ɽֳ,SanJiaoShanLinChang,421125401,1532,177,965,514,1944,917,275,927,1844,1019,1984
,CaoHeZhen,421126100,114399,10974,72997,43830,125721,70166,25227,73527,143693,77603,150600
ණ,ChiDongZhen,421126101,36190,5364,24158,13631,48066,23869,8112,24995,48864,25508,49666
ޭ,QiZhouZhen,421126102,47992,6526,32468,19297,63917,31527,12522,33260,64787,34572,67040
Ҥ,GuanYaoZhen,421126103,13867,2365,10288,6929,20251,10196,4315,10091,20287,10259,20547
˼,PengSiZhen,421126104,25112,3760,17750,10632,34356,17415,6697,17262,34677,17819,35569
ᳵ,HengCheZhen,421126105,48111,7293,34012,20914,64943,33873,13139,34271,68144,34531,68543
,ZhuLinZhen,421126106,20243,3998,15543,10367,30124,15336,6679,14874,30210,15377,30920
,LiuHeZhen,421126107,46724,6876,33548,19234,64103,30452,14156,29708,60160,34208,67756
ʨ,ShiZiZhen,421126108,27028,5055,20731,13698,41069,20411,10364,21068,41479,21716,42447
ʯ,QingShiZhen,421126109,34457,4786,24583,14669,49142,24363,10829,25119,49482,25489,50072
Ű,ZhangBangZhen,421126110,29390,4874,20471,13281,40006,19639,7801,20015,39654,21594,42065
ͬ,DaTongZhen,421126111,13516,2495,9552,6474,19072,9498,3613,9915,19413,10072,19624
̴,TanLinZhen,421126112,21167,3734,15110,10526,29854,14906,6035,15424,30330,15826,30936
,XiangQiaoXiang,421126200,26674,3882,17274,9701,36115,16936,6203,18752,35688,19485,36759
ũ,BaLiHuNongChang,421126450,6988,1424,5171,3652,9478,5111,1995,5107,10218,5236,10407
·ÿ,TieLuJingJiKaiFaQu,421126451,3436,516,2375,1452,4122,2309,902,2444,4753,2479,4854
÷,HuangMeiZhen,421127100,108535,10343,65635,35342,118303,58557,22610,63426,121983,75853,141488
¢,KongLongZhen,421127101,70939,9898,47678,22946,94584,45382,17706,47537,92919,50865,98543
С,XiaoChiZhen,421127102,72792,9633,47092,23952,92262,44782,15531,47598,92380,50864,97956
,XiaXinZhen,421127103,15628,2444,10497,5695,21303,9714,3873,9816,19530,11448,21945
,DaHeZhen,421127104,43646,5910,28342,14382,55290,25216,10203,26459,51675,31417,59759
ͣǰ,TingQianZhen,421127105,24158,3412,15785,7268,32652,14988,5753,15985,30973,17538,33323
,WuZuZhen,421127106,9201,1979,6875,4288,13654,6865,2791,7080,13945,7096,13971
媸,ZhuoGangZhen,421127107,45305,7094,31127,17368,64398,30353,12723,32401,62754,33995,65122
ɽ,CaiShanZhen,421127108,47478,8010,35052,19742,67260,34739,15680,35400,70139,36116,71168
¿,XinKaiZhen,421127109,39827,6014,26906,12378,55390,26150,10042,27396,53546,28977,55883
ɽ,DuShanZhen,421127110,19274,2834,13211,7153,26841,12701,5019,12975,25676,13916,27127
·,FenLuZhen,421127111,34152,5405,23126,11817,44332,22597,8315,23230,45827,24746,47872
,LiuLinXiang,421127200,8506,1574,5828,3756,12090,5635,2277,6043,11678,6529,12357
ɼľ,ShaMuXiang,421127201,23594,3900,16837,9916,33056,16634,6805,17042,33676,17462,34299
,KuZhuXiang,421127202,20007,2788,13197,6745,26906,12836,4839,13557,26393,14437,27634
,LiuZuoXiang,421127203,11103,1679,7952,4463,15345,7951,3137,7960,15911,7967,15919
Ų԰羰�,NuoBuYuanFengJingGuanLiChu,421127400,183,44,128,93,275,128,53,152,280,152,280
÷ũҵܹ˾,HuangMeiXianNongYeKaiFaZongGongSi,421127401,1083,255,777,496,1553,717,241,729,1446,802,1579
÷ũ,HuangMeiXianNongKeSuo,421127402,100,20,73,35,149,73,29,76,149,76,149
ϼբ´,YanJiaZhaBanShiChu,421127450,10742,1611,7394,4288,12666,7391,2840,7792,15183,7799,15193
«´,LuChaiHuBanShiChu,421127451,2102,375,1446,897,2746,1440,565,1584,3024,1596,3042
´,YangHuBanShiChu,421127452,1201,250,879,544,1731,878,358,930,1808,930,1809
ɳ´,ShaHuBanShiChu,421127453,3254,590,2204,1283,4140,2189,770,2361,4550,2410,4614
۰´,ChunGangBanShiChu,421127454,1764,291,1185,697,2104,1185,422,1292,2477,1292,2477
´,SaiHuBanShiChu,421127455,3428,586,2312,1372,4560,2312,767,2469,4781,2469,4781
´,QingNiHuBanShiChu,421127456,380,45,215,127,304,212,61,220,432,271,486
кҵ԰,LongGanHuGongYeYuanQu,421127457,30,0,9,0,0,0,0,0,0,21,30
ذ´,LongChiBanShiChu,421181001,53335,4947,33961,19199,55567,29818,10203,29688,59506,34524,68485
¥´,GuLouBanShiChu,421181002,63785,5573,39087,17160,66279,26348,11364,26499,52847,41635,80722
Ϻ´,NanHuBanShiChu,421181003,42502,4554,27278,15392,47436,24016,8545,24526,48542,28323,55601
й,ZhongGuanYiZhen,421181100,30501,5218,21319,15342,41358,21212,7199,21292,42504,21599,42918
β,SongBuZhen,421181101,37041,5448,24802,15984,48294,22756,7620,22053,44809,25307,50109
ͤ,QiTingZhen,421181102,14906,2643,10299,7226,20055,10085,2971,9937,20022,10221,20520
׹,BaiGuoZhen,421181103,45672,7332,30546,19954,59373,27328,8835,26793,54121,31293,61839
Ӻ,FuZiHeZhen,421181104,18364,3541,13026,8660,25769,12031,4565,12125,24156,13444,26470
ּҺ,YanJiaHeZhen,421181105,23409,2828,15543,10275,30942,15437,5060,15336,30773,15754,31297
ɽ,GuiShanZhen,421181106,26690,3830,17758,12545,35644,17579,6047,18273,35852,18809,36567
,YanTianHeZhen,421181107,22489,3913,15356,10739,31536,14852,5677,15651,30503,16723,32079
ż,ZhangJiaFanZhen,421181108,24815,4560,16994,13146,36390,16887,7691,19706,36593,20072,37066
ľӵ,MuZiDianZhen,421181109,26265,4306,17953,13368,37324,17663,7421,19137,36800,20039,37992
ӿ,SanHeKouZhen,421181110,29523,3804,19517,12607,39157,19226,6756,19961,39187,20566,40083
,HuangTuGangZhen,421181111,24957,3335,17132,12065,33511,16716,6221,16703,33419,17381,34513
,FuTianHeZhen,421181112,25274,4257,17959,12461,35534,17271,6638,16810,34081,18210,36169
,ChengMaGangZhen,421181113,35336,4148,23112,15081,46548,22278,8148,22979,45257,24520,47632
˳,ShunHeZhen,421181114,30718,4244,21908,15196,42377,21615,8271,20761,42376,21325,43233
Ÿ,TieMenGangXiang,421181200,28756,6088,20353,14115,39862,20322,5613,20045,40367,20104,40457
Ǹźˮ,MaChengFuQiaoHeShuiKu,421181400,139,14,80,61,152,77,22,67,144,95,175
βֳ,SongBuLiangZhongChang,421181401,466,120,338,268,537,337,87,332,669,335,673
ɽˮ,MaChengMingShanShuiKu,421181402,6,0,3,3,6,3,1,4,7,4,7
ˮ,MaChengSanHeShuiKu,421181403,151,5,30,22,94,19,8,47,66,134,164
ʨӷֳ,ShiZiFengLinChang,421181404,645,97,407,258,825,402,108,430,832,443,850
ֵ賡,MaChengLinDianChaChang,421181405,216,55,164,146,295,164,41,146,310,148,312
·,TieLuShengHuoQu,421181470,2360,60,1241,1067,2046,1200,355,1439,2639,1534,2775
ǿ,MaChengKaiFaQu,421181471,13752,684,7900,3063,11675,4581,2517,4790,9371,9053,16953
ɽ羰�,GuiShanFengJingQuGuanLiChu,421181472,1511,221,1031,794,2011,1007,376,1023,2030,1077,2108
ɽֳ,WuNaoShanLinChang,421181500,992,130,671,444,1265,629,199,582,1211,650,1321
Ѩ´,WuXueBanShiChu,421182001,122368,12138,74740,42974,125111,69259,27076,76291,145550,86842,161582
´,KanJiangBanShiChu,421182002,25234,3041,15957,8155,28965,15410,5751,17115,32525,18069,34026
´,TianZhenBanShiChu,421182003,13833,1671,8577,4365,17170,8063,3444,9044,17107,10371,18948
ɺ´,WanZhangHuBanShiChu,421182004,2748,626,1969,1511,3820,1958,709,2080,4038,2114,4083
÷,MeiChuanZhen,421182100,81297,11718,55146,30091,105748,53143,20232,54843,107986,58101,113247
ന,YuChuanZhen,421182101,34960,6069,24869,14181,48155,24744,9268,25227,49971,25428,50297
,HuaQiaoZhen,421182102,44561,6762,31587,17269,62659,31220,13367,32585,63805,33103,64690
,DaJinZhen,421182103,24273,3587,17416,8899,32621,17288,8061,18277,35565,18505,35921
ʯ,ShiFoSiZhen,421182104,28204,4685,21593,12992,40659,21479,11968,23081,44560,23264,44857
,SiWangZhen,421182105,20220,3790,15544,9299,29349,15521,8193,16601,32122,16659,32203
,DaFaSiZhen,421182106,32158,4236,22047,11069,42985,21881,10917,24933,46814,25264,47311
ƺ,LongPingZhen,421182107,27211,4004,17730,9799,35366,17533,5867,19071,36604,19352,37082
Ȫ´,WenQuanBanShiChu,421202001,98336,5409,60294,32367,75899,46499,16411,49001,95500,59862,120156
ɽ´,FuShanBanShiChu,421202002,37231,2446,22427,13060,31939,21873,8099,23276,45149,25349,47776
´,YongAnBanShiChu,421202003,71109,5232,45420,25775,62620,41171,15159,43204,84375,46080,91500
͡,TingSiQiaoZhen,421202100,15499,2616,10932,7477,20036,10894,4253,11318,22212,11436,22368
,XiangYangHuZhen,421202101,15021,1600,9930,5786,17557,9823,4207,10538,20361,10898,20828
ٲ,GuanBuQiaoZhen,421202102,22922,2721,15230,9839,24760,15085,6014,15933,31018,16427,31657
ṵ,HengGouQiaoZhen,421202103,24592,2523,15898,8837,28539,15308,6759,16999,32307,17976,33874
ʤ,HeShengQiaoZhen,421202104,10350,1487,6867,4085,12965,6829,2438,7328,14157,7408,14275
˫Ϫ,ShuangXiQiaoZhen,421202105,22501,3360,15965,9915,30897,15926,7415,17248,33174,17311,33276
,MaQiaoZhen,421202106,17020,2020,11602,7172,21212,11562,5317,12703,24265,12755,24357
,GuiHuaZhen,421202107,17541,1964,12366,6762,23087,12224,6241,13199,25423,13380,25746
,GaoQiaoZhen,421202108,10787,1583,7621,4982,14222,7579,3612,8269,15848,8361,15982
Ļ,DaMuXiang,421202200,16879,2151,12252,7306,23792,12080,6576,13050,25130,13354,25606
ţֳ,XiangYangHuNaiNiuLiangZhongChang,421202450,2258,158,1350,731,2535,1043,443,1163,2206,1509,2859
ÿ,XianNingJingJiKaiFaQu,421202570,809,5,242,97,1,62,19,108,170,591,833
̰ÿ,XianAnJingJiKaiFaQu,421202571,1304,3,819,246,2,313,117,340,653,605,1424
½Ϫ,LuXiZhen,421221100,13739,1766,8797,4787,17554,8701,2837,9341,18042,9545,18342
,GaoTieLingZhen,421221101,16644,2110,10582,5739,20932,10441,3377,11160,21601,11549,22131
,GuanQiaoZhen,421221102,16390,2738,10970,7247,20754,10875,3366,11312,22187,11524,22494
,YuYueZhen,421221103,92408,8395,56852,36628,84771,54858,16404,57791,112649,60355,117207
½,XinJieZhen,421221104,17546,2176,11063,5818,22012,10951,3273,11771,22722,11932,22995
,DuPuZhen,421221105,21147,2451,12950,6982,26375,12049,3672,13179,25228,14320,27270
˼,PanJiaWanZhen,421221106,32766,3915,20297,11781,40438,19810,5705,21434,41244,22089,42386
,PaiZhouWanZhen,421221107,30187,4102,19493,12008,38710,19464,5244,19992,39456,20040,39533
ͷũ,TouDunNongChang,421221450,4902,907,3293,2385,6317,3293,1029,3545,6838,3545,6838
ˮ,JunShuiZhen,421222100,79604,6413,51301,28926,72813,47737,18009,48778,96515,52725,104026
,MaiShiZhen,421222101,20217,2863,13711,7592,26996,12733,4928,13041,25774,14297,28008
,TangHuZhen,421222102,23443,2658,15698,8650,31242,15599,6229,16389,31988,16632,32330
ص,GuanDaoZhen,421222103,25627,3394,17333,9312,34298,16791,6516,17332,34123,18204,35537
ɳ,ShaDuiZhen,421222104,14178,1812,9708,5702,18611,9486,3838,9724,19210,10120,19828
,WuLiZhen,421222105,14835,2378,10629,6492,19973,10213,4309,10308,20521,10893,21522
ʯ,ShiNanZhen,421222106,14818,2350,10581,6098,20622,10265,4425,10511,20776,11012,21593
,BeiGangZhen,421222107,14778,2259,10698,6621,20360,10144,4384,10185,20329,10723,21421
,MaGangZhen,421222108,19592,3477,14258,8894,27778,14211,6057,14770,28981,14868,29126
ׯ,SiZhuangXiang,421222200,18656,2493,12437,6516,24795,12060,4621,12742,24802,13333,25770
ƺ,DaPingXiang,421222201,28270,3635,20022,11361,39447,19666,9108,20466,40132,20991,41013
¹ɽֳ,LuJiaoShanLinChang,421222500,166,23,109,97,212,109,37,117,226,117,226
ɽɭֹ԰�,XiShanSenLinGongYuanGuanLiChu,421222501,137,19,87,77,149,87,26,95,182,95,182
ֳ,HuangLongLinChang,421222502,89,8,45,52,79,45,15,57,102,67,112
ֳ,HuangPaoLinChang,421222503,23,6,11,18,27,11,0,16,27,18,29
ҩֳ,YaoGuLinChang,421222504,21,10,14,19,32,14,4,21,35,21,35
,TianChengZhen,421223100,98979,6153,63667,34739,88122,59331,23985,60534,119865,65450,129117
ɳƺ,ShaPingZhen,421223101,21819,2029,14225,7697,27180,14146,5470,14889,29035,15093,29318
ʯ,ShiChengZhen,421223102,26608,2622,18255,9663,33884,17847,6611,16930,34777,17586,35841
Ȫ,GuiHuaQuanZhen,421223103,5223,643,3519,2286,6678,3516,1465,3788,7304,3812,7331
,BaiNiZhen,421223104,34035,3216,23682,12830,42951,23621,9412,22834,46455,22981,46663
·,LuKouZhen,421223105,19132,2273,13770,8068,25297,13714,5511,12959,26673,13146,26916
,JinTangZhen,421223106,10578,1253,7499,4302,13354,7446,2716,6924,14370,7048,14547
ɽ,QingShanZhen,421223107,34397,2943,22515,11093,43576,22295,8378,22847,45142,23203,45718
Ф,XiaoLingXiang,421223200,20333,1933,13609,7423,26454,13560,5698,14279,27839,14355,27964
ͭ,TongZhongXiang,421223201,11748,1251,7931,4382,15450,7930,3175,8242,16172,8243,16174
ۿ,GangKouXiang,421223202,14725,1559,10294,5683,18914,10186,4155,9922,20108,10145,20439
,GaoJianXiang,421223203,6061,778,4100,2438,7953,4090,1738,4442,8532,4477,8577
�ÿ,ChongYangJingJiKaiFaQu,421223570,1643,63,1089,431,1063,767,312,799,1566,929,2018
ͨ,TongYangZhen,421224100,95501,6550,59411,31298,100830,54567,22090,57753,112320,64730,124141
,NanLinQiaoZhen,421224101,17201,2131,12356,7384,24132,12348,5957,12913,25261,12933,25289
ɳ,HuangShaPuZhen,421224102,19677,2568,13333,7728,26528,13237,5813,14329,27566,14725,28058
,ShaPuZhen,421224103,9194,1204,6359,4246,12610,6316,2733,6680,12996,6772,13131
Źɽ,JiuGongShanZhen,421224104,20555,2165,13565,7446,27330,13028,5564,13796,26824,14719,28284
,ChuangWangZhen,421224105,10778,1173,7064,4186,13932,6965,2953,7591,14556,7840,14904
,HongGangZhen,421224106,18535,1965,11961,7121,24643,11705,4691,12828,24533,13230,25191
,DaFanZhen,421224107,17916,1711,11021,5275,22385,10457,4143,11305,21762,12749,23770
·,DaLuXiang,421224200,18779,1553,12778,7021,24214,12660,5784,13205,25865,13338,26116
,YangFangLinXiang,421224201,8726,1078,6221,4000,12303,6182,2923,6436,12618,6506,12727
,YanShaXiang,421224202,16685,2058,11544,5794,22650,11477,4886,11944,23421,12085,23629
ȿ,CiKouXiang,421224203,9619,1348,6597,3586,13253,6595,2520,6878,13473,6890,13487
Źɽ羰,JiuGongShanFengJingQu,421224450,1692,187,1041,697,2032,887,421,981,1868,1259,2300
ͨɽؿ,TongShanXianKaiFaQu,421224570,52,0,15,24,0,6,0,22,28,37,52
ֵ߽´,PuQiJieDaoBanShiChu,421281001,92269,8447,56104,36058,83754,51505,17413,54818,106323,62025,118129
۽ֵ´,ChiMaGangJieDaoBanShiChu,421281002,63302,4316,38695,24792,42632,37170,13226,39791,76961,42149,80844
½ˮֵ´,LuShuiHuJieDaoBanShiChu,421281003,14028,1235,9089,4378,12720,6938,2543,7160,14098,8717,17806
µ,XinDianZhen,421281100,17055,2076,11217,6779,21715,11083,4055,11687,22770,11969,23186
,ZhaoLiQiaoZhen,421281101,17173,1885,11088,7112,20658,11061,3735,11615,22676,11705,22793
,ChaAnLingZhen,421281102,11588,1360,7346,4089,14569,7266,2468,7945,15211,8070,15416
,CheBuZhen,421281103,23923,2818,15078,8140,30262,13328,5335,14597,27925,16998,32076
,ChiBiZhen,421281104,14120,1760,8969,5309,18709,8705,3037,9542,18247,9948,18917
ɽ,LiuShanHuZhen,421281105,5421,729,3463,2252,6932,3443,1081,3731,7174,3768,7231
ɽ,ShenShanZhen,421281106,18839,2521,11668,6605,23978,11639,3486,13103,24742,13178,24846
л,ZhongHuoPuZhen,421281107,18440,2606,12173,7243,23708,11956,4015,12545,24501,12888,25061
,GuanTangYiZhen,421281108,35107,4178,22849,13782,44925,22643,8267,23869,46512,24703,47552
ƸǺ,HuangGaiHuZhen,421281109,3846,596,2545,1625,4937,2545,786,2671,5216,2683,5228
,YuJiaQiaoXiang,421281200,7443,1023,4911,3122,9953,4905,1956,5467,10372,5511,10422
ѷĹҵ԰,PuFangGongYeYuan,421281400,16563,1397,10895,8804,18623,10060,2557,8987,19047,9622,20517
ֳ,GuanTangYiLinChang,421281401,1768,214,1178,795,2229,1174,400,1201,2375,1204,2382
¥賡,YangLouDongChaChang,421281402,3087,234,1922,1264,2990,1897,549,1933,3830,1948,3870
׺,CangHuKaiFaQu,421281403,1613,172,1034,579,1967,1031,349,1080,2111,1100,2134
ǽֵ´,XiChengJieDaoBanShiChu,421303001,53720,4683,34447,24517,39674,33446,9609,32448,65894,33565,68012
ǽֵ´,DongChengJieDaoBanShiChu,421303002,82341,5597,50652,32907,64805,45517,13396,45113,90630,50682,101334
Ͻֵ´,NanJiaoJieDaoBanShiChu,421303003,51331,4759,31966,18852,44250,29255,8071,28807,58062,32195,64161
ֵ´,BeiJiaoJieDaoBanShiChu,421303004,51147,4250,31199,19838,50950,28652,7778,29421,58073,31976,63175
ί,ChengNanXinQuGuanWeiHui,421303005,12203,746,7044,2892,7667,4295,1268,4402,8697,7173,14217
,WanDianZhen,421303101,33256,3954,20831,11670,41746,20775,5376,21583,42358,21755,42586
ε,HeDianZhen,421303102,32101,4736,20516,12369,40484,19998,4994,20502,40500,21315,41831
,LuoYangZhen,421303103,24046,3351,15436,8600,30759,14909,4084,15336,30245,16045,31481
,FuHeZhen,421303104,33043,4678,21736,12064,43345,21692,6229,22105,43797,22214,43950
,XiHeZhen,421303187,84347,9774,53882,29912,103847,52285,13968,52430,104715,54207,108089
ÿ,CengDouQuJingJiKaiFaQu,421303499,13641,1239,8725,4944,14046,8212,2347,8010,16222,8502,17227
оÿ,SuiZhouShiJingJiKaiFaQu,421303587,18234,1279,10932,6097,15441,9552,3006,9392,18944,11587,22519
ɽ,LiShanZhen,421321101,46929,5943,30421,16682,56286,25693,7953,25156,50849,30404,60825
߳,GaoChengZhen,421321102,18305,2272,11301,6426,22595,11226,2560,11746,22972,11836,23137
,YinDianZhen,421321103,42711,4897,26605,14699,53156,24620,7403,26169,50789,28406,55011
ݵ,CaoDianZhen,421321104,18165,2119,11528,7362,23325,11478,3769,12391,23869,12525,24053
С,XiaoLinZhen,421321105,20279,2160,13306,7324,26371,13096,5225,13983,27079,14358,27664
,HuaiHeZhen,421321106,18095,1888,11568,6398,23562,11477,4344,12385,23862,12759,24327
,WanHeZhen,421321107,44809,5605,28145,16905,58798,27875,9073,30436,58311,31342,59487
,ShangShiZhen,421321108,32699,4113,20786,12178,41459,20673,5357,21124,41797,21383,42169
,TangXianZhen,421321109,60742,8146,38454,22371,77031,35725,9650,36584,72309,40084,78538
ɽ,WuShanZhen,421321110,20930,2744,12803,8278,25917,12398,3326,13206,25604,14197,27000
½,XinJieZhen,421321111,27920,3563,17844,10486,35798,17733,4623,17993,35726,18262,36106
,AnJuZhen,421321112,42435,5626,27105,15266,53651,25830,6632,25976,51806,27588,54693
̶,HuanTanZhen,421321113,40063,6867,26886,15196,53115,23522,6948,23591,47113,26992,53878
ɽ,HongShanZhen,421321114,50975,6578,32536,19083,60845,30781,7666,30934,61715,32683,65219
,ChangGangZhen,421321115,13351,1620,8235,4966,16618,8179,1989,8575,16754,8725,16960
,SanLiGangZhen,421321116,28707,3780,18011,11654,36015,17981,4701,19044,37025,19177,37188
,LiuLinZhen,421321117,15998,2273,10312,6514,20527,10118,2958,10428,20546,10917,21229
,JunChuanZhen,421321118,41570,5928,27025,15410,53830,26976,6869,27069,54045,27342,54367
򸣵,WanFuDianZhen,421321119,20297,2278,12998,5722,25439,10145,3304,10278,20423,12881,25879
Ӧɽֵ´,YingShanJieDaoBanShiChu,421381001,75676,6843,50116,32601,69460,48617,16068,46630,95247,48471,98587
ʮֵ´,ShiLiJieDaoBanShiChu,421381002,35574,4490,22963,12791,41838,22165,6602,22727,44892,23703,46666
ˮֵ´,GuangShuiJieDaoBanShiChu,421381003,59842,6153,37751,23270,64098,35066,9116,34682,69748,37360,75111
ʤ,WuShengGuanZhen,421381100,28062,3173,18125,9429,35157,15777,5775,16366,32143,18885,37010
կ,YangZhaiZhen,421381101,27309,3973,17727,10390,35463,17260,5419,18258,35518,18974,36701
,ChenXiangZhen,421381102,28473,4110,19557,10796,38434,19531,6653,19639,39170,19679,39236
,ChangLingZhen,421381103,49557,6321,33174,19381,64713,33137,10807,33395,66532,33511,66685
ƺ,MaPingZhen,421381104,23402,3286,15608,8523,28395,13324,4533,12967,26291,15613,31221
,GuanMiaoZhen,421381105,31919,4705,21043,11940,43579,20249,7282,21647,41896,22863,43906
,YuDianZhen,421381106,36865,5047,24373,14142,49129,24078,8061,25252,49330,25600,49973
,WuDianZhen,421381107,16814,2159,10746,5821,21774,10335,3410,10993,21328,11637,22383
µ,HaoDianZhen,421381108,19900,2774,12966,6868,26215,11847,4142,12301,24148,13850,26816
̺,CaiHeZhen,421381109,28330,3800,18301,10030,36967,18103,5643,19356,37459,19472,37773
ǽ,ChengJiaoXiang,421381200,38197,4199,23915,13328,41947,22525,6873,23853,46378,25354,49269
,LiDianXiang,421381201,22853,3380,15137,8630,30459,14714,4629,15075,29789,15725,30862
̫ƽ,TaiPingXiang,421381202,19878,2582,13006,7066,25895,12887,4169,13450,26337,13623,26629
,LuoDianXiang,421381203,27449,3565,17839,9688,35878,17284,5222,17567,34851,18397,36236
лɽֳ,ZhongHuaShanLinChang,421381400,97,19,60,65,106,60,12,68,128,68,128
̶羰,SanTanFengJingQu,421381401,535,80,330,237,605,320,103,347,667,388,718
ӽֵ´,WuYangBaJieDaoBanShiChu,422801001,137336,11146,86174,43931,101190,62238,20420,60544,122782,82728,168902
ֵͤ´,LiuJiaoTingJieDaoBanShiChu,422801002,40585,4960,27024,17356,36470,25286,8344,24913,50199,26865,53889
Сɴֵ´,XiaoDuChuanJieDaoBanShiChu,422801003,43448,4170,28605,19337,29867,27886,8776,26775,54661,27789,56394
,LongFengZhen,422801100,44903,6433,30280,17975,56242,28462,10526,29373,57835,31582,61862
ް,CuiBaZhen,422801101,23923,4098,16679,10864,33241,16026,6229,16549,32575,17571,34250
,BanQiaoZhen,422801102,9679,2004,6765,4778,13749,6753,2491,7336,14089,7409,14174
,SanChaXiang,422801200,21854,4133,15127,10024,29912,14913,4829,15241,30154,15689,30816
,XinTangXiang,422801201,24618,5275,18140,12214,36025,17720,7365,18089,35809,19118,37258
,HongTuXiang,422801202,24356,4187,18039,11586,35081,17986,7636,17987,35973,18140,36179
ɳ,ShaDiXiang,422801203,17688,3441,12919,9277,25221,12622,4890,12689,25311,13100,26019
ƺ,BaiYangPingXiang,422801204,35053,5515,24290,15104,48294,24255,9012,25167,49422,25290,49580
̫,TaiYangHeXiang,422801205,12692,2854,8671,6102,17776,8336,2729,8842,17178,9604,18275
ͱ,TunBaoXiang,422801206,26899,4668,19291,11920,38106,18842,7623,19134,37976,19899,39190
׹,BaiGuoXiang,422801207,14188,3118,10461,7261,20975,10153,4483,10648,20801,11328,21789
Ž,BaJiaoDongZuXiang,422801208,33954,6140,24368,15378,47524,23975,9781,24758,48733,25507,49875
ʢҰ,ShengJiaBaXiang,422801209,20787,3825,14804,10017,29801,14716,6047,15668,30384,15855,30659
帧´,MuFuBanShiChu,422801400,12988,2329,10162,6589,19381,10107,5146,10087,20194,10301,20463
ֵͤ´,DouTingJieDaoBanShiChu,422802001,61080,5319,40427,23231,48344,36753,14187,36158,72911,40159,80586
ǽֵ´,DongChengJieDaoBanShiChu,422802002,29797,2737,19867,11822,25773,19206,7467,19434,38640,20134,40001
ı,MouDaoZhen,422802100,25583,6013,21918,15676,42637,21796,12640,22008,43804,22318,44236
,BaiYangBaZhen,422802101,40847,7190,29176,17245,58283,27052,12734,28533,55585,31595,60771
Ӫ,WangYingZhen,422802102,39221,6512,30031,19589,57882,29796,15251,30419,60215,30953,60984
,JianNanZhen,422802103,28649,6133,22897,15317,46060,22270,12482,22894,45164,24367,47264
·,ZhongLuZhen,422802104,40535,6477,28663,18083,58133,27663,12527,29464,57127,30876,59539
ű,TuanBaoZhen,422802105,41935,6315,28476,17186,58468,28174,11330,30508,58682,31104,59580
,LiangWuXiang,422802200,28232,5265,21011,14058,40881,20649,9882,21363,42012,22368,43379
Ԫ,YuanBaoXiang,422802201,15018,2785,11148,7603,22214,10987,5264,11581,22568,11919,23067
ƺ,NanPingXiang,422802202,22825,3924,17577,11131,34299,17548,8844,17914,35462,18016,35593
Ķ,WenDouXiang,422802203,31209,5313,24178,15742,47021,24067,13493,25462,49529,25837,50015
ë,MaoBaXiang,422802204,16383,3352,13124,9254,25061,13071,6178,12588,25659,12789,25913
ɳϪ,ShaXiXiang,422802205,13426,2609,10673,7759,20958,10539,5639,10593,21132,11001,21674
ɽ̬ۺϿ,FuBaoShanShengTaiZongHeKaiFaQu,422802400,1046,185,722,499,1394,715,261,741,1456,770,1492
ҵ,YeZhouZhen,422822100,77981,10600,52664,32066,92727,50086,16258,49430,99516,52175,104839
ƺ,GaoPingZhen,422822101,31762,5383,21795,13835,42321,21757,6850,22086,43843,22200,43995
,HongYanZhen,422822102,14355,2055,9290,5475,18079,9107,2798,9558,18665,9918,19208
,JingYangZhen,422822103,25245,3529,16872,9432,34169,16773,6132,17693,34466,18034,34906
ٵ,GuanDianZhen,422822104,28070,5023,20792,13181,40267,20737,8415,20521,41258,20716,41508
,ChangLiangXiang,422822200,38168,7484,27455,18569,53008,27130,9346,26910,54040,27543,54998
é,MaoTianXiang,422822201,12751,2521,8833,5966,17247,8709,2976,9131,17840,9415,18248
ƺ,LongPingXiang,422822202,17079,2772,11441,7505,22323,11227,3729,11654,22881,12139,23580
,SanLiXiang,422822203,18695,4364,14680,10337,27988,14533,5810,13832,28365,14189,28869
ƺ,HuaPingXiang,422822204,29357,5917,20785,13897,40247,20294,6613,20466,40760,21102,41887
,XinLingZhen,422823100,46909,4833,30391,21253,43539,28192,9089,27954,56146,30440,60831
,DongRangKouZhen,422823101,16582,2342,11273,7862,21667,11153,3847,11232,22385,11498,22771
ضɺ,YanDuHeZhen,422823102,28524,5041,18587,13884,37068,18118,6042,19335,37453,21020,39607
ٶɿ,GuanDuKouZhen,422823103,30438,5385,21660,15853,40327,20627,8334,21346,41973,22497,44157
,ChaDianZiZhen,422823104,18428,3872,12973,10997,25257,12951,4210,13465,26416,13537,26510
̴,LvCongPoZhen,422823105,16944,2679,10455,7087,21366,10174,2910,11235,21409,12078,22533
֧ƺ,DaZhiPingZhen,422823106,11991,2194,8419,5856,16146,8192,2716,8012,16204,8482,16901
Ұ,YeSanGuanZhen,422823107,44755,6401,30131,20439,56585,28965,10077,29512,58477,31102,61233
ˮ,ShuiBuYaZhen,422823108,27856,4635,19081,12836,37459,18591,6520,18674,37265,19930,39011
̫ƺ,QingTaiPingZhen,422823109,21839,3931,15881,11332,30654,15828,5875,15625,31453,15764,31645
Ϫ,XiQiuWanXiang,422823200,26505,4159,17425,12631,32978,16399,5813,17163,33562,19052,36477
ƺ,JinGuoPingXiang,422823201,13616,2182,9546,6312,18132,9387,3366,9274,18661,9618,19164
ɽ,ZhuShanZhen,422825100,39829,4483,27029,16903,43477,26019,10182,25981,52000,27465,54494
԰,JiaoYuanZhen,422825101,16729,2481,11222,6952,22514,11100,4077,11754,22854,12065,23287
ɳ,ShaDaoGouZhen,422825102,37081,6303,26235,17761,52981,26163,11178,28010,54173,28327,54562
կ,WanZhaiXiang,422825200,16305,2850,11294,7521,22905,11213,4418,11884,23097,12279,23573
̶,ChangTanHeXiang,422825201,19858,3563,13952,9296,28066,13919,5680,15011,28930,15149,29101
Һ,LiJiaHeXiang,422825202,27944,4436,19958,10867,39980,19800,9071,21070,40870,21493,41451
,XiaoGuanXiang,422825203,23873,4310,16596,11879,33046,16457,6089,17402,33859,17676,34272
,GaoLuoXiang,422825204,27007,4339,18803,11681,38319,18719,7811,20191,38910,20354,39157
ľӪ,ChunMuYingXiang,422825205,7166,1225,4897,3528,9996,4865,2080,5495,10360,5574,10471
ɽ,GaoLeShanZhen,422826100,59856,7123,40190,24704,62652,36385,14241,36730,73115,41030,81220
ұ,ZhongBaoZhen,422826101,7014,1565,5270,3586,10334,5096,2225,5225,10321,5534,10804
,JiaMaChiZhen,422826102,29309,4550,20717,13273,41343,20170,9756,21641,41811,22898,43615
,ZhaoYangSiZhen,422826103,7029,1147,5270,3298,10074,5172,2525,5238,10410,5431,10701
ƺ,QingPingZhen,422826104,22804,4035,16085,11023,32181,15681,6429,16301,31982,17183,33268
կ,DingZhaiXiang,422826200,13947,2827,10472,6986,19798,10383,4329,10461,20844,10631,21103
ɽ,JianShanXiang,422826201,19509,3204,14359,9806,28042,14283,6329,14430,28713,14683,29042
ƺ,HuoLongPingXiang,422826202,19885,3141,14738,9392,29087,14636,6956,15057,29693,15244,29982
С,XiaoCunXiang,422826203,11823,1757,8415,5400,16733,8305,3579,8338,16643,8744,17159
ƽ,HuangJinDongXiang,422826204,10868,2161,8384,5825,15998,8357,3390,7937,16294,8035,16419
·,DaLuBaQu,422826400,4968,808,3490,2346,6951,3482,1529,3769,7251,3815,7305
,XiangFengZhen,422827100,69984,7410,47485,28961,81154,46067,16876,45457,91524,46785,94270
ٸ˾,BaiFuSiZhen,422827101,10544,1959,8488,5994,15854,8479,4228,8158,16637,8243,16731
,DaHeZhen,422827102,25244,4203,17780,12166,36426,17727,7784,19156,36883,19451,37231
ˮ,LvShuiXiang,422827200,11946,1449,8663,5114,16197,8634,3930,8600,17234,8662,17325
ˮ,ManShuiXiang,422827201,12161,1377,8463,4985,17038,8396,3827,8673,17069,8902,17365
˾,JiuSiXiang,422827202,21666,3804,15718,9710,31737,15264,6580,15430,30694,16332,32050
ճ,GeLeCheXiang,422827203,6249,1563,4908,3898,9703,4891,2230,5053,9944,5134,10042
,SanHuXiang,422827204,11720,2189,8750,5726,17405,8738,3947,9030,17768,9106,17856
,ZouMaZhen,422828100,32751,5409,20887,13723,41342,19965,6262,21373,41338,23535,44422
,RongMeiZhen,422828101,37229,4481,24839,16250,37126,22523,7921,22425,44948,24792,49631
¯,TieLuXiang,422828200,7914,1649,5652,3997,11223,5643,2096,5974,11617,6007,11659
,WuLiXiang,422828201,12432,2368,8308,5794,16464,8261,2518,8806,17067,9010,17318
,YanZiXiang,422828202,12767,2399,8437,6057,16966,8362,2630,9159,17521,9359,17796
ƺ,XiaPingXiang,422828203,8564,1499,5733,3947,11438,5654,1876,5849,11503,6206,11939
,WuYangXiang,422828204,9132,1640,5983,4052,12427,5860,2051,6390,12250,6840,12823
Ӫ,ZhongYingXiang,422828205,13988,2544,9580,6212,19221,9549,3222,10077,19626,10174,19754
̫ƽ,TaiPingXiang,422828206,9359,1808,6530,4554,12502,6395,2370,6593,12988,7007,13537
׷徭ÿ,HeFengJingJiKaiFaQu,422828400,697,56,503,333,538,493,260,493,986,510,1013
ɳֵ´,ShaZuiJieDaoBanShiChu,429004001,57424,5128,34072,22252,43615,32510,10038,35459,67969,38518,72590
ɺӽֵ´,GanHeJieDaoBanShiChu,429004002,115216,11418,69623,44265,109008,66968,20894,72901,139869,77905,147528
ɽ´,LongHuaShanBanShiChu,429004003,81714,7996,48971,28377,73946,45498,14450,48797,94295,55189,104160
֣,ZhengChangZhen,429004100,32369,5775,22194,15104,44262,22010,7054,22697,44707,23004,45198
ë,MaoZuiZhen,429004101,43933,5593,27527,15101,53339,26728,8037,28695,55423,30036,57563
,DouHeZhen,429004102,46240,6027,30043,16972,61172,29988,9555,31673,61661,31779,61822
̶,SanFuTanZhen,429004103,37140,6139,25848,17189,51522,25739,9292,26533,52272,26723,52571
,HuChangZhen,429004104,38108,6630,25862,17410,53113,25776,9738,28358,54134,28614,54476
ȿ,ChangTangKouZhen,429004105,54520,9628,35426,22732,71404,34746,10523,38330,73076,39245,74671
,XiLiuHeZhen,429004106,54926,8940,34514,23818,70735,34432,8605,37773,72205,37957,72471
ɳ,ShaHuZhen,429004107,24263,4159,15643,10119,30902,15637,4043,16806,32443,16822,32465
β,YangLinWeiZhen,429004108,41286,8304,27511,19524,55142,27173,7902,29345,56518,29981,57492
�,PengChangZhen,429004109,65108,8010,39095,22654,76849,37555,9606,41629,79184,43629,82724
Ź,ZhangGouZhen,429004110,43437,7231,28248,18318,56636,28132,8297,30598,58730,30717,58965
,GuoHeZhen,429004111,33289,6199,22160,14939,45079,22069,6824,24081,46150,24152,46312
ǻ,MianChengHuiZuZhen,429004112,12345,2053,8295,5561,16219,8140,2742,8493,16633,8845,17140
ͨ,TongHaiKouZhen,429004113,33795,4812,21723,13096,43131,21657,6328,23071,44728,23212,44935
³,ChenChangZhen,429004114,40256,5820,26576,15687,53881,26144,8965,27986,54130,28465,55041
ҹҵ԰,XianTaoGongYeYuan,429004400,17328,857,10368,4060,9243,6112,1885,6740,12852,9702,20070
źԭֳ,JiuHeYuanYuanZhongChang,429004401,2904,451,1870,1205,3830,1862,567,2028,3890,2052,3922
ɳԭֳ,ShaHuYuanZhongChang,429004402,4993,891,3254,2146,6394,3227,900,3487,6714,3530,6784
ź泡,PaiHuYuChang,429004403,1399,131,818,524,1462,802,218,869,1671,930,1748
泡,WuHuYuChang,429004404,1597,174,983,629,1798,936,278,1017,1953,1066,2049
ֳ,ZhaoXiYuanLinChang,429004405,299,66,210,167,426,209,64,219,428,219,429
ֳ,LiuJiaYuanLinChang,429004406,703,161,511,417,940,511,163,516,1027,516,1027
ֳ,ChuQinLiangZhongChang,429004407,666,132,446,329,545,446,134,483,929,486,932
԰ְ´,YuanLinBanShiChu,429005001,112634,8785,69490,44949,119175,66253,17974,66865,133118,69903,139393
а´,YangShiBanShiChu,429005002,34048,3801,21178,11279,41514,20983,5516,21906,42889,22187,43365
�´,ZhouJiBanShiChu,429005003,30254,3974,19223,10253,37215,18994,4709,19266,38260,19714,38937
㻪´,GuangHuaBanShiChu,429005004,6007,280,3852,2741,4126,3838,1400,3816,7654,3835,7687
̲,ZhuGenTanZhen,429005100,47981,5972,30248,15979,56485,29081,7419,29701,58782,31124,61372
,YuYangZhen,429005101,37799,4601,23879,13408,48224,23840,6716,25104,48944,25237,49116
,WangChangZhen,429005102,33380,3403,20726,10502,41051,19094,5587,19801,38895,21644,42370
ʯ,GaoShiBeiZhen,429005103,32034,3566,20045,11172,37818,19935,5184,20132,40067,20739,40784
ܿ,XiongKouZhen,429005104,34946,3889,22017,11660,43196,21947,5608,22272,44219,22426,44443
,LaoXinZhen,429005105,41702,4680,26245,13502,52402,25772,7218,26723,52495,27355,53600
ƿ,HaoKouZhen,429005106,45201,5296,28425,14407,55929,28417,6518,28581,56998,28590,57015
,JiYuKouZhen,429005107,27095,3247,17373,9242,33346,17123,4624,17360,34483,17593,34966
Ž,ZhangJinZhen,429005108,44608,5372,28951,14005,56886,25995,8580,26537,52532,29609,58560
,LongWanZhen,429005109,30187,3677,19433,9796,37804,18908,5394,19240,38148,19825,39258
ʯ͹,JiangHanShiYouGuanLiJu,429005400,62886,12363,44436,35625,72555,43261,11190,39692,82953,42003,86439
Ǳÿ,QianJiangJingJiKaiFaQu,429005401,17390,1755,10517,6694,20179,10443,2652,11155,21598,11280,21797
�,ZhouJiGuanLiQu,429005450,7973,855,5241,3082,8234,5229,1634,5217,10446,5221,10462
,HouHuGuanLiQu,429005451,18758,2654,12358,7593,23299,12199,3239,12121,24320,12293,24651
ܿڹ,XiongKouGuanLiQu,429005452,9890,1487,6728,3715,11181,6552,1647,6211,12763,6296,13024
ܿڹ,ZongKouGuanLiQu,429005453,25664,4638,17546,11977,33395,17417,4577,17121,34538,17333,34879
,XiDaYuanGuanLiQu,429005454,10099,1384,6475,3668,12277,6431,1424,6382,12813,6432,12907
,YunLiangHuGuanLiQu,429005455,9955,1577,6606,4291,12337,6559,1621,6476,13035,6547,13153
߳ԭֳ,GaoChangYuanZhongChang,429005456,5611,610,3579,2059,6257,3574,985,3612,7186,3627,7206
ƿԭֳ,HaoKouYuanZhongChang,429005457,2095,252,1337,769,2366,1335,300,1310,2645,1310,2647
޻ԭֳ,MianHuaYuanZhongChang,429005458,6619,547,4088,2324,5062,3640,1080,3801,7441,4158,8246
ֵ´,JingLingJieDaoBanShiChu,429006001,134883,14593,80835,39938,143458,58760,20258,61722,120482,88899,169734
žÿί,TianMenJingJiKaiFaQuGuanWeiHui,429006002,27041,2291,15978,8797,27454,15574,4436,17311,32885,17790,33768
ֵֽ´,YangLinJieDaoBanShiChu,429006003,21634,2753,13179,7697,27488,12878,3821,14696,27574,15029,28208
౦,DuoBaoZhen,429006100,56282,5862,35147,19824,70697,35081,9764,36591,71672,36761,71908
,TuoShiZhen,429006101,46213,4955,28689,16975,57486,28628,7179,29529,58157,29658,58347
Ÿ,ZhangGangZhen,429006102,60303,6260,36347,20348,73868,33701,9742,36554,70255,39958,76305
,JiangChangZhen,429006103,31283,3299,19750,10661,39831,19712,5407,20192,39904,20239,39989
,WangChangZhen,429006104,30320,3392,18815,10550,38491,18109,5513,19480,37589,20410,39225
н,YuXinZhen,429006105,44053,5376,27315,15677,55046,25683,7486,27443,53126,29600,56915
̶,HuangTanZhen,429006106,39708,4769,24187,13598,48932,23702,6277,26244,49946,26567,50754
,YueKouZhen,429006107,66739,9597,41871,25128,86934,39890,11759,43930,83820,46224,88095
,HengLinZhen,429006108,47622,5451,29523,16015,62868,29135,10548,33571,62706,34098,63621
,PengShiZhen,429006109,39106,4377,24036,12749,51833,23302,8587,27020,50322,28034,52070
,MaYangZhen,429006110,35799,4192,22103,12175,47496,21672,8032,25353,47025,25920,48023
,DuoXiangZhen,429006111,46810,5531,28453,15390,60056,27998,10055,32527,60525,33943,62396
,GanYiZhen,429006112,35076,5227,21526,12678,44661,20538,6298,23362,43900,25075,46601
,MaWanZhen,429006113,27765,3642,17032,9800,36319,16494,5225,18829,35323,19600,36632
¬,LuShiZhen,429006114,42800,6015,26101,13473,53090,24788,7080,27817,52605,29794,55895
С,XiaoBanZhen,429006115,25013,2843,15164,8098,31599,14699,4774,16644,31343,17466,32630
,JiuZhenZhen,429006116,56911,5739,33641,18304,71216,33445,9958,38797,72242,38967,72608
,ZaoShiZhen,429006118,53529,6872,32204,20216,62966,31070,7871,34020,65090,36068,68272
,HuShiZhen,429006119,23306,3214,13953,8047,30109,13371,3691,15380,28751,16258,30211
ʯ,ShiHeZhen,429006120,39141,4882,23807,13379,49585,23027,6148,25227,48254,26364,50171
ɽ,FoZiShanZhen,429006121,26248,2786,15574,8793,32904,14966,4120,16536,31502,17580,33154
̶,JingTanXiang,429006201,21352,2923,12973,7614,26722,12956,3580,14838,27794,14882,27855
ũ,JiangHuNongChang,429006450,14235,2137,9414,5564,18552,9408,2455,9406,18814,9413,18827
éũ,BaiMaoHuNongChang,429006451,5063,582,3150,1811,6391,3134,870,3329,6463,3365,6515
ί,ChenHuGuanWeiHui,429006452,163,2,49,32,0,39,19,47,86,135,184
ɰ,SongBaiZhen,429021100,24223,2997,14891,9089,28056,13176,3987,13765,26941,16316,31207
,YangRiZhen,429021101,7739,1103,4669,3123,9117,4586,1243,5136,9722,5416,10085
ľ,MuYuZhen,429021102,7107,991,4282,2818,7854,4006,991,4522,8528,4807,9089
ƺ,HongPingZhen,429021103,4446,789,2638,1581,5311,2406,666,2857,5263,3263,5901
»,XinHuaZhen,429021104,2832,453,1632,1066,3364,1562,403,1830,3392,2056,3688
,SongLuoXiang,429021200,5017,840,2931,1660,6177,2801,752,3335,6136,3678,6609
ź,JiuHuXiang,429021201,2682,460,1680,1034,3499,1657,515,1924,3581,1977,3657
¹ƺ,XiaGuPingTuJiaZuXiang,429021202,4508,638,2763,1749,5746,2749,758,3090,5839,3141,5904
·ֵ,WenYiLuJieDao,430102001,29939,4647,19619,12139,22906,16379,3375,15402,31781,18342,37961
ֵֽ,ZhaoYangJieJieDao,430102002,30376,4741,19440,12715,23601,16722,3396,16232,32954,19073,38513
²԰ֵ,JiuCaiYuanJieDao,430102003,32852,4773,21876,12563,27300,18111,4106,16862,34973,19855,41731
ֵֽ,LiuZhengJieJieDao,430102004,9617,1142,5997,3870,5386,4947,905,4670,9617,5667,11664
·ֵ,JieFangLuJieDao,430102005,7268,1038,4921,3270,4723,4176,750,3692,7868,4135,9056
ֵֽ,FuHouJieJieDao,430102006,9510,936,5862,3615,5208,4783,1027,4301,9084,5611,11473
ֵֽ,DouZhengJieJieDao,430102007,9911,1174,6284,3934,5131,5187,1042,4714,9901,5843,12127
ƽֵ,WuLiPaiJieDao,430102008,10480,1195,6470,4089,6352,5231,998,5017,10248,6203,12673
ǽֵ,HuoXingJieDao,430102009,24846,1936,14989,9882,13944,13406,3673,13481,26887,15466,30455
ѽֵ,MaWangDuiJieDao,430102010,86131,4431,51505,35522,38152,46802,14396,47302,94104,53453,104958
Ͷɽֵ,DongTunDuJieDao,430102011,55538,3426,34578,22658,23990,30856,9984,29723,60579,34370,68948
ֵ,XiangHuJieDao,430102012,26612,1947,16575,9901,12304,14370,4400,13778,28148,16384,32959
,DongAnXiang,430102200,96205,4718,52216,23487,38432,32098,10556,32895,64993,59263,111479
Ժ·ֵ,ShuYuanLuJieDao,430103001,24019,3067,16388,9652,18251,12949,2936,12252,25201,13634,30022
ӽֵֽ,PoZiJieJieDao,430103002,13243,1332,8332,5538,6719,7151,1425,6670,13821,7668,16000
ѧԺֵֽ,XueYuanJieJieDao,430103003,12311,1439,7616,5234,8089,6774,1308,6469,13243,7442,15058
·ֵ,ChengNanLuJieDao,430103004,29670,4213,18737,12429,25535,16707,2975,16147,32854,18121,36858
ԣϽֵֽ,YuNanJieJieDao,430103005,55411,6752,34735,23908,45681,31399,6642,30618,62017,34070,68805
ֵ,JinPenLingJieDao,430103006,82888,8426,48715,30461,67510,40655,9977,40337,80992,52576,101291
¿ֵ̽,XinKaiPuJieDao,430103007,90780,6113,51213,27383,51954,35128,9552,35409,70537,55232,106445
԰ֵ,QingYuanJieDao,430103008,31929,1561,21603,10688,21867,13878,3982,13717,27595,15869,37472
ƺֵ,GuiHuaPingJieDao,430103009,11198,482,6393,2703,4372,3966,1246,3863,7829,6533,12926
,DaTuoZhen,430103100,39576,3769,24132,15466,31627,21641,6999,21659,43300,26212,50344
ºֵ,WangYueHuJieDao,430104001,27404,3826,17866,12099,22829,16058,3813,15313,31371,17177,35043
´ֵ,YueLuJieDao,430104002,69340,5197,37921,17099,51890,23364,6830,22496,45860,43446,81367
޽ֵ,JuZiZhouJieDao,430104003,72001,4738,39685,14187,46965,18551,4350,17795,36346,41404,81089
ֵ,YinPenLingJieDao,430104004,43022,4207,27029,16451,31782,22651,5765,21972,44623,25965,52994
ɳֵ,GuanShaLingJieDao,430104005,40307,3473,25860,17153,27689,24857,7544,24059,48916,25464,51324
½ֵ,WangChengPoJieDao,430104006,54116,2570,32668,16988,29872,23130,7592,23508,46638,31610,64278
ֵ,XiHuJieDao,430104007,36529,2484,22490,14905,18536,17965,4593,17975,35940,21116,43606
̼κֵ,XianJiaHuJieDao,430104008,33439,1617,21896,10177,15691,13406,4478,13390,26796,17638,39534
ֵ,WangYueJieDao,430104009,22009,1788,13312,8055,11880,12288,4015,11921,24209,14500,27812
÷Ϫֵ,MeiXiHuJieDao,430104010,5942,541,3993,2501,4972,3848,1588,3793,7641,4078,8071
´Ƚֵ,LuGuJieDao,430104011,68990,1225,40357,7754,13786,11159,3988,10799,21958,33846,74203
,DongFangHongZhen,430104100,6659,788,4475,2876,8042,4419,1567,4386,8805,4539,9014
,LianHuaZhen,430104102,27628,4369,18503,12815,35826,18322,6142,18600,36922,19636,38139
ƺ,PingTangZhen,430104103,40610,5494,27101,17543,51945,27039,8331,27036,54075,27334,54435
,HanPuZhen,430104104,57343,3942,32430,13220,38703,20620,7100,21022,41642,35955,68385
골ƺ,YuChangPingZhen,430104105,18496,3286,12922,8702,25203,12901,4136,12929,25830,12996,25918
춥,TianDingXiang,430104201,37515,2882,24411,12175,21031,17727,6172,17921,35648,22158,46569
ܽر·ֵ,FuRongBeiLuJieDao,430105001,28714,1320,17009,11875,15156,15445,5270,16101,31546,18295,35304
·ֵ,DongFengLuJieDao,430105002,39292,5978,24781,17644,33933,22704,4404,22152,44856,24893,49674
ˮֵ,QingShuiTangJieDao,430105003,21001,2977,13280,7059,14047,10298,2293,9750,20048,12991,26271
´԰ֵ,WangLuYuanJieDao,430105004,35472,4760,23365,14648,26202,18881,3648,17673,36554,20515,43880
·ֵ,XiangYaLuJieDao,430105005,38929,5611,24103,16154,32090,21083,3552,20831,41914,23989,48092
ֵ,WuJiaLingJieDao,430105006,49416,4835,28241,20178,37458,26551,6266,26144,52695,32276,60517
ºӽֵ,XinHeJieDao,430105009,33274,3588,18855,12569,23344,17150,3627,17004,34154,21634,40489
ֵֽ̩ͨ,TongTaiJieJieDao,430105010,36449,4372,21647,15854,25124,19876,3279,19318,39194,22453,44100
ķƺֵ,SiFangPingJieDao,430105012,51483,4230,32319,22769,29643,30603,8773,29739,60342,32167,64486
ɽֵ,HongShanJieDao,430105013,53176,2590,30165,14782,25653,22300,6978,22344,44644,32579,62744
̵,LaoDaoHeZhen,430105100,39352,4391,25260,15926,43855,23715,7633,23777,47492,26116,51376
¸,XinGangZhen,430105101,21547,1897,13466,7327,17124,10725,4024,10414,21139,14002,27468
,QingZhuHuZhen,430105102,9933,1014,6355,3218,9963,5425,1818,5211,10636,6410,12765
ֵ,HouJiaTangJieDao,430111001,50257,7990,31728,20648,51762,27960,5787,27767,55727,32306,64034
ֵ,ZuoJiaTangJieDao,430111002,103392,12108,63778,48582,93311,60809,13141,59774,120583,64863,128641
ֵ,GuiTangJieDao,430111003,44444,3918,25937,14906,24632,20301,6367,20246,40547,28792,54729
ɰֵ,ShaZiTangJieDao,430111004,46656,5560,29797,20165,44667,26600,6359,26078,52678,28778,58575
ֵ,DongTangJieDao,430111005,28759,3922,19004,13458,26578,17323,4422,16787,34110,18099,37103
껨ֵͤ,YuHuaTingJieDao,430111006,138722,9600,86530,51052,84384,68186,21921,67618,135804,83713,170243
Žֵ,GaoQiaoJieDao,430111007,60816,1997,34453,24516,21002,31126,9778,32735,63861,38138,72591
,DongJingZhen,430111100,59618,3761,36263,20427,30247,29127,10036,29659,58786,37152,73415
,LiTuoXiang,430111200,52598,2568,30008,17360,30894,24978,9551,24720,49698,34709,64717
ɳֵ´,XingShaJieDaoBanShiChu,430121001,104096,3397,62542,30992,29118,40748,14867,41036,81784,59818,122360
Ȫֵ´,QuanTangJieDaoBanShiChu,430121002,60725,1428,28309,14510,9795,17367,6079,18960,36327,39923,68232
ֵ´,XiangLongJieDaoBanShiChu,430121003,76908,1452,34797,16249,13328,21752,8082,22747,44499,51645,86442
ĺ,MuYunZhen,430121101,54778,4799,29301,12841,30979,21288,6665,20806,42094,36941,66242
,HuangXingZhen,430121102,37918,4761,24476,14213,41661,23883,7645,24449,48332,25848,50324
,LangLiZhen,430121103,29152,2644,16589,9102,23915,14101,4483,13786,27887,19690,36279
,JiangBeiZhen,430121104,38778,6450,25678,15425,50524,25081,7770,26147,51228,27320,52998
ƻ,HuangHuaZhen,430121105,63392,7479,40445,23199,70645,36534,11765,36599,73133,42191,82636
,ChunHuaZhen,430121106,26432,4491,18032,11537,34391,17874,5914,18435,36309,18805,36837
԰,GuoYuanZhen,430121107,16089,2341,10609,6519,20873,10426,3135,10724,21150,10956,21565
·,LuKouZhen,430121108,16967,2945,11427,7414,20689,10942,3337,10758,21700,11822,23249
,GaoQiaoZhen,430121109,15583,3199,10798,7849,21143,10656,3126,10871,21527,11110,21908
,JinJingZhen,430121110,23954,4374,16603,11274,31749,16399,4976,16486,32885,16701,33304
,FuLinZhen,430121111,16488,3143,11344,7992,21639,11311,3194,11416,22727,11481,22825
ɽ,QingShanPuZhen,430121112,13199,1994,8719,5078,16480,8604,2287,8613,17217,8761,17480
ɳ,AnShaZhen,430121113,39617,5235,25735,15374,41218,21606,6267,21898,43504,25384,51119
ɽ,BeiShanZhen,430121114,33947,5631,22245,14511,43811,21907,5898,22773,44680,23231,45476
˫,ShuangJiangZhen,430121115,10540,2056,7659,5427,14440,7552,2714,7502,15054,7651,15310
,TiaoMaXiang,430121200,46538,5857,28307,16186,50754,26553,9026,27672,54225,33114,61421
ɼ,GanShanXiang,430121201,24473,2488,14781,6928,21818,11188,3548,11392,22580,15728,30509
ɳ,BaiShaXiang,430121203,11566,2120,8077,5186,15639,8030,2436,7926,15956,8045,16122
,KaiHuiXiang,430121204,12048,2231,8565,5482,16431,8540,2555,8215,16755,8269,16834
,GaoTangLingZhen,430122100,58813,4838,34570,19260,44519,28428,8520,28748,57176,37601,72171
,QiaoYiZhen,430122101,23234,3817,15446,10401,29064,15109,4313,15348,30457,15918,31364
,DingZiZhen,430122102,28129,4119,18452,11714,34882,18232,4993,18051,36283,18789,37241
ͤ,ChaTingZhen,430122103,21115,3358,13796,8910,26766,13585,4040,14148,27733,14717,28513
,DongChengZhen,430122104,9632,1902,6651,4518,13292,6643,2042,6869,13512,6925,13576
ͭ,TongGuanZhen,430122105,14956,2968,9923,7738,18487,9822,2132,9813,19635,10133,20056
,JingGangZhen,430122106,21639,3677,14266,7492,27361,13973,3738,14284,28257,14788,29054
ǿ,QiaoKouZhen,430122107,22186,3489,14861,8109,28951,14766,4393,15096,29862,15207,30068
ɽ,WuShanZhen,430122108,23488,4126,15791,9816,30651,15480,4798,15944,31424,16621,32412
ǳ,XingChengZhen,430122109,35476,3999,23015,13745,40563,22340,7457,21990,44330,23917,46932
׷,LeiFengZhen,430122110,36293,2646,21797,11236,25238,16311,5667,16499,32810,22809,44606
,BaiRuoPuZhen,430122115,28601,4221,18923,11919,36581,18665,5996,19274,37939,19895,38818
ƽ,HuangJinZhen,430122116,39014,3557,24905,10205,30848,16259,5400,16749,33008,23066,47971
,GeTangXiang,430122200,15954,3070,11514,6975,21811,11471,3579,11045,22516,11089,22603
¿,XinKangXiang,430122201,21040,3467,13585,7743,26727,13471,3768,13929,27400,14690,28275
̶,YuTanZhen,430124100,74979,7142,47240,28851,64723,41876,12652,39732,81608,47533,94773
,DaoLinZhen,430124101,31164,5711,21906,15167,43594,21903,7442,22406,44309,22411,44317
¥,HuaMingLouZhen,430124102,26902,5236,19515,13010,35525,18306,6480,17899,36205,19103,38618
,DongHuTangZhen,430124103,26219,5410,19011,12814,37250,18936,6561,19034,37970,19179,38190
,XiaDuoPuZhen,430124104,25754,4025,16829,10279,31090,15981,5463,16328,32309,18413,35242
˫,ShuangJiangKouZhen,430124105,27920,4707,19263,12177,38638,19263,6377,19741,39004,19741,39004
ú̿,MeiTanBaZhen,430124106,30895,4638,20905,13967,38816,20842,6752,20806,41648,21380,42285
,BaTangZhen,430124107,27171,4783,18890,11580,37078,18838,6098,19032,37870,19162,38052
,XieLeQiaoZhen,430124108,18961,3839,13714,8516,26836,13601,4474,13382,26983,13560,27274
,HuiTangZhen,430124109,13887,2438,9775,6252,17959,9472,3392,9082,18554,9942,19717
˫,ShuangFuPuZhen,430124110,23309,4254,16377,10395,31947,16120,5425,16253,32373,16611,32988
,LaoLiangCangZhen,430124111,26911,6541,21288,14779,40591,21045,8935,20691,41736,21099,42387
ɳ,LiuShaHeZhen,430124112,31990,7268,24401,16223,48086,24183,9714,24243,48426,24571,48972
ӿ,XiangZiKouZhen,430124113,21347,4829,17013,11376,32565,16991,7387,16509,33500,16550,33563
,LongTianZhen,430124114,11666,2434,8800,5847,17026,8725,3689,8725,17450,8989,17789
,HengShiZhen,430124116,28101,5463,20697,12986,40260,20558,7824,20509,41067,20691,41388
,HuiLongPuZhen,430124117,24996,3945,17142,10424,33642,17129,5699,17476,34605,17498,34640
Ʋ,HuangCaiZhen,430124118,31729,6843,23786,16163,46665,23747,9145,23852,47599,23931,47717
,DaChengQiaoZhen,430124119,18631,3523,13528,9055,26076,13516,4681,13238,26754,13307,26835
ɽ,QingShanQiaoZhen,430124120,21904,5931,17365,12602,33985,17299,6792,17097,34396,17262,34627
,JinZhouZhen,430124121,23205,3035,14422,8737,27825,13930,4602,14414,28344,16420,30842
Ӫ,DaTunYingXiang,430124200,24474,4803,17405,11601,33688,17015,5689,17138,34153,17561,34966
,ZhuLiangQiaoXiang,430124202,18011,3372,12951,8766,25444,12864,4857,13100,25964,13289,26240
ݼ,JingHuaPuXiang,430124203,20922,3209,14330,8874,28127,14249,5033,14699,28948,14834,29164
ƺ,NanTianPingXiang,430124205,14317,3078,10616,7403,20627,10495,3638,10218,20713,10417,21033
ʸ,ZiFuXiang,430124206,20881,4391,15387,9979,30092,15352,5302,15115,30467,15187,30574
ľ,FengMuQiaoXiang,430124207,20148,4191,15098,9971,29634,15012,5904,14998,30010,15145,30243
,YuJiaAoXiang,430124209,23874,4308,16766,10825,33429,16586,5793,16863,33449,17209,33975
ɳ,ShaTianXiang,430124213,14417,3720,11650,8206,22261,11637,4701,11123,22760,11188,22838
,BaiMaQiaoXiang,430124215,26561,2150,17254,11887,20991,15813,5868,15858,31671,17325,34579
,LiJingPuXiang,430124216,22372,2504,14403,8723,24554,13748,4557,13719,27467,15030,29433
ǽ,ChengJiaoXiang,430124217,40851,3363,24528,14242,32869,20557,7245,20722,41279,26931,51459
ɽ,WeiShanXiang,430124218,7865,2100,6067,4322,11938,5992,2449,6168,12160,6347,12414
ֵ,HuaiChuanJieDao,430181001,52743,5552,34614,22085,43748,31886,9479,30544,62430,33160,67774
ֵ,JiLiJieDao,430181002,42056,3313,26335,16374,28807,25089,8307,25253,50342,27341,53676
ɻֵ,HeHuaJieDao,430181003,35758,4538,23866,13610,40098,23613,8119,24074,47687,24549,48415
ؿڽֵ,GuanKouJieDao,430181004,20497,2305,13445,6068,22552,11661,4127,11759,23420,13484,26929
,SheGangZhen,430181102,27092,4339,18553,11509,36444,18206,6807,19220,37426,19685,38238
ٶ,GuanDuZhen,430181104,18875,2873,12899,7501,26123,12610,4753,13225,25835,13602,26501
ŷ,ZhangFangZhen,430181105,17151,2709,11223,7379,22928,11087,4275,12187,23274,12912,24135
,DaHuZhen,430181106,15607,2436,10440,6553,21367,10345,3705,11185,21530,11308,21748
Ϫ,YanXiZhen,430181107,20587,2795,13570,7488,27816,13529,4790,14554,28083,14602,28172
Ÿ,GuGangZhen,430181108,25047,3625,16965,9480,33483,16282,6095,17206,33488,17802,34767
,YongHeZhen,430181109,13152,2156,8743,5887,16981,8621,2923,9037,17658,9488,18231
,DaYaoZhen,430181110,42169,4511,28196,15077,55612,28025,10870,29107,57132,29354,57550
,JinGangZhen,430181111,39231,4488,26694,13531,53259,26648,11038,27935,54583,28063,54757
ļ,WenJiaShiZhen,430181112,32086,3889,21886,11375,44422,21197,9607,22277,43474,23696,45582
̫ƽ,TaiPingQiaoZhen,430181113,15153,2318,10047,5289,19235,9508,3203,10020,19528,10627,20674
ǳ,ChengChongZhen,430181114,29465,4917,19801,11103,40964,19782,6665,21206,40988,21246,41047
ͷ,ZhenTouZhen,430181115,37929,6238,25244,15245,48706,24466,7140,25188,49654,26063,51307
ռ,PuJiZhen,430181116,23255,5016,15940,10476,32238,15812,4807,16857,32669,17138,33078
,YongAnZhen,430181117,43791,5948,28149,16168,53670,27370,8754,27892,55262,30344,58493
ʢ,BeiShengZhen,430181118,33959,5430,23314,13792,46472,23020,7769,23327,46347,23844,47158
,LongFuZhen,430181120,25768,4750,18078,12025,35738,17914,6290,18483,36397,18730,36808
̶,ChengTanJiangZhen,430181121,39869,4845,27012,14635,54921,26936,11453,28994,55930,29155,56167
к,ZhongHeZhen,430181122,12426,2151,8498,5191,17505,8464,3511,9510,17974,9590,18088
ؼ,BaiJiaZhen,430181123,14839,2154,9891,6359,19698,9888,3048,10144,20032,10150,20041
,DongYangZhen,430181124,31362,3841,20380,10394,33506,17362,6166,17752,35114,20989,41369
Χɽ,DaWeiShanZhen,430181125,14168,2542,9552,7172,19545,9501,3332,10382,19883,10490,20042
ɳ,ShaShiZhen,430181126,43797,6728,28842,16677,58670,28694,8615,29834,58528,30298,59140
,ChunKouZhen,430181127,38442,6382,26336,16428,52623,26170,9017,27181,53351,27505,53841
ƺ,GaoPingZhen,430181128,21820,3569,15048,8886,30886,14940,5940,16178,31118,16281,31329
,SanKouZhen,430181129,12912,2122,8949,5188,17889,8812,3354,9169,17981,9439,18388
,GuanQiaoZhen,430181130,18067,3104,11887,7060,23744,11727,3278,12146,23873,12562,24449
С,XiaoHeXiang,430181201,7406,1493,5249,3695,10837,5187,2223,5725,10912,5873,11122
߱ɽ,QiBaoShanXiang,430181202,8268,1378,5444,3933,11223,5411,1849,5939,11350,6051,11495
Ϫ,XiJiangXiang,430181205,13608,2042,9218,5108,18641,9179,3410,9671,18850,9842,19060
,YangHuaXiang,430181206,14688,1997,10011,5374,20530,9955,4196,10765,20720,10870,20881
,GeJiaXiang,430181207,11501,2422,7835,5011,15655,7773,2399,8347,16120,8487,16322
Ϫ,JiaoXiXiang,430181211,15746,2746,10860,6884,21542,10732,4203,11230,21962,11835,22695
ֵ,YueTangJieDao,430202001,89861,5104,52553,25782,34257,35340,10696,36457,71797,53108,105661
Ĺֵ,CiGuTangJieDao,430202002,47808,6737,30502,23054,39984,29547,7802,30160,59707,31845,62347
μŽֵ,SongJiaQiaoJieDao,430202003,16846,2457,11029,8382,16907,10893,3115,10882,21775,11389,22418
𻨽ֵ,GuiHuaJieDao,430202004,30193,3174,17988,12615,23062,16925,5047,17336,34261,20426,38414
ɽֵ,JinShanJieDao,430202005,29036,2202,18160,11370,18989,16401,5361,17029,33430,18439,36599
,XianYuZhen,430202100,12906,1963,8479,5044,16513,8418,2516,8697,17115,8906,17385
,MingZhaoXiang,430202201,20027,2489,12791,7596,23625,12533,3721,12687,25220,13446,26237
ؼֵ,HeJiaTuJieDao,430203001,28283,5248,19156,14233,29711,18317,4144,17958,36275,18519,37675
ֵ,JianSheJieDao,430203002,19849,3049,12559,8055,14970,11113,2045,9998,21111,12384,24943
ֵ,JianNingJieDao,430203003,20142,804,11879,7202,5768,10250,2925,10791,21041,11992,23871
Ҷνֵ,DongJiaDuanJieDao,430203004,29457,6409,19681,14680,37654,19237,4856,19835,39072,21041,40722
ƽֵ,QingYunJieDao,430203005,33454,3105,21370,14347,23368,20641,6448,20848,41489,21637,43007
Ϫֵ,FengXiJieDao,430203006,10396,1429,6690,4483,11825,6348,1802,6347,12695,6937,13627
Ȫֵ,LongQuanJieDao,430203007,46319,2449,28954,13501,20151,20293,6170,20515,40808,25984,54938
,WuLiDunXiang,430203201,6886,691,4204,2323,6936,4033,1158,4005,8038,4531,8735
Ľֵ,TianXinJieDao,430204001,54870,6538,30345,18922,47298,24065,5770,25454,49519,36833,67178
ʯֵ,XiangShiLingJieDao,430204002,58152,7081,35727,26426,57795,34522,8906,35579,70101,38412,74139
ˮֵ,QingShuiTangJieDao,430204003,41327,5830,25341,17825,40043,22628,5735,23913,46541,27551,52892
ֵͭ,TongTangWanJieDao,430204004,29408,3219,17282,11760,26253,16194,4298,16889,33083,19643,36925
ֵ,JingLongJieDao,430204005,14621,1505,8429,5622,14692,7895,2329,8072,15967,10026,18455
ͷ,LongTouPuZhen,430204100,9457,1259,6061,3806,11148,5917,1667,5997,11914,6322,12383
,YunTianXiang,430204202,15616,2525,10525,5789,20457,10447,3066,10394,20841,10682,21207
ɽ·ֵ,SongShanLuJieDao,430211001,53424,4108,33165,20940,37278,30583,9645,30081,60664,34012,67177
̩ɽ·ֵ,TaiShanLuJieDao,430211002,79102,4746,46022,26500,52428,37247,10788,37323,74570,48614,94636
ֵ,LiYuJieDao,430211003,10679,1012,6623,3699,8939,6242,2072,6091,12333,7140,13763
Һ,MaJiaHeZhen,430211100,14394,1952,9596,5854,18195,9477,2999,9556,19033,9749,19345
Ⱥ,QunFengZhen,430211101,15284,2263,9951,6174,18668,9888,2924,10264,20152,10520,20471
˿,LuKouZhen,430221100,49405,5895,31540,21301,57756,29977,9327,30969,60946,33087,64627
ͤ,ZhuTingZhen,430221101,12002,2554,8682,5427,16577,8659,2734,8580,17239,8608,17290
״ʯ,LeiDaShiZhen,430221104,21715,3679,14333,9452,28400,13951,4120,14607,28558,15181,29514
,SanMenZhen,430221105,20112,3358,13493,7822,26503,13472,4032,13968,27440,14009,27502
,GuYueFengZhen,430221106,14482,2502,9504,5682,19276,9504,2729,10204,19708,10209,19713
,GanTianZhen,430221107,13531,2533,9079,5328,17493,8483,2544,8670,17153,9529,18608
׹,BaiGuanZhen,430221108,17019,2436,10929,6604,21376,10912,3219,11719,22631,11745,22674
,LongFengXiang,430221200,7261,1507,5270,3244,10364,5248,1718,5186,10434,5216,10486
̶,LongTanXiang,430221201,4843,1009,3324,1803,6710,3300,1014,3471,6771,3542,6866
ש,ZhuanQiaoXiang,430221202,7702,1328,5129,2696,10173,5110,1492,5348,10458,5393,10522
ƽɽ,PingShanXiang,430221203,6419,1122,4166,2349,8439,4166,1090,4451,8617,4465,8631
ƺ,ZhouPingXiang,430221207,14503,2560,9746,5274,19207,9620,2867,9943,19563,10184,19930
,NanYangQiaoXiang,430221208,15383,2345,10199,5722,20278,10149,3202,10627,20776,10731,20930
ɾ,XianJingXiang,430221209,22184,3024,14457,7821,29471,14453,4811,15521,29974,15562,30019
ҦҰ,YaoJiaBaXiang,430221210,12975,2207,8548,4943,17124,8527,2418,9020,17547,9052,17600
,TangShiXiang,430221212,14547,2633,9500,6132,19190,9371,2894,9959,19330,10574,20074
ʮ,WangShiWanXiang,430221213,16092,2710,10571,5947,21642,10557,3235,11423,21980,11466,22037
̫,TaiHuXiang,430221214,12060,2173,8065,4023,16145,7997,2342,8325,16322,8510,16575
ǹ,ChengGuanZhen,430223100,81242,6250,52231,24365,71176,41191,15568,39464,80655,50829,103060
Ʋ,JiuBuJiangZhen,430223102,21508,2820,14248,7401,26266,13249,4326,13159,26408,14406,28654
ˮ,TaoShuiZhen,430223103,21984,3342,15233,7485,29691,14516,5499,14420,28936,15592,30825
,WangLingZhen,430223106,27932,3978,16668,9525,35181,16514,4937,16337,32851,20179,36847
,LuTianZhen,430223109,28589,3001,20772,10574,39125,20680,9825,20461,41141,20643,41415
,BaiShiZhen,430223110,8120,1164,5366,3028,10644,5310,1641,5453,10763,5559,10925
ͬ,DaTongQiaoZhen,430223111,17305,3103,12246,6431,22944,12187,3786,11808,23995,11948,24194
ʯ,ShiYangTangZhen,430223115,21712,3697,15385,7479,30230,15142,5658,15004,30146,15682,31067
Ʒ,HuangFengQiaoZhen,430223118,21176,1912,11155,5994,20415,10444,3409,10388,20832,15342,26497
ɽ,LuanShanZhen,430223119,17138,2538,11540,6610,21835,11331,4122,11382,22713,12258,23798
Ѿ,YaJiangQiaoZhen,430223120,27325,4282,18561,9347,36756,18534,5713,18664,37198,18759,37320
,ShangYunQiaoZhen,430223121,21307,3488,15117,8843,28578,14913,5428,14731,29644,15106,30223
ͼ,HuangTuLingZhen,430223122,43729,7056,29819,16395,56372,28844,9229,29030,57874,30195,60014
,XinShiZhen,430223123,24984,4929,18011,10377,34456,17676,5761,16874,34550,17663,35674
˻ƺ,CaiHuaPingZhen,430223124,39784,4299,27464,12991,51178,26567,11549,26462,53029,28168,55632
,HuNanAoXiang,430223204,13639,2518,9480,6051,18613,9425,2873,9382,18807,9550,19030
ƺ,PingYangMiaoXiang,430223205,11720,2649,8608,5748,16488,8561,2827,8481,17042,8588,17196
ɽ,JiaShanXiang,430223207,13171,2713,9578,5629,18675,9496,3139,9228,18724,9445,19023
Ѽ,YaTangPuXiang,430223212,17539,2834,12802,6618,24459,12456,5299,12209,24665,12870,25672
,LianTangAoXiang,430223213,24098,5016,18535,12656,35607,18517,7278,17764,36281,17857,36392
ǹ,ChengGuanZhen,430224100,54804,4986,37159,21448,45160,36561,13433,35058,71619,36064,73223
,JieShouZhen,430224101,21031,2133,13656,7429,27813,13603,5077,14512,28115,14585,28241
,HuKouZhen,430224103,15933,1905,11367,6130,22777,11346,5338,11782,23128,11809,23176
Ϫ,HuanXiZhen,430224104,11747,1201,8041,4030,15605,7915,3374,7961,15876,8281,16322
�,MaJiangZhen,430224105,20384,1981,13738,6916,27146,13721,5344,13944,27665,13971,27709
¤,GaoLongZhen,430224106,14006,1378,9090,4445,18094,8952,3248,9159,18111,9542,18632
ºˮ,LuShuiZhen,430224108,17403,1784,11390,5786,22247,11317,4037,11684,23001,11834,23224
,HuJuZhen,430224109,19174,2143,12999,6235,25751,12988,5098,13409,26397,13416,26415
ƽˮ,PingShuiZhen,430224110,20910,2158,14013,6775,27648,13893,4957,13702,27595,14012,28025
,ZaoShiZhen,430224111,18997,1945,12616,6632,24795,12615,4448,12773,25388,12774,25390
,HuoTianZhen,430224112,17053,1705,11179,5395,22106,11098,3845,11150,22248,11424,22603
,YanTangZhen,430224113,28731,2963,19355,9502,38496,19308,7269,19416,38724,19608,38963
,YaoBeiZhen,430224114,37025,4235,25475,12883,49941,25107,10199,25089,50196,25984,51459
¶,XiaDongXiang,430224202,27537,3269,19192,10505,36030,19075,7270,18526,37601,18884,38076
z,LingFangXiang,430224203,21411,2272,14483,7010,29430,14411,5922,14881,29292,15122,29605
˼,SiCongXiang,430224204,17498,1810,11959,6112,21985,11908,4295,11522,23430,11644,23603
,MiJiangXiang,430224205,19554,2182,13393,6689,25671,13336,5241,13456,26792,13584,26977
,BaTuanXiang,430224207,4583,562,2910,1579,5990,2894,966,3136,6030,3201,6111
,ZhiTangZhen,430224212,19677,2023,12757,5798,26120,12588,4731,13319,25907,13674,26431
ҿ,TaoKengXiang,430224213,6718,1118,4738,2749,9273,4705,1818,4828,9533,4916,9654
,XuNiDiQu,430224403,4321,217,706,687,1264,700,194,770,1470,4026,4732
´,HanBeiBanShiChu,430224404,1935,474,1204,1144,2328,1189,203,1293,2482,1408,2612
´,LiMinBanShiChu,430224405,3170,743,1819,1197,4221,1468,340,1494,2962,2434,4253
ϼ,XiaYangZhen,430225100,41399,3667,24767,13999,37655,22534,8281,21674,44208,28580,53347
,MianDuZhen,430225101,10913,1482,7014,3756,12585,6467,2359,6455,12922,7740,14754
ʮ,ShiDouZhen,430225102,8550,1194,5724,3324,10481,5582,1868,5499,11081,5888,11612
ˮ,ShuiKouZhen,430225103,12268,1633,7652,4092,14513,7201,2600,7506,14707,8849,16501
,SanHeZhen,430225104,20285,1677,11249,4764,17270,9032,2962,8693,17725,13675,24924
¹ԭ,LuYuanZhen,430225105,17175,2150,11387,6043,21473,10876,3851,10796,21672,11789,23176
¢Ϫ,LongXiXiang,430225200,5524,803,3850,2082,6924,3617,1352,3485,7102,3829,7679
ʯ,ShiZhouXiang,430225201,3795,470,2303,1214,4218,2114,651,2088,4202,2613,4916
Դ,CeYuanXiang,430225202,4660,603,2918,1517,5835,2843,974,3018,5861,3319,6237
´,XiaCunXiang,430225203,5627,868,3680,2243,7319,3586,1384,3875,7461,4199,7879
д,ZhongCunXiang,430225204,6642,701,3442,2012,6274,3199,1285,3295,6494,5186,8628
,LongZhaYaoZuXiang,430225205,2628,202,1080,585,1986,981,360,1018,1999,2110,3190
ƽ,PingLeXiang,430225206,1676,275,1126,661,2202,1100,372,1142,2242,1197,2323
,ChuanXingXiang,430225207,4995,773,3021,1816,5648,2757,1063,2884,5641,3810,6831
,DongFengXiang,430225208,6667,965,4659,2489,8623,4590,1543,4363,8953,4516,9175
شԺũ,YanLingXianDaYuanNongChang,430225400,599,44,371,208,634,322,123,319,641,395,766
ũȹ,YanLingXianShenNongGuGuanLiJu,430225401,105,14,70,39,126,70,14,63,133,63,133
ֵ,YangSanJieDao,430281002,36722,3850,23812,13126,37297,23594,6796,23129,46723,23556,47368
ɽֵ,XiShanJieDao,430281003,37598,4099,24111,12676,37276,23255,6431,22828,46083,24017,48128
ֵ,HuangNiAoJieDao,430281004,39097,4256,24519,13079,39326,22858,5979,22682,45540,24813,49332
Žֵ,LaiLongMenJieDao,430281006,62649,5880,39723,19160,48863,34004,9337,32461,66465,38143,77866
,NanQiaoZhen,430281100,30270,3507,19628,9273,39723,19533,6779,20748,40281,20928,40556
,FuLiZhen,430281101,24986,2805,16967,7800,32624,16788,6878,17480,34268,17702,34669
̶,BaiTuTanZhen,430281102,26456,3018,17722,8127,33134,17510,6332,17792,35302,18084,35806
ֿ,PuKouZhen,430281103,29047,3429,19348,9242,36558,19054,6814,19479,38533,19942,39290
,WangFangZhen,430281104,20830,2582,13961,6957,27443,13943,5009,14411,28354,14460,28421
,WangXianZhen,430281105,26848,3828,17731,9368,33870,17566,5904,18212,35778,18849,36580
,SiFenZhen,430281107,27813,3531,18106,8718,33081,16814,5263,17342,34156,18501,36607
̶,ShenTanZhen,430281108,13831,2399,10019,6231,19354,10019,3841,10052,20071,10052,20071
,ChuanWanZhen,430281109,16790,2594,11433,6487,22559,11358,3805,11587,22945,11756,23189
,DaZhangZhen,430281110,34357,4451,22209,11259,44999,22144,7020,23444,45588,23619,45828
ؼ,HeJiaQiaoZhen,430281111,12933,2026,8859,4726,17445,8746,3012,8815,17561,9112,17971
ϼ,XianXiaZhen,430281118,13710,1991,9033,4990,18150,8961,2771,9366,18327,9439,18472
̡,HuangTaZuiZhen,430281119,12000,2057,7969,5143,15659,7871,2687,8287,16158,8775,16744
,JunChuZhen,430281120,25949,4587,17335,9402,34729,16968,5256,17771,34739,18457,35792
,DongFuZhen,430281121,29896,4322,19719,11116,39397,19717,6219,20714,40431,20718,40437
ʯͤ,ShiTingZhen,430281122,23521,3791,15606,8985,31777,15532,5147,16740,32272,16853,32459
ɽ,LiShanBaZhen,430281123,24837,3592,16010,8518,32506,15921,4772,17014,32935,17191,33201
񸣸,ShenFuGangZhen,430281124,18006,2857,12127,6471,23971,12099,3740,12405,24504,12476,24603
,SunJiaWanXiang,430281204,15365,2153,9950,5374,19484,9803,2704,10159,19962,10272,20222
ˮ,QingShuiJiangXiang,430281205,15894,2106,10622,5552,21475,10619,3668,11035,21654,11046,21668
,JiaShuXiang,430281206,15739,2413,10311,5287,20444,10271,3224,10862,21133,11065,21376
,XinYangXiang,430281213,15829,2327,10374,5252,20741,10327,3023,10700,21027,10805,21179
ׯ,GuanZhuangXiang,430281214,8472,1843,5350,3662,11544,5037,1492,5862,10899,6457,11807
,FengLinShiXiang,430281215,9877,1655,6421,4037,13086,6383,1929,6915,13298,7040,13461
,DongBaoXiang,430281216,14211,2209,8972,5256,18024,8935,2765,9856,18791,10213,19185
ɼ,BanShanXiang,430281217,25639,3914,17196,9825,34084,17129,5546,17677,34806,17903,35099
·ֵ,YuHuLuJieDao,430302001,24386,3869,17369,9611,21097,13531,3402,12776,26307,14288,31657
ֵֽ,ChengZhengJieJieDao,430302002,54425,3683,27927,11525,34321,15334,3531,15139,30473,33712,61639
ƽ·ֵ,PingZhengLuJieDao,430302003,7847,1097,5205,3626,6822,5077,1179,4777,9854,4918,10123
ֵ,YunTangJieDao,430302004,42539,5334,28031,17450,32511,25296,6086,24489,49785,25928,53959
㳡ֵ,GuangChangJieDao,430302005,34720,4930,21366,14200,25862,18230,4377,17663,35893,22661,44027
ɽ·ֵ,ZhongShanLuJieDao,430302006,25642,4492,16926,12235,30119,16804,3350,16458,33262,16558,33484
Ҥֵ,YaoWanJieDao,430302007,18039,1836,11259,8095,11308,11240,3021,11576,22816,11637,22896
ֵ,YangGuTangJieDao,430302008,32785,995,17091,2593,16155,3164,967,3041,6205,17656,34747
,HeLingZhen,430302100,10045,1698,6595,5176,11744,6547,1645,6661,13208,6793,13388
ɽ,NanZhuShanZhen,430302101,18807,4573,12084,9105,22538,11707,2410,11759,23466,13706,25790
̶,ZhaoTanXiang,430302200,18408,1504,11592,7966,11299,11352,3312,11321,22673,11632,23224
̶,HuTanXiang,430302201,13808,1257,8806,5058,14582,8597,2306,8146,16743,8565,17371
,ChangChengXiang,430302202,20549,2136,13106,7286,20338,12970,4193,13475,26445,13772,26878
ȷ,XianFengXiang,430302203,13221,1316,8230,5287,10156,8034,2214,8182,16216,8521,16751
ˮ,XiangShuiXiang,430302204,68616,5916,41040,21003,63418,33363,11382,33990,67353,44874,85914
ֵ,YueTangJieDao,430304001,52401,8548,32788,21199,56583,30806,7581,30435,61241,35742,68530
ƺֵ,DongPingJieDao,430304002,10140,1095,6157,3808,8362,5409,1398,5387,10796,6476,12633
·ֵ,ZhongZhouLuJieDao,430304003,31406,5286,18834,13123,32967,17779,3454,17690,35469,21312,40146
Ժ·ֵ,ShuYuanLuJieDao,430304004,32006,3158,14902,9255,25146,12595,2775,12462,25057,23037,37939
˾ֵ,XiaSheSiJieDao,430304005,11364,1394,6713,4769,12271,6359,1374,6492,12851,7419,14132
·ֵ,JianSheLuJieDao,430304006,22520,2306,13329,8797,19263,12294,3180,12623,24917,14677,28006
ˮֵ,DiShuiBuJieDao,430304007,13745,1837,8201,5885,14988,7740,1929,8362,16102,9310,17511
ѽֵ,WuLiDuiJieDao,430304008,19942,1770,13722,6094,15429,8537,2086,8395,16932,10076,23798
罨ֵ,SheJianCunJieDao,430304009,15874,2938,10746,7614,18297,10074,2191,9623,19697,10257,21003
ֵ,BaoTaJieDao,430304010,46172,3934,28719,17022,24387,25799,8088,25535,51334,29475,58194
׼,YiJiaWanZhen,430304100,16363,1581,9723,5627,11967,8063,2440,8437,16500,10661,20384
˫,ShuangMaZhen,430304101,14161,1674,8667,4810,15380,8014,2540,8183,16197,9708,18375
ϼ,XiaChengXiang,430304200,18539,1853,11788,6911,15694,11589,3265,11449,23038,11869,23657
,BanTangXiang,430304201,8492,1015,5407,3072,8805,5134,1499,5075,10209,5599,11006
,HeTangXiang,430304202,15295,1730,10014,4870,18932,9963,2886,9852,19815,9897,19911
ɽ,ZhaoShanXiang,430304203,9663,1375,6312,4037,11756,6245,1784,6367,12612,6510,12822
ũ,HongQiNongChang,430304400,27457,937,14481,5622,11073,7730,2014,7586,15316,15927,30408
׺,YiSuHeZhen,430321100,91776,6924,56996,25783,62111,39235,15581,39395,78630,57285,114281
÷,MeiLinQiaoZhen,430321101,28833,5232,19065,12966,38518,19039,5567,20532,39571,20567,39632
̷ɽ,TanJiaShanZhen,430321102,29431,5177,19347,12153,38100,17621,6065,18427,36048,21326,40673
·,ZhongLuPuZhen,430321103,32475,6075,23138,14591,42498,21996,7674,22078,44074,23086,46224
,ChaEnSiZhen,430321104,22913,4247,16767,10208,33152,16592,6734,16769,33361,17127,33894
ӿ,HeKouZhen,430321105,25904,4641,17246,11688,33806,17074,5273,18185,35259,18572,35818
䲺,SheBuZhen,430321106,34306,6939,23544,15378,47307,23160,7041,23935,47095,24742,48286
ʯ,HuaShiZhen,430321107,29605,5690,20391,13296,40766,20221,6388,21079,41300,21292,41683
ɽ,QingShanQiaoZhen,430321108,24446,4687,17653,10434,34037,17291,6726,17348,34639,18206,35859
ʯ,ShiGuZhen,430321109,28185,5661,19620,12083,38059,19012,6659,19591,38603,20885,40505
,JiangSheZhen,430321110,34613,5040,22362,13231,43705,21478,6700,22954,44432,23991,46353
ƺ,YunHuQiaoZhen,430321111,34172,6508,23624,15535,45558,23473,7422,24155,47628,24478,48102
ʯ̶,ShiTanZhen,430321112,44670,7384,30043,18390,57937,28977,8881,29708,58685,30892,60935
,YangJiaQiaoZhen,430321113,36178,6395,24230,15406,46688,23711,7715,25087,48798,26058,50288
ʯ,WuShiZhen,430321114,20629,3976,14160,9095,27860,14090,4365,14669,28759,14810,28970
ʯ,BaiShiZhen,430321115,20745,3656,14464,8963,28810,14375,5097,14780,29155,15034,29498
,XiangTangXiang,430321200,37378,6200,24648,15669,48976,24317,7328,25831,50148,26258,50906
ˮ,FenShuiXiang,430321202,18995,4290,14068,9508,27587,13977,5061,14113,28090,14278,28346
ͷ,PaiTouXiang,430321203,38742,6533,26236,14765,50829,25179,8287,25830,51009,27326,53562
,LongKouXiang,430321204,14146,2868,10323,6541,20292,10273,3841,10409,20682,10532,20855
ʯ,JinShiXiang,430321205,16027,3239,11297,6961,22246,11099,3680,11331,22430,11649,22946
Žֵ,WangChunMenJieDao,430381001,33588,3763,22432,15058,32087,21982,7102,21311,43293,22021,44453
·ֵ,XinXiangLuJieDao,430381002,29848,3178,20017,13448,22955,19381,6676,19232,38613,19685,39702
Žֵ,KunLunQiaoJieDao,430381003,33564,4257,22773,14666,29469,20540,7015,19655,40195,22063,44836
ɽֵ,DongShanJieDao,430381004,16923,1801,10855,5744,15843,9165,3412,9071,18236,11281,22136
ɽ,ShanZaoZhen,430381100,28134,4684,19587,11964,39137,19577,6885,20069,39646,20116,39703
ɽ,LiShanZhen,430381101,15677,2904,11053,7149,22542,11024,4293,11716,22740,11821,22874
ɳ,ZhongShaZhen,430381102,14149,2737,10106,6363,20324,9971,4284,10901,20872,11064,21170
,YuTangZhen,430381103,22152,3809,15173,8832,30632,15018,5087,15608,30626,15875,31048
̶,TanShiZhen,430381104,28719,5518,19584,11489,40416,19081,6689,20220,39301,21342,40926
,QiZiZhen,430381105,32484,5294,22687,15245,43416,22557,8228,23031,45588,23319,46006
,HuTianZhen,430381106,31269,5226,22029,12330,43720,21849,8330,22471,44320,22796,44825
,FanJiangZhen,430381107,21622,4458,15871,9488,31401,15722,6284,16224,31946,16493,32364
ʯ,JinShiZhen,430381108,19036,4180,13958,8687,27146,13748,4351,13187,26935,13609,27567
,BaiTianZhen,430381109,26089,5173,18556,10852,36927,18548,6099,18788,37336,18805,37361
ɽ,YueShanZhen,430381110,31068,6814,22871,14659,45163,22795,8686,23562,46357,23697,46568
Ȫ,QuanTangZhen,430381111,30626,4968,21285,12948,41721,20471,7377,20723,41194,21686,42971
÷,MeiQiaoZhen,430381112,28206,5063,19900,11852,39087,19888,7238,20578,40466,20607,40507
ë,MaoTianZhen,430381113,20350,4030,14480,9599,28594,14351,5002,14660,29011,14902,29382
,LongDongZhen,430381114,22401,4111,15624,9333,31001,15620,5021,15900,31520,15909,31533
,DongJiaoXiang,430381200,30031,5517,21186,12833,40625,21052,6752,20743,41795,21114,42300
޴,JinSouXiang,430381202,19399,4409,14357,9005,28329,13998,5612,13946,27944,15063,29420
F,YuDuanXiang,430381203,21217,3938,15056,9699,30203,15017,5409,15378,30395,15508,30564
Ϫ,QingXiZhen,430382100,10641,1054,6822,4120,9770,5612,1796,5492,11104,6669,13491
,YinTianZhen,430382101,9666,1834,6807,4368,12725,6783,2035,6657,13440,6728,13535
,RuYiZhen,430382102,8028,1670,5723,3762,10630,5634,1777,5634,11268,5752,11475
ɽ,ShaoShanXiang,430382200,11283,1680,7823,4566,14238,7765,2475,7557,15322,7615,15438
,YongYiXiang,430382201,6033,1117,4211,2712,7943,4201,1325,4238,8439,4264,8475
,YangLinXiang,430382203,8733,1819,6292,3987,11898,6285,1963,6205,12490,6223,12515
ƺ,DaPingXiang,430382204,7703,1607,5589,3327,10943,5589,1797,5518,11107,5518,11107
㶫·ֵ,GuangDongLuJieDao,430405001,37088,4058,23583,15609,31132,23060,6704,23523,46583,24267,47850
·ֵ,DongFengLuJieDao,430405002,19671,2036,12648,7792,17982,10169,3037,10289,20458,12096,24744
ұֵ,YeJinJieDao,430405003,14725,3038,9867,6981,16727,9644,2212,9527,19171,10108,19975
Խֵ,MiaoPuJieDao,430405004,43944,7787,29357,19694,42341,25967,6605,25498,51465,28979,58336
ֵ,YueHanJieDao,430405005,18266,1656,11862,7494,12647,10625,3200,10603,21228,11260,23122
ֵ,XinXiangJieDao,430405006,9865,2604,7250,5229,12587,6972,2087,6982,13954,7306,14556
·ֵ,HengZhouLuJieDao,430405007,2963,316,2047,1029,3905,2039,761,1984,4023,1993,4040
ɽ,ChaShanAoZhen,430405100,17981,2258,11468,6968,23059,11369,4305,11987,23356,13076,24544
,DongYangDuZhen,430405101,23956,2641,16071,8657,30112,15981,6169,16469,32450,16695,32766
ƽ,HePingXiang,430405200,24167,1898,16173,9269,16890,16124,6025,15803,31927,15917,32090
۹,LingHuXiang,430405201,37989,1835,21306,6323,24592,12176,4713,11950,24126,23231,44537
ũ,JinJiaLingNongChang,430405400,1893,161,1178,698,2271,1152,441,1197,2349,1317,2495
̶԰ճ,BaiYuTanYuanYiChang,430405401,518,81,222,117,214,192,49,159,351,426,648
۹泡,LingHuYuChang,430405402,1013,93,665,418,724,663,256,691,1354,697,1362
ֲ賡,SongLinChaChang,430405403,18,2,16,9,16,16,9,13,29,13,29
ȷֵ,XianFengJieDao,430406001,22056,2469,14502,10106,19047,13941,3512,13198,27139,13535,28037
ֵ,YanFengJieDao,430406002,33008,3072,19512,11114,21889,15691,4250,15071,30762,20818,40330
ɽֵ,TianMaShanJieDao,430406003,16729,2304,10860,7622,16119,10529,2857,10361,20890,11030,21890
Ʋֵ,HuangChaLingJieDao,430406004,29213,2805,19443,9914,20311,13079,3881,12695,25774,16456,35899
ɳ޽ֵ,BaiShaZhouJieDao,430406005,30493,3710,19611,13060,29646,17856,5715,17676,35532,20307,39918
,YuePingZhen,430406100,16462,1482,9424,4849,13200,7795,3144,8056,15851,11664,21088
潭,XiangJiangXiang,430406200,12623,934,8412,4969,8686,8291,3212,8134,16425,8357,16769
ɳ޹ҵ԰,BaiShaZhouGongYeYuan,430406400,6545,660,4500,2869,8529,4486,1778,4451,8937,4483,8983
·ֵ,RenMinLuJieDao,430407001,21448,2355,13965,9698,19227,13454,3523,12970,26424,13361,27326
ɽֵ,QingShanJieDao,430407002,31972,4425,20963,14316,30094,20263,5211,19914,40177,20645,41608
ֵ,XiaoXiangJieDao,430407003,37661,3826,24262,16770,36086,24012,6775,23554,47566,24000,48262
һֵ,WuYiJieDao,430407004,25840,3125,16589,11091,27154,15417,4526,15549,30966,16902,33491
Ͻֵ,HeJiangJieDao,430407005,19350,2690,10954,7467,19670,10167,3272,10071,20238,14358,25312
ɳֵ,HuangShaWanJieDao,430407006,7323,422,4465,2849,4652,4338,1665,4403,8741,4945,9410
ľ,SongMuXiang,430407200,16259,871,11513,3414,12308,6207,2614,6295,12502,8231,19744
ɽ,JiaoShanXiang,430407201,12101,1212,8409,4194,16573,8150,3800,8365,16515,8704,17113
ľҵ԰,SongMuGongYeYuan,430407400,7283,483,4200,1977,6223,3406,1560,3509,6915,5126,9326
ֵ,ZhengXiangJieDao,430408001,31740,3290,20955,13140,26386,19052,5501,19279,38331,19576,40531
ֵ,HongXiangJieDao,430408002,66540,3520,35593,15010,35894,21107,6922,21766,42873,41389,76982
˽ֵ,HuaXingJieDao,430408003,48169,3298,30627,20016,37145,29438,10561,29179,58617,31401,62028
Ͻֵ,LianHeJieDao,430408004,32610,3280,20396,14636,29108,20148,6306,20618,40766,21800,42196
ӥ,DaiYingLingZhen,430408100,21915,1517,13365,6707,20514,10493,4378,10915,21408,14445,27810
,ChangHuXiang,430408200,23557,1508,15143,10253,14496,14994,5752,15440,30434,15674,30817
ĸɽ,YuMuShanXiang,430408201,13473,1462,8897,5396,17694,8892,3387,9206,18098,9425,18322
ףڽֵ,ZhuRongJieDao,430412001,16726,1375,10967,5884,12404,9623,3719,9200,18823,10853,21820
,NanYueZhen,430412100,23932,2625,16071,9088,27292,15645,6453,16110,31755,16939,33010
,YueLinXiang,430412200,1093,277,839,520,1671,836,346,877,1713,877,1716
,LongFengXiang,430412201,1169,234,889,544,1724,889,395,909,1798,909,1798
ݵ,BaiDianXiang,430412202,916,153,660,345,1307,656,268,675,1331,677,1337
,XiDuZhen,430421100,127673,11141,81858,44561,143423,73847,31537,77575,151422,88493,170351
,JiBingZhen,430421101,21655,2052,14344,8004,28591,14335,6099,15427,29762,15462,29806
ɼ,ShanQiaoZhen,430421103,14202,1800,9504,5226,19854,9430,4047,10305,19735,10545,20049
ͷ,JingTouZhen,430421104,41280,6140,28401,15866,58961,28392,12293,31285,59677,31312,59713
,YanBeiZhen,430421105,26880,3950,18503,10458,36182,17796,7626,18481,36277,19953,38456
,JinLanZhen,430421106,48202,7371,33753,18895,67593,33017,15211,35649,68666,37031,70784
,HongShiZhen,430421107,38663,5050,26724,13719,53670,25844,12301,28008,53852,29290,56014
,QuLanZhen,430421108,30519,4298,21931,11965,45040,21930,10792,23676,45606,23678,45609
Ϫ,JinXiZhen,430421109,22082,3326,15208,7830,32281,14883,7217,16521,31404,17417,32625
,JiePaiZhen,430421110,21840,2615,14404,8803,29752,14369,5935,15828,30197,15986,30390
,ZhaJiangZhen,430421111,42505,5952,29717,16466,58784,28799,14049,31412,60211,32789,62506
,SanHuZhen,430421112,32632,4801,22637,12520,47086,22312,10723,24627,46939,25519,48156
̨Դ,TaiYuanZhen,430421113,37527,4993,24624,14708,50948,24238,9864,27183,51421,27760,52384
ľ,ZhangMuXiang,430421200,18393,1779,12094,6749,24743,12049,4992,12931,24980,13070,25164
,GouLouXiang,430421201,15074,1843,10013,5528,20614,9930,4237,10910,20840,11141,21154
ɽ,XianShanXiang,430421203,42655,6188,29357,16477,60733,29322,12310,31733,61055,31796,61153
,GuanShiXiang,430421204,28429,4468,20126,11597,41018,20020,9938,22231,42251,22709,42835
,LanLongXiang,430421205,15110,2161,10174,5611,21169,10053,4123,11013,21066,11220,21394
,KuZongXiang,430421206,29590,4478,21070,11435,41952,20193,9550,21335,41528,22548,43618
,DaAnXiang,430421207,26734,3894,18846,10773,38583,18780,8855,20485,39265,20637,39483
Ϫ,XiJiangXiang,430421208,21725,3373,15590,8659,32295,15426,7817,16865,32291,17325,32915
ʯ,ShiShiXiang,430421209,33647,5063,23159,12410,47573,22920,10655,24949,47869,26206,49365
,ChangAnXiang,430421210,10490,1708,7288,4335,15231,7252,3234,8073,15325,8144,15432
,BanShiXiang,430421211,9374,1061,6151,3178,12491,6119,2523,6728,12847,6807,12958
,ZhangShuXiang,430421212,9499,996,6228,3425,12909,6228,2463,6730,12958,6730,12958
,ChaoJiangXiang,430421213,6032,674,3968,2082,8107,3942,1699,4360,8302,4437,8405
Ƽ,YunJiZhen,430422100,36483,2849,23630,13352,38208,20049,11317,21534,41583,27019,50649
,XiangYangZhen,430422101,34138,3020,21295,9141,39493,14568,8594,15743,30311,24457,45752
,LiaoTianZhen,430422102,17504,1999,12109,6164,24217,12023,5534,12702,24725,12928,25037
,ChaShiZhen,430422103,21162,2618,14322,7710,27918,13464,6212,14312,27776,15670,29992
,GuanShiZhen,430422104,27977,3596,19063,11062,39148,18899,8308,20363,39262,20818,39881
,JiangKouZhen,430422105,33776,4469,23842,13964,47000,23825,10855,25211,49036,25258,49100
,BaoGaiZhen,430422106,27654,3295,19500,10438,39619,19444,10124,21461,40905,21573,41073
,HuaQiaoZhen,430422107,27234,3057,18152,8364,37925,16526,8831,17783,34309,20970,39122
˿,TieSiTangZhen,430422108,13466,1769,9618,4989,19918,9341,5070,10102,19443,10687,20305
ȪϪ,QuanXiZhen,430422109,16001,2111,10927,6962,22191,10901,4521,11652,22553,11706,22633
ɽ,HongShanZhen,430422110,27149,3194,18655,9836,37863,18169,8171,19507,37676,19859,38514
,SanTangZhen,430422111,46439,3323,26437,13870,49331,21337,8513,23187,44524,31838,58275
̷ɽ,TanZiShanZhen,430422112,32765,4133,21500,13320,45139,21500,8299,23697,45197,23697,45197
,JiLongZhen,430422113,23536,3636,16088,10029,33798,16086,7057,18131,34217,18141,34229
Ȫ,QuanHuZhen,430422114,20337,3483,14338,8958,29327,14324,6059,15482,29806,15541,29879
,ZhaShiZhen,430422115,18385,2973,12923,6506,26535,12820,5818,14113,26933,14253,27176
é,MaoShiZhen,430422116,37262,5614,25352,15597,52673,25194,11404,28668,53862,28928,54280
,LiuShiZhen,430422117,25606,4111,17243,10316,35835,17218,7255,19549,36767,19729,36972
,LiJiangZhen,430422118,41469,5309,27476,14975,58724,27120,13067,31335,58455,32369,59845
β,JinWeiZhouZhen,430422119,17708,3150,12591,7621,25991,12590,5639,13896,26486,13906,26497
,CheJiangZhen,430422120,25836,2745,17017,9929,34496,16238,6949,17568,33806,18513,35530
,XianTangZhen,430422121,13179,1462,8732,4429,17114,8234,3299,8592,16826,9208,17940
ɽ,SongJiangZhen,430422122,30530,3167,20422,10526,40979,20297,9177,22180,42477,22452,42874
,XiangShiXiang,430422200,16140,2265,11076,6891,22550,11070,4567,11882,22952,11896,22972
,ZhouShiXiang,430422201,26012,3392,17031,9359,35827,17029,6555,18918,35947,18928,35959
ڰ´,ChuanKouBanShiChu,430422202,12785,1501,8110,4635,17482,7905,3316,8560,16465,9492,17602
ԭֳ,HengNanXianYuanZhongChang,430422402,700,87,486,262,925,486,199,498,984,500,986
,XuNiDiQu,430422404,1850,71,188,132,391,146,32,172,318,1765,1953
ɽ´,HengNanXianQiShanBanShiChu,430422406,3097,375,2122,1119,4360,2121,923,2262,4383,2273,4395
,KaiYunZhen,430423100,58974,6184,39413,22983,69371,37343,15096,38181,75524,40841,80254
׹,BaiGuoZhen,430423101,22042,2989,14994,7922,28456,14261,5788,14898,29159,15825,30819
,DongHuZhen,430423102,12584,1867,8769,4535,17550,8631,3662,8999,17630,9344,18113
,XuanZhouZhen,430423103,12032,1673,8417,4709,16824,8416,3444,8729,17145,8732,17149
,ChangJiangZhen,430423104,21454,2720,14842,7705,29121,14774,6305,15508,30282,15637,30479
,XinQiaoZhen,430423105,19146,2729,13448,6922,26959,13411,5511,13891,27302,13938,27386
�,MaJiZhen,430423106,7860,1223,5506,2802,11320,5256,2326,5516,10772,5903,11409
,DianMenZhen,430423107,17846,2305,12047,6236,24568,11962,4810,12731,24693,12914,24961
ؼ,HeJiaXiang,430423200,11266,1571,7620,4261,15571,7550,3048,8114,15664,8265,15885
,YongHeXiang,430423201,17921,2509,12315,6394,24857,12162,5305,13069,25231,13420,25735
ɳȪ,ShaQuanXiang,430423202,10261,1716,7492,4313,14956,7492,3254,7739,15231,7739,15231
,FuTianXiang,430423203,10323,1600,7361,3812,15146,7237,3296,7582,14819,7858,15219
,LingPoXiang,430423204,8295,1407,5981,3028,11988,5970,2522,6233,12203,6243,12224
,WangFengXiang,430423205,6767,1142,4902,2762,9980,4896,2144,5128,10024,5151,10053
,ChangQingXiang,430423206,10888,1729,7602,4186,15326,7562,3037,7945,15507,8052,15654
,GuanTangXiang,430423207,12554,1840,8851,4745,18053,8851,3710,9253,18104,9253,18104
,JiangDongXiang,430423208,10582,1527,7611,3784,15473,7574,3412,7828,15402,7910,15521
ǹ,ChengGuanZhen,430424100,40534,3646,27859,15600,39447,24942,11376,24651,49593,27697,55556
ʯ,ShiWanZhen,430424101,21062,2826,14993,8215,28590,14966,6103,14976,29942,14998,29991
,XinTangZhen,430424102,27080,4030,19364,10667,36651,18719,7922,18960,37679,19668,39032
,DaPuZhen,430424103,34284,5196,23841,13295,41003,22589,9773,23562,46151,25412,49253
⼯,WuJiZhen,430424104,25611,3601,18105,8961,35955,17943,7807,18667,36610,18914,37019
Ϫ,GanXiZhen,430424105,19713,2617,13657,6570,27134,13418,5682,13834,27252,14355,28012
,YangLinZhen,430424106,19597,2653,14344,6985,26457,13282,6279,13165,26447,14185,28529
,CaoShiZhen,430424107,18757,2444,13812,7520,27182,13680,6875,13933,27613,14264,28076
,YangQiaoZhen,430424108,21258,3164,15060,8016,29799,14815,6119,15121,29936,15481,30541
ϼ,XiaLiuZhen,430424109,28358,3615,19364,9675,39926,19150,8413,20650,39800,21022,40386
ٺ,RongHengZhen,430424110,17209,2488,12825,6396,25079,12721,5910,12547,25268,12782,25607
ߺ,GaoHuZhen,430424111,13504,2341,11087,6523,21616,10989,6220,10814,21803,10978,22065
,BaiLianZhen,430424112,13768,2417,10380,6011,19813,10338,4406,10107,20445,10211,20591
,DaQiaoZhen,430424113,14240,2025,9833,4946,19617,9732,3815,10048,19780,10247,20080
Դ,PengYuanZhen,430424114,15427,2360,10976,4994,21472,10928,4255,10903,21831,11066,22042
Ī,MoJingXiang,430424200,6492,1122,4838,2754,9599,4817,2203,4943,9760,4979,9817
̤ׯ,TaZhuangXiang,430424201,9756,1379,6706,3543,13856,6658,2824,7165,13823,7253,13959
,GaoTangXiang,430424202,13122,1601,9374,4731,18931,9372,4471,9816,19188,9820,19194
,NanWanXiang,430424204,8221,915,6006,2803,11494,5980,3039,6061,12041,6169,12175
,SanZhangXiang,430424208,11012,1840,7984,4153,15749,7919,3204,7987,15906,8072,16056
ľ,LiMuXiang,430424209,11012,1508,7922,3847,15622,7833,3656,8124,15957,8254,16176
,ZhenZhuXiang,430424210,11380,1772,8206,4189,16249,8146,3754,8533,16679,8700,16906
ʯ̲,ShiTanXiang,430424211,24430,2939,17148,8232,34005,17120,7844,18029,35149,18065,35213
,DeZhenXiang,430424212,7546,970,5045,2589,10418,5027,2130,5531,10558,5601,10646
ֹҵ԰,DaPuGongYeYuan,430424400,2143,302,1527,837,3092,1526,662,1580,3106,1580,3107
,HongQiaoZhen,430426100,152137,14109,102266,52787,159029,96257,43590,100547,196804,107570,209836
׺,BaiHePuZhen,430426101,30148,4207,20761,12664,42487,20736,8767,22279,43015,22361,43122
,JinQiaoZhen,430426102,28733,4481,20226,11448,41166,20224,8615,21602,41826,21603,41829
,NiaoJiangZhen,430426103,17730,2847,12623,7769,25484,12529,5486,13123,25652,13440,26063
,LiangShiZhen,430426104,11137,2284,8297,5332,16983,8221,3877,8847,17068,9001,17298
,HeZhouZhen,430426105,20343,3518,14926,8899,30495,14926,7393,16322,31248,16328,31254
,GuiYangZhen,430426106,25088,4358,17650,13104,36000,17426,7169,18370,35796,18965,36615
ˮƺ,GuoShuiPingZhen,430426107,28541,4582,20138,12196,41465,20122,8871,21810,41932,21856,41994
˫,ShuangQiaoZhen,430426108,29693,4736,19957,12692,42100,19895,8205,22256,42151,22677,42634
,LingGuanZhen,430426109,25354,4344,18057,11161,37554,18026,8179,19657,37683,19820,37877
ʯ,FengShiYanZhen,430426110,36323,5144,25631,14543,51696,25597,11386,27138,52735,27222,52853
׵,BaiDiShiZhen,430426111,45007,6357,31328,18107,62364,30837,13866,33150,63987,33902,65230
,HuangTuPuZhen,430426112,30406,4605,20599,12934,43289,20030,8859,22172,42202,23271,43870
ʯͤ,ShiTingZiZhen,430426113,15667,3156,12216,8177,24938,11985,6347,12634,24619,12954,25170
ټ,GuanJiaZuiZhen,430426114,23602,3560,16262,9103,33752,16074,6953,17286,33360,17853,34115
,BuYunQiaoZhen,430426115,45973,7176,32561,18689,66827,32545,15185,35707,68252,35773,68334
ש,ZhuanTangZhen,430426116,12898,3617,10933,8088,21574,10803,6140,11450,22253,11722,22655
,JiangJiaQiaoZhen,430426117,21852,3852,15967,10668,32699,15966,8294,18030,33996,18031,33998
̫,TaiHeTangZhen,430426118,35201,5536,25061,15751,51768,25055,12211,27867,52922,27887,52948
,MaDuQiaoXiang,430426200,8874,1304,6221,3710,12650,6208,3085,6929,13137,7042,13263
ƺ,FengQiPingXiang,430426201,8331,1242,5744,3352,11950,5721,2878,6619,12340,6707,12451
,ChengLianWeiXiang,430426202,16931,2522,11504,6769,23873,11285,5004,12569,23854,12953,24457
ɽ,SiMingShanXiang,430426203,1283,244,894,610,1924,891,462,1085,1976,1095,1989
ӳؽֵ,CaiZiChiJieDao,430481001,137633,8933,84452,45613,110641,79602,34607,84399,164001,96721,181173
нֵֽ,ZaoShiJieJieDao,430481002,51888,4481,32702,19283,43848,32398,12816,35280,67678,36483,69185
ˮֵ,ShuiDongJiangJieDao,430481003,20068,1740,13479,8034,23274,13381,6389,14421,27802,14718,28197
ƽֵ´,WuLiPaiJieDaoBanShiChu,430481004,86113,4991,53372,25553,62023,44625,18556,48139,92764,56288,109660
,HuangShiZhen,430481100,15380,1880,10166,6228,19859,9941,4656,10593,20534,11750,21916
Сˮ,XiaoShuiZhen,430481101,19673,3485,16274,10693,33023,16225,10358,16978,33203,17242,33516
ƽ,GongPingWeiZhen,430481102,21768,2794,16725,8774,33251,16596,9401,16940,33536,17238,33963
,SiMenZhouZhen,430481103,25853,3503,18369,12831,34459,18340,8682,19291,37631,19669,38038
,SanDouZhen,430481104,17823,2479,12473,7673,24779,12402,6118,13098,25500,13947,26420
,NanYangZhen,430481105,25064,3116,17033,10909,33507,16795,8263,18121,34916,19410,36443
,ZhuShiZhen,430481106,16256,1974,11874,7088,24118,11874,6195,12551,24425,12551,24425
,XiaTangZhen,430481107,13148,2790,10032,6899,20186,9955,4636,10254,20209,10542,20574
,LongTangZhen,430481108,15024,2179,10927,6707,21892,10851,5305,11350,22201,11581,22508
,ZheQiaoZhen,430481109,27835,3386,20414,12668,41365,20396,10935,21714,42110,21742,42156
,YongJiZhen,430481110,11264,2627,9133,6258,18267,9133,4690,9448,18581,9448,18581
ң,YaoTianZhen,430481111,17396,3072,12992,7772,26099,12886,6025,13114,26000,13501,26493
,XinShiZhen,430481112,17078,3074,13760,8924,27056,13727,7352,13644,27371,13744,27504
,ZhouBeiXiang,430481200,10774,1522,7699,4103,15825,7599,3911,8227,15826,8508,16207
Դ,LiangYuanXiang,430481201,8566,1842,7176,4542,14143,7139,3953,7018,14157,7185,14361
ˮ,MaShuiXiang,430481202,12351,2444,9546,6102,19682,9208,5096,9549,18757,10345,19891
̫ƽ,TaiPingWeiXiang,430481203,12168,2332,9015,4562,19107,8970,5052,10304,19274,10537,19552
,DaoZiXiang,430481204,19747,2814,13961,7344,28101,13856,6342,14388,28244,14942,28903
,DongHuWeiXiang,430481205,18554,3122,14693,8229,28369,14525,8411,14792,29317,15394,30087
ϼ,ShangJiaXiang,430481206,6041,2038,5079,3721,10217,5037,2389,5234,10271,5389,10468
ɳ,ShaMingXiang,430481207,3436,450,2459,1354,5120,2411,1254,2518,4929,2681,5140
,DaYiXiang,430481208,20138,2655,14499,7985,28855,14430,6777,14798,29228,15071,29570
ĥ,MoXingXiang,430481209,7632,1207,5612,2784,11681,5582,2947,6081,11663,6174,11786
Ͼ,NanJingXiang,430481210,10211,1672,8250,4907,16479,8155,5154,8525,16680,8787,17037
,RenYiXiang,430481211,21852,2812,16819,9176,34038,16814,9818,17652,34466,17663,34482
,YuQingXiang,430481212,13612,1965,10513,6860,21157,10509,5892,10956,21465,10956,21469
ƺ,ChangPingXiang,430481213,11840,2531,10148,6541,20342,10113,6416,10550,20663,10639,20787
̫,TaiHeWeiXiang,430481214,16563,2693,13085,8547,25356,12980,7175,12971,25951,13346,26431
̳,TanXiaXiang,430481215,17896,1853,12174,6126,24576,12131,5748,13165,25296,13323,25497
,DaShiXiang,430481216,24389,3957,19338,12479,36737,19255,11288,20044,39299,20296,39634
,FeiTianXiang,430481217,12567,2586,9412,6796,19307,9368,4347,9944,19312,10088,19500
ֵ,YiYangJieDao,430482001,29824,2318,19592,6734,35003,12383,8347,12878,25261,20897,40489
Ȫֵ,QuanFengJieDao,430482002,40507,3819,27395,14031,39214,23964,12459,25674,49638,29390,56785
Ԫֵ,PeiYuanJieDao,430482003,18043,1603,12031,6539,17537,11175,5313,11689,22864,12928,24959
ˮɽֵ´,ShuiKouShanJieDaoBanShiChu,430482004,34478,3817,21366,14022,42302,20113,7760,20875,40988,24689,46055
ط,BaiFangZhen,430482101,36013,5104,23977,14476,51026,23776,10227,26539,50315,27367,51344
ɰ,SongBaiZhen,430482102,18030,2343,11951,5521,24152,10134,4790,10475,20609,13212,25163
,YanZhouZhen,430482103,23942,2569,16529,7878,34883,15804,8430,16887,32691,18412,34941
,YinTianZhen,430482104,21616,2974,16079,8110,33315,15820,9070,16916,32736,17581,33660
ɳ,BaiShaZhen,430482105,20338,2141,14898,7661,30764,14747,8703,15936,30683,16284,31182
,XiLingZhen,430482106,21173,2222,14678,7246,31220,14608,7954,16402,31010,16671,31349
κ,YanHuZhen,430482107,12833,1961,8408,5368,18640,8072,3878,8945,17017,10264,18672
,SanJiaoTangZhen,430482108,19862,2397,13409,6576,27971,13268,5824,14163,27431,14674,28083
Ȫ,YangQuanZhen,430482109,31615,5580,24053,13805,49128,23641,13745,25410,49051,26887,50940
ǰ,MiaoQianZhen,430482110,11139,1550,7674,3780,16190,7616,3680,8523,16139,8695,16369
,LuoQiaoZhen,430482111,23219,2821,15468,8215,32683,15428,7413,17872,33300,17985,33453
,BanQiaoZhen,430482112,25531,3338,17946,8223,37320,17788,8661,19164,36952,19584,37530
ʤ,ShengQiaoZhen,430482113,24870,3512,17295,7877,36806,17090,8705,19082,36172,19792,37087
,GuanLingZhen,430482114,24644,3753,18110,10349,37326,18083,9056,19289,37372,19343,37453
º,XinHeZhen,430482115,14200,2856,10680,6725,22119,10680,5177,11553,22233,11553,22233
̶,YiTanXiang,430482200,27589,3761,18881,8752,38716,18523,7947,19855,38378,20416,39297
,PengTangXiang,430482201,26419,3168,18332,10038,38603,18230,9317,20166,38396,20572,38904
,LanJiangXiang,430482202,17639,2862,12801,7040,26626,12526,6324,13407,25933,14024,26825
,DaBaoXiang,430482203,15114,3472,11735,6328,24137,11144,5807,11423,22567,12658,24393
,JiangHeXiang,430482204,9188,1494,6305,3554,13359,6273,2704,6968,13241,7081,13386
Ȫ,MiQuanXiang,430482205,1509,190,1019,467,2212,839,532,974,1813,1212,2231
ɽ,TaShanYaoZuXiang,430482206,5099,604,3623,1930,7663,3596,1961,3957,7553,4041,7664
¡ֵ,XingLongJieDao,430502001,14171,1517,8242,5649,13134,7555,2621,8112,15667,10067,18309
ֵ,LongXuTangJieDao,430502002,25334,2962,16066,10587,26168,15116,5181,15527,30643,17411,33477
վֵ,QiCheZhanJieDao,430502003,32474,3887,20845,13120,33036,20378,6822,21312,41690,22338,43183
Сֵ,XiaoJiangHuJieDao,430502004,24692,3973,16737,11284,25872,16404,5159,16392,32796,17087,33824
·ֵ,DongFengLuJieDao,430502005,27765,3251,17959,10806,30547,16597,5822,17316,33913,18879,36838
ͷֵ,QiaoTouJieDao,430502006,18884,2298,12174,7745,17640,11774,3682,12093,23867,12690,24864
߳ɽ,GaoChongShanZhen,430502100,19286,2664,13622,7721,25068,13316,5745,13616,26932,14073,27695
ͷ,DuTouQiaoZhen,430502101,12879,1835,8753,5137,18000,8504,3872,9420,17924,9833,18586
Ƕ,ChengDongXiang,430502200,9613,991,6877,3991,10442,6675,2953,6447,13122,6680,13557
ʯ,ShiQiaoXiang,430502201,14492,1414,10155,6155,14225,10138,4636,10336,20474,10387,20542
վ,HuoCheZhanXiang,430502202,14858,1827,10376,5525,16912,10155,4455,10257,20412,10764,21140
ˮ,YunShuiXiang,430502203,11456,1438,7747,4472,15098,7718,3071,8028,15746,8218,15965
·ֵ,ZhongXinLuJieDao,430503001,18148,2837,12455,8029,19891,12260,3937,12214,24474,12467,24922
·ֵ,HongQiLuJieDao,430503002,26142,3756,18234,9804,32794,17036,6346,16533,33569,18010,36244
Ǳ·ֵ,ChengBeiLuJieDao,430503003,22781,2519,16068,8119,25672,13364,4344,12812,26176,13576,29644
·ֵ,ChengXiLuJieDao,430503004,26057,3386,17475,10724,27391,16291,5264,16778,33069,17232,34707
԰ֵ,CuiYuanJieDao,430503005,25109,2388,17047,8155,22634,12236,4397,11954,24190,14847,31894
ٴ԰ֵ,BaiChunYuanJieDao,430503006,23854,1924,13452,6259,18743,9554,3604,9300,18854,15930,29382
Ϫ,YuXiZhen,430503100,12267,1738,8637,4698,16645,8501,3832,8609,17110,9200,17837
,LuoShiZhen,430503101,15582,2361,10794,6124,21641,10748,4468,11521,22269,11617,22411
,ChengNanXiang,430503200,21621,2069,15095,10425,21735,15077,6252,14809,29886,14847,29942
̴,TanJiangXiang,430503202,18104,2407,12068,7116,24837,11982,4990,13271,25253,13433,25501
,CaiEXiang,430503203,13669,2075,9406,5520,19561,9406,4157,10495,19901,10495,19901
,BanQiaoXiang,430503204,16314,2343,11172,6408,22829,11039,4716,11922,22961,12201,23373
԰ճ,ChengNanYuanYiChang,430503500,2805,295,1970,1300,3002,1961,888,1979,3940,2018,3988
վվǰ,HuoCheNanZhanZhanQianGuanLiQu,430503501,7810,519,5432,3364,3376,5233,2530,5245,10478,5427,10859
ֵ̲,XinTanZhenJieDao,430511001,9237,899,6601,3392,10552,5296,1972,5117,10413,5507,12108
״Ԫ޽ֵ,ZhuangYuanZhouJieDao,430511002,30947,2405,20897,12068,22734,17785,7347,17960,35745,19802,40699
ｭ,TianJiangXiang,430511200,8603,1050,6211,3579,11734,6004,2485,5699,11703,5927,12138
Ԫͷ,ChaYuanTouXiang,430511202,13848,1673,8451,4795,16717,8249,3562,8591,16840,10632,19083
¼,ChenJiaQiaoXiang,430511203,13945,1757,9640,5411,19319,9632,4064,10107,19739,10126,19766
԰ճ,ShaoYangShiYuanYiChang,430511500,576,84,407,240,663,389,155,374,763,408,815
,LiangShiZhen,430521100,139393,12033,91528,53947,152233,85485,40335,91920,177405,100233,191761
ţ˾,NiuMaSiZhen,430521101,22542,4141,16376,10710,32148,16311,6886,17045,33356,17193,33569
ɽ,FanJiaShanZhen,430521102,10506,2326,7967,5515,15484,7961,3378,8232,16193,8243,16210
,JiuLongLingZhen,430521103,16370,3773,12454,7736,25753,12396,5705,13347,25743,13394,25848
,XianChaQiaoZhen,430521104,21780,4263,15957,9701,32991,15799,7352,17027,32826,17438,33395
ƺ,HuoChangPingZhen,430521105,27495,5341,20352,12453,41060,19230,9891,20514,39744,22375,42727
,SheTianQiaoZhen,430521106,13983,2974,10225,6690,20866,9319,5188,9966,19285,11920,22145
ٵ,LingGuanDianZhen,430521107,24204,5348,19091,12430,38280,19052,10177,20392,39444,20638,39729
ɽ,TuanShanZhen,430521108,27865,6186,21993,14124,44315,20298,10903,21041,41339,22961,44954
ɰʯ,ShaShiZhen,430521109,16086,2749,11471,6943,22968,11448,4992,12099,23547,12356,23827
,LianQiaoZhen,430521110,32812,5917,23528,16377,46195,23217,10702,25514,48731,25903,49431
,LiuGuangLingZhen,430521111,8872,2132,6821,4324,13664,6693,2880,6843,13536,7063,13884
,LiuZeZhen,430521112,20005,3408,14688,7497,29958,14484,7234,15583,30067,15959,30647
κ,WeiJiaQiaoZhen,430521113,20559,3949,14880,8243,30727,14860,6622,16225,31085,16250,31130
Ұƺ,YeJiPingZhen,430521114,18861,4191,14188,8831,28663,14184,6653,15495,29679,15517,29705
,YangQiaoZhen,430521115,10926,2855,8811,5948,17542,8754,4006,8891,17645,8976,17787
ˮ,ShuiDongJiangZhen,430521116,22233,4802,16848,9784,34178,16763,7620,17671,34434,17807,34655
,HuangBeiQiaoXiang,430521201,19390,3241,13801,7814,27471,13512,5893,14403,27915,14723,28524
,HeiTianPuXiang,430521202,30355,5170,21452,12838,42799,20810,10290,23216,44026,24363,45815
˫,ShuangFengXiang,430521203,8816,1886,6779,3984,14270,6679,3621,7309,13988,7544,14323
ܹ,ZhouGuanQiaoXiang,430521204,14402,2984,10571,6035,20778,10531,4583,11250,21781,11398,21969
¤,JianJiaLongXiang,430521205,23710,5377,18110,11125,37091,18047,8671,19512,37559,19648,37758
ǰ,BaoMianQianXiang,430521209,6232,1510,5122,3363,10684,5115,3054,5659,10774,5674,10796
ʯ,ShiZhuQiaoXiang,430521210,10537,2628,8778,6433,17759,8777,4922,9307,18084,9309,18087
,JieLingXiang,430521211,13340,2695,10186,6516,20808,10154,5089,10812,20966,10938,21124
�,ZhuoCaoXiang,430521212,10176,1937,7791,4944,16484,7712,4706,8921,16633,9028,16819
Ϫ,NiangXiZhen,430522100,67650,7449,44426,26057,80958,42930,17200,45702,88632,47873,92299
,YanTangZhen,430522101,35505,5369,24917,13736,49875,24888,10828,26712,51600,26785,51702
ȸ,QueTangZhen,430522102,36706,5307,25109,13406,50852,24971,10669,26675,51646,27573,52682
¼ҷ,ChenJiaFangZhen,430522103,44452,6211,31050,16449,63005,30666,13643,32611,63277,33256,64306
̶Ϫ,TanXiZhen,430522104,23851,3913,16789,10441,34945,16783,7594,18547,35330,18569,35358
ʯ,CunShiZhen,430522105,29654,4669,21199,11808,42758,21063,9228,22112,43175,22352,43551
ƺ,PingShangZhen,430522106,55506,7861,38444,19980,78463,37037,16113,38268,75305,41036,79480
Ϫ,LongXiPuZhen,430522107,34434,4583,24763,12046,51015,23776,13217,25344,49120,27471,52234
޿,JuKouPuZhen,430522108,32730,5105,24113,14141,50821,24033,13272,26532,50565,26994,51107
,XinTianPuZhen,430522109,37737,5327,26956,15369,54750,26791,13298,29115,55906,29406,56362
С,XiaoTangZhen,430522110,30831,5313,21707,12308,45803,21400,10116,23565,44965,24553,46260
̶,TanFuXiang,430522200,19869,3069,13820,7422,28528,13562,6185,14874,28436,15303,29123
̫֥,TaiZhiMiaoXiang,430522201,18484,2422,12471,7014,26172,12430,6224,14308,26738,14659,27130
,DaXinXiang,430522202,22641,3424,16291,9876,33792,16207,8626,18250,34457,18400,34691
ӭ,YingGuangXiang,430522203,17559,2615,12764,6811,26195,12735,6614,13933,26668,14024,26788
ɿ,TangDuKouZhen,430523100,80979,9110,56221,31221,97674,55363,25937,58739,114102,59805,116026
ײ,BaiCangZhen,430523101,45793,6554,32704,17393,65511,32581,15469,34822,67403,35112,67816
,JinChengShiZhen,430523102,26461,3860,18105,9956,37016,18080,8375,20561,38641,20591,38696
,TangTianShiZhen,430523103,29299,4053,19890,11059,40963,19864,9033,22454,42318,22495,42385
ͤ,HuangTingShiZhen,430523104,37416,5252,26440,13911,53900,26440,12943,29170,55610,29171,55611
,ChangYangPuZhen,430523105,26862,4095,18842,11177,37273,18706,8305,20121,38827,20420,39262
ҿ,YanKouPuZhen,430523106,20481,3259,14248,7920,29255,14153,6375,15699,29852,15867,30115
Ź,JiuGongQiaoZhen,430523107,36216,5294,24528,14640,49851,24476,10567,27234,51710,27549,52077
»,XiaHuaQiaoZhen,430523108,32636,4528,23085,12321,46314,23072,10319,24372,47444,24398,47483
,GuZhouZhen,430523109,37219,5121,25488,13113,51473,25348,11204,27711,53059,28056,53544
۪ƺ,LiJiaPingZhen,430523110,33670,4953,24158,12653,48630,24150,12054,26479,50629,26519,50677
,WuFengPuZhen,430523111,59063,8249,42668,22215,85583,42427,21204,45597,88024,45848,88516
,HuangTangXiang,430523200,14835,2494,11209,6335,22109,11209,5466,11583,22792,11586,22795
СϪ,XiaoXiShiXiang,430523201,22681,3483,15972,8704,32280,15967,7544,17702,33669,17736,33708
ϼ,XiaTangYunXiang,430523202,17830,2529,12861,7280,25964,12832,6403,13827,26659,13901,26762
,ChangLeXiang,430523203,16649,2261,11842,5857,24143,11832,5864,12916,24748,12932,24774
,CaiQiaoXiang,430523204,17878,2297,12691,6600,25451,12658,6743,14174,26832,14227,26918
Ӳ,HeBoXiang,430523205,18817,2878,13127,7340,27187,13072,6007,14448,27520,14575,27702
ƾ,HuangJingXiang,430523206,12293,1994,8601,4537,17457,8600,3816,9497,18097,9502,18103
ͤ,ZhuJiaTingXiang,430523207,16550,2287,11558,6081,23654,11540,5652,12907,24447,12931,24489
޳,LuoChengXiang,430523208,11348,1775,8469,4683,16775,8439,4295,8897,17336,8949,17418
,JinJiangXiang,430523209,1882,279,1389,643,2645,1389,587,1359,2748,1359,2748
ɽ԰ճ,QiLiShanYuanYiChang,430523401,4886,693,3448,1947,6751,3441,1361,3477,6918,3492,6940
ֳ,WuFengPuLinChang,430523402,243,26,156,96,335,156,68,181,337,181,337
Ӳֳ,HeBoLingLinChang,430523403,420,129,323,311,657,323,149,375,698,375,698
Һ,TaoHongZhen,430524100,82319,8566,54686,33527,94926,52400,22387,55851,108251,58586,113272
Сɳ,XiaoShaJiangZhen,430524101,14283,1906,10347,6792,20492,10284,5461,11111,21395,11303,21650
ʯ,JinShiQiaoZhen,430524102,40826,5450,29634,18098,60147,29506,15143,31592,61098,31785,61419
˾ǰ,SiMenQianZhen,430524103,34402,4748,24339,15340,49662,24265,12155,26754,51019,26966,51305
ƽ,GaoPingZhen,430524104,50730,6299,34660,18674,71952,34127,16802,38126,72253,39171,73831
կ,LiuDouZhaiZhen,430524105,36488,5496,25296,17549,52397,25295,11795,28466,53761,28483,53779
,HeXiangQiaoZhen,430524106,34703,5328,24710,14778,51228,24285,12967,27501,51786,28288,52998
,HengBanQiaoZhen,430524107,30534,4265,21138,12114,44058,21092,10202,23735,44827,23863,45001
,ZhouWangZhen,430524108,22510,3167,15077,8957,30799,15077,6221,16821,31898,16821,31898
̲ͷ,TanTouZhen,430524109,49396,7501,33945,21514,69969,33941,15486,38366,72307,38438,72383
Ѽ,YaTianZhen,430524110,18776,2399,13439,7417,27384,13382,7112,14703,28085,14848,28287
,XiYangJiangZhen,430524111,24413,3728,17637,9820,35771,17533,9151,19408,36941,19655,37292
ɽ,YuShanPuZhen,430524112,25904,3912,18086,11100,36741,17989,8259,19586,37575,19989,38075
ҿ,YanKouZhen,430524113,39856,5678,27816,16358,58549,27743,14449,31966,59709,32167,59983
ɽ,MaTangShanXiang,430524200,8671,1255,6368,3866,12243,6320,3280,6722,13042,6838,13206
ɽ,HuXingShanYaoZuXiang,430524201,10061,1229,7086,3994,13850,7039,3674,7763,14802,7878,14964
ˮ,DaShuiTianXiang,430524203,6782,1064,4908,3394,9824,4864,2603,5400,10264,5541,10449
,YangGuAoXiang,430524204,20241,2752,14367,8840,29497,14310,7291,15768,30078,15917,30284
޺,LuoHongXiang,430524205,16682,1972,11343,6816,23694,11264,5600,12735,23999,12911,24254
߽,QiJiangXiang,430524206,31348,4866,22845,14298,46617,22693,11007,23996,46689,24376,47221
,HeTianXiang,430524207,16542,2412,11482,6905,23584,11421,5175,12510,23931,12647,24129
ʯ,ShiMenXiang,430524208,24886,3877,17447,10615,36743,17427,8722,19957,37384,20038,37485
,NanYueMiaoXiang,430524211,19634,2946,14286,8968,28636,14224,7320,15477,29701,15614,29900
ɽ,ShanJieHuiZuXiang,430524212,15612,2285,10763,6781,22277,10724,5136,12220,22944,12270,23033
˾,SanGeSiXiang,430524213,41662,5913,29280,16611,61579,29164,14645,32753,61917,32940,62220
ɽ,BeiShanXiang,430524214,25311,3758,17183,9988,36010,17133,8005,19675,36808,19891,37074
,DongKouZhen,430525100,60295,7970,42169,26407,79295,41438,17214,42335,83773,43310,85479
,JiangKouZhen,430525101,8308,1322,5886,3350,11316,5845,2371,6072,11917,6115,12001
ع,YuLanZhen,430525102,30707,5137,21585,13022,43434,21334,8749,22324,43658,23008,44593
ɳ,GaoShaZhen,430525103,73610,10614,51703,31117,102789,51385,21875,53985,105370,54396,106099
,ZhuShiZhen,430525104,49975,8103,35784,20748,71329,35666,16460,38548,74214,38754,74538
ʯ,ShiJiangZhen,430525105,55284,8620,38747,23712,77726,38257,16950,41506,79763,42107,80854
,HuangQiaoZhen,430525106,58725,8117,41377,22777,83692,41328,19706,45030,86358,45171,86548
ɽ,ShanMenZhen,430525107,34939,5660,24830,13681,50002,23979,11393,25656,49635,27162,51992
,LaoTianZhen,430525108,15618,2620,11464,6217,22577,11424,5942,12606,24030,12716,24180
԰,HuaYuanZhen,430525109,21351,3555,14851,8619,29836,14749,5977,15792,30541,16032,30883
,HuaGuXiang,430525200,14669,2255,10556,6113,20512,10496,4512,10771,21267,10880,21436
¥,GuLouXiang,430525201,3948,673,2786,1567,5518,2786,1098,2931,5717,2933,5719
,ChangTangYaoZuXiang,430525202,3215,567,2250,1246,4427,2228,881,2347,4575,2413,4663
Ϫ,LuoXiYaoZuXiang,430525203,6707,970,4600,2767,9557,4598,2027,5089,9687,5104,9704
Ϫ,YueXiXiang,430525204,10405,1648,7058,3896,14216,6912,2908,7643,14555,7903,14961
ƺ,ZhaPingXiang,430525205,5161,982,3652,2116,7321,3651,1521,4010,7661,4012,7664
ɽ,YanShanXiang,430525207,15506,2511,11098,6478,21512,11087,4997,11907,22994,11916,23014
,YangLinXiang,430525208,14628,2183,10506,5632,20935,10448,5191,11379,21827,11496,22002
ˮ,ShuiDongXiang,430525209,13038,1974,9271,4637,18686,9249,4479,10180,19429,10220,19491
ʯ,ShiZhuXiang,430525210,16878,2720,12268,6564,23797,12217,5954,13179,25396,13284,25552
ͩɽ,TongShanXiang,430525211,6529,1094,4601,2613,8823,4600,2056,5043,9643,5078,9679
,DaWuYaoZuXiang,430525212,3144,503,2138,1320,4453,2135,960,2462,4597,2469,4607
в̲賡,ShaoYangShiChaPuChaChang,430525500,3416,400,2392,1523,4612,2392,998,2422,4814,2422,4814
,ChangPuZhen,430527100,32840,3136,21949,14213,27533,21451,8289,21753,43204,22316,44265
,WuYangZhen,430527101,18817,2345,12831,7068,25808,12761,5406,13531,26292,13737,26568
,LiXiQiaoZhen,430527102,12811,1679,9031,4522,18070,8927,3976,9166,18093,9435,18466
,HongYanZhen,430527103,18091,2707,12812,7047,25723,12702,5591,13216,25918,13577,26389
Ƽҷ,TangJiaFangZhen,430527104,14236,2049,9749,5343,19718,9696,4016,10329,20025,10552,20301
,JinWuTangZhen,430527105,9755,1386,6818,3670,13763,6789,3064,7282,14071,7387,14205
ɽ,DongShanDongZuXiang,430527200,11450,1502,7664,3463,15648,7475,3013,7929,15404,8301,15965
칫붱,EGongLingDongZuMiaoZuXiang,430527201,7800,1113,5415,2817,11024,5415,2247,5743,11158,5745,11160
Ƕ,ChaoYiDongZuXiang,430527202,5567,693,3714,1817,7403,3695,1396,3885,7580,3942,7656
,ZaiShiMiaoZuXiang,430527203,10092,1455,6887,3712,13730,6867,2450,7058,13925,7110,13997
ְ嶱,LeAnPuMiaoZuDongZuXiang,430527204,6574,715,4320,2270,8394,4259,1720,4482,8741,4689,9009
ɣƺ,HuangSangPingMiaoZuXiang,430527205,3542,523,2472,1336,4955,2416,978,2479,4895,2571,5043
Ͽ,GuanXiaMiaoZuXiang,430527206,14915,1828,10000,5388,20412,9976,4048,10724,20700,10791,20791
,ChangPuZiMiaoZuXiang,430527207,12845,1601,8611,4851,15445,8364,3167,8574,16938,9002,17613
ƺ,DangPingMiaoZuXiang,430527208,7362,965,4807,2424,9885,4784,1805,5237,10021,5325,10132
,LianMinMiaoZuYaoZuXiang,430527209,3877,521,2525,1437,5252,2467,921,2643,5110,2794,5319
,MaTangMiaoZuXiang,430527210,6443,887,4357,2264,8853,4286,1763,4547,8833,4736,9093
ľ嶱,FengMuTuanMiaoZuDongZuXiang,430527211,4730,556,3169,1714,6393,3147,1252,3277,6424,3369,6538
ӿ,HeKouMiaoZuXiang,430527212,4115,531,2744,1464,5441,2706,1035,2857,5563,2937,5681
۽,ZhuZhouJiangMiaoZuXiang,430527213,5673,722,3714,1927,7661,3689,1347,3961,7650,4028,7742
,BaiYuXiang,430527214,5834,716,4187,2144,8332,4170,1971,4298,8468,4334,8521
,HuangTuKuangXiang,430527215,11481,1744,7860,4146,16055,7633,3051,7908,15541,8416,16276
,WaWuTangXiang,430527216,13547,1858,9320,5141,18874,9211,3765,9560,18771,9850,19170
ˮ,ShuiKouXiang,430527217,6237,986,4144,2360,8573,4093,1419,4417,8510,4498,8642
÷ƺ,MeiPingXiang,430527218,1896,257,1254,689,2517,1254,444,1333,2587,1343,2597
ʯ,JinShiZhen,430528100,75094,8786,50486,31262,89687,49955,17807,50433,100388,51201,101687
ˮ,ShuiMiaoZhen,430528101,14984,2337,10362,5927,20802,10324,3740,10565,20889,10699,21061
~ɽ,NangShanZhen,430528102,19626,2837,12797,7058,25893,12719,4327,13436,26155,13993,26790
ɳ,BaiShaZhen,430528103,19329,2815,12886,7024,26422,12882,4438,13690,26572,13696,26582
,HuangLongZhen,430528104,17811,2760,11585,6239,24216,11433,4042,12610,24043,13028,24613
,GaoQiaoZhen,430528105,23935,3904,16049,9267,33635,16048,6019,17804,33852,17809,33858
,HuiLongSiZhen,430528106,50521,6728,35475,19257,71622,35425,16225,37946,73371,37999,73474
һˮ,YiDuShuiZhen,430528107,22989,3512,15682,8662,32990,15536,6696,17158,32694,17515,33197
ͷ,MaTouQiaoZhen,430528108,33329,4677,23494,11746,49223,23416,11739,26074,49490,26251,49745
ƽ,HuangJinYaoZuXiang,430528200,5676,728,3953,1967,7832,3938,1557,3970,7908,4008,7961
,MaLinYaoZuXiang,430528201,9084,1214,6155,3238,12492,6051,2345,6299,12350,6488,12643
,FeiXianQiaoXiang,430528202,17392,2398,11485,5697,22987,11469,3623,11843,23312,11928,23413
,WanTangXiang,430528203,17495,2711,11688,6280,24260,11686,4243,12746,24432,12761,24449
彭,QingJiangQiaoXiang,430528204,16749,2844,11891,6559,23861,11766,4904,12368,24134,12606,24497
ɽ,AnShanXiang,430528205,16344,2692,11638,6148,24182,11565,5433,12688,24253,12831,24469
,FengTianXiang,430528206,15342,2211,10720,5972,22891,10637,5504,12217,22854,12337,23057
Ѳ,XunTianXiang,430528208,15572,2239,10759,5678,22112,10729,4634,11565,22294,11686,22445
λ,JingWeiXiang,430528209,4870,765,3211,1711,6616,3176,1166,3494,6670,3590,6801
,RuLinZhen,430529100,46717,5235,32151,17949,58290,31718,12412,31668,63386,32213,64364
éƺ,MaoPingZhen,430529101,19800,2286,13279,7078,27507,12991,5777,14017,27008,14584,27863
,XiYanZhen,430529102,47577,5539,33122,17121,67918,32378,15129,33925,66303,35123,68245
,DanKouZhen,430529103,16693,2010,10743,5387,22627,10560,4145,11427,21987,12105,22848
,WuTuanZhen,430529104,8224,958,5338,2669,10951,5331,1927,5722,11053,5771,11109
ɽ,NanShanZhen,430529105,1971,232,1256,819,1684,1227,479,1347,2574,1426,2682
Ϫ,WeiXiXiang,430529200,5835,765,3831,2082,8105,3810,1583,4262,8072,4352,8183
Ӫ,ChangAnYingXiang,430529201,3907,579,2495,1403,5204,2467,896,2817,5284,2887,5382
ëƺ,BaiMaoPingXiang,430529202,11428,1221,7339,3777,14985,7152,2712,7687,14839,8022,15361
,LanRongXiang,430529203,5974,705,3922,1983,8062,3898,1536,4182,8080,4293,8215
͡ƺ,TingPingXiang,430529204,12146,1366,7912,3711,16019,7808,2869,8212,16020,8469,16381
ԯſڽֵ,YuanMenKouJieDao,430581001,45092,5816,31974,18187,51179,30443,12926,30409,60852,31860,63834
ӭֵͤ,YingChunTingJieDao,430581002,49980,4802,33851,20200,50114,32469,13841,32890,65359,34772,68623
Ԫ̩,DengYuanTaiZhen,430581100,43649,6524,31223,16176,62142,31205,13897,32759,63964,32847,64070
ͷ,WanTouQiaoZhen,430581101,48284,7400,33714,19276,69264,33364,15179,36376,69740,37149,70863
ƺ,WenPingZhen,430581102,20982,3397,15605,8865,31166,15598,7673,16417,32015,16447,32052
,JingZhuPuZhen,430581103,24991,4204,18833,10828,37549,18692,9428,19465,38157,19790,38623
,ChouShuTangZhen,430581104,23433,3682,16976,9349,34888,16904,8333,18216,35120,18472,35448
˼,DengJiaPuZhen,430581105,33359,5037,24999,12817,50236,24623,14005,26344,50967,27402,52401
Ϫ,LongXiZhen,430581106,21018,3103,15487,8988,31243,15459,7742,16291,31750,16376,31863
˾,SiMaChongZhen,430581107,15842,2367,11046,6156,22221,10930,4919,11672,22602,12082,23128
,LongTianXiang,430581200,15235,2855,11152,6733,22938,11038,5380,11968,23006,12318,23470
ͷ,TouTangXiang,430581201,26426,4302,18998,10586,37904,18946,8741,20166,39112,20471,39469
,AnLeXiang,430581202,17271,2494,12451,7055,24889,12432,5919,13160,25592,13233,25684
,DaDianXiang,430581203,16236,2445,11604,6348,22934,11584,5358,12345,23929,12435,24039
ƺ,MaPingXiang,430581204,22725,3567,16823,8399,33524,16734,8387,17673,34407,17856,34679
,YanTianXiang,430581205,15174,2563,11106,6087,22753,11089,5739,12327,23416,12370,23476
,QinQiaoXiang,430581206,13542,2270,9844,5613,20663,9834,5163,11057,20891,11131,20975
ˮƺ,ShuiJinPingXiang,430581207,15837,2869,11796,6286,23667,11744,6000,12797,24541,12910,24706
˫,ShuangPaiXiang,430581208,23025,3967,17761,9638,36738,17721,10475,19648,37369,19706,37467
¥ֵ,YueYangLouJieDao,430602001,27896,3684,17663,11987,31949,16038,3710,16215,32253,17627,35290
Žֵ,SanYanQiaoJieDao,430602002,31372,2638,20221,13477,24616,19662,6524,19912,39574,20313,40534
ֵͤ,LvXianTingJieDao,430602003,29760,4324,18885,12478,29183,18463,4360,18964,37427,19559,38444
ɽֵ,JinEShanJieDao,430602004,42917,4275,27129,17596,39978,24072,7190,23790,47862,27253,54382
éֵ,DongMaoLingJieDao,430602005,34641,3685,21554,12497,29814,16522,4831,16497,33019,21603,43157
ƽֵ,WuLiPaiJieDao,430602006,52255,4950,31845,21188,49117,29077,8838,30089,59166,34198,66043
·ֵ,WangYueLuJieDao,430602007,30830,2972,19437,13726,30467,18162,5982,18843,37005,20347,39784
�ֵ,ChengLingJiJieDao,430602008,18989,2500,11769,8969,19564,11609,3198,12090,23699,12918,24687
źֵ,FengQiaoHuJieDao,430602009,36934,2068,22421,15865,21256,22151,7422,23512,45663,24003,46424
ֵ,QiJiaLingJieDao,430602010,52316,1820,29861,9291,48303,15740,6239,16776,32516,30514,60375
ֵͥ,DongTingJieDao,430602011,5357,398,3246,1990,3595,2950,941,3118,6068,3450,6696
ֵ,LuoWangJieDao,430602012,26803,1233,16874,10010,13258,16214,6834,17077,33291,17996,34870
Ϻֵ,NanHuJieDao,430602013,12453,899,7984,4967,7313,7430,2761,7476,14906,8129,16113
վǰֵ,ZhanQianJieDao,430602014,28590,1807,18166,12366,25584,16036,5145,15972,32008,17376,35542
Һӽֵ,WangJiaHeJieDao,430602015,25736,1539,15627,10415,17669,14717,5663,15718,30435,17311,32938
,XiTangZhen,430602100,13611,1494,8714,5106,17663,8680,3013,9317,17997,9404,18118
÷Ϫ,MeiXiXiang,430602200,28964,3644,18835,11894,31197,18480,6381,19504,37984,20154,38989
,GuoZhenXiang,430602201,25961,1031,19129,3879,20104,6207,2582,6562,12769,10445,29574
,SanHeXiang,430602202,18364,2376,11493,7380,23981,11408,3809,12668,24076,13056,24549
,KangWangXiang,430602203,21176,2327,13430,8805,26413,12960,4734,14031,26991,14807,28237
ü�ͨ·�,JingJiJiShuKaiFaQuTongHaiLuGuanLiChu,430602402,46197,2007,27380,17340,13659,25375,10134,27012,52387,30958,58338
ֵ´,QiuSuoJieDaoBanShiChu,430602404,7269,427,4683,2837,2343,4068,1308,4027,8095,4321,9004
ֵ´,HuBinJieDaoBanShiChu,430602405,11245,900,8185,2851,6976,4921,1993,4409,9330,5953,14138
Ź�,JinFengQiaoGuanLiChu,430602406,13785,959,8458,5431,13593,7963,3399,8846,16809,9685,18143
Ϫ,YunXiZhen,430603100,15472,1195,9779,5196,13383,8229,3330,8510,16739,10218,19997
½,LuChengZhen,430603101,7166,974,4573,2119,9327,3775,1303,3932,7707,4870,9443
·,LuKouZhen,430603102,17578,2106,11094,5339,19978,9227,3561,9532,18759,12151,23245
,DaoRenJiZhen,430603103,6694,761,4271,2359,8420,4208,1396,4421,8629,4580,8851
,WenQiaoZhen,430603104,14098,1668,9100,4909,18120,8914,2867,9182,18096,9533,18633
Ϫ,YunXiXiang,430603200,24515,2289,15071,7527,26666,13124,5014,14128,27252,16747,31818
,YongJiXiang,430603201,5615,582,3648,2425,6693,3576,1299,3594,7170,3848,7496
,ChangLianGongKuangQu,430603450,22368,2655,12670,9839,25041,11647,3174,12528,24175,15527,28197
,YueHuaGongKuangQu,430603451,22025,2837,14295,11569,25443,13338,4130,13675,27013,14697,28992
ǽֵ,XiChengJieDao,430611001,20010,2272,12946,8218,24677,12852,4215,13412,26264,13551,26497
,LiuLinZhouZhen,430611100,42204,4561,23812,18057,42797,23407,7752,24223,47630,30705,54517
,GuangXingZhouZhen,430611101,26581,3533,17286,10157,34587,17255,5378,18125,35380,18206,35492
,XuShiZhen,430611102,22247,2771,14202,7384,29172,13709,4581,14587,28296,15397,29599
Ǯ,QianLiangHuZhen,430611103,34109,5293,22651,13912,44538,22613,6400,23066,45679,23151,45802
ı,LiangXinBaoZhen,430611104,23770,3550,15840,10317,30828,14735,4307,14652,29387,15787,31627
ɣ,CaiSangHuZhen,430611105,12364,2048,8416,5268,16241,8217,2522,8238,16455,8518,16934
ټ,RongJiaWanZhen,430621100,113517,6464,65303,31622,107025,46102,20139,49241,95343,74817,140120
,MaTangZhen,430621102,16249,2004,10440,5995,20037,10015,3096,10657,20672,10909,21349
¹,LuJiaoZhen,430621103,23228,3185,14979,9171,30590,14937,5046,16270,31207,16480,31459
ɳ,HuangShaJieZhen,430621104,33105,4177,21935,12893,45364,21927,8577,23892,45819,23924,45859
ǽ,XinQiangZhen,430621105,24704,2735,15514,8798,28696,14050,5018,14979,29029,16943,32457
,BaiXiangZhen,430621106,22633,2828,14686,8443,29608,14625,5163,15779,30404,15938,30624
,GangKouZhen,430621107,38330,5235,24799,14171,50992,24700,8232,26763,51463,26998,51797
,GongTianZhen,430621108,17994,2620,11764,6918,23619,11690,3789,12362,24052,12639,24403
ë,MaoTianZhen,430621109,15002,2152,9913,5462,20331,9632,3401,10126,19758,10642,20555
,YueTianZhen,430621110,28557,4004,19541,10481,39475,19532,7619,20602,40134,20639,40180
ŹӢ,ZhangGuYingZhen,430621111,19088,2303,12817,7106,26231,12782,5190,13699,26481,13764,26581
¿,XinKaiZhen,430621112,25705,3145,16261,9657,32198,16001,5090,17043,33044,17679,33940
,ZhongZhouXiang,430621202,19742,2446,12920,7390,25865,12792,4254,13281,26073,13522,26442
,ChangHuXiang,430621203,27322,3066,17597,10235,35218,17156,6269,18311,35467,19060,36657
,BuXianXiang,430621204,21074,2759,14020,7349,28675,14004,5546,15310,29314,15359,29379
,GanTianXiang,430621205,11314,1711,7362,4026,14765,7278,2408,7821,15099,8071,15433
,YangLinXiang,430621206,19904,2769,13168,7292,26899,13075,4728,14042,27117,14233,27401
ɽ,YunShanXiang,430621207,6616,1092,4514,3040,8998,4489,1571,4722,9211,4765,9279
˼,XiangSiXiang,430621208,11637,1784,7989,4611,15870,7911,3323,8655,16566,8755,16744
Ĵ,RaoCunXiang,430621209,9556,1488,6349,3482,12740,6312,2220,6845,13157,6915,13264
ͥί,DongDongTingHuGuanWeiHui,430621500,42062,376,3154,1009,1728,1424,468,2089,3513,39752,42906
ǹ,ChengGuanZhen,430623100,76100,8600,49377,21789,78895,31773,15028,30878,62651,50351,99728
,SanFengSiZhen,430623101,21682,2759,13913,7370,27748,13640,4123,14176,27816,14651,28564
κӶ,ZhiHeDuZhen,430623102,21606,2750,13514,7576,27107,13023,3644,13700,26723,14486,28000
,BeiJingGangZhen,430623103,28142,4400,18250,10020,36644,17972,4805,18675,36647,19097,37347
,NianYuXuZhen,430623104,23711,3162,15099,8989,30761,14893,4266,15632,30525,16040,31139
μ,SongJiaZuiZhen,430623105,15943,2210,10229,6047,21024,10214,2924,10788,21002,10848,21077
,WanYuZhen,430623106,32327,3789,20237,11943,41408,20136,5799,21303,41439,21678,41915
,ChaQiZhen,430623110,22577,3377,14653,8137,29505,14584,3738,14853,29437,15039,29692
ע̿,ZhuZiKouZhen,430623111,30726,4581,19663,11365,39042,19169,4538,19432,38601,20182,39845
پ,CaoJunZhen,430623112,34557,4848,21820,12562,45003,21783,6284,23579,45362,23869,45689
ɽ,DongShanZhen,430623114,57928,7089,36623,20288,74249,35757,10807,37832,73589,39201,75824
÷,MeiTianHuZhen,430623119,13407,2229,8695,4983,17521,8583,2203,8915,17498,9144,17839
ʤ,ShengFengXiang,430623200,17831,2052,10905,6081,22686,10706,2987,11509,22215,11965,22870
º,XinHeXiang,430623201,27133,3830,17542,10133,35611,17470,4917,18231,35701,18338,35880
,HuChengXiang,430623202,21033,3016,14317,9078,21056,14266,4758,14265,28531,14490,28807
½,XinJianXiang,430623203,15498,2359,9895,5418,20408,9593,2628,10132,19725,10590,20485
ɽ,NanShanXiang,430623204,19320,2817,12341,7465,25433,12285,3635,13337,25622,13431,25772
,ZhongNanXiang,430623205,15077,2087,9417,5227,19519,9294,2568,10059,19353,10315,19732
Ҹ,XingFuXiang,430623206,25526,3628,16423,8602,32694,16066,3788,16036,32102,16519,32942
,TuanZhouXiang,430623207,20489,2328,12535,7279,25476,12254,2934,12768,25022,13216,25751
,WenXingZhen,430624100,114454,11990,71065,30110,125366,46403,17445,45895,92298,72824,143889
,DongTangZhen,430624101,19506,2476,12609,7717,25722,12430,4552,13674,26104,13925,26534
Ԭ,YuanJiaPuZhen,430624102,14956,1785,9796,5465,19694,9576,3336,9966,19542,10281,20077
ͷ,JieTouPuZhen,430624103,11090,1613,7378,4240,14785,7223,2509,7531,14754,7834,15212
,ZhangShuZhen,430624104,16246,2500,10872,6534,21899,10839,3674,11423,22262,11548,22420
,SanTangZhen,430624110,14265,1740,9423,5303,18625,8730,3088,9251,17981,9670,19093
,ChangKangZhen,430624111,15390,2419,10185,6491,21220,10063,3604,11043,21106,11228,21413
,ChengXiZhen,430624115,44408,6836,30233,16045,60622,30081,10894,31589,61670,31905,62138
뱱,LingBeiZhen,430624116,47483,7764,32372,19077,64980,31791,10279,32632,64423,33154,65526
Ȫ,XinQuanZhen,430624117,48829,8810,35059,20594,68273,32962,12163,32928,65890,34743,69802
,XiangBinZhen,430624118,33688,5715,24109,13693,47440,23428,9333,23794,47222,24627,48736
Ϻ,NanHuZhouZhen,430624119,36213,5952,24854,14877,49657,24831,8371,25638,50469,25682,50536
ʯ,ShiTangXiang,430624200,15834,2002,10010,5935,20660,9825,3538,11023,20848,11364,21374
,LiuTangXiang,430624201,9697,1401,6302,3953,13012,6215,2291,6893,13108,7087,13389
,BaiNiHuXiang,430624202,10856,1392,7074,3867,14198,6758,2456,7250,14008,7630,14704
,JingHeXiang,430624203,18868,2904,12802,7454,26239,12515,4712,13178,25693,13682,26484
,YuHuaXiang,430624204,11869,1718,7918,4467,16191,7735,2793,8377,16112,8462,16380
կ,YangLinZhaiXiang,430624206,15609,2133,11195,5963,22052,11174,4468,10958,22132,11015,22210
̶,QingTanXiang,430624209,690,181,480,351,715,478,87,457,935,478,958
ǹ,ChengGuanZhen,430626100,71277,7887,48426,29547,69715,44315,16957,44090,88405,47695,96121
,AnDingZhen,430626101,37529,6419,27415,16252,53885,27208,11238,27507,54715,27771,55186
,SanShiZhen,430626102,34970,4958,24343,12190,49260,24278,9816,25251,49529,25401,49744
,JiaYiZhen,430626103,29732,4463,21377,11678,42434,21362,9076,21865,43227,21894,43271
,ChangShouZhen,430626104,46831,6203,32901,17944,62365,32222,14039,33153,65375,34172,67073
,LongMenZhen,430626105,21606,3514,15587,8509,32144,15479,7643,17028,32507,17176,32763
,HongQiaoZhen,430626106,21619,3305,15108,8455,30988,14681,6661,15887,30568,16477,31585
Ͻ,NanJiangZhen,430626107,49907,6571,33901,18347,68370,33785,13058,35475,69260,35635,69536
÷,MeiXianZhen,430626108,42424,5645,29361,15060,59180,28946,12420,30499,59445,31128,60489
䴿,WuKouZhen,430626109,23567,3548,15687,8961,32634,15583,6097,17354,32937,17525,33212
ͽ,WengJiangZhen,430626110,32580,5198,21416,12291,44944,20846,7683,23195,44041,24045,45461
,WuShiZhen,430626111,50731,6172,33557,17504,66274,32046,12243,33657,65703,35589,69146
,XiangJiaZhen,430626112,11918,1548,7872,4484,15105,7716,2685,8089,15805,8279,16151
ͯ,TongShiZhen,430626113,20565,3106,13438,7318,28156,13134,4853,14549,27683,15086,28524
᯴,CenChuanZhen,430626114,12463,1496,8604,5046,16965,8587,3671,8957,17544,9026,17630
ɽ,FuShouShanZhen,430626115,12894,2085,8822,4422,17555,8778,3295,9327,18105,9452,18274
,SanYangXiang,430626200,34801,5554,24491,14977,48161,24365,9738,24945,49310,25602,50093
ӽ,YongShengXiang,430626202,2251,356,1473,829,3128,1461,587,1679,3140,1721,3194
ƽ,HuangJinDongXiang,430626203,3185,374,2045,1305,4172,2036,795,2289,4325,2309,4354
,NanQiaoXiang,430626204,1781,300,1120,780,2418,1096,463,1294,2390,1424,2544
ľ,MuJinXiang,430626205,13540,2252,10022,5706,20265,9914,4862,10450,20364,10632,20654
ƺ,DaPingXiang,430626206,14179,2005,10113,5352,20492,10090,4723,10737,20827,10794,20907
,DongTaXiang,430626207,15717,1873,10850,5360,21721,10850,4426,11166,22016,11166,22016
彭,BanJiangXiang,430626208,9487,1175,6324,3400,12800,6284,2308,6544,12828,6646,12970
,DaZhouXiang,430626209,13239,1867,8904,4991,18641,8898,3782,9955,18853,9984,18888
,SanDunXiang,430626210,16631,2958,11621,7209,24226,11484,5158,12847,24331,13126,24747
ƺ,YuPingXiang,430626211,22607,3575,15626,9074,32614,15568,6859,17292,32860,17415,33041
ʽֵ´,TianWenJieDaoBanShiChu,430681001,4527,466,2995,2356,4367,2891,674,2646,5537,2672,5667
ǹ,ChengGuanZhen,430681100,44319,4920,28079,15316,50896,22018,7173,21902,43920,28333,56412
,MiLuoZhen,430681101,17357,2243,11221,6637,21307,11157,3752,12005,23162,12131,23352
,XinShiZhen,430681102,21343,2313,13576,7400,25149,13041,4416,13684,26725,14496,28072
,GuPeiZhen,430681103,23463,3000,15048,8233,30844,14764,4678,15471,30235,16093,31141
ˮ,BaiShuiZhen,430681104,21336,2679,13677,7578,27210,13625,4198,14448,28073,14536,28213
ɽƺ,ChuanShanPingZhen,430681105,19176,2389,12261,6983,24389,12251,3559,12830,25081,12863,25124
߼ҷ,GaoJiaFangZhen,430681106,17793,2899,11388,7233,21630,10692,2938,11362,22054,12242,23630
ʱ,BiShiZhen,430681107,17929,3018,11960,8389,23738,11764,3195,11889,23653,12182,24142
Ҷ,LiJiaDuanZhen,430681108,14624,2756,9780,5606,19446,9422,2502,9519,18941,10102,19882
ư,HuangBoZhen,430681109,22616,3573,14845,8084,29881,13808,3812,14026,27834,15156,30001
,ChangLeZhen,430681110,21440,2432,14102,8058,27873,13623,5091,14190,27813,14861,28963
,DaJingZhen,430681111,8540,1104,5607,3060,11502,5600,1901,5908,11508,5938,11545
,TaoLinSiZhen,430681112,20172,2321,13036,7599,25871,12506,4723,13625,26131,14180,27216
,SanJiangZhen,430681113,11800,1361,7580,4320,15681,7518,2738,8212,15730,8319,15899
԰,FanJiaYuanZhen,430681114,10842,1585,7269,4594,14555,7269,2538,7691,14960,7696,14965
ɳϪ,ShaXiZhen,430681115,11724,2524,8048,4573,16229,8032,2145,8325,16357,8345,16393
Ӫ,YingTianZhen,430681116,23702,3227,15741,10272,28393,15558,4820,15831,31389,16008,31749
,HeShiZhen,430681117,6419,842,4306,2556,8250,4299,1501,4422,8721,4456,8762
,QuZiCiZhen,430681118,11766,1936,8410,5549,16444,8383,3207,8466,16849,8499,16909
ǽ,ChengJiaoXiang,430681200,35508,3296,22919,13905,37443,22668,7369,22765,45433,23254,46173
컨,HongHuaXiang,430681201,17797,2185,11897,6637,23585,11710,4351,12151,23861,12436,24333
,HuangShiXiang,430681202,10437,1406,6970,3964,14121,6901,2642,7375,14276,7515,14485
,YuChiXiang,430681203,4380,912,2769,1976,5627,2745,658,3094,5839,3181,5950
쾮,TianJingXiang,430681205,11103,1512,7202,3904,14960,7120,2433,7672,14792,7846,15048
Ƿ,ZhiFengXiang,430681206,6641,787,4467,2389,9128,4432,1723,4648,9080,4684,9151
,GuLunXiang,430681208,9188,1610,6287,3265,13042,6130,2264,6531,12661,6775,13062
,HuoTianXiang,430681209,13704,1670,8862,4815,18450,8853,3204,9709,18562,9716,18578
,XinTangXiang,430681210,6890,1526,5238,3768,10222,5223,2188,5330,10553,5366,10604
,BaiTangXiang,430681211,14078,1944,9356,5669,19411,9338,3662,10193,19531,10328,19684
ʯ,LeiShiXiang,430681214,4220,453,2673,1546,5478,2632,864,2777,5409,2864,5537
˾,BaJingXiang,430681215,2789,326,1774,946,3701,1716,627,1886,3602,1968,3742
ƽ,HuangJinXiang,430681216,10589,1528,7031,3947,13835,6760,2301,7059,13819,7387,14418
,QinQiXiang,430681217,5046,697,3358,1959,6548,3343,1150,3512,6855,3535,6893
,FengHuangXiang,430681218,6546,1050,4456,2485,8756,4383,1368,4364,8747,4508,8964
ԭֳ,YuanZhongChang,430681401,2523,272,1565,922,2976,1559,490,1704,3263,1720,3285
԰Ҷʾ,FanJiaYuanChaYeShiFanChang,430681402,1692,216,1083,638,2153,1082,357,1181,2263,1182,2265
Ӫ´,YingTianBanShiChu,430681403,1404,238,951,665,1245,951,229,920,1871,920,1871
ֵ,ChangAnJieDao,430682001,89037,6955,56972,33658,96131,55075,22065,58780,113855,61085,118057
ҿֵ,TaoKuangJieDao,430682003,5670,1720,4160,3778,7631,4144,1041,4252,8396,4271,8431
ҷ,ZhongFangZhen,430682101,21351,2337,13657,7241,28057,13651,5071,15094,28745,15102,28759
,BaiYunZhen,430682102,11094,1092,7285,3744,12914,6951,3052,7579,14530,7953,15238
,NieShiZhen,430682103,14645,2142,9712,5303,19131,9525,3524,10374,19899,10599,20311
Դ̶,YuanTanZhen,430682104,11825,1443,7669,3924,15053,7420,2528,7783,15203,8127,15796
,JiangNanZhen,430682105,15356,2636,10160,5827,20869,9999,3555,11018,21017,11387,21547
,TaoLinZhen,430682107,26783,2790,17142,8770,31914,15778,6731,17262,33040,19162,36304
,ChangTangZhen,430682108,17755,2086,11674,6157,23178,11620,4739,12784,24404,12906,24580
,BaiYangTianZhen,430682109,16077,2256,10562,5682,21525,10553,3641,11401,21954,11412,21974
ղ,ZhanQiaoZhen,430682110,27051,2986,17585,9049,36009,17536,7013,19336,36872,19465,37050
Ϫ,RuXiZhen,430682111,7815,1007,5004,2599,9518,4975,1563,5291,10266,5381,10385
,DingHuZhen,430682112,11201,1288,7327,3831,14798,7259,2791,7820,15079,7953,15280
Ƹ,HuangGaiZhen,430682113,7391,975,4796,2876,9356,4795,1377,4943,9738,4947,9743
¥˾,YangLouSiZhen,430682114,28419,2983,18660,10289,36456,18560,7433,19939,38499,20175,38835
,WuLiXiang,430682200,17405,1939,11289,5580,20344,11095,4411,12169,23264,12466,23755
˷,ChengFengXiang,430682201,6402,916,4191,2480,8400,4188,1436,4559,8747,4563,8754
̹,TanDuXiang,430682204,12137,1276,7364,3831,14222,6884,2642,7554,14438,8691,16055
,ChengNanXiang,430682205,9573,959,5883,3068,11801,5764,2156,6555,12319,6805,12688
,HengPuXiang,430682206,10987,1426,6862,3893,14766,6862,2364,7915,14777,7915,14777
Ƕֵ,ChengDongJieDao,430702001,52798,5895,33667,22671,48249,30317,7748,29630,59947,32774,66441
Ͻֵ,ChengNanJieDao,430702002,30025,2965,17782,10862,19556,14314,3258,13574,27888,18466,36248
ֵ,ChengXiJieDao,430702003,62646,5927,40170,26156,55778,35718,9503,33974,69692,37906,78076
Ǳֵ,ChengBeiJieDao,430702004,44723,4846,28845,20163,37883,27785,7186,27054,54839,27910,56755
·ֵ,SanChaLuJieDao,430702005,98595,7272,64517,27207,59070,37243,9835,35849,73092,51185,115702
ɽֵ,DeShanJieDao,430702006,40922,5636,24242,13503,42312,16452,6626,16067,32519,28942,53184
ӛ,HeFuZhen,430702100,13231,2027,8621,5152,14884,8304,1881,8007,16311,8518,17139
ɽ,DeShanZhen,430702101,24212,2990,15827,8708,26610,14878,3989,14155,29033,15364,31191
«ݶɽ,LuDiShanXiang,430702200,21041,3192,13364,8029,25604,13320,2882,13387,26707,13751,27115
,DongJiaoXiang,430702201,21678,2129,13726,8675,15494,13264,3390,12715,25979,13471,27197
,DongJiangXiang,430702202,8216,967,5217,2662,8056,4804,1245,4576,9380,5211,10428
,HuChengXiang,430702203,21258,1484,13211,8982,11317,12627,3464,12166,24793,12995,26206
,DanZhouXiang,430702204,17482,2993,11714,7195,21662,11583,2781,11304,22887,11542,23256
ƺ,NanPingGangXiang,430702205,22109,1595,12911,7947,16261,12243,3462,12151,24394,14255,27166
Ҷζɼ,LiuYeHuLvYouDuJiaQu,430702401,19230,2198,12351,7453,19936,12262,3048,11801,24063,12125,24476
,WuLingZhen,430703100,97126,7745,59979,28801,73281,44656,14743,44159,88815,59635,119614
Ӹ,HaoZiGangZhen,430703101,22669,3370,14425,7732,27185,13062,3237,12997,26059,14851,29276
кӿ,ZhongHeKouZhen,430703102,20785,3322,13535,7707,26979,13506,3404,13930,27436,13976,27511
ʮ,ShiMeiTangZhen,430703103,16901,2770,11068,6143,21299,10958,2619,11074,22032,11222,22290
ţ̲,NiuBiTanZhen,430703104,25797,4379,16840,9924,33513,16065,3661,16167,32232,16997,33837
,HanGongDuZhen,430703105,27666,4683,18199,10855,35889,18181,4326,18422,36603,18476,36675
ʯ,ShiGongQiaoZhen,430703106,23220,4048,15166,9103,30291,14719,3477,14947,29666,15579,30745
,ZhenDeQiaoZhen,430703107,12947,2203,8281,5130,16370,8236,1592,8350,16586,8461,16742
ܼҵ,ZhouJiaDianZhen,430703108,23503,3882,15618,9578,29040,14851,4034,14868,29719,15801,31419
վ,DaLongZhanZhen,430703109,7993,1394,5083,2803,10093,4718,1040,4692,9410,5344,10427
˫ƺ,ShuangQiaoPingZhen,430703110,12015,2407,8283,5251,16335,8134,2368,8207,16341,8507,16790
Ϫ,GuanXiZhen,430703111,23009,2923,14247,7603,25359,13927,3268,13816,27743,14953,29200
̼Ҹ,CaiJiaGangZhen,430703112,12012,1898,7743,4584,14842,7579,1681,7596,15175,7848,15591
ķ,DouMuHuZhen,430703113,15928,2517,10306,5465,19796,9575,2369,9565,19140,10508,20814
ƺ,CaoPingZhen,430703114,17869,3111,11733,7130,22966,11707,2551,11760,23467,11798,23531
ʯ,ShiMenQiaoZhen,430703115,31555,5216,20637,10826,40368,19975,4640,19839,39814,20774,41411
л,XieJiaPuZhen,430703116,14497,2725,10037,5986,18812,9896,2775,9760,19656,9960,19997
,HuangTuDianZhen,430703117,17645,3064,11684,6494,20437,10743,2520,10590,21333,11545,23229
Ңƺ,YaoTianPingZhen,430703118,8909,1860,6117,4220,11873,6053,1664,6247,12300,6316,12433
۶,GangErKouZhen,430703119,10004,2129,6862,4256,13784,6576,1827,6712,13288,7098,13960
׹,LeiGongMiaoZhen,430703120,10059,1660,6550,4021,13086,6502,1611,6660,13162,6780,13330
ʯ̲,ShiBanTanZhen,430703121,16173,2474,10201,6092,19351,10116,2082,10098,20214,10528,20729
,HuangZhuZhouXiang,430703200,11887,1925,7861,4489,15748,7798,2032,7850,15648,7983,15844
ɽ,HeiShanZuiXiang,430703201,12139,2157,8015,4899,15536,7930,1931,8068,15998,8212,16227
׺ɽ,BaiHeShanXiang,430703202,17663,3178,10578,7211,20140,10450,2273,10282,20732,12536,23114
,ChangLingGangXiang,430703203,6816,1333,4542,2811,8873,4431,1044,4478,8909,4651,9193
Żά,XuJiaQiaoHuiZuWeiWuErZuXiang,430703204,14344,2838,9788,5591,18087,9371,2405,9475,18846,9799,19587
Ҹ,DingJiaGangXiang,430703205,10322,2229,7068,4565,13986,7049,1800,7258,14307,7283,14351
Ǯƺ,QianJiaPingXiang,430703206,8487,1839,5813,3336,11417,5679,1532,5788,11467,6045,11858
Ƽ,TangJiaPuXiang,430703207,9991,2130,6723,4149,13366,6577,1539,6700,13277,6937,13660
ɽ,CangShanXiang,430703208,7596,1765,5337,3405,10287,5282,1393,5338,10620,5417,10754
é,ChangMaoLingXiang,430703209,7683,2025,5649,4100,11165,5648,1666,5722,11370,5725,11374
潭ƺ,NiJiangPingXiang,430703210,6222,1529,4650,3168,8775,4594,1395,4408,9002,4496,9146
԰ճ,DingChengQuYuanYiChang,430703500,4547,676,2874,1675,5490,2819,587,2738,5557,2936,5810
ֳ,TeZhongYangZhiChang,430703501,3073,481,1988,1249,3968,1988,452,2018,4006,2018,4006
Ϫֳ,HuaYanXiLinChang,430703502,2410,399,1623,1050,3199,1588,437,1571,3159,1623,3246
ؼɽԭֳ,HeJiaShanYuanZhongChang,430703503,6082,1239,4301,2555,8188,4251,972,3948,8199,3992,8293
ͥ,XiDongTingGuanLiQu,430703504,40856,5647,26393,14190,38559,20281,4322,20179,40460,24432,50825
,ShenLiuZhen,430721100,98680,11748,63120,32463,108272,48466,16158,49002,97468,63466,126586
󾨸,DaJingGangZhen,430721101,17342,2191,10753,5351,21078,8854,2447,9106,17960,11227,21980
ɽͷ,HuangShanTouZhen,430721102,26108,3693,16671,10017,32809,15514,4217,15849,31363,17347,34018
,SanChaHeZhen,430721103,15650,2727,10318,5544,20188,9708,2456,9807,19515,10515,20833
و,GuanDangZhen,430721104,16908,2448,10693,6088,21510,10342,2409,10678,21020,11072,21765
,XiaYuKouZhen,430721105,25107,4031,16262,9463,32588,15901,4094,16478,32379,16970,33232
¼,ChenJiaZuiZhen,430721106,16191,2535,10486,5908,21033,10006,2697,10383,20389,10937,21423
,JiaoQiZhen,430721107,12999,2108,8843,5100,17119,8056,2378,7992,16048,8642,17485
,AnZhangXiang,430721201,15822,2379,10242,5232,20414,9128,2494,9366,18494,10453,20695
,AnChangXiang,430721202,14788,2617,9366,5487,19322,9079,2161,9601,18680,10200,19566
,AnHongXiang,430721203,13150,2419,8578,5203,17230,8565,2094,8988,17553,9085,17663
,AnShengXiang,430721204,13242,2143,8439,4249,17065,7066,1972,7394,14460,8918,17357
ȫ,AnQuanXiang,430721205,19893,3086,12990,6864,23470,11515,3082,11731,23246,13071,26061
,AnFuXiang,430721206,16781,3086,10801,5948,21954,9703,2437,9980,19683,11503,22304
,AnNingXiang,430721207,15928,2805,10176,5553,20674,9656,2060,9954,19610,10617,20793
,AnFengXiang,430721208,18737,3522,12582,7861,24508,12347,3127,12405,24752,12804,25386
ԣ,AnYuXiang,430721209,13385,2410,8688,4958,17351,8611,2011,8997,17608,9118,17806
,AnKangXiang,430721210,18010,3080,11471,6230,23379,10448,2777,10966,21414,12396,23867
,AnDeXiang,430721211,12787,2166,8179,4274,16787,7741,2071,8293,16034,8845,17024
,JiangJiaZuiZhen,430722101,37079,4117,24314,15268,43708,22800,7342,23256,46056,24224,48538
,YanWangHuZhen,430722102,19683,2931,12965,6761,25099,12367,3655,12528,24895,13304,26269
ͷ,PoTouZhen,430722103,15298,2685,10447,6859,19960,10394,3084,10529,20923,10620,21067
ϸ,YouGangZhen,430722104,27691,4084,18309,10168,35975,17872,5357,18287,36159,18823,37132
޿,ZhouKouZhen,430722105,23398,3692,15527,9210,30990,15524,4398,15953,31477,15961,31488
ͷ,GuanTouZuiZhen,430722106,23490,3567,15554,8671,30765,15292,4343,15554,30846,15846,31400
׸,CangGangZhen,430722107,15068,2391,9938,5748,19685,9924,2578,10081,20005,10099,20037
,ZhuJiaPuZhen,430722108,16281,2579,10767,5751,21482,10765,3155,11238,22003,11248,22015
̫,TaiZiMiaoZhen,430722109,15170,2164,10601,6285,19914,10410,4069,10569,20979,10802,21403
ع,YuDePuZhen,430722110,8530,1618,6203,3993,11718,6203,2240,6178,12381,6185,12388
޼,CuiJiaQiaoZhen,430722111,12052,1822,8221,4459,16031,8131,2971,8438,16569,8624,16845
ɽ,JunShanPuZhen,430722112,18395,2652,12413,6352,25116,11984,4572,12721,24705,13206,25619
»,BaiLuQiaoZhen,430722113,13077,2096,9067,5612,17458,8999,3358,9370,18369,9464,18531
,XiHuZhen,430722114,9919,937,6502,4681,11958,6327,2343,6561,12888,6697,13199
Ժ,YangTaoHuZhen,430722115,10258,1639,6895,3548,13369,6039,1771,5874,11913,6773,13668
,LongYangZhen,430722116,91019,10631,60153,38636,95472,57068,17763,56384,113452,59260,119413
,ZhouWenMiaoXiang,430722201,12504,2076,8643,5217,17097,8643,2994,8931,17574,8931,17574
ѼӸ,YaZiGangXiang,430722202,17141,2661,11348,6207,22280,11280,3058,11406,22686,11512,22860
ε,WenWeiXiang,430722203,11007,1590,7096,4235,14225,7092,1864,7360,14452,7365,14461
,XinXingXiang,430722204,15317,2592,10208,5881,20117,10208,2689,10390,20598,10390,20598
,NieJiaQiaoXiang,430722205,12716,2300,8560,5059,16606,8541,2407,8821,17362,8863,17423
ë̲ά,MaoJiaTanHuiZuWeiWuErZuXiang,430722206,18910,2838,12617,7331,24975,12213,3635,12377,24590,12766,25383
,FengJiaPuXiang,430722207,16959,2481,11281,5985,22785,11164,4319,12248,23412,12478,23759
,DongYueMiaoXiang,430722208,15542,2552,10551,5439,21123,10411,3918,11198,21609,11461,22012
,YanZuiXiang,430722209,15306,2495,10499,6043,20551,10499,3840,11142,21641,11142,21641
ľɽ,ZhuMuShanXiang,430722210,17502,2656,12026,6819,22212,11708,4331,12058,23766,12463,24489
,SanHeXiang,430722211,12980,2055,8801,5130,17741,8766,3398,9554,18320,9632,18433
̶,LongTanQiaoXiang,430722212,17153,2761,11775,6767,23699,11775,4410,12549,24324,12549,24324
̶,YueMingTanXiang,430722213,13749,2510,9932,6242,19556,9873,3819,10066,19939,10146,20078
Ϻ,DaNanHuXiang,430722216,7522,992,4916,2791,9823,4660,1478,4732,9392,5076,9992
,XiHuGuanLiQu,430722501,26946,3722,19064,10844,37600,19011,7312,18850,37861,18916,37980
,LiYangZhen,430723100,155564,14726,103017,56906,145460,89601,29483,84726,174327,96756,199773
Ź,ZhangGongMiaoZhen,430723101,19108,3706,13484,8321,25484,13458,3362,12633,26091,12692,26176
Сɿ,XiaoDuKouZhen,430723102,32897,4356,20683,10822,38882,18539,4817,18887,37426,21387,42070
Ϫ,MengXiZhen,430723103,16615,3224,11478,7505,22539,10844,3218,10759,21603,11579,23057
˳,FuXingChangZhen,430723104,11557,2009,7678,5258,15193,7593,1895,7639,15232,7783,15461
ξ,YanJingZhen,430723105,11183,1984,7363,5075,14567,7341,1737,7501,14842,7541,14904
׹,LeiGongTaZhen,430723106,13595,2347,9194,5729,17974,9137,2502,9147,18284,9250,18444
߈,DaYanDangZhen,430723107,24255,4317,16765,12698,32572,16480,5060,16193,32673,16867,33632
ҳ,WangJiaChangZhen,430723108,13991,2689,9741,6514,18621,9646,2791,9549,19195,9730,19471
,JinLuoZhen,430723109,19004,3033,12649,8237,25220,12332,3617,12541,24873,13005,25654
ͷ,MaTouPuZhen,430723110,9503,1741,6630,3931,13072,6542,1965,6366,12908,6579,13209
ʯƺ,FangShiPingZhen,430723111,9180,1667,6302,4216,12191,6292,1872,6384,12676,6417,12719
Ϫ̲,GanXiTanZhen,430723112,12538,2141,8574,5453,16803,8570,2645,8712,17282,8750,17324
,HuoLianPoZhen,430723113,9677,1734,6972,4376,13343,6947,2407,6778,13725,6846,13818
,LiNanZhen,430723114,18488,3036,12739,7553,24436,12737,3280,12062,24799,12065,24804
,JiuYuanXiang,430723200,16292,2649,10901,6412,21359,10899,2727,10741,21640,10767,21668
,GuanYuanXiang,430723201,12951,2373,8633,5996,15510,8633,2128,8819,17452,8819,17452
,YongFengXiang,430723202,14007,3024,10156,6510,19555,9633,2901,9206,18839,9776,19932
綫,RuDongXiang,430723203,16532,2663,11293,6961,22165,11286,3254,11125,22411,11156,22449
,LiDanXiang,430723204,28813,3768,18864,10746,34997,18783,5360,18801,37584,19077,37941
墶,LiDongXiang,430723206,18538,3449,12965,7662,25193,12890,3645,12479,25369,12667,25632
,CenNanXiang,430723207,14508,2580,10269,6606,19858,10264,3009,9818,20082,9828,20097
ƺ,DaPingXiang,430723208,12893,2403,8836,5361,17100,8768,2526,8873,17641,8986,17822
,DaoHeXiang,430723209,9978,1588,6424,4168,12894,6310,1478,6343,12653,6620,13044
˫,ShuangLongXiang,430723210,9457,1559,6401,3936,12564,6384,1806,6372,12756,6421,12822
,YiWanXiang,430723211,14635,2471,9621,6146,19325,9617,2502,9965,19582,9987,19608
Ϫ,CheXiXiang,430723212,18405,3148,12413,7770,24809,12282,3615,12499,24781,12755,25168
,ZhongWuXiang,430723213,14304,2161,9340,5764,18701,9038,2403,9056,18094,9528,18868
բ,ZhaKouXiang,430723214,14503,2533,9652,6327,19435,9287,2662,9613,18900,10046,19698
,DongShiXiang,430723215,7899,1384,5408,3250,10382,5398,1550,5415,10813,5425,10833
ҷ,YangJiaFangXiang,430723216,5760,1285,4296,2849,8346,4290,1547,4265,8555,4296,8592
̫,TaiQingXiang,430723217,9876,2069,7076,4691,14292,7019,2568,7189,14208,7437,14513
,AnFuZhen,430724100,57345,5417,37263,21759,54821,33626,10181,32256,65882,35680,72943
Ͽ,HeKouZhen,430724101,31695,5192,21536,13405,40490,21241,5985,20803,42044,21336,42872
°,XinAnZhen,430724102,31713,5158,21680,12506,39707,21487,6015,20896,42383,21206,42886
,SheShiQiaoZhen,430724103,14024,2055,9149,5623,18272,9142,2502,9424,18566,9432,18581
̫,TaiFuZhen,430724104,9778,1592,6399,3877,12875,6321,1699,6584,12905,6670,13069
¸,SiXinGangZhen,430724105,12070,2195,8124,5463,16338,8046,2309,8297,16343,8450,16574
ͣҶ,TingXianDuZhen,430724106,12541,2368,8532,5554,16762,8292,2107,8054,16346,8484,17016
÷,XiuMeiZhen,430724107,13376,2124,8754,5375,17404,8729,2136,8788,17517,8882,17636
ɼ,ShanBanXiang,430724200,8797,1609,6268,4047,11906,6222,2041,6018,12240,6179,12447
ļ,WenJiaXiang,430724201,10401,1763,6926,4316,13735,6772,1853,6924,13696,7091,14017
¶,ChenErXiang,430724202,10464,1669,6639,3874,13611,6505,1599,6737,13242,7093,13732
֦,BaiZhiXiang,430724203,19180,3182,12623,7251,25694,12416,3450,12697,25113,13189,25812
,FengHuoXiang,430724204,15105,2392,9805,5759,19762,9609,2349,9699,19308,10041,19846
,WangChengXiang,430724205,13385,1905,8787,4942,17337,8650,2347,8600,17250,8850,17637
,YangBanXiang,430724206,12673,2182,8434,5656,16700,8371,2130,8448,16819,8551,16985
ͤ,GuanTingXiang,430724207,15700,2420,10419,5562,20630,10373,2935,10547,20920,10636,21055
,JiuLiXiang,430724208,13212,2048,8772,5294,17027,8624,2471,8627,17251,8959,17731
Ľ,ZhangJiangZhen,430725100,94294,10936,61677,41895,96920,57778,16147,56475,114253,59700,121377
,ZouShiZhen,430725101,39103,5655,25546,16615,47839,24935,6397,25067,50002,25609,51155
,PanTangZhen,430725102,15014,2397,8962,5969,17694,8742,2531,9076,17818,10980,19942
,ReShiZhen,430725103,18801,3330,12762,8170,25366,12749,3910,13250,25999,13279,26041
ʯ,HuangShiZhen,430725104,11843,2532,8070,5471,16206,8035,2225,8469,16504,8530,16600
,QiHeZhen,430725105,36912,6835,24673,15621,47779,24187,6645,25241,49428,25719,50392
�,LiGongGangZhen,430725106,10410,2156,7212,4361,14431,7212,2423,7777,14989,7777,14989
,GuanYinSiZhen,430725107,14958,2823,9552,6493,20185,9552,2731,10958,20510,10960,20512
̶,LongTanZhen,430725108,15097,3847,10871,7449,22179,10850,3674,11730,22580,11747,22618
,SanYangGangZhen,430725109,16158,3106,10564,6847,20256,10131,2649,10790,20921,11349,21913
,JianShiZhen,430725110,14423,3140,9946,6826,20034,9905,2874,10432,20337,10491,20437
,ChaAnPuZhen,430725111,15911,3246,10933,7612,20926,10860,3257,11350,22210,11481,22414
,XiAnZhen,430725112,9461,1530,6310,3791,12512,6305,2177,6837,13142,6858,13168
ɳƺ,ShaPingZhen,430725113,11141,1985,7106,5126,14633,7103,1728,7744,14847,7748,14854
һԴ,TaoHuaYuanZhen,430725114,19399,3530,12924,7775,24156,12364,3411,12876,25240,13416,26340
,JiaQiaoZhen,430725115,18855,3836,12824,8247,25622,12797,3616,13435,26232,13483,26307
,MaZongLingZhen,430725116,13835,2682,9399,6287,19016,9394,2755,9868,19262,9873,19272
̲,LingJinTanZhen,430725117,12360,2536,8338,5286,16932,8322,2352,8865,17187,8910,17248
,QingLinXiang,430725200,15467,2559,10557,5847,19447,9974,3216,10160,20134,10685,21242
,CheHuYuanXiang,430725201,11024,2127,7605,4301,14822,7605,2184,7729,15334,7730,15335
ά,FengShuWeiWuErZuHuiZuXiang,430725202,19778,3278,13163,7359,26293,13139,4031,13869,27008,13924,27087
ľ,MuTangYuanXiang,430725203,19822,4071,13848,7860,27196,13822,3977,13964,27786,14022,27870
˫Ϫ,ShuangXiKouXiang,430725206,15819,2760,10651,6486,21630,10651,3261,11189,21840,11189,21840
ƺ,HaoPingXiang,430725207,6979,1236,4509,2834,9162,4501,1243,4936,9437,4949,9458
Ϫ,JiuXiXiang,430725208,13496,2900,9117,5720,18243,9105,2465,9707,18812,9744,18861
Ƽ,HuangJiaPuXiang,430725209,10827,2178,7404,4545,14627,7404,2068,7666,15070,7669,15073
Ӽ,ZhongJiaPuXiang,430725210,9164,2047,6258,3887,12747,6238,1875,6783,13021,6828,13086
ţ,NiuCheHeXiang,430725211,8005,1925,5554,3714,11153,5554,1494,5870,11424,5870,11424
ܼƺ,SheJiaPingXiang,430725212,12184,2896,8207,5652,16670,8200,2150,9004,17204,9023,17230
̫ƽ,TaiPingQiaoXiang,430725213,10200,2197,6792,4536,14062,6791,1767,7365,14156,7372,14164
Ϫ,WuXiHeXiang,430725214,8486,1772,5790,3524,11836,5781,1742,6200,11981,6210,12000
ˮ,ShenShuiGangXiang,430725215,13262,2588,8951,5465,17826,8946,2239,9128,18074,9138,18089
̶,NiWoTanXiang,430725216,11382,2223,7608,4625,15262,7608,2202,8199,15807,8199,15807
¡,XingLongJieXiang,430725218,7443,1372,5051,3337,10094,5014,1659,5332,10346,5423,10474
̫ƽ,TaiPingPuXiang,430725219,6723,1215,4320,2643,8679,4224,1265,4752,8976,4883,9203
ţɽ,GuNiuShanXiang,430725220,3758,594,2137,1307,4329,2064,470,2325,4389,2685,4822
Ϫ,YangXiQiaoXiang,430725221,6917,1277,4656,2995,9035,4654,1360,4889,9543,4898,9554
ƺ,SiPingXiang,430725222,8538,1526,5879,3598,11595,5866,1771,5943,11809,5956,11835
֣,ZhengJiaYiXiang,430725223,8054,1540,5490,3562,10755,5455,1575,5635,11090,5679,11169
«̶,LuHuaTanXiang,430725224,8885,1767,5981,3639,12242,5981,1808,6479,12460,6479,12460
,ChuJiangZhen,430726100,86005,8531,56057,35086,82695,51646,14986,49174,100820,53465,109522
Ȫ,MengQuanZhen,430726101,46943,6916,31314,17689,60764,30015,8777,29849,59864,31322,62636
ɽ,JiaShanZhen,430726102,32380,4730,21405,12502,42242,21195,6044,21363,42558,21749,43154
׼Ҷ,YiJiaDuZhen,430726103,21934,3470,14903,8391,27876,14639,4158,14343,28982,14659,29562
¹,XinGuanZhen,430726104,14001,2343,9591,6213,17919,9554,2712,9285,18839,9465,19056
,ZaoShiZhen,430726105,14474,2987,10220,7168,18636,9835,2908,9760,19595,10149,20369
ά,WeiXinZhen,430726106,12769,2372,8242,5056,16810,8174,2262,9021,17195,9161,17403
̫ƽ,TaiPingZhen,430726107,17525,3752,11674,8391,24254,11663,3391,12947,24610,12994,24668
ĥ,MoShiZhen,430726108,20572,3871,13360,7877,27837,13334,3703,14709,28043,14786,28146
ƿɽ,HuPingShanZhen,430726109,19332,3581,12040,7840,25156,11984,3034,13743,25727,13907,25947
ϱ,NanBeiZhen,430726110,4944,1058,3222,2374,6530,3216,845,3591,6807,3625,6847
,ErDouXiang,430726200,20844,3090,14105,7782,25312,13465,3836,12985,26450,13665,27770
,XinPuXiang,430726201,18281,3442,12590,7684,25111,12583,4079,13207,25790,13212,25802
,BaiYunXiang,430726202,20650,3510,13524,8601,27206,13439,3661,14121,27560,14297,27821
ʥ,SanShengXiang,430726203,24364,4851,16414,10123,33668,16349,4879,17539,33888,17680,34094
,ZiLiangXiang,430726204,15463,3325,10829,7428,21643,10578,3376,10921,21499,11335,22164
,SuoJieXiang,430726205,16942,3523,11506,8089,23297,11484,3412,12322,23806,12371,23877
,YanChiXiang,430726206,16943,4171,11802,8696,23960,11595,3605,12307,23902,12917,24719
ƺ,LuoPingXiang,430726207,10193,1816,6475,4166,13614,6465,1797,7285,13750,7331,13806
ƺ԰ճ,XiuPingYuanYiChang,430726500,2590,442,1833,1319,3499,1825,581,1779,3604,1780,3613
ɽũ,DongShanFengNongChang,430726502,3591,720,2255,1237,4480,1614,457,1835,3449,2513,4768
ͬɽֳ,DaTongShanLinChang,430726503,975,173,615,380,1252,605,163,663,1268,696,1311
ɽֳ,BaiYunShanLinChang,430726504,399,133,273,242,575,273,61,317,590,320,593
ֳ,LuoPuSiLinChang,430726505,447,95,287,228,574,284,78,315,599,333,620
ɽ�,JiaShanGuanLiChu,430726506,744,130,513,284,969,513,145,506,1019,506,1019
ֵ,SanZhouYiJieDao,430781001,28209,3901,17625,13248,29845,16202,3875,15865,32067,18360,35985
Žֵ,WangJiaQiaoJieDao,430781002,28474,4336,18493,13787,32540,17375,3965,17282,34657,18282,36775
ֵֽ,XiangYangJieJieDao,430781003,17963,2485,10722,7471,20104,9719,2410,9623,19342,12136,22858
ֵ,JinYuLingJieDao,430781004,14800,1920,9037,5528,16688,7339,2215,7428,14767,9898,18935
,XinZhouZhen,430781100,18930,2635,11353,6055,23385,9274,2422,9235,18509,12634,23987
ɿ,DuKouZhen,430781101,15346,2257,9851,5556,19685,9427,2330,9516,18943,10082,19933
͵,BaoHeDiZhen,430781102,17509,2509,11383,6499,22705,10688,3026,10758,21446,11661,23044
,BaiYiZhen,430781103,13113,2656,8950,6324,17905,8931,2318,9119,18050,9137,18087
Ȫ,LingQuanZhen,430781104,7725,1239,5194,3432,9893,5085,1233,4896,9981,5003,10197
Ļ,TangHuaXiang,430781203,10619,1839,7151,4546,14316,6992,2100,7259,14251,7407,14558
,LiJiaPuXiang,430781204,11897,1958,7892,4762,15629,7725,2029,7700,15425,7992,15884
ũ,CenDanNongChang,430781500,9371,843,1955,1626,9739,1848,441,1895,3743,8700,10655
ֵ,YongDingJieDao,430802001,49608,3607,32090,19632,45453,27622,11732,27498,55120,32857,64947
ӹŽֵ,DaYongQiaoJieDao,430802002,19027,969,12684,5367,10204,8644,3778,8697,17341,11090,23774
Ϫƺֵ,XiXiPingJieDao,430802003,26789,3361,17855,9786,33568,16203,6345,16265,32468,18640,36495
ƺֵ,GuanLiPingJieDao,430802004,15722,1466,10768,7904,14269,10514,4421,10564,21078,10841,21609
Ľֵ,ChongWenJieDao,430802005,42446,3008,26249,14646,33712,21993,8724,21471,43464,27929,54178
ׯƺֵ,NanZhuangPingJieDao,430802006,14951,1083,9614,6020,9928,9227,3403,9317,18544,9823,19437
,XinQiaoZhen,430802100,5884,1216,4296,2962,8323,4272,1623,4333,8605,4427,8723
,WenTangZhen,430802101,2101,548,1622,1276,3263,1618,699,1713,3331,1726,3348
,JiaoZiYaZhen,430802102,14529,2554,10161,6402,20807,9925,4307,10657,20582,11229,21390
ƺ,DaPingZhen,430802103,3182,723,2452,1742,4778,2424,1057,2356,4780,2510,4962
ƺ,YuanGuPingZhen,430802104,8356,1663,5703,3957,11566,5702,1901,6212,11914,6217,11920
Ϫ,YinJiaXiZhen,430802105,15919,2580,10941,6746,21648,10872,4427,11658,22530,11985,22926
ƺ,HouPingZhen,430802106,13165,1863,9299,4937,17749,9292,3875,9538,18830,9604,18903
ƺ,YangHuPingZhen,430802107,13839,2192,9684,6193,18798,9615,3561,9726,19341,9908,19592
ƺ,WangJiaPingZhen,430802108,5421,1745,4366,3301,8547,4363,1587,4362,8725,4387,8753
ҹ,SanJiaGuanXiang,430802201,7345,1179,4276,2922,8337,4116,1744,4578,8694,5992,10268
ɳ,ShaDiXiang,430802202,11523,1599,7743,4463,14820,7711,2990,8213,15924,8369,16112
,FengXiangGangXiang,430802203,8127,1218,5590,3383,11052,5590,2190,5945,11535,5945,11535
,HeZuoQiaoXiang,430802204,6225,1406,4625,3462,9070,4625,1952,4958,9583,4958,9583
˫Ϫ,ShuangXiQiaoXiang,430802205,2584,700,1961,1392,3924,1961,764,2086,4047,2087,4048
л,XieJiaYaXiang,430802206,3857,1096,2918,2171,5718,2918,926,2961,5879,2961,5879
లƺ,QingAnPingXiang,430802207,2570,744,2066,1541,3935,2046,1001,2147,4193,2249,4315
ƺ,LuoTaPingXiang,430802208,2985,694,2387,1628,4471,2387,1142,2434,4821,2434,4821
ˮ,LuoShuiXiang,430802209,5152,805,3468,2269,7282,3468,1466,3955,7423,3955,7423
ͷ,QiaoTouXiang,430802210,7170,1320,5098,3319,10454,5092,2399,5783,10875,5791,10889
,SanChaXiang,430802211,3110,564,2127,1338,4307,2127,705,2252,4379,2252,4379
Ķƺ,SiDouPingXiang,430802212,7212,1189,4776,2731,9817,4764,1692,5217,9981,5317,10093
éϪˮ,MaoXiShuiKuGuanLiSuo,430802400,604,101,437,297,824,437,197,465,902,465,902
ʯͷֳ,ZhuShiTouLinChang,430802401,387,96,279,265,587,279,117,321,600,321,600
ƺֵ,JunDiPingJieDao,430811001,15568,762,9676,4429,11107,6511,3047,6558,13069,9701,19377
ɽ,TianZiShanZhen,430811100,2516,422,1692,1216,3277,1653,727,1824,3477,1973,3665
Ϫ,SuoXiYuTuJiaZuXiang,430811200,7238,930,5139,3179,8350,5014,2220,5073,10087,5249,10388
Э,XieHeXiang,430811201,3921,750,2786,1825,5514,2781,1069,2930,5711,2954,5740
к,ZhongHuXiang,430811202,6211,1285,4686,3213,8930,4671,2197,4877,9548,5007,9693
żҽɭֹ԰�,ZhangJiaJieGuoJiaSenLinGongYuanGuanLiChu,430811450,3001,243,1911,1073,3076,1597,617,1614,3211,1950,3861
,LingYangZhen,430821100,89118,12618,60520,38958,100292,58350,18045,57245,115595,59261,119781
Ҳ,YanBoDuZhen,430821101,17788,2878,11688,6553,21972,11082,3178,11198,22280,12156,23844
Ϫ,XiKouZhen,430821102,10272,1879,6897,4094,12096,5987,2149,6240,12227,7403,14300
,DongYueGuanZhen,430821103,19268,3290,12836,8042,25529,12830,3256,12952,25782,12978,25814
ͨ,TongJinPuZhen,430821104,18417,2997,12110,7388,24125,11975,3317,12399,24374,12621,24731
ɼľ,ShaMuQiaoZhen,430821105,10463,2871,8222,6502,15703,8173,3054,7932,16105,8166,16388
,XiangShiZhen,430821106,15240,2621,10242,6123,20364,10110,3213,10556,20666,10832,21074
,JiangYaZhen,430821107,32120,5274,22259,13848,40779,20992,7236,21017,42009,22371,44630
,MiaoShiZhen,430821108,17695,2746,11915,6529,23109,11747,3500,11608,23355,12026,23941
Ϫ,LingXiZhen,430821109,17442,2885,11705,7344,23375,11691,3310,11930,23621,11932,23637
,GaoQiaoZhen,430821110,8823,1555,5824,3295,11619,5810,1628,6111,11921,6182,12006
̶,LongTanHeZhen,430821111,9808,1438,6218,4291,12557,6147,1711,6626,12773,6739,12957
㸣,GuangFuQiaoZhen,430821112,10428,1490,6790,3762,13515,6720,1886,6899,13619,7014,13804
ɽƺ,NanShanPingXiang,430821200,8041,1414,5099,2780,10497,5053,1282,5502,10555,5638,10737
˳,YiChongQiaoXiang,430821201,8874,1926,6223,4491,12723,6221,2149,6725,12946,6726,12949
Ϫ,DongXiXiang,430821202,5729,1187,4061,2880,8061,4035,1424,4226,8261,4279,8340
ƺ,JinPingXiang,430821203,6158,987,3978,2311,8159,3942,1194,4275,8217,4361,8339
,JingLongQiaoXiang,430821204,7367,1179,4832,2757,9846,4786,1433,5069,9855,5147,9979
ƺ,ErFangPingXiang,430821205,6786,1213,4481,2462,8974,4439,1138,4565,9004,4656,9137
Ͽ,SanHeKouXiang,430821206,5630,1193,3823,2505,7506,3765,1164,3995,7760,4164,7987
̫,GuoTaiQiaoXiang,430821207,5397,966,3456,2273,6865,3384,873,3578,6962,3780,7236
ׯ,ZhuangTaXiang,430821208,4562,860,2971,1993,6089,2943,882,3265,6208,3333,6304
,YangLiuPuXiang,430821209,13486,2581,9231,5429,18052,9115,2563,9241,18356,9399,18630
,ZhaoYangXiang,430821210,6015,1029,3972,2264,8023,3970,1168,4238,8208,4240,8212
,SanGuanSiTuJiaZuXiang,430821211,14666,2431,10427,5746,21052,10152,4464,10732,20884,11134,21561
߷,GaoFengTuJiaZuXiang,430821212,10801,1854,7275,4148,14854,7181,2351,7532,14713,7731,15006
ҷ,XuJiaFangTuJiaZuXiang,430821213,10864,1964,7574,4920,15741,7207,3088,7844,15051,8342,15916
,JinYanTuJiaZuXiang,430821214,11036,1925,7252,4091,15447,6979,2579,7745,14724,8288,15540
ԼҸ,ZhaoJiaGangTuJiaZuXiang,430821215,9878,1568,7133,3813,14363,7111,3129,7411,14522,7442,14575
,GanYanTuJiaZuXiang,430821216,12772,2007,8612,5345,17915,8551,3385,9439,17990,9552,18164
,YangHeTuJiaZuXiang,430821217,12276,1916,8264,4608,16893,8142,3025,8680,16822,8953,17217
Դ,LiYuanZhen,430822100,58780,6146,40118,19009,66706,29474,16075,28419,57893,40883,81001
,RuiTaPuZhen,430822101,13503,2287,9909,6629,18777,9880,4252,10081,19961,10133,20042
ٵƺ,GuanDiPingZhen,430822102,9723,1902,7006,4390,13959,7005,2793,7408,14413,7412,14418
ˮ,LiangShuiKouZhen,430822103,5686,1172,4377,2626,8563,4294,2024,4354,8648,4505,8882
̶ƺ,LongTanPingZhen,430822104,4526,940,3406,2232,6649,3391,1466,3448,6839,3526,6932
ˮ,WuDaoShuiZhen,430822105,4045,776,2781,1656,5116,2728,1123,2935,5663,3163,5944
¼Һ,ChenJiaHeZhen,430822106,9931,1696,7271,4078,14035,7183,3174,7359,14542,7530,14801
μҴ,LiaoJiaCunZhen,430822107,6386,1061,4611,2437,9120,4610,2022,4853,9463,4858,9469
,LiFuTaZhen,430822108,11492,1977,8150,4497,16247,8137,3433,8721,16858,8752,16902
տ,KongKeShuXiang,430822200,7763,1515,5932,3642,11618,5907,2610,5915,11822,5956,11888
,MiHuXiang,430822201,4902,985,3642,2287,7232,3588,1669,3802,7390,3914,7556
Ҷƺ,ZhuYePingXiang,430822202,6135,1100,4193,2765,8734,4127,1668,4553,8680,4710,8903
ƺ,ZouMaPingBaiZuXiang,430822203,4418,887,3107,1950,6397,3090,1301,3449,6539,3499,6606
˳Ϫ,RenChaoXiXiang,430822204,3618,761,2483,1739,5094,2465,905,2756,5221,2801,5284
,XiLianXiang,430822205,3288,622,2170,1502,4505,2138,731,2395,4533,2471,4641
ʯ,BaiShiXiang,430822206,3182,678,2101,1390,4195,2075,675,2313,4388,2434,4535
ƺ,LiuJiaPingBaiZuXiang,430822207,5627,1247,4373,2734,8403,4349,1814,4287,8636,4315,8688
ܽŰ,FuRongQiaoBaiZuXiang,430822208,6475,1264,4783,2866,9310,4702,2004,4843,9545,4960,9743
ƺ,MaiDiPingBaiZuXiang,430822209,2663,563,1875,1281,3856,1867,780,2097,3964,2131,4006
Ͽڰ,MaHeKouBaiZuXiang,430822210,4869,1304,3923,2557,7554,3874,1675,3859,7733,3925,7848
̶ƺ,ChangTanPingXiang,430822211,2376,527,1753,1202,3459,1740,706,1819,3559,1856,3609
Ϫ,LinXiHeXiang,430822212,2176,538,1607,1145,3231,1607,629,1736,3343,1736,3343
ҹ,HongJiaGuanXiang,430822213,12803,2577,9600,5483,18558,9505,3912,9496,19001,9692,19292
,QiaoZiWanXiang,430822214,6340,1365,5017,3054,9787,5014,2480,5139,10153,5168,10185
ɽ,GuLuoShanXiang,430822215,2088,723,1972,1480,3665,1942,1117,1876,3818,1956,3928
ɳƺ,ShaTaPingXiang,430822216,8317,1611,5994,3708,11935,5948,2549,6409,12357,6483,12477
ƺ,KuZhuPingXiang,430822217,2232,614,1931,1392,3660,1931,1029,1944,3875,1944,3875
ķϪ,SiFangXiXiang,430822218,2169,610,1732,1279,3454,1732,825,1867,3599,1872,3604
éϪ,BaMaoXiXiang,430822219,2328,679,1801,1328,3540,1772,770,1922,3694,1976,3777
ϸɳƺ,XiShaPingXiang,430822220,3123,893,2510,1798,4818,2498,1107,2594,5092,2613,5123
˴ɽ,BaDaGongShanXiang,430822221,2078,555,1533,1085,3068,1513,626,1656,3169,1726,3259
忼,JianJiaPoXiang,430822222,3216,703,2342,1486,4668,2335,912,2464,4799,2489,4831
ݿ,YanWuKouXiang,430822223,2165,585,1828,1298,3441,1828,880,1802,3630,1802,3630
ӿ,HeKouXiang,430822224,6323,1294,4610,2795,9159,4578,1903,4849,9427,4910,9520
ϺϪ,ShangHeXiXiang,430822225,7697,1400,5471,3221,11098,5417,2430,5954,11371,6056,11527
ӿ,LiangHeKouXiang,430822226,5100,917,3665,2180,7284,3610,1729,3981,7591,4081,7746
Ȫ,DaGuQuanXiang,430822227,2411,798,2152,1563,3977,2134,1099,2124,4258,2156,4308
϶,ShangDongJieXiang,430822228,4854,990,3626,2003,7392,3600,1751,3919,7519,3969,7595
ɽֳ,TianXingShanLinChang,430822500,704,222,582,481,1124,582,241,585,1167,585,1167
ͷֵ,DaMaTouJieDao,430902005,33439,5789,22113,16947,33524,20947,4255,20304,41251,21370,43483
·ֵ,QiCheLuJieDao,430902006,27449,4540,17751,13700,29027,16836,3307,16606,33442,17545,35296
ӭ,YingFengQiaoZhen,430902102,31234,3534,19579,9190,32480,16436,5635,17301,33737,20824,40403
ɳͷ,ShaTouZhen,430902104,15971,2567,10707,6213,20641,10406,3406,10841,21247,11237,21944
,ZiHuKouZhen,430902105,24685,3758,16465,9574,32738,16406,5089,17005,33411,17067,33532
,ChangChunZhen,430902106,58605,8742,38650,21721,77171,38567,12024,40420,78987,40721,79371
ź,XinQiaoHeZhen,430902107,57143,8176,37902,20813,76480,37511,12523,39822,77333,39940,77842
ż,ZhangJiaSaiXiang,430902203,28238,4242,19406,12087,39095,19388,7244,20270,39658,20318,39724
ҵ԰,ChangChunGongYeYuan,430902401,29927,2359,19238,10926,17702,16502,5181,16558,33060,18229,37467
ɽֵ,HeShanJieDao,430903001,65876,6912,41397,27552,66107,38388,10561,38638,77026,41952,83349
һؽֵ,TaoHuaLunJieDao,430903002,43576,6149,28843,20429,45401,28329,7178,27051,55380,28060,56903
ɽֵ,JinYinShanJieDao,430903003,41149,4084,24310,14401,26212,18828,4697,18401,37229,25620,49930
ֵ,ZhaoYangJieDao,430903005,42959,3662,28562,17367,29166,24220,7469,23803,48023,25528,54090
ɽֵ,HuiLongShanJieDao,430903006,34735,5276,22568,13584,36504,18151,4374,18507,36658,21817,44385
,BaZiShaoZhen,430903101,13662,2569,9605,5910,18946,9585,3251,9831,19416,9877,19482
Ȫ,QuanJiaoHeZhen,430903103,30976,5139,21233,12660,40886,20664,6696,21026,41690,21578,42811
ŷ,OuJiangChaZhen,430903104,25548,4286,17414,9677,34076,16634,5633,17145,33779,18053,35467
ˮ,CangShuiPuZhen,430903105,36725,5014,24195,13502,45053,23074,7288,23550,46624,24832,49027
,YueJiaQiaoZhen,430903107,28708,5226,20012,13250,39092,19770,6601,20249,40019,20523,40535
лָ,XieLinGangZhen,430903109,20075,3355,13469,9630,25751,13454,3822,13660,27114,13783,27252
ж,XinShiDuZhen,430903110,11357,2125,7939,5644,15271,7921,2415,7921,15842,7958,15897
Ϫ,LanXiZhen,430903111,52460,8612,35178,21093,70155,34962,10984,36544,71506,36878,72056
,LongGuangQiaoZhen,430903112,41791,6885,28422,17010,54826,28260,9018,29112,57372,29272,57694
,HengLongQiaoZhen,430903113,50263,7462,33782,20270,66581,33402,11260,34662,68064,35203,68985
཭,NiJiangKouZhen,430903114,30508,6325,22527,14393,43557,22501,7543,21806,44307,21849,44376
ƿ,PaiKouXiang,430903202,16118,2785,10848,6147,21880,10848,3285,11340,22188,11340,22188
ʼɽ,BiJiaShanXiang,430903209,19943,3716,13766,8477,26850,13669,4248,13961,27630,14141,27907
빤ҵ԰,LongLingGongYeYuan,430903402,19286,1668,12619,5323,14828,8377,3167,8398,16775,11502,24121
ɽͷ,MingShanTouZhen,430921102,23853,3988,15705,8149,31358,15549,4217,16160,31709,16353,32058
,QingShuZuiZhen,430921103,25824,4410,17171,8986,34345,16865,4826,17491,34356,17889,35060
,ChangJiaoZhen,430921106,24690,4069,16381,10154,33198,16194,4799,16928,33122,17177,33558
ʥ,WuShengGongZhen,430921107,20651,3012,13396,7347,26504,13392,3520,13779,27171,13787,27183
Ӱ,HeBaZhen,430921121,28924,5218,19500,11445,33627,17437,4756,17465,34902,19398,38898
,JinPenZhen,430921123,14128,2665,9359,6070,17580,9242,2035,9223,18465,9469,18828
,BeiZhouZiZhen,430921124,11085,2032,7302,4512,13922,6763,1657,6957,13720,7472,14774
,NanZhouZhen,430921125,119874,13970,76523,48395,132930,71572,20224,72192,143764,77545,154068
,HuaGeZhen,430921126,50920,7368,32855,16797,64274,31454,8420,32130,63584,33853,66708
éݽ,MaoCaoJieZhen,430921127,44667,6816,29379,16338,58110,29029,8197,29846,58875,30301,59680
ɺ,SanXianHuZhen,430921128,34163,5024,21609,11267,43885,20402,5907,21924,42326,23485,45094
ӿ,MaHeKouZhen,430921129,33592,5885,22400,11781,44966,21649,6276,22304,43953,23353,45753
ǧɽ,QianShanHongZhen,430921130,18812,2701,12204,8010,23324,12201,3376,12666,24867,12685,24889
,WuZuiXiang,430921201,27021,4264,17840,10101,35157,17363,4951,17898,35261,18396,36236
,ZhongYuKouXiang,430921212,34461,5161,22730,11848,44519,22163,6829,22933,45096,23721,46451
˰κ,LangBaHuZhen,430921213,31720,5089,20863,10740,41213,19578,5760,20156,39734,21706,42569
ɳ޽ֵ´,ShaBaoZhouJieDaoBanShiChu,430921404,1772,312,1179,811,2141,1166,250,1100,2266,1155,2334
ֵ´,NanWanHuJieDaoBanShiChu,430921405,940,73,494,391,106,428,134,483,911,653,1147
ɽ,XiuShanZhen,430922101,18545,3528,13302,8071,26409,13301,4882,13650,26951,13653,26955
˶,LuCiDuZhen,430922103,19325,3779,13614,8986,27738,13226,5185,14087,27313,14675,28289
ʯţ,ShiNiuJiangZhen,430922107,21003,3837,14714,9498,29570,14250,5155,14660,28910,15281,29995
ţ,NiuTianZhen,430922108,22231,3979,15353,9802,30880,14892,5237,15394,30286,16094,31447
ľ,SongMuTangZhen,430922109,21094,4094,14507,7861,29590,14242,5060,14831,29073,15741,30248
һ,TaoHuaJiangZhen,430922112,118845,15183,77160,42043,140670,66941,22258,67965,134906,79126,156286
ɽ,HuiShanGangZhen,430922113,86704,12735,56951,31788,115170,54333,18071,57025,111358,60559,117510
̶,WuTanZhen,430922114,46524,8313,32563,18184,64499,32418,11844,33773,66191,34118,66681
�,MaJiTangZhen,430922115,40999,6840,28292,15481,56274,28007,10505,29781,57788,30052,58344
ý,SanTangJieZhen,430922116,35637,6379,24977,13725,49497,24856,8699,25577,50433,25738,50715
,DaLiGangZhen,430922117,40769,6958,28174,14731,54998,27284,10272,28627,55911,29825,57999
,GaoQiaoXiang,430922203,18258,3358,12305,6801,25212,12243,3922,13097,25340,13233,25538
մϪ,ZhanXiXiang,430922205,17638,3021,11876,7692,23818,11814,4028,12648,24462,12811,24687
�,ZhaBuHuiZuXiang,430922208,13110,2148,9156,4627,18318,8561,3579,9132,17693,9681,18837
ɽ,FuQiuShanXiang,430922212,31137,6548,21470,13583,43654,20907,6946,22010,42917,23161,44631
Ϫֳ,BanXiLinChang,430922400,1334,149,755,692,1414,753,218,946,1699,946,1701
,QingTangPuZhen,430923101,40423,5794,27772,15235,54302,26465,10748,27935,54400,29193,56965
Ϫ,XianXiZhen,430923103,32858,5448,22740,12110,45671,22632,8354,23497,46129,23920,46660
,ChangTangZhen,430923105,29865,4633,21033,10227,42297,20806,8613,21601,42407,22078,43111
С,XiaoYanZhen,430923106,25597,3555,16954,9487,34623,16945,5832,18000,34945,18030,34984
,YangJiaoTangZhen,430923108,42025,6926,28794,15706,58325,28321,10209,29709,58030,30366,59160
,LengShiZhen,430923109,23810,3586,15618,8040,31735,15406,4768,16173,31579,16546,32164
Ϫ,KuiXiZhen,430923111,12564,2170,8735,5882,17042,8499,3108,8786,17285,9107,17842
Ϫ,YanXiZhen,430923112,14892,2393,10090,5614,19971,9823,3006,9805,19628,10201,20291
,QuJiangZhen,430923113,9321,1348,6124,3266,12449,6055,2111,6509,12564,6656,12780
ƽ,PingKouZhen,430923114,12840,1621,8667,4650,16958,8601,3082,8760,17361,8876,17543
Ϫ,ZheXiZhen,430923115,11693,1533,7755,4336,15176,7686,2398,7767,15453,7869,15624
ְ,LeAnZhen,430923116,30834,5319,21488,12116,41979,21433,7264,21839,43272,21929,43417
Ϫ,TaoXiZhen,430923117,18444,2918,12301,7102,25611,12223,4542,13430,25653,13603,25904
÷,MeiChengZhen,430923118,53556,8046,36977,21261,69089,36767,13405,37610,74377,38030,75007
,DaFuZhen,430923119,58951,9379,42003,21565,84947,41610,18032,43732,85342,44359,86362
·,MaLuZhen,430923120,28996,4318,19113,10646,38339,18332,6238,19336,37668,20439,39552
ƺ,DongPingZhen,430923121,93830,13094,62229,43367,116620,59904,19240,61548,121452,63935,126164
,JiangNanZhen,430923122,36862,6010,24861,14078,50245,24049,8201,25696,49745,26212,51073
,GaoMingXiang,430923200,12065,1900,8151,4420,16543,8014,3060,8610,16624,8874,17025
,LongTangXiang,430923206,18216,2729,11938,6248,24217,11567,3734,12293,23860,12741,24679
ׯ,TianZhuangXiang,430923209,22192,3207,14123,7240,29315,14008,4293,15432,29440,15569,29692
Ͻ,NanJinXiang,430923211,7815,1155,5112,3242,10679,5111,1786,5624,10735,5644,10756
¥,GuLouXiang,430923212,10391,1588,6870,3907,14013,6780,2261,7261,14041,7370,14240
ֵ´,QiongHuJieDaoBanShiChu,430981006,65611,7304,42675,28675,58726,40565,11459,39303,79868,41699,84374
ɽֵ´,QingYunShanJieDaoBanShiChu,430981007,56347,6383,33339,22938,52535,29521,7727,29103,58624,37118,70457
ļ,SiJiHongZhen,430981102,9626,1641,6925,4347,13332,6925,2423,6763,13688,6765,13690
ɽ,SiHuShanZhen,430981105,31993,5915,21637,14675,43110,21593,6110,22305,43898,22381,44018
,NanZuiZhen,430981107,15951,2350,10401,7680,19183,10376,3022,10835,21211,10922,21323
,XinWanZhen,430981108,14500,2164,9674,6751,17923,9055,2935,9354,18409,9925,19599
,ChaPanZhouZhen,430981110,16946,2998,11418,8658,21898,11401,2893,11404,22805,11419,22837
ϴ,NanDaShanZhen,430981112,56103,9312,37170,22615,73634,36733,10327,37847,74580,38572,75742
é,HuangMaoZhouZhen,430981113,48314,7955,31955,18140,60670,30179,8888,31232,61411,33202,65157
β,CaoWeiZhen,430981114,60540,10379,39793,25081,77108,39172,9935,40274,79446,41061,80854
,YangLuoZhouZhen,430981115,28974,5563,19574,11706,38869,19512,5267,20147,39659,20230,39804
,GongHuaZhen,430981116,43631,7374,28826,17728,56762,28278,7637,28968,57246,29816,58642
,SanYanTangZhen,430981117,33281,4875,22094,12922,43262,21166,7210,21820,42986,23272,45366
Ӻ,WanZiHuXiang,430981209,6003,674,3984,2541,7255,3979,998,3689,7668,3691,7675
϶ͥ«έ,NanDongTingLuWeiChang,430981401,5804,946,3935,2799,7642,3855,996,3703,7558,3811,7746
«έ,LuHuLuWeiChang,430981402,4708,715,3219,2102,6074,3201,782,2968,6169,2986,6205
ÿ,JingJiKaiFaQu,430981403,2281,186,1266,700,1833,991,314,979,1970,1515,2781
·ֵ´,RenMinLuJieDaoBanShiChu,431002001,37732,4515,25348,16682,27847,22565,7017,22075,44640,23916,49264
ֵ´,BeiHuJieDaoBanShiChu,431002002,41146,3248,26450,18162,25726,26023,9426,26731,52754,27370,53820
Ȫֵ´,YanQuanJieDaoBanShiChu,431002003,73984,6432,46139,30606,47003,44281,15938,43663,87944,50215,96354
Žֵ´,XiaMeiQiaoJieDaoBanShiChu,431002004,19132,1579,12563,8531,11887,11557,4399,11819,23376,12547,25110
ʯ,ShiGaiTangZhen,431002100,9761,856,6012,3430,8217,5390,2658,5585,10975,7263,13275
,HuaTangZhen,431002101,12467,1654,8711,5628,16237,8563,4099,8896,17459,9509,18220
³,LuTangZhen,431002102,16388,1475,11756,6987,20793,11467,7187,12654,24121,13294,25050
,ChenJiangZhen,431002103,32972,1263,21212,14142,14987,20353,9846,21248,41601,22869,44081
,WanHuaYanZhen,431002104,8029,981,5440,3356,8766,5056,2534,5348,10404,6104,11544
,JiangKouXiang,431002200,2956,522,2056,1498,4123,2051,884,2286,4337,2306,4362
н,ShiJiaoXiang,431002201,10276,904,6744,4189,10573,6370,2924,6612,12982,7360,14104
,DaTangYaoZuXiang,431002202,2218,275,1645,1113,3135,1645,1062,1910,3555,1910,3555
ͬ,TongHeXiang,431002203,3394,628,2603,1795,5006,2560,1396,2740,5300,2815,5418
,BaoHeXiang,431002204,5065,783,3268,2274,6030,3134,1560,3485,6619,4140,7408
·,YueFengYaoZuXiang,431002205,3696,439,2508,1718,4772,2499,1385,2972,5471,3012,5520
ܽ,FuRongXiang,431002206,3917,457,2562,1784,4491,2490,1342,2843,5333,3154,5716
,YongChunXiang,431002207,4993,744,3648,2492,7005,3597,1952,3933,7530,4041,7689
Ϫ,NanXiXiang,431002208,2308,412,1704,1198,3395,1698,868,1867,3565,1884,3588
оü�,ChenZhouShiJingJiJiShuKaiFaQu,431002400,19191,1367,12796,7736,8455,11711,5148,11871,23582,12910,25706
ֵ,SuXianLingJieDao,431003001,81688,6880,50629,26164,53424,36541,12342,36225,72766,50281,100910
ֵ,NanTaJieDao,431003002,22001,2722,15013,10430,16643,14405,4745,13962,28367,14455,29468
ſ,QiaoKouZhen,431003100,12927,1670,8525,6078,16500,8492,3096,8998,17490,9168,17693
¶,BaiLuTangZhen,431003101,28628,2518,18747,9812,23547,13282,5526,13675,26957,17925,36672
,LiangTianZhen,431003102,20261,1987,13597,8005,18324,12567,5558,13324,25891,14209,27806
ܷ,QiFengDuZhen,431003103,20390,2479,12577,8113,23470,12109,3844,12828,24937,14136,26713
,AoShangZhen,431003104,14448,1675,9685,6766,18523,9658,3896,10152,19810,10334,20019
Ҷ,XuJiaDongZhen,431003105,9374,2137,6679,5511,11500,6115,1965,6313,12428,6797,13476
¹,BaiLuDongZhen,431003106,17827,1020,11675,7694,13428,11037,5038,10745,21782,12210,23885
,WuLiPaiZhen,431003107,15624,1792,10120,6449,19260,10085,3526,10646,20731,10822,20942
ڽ,GangJiaoXiang,431003200,5275,719,3545,2093,7050,3540,1505,3917,7457,3954,7499
ƺ,LiaoWangPingXiang,431003201,7768,874,5205,3143,10285,5179,2040,5417,10596,5477,10682
ͷ,MaTouLingXiang,431003202,6605,903,4433,3170,8809,4418,1685,4741,9159,4760,9193
Ҷƺ,HeYePingXiang,431003203,6759,816,4456,2939,9038,4423,1879,4884,9307,4998,9454
Ϫ,TangXiXiang,431003204,6623,899,4671,2999,9304,4664,1971,4794,9458,4822,9493
̫ƽ,TaiPingXiang,431003205,8002,1005,5270,3372,10818,5256,1962,5685,10941,5699,10969
˼,DengJiaTangXiang,431003206,6053,647,3862,2458,7522,3745,1570,4030,7775,4408,8270
μ,LiaoJiaWanXiang,431003207,8146,975,5267,3316,10540,5221,2075,5810,11031,5929,11196
,DaKuiShangXiang,431003208,5663,659,3916,2286,7740,3830,2088,4182,8012,4494,8410
ǹ,ChengGuanZhen,431021100,88818,7108,59919,35068,73434,56215,27050,58622,114837,63057,122976
ɳƺ,HuangShaPingZhen,431021101,8642,1506,5654,3962,9490,5173,1897,5536,10709,6391,12045
,RenYiZhen,431021102,12100,1575,8264,5432,16217,8239,3599,8939,17178,9010,17274
̫,TaiHeZhen,431021103,14404,1449,9952,5572,19542,9895,5313,11068,20963,11214,21166
,YangShiZhen,431021104,16284,2048,11651,6599,22512,11642,6041,12669,24311,12722,24373
ƽ,HePingZhen,431021105,10065,1707,7477,4960,14464,7373,3386,7483,14856,7681,15158
,LiuFengZhen,431021106,10872,1596,8076,6009,15732,8019,4349,8527,16546,8741,16817
,TangShiZhen,431021107,11033,1839,8731,5937,17220,8694,5318,9367,18061,9459,18190
,LianTangZhen,431021108,12108,1929,8927,5947,18211,8809,4669,9558,18367,9779,18706
,FeiXianZhen,431021109,11987,1613,8697,4713,18230,8679,4729,9607,18286,9632,18329
Ҷ,HeYeZhen,431021110,17219,1672,12753,6950,23944,12709,7770,13705,26414,13908,26661
Ԫ,FangYuanZhen,431021111,12096,1719,8827,5527,17982,8769,4781,9497,18266,9769,18596
,ZhangShiZhen,431021112,17800,2018,12140,6592,24193,12117,5246,12891,25008,12924,25064
Ȫ,AoQuanZhen,431021113,13947,1874,9750,5402,19481,9625,4405,10270,19895,10476,20226
ǽ,ChengJiaoXiang,431021200,20660,1753,13901,8141,22335,13805,6999,15151,28956,15511,29412
,QingHeXiang,431021201,7687,906,5374,3374,10587,5354,3018,6157,11511,6237,11611
,ZhengHeXiang,431021202,5935,701,4009,2310,7883,3965,1867,4386,8351,4494,8503
,YanTangXiang,431021203,8390,1309,6478,4454,12868,6474,3922,7118,13592,7143,13621
,HaoTangXiang,431021204,9911,1358,7016,4099,14557,7016,3444,7696,14712,7697,14713
Ž,TuanJieXiang,431021205,7743,948,5436,3135,10934,5414,2832,6052,11466,6087,11523
,DongChengXiang,431021206,10099,1310,7471,4557,14587,7379,3980,7772,15151,7918,15389
ƺ,LeiPingXiang,431021207,7684,1004,5528,3292,11429,5528,2938,6098,11626,6098,11626
,QingLanXiang,431021208,9733,1154,6726,3581,13557,6303,3441,7062,13365,7602,14328
,QiaoShiXiang,431021209,10017,1105,7129,4216,14350,7126,3535,7512,14638,7528,14657
,YinHeXiang,431021211,6325,788,4101,2240,8179,4082,1435,4364,8446,4447,8548
ľ,ZhangMuXiang,431021212,9597,1103,6826,3961,14151,6686,3653,7308,13994,7527,14353
,BanQiaoXiang,431021213,8213,1408,6126,3993,12845,6113,3399,6845,12958,6894,13020
ɽ,HuaShanYaoZuXiang,431021214,1378,170,981,614,2052,973,540,1095,2068,1107,2088
,SiLiXiang,431021215,11667,1831,8402,4671,17790,8371,4357,9417,17788,9453,17855
,LiuHeXiang,431021216,7117,994,5093,2904,10729,5084,2744,5738,10822,5762,10855
,SiZhouXiang,431021217,8858,1215,6183,4003,12842,6183,2982,6870,13053,6872,13055
ŷ,OuYangHaiXiang,431021218,12939,1663,9094,5405,18422,9060,4713,10077,19137,10221,19315
,GuangMingXiang,431021219,10673,1085,7158,4157,14850,7130,3730,8281,15411,8330,15488
ˮ,BaiShuiXiang,431021220,5606,707,3917,2327,8575,3872,2410,4703,8575,4806,8723
,YangLiuYaoZuXiang,431021221,1424,175,937,531,2003,931,467,1112,2043,1129,2066
Ȫ,HuaQuanXiang,431021222,3094,503,2197,1542,4470,2183,1090,2476,4659,2490,4687
¥,GuLouXiang,431021223,6741,1081,4817,3052,10145,4817,2394,5399,10216,5399,10216
ʮ,ShiZiXiang,431021224,7468,1027,5263,3064,10791,5232,2548,5597,10829,5780,11043
,YuTianXiang,431021225,10237,1640,7630,4448,15692,7612,4060,8267,15879,8307,15937
ũ,GongHeNongChang,431021400,2833,260,1993,1240,3885,1986,903,1987,3973,2003,3996
賡,GuiYangChaChang,431021401,1773,166,1217,728,2477,1217,580,1302,2519,1302,2519
̫͹ֳ,TaiHeGuoYouLinChang,431021402,530,98,392,297,738,392,190,426,818,426,818
ƺ,LianHuaPingGuanLiQu,431021403,206,77,195,164,357,195,90,178,373,178,373
ֳ,ChuQinLiangZhongChang,431021404,88,13,73,36,122,73,38,66,139,66,139
̿ѧо,KaoYanKeXueYanJiuSuo,431021405,42,2,30,23,24,30,17,31,61,31,61
ũҵѧо,NongYeKeXueYanJiuSuo,431021406,144,35,116,76,214,113,52,115,228,115,231
ҵ԰ί,GongYeYuanQuGuanWeiHui,431021407,547,3,416,3,17,4,22,4,8,156,572
ǹ,ChengGuanZhen,431022100,54205,4179,36365,20964,39733,32913,15801,34927,67840,37820,74185
ʯ,BaiShiDuZhen,431022101,8449,1056,5289,3395,10031,4903,2075,5467,10370,6291,11580
÷ɽ,YangMeiShanZhen,431022102,9285,1299,6241,4121,11120,6220,2285,6578,12798,6628,12869
,YaoGangXianZhen,431022103,5851,965,4119,2931,6683,4098,1412,3991,8089,4109,8228
÷,MeiTianZhen,431022104,22753,2004,15483,8454,28006,15339,8048,16886,32225,17322,32805
,MaTianZhen,431022105,13486,1222,9299,5114,16889,9296,5118,10488,19784,10527,19826
ɳ,HuangShaZhen,431022106,22637,2358,16204,8458,29763,16123,9169,17388,33511,17960,34164
ӭ,YingChunZhen,431022107,14511,1585,10711,5498,21165,10642,5972,11259,21901,11357,22068
һ,YiLiuZhen,431022108,26588,2699,19711,9547,36554,19527,11984,21345,40872,21560,41271
Դ,LiYuanZhen,431022109,21243,2362,15086,8095,28618,15010,7704,16119,31129,16223,31309
Ȫ,YanQuanZhen,431022110,24568,2439,17368,8788,32429,17089,9504,18681,35770,19143,36511
,ChengNanXiang,431022200,24201,2495,16304,9284,28688,15910,7508,17145,33055,17900,34204
ˮ,JiangShuiXiang,431022201,14931,1393,9978,5735,18516,9950,4931,11079,21029,11277,21255
,ChangCunXiang,431022202,9942,1098,7093,3629,14089,7092,3689,7636,14728,7636,14729
,DongFengXiang,431022203,9477,1233,6871,3686,13121,6823,3632,7393,14216,7471,14342
,TianTangXiang,431022204,16258,2121,12193,6812,22723,12191,7323,13499,25690,13509,25702
çɽ,MangShanYaoZuXiang,431022205,5447,715,3644,2052,6734,3615,1631,4008,7623,4149,7793
,BaLiXiang,431022206,13110,1520,9208,4596,17146,9069,4652,9774,18843,10074,19282
ɳ,BaiShaWeiXiang,431022207,10840,1688,8128,4614,15633,8090,4459,8764,16854,8859,16987
Ϫ,GuanXiXiang,431022208,8939,1331,6504,3720,12276,6495,3275,7012,13507,7041,13545
,ChangCeXiang,431022209,7117,929,5197,3192,9767,5186,2771,5596,10782,5620,10817
,LiTianXiang,431022210,7738,1062,5601,3631,9724,5556,3148,6046,11602,6347,11948
»,XinHuaXiang,431022211,6416,763,4544,2321,8686,4541,2323,4946,9487,4958,9502
ʯ,ChiShiXiang,431022212,9714,1286,6909,3970,13282,6909,3370,7461,14370,7461,14370
ƽ,PingHeXiang,431022213,7433,1008,4868,2914,9151,4800,2452,5475,10275,6025,10893
̫ƽ,TaiPingLiXiang,431022214,7823,1026,5309,3145,10581,5309,2354,5894,11203,5894,11203
ɳƺ,ShaPingXiang,431022215,12706,1483,8480,5050,16907,8461,3763,9446,17907,9472,17952
ǹ,ChengGuanZhen,431023100,54979,6137,37619,25486,55843,36270,15006,36892,73162,38503,76122
,MaTianZhen,431023101,48188,6125,33391,23391,63945,33356,15432,36187,69543,36354,69745
,XiangYinDuZhen,431023102,21924,2347,15012,8746,30153,14964,6648,15793,30757,15907,30919
ſ,TangMenKouZhen,431023103,9384,1525,6887,4741,12939,6878,3257,7260,14138,7279,14166
,JinGuiZhen,431023104,12709,1465,8699,5021,17923,8401,3917,8893,17294,9392,18091
,BoLinZhen,431023105,22220,2692,15204,8745,30108,15176,6973,16522,31698,16681,31885
,LiYuTangZhen,431023106,15862,2044,10740,7344,22135,10667,4520,11593,22260,11686,22426
,YouShiZhen,431023107,17330,1974,12132,7284,24997,12073,5984,13046,25119,13156,25288
ǽ,ChengJiaoXiang,431023200,4001,508,2727,1597,5482,2727,1147,2929,5656,2929,5656
,BiTangXiang,431023201,15864,1702,10740,6281,21458,10662,4806,11486,22148,11632,22372
ͤ,GaoTingXiang,431023202,19672,2246,14376,8175,26965,14282,7505,14892,29174,15047,29423
,YangTangXiang,431023203,12328,1672,9267,5504,17384,9251,4974,9691,18942,9707,18974
,FuHeXiang,431023204,13503,1407,9314,5557,18811,9301,4449,9992,19293,10045,19359
,YouMaXiang,431023205,11539,1378,8380,4579,16273,8368,4595,9112,17480,9132,17512
,SanTangXiang,431023206,12975,1673,9614,5720,18882,9593,5801,10774,20367,10835,20449
,YueLaiXiang,431023207,12149,2019,9677,5979,18212,9590,6073,10380,19970,10564,20241
,HuangNiXiang,431023208,19257,2267,13347,7677,25786,13208,5710,13715,26923,13887,27234
÷,XiangMeiXiang,431023209,6879,1201,5296,3630,9021,5253,2428,5140,10393,5212,10508
,ZhangShuXiang,431023210,19547,2113,14207,8558,25743,14189,7674,15075,29264,15127,29334
̫,TaiHeXiang,431023211,10263,1464,7337,4849,15098,7336,3440,7826,15162,7830,15167
,DongKouXiang,431023212,5509,787,3823,2220,7694,3823,1688,4161,7984,4161,7984
ǧ,QianChongXiang,431023213,3392,467,2214,1419,4466,2207,849,2455,4662,2494,4708
󲼽,DaBuJiangXiang,431023214,9291,1233,6321,4321,13169,6319,2873,7061,13380,7076,13397
,LongXingShiXiang,431023215,7136,1127,4968,3166,9842,4862,2060,5147,10009,5355,10323
߼,QiJiaXiang,431023216,7796,1170,5481,3369,11290,5472,2406,5872,11344,5891,11372
ǹ,ChengGuanZhen,431024100,32242,3119,22454,13903,40838,22145,11066,23663,45808,23973,46427
ͷ,CheTouZhen,431024101,8958,1176,6407,4768,13449,6407,3675,7398,13805,7402,13809
,TangCunZhen,431024102,14046,1787,10258,6262,18912,10258,5485,11056,21314,11060,21318
Ԭ,YuanJiaZhen,431024103,7417,1262,5830,4070,11094,5827,3382,6135,11962,6231,12061
,XingLangZhen,431024104,11551,1670,8854,6579,17352,8834,5190,9491,18325,9557,18411
Ф,XiaoJiaZhen,431024105,6682,988,5186,3680,9758,5180,3222,5685,10865,5706,10892
̶,LongTanZhen,431024106,12386,2176,9807,7059,19734,9775,5956,10585,20360,10711,20518
ʯ,ShiQiaoZhen,431024107,14833,2577,11980,8109,22546,11979,6951,12381,24360,12381,24361
ͷ,PanTouXiang,431024200,5504,946,4339,2836,7906,4209,2598,4312,8521,4709,9048
,PuManXiang,431024201,8343,1691,6559,5122,13219,6557,3840,7258,13815,7315,13874
,TianXinXiang,431024202,9486,1550,7326,5349,14518,7321,4347,8015,15336,8057,15383
̹ƺ,TanPingXiang,431024203,6854,1991,6183,5060,12246,6183,4003,6665,12848,6665,12848
㷢,GuangFaXiang,431024204,17701,2321,12626,7488,26459,12626,6768,14164,26790,14164,26790
,LianHeXiang,431024205,6972,1044,5346,3873,11313,5346,3407,6077,11423,6077,11423
̽,PanJiangXiang,431024206,7279,1002,5145,3406,10968,5145,2813,5949,11094,5949,11094
ˮ,ZhongShuiXiang,431024207,9001,1399,6842,4669,14107,6841,3932,7489,14330,7490,14332
ʯ,ShiGaoXiang,431024208,8722,1448,6731,4948,13607,6729,4052,7487,14216,7491,14222
ǹ,ChengGuanZhen,431025100,43728,3965,30302,18639,46871,29099,13731,30233,59332,31122,61424
,JinJiangZhen,431025101,13912,1156,10400,5503,18245,10272,6693,11216,21488,11361,21761
㻨,XiangHuaLingZhen,431025102,5102,507,3660,2577,3698,3619,2046,3901,7520,3995,7655
,LanQiaoZhen,431025103,7665,959,5503,3166,10836,5471,3106,6143,11614,6227,11730
ˮ,WuShuiZhen,431025104,17754,1979,13099,7430,25255,13089,7174,13780,26869,13808,26907
˫Ϫ,ShuangXiXiang,431025200,11911,1353,8291,4991,16681,8209,4156,9035,17244,9129,17420
ǿ,NanQiangXiang,431025201,8670,1320,6734,4042,12961,6674,3832,6974,13648,7088,13822
,GuangYiXiang,431025202,3499,720,2818,2043,5281,2807,1592,2952,5759,2993,5811
ͬ,TongYiXiang,431025203,6595,918,4956,3067,9719,4913,2878,5354,10267,5435,10391
,FenShiXiang,431025204,8825,1229,6717,4010,12819,6699,4085,7420,14119,7422,14139
,TuDiXiang,431025205,7500,1007,5560,3484,10910,5520,3253,6126,11646,6200,11760
ˮ,ShuiDongXiang,431025206,6831,714,4933,2789,9426,4826,2974,5267,10093,5586,10519
,JieLongXiang,431025207,4576,353,3159,1743,6485,3130,1892,3581,6711,3662,6821
,HuaTangXiang,431025208,9670,1432,7144,4723,13640,7105,3814,7624,14729,7772,14916
,ChuJiangXiang,431025209,10138,1684,8303,5053,15350,8110,5315,8445,16555,8834,17137
Դ,WuYuanXiang,431025210,4842,827,3747,2542,7012,3715,2209,4031,7746,4131,7878
ˮ,WanShuiXiang,431025211,11496,1579,8956,4692,16622,8900,5488,9503,18403,9607,18563
,MaiShiXiang,431025212,17888,2122,13285,7206,26147,13158,7745,14214,27372,14470,27755
,SanHeXiang,431025213,7829,1155,6266,4272,11945,6237,3937,6593,12830,6655,12921
,ZhenNanXiang,431025214,7002,855,5228,2817,9886,5209,2855,5443,10652,5484,10712
,DaChongXiang,431025215,3660,625,2700,1742,5492,2688,1549,3075,5763,3134,5834
ɽ,XiShanYaoZuXiang,431025216,892,139,652,446,1177,638,371,729,1367,750,1402
عҵ԰,LinWuXianGongYeYuan,431025400,1138,2,841,0,418,0,4,0,0,303,1144
ʮ,SanShiLiuWanKuangQu,431025401,2,0,0,2,2,0,0,2,2,2,2
ú,JinJiangMeiQu,431025402,21,0,0,21,4,0,0,21,21,21,21
ǹ,ChengGuanZhen,431026100,17713,2064,12165,7678,16721,11505,4496,11451,22956,12108,24273
Сԫ,XiaoYuanYaoZuZhen,431026101,4751,727,3377,2193,6386,3299,1651,3537,6836,3752,7129
ˮ,ReShuiZhen,431026102,7064,760,4896,2763,9402,4881,2232,5123,10004,5160,10056
,TuQiaoZhen,431026103,19719,2437,13625,7472,25640,13193,6083,14061,27254,14614,28239
,SanXingZhen,431026104,14903,2536,11264,7252,21061,11185,5925,11895,23080,12100,23364
ůˮ,NuanShuiZhen,431026105,6164,929,4441,2947,8581,4355,2391,4613,8968,5043,9484
ƺ,DaPingZhen,431026106,18602,2325,13018,7497,24591,12911,6757,14310,27221,14666,27684
,SanJiangKouYaoZuZhen,431026107,5615,724,3889,2391,7324,3820,2050,4116,7936,4500,8389
ǽ,ChengJiaoXiang,431026200,12625,1282,8763,4753,13460,8740,3613,8621,17361,8757,17520
,FuChengXiang,431026201,15771,1988,10779,6581,21344,10779,4687,11667,22446,11667,22446
,JingPoXiang,431026202,11958,1680,8228,5298,16696,8159,3610,8871,17030,9020,17248
,WenMingXiang,431026203,17974,2135,12377,7395,23788,12239,5705,13130,25369,13437,25814
ӯ,YingDongYaoZuXiang,431026204,4118,523,2795,1756,5853,2764,1396,3142,5906,3242,6037
,LingXiuYaoZuXiang,431026205,6859,725,4448,2554,8962,4368,2214,5011,9379,5350,9798
ׯ,TianZhuangXiang,431026206,8132,1126,5707,3499,11173,5620,2902,6081,11701,6453,12160
϶,NanDongXiang,431026207,5574,897,3900,2338,7541,3861,1678,4161,8022,4249,8149
,YongFengXiang,431026208,8348,1218,5993,3852,11705,5937,2930,6369,12306,6503,12496
ͷ,HaoTouXiang,431026209,7349,1119,5241,3497,10470,5236,2543,5713,10949,5770,11011
潫,YiJiangXiang,431026210,4374,490,2778,1724,5467,2733,1352,3063,5796,3438,6216
,JiLongXiang,431026211,3640,413,2460,1229,4738,2434,1062,2575,5009,2655,5115
,MaQiaoXiang,431026212,9910,1288,6608,3985,13236,6540,3052,7342,13882,7642,14250
ɳ,WaiShaXiang,431026213,7613,1151,5579,3472,10814,5538,2864,5922,11460,6049,11628
,YanShouYaoZuXiang,431026214,6987,1274,5798,3902,10922,5768,3493,5853,11621,5956,11754
ǹ,ChengGuanZhen,431027100,31651,2801,20264,11563,28014,18326,6552,18785,37111,20740,41004
ɳ,ShaTianZhen,431027101,21138,1743,11922,6251,19963,10604,4011,10908,21512,14970,26892
Ȫ,QingQuanZhen,431027102,8393,953,5391,2677,9167,5249,1992,5609,10858,5947,11338
ͷ,QiaoTouXiang,431027200,7885,939,4940,2476,8861,4794,1660,5024,9818,5544,10484
,HanKouXiang,431027201,4773,597,3039,1653,5773,2880,1005,3109,5989,3336,6375
ƶ,HuangDongXiang,431027202,4040,456,2447,1351,4677,2261,827,2441,4702,2876,5323
,SanDongXiang,431027203,4145,465,2472,1315,4504,2327,882,2432,4759,3020,5492
,ZengKouXiang,431027204,8619,902,5483,2320,9560,4871,1824,4922,9793,5862,11345
կǰ,ZhaiQianXiang,431027205,13182,1300,7726,3938,14149,7172,2722,7145,14317,9478,17204
Դ,LiuYuanXiang,431027206,3720,437,2453,1244,4775,2366,838,2353,4719,2542,4995
,DaTangXiang,431027207,12908,1619,8662,4477,17293,8515,3296,8699,17214,9161,17823
·,XinFangXiang,431027208,8237,859,5313,2358,8542,4249,1851,4433,8682,5634,10947
,PuLeXiang,431027209,11546,1314,7706,4053,14913,7638,2799,7697,15335,7953,15659
,DongLuoXiang,431027210,4997,555,3314,1925,6725,3314,1246,3484,6798,3484,6798
Ϫ,BeiXiXiang,431027211,5423,474,2759,1624,5289,2640,928,2769,5409,4066,6825
ˮ,DaShuiXiang,431027212,2912,366,1909,1065,3820,1887,707,2011,3898,2076,3985
ɽ,QingShanXiang,431027213,4530,413,2278,1281,4502,2119,662,2370,4489,3327,5605
Ķ,SiDouXiang,431027214,13469,1235,6958,4257,13986,6781,2718,7493,14274,10464,17422
ƺֳ,SongPingLinChang,431027400,886,84,389,220,453,218,76,274,492,657,1046
ǹ,ChengGuanZhen,431028100,27674,2479,18736,11431,30635,18370,7231,18378,36748,18648,37384
ƽ,AnPingZhen,431028101,26119,2795,17870,9826,36248,17779,7711,18614,36393,18755,36625
,LongHaiZhen,431028102,13681,1302,8727,4501,17377,8518,3455,9079,17597,9711,18438
Ϫ,QingXiZhen,431028103,25866,2008,16930,9003,34275,16843,7204,18090,34933,18148,35078
,GuanWangZhen,431028104,10843,1227,7203,3768,14707,7144,2807,7528,14672,7674,14877
,LingGuanZhen,431028105,9156,1215,6909,4804,13352,6803,3842,7084,13887,7304,14213
ɽ,PaiShanXiang,431028200,8456,852,5817,3487,11388,5770,2511,5951,11721,6002,11819
,LongShiXiang,431028201,10975,937,7315,3875,14722,7312,3344,7938,15250,7941,15256
ɽ,JunShanXiang,431028202,10493,942,7122,3887,14156,7111,3182,7480,14591,7495,14617
,HeShiXiang,431028203,13346,1189,9046,5294,18265,9033,4357,9809,18842,9846,18892
ɿ,DuKouXiang,431028204,15905,1550,10985,5589,22159,10972,5264,11700,22672,11734,22719
,HuaWangXiang,431028205,8388,1027,6298,4327,12404,6275,3544,6604,12879,6661,12959
¥,PaiLouXiang,431028206,22015,2309,14640,7904,29987,14609,6059,15697,30306,15743,30383
ƽ,PingBeiXiang,431028207,13492,1348,8873,5014,18163,8830,3703,9602,18432,9670,18543
ƺ,PingShangXiang,431028208,11464,1213,7637,3879,15361,7637,2809,7849,15486,7849,15486
ƺ,ChengPingXiang,431028209,10978,1249,7366,4046,15123,7283,3178,7885,15168,8039,15405
ɽ,ZhuShanXiang,431028210,9140,1008,6181,3620,12618,6176,2557,6518,12694,6524,12705
ɽ,HaoShanXiang,431028211,6325,1012,4621,2760,9001,4598,1947,4589,9187,4663,9284
,YangNaoXiang,431028212,5268,704,3528,1963,7198,3514,1315,3726,7240,3759,7287
,XinZhouXiang,431028213,4754,578,3277,1809,6657,3277,1484,3539,6816,3539,6816
,YangJiXiang,431028214,10082,893,6689,3535,13840,6678,2947,7221,13899,7233,13922
ƶֵ,TangDongJieDao,431081001,46904,5310,31002,19231,43006,28874,9776,28610,57484,30988,61990
,ChuKouZhen,431081100,8800,1146,5973,4127,11409,5973,2019,5990,11963,5992,11965
㽭,LiYuJiangZhen,431081101,19464,2322,12939,9146,15245,12205,4190,11988,24193,13037,25976
,SanDouZhen,431081102,18816,3307,12966,9075,22571,12910,3869,12952,25862,13026,25992
ޤ,LiaoJiangZhen,431081103,11198,1619,7495,4771,14265,7375,2669,7777,15152,7991,15486
,QiLiZhen,431081104,8978,1186,5972,3831,11667,5970,2129,6311,12281,6321,12293
,XingNingZhen,431081105,12790,1571,8640,5550,11013,7827,3092,7860,15687,8813,17453
˾,ZhouMenSiZhen,431081106,5287,802,3429,2781,7175,3425,1159,3792,7217,3819,7248
,QingYaoZhen,431081107,5441,892,3577,3014,7399,3577,1296,4052,7629,4052,7629
Ʋ,HuangCaoZhen,431081108,6943,1085,4807,3875,9531,4770,1819,4960,9730,5040,9847
,DongJiangZhen,431081109,26274,2515,17282,11325,22314,16256,5944,16324,32580,17451,34733
㻨,XiangHuaXiang,431081200,12639,1565,8352,5108,15256,8192,2792,8384,16576,8644,16996
,GaoMaXiang,431081201,6865,864,4528,2950,7852,4458,1625,4579,9037,4826,9354
ƺ,DongPingXiang,431081202,2363,331,1584,1027,3145,1580,540,1640,3220,1650,3234
Ž,TuanJieYaoZuXiang,431081203,1340,228,868,550,1757,865,252,943,1808,952,1820
,BeiJiXiang,431081206,5695,811,3675,2654,7394,3661,1233,4034,7695,4064,7739
ƺ,LianPingYaoZuXiang,431081207,1244,171,809,596,1556,809,273,879,1688,879,1688
μɽ,HeJiaShanXiang,431081208,3156,571,2217,1890,4386,2214,784,2292,4506,2294,4511
ƺʯ,PingShiXiang,431081209,4250,630,2825,2132,5620,2819,929,2965,5784,2984,5809
,PengShiXiang,431081210,4511,601,3014,1926,5813,2994,1070,3132,6126,3168,6182
,TangShiXiang,431081211,4625,662,2995,1851,6016,2982,973,3200,6182,3265,6260
ƺ,YanPingXiang,431081212,2748,434,1841,1309,3562,1840,674,2012,3852,2015,3856
,LanShiXiang,431081213,3863,609,2491,1778,5041,2477,767,2725,5202,2748,5239
ˮ,BoShuiXiang,431081214,4649,982,3436,2728,6567,3394,1325,3403,6797,3520,6956
Ƥʯ,PiShiXiang,431081215,2522,484,1678,1368,3410,1678,549,1866,3544,1877,3555
彭,QingJiangXiang,431081216,7502,1018,4962,3311,9786,4919,1751,5117,10036,5309,10271
Ϫ,LongXiXiang,431081217,2585,439,1724,1447,3419,1711,519,1783,3494,1819,3543
,BaiLangXiang,431081218,6919,1023,4761,3614,9136,4673,1727,4752,9425,4908,9669
ֵ,ZhaoYangJieDao,431102001,37071,2879,22721,10359,28740,16000,5170,15933,31933,22399,45120
Ͻɽֵ,NanJinDuJieDao,431102002,33084,4037,22274,13067,29749,20249,7025,20198,40447,21872,44146
ֵ,QiLiDianJieDao,431102003,38698,3137,26268,14156,28666,21243,8847,21959,43202,24414,50682
Ҿֵ,XuJiaJingJieDao,431102004,22444,2458,13529,9171,21071,13343,4920,13446,26789,16293,29822
ˮɽ,ShuiKouShanZhen,431102101,23159,3476,16411,8948,33243,16388,7470,17621,34009,17694,34105
ɽ,ZhuShanZhen,431102102,40534,5143,27419,14603,55738,27268,11710,29629,56897,29968,57387
,HuangTianPuZhen,431102103,17056,2719,11517,6183,23817,11507,4216,12442,23949,12474,23991
,FuJiaQiaoZhen,431102104,26033,4329,18289,10715,35680,18197,7002,18962,37159,19075,37364
,LingJiaoTangZhen,431102105,17136,2640,11571,6357,23504,11562,4141,12327,23889,12346,23917
ͤ,YouTingWeiZhen,431102106,35438,5329,23728,14052,48199,23728,8338,25341,49069,25377,49105
,JieLvQiaoZhen,431102107,14127,2157,9358,5596,19227,9358,3294,10220,19578,10220,19578
ʯͷ,ShiYanTouZhen,431102108,23749,3262,16137,8396,33595,16133,7163,18009,34142,18037,34174
ƺ,DaQingPingXiang,431102200,15011,2743,10678,5862,22359,10653,4900,11901,22554,11976,22654
,ShuZiPuXiang,431102201,13322,2444,9195,5282,19166,9166,3613,10056,19222,10184,19379
ʯɽ,ShiShanJiaoXiang,431102202,17273,2880,11635,6478,23490,11566,3814,12185,23751,12332,23967
ʵ,DangDiXiang,431102203,12396,1798,8387,4296,16945,8387,3120,8927,17314,8927,17314
÷ֵ,MeiWanJieDao,431103001,45925,4179,29569,18320,39666,26883,10161,27105,53988,30696,60265
ɽֵ,LingJiaoShanJieDao,431103002,26932,3134,17746,11289,25058,16310,5405,15928,32238,17725,35471
Ф԰ֵ,XiaoJiaYuanJieDao,431103003,13539,1408,9213,6437,10069,9031,3327,8842,17873,9061,18274
Žֵ,YangJiaQiaoJieDao,431103004,29957,3300,20000,12992,27016,18449,7105,18670,37119,20362,40362
ֵͩ,WuTongJieDao,431103005,32941,2790,21126,13023,18467,19357,7968,19729,39086,22573,43699
˽ֵ,FengHuangJieDao,431103006,24853,1829,17179,9256,11068,14903,7014,14913,29816,16517,33696
Ž,HuaQiaoJieZhen,431103101,9321,1665,6285,3690,13148,6285,2237,6938,13223,6938,13223
,PuLiQiaoZhen,431103102,26143,4170,17312,10854,36287,17312,6537,19538,36850,19538,36850
ţǰ,NiuJiaoBaZhen,431103103,13881,2243,9267,5117,19525,9266,3577,10430,19696,10434,19701
Ϫ,GaoXiShiZhen,431103104,9750,1555,6624,3254,12949,6561,2238,6719,13280,6919,13543
˾,HuangYangSiZhen,431103105,20246,3507,13613,7765,27846,13509,4995,14885,28394,15135,28748
,ShangLingQiaoZhen,431103106,16841,2433,11326,6615,22659,11305,3894,11800,23105,11842,23168
ɽ,ZhuShanQiaoZhen,431103107,10565,1796,7053,4199,14234,7047,2312,7612,14659,7620,14673
,YiTangZhen,431103108,11865,2056,8061,4393,16199,8061,2808,8668,16729,8668,16729
᰽ɽ,LanJiaoShanZhen,431103109,16404,2330,10814,5702,20629,10603,3545,10915,21518,11465,22279
,CaiShiZhen,431103110,9385,1392,6232,3392,12596,6232,1973,6518,12750,6518,12750
,RenWanZhen,431103111,15150,1778,10298,5499,19768,10295,3759,10386,20681,10389,20687
ɺ,ShanHuXiang,431103200,7798,791,5385,2971,9038,5381,2157,5360,10741,5361,10746
,YangCunDianXiang,431103201,9497,1754,6500,3602,13652,6468,2533,7155,13623,7284,13784
ƺũҵ,MaPingNongYeKaiFaQu,431103401,2780,312,1733,903,3213,1694,579,1773,3467,1938,3671
ҵ԰,GongYeYuanQu,431103402,4421,294,2648,1303,2272,1916,976,1879,3795,3043,5691
Ϫ,WuXiZhen,431121100,130360,13286,87957,46237,142016,77682,30717,76789,154471,86406,174363
̲,GuanYinTanZhen,431121101,22593,3545,15828,9867,31770,15791,6242,16464,32255,16552,32380
é,MaoZhuZhen,431121102,13979,2481,9700,5336,19354,9682,3373,10091,19773,10133,19833
,DaZhongQiaoZhen,431121103,30044,4732,20805,10311,42311,18495,7677,19480,37975,21648,42453
,SanKouTangZhen,431121104,12921,2704,9241,4852,18586,8518,3540,8824,17342,9924,19165
ФҴ,XiaoJiaCunZhen,431121105,17867,4011,14329,8788,28306,13808,7569,13946,27754,15118,29447
˱,BaBaoZhen,431121106,21536,3540,15638,8499,30846,15439,7243,16276,31715,16681,32319
ˮ,BaiShuiZhen,431121107,36411,6398,27172,16074,51982,25283,12868,25273,50556,28505,55677
,HuangNiTangZhen,431121108,14795,3313,11889,7426,22384,11699,6173,11743,23442,12392,24281
,JinBaoTangZhen,431121109,16270,2971,12082,7183,23481,11971,5487,12414,24385,12646,24728
,PanShiZhen,431121110,25354,4383,18454,11167,36888,18390,7785,18967,37357,19068,37522
÷Ϫ,MeiXiZhen,431121111,14212,2704,10646,6109,21073,10544,4981,10958,21502,11251,21897
,YangJiaoTangZhen,431121112,36648,5391,25621,13640,51554,25438,11126,27076,52514,27544,53165
,XiaMaDuZhen,431121113,29853,4839,20982,11890,42478,20564,8428,21265,41829,22138,43120
,QiLiQiaoZhen,431121114,20758,3661,14552,7583,29328,14448,5559,15303,29751,15426,29978
,DaCunDianZhen,431121115,18723,3047,13224,7665,26762,13198,5599,14052,27250,14145,27369
ƺ,LiJiaPingZhen,431121116,31369,4117,20857,12206,37877,18523,8084,19101,37624,22713,43570
ĸ,WenFuShiZhen,431121117,16987,3053,11985,6718,24142,11864,5077,12832,24696,13132,25117
,WenMingPuZhen,431121118,24031,4588,17066,10326,35000,16618,7363,18097,34715,18916,35982
ƺ,GongJiaPingZhen,431121119,18447,3107,12785,7489,26557,12704,5786,14340,27044,14555,27340
,JinDongZhen,431121120,5898,847,4043,2412,7844,3885,1814,4169,8054,4516,8559
С,XiaoJinDongXiang,431121200,3458,492,2534,1469,5008,2439,1296,2506,4945,2712,5246
ɹ̲,ShaiBeiTanYaoZuXiang,431121201,3040,455,2113,1338,4345,1971,1007,2174,4145,2389,4502
,FengHuangXiang,431121202,5060,727,3620,1946,6978,3620,1564,3730,7350,3731,7351
׹,BaiGuoShiXiang,431121203,2547,429,1819,1204,3609,1807,779,1888,3695,1936,3755
ʯԴ,ShiGuYuanXiang,431121204,4264,944,3383,2364,6915,3355,1843,3584,6939,3668,7051
˾Դ,ShangSiYuanXiang,431121205,2411,437,1828,1217,3693,1821,1011,1996,3817,2031,3859
,NeiXiaXiang,431121206,1848,187,1273,635,2571,1270,557,1287,2557,1319,2592
ԭֳ,YuanZhongChang,431121401,1734,211,1229,516,2217,1227,431,1144,2371,1147,2376
,XuMuChang,431121402,445,56,301,182,440,297,104,298,595,304,605
Ұɽֳ,GuaBangShanLinChang,431121403,1282,384,1101,837,2180,1048,550,1044,2092,1115,2216
ֳ,DaJiangLinChang,431121404,3152,428,2140,1114,4129,2125,806,2205,4330,2246,4386
,BaiYaShiZhen,431122100,79185,8756,51436,35380,88763,50483,18609,51985,102468,55114,106550
,DaMiaoKouZhen,431122101,22830,3296,15318,8871,30617,15251,5050,15677,30928,15858,31176
Ϫ,ZiXiShiZhen,431122102,24501,3345,16409,8678,33009,15836,5634,16251,32087,17071,33480
,HengTangZhen,431122103,18952,2894,13139,7184,26077,13089,5491,14073,27162,14198,27337
ʯ,ShiQiShiZhen,431122104,24571,3578,16650,9994,33955,16379,6672,17644,34023,18171,34821
ͷ,JingTouWeiZhen,431122105,31877,4483,21558,12664,44253,21556,8520,23306,44862,23322,44880
,DuanQiaoPuZhen,431122106,26610,3749,18333,10870,36437,18206,6983,18728,36934,19009,37342
¹,LuMaQiaoZhen,431122107,19662,2660,13368,8185,27209,13357,5174,14106,27463,14128,27496
«,LuHongShiZhen,431122108,36455,5014,24528,14755,48396,23642,8994,24989,48631,25935,50463
׽,XinWeiJiangZhen,431122109,17161,2549,11688,7889,24382,11687,5072,13094,24781,13094,24782
,HuaQiaoZhen,431122110,9652,1509,6490,4233,13227,6486,2435,7091,13577,7106,13596
ʢ,DaShengZhen,431122111,18504,2671,13103,7930,26884,13099,5791,13828,26927,13863,26966
,NanQiaoZhen,431122112,19977,2813,13378,8110,27517,13299,5311,14595,27894,14723,28101
󽭿,DaJiangKouXiang,431122200,16780,2376,11237,6141,23201,11237,4550,12461,23698,12469,23706
,ChuanYanXiang,431122201,11153,1491,7607,4258,15459,7606,2836,7872,15478,7873,15480
ˮ,ShuiLingXiang,431122202,8147,1171,5476,2866,11073,5453,1953,5696,11149,5795,11271
ֳ,DaMiaoKouLinChang,431122400,2711,435,1794,1198,3517,1787,560,1871,3658,1912,3706
පֳ,HuangNiDongLinChang,431122401,4044,482,2674,1607,5384,2631,1065,2859,5490,2917,5591
,LongBoZhen,431123100,42063,4435,27172,19906,40995,25882,9862,27436,53318,29188,56360
,JiangCunZhen,431123101,11257,1619,7668,3706,15671,6998,3481,7905,14903,8689,16357
,WuLiPaiZhen,431123102,10029,1329,6716,3601,13260,6714,2197,6836,13550,6839,13555
ƽͷ,PingFuTouXiang,431123200,5000,738,3337,1682,6769,3280,1129,3398,6678,3530,6867
,ShangRenLiXiang,431123201,2805,455,1930,1000,3790,1911,634,1932,3843,1964,3894
,YongJiangXiang,431123202,2779,382,1820,959,3644,1790,605,1885,3675,1946,3766
μҶ,HeJiaDongXiang,431123203,6489,1099,4270,2212,8788,4184,1467,4618,8802,4785,9055
齭,MaJiangXiang,431123204,5338,683,3271,1757,6559,3205,1230,3363,6568,3980,7251
,ChaLinXiang,431123205,6316,745,3571,1920,6962,3435,1231,3628,7063,4721,8292
,TangDiXiang,431123206,3392,504,2250,1302,4649,2235,922,2487,4722,2568,4818
཭,ShangWuJiangYaoZuXiang,431123207,7638,985,4927,2708,10324,4886,1964,5572,10458,5660,10587
ƺ,LiJiaPingXiang,431123208,9523,1259,6477,3190,13720,6447,3118,7356,13803,7423,13900
˫ƴƺֳ,ShuangPaiDaGuPingLinChang,431123400,2748,322,1808,1015,3768,1791,863,2054,3845,2125,3933
˫ֳ,ShuangPaiWuXingLingLinChang,431123401,2675,399,1656,1057,3395,1631,560,1902,3533,1978,3634
˫ɽֳ,ShuangPaiYangMingShanLinChang,431123402,1974,259,1247,757,2533,1230,445,1362,2592,1431,2678
,DaoJiangZhen,431124100,55536,5201,35586,17519,47879,27892,13171,30230,58122,38322,73908
÷,MeiHuaZhen,431124101,22154,2865,15094,8552,32238,15021,8309,18122,33143,18234,33328
,ShouYanZhen,431124102,41913,5374,29477,18683,63990,29471,18419,36214,65685,36229,65706
ӽ,XianZiJiaoZhen,431124103,17092,2627,11988,6976,25613,11984,7183,14881,26865,14914,26902
,QingTangZhen,431124104,20035,2887,14085,8056,30725,13955,8507,17090,31045,17344,31429
,XiangLinPuZhen,431124105,27608,3341,18543,9557,39117,18348,9326,21270,39618,21732,40275
,GongBaZhen,431124106,27661,3659,19364,10175,40000,19342,10219,22113,41455,22175,41539
,SiMaQiaoZhen,431124107,19820,2643,14022,7908,28781,14022,7434,15875,29897,15875,29897
,BaiMaDuZhen,431124108,22138,2541,15007,8501,30734,14988,7578,17230,32218,17250,32257
,FuTangXiang,431124200,7058,823,4730,2535,9736,4675,2323,5359,10034,5474,10204
ָ,LeFuTangXiang,431124201,8706,1335,5665,3438,12876,5657,2949,7310,12967,7325,12990
ͷ,QiaoTouXiang,431124202,14746,2099,10349,6015,21833,10287,5819,12188,22475,12315,22664
Ӫ,YingJiangXiang,431124203,9049,981,6409,3392,13055,6405,3719,7327,13732,7340,13749
ׯ,WanJiaZhuangXiang,431124204,9094,958,6176,3338,12919,6164,3073,6913,13077,6949,13125
³,XinCheXiang,431124205,14078,1945,9707,5050,20485,9692,5257,11511,21203,11573,21280
Ϲ,ShangGuanXiang,431124206,15878,1874,10555,5778,22289,10542,5097,12273,22815,12294,22849
â,BaiMangPuXiang,431124207,17333,2409,11565,6527,25254,11462,6264,14210,25672,14441,26006
԰,GanZiYuanXiang,431124208,18324,2367,12313,6848,26351,12313,6265,14643,26956,14643,26956
,DongMenXiang,431124209,8780,940,6095,2985,12170,6094,2890,6512,12606,6515,12610
,ShenZhangTangYaoZuXiang,431124210,7897,1209,5472,3008,11964,5457,2927,6517,11974,6561,12033
,JingTangYaoZuXiang,431124211,5268,658,3639,1981,7483,3581,1920,4146,7727,4207,7846
,HengLingYaoZuXiang,431124212,4891,668,3270,1692,6843,3268,1581,3865,7133,3870,7140
Ӫ,HongTangYingYaoZuXiang,431124213,8429,1003,5465,2971,11651,5451,2455,6356,11807,6422,11887
ֳ,DaoXianYueYanLinChang,431124400,2225,279,1477,789,3110,1471,778,1779,3250,1805,3282
ͷֳ,DaoXianQiaoTouLinChang,431124401,3898,535,2813,1823,5547,2786,1631,3195,5981,3251,6064
شƺũ,DaoXianDaPingPuNongChang,431124402,232,53,171,164,346,171,88,202,373,202,373
,XiaoPuZhen,431125100,27314,3462,18548,12054,35871,18397,7596,19516,37913,19824,38372
Ͻ,ShangJiangWeiZhen,431125101,12547,1666,8717,5257,17986,8705,4365,9847,18552,9861,18578
ɽ,YunShanZhen,431125102,20375,2406,13949,8198,28384,13908,6779,15546,29454,15611,29560
Ĳ,XiaCengPuZhen,431125103,14877,2094,10099,6163,20793,10096,4406,11260,21356,11278,21377
Ҵ,TaoChuanZhen,431125104,31848,3526,21409,12799,42315,21383,9137,23063,44446,23102,44511
ʯ,CuShiJiangZhen,431125105,18479,2421,12376,7845,25171,12348,5012,13485,25833,13536,25912
ޒ,HuiLongWeiZhen,431125106,8505,1008,5596,3183,10600,5513,2183,5962,11475,6100,11696
ɰ,SongBaiYaoZuXiang,431125200,5893,1025,4260,3085,8963,4260,2135,4791,9051,4793,9053
Ƽ,HuangJiaLingXiang,431125201,8834,1132,5976,3582,12285,5976,2935,6925,12901,6925,12901
ǧ,QianJiaDongYaoZuXiang,431125202,5882,561,3846,2284,8097,3842,1737,4332,8174,4334,8180
Ϫ,LanXiYaoZuXiang,431125203,3522,499,2437,1346,4942,2435,1032,2610,5045,2616,5053
Դ,YuanKouYaoZuXiang,431125204,4741,653,3281,1891,6525,3270,1311,3410,6680,3424,6705
˴,ShunLingZhen,431126100,90004,11257,60759,35627,92472,56320,25854,60992,117312,66356,127115
,TianTangZhen,431126101,24358,3283,15989,9291,34300,15920,7111,18597,34517,18763,34752
ˮ,ShuiShiZhen,431126102,44637,5953,29309,16629,63044,29242,12733,33856,63098,34014,63323
微,WanJingZhen,431126103,23581,3375,15683,8664,34014,15670,7266,18489,34159,18539,34222
ˮ,LengShuiZhen,431126104,48059,6515,32944,18577,70570,32900,16681,37876,70776,38311,71255
̫ƽ,TaiPingZhen,431126105,32659,4467,22628,12076,48258,22590,11435,25779,48369,25933,48561
ͤ,HeTingZhen,431126106,26688,3790,17934,10516,38434,17924,8139,20670,38594,20683,38617
ʺ,RenHeZhen,431126107,19977,2936,13645,7703,28403,13397,5956,14709,28106,15224,28869
к,ZhongHeZhen,431126108,41734,5322,27986,15129,60198,27938,13491,32393,60331,32561,60547
ؼƺ,BaiJiaPingZhen,431126109,37743,4766,25703,13963,54306,25664,12268,28819,54483,29074,54777
ˮ,QingShuiQiaoZhen,431126110,23248,3031,16252,9423,34221,16252,8105,18129,34381,18132,34384
Ϫ,LiXiZhen,431126111,28864,3518,19095,9856,40591,19086,8461,21706,40792,21748,40843
ɽ,JiuYiShanYaoZuXiang,431126200,17198,2410,12040,7068,25236,11924,6130,13452,25376,13698,25738
,BaoAnXiang,431126201,18671,2430,12097,6647,25999,12039,5361,13926,25965,14365,26462
,HuangTangYaoZuXiang,431126202,5343,674,3620,1869,7632,3582,1673,3984,7566,4070,7690
޻ƺ,MianHuaPingYaoZuXiang,431126203,1317,268,1069,793,2199,1061,618,1110,2171,1134,2203
ͩľ,TongMuLuoYaoZuXiang,431126204,1986,348,1547,1011,3140,1542,870,1630,3172,1657,3204
,TaFengZhen,431127100,61749,6569,42711,22208,68154,39247,18211,40873,80120,43818,86529
,ZhuGuanSiZhen,431127101,21546,2766,15143,8082,31109,15029,8108,16859,31888,17277,32420
ë,MaoJunZhen,431127102,19584,2942,14796,8542,30100,14791,8219,15933,30724,15949,30745
,NanShiZhen,431127103,17277,2403,12825,7115,26480,12786,7510,14282,27068,14365,27190
,SuoChengZhen,431127104,15470,2031,10811,5668,21413,10764,5091,11176,21940,11781,22592
,XinWeiZhen,431127105,27116,3468,19563,10650,39861,19559,9926,20923,40482,20947,40510
Դ,HuiYuanYaoZuXiang,431127200,1029,212,819,544,1645,819,470,892,1711,892,1711
ͷ,LiTouYaoZuXiang,431127201,909,132,660,470,1359,660,382,763,1423,763,1423
,JiangDongYaoZuXiang,431127202,2766,390,1928,1107,3957,1895,950,2137,4032,2178,4106
,ZiLiangYaoZuXiang,431127203,1493,262,1148,650,2186,1141,559,1143,2284,1166,2314
,DaQiaoYaoZuXiang,431127204,5062,799,3688,1925,7322,3667,1734,3867,7534,3907,7595
,JingZhuYaoZuXiang,431127205,2344,354,1630,1028,3064,1599,595,1544,3143,1663,3293
,CiTangWeiXiang,431127206,7833,1611,6356,4426,13119,6355,4023,7105,13460,7111,13467
,TuShiXiang,431127207,18035,2491,13674,7253,27507,13659,7701,14516,28175,14553,28227
̫ƽ,TaiPingWeiXiang,431127208,16518,2055,12109,6501,24727,12016,6679,12966,24982,13143,25252
ɽֳ,LanShanJingZhuLinChang,431127400,57,2,27,19,41,25,9,29,54,41,68
ɽֳ,LanShanJiangDongLinChang,431127401,54,6,30,36,48,29,9,33,62,39,69
ɽֳ,LanShanNanLingLinChang,431127402,455,54,332,171,686,332,177,354,686,354,686
ɽԭֳ,LanShanYuanZhongChang,431127403,36,19,32,29,64,32,9,32,64,32,64
ɽë賡,LanShanHuangMaoLingChaChang,431127404,84,15,63,30,124,63,25,61,124,61,124
Ȫ,LongQuanZhen,431128100,69041,7341,48271,29187,72400,46972,22114,49210,96182,50225,98496
,JinLingZhen,431128101,5701,780,4045,2252,7818,4029,1903,4319,8348,4339,8384
,JiCunZhen,431128102,10032,1317,7002,3767,14296,7002,3188,7535,14537,7535,14537
ͷ,JianTouZhen,431128103,11789,1664,8193,4587,16903,8144,3814,8990,17134,9074,17267
,XinWeiZhen,431128104,11841,1683,8346,4576,17315,8234,3856,8830,17064,9034,17380
ʯ,ShiYangZhen,431128105,17043,2188,11995,6416,24621,11994,5931,13159,25153,13167,25162
¡,XinLongZhen,431128106,7763,1271,5726,3194,11801,5726,2926,6234,11960,6234,11960
,LianHuaXiang,431128200,6558,934,4584,2503,9227,4584,2055,4940,9524,4963,9547
ˮ,LengShuiJingXiang,431128201,4873,777,3468,1838,7040,3465,1645,3813,7278,3827,7295
¥,MenLouXiaYaoZuXiang,431128202,5377,585,3691,1813,7455,3691,1626,3897,7588,3897,7588
ï,MaoJiaXiang,431128203,5857,900,3972,2150,8311,3962,1645,4417,8379,4430,8402
ë,MaoLiXiang,431128204,8273,1273,6064,3628,12339,5988,3001,6399,12387,6483,12547
ʮ,ShiZiXiang,431128205,8661,1333,6182,3260,12314,6182,3057,6869,13051,6869,13051
,JinPenWeiXiang,431128206,12178,1708,8882,5575,18424,8877,4884,9877,18754,9888,18770
,SanJingXiang,431128207,7613,1108,5197,2921,10703,5197,2234,5758,10955,5758,10955
,TaoLingXiang,431128208,7121,1085,5060,3304,10663,5051,2501,5632,10683,5647,10707
ɽ,GaoShanXiang,431128209,6478,1092,5007,3232,10242,4993,2775,5306,10299,5338,10345
֪ƺ,ZhiShiPingXiang,431128210,8172,1227,5693,2999,12021,5693,2638,6344,12037,6344,12037
ƺ,DaPingTangXiang,431128211,9730,1418,6988,3995,14491,6987,3404,7563,14550,7564,14552
,DuoJiangZhen,431129100,58108,6346,38648,23541,71573,38021,15194,40239,78260,41000,79648
ͷ,QiaoTouPuZhen,431129101,16575,2362,11706,7806,24189,11698,5835,13017,24715,13066,24772
,DongTianZhen,431129102,9544,1298,6619,4345,13306,6619,3010,7233,13852,7233,13852
·,DaLuPuZhen,431129103,18717,2714,13397,7860,27025,13397,6883,14915,28312,14917,28314
âӪ,BaiMangYingZhen,431129104,27698,4227,19842,11232,41398,19776,10893,22847,42623,22976,42818
,TaoWeiZhen,431129105,18396,2402,12985,6925,27178,12782,6751,14125,26907,14564,27549
·,HeLuKouZhen,431129106,12412,1442,9287,5028,18291,9257,5038,9505,18762,9605,18892
С,XiaoWeiZhen,431129107,12582,2151,9896,5727,19265,9895,5243,10075,19970,10080,19976
,DaWeiZhen,431129108,14669,2826,11638,7033,22845,11638,6181,12038,23676,12038,23676
ˮ,ShuiKouZhen,431129109,5591,700,3996,2470,7295,3722,1652,3632,7354,3947,7943
,MaShiZhen,431129110,18159,2550,13012,7180,25026,13004,5222,12884,25888,12919,25931
,JiePaiXiang,431129200,9454,1388,6805,4410,13886,6803,3440,7469,14272,7477,14282
,QiaoShiXiang,431129201,6829,1058,4901,3226,10055,4864,2463,5399,10263,5449,10350
ʯ,DaShiQiaoXiang,431129202,12578,1786,9264,5206,19308,9264,5178,10278,19542,10278,19542
׳,QingTangZhuangZuXiang,431129203,3045,662,2552,1689,5023,2545,1437,2565,5110,2592,5144
,LiangChaHeXiang,431129204,2532,462,1873,1108,3648,1869,769,1867,3736,1890,3763
,WuJiangXiang,431129205,3745,313,2699,1607,5232,2699,1215,2574,5273,2574,5273
,HuaJiangXiang,431129206,4116,573,3124,1948,6030,3124,1417,2982,6106,2982,6106
潭,XiangJiangXiang,431129207,3907,441,2707,1605,5418,2700,1110,2743,5443,2751,5458
,BeiJiangXiang,431129208,6879,938,5063,3018,9840,5055,2051,4797,9852,4805,9868
δ,WeiZhuKouXiang,431129209,5062,696,3545,2060,7135,3545,1414,3627,7172,3627,7172
,DaXiXiang,431129210,3188,484,2197,1212,4354,2191,827,2279,4470,2302,4499
ҵ,JiangHuaLinYeCaiYuChang,431129400,4934,705,3012,1764,5838,2475,1072,2667,5142,3699,6711
нֵ,ChengZhongJieDao,431202001,97859,7520,60375,36785,62303,56735,18494,57324,114059,63498,123873
Ǳֵ,ChengBeiJieDao,431202002,49010,4128,30504,20528,40673,28862,8675,30044,58906,31309,61813
ǽֵ,HongXingJieDao,431202003,42550,3695,26293,19034,30924,25112,8429,25965,51077,28381,54674
ӭֵ,YingFengJieDao,431202004,61542,6698,40761,23205,48714,33926,11225,33739,67665,38704,79465
Ժֵ,TuoYuanJieDao,431202005,29412,2057,18372,7153,15615,10979,3911,10970,21949,17008,35380
ֵ,HeXiJieDao,431202006,37822,2050,22671,12483,18292,20712,8031,21710,42422,25232,47903
Ͻֵ,ChengNanJieDao,431202007,7374,560,3976,2886,4748,3460,1179,3832,7292,5137,9113
ƽ,HuangJinAoZhen,431202101,8533,1172,5648,3564,11597,5648,2343,6400,12048,6400,12048
ӯ,YingKouXiang,431202201,60683,4358,38329,21479,32797,36812,13367,37747,74559,40079,78408
,YangCunXiang,431202202,7109,764,4805,3283,8241,4778,1841,4851,9629,4909,9714
ʯ,ShiMenXiang,431202203,14360,1788,9128,5302,16407,9114,3005,9961,19075,10025,19153
ؼ,HeJiaTianXiang,431202204,2187,424,1499,1068,3047,1482,558,1631,3113,1670,3169
ͤ,LiangTingAoXiang,431202205,3582,865,2851,2097,5695,2833,1539,3008,5841,3135,5986
«ƺ,LuPingXiang,431202206,6254,1157,4367,3064,8798,4364,1699,4725,9089,4743,9110
ζȼ,HuangYanLvYouDuJiaQu,431202400,2040,323,1384,749,2723,1384,450,1429,2813,1429,2813
з,ZhongFangZhen,431221100,22879,2697,15054,9832,26928,14753,5206,15012,29765,15728,30782
¥,PaiLouZhen,431221101,11913,1886,8008,4886,15480,7928,2778,8344,16272,8569,16577
,LuYangZhen,431221102,15034,1925,9798,5111,18499,9540,3284,9863,19403,10445,20243
,HuaQiaoZhen,431221103,12444,1771,8256,4482,16688,8255,2673,8627,16882,8632,16888
ͭ,TongWanZhen,431221104,15685,2269,10454,6678,20617,10454,3667,11151,21605,11167,21621
ͩľ,TongMuZhen,431221105,14201,2178,9455,5535,18364,9406,3105,9779,19185,10029,19484
,TiePoZhen,431221106,6169,1018,4083,2462,8127,4076,1419,4517,8593,4523,8606
¯ͤ,LuTingAoXiang,431221200,3658,662,2457,1579,4823,2412,839,2619,5031,2702,5159
ƺ,XiaPingXiang,431221201,5936,767,3903,1968,7214,3577,1260,3730,7307,4060,7963
Ҵ,NieJiaCunXiang,431221202,6493,1114,4474,2579,8989,4472,1521,4627,9099,4654,9128
,LongChangXiang,431221203,3912,734,2585,1401,5332,2576,916,2948,5524,2977,5562
ͭ,TongDingXiang,431221204,8286,1468,5728,3410,11541,5629,2144,5900,11529,6170,11898
½,XinJianXiang,431221205,8063,1410,5470,3110,11358,5348,2053,5760,11108,6056,11526
Ԭ,YuanJiaXiang,431221206,3344,722,2496,1670,4743,2457,941,2417,4874,2511,5007
,JiangJiaXiang,431221207,3846,726,2623,1588,5395,2597,902,2778,5375,2851,5474
·,XinLuHeXiang,431221208,6893,1174,4523,2763,9543,4510,1546,5047,9557,5090,9613
,DingJiaXiang,431221209,2655,586,1795,1220,3770,1785,604,1989,3774,2050,3845
Ϫ,JinXiXiang,431221211,2759,578,1841,1057,3866,1823,629,2067,3890,2125,3966
ˮ,HuoShuiXiang,431221212,3198,632,2224,1329,4518,2173,771,2238,4411,2377,4601
ʯ,ShiBaoXiang,431221213,4864,935,3261,1803,6848,3223,1129,3589,6812,3667,6928
Ｊƺ,HaoJiPingYaoZuXiang,431221214,2739,498,1957,1290,4035,1957,798,2078,4035,2078,4035
,JieLongXiang,431221215,5560,940,3562,2053,7352,3458,1243,3951,7409,4181,7743
Ϫ,MaXiPuZhen,431222102,11772,1778,7840,3952,15716,7704,2833,8308,16012,8543,16383
ǿϪ,WuQiangXiZhen,431222105,20635,2887,13652,8028,25880,13089,4636,13490,26579,14506,28158
,YuanLingZhen,431222109,79107,10654,54210,32516,84691,53666,18530,52935,106601,54081,108291
Ϫ,MingXiKouZhen,431222110,13856,2431,9201,4781,19100,9040,3238,10025,19065,10324,19525
ˮ,LiangShuiJingZhen,431222111,35362,5910,23205,13278,48270,23116,8597,26441,49557,26664,49869
߼ƺ,QiJiaPingZhen,431222112,26034,4916,18477,11608,36543,18398,6746,19022,37420,19219,37696
,ShaoJiWanZhen,431222113,19179,2934,13325,7571,27261,13179,5873,14225,27404,14661,27986
ׯ,GuanZhuangZhen,431222114,32271,5467,21310,13967,40676,21074,6560,22078,43152,22988,44298
żƺ,DuJiaPingXiang,431222223,4443,658,2904,1642,5793,2893,963,3115,6008,3160,6064
ľ,NanMuPuXiang,431222224,9307,1621,6420,3550,12669,6383,2343,6784,13167,6851,13271
Ϫ,ShenXiKouXiang,431222229,7311,1157,4815,2382,9761,4747,1469,5005,9752,5122,9937
Ф,XiaoJiaQiaoXiang,431222230,7360,1285,5099,3112,10219,5093,1692,5228,10321,5238,10337
,HuoChangTuJiaZuXiang,431222234,4970,806,3211,1439,6789,2825,1124,3226,6051,3689,6900
¼̲,ChenJiaTanXiang,431222238,5928,1101,4184,2909,8167,4148,1372,4164,8312,4217,8401
,QingLangXiang,431222239,15247,2597,10240,5763,20624,10108,3403,10748,20856,11007,21247
ĸϪ,JieMuXiXiang,431222245,12785,2296,8318,4744,17521,8208,2805,9278,17486,9568,17886
Ϫ,LiXiXiang,431222247,19032,3343,12758,6564,26947,12719,5272,14718,27437,14889,27647
ƺ,DaHePingXiang,431222248,11713,2237,7640,4227,16035,7611,2260,8500,16111,8570,16210
̫,TaiChangXiang,431222249,16354,2488,10553,5292,21967,10143,3390,11096,21239,11679,22232
,MaDiYiXiang,431222250,12170,2321,8653,5058,17079,8471,3235,8817,17288,9073,17726
,BeiRongXiang,431222251,12873,2353,8267,4746,17443,8111,2519,9197,17308,9478,17745
,ErYouXiang,431222252,25087,4028,16812,8212,34743,16465,6246,18043,34508,18549,35361
̹,PanGuXiang,431222253,13976,2205,9427,4761,18968,9427,3231,9984,19411,9985,19412
,ChenYangZhen,431223100,58477,7173,39114,30047,55035,38187,12472,38170,76357,39008,78122
Тƺ,XiaoPingZhen,431223101,17540,3510,11738,8733,23965,11595,3228,12252,23847,12540,24278
,TianWanZhen,431223102,6085,1044,3966,2227,8415,3951,1353,4481,8432,4516,8482
,HuoMaChongZhen,431223103,15269,1770,9096,5927,17559,8760,2846,9567,18327,10789,19885
Ϫ,HuangXiKouZhen,431223104,13618,1890,9228,5463,16954,9076,3548,9638,18714,9828,19056
̶,TanWanZhen,431223105,14113,2250,9416,4840,19186,9416,3022,9969,19385,9969,19385
ƺ,AnPingZhen,431223106,12138,1891,7993,4662,15721,7768,2601,8238,16006,8637,16630
ǰ,SiQianZhen,431223107,10611,1557,6766,3697,13991,6305,2091,6741,13046,7493,14259
Ϫ,ChuanXiXiang,431223200,7651,1235,5178,2435,10551,5153,1798,5434,10587,5506,10684
ǽ,ChengJiaoXiang,431223201,18429,2125,12035,7493,16642,11919,4057,12426,24345,12576,24611
,BanQiaoXiang,431223202,6062,1164,4038,2244,8403,3961,1336,4378,8339,4524,8562
,ChangTianWanXiang,431223204,9403,1536,6290,3543,12925,6200,2175,6630,12830,6824,13114
С,XiaoLongMenXiang,431223205,7984,1080,5010,2496,10107,4592,1621,4974,9566,5675,10685
,HouTangYaoZuXiang,431223206,10330,1606,7071,3963,14732,7066,2837,7676,14742,7702,14773
ľϪ,SuMuXiYaoZuXiang,431223207,5641,860,3735,2170,7919,3725,1566,4317,8042,4332,8067
ɽ,LuoZiShanYaoZuXiang,431223208,4071,627,2680,1479,5686,2676,1010,3018,5694,3028,5708
Ϫ,ShangPuXiYaoZuXiang,431223209,5381,881,3503,1975,7404,3503,1208,3967,7470,3967,7470
,XianRenWanYaoZuXiang,431223210,13980,2064,9221,4923,19152,9194,3373,10137,19331,10196,19417
ͷ,LongTouAnXiang,431223211,9376,1599,6300,3334,12944,6295,2218,6878,13173,6893,13193
,JinBinXiang,431223212,9737,1494,6379,4399,11791,6359,2043,6814,13173,6895,13274
ʯ,ShiBiXiang,431223213,8031,1326,5462,2916,10956,5442,1813,5672,11114,5708,11170
ͷ,QiaoTouXiang,431223214,7885,1383,5348,2705,10994,5339,1777,5676,11015,5697,11045
ˮ,DaShuiTianXiang,431223215,9715,1674,6554,3384,13988,6389,2740,7187,13576,7575,14129
ͷϪ,QiaoTouXiXiang,431223216,5324,1010,3582,1893,7379,3582,1156,3898,7480,3908,7490
ʯ,ShiMaWanXiang,431223217,8624,1496,5874,2951,11921,5788,1949,6002,11790,6195,12069
Ȫ,LongQuanYanXiang,431223218,5862,1095,4072,2221,8306,4061,1504,4372,8433,4389,8461
Ϫ,XiuXiXiang,431223219,8708,1389,5730,3451,11557,5663,1734,5935,11598,6101,11831
,WuJiaWanXiang,431223220,3664,784,2357,1605,5171,2351,767,2848,5199,2858,5215
Ϫ,ShiXiXiang,431223221,10150,1760,6859,3717,13963,6782,2283,7247,14029,7334,14193
̷ҳ,TanJiaChangXiang,431223222,5549,1273,3819,2586,8134,3769,1485,4407,8176,4488,8307
¬,LuFengZhen,431224100,99559,10917,66998,37855,110269,64117,24511,64224,128341,67989,134987
,JiangKouZhen,431224101,22847,2706,14935,9759,26951,14630,5482,15313,29943,16100,31035
ׯ,DiZhuangZhen,431224102,25813,4532,18922,12271,36141,18791,8093,19218,38009,19516,38438
Ž,QiaoJiangZhen,431224103,33813,4647,23164,11973,46123,23071,8358,23548,46619,23654,46818
̶,LongTanZhen,431224104,18952,2902,13572,7338,23624,13316,5471,13466,26782,13753,27325
ƺ,JunPingZhen,431224105,13984,2113,9332,5388,19478,9169,3785,10280,19449,10550,19882
,GuanYinGeZhen,431224106,21450,3113,14181,7906,29244,14026,5064,15142,29168,15446,29627
˫,ShuangJingZhen,431224107,21329,3598,15236,8930,29910,15216,5871,15524,30740,15562,30798
ˮ,ShuiDongZhen,431224108,12269,1845,8584,4491,16910,8571,3071,8576,17147,8601,17185
Ѿƺ,LiangYaPingZhen,431224109,8263,1575,5566,3520,11647,5278,1933,5628,10906,6205,11771
é԰,HuangMaoYuanZhen,431224110,21516,3688,15137,8236,29645,15057,5706,15482,30539,15773,30910
е,ZuShiDianZhen,431224111,13465,2072,9100,5395,18718,9100,3396,9831,18931,9833,18933
ƺ,GeZhuPingZhen,431224112,13863,2370,9616,5888,19429,9557,3861,10379,19936,10478,20094
̷,TanJiaWanZhen,431224113,9378,1498,6712,4352,13347,6699,2869,6988,13687,7033,13745
ˮ,FuShuiWanXiang,431224200,9582,1753,7058,4568,13416,7050,2809,7057,14107,7086,14144
С,XiaoJiangKouXiang,431224201,5107,1027,3666,2612,7085,3621,1548,3739,7360,4016,7682
˼,SiMengXiang,431224202,9590,1652,6631,3572,13360,6615,2444,7036,13651,7055,13686
ľϪ,MuXiXiang,431224203,5412,1184,3776,2212,8028,3776,1496,4307,8083,4316,8092
Ϫ,ShuRongXiXiang,431224204,6578,1211,4640,2884,9575,4636,1984,5099,9735,5133,9773
,ZhongXiaXiang,431224205,10108,1385,7073,4176,13885,7020,2637,6937,13957,7057,14130
ˮ,ShuiAiXiang,431224207,5253,1038,3889,2850,7800,3871,1677,4034,7905,4079,7968
üϪ,RangJiaXiXiang,431224208,4373,846,3042,2152,6194,3042,1066,3240,6282,3243,6285
μϪ,DaWeiXiXiang,431224209,3511,820,2576,1794,5305,2565,1104,2784,5349,2859,5435
Ҽ,YanJiaLongXiang,431224210,10468,2094,8017,4734,15672,7979,3585,8021,16000,8130,16147
ˮׯ,ShuiTianZhuangXiang,431224212,4230,839,3098,2068,6347,3098,1329,3299,6397,3300,6398
,YouYangXiang,431224213,10730,2363,7922,5074,15829,7899,3075,8174,16073,8246,16168
,XinTianXiang,431224214,3371,800,2441,1744,5047,2428,954,2663,5091,2684,5125
ڶ,GangDongXiang,431224215,4769,1102,3500,2653,7046,3470,1274,3572,7042,3645,7145
,LiangJiangXiang,431224216,6992,1264,4891,3147,10096,4869,1963,5222,10091,5328,10219
Ϫ,ShanXiXiang,431224217,3369,821,2537,1791,5214,2537,1146,2797,5334,2799,5336
ͩľϪ,TongMuXiXiang,431224218,10666,1660,7511,4166,14972,7433,3135,7799,15232,7950,15461
С,XiaoHengLongXiang,431224219,8861,1765,6277,3682,12760,6219,2476,6682,12901,6825,13102
ͳϪ,TongXiHeXiang,431224220,6582,1355,4682,2810,9498,4678,1810,5060,9738,5065,9747
,LongWangJiangXiang,431224221,4691,1057,3368,2387,6793,3359,1300,3563,6922,3680,7048
սƺ,TaoJinPingXiang,431224222,4566,1025,3411,2218,6890,3392,1439,3564,6956,3619,7030
ж,ZhongDouXiang,431224223,4654,1130,3520,2559,6867,3502,1500,3739,7241,3764,7284
Ϫ,YanXiXiang,431224224,6310,1195,4335,2852,8952,4285,1727,4767,9052,4897,9232
Ϫ,JiuXiJiangXiang,431224225,4332,1071,3243,2355,6383,3213,1292,3360,6573,3452,6695
Ϫ,BeiDouXiXiang,431224226,3495,688,2487,1680,4919,2470,930,2580,5050,2626,5113
,HengBanQiaoXiang,431224227,8188,1575,5837,3309,11815,5778,2335,6046,11824,6261,12098
ˮ,WenShuiXiang,431224228,4084,821,2989,2070,5926,2981,1231,3132,6113,3147,6136
,DaHuaXiang,431224229,6048,1141,4334,2809,8612,4322,1795,4598,8920,4650,8984
ׯ,LongZhuangWanXiang,431224230,5395,691,3721,2378,7248,3705,1717,4024,7729,4082,7803
ֳ,LinChengZhen,431225100,44522,4549,29323,18872,46479,28383,10058,28613,56996,29806,59129
ƺ,PingCunZhen,431225101,15753,2340,10483,5867,20416,10332,3699,10530,20862,11309,21792
,BuZiZhen,431225102,10547,1586,7202,4043,14303,7067,2518,7250,14317,7449,14651
ź,TuanHeZhen,431225103,8578,1315,5745,3536,11467,5698,2197,6245,11943,6345,12090
ˮ,RuoShuiZhen,431225104,7969,1537,5474,3282,11004,5467,1800,5806,11273,5832,11306
ʽ,LangJiangZhen,431225105,7376,1244,5157,3423,10362,5156,1841,5302,10458,5304,10461
ƺ,GuangPingZhen,431225106,13314,1756,8802,5540,18437,8798,3617,9880,18678,9885,18687
�,MaAnZhen,431225107,7996,1251,5312,3314,10677,5273,1891,5570,10843,5826,11138
ɳϪ,ShaXiXiang,431225200,8773,1384,5844,3358,12193,5752,2123,6266,12018,6436,12280
Ҷ,JinZiYanDongZuMiaoZuXiang,431225201,7733,1191,5305,2824,10963,5303,2166,5781,11084,5785,11090
ƺ,WangJiaPingXiang,431225202,6878,1170,4546,2507,9582,4526,1706,5166,9692,5208,9754
կ,ChangZhaiXiang,431225203,5074,859,3317,1733,6758,3281,1097,3511,6792,3713,7030
,GaoYiXiang,431225204,5647,992,3786,2226,7700,3717,1285,3990,7707,4138,7924
é,HuangMaoXiang,431225205,4632,734,3056,1699,6071,2977,919,3103,6080,3229,6285
Ф,XiaoJiaXiang,431225206,5717,854,3825,2321,7710,3813,1246,3985,7798,3992,7817
,JinLongXiang,431225207,6640,1092,4524,2956,9042,4516,1510,4707,9223,4718,9242
ﶱ,BaoTianDongZuMiaoZuXiang,431225209,6247,922,4120,2507,8623,3867,1597,4320,8187,4646,8766
Į,MoBinDongZuMiaoZuXiang,431225210,8355,1129,5598,3927,11572,5598,2222,6108,11706,6108,11706
ȶ,PuWenDongZuMiaoZuXiang,431225211,5938,867,3960,2306,8337,3954,1660,4456,8410,4505,8465
ʶ,QingLangDongZuMiaoZuXiang,431225212,6056,865,4153,2119,8567,3972,1797,4251,8223,4565,8718
Ŷ,PaoTuanDongZuMiaoZuXiang,431225213,7893,1187,5235,3040,11102,5211,2130,5942,11153,5975,11210
,DiLingXiang,431225214,5893,837,3779,2539,8034,3779,1430,4381,8160,4381,8160
ɽ,LianShanXiang,431225215,8844,1243,6022,3536,11728,5983,2213,6086,12069,6278,12300
ͷ,YanTouXiang,431225216,7495,1193,5134,3099,10514,5134,1873,5427,10561,5427,10561
Ϫ,SaXiXiang,431225217,5963,907,3961,2235,7984,3951,1254,4156,8107,4163,8124
,JinHeZhen,431226101,12030,1855,8215,4401,16496,7889,3176,8302,16191,8846,17061
,JiangKouXuZhen,431226102,11521,1782,7983,4234,16068,7960,3256,8488,16448,8576,16559
,YanMenZhen,431226103,13870,1768,9038,4650,18262,8924,3583,9467,18391,10183,19221
,LanLiZhen,431226104,16169,2497,10848,5176,22748,10783,4137,11789,22572,11955,22803
ƺ,LvJiaPingZhen,431226105,11335,1742,7774,3953,15378,7751,3142,8421,16172,8445,16219
ߴ,GaoCunZhen,431226106,50130,5108,32994,18517,51188,31416,11649,32019,63435,33893,66887
ƺ,GuoGongPingXiang,431226200,9995,1495,6753,3745,14237,6341,2764,7413,13754,7501,14254
̶,ChangTanXiang,431226201,5930,940,4172,2187,8406,4161,1719,4368,8529,4417,8589
ϳ,TuoChongXiang,431226202,6416,981,4193,2267,8965,4158,1575,4694,8852,4779,8972
Ң,YaoShiXiang,431226203,7198,1089,4806,2629,9976,4690,1783,5177,9867,5264,10070
Ĳ,WenChangGeXiang,431226204,6482,1161,4518,2432,9106,4433,1720,4715,9148,4845,9363
Ž,DaQiaoJiangXiang,431226205,6888,1031,4726,2388,9725,4726,1844,5037,9763,5037,9763
Ҵ,ShuJiaCunXiang,431226206,6683,1117,4600,2371,9608,4395,1834,4761,9156,5034,9634
¡ұ,LongJiaBaoXiang,431226207,8051,1232,5553,2678,11215,5451,2128,5656,11107,5858,11411
̷կ,TanJiaZhaiXiang,431226208,6774,1290,4785,2694,9925,4618,1910,4922,9540,5189,9974
ʯ,ShiYangShaoXiang,431226209,7261,1036,4730,2440,9677,4656,1718,4992,9648,5285,10015
,BanLiShuXiang,431226210,7463,1220,5021,2521,10709,4963,2033,5512,10475,5695,10716
ȴ,GuDaPoXiang,431226211,5461,956,3805,1936,7801,3507,1529,3789,7296,4141,7946
,LanCunXiang,431226212,5234,817,3563,2002,7132,3519,1484,3617,7136,3972,7535
ƺ,LiPingXiang,431226213,8201,1183,5420,2572,11338,5371,2045,5887,11258,6009,11429
Ϫ,LvXiKouXiang,431226214,11777,1771,8210,3962,16608,8008,3128,8298,16306,8466,16676
ƺϪ,HePingXiXiang,431226215,9327,1396,6214,3185,13180,6167,2553,6929,13096,7062,13276
ɣ,HuangSangXiang,431226216,10659,1511,7280,3127,14884,7218,2766,7533,14751,7656,14936
»,XinHuangZhen,431227100,25965,3669,17401,12295,25582,16894,5483,17067,33961,17716,35117
,BoZhouZhen,431227101,8463,1155,5489,3531,11454,5484,1975,6093,11577,6104,11593
¡,XingLongZhen,431227102,14930,2038,9617,5394,18333,9371,3148,10125,19496,10499,20116
,YuShiZhen,431227103,8651,1409,5631,3557,11895,5531,2031,6223,11754,6460,12091
ɡ,LiangSanZhen,431227104,8680,1637,5621,3008,12187,5557,1996,6527,12084,6692,12313
,FuLuoZhen,431227105,9300,1599,6130,3360,13088,6127,2403,7131,13258,7172,13302
կ,ZhongZhaiZhen,431227106,8030,1487,5143,3199,11361,5143,1946,6313,11456,6320,11463
ͷ,BuTouJiangMiaoZuXiang,431227200,7591,1247,4876,2914,10471,4798,1717,5523,10321,5679,10555
ƺ,DongPingXiang,431227201,5617,1048,3781,2301,7976,3758,1435,4258,8016,4319,8100
,DaWanLuoXiang,431227202,6224,968,3968,2484,8089,3933,1425,4469,8402,4649,8617
,FangJiaTunXiang,431227203,10343,1533,6850,4186,13791,6784,2517,7382,14166,7543,14393
̼,YanJiaXiang,431227204,3940,724,2477,1475,5537,2474,889,3072,5546,3076,5553
ֳ,LinChongXiang,431227205,4472,729,2806,1692,6226,2803,1088,3466,6269,3483,6289
,TianTangXiang,431227206,4218,811,2592,1600,5981,2557,977,3362,5919,3414,6006
,HuangLeiXiang,431227207,4030,769,2528,1486,5664,2522,975,3208,5730,3246,5774
կ,DengZhaiXiang,431227208,5150,967,3300,1787,7213,3293,1142,3913,7206,3959,7259
ƺ,ChaPingXiang,431227209,2858,577,1892,1002,4143,1882,731,2244,4126,2274,4166
կ,XinZhaiXiang,431227210,6369,1110,4047,2368,8995,4002,1554,4880,8882,4986,9033
Ϫ,GongXiXiang,431227211,7398,1534,4731,3086,10690,4710,1887,5993,10703,6088,10819
,LiShuXiang,431227212,6075,1081,3923,2219,8579,3849,1557,4592,8441,4790,8713
̲,HeTanXiang,431227213,5376,1092,3515,2177,7711,3515,1283,4236,7751,4236,7751
,BiLangXiang,431227214,4772,688,2874,1879,6653,2874,1216,3802,6676,3802,6676
ױ,MiBeiMiaoZuXiang,431227215,6086,1077,3863,2183,8458,3797,1460,4556,8353,4760,8623
ƽ,ZhiJiangZhen,431228100,58218,7013,40336,23958,57058,37066,13220,35494,72560,38115,78451
޾,LuoJiuZhen,431228101,10827,1457,7306,4157,14264,7237,2695,7540,14777,7673,14979
µƺ,XinDianPingZhen,431228102,12179,1775,8151,4822,16323,7732,3241,8296,16028,9044,17195
ӿ,BiYongZhen,431228103,9449,1484,6098,4205,13085,6027,2563,7262,13289,7398,13496
ƺ,GongPingZhen,431228104,5839,691,3828,2248,6674,3631,1576,3899,7530,4278,8106
ţƺ,NiuGuPingXiang,431228201,4992,739,3280,2093,6867,3277,1170,3613,6890,3621,6901
ͷƺ,AiTouPingXiang,431228202,5114,803,3483,2237,7028,3452,1277,3654,7106,3711,7194
,YanQiaoXiang,431228203,15102,2099,10025,5963,20172,9806,3552,10421,20227,10728,20753
ˮ,ShuiKuanXiang,431228204,6802,1107,4537,2685,9467,4404,1754,4735,9139,5126,9663
ľҶϪ,MuYeXiXiang,431228206,5054,813,3322,2158,6858,3267,1191,3632,6899,3736,7058
Ϫ,WuLangXiXiang,431228207,2947,488,1959,1141,4067,1932,701,2070,4002,2177,4136
ӧ,MaYingTangXiang,431228208,9557,1508,6568,3499,13309,6440,2514,6791,13231,7011,13579
ƺ,ZhuPingPuXiang,431228209,6767,978,4885,2646,9330,4878,1794,4645,9523,4654,9539
,TuQiaoXiang,431228210,9997,1586,7070,4530,13847,6972,2782,7131,14103,7295,14365
ƺ,ShangPingXiang,431228211,6983,1227,4804,2656,10100,4781,1988,5306,10087,5394,10198
,DaShuAoXiang,431228212,5817,1002,4039,2229,8312,4008,1819,4501,8509,4599,8638
ɽ,DaHongShanXiang,431228213,3444,588,2349,1476,4860,2317,880,2519,4836,2563,4912
,YangGongMiaoXiang,431228214,5554,979,3894,2249,7775,3832,1592,4137,7969,4231,8125
Ϫ,LiXiKouXiang,431228215,6399,1065,4252,2466,8993,4242,1617,4777,9019,4829,9081
³,DongXiaChangXiang,431228216,5994,983,4120,2661,8445,4032,1627,4292,8324,4484,8604
,LuoYanXiang,431228217,1898,533,1462,1267,3072,1447,720,1647,3094,1689,3151
ɽ,BanShanXiang,431228218,2971,452,1974,1330,4314,1974,920,2369,4343,2369,4343
,DaLongXiang,431228219,4194,612,2813,1680,6000,2805,1290,3262,6067,3283,6096
,LiAoXiang,431228220,6268,1081,4512,2479,9213,4474,1990,4728,9202,4827,9339
ˮϪ,LengShuiXiXiang,431228221,7970,1338,5655,2917,11473,5623,2297,5907,11530,5950,11605
ľƺ,NanMuPingXiang,431228222,7905,1470,5552,3331,11430,5490,2323,6019,11509,6146,11698
ƺ,XiaoPingXiang,431228223,6807,1081,4715,2378,9506,4699,1693,4848,9547,4866,9581
޲,LuoBuTianXiang,431228224,5824,966,4068,2380,8331,4025,1585,4218,8243,4307,8375
,QuYangZhen,431229100,69470,7212,44965,27422,73326,44376,16095,45623,89999,47812,92777
,GanTangZhen,431229101,14568,2032,9566,5034,19143,9505,3015,9873,19378,10049,19615
,DaBuZiZhen,431229102,12014,1506,8122,4258,16758,8122,3410,8791,16913,8808,16930
,AoShangZhen,431229103,11850,1333,7584,4004,15645,7584,2718,8317,15901,8317,15901
³,XinChangZhen,431229104,13055,1782,8718,4615,17742,8716,3348,9386,18102,9467,18185
ƽ,PingChaZhen,431229105,6654,934,4453,2424,9126,4448,1763,4883,9331,4898,9351
̫ƺ,TaiYangPingXiang,431229200,9739,1179,6273,3321,12600,6178,2245,6500,12678,6890,13163
,SanQiaoXiang,431229201,4361,543,2776,1524,5901,2755,1071,3130,5885,3199,5975
Ϫ,WenXiXiang,431229202,6266,950,4242,2360,8763,4242,1632,4606,8848,4606,8848
կ,ZhaiYaXiang,431229203,5670,628,3097,1683,6254,3015,1154,3282,6297,4355,7452
Ὥ,HengJiangQiaoXiang,431229204,7406,869,4913,2422,10019,4803,1887,5085,9888,5249,10162
̿,PuKouXiang,431229205,10849,1452,6999,3426,14056,6972,2416,7468,14440,7718,14717
ź,OuTuanXiang,431229206,8599,1152,5734,2909,11834,5691,2289,6195,11886,6306,12040
˫,ShuangJiangZhen,431230100,28143,3003,19015,11241,28846,18238,6985,18337,36575,19116,38131
Ϫ,XianXiZhen,431230101,11976,1787,8497,4982,15699,8479,3379,8592,17071,8645,17142
,BoYangZhen,431230102,10029,1387,6920,3781,14177,6906,2982,7403,14309,7478,14398
ٿ,LinKouZhen,431230103,8507,1115,5669,2935,11229,5622,1993,5663,11285,5946,11615
ͱ,YaTunBaoZhen,431230104,12372,1430,8086,4579,16814,8081,3519,9206,17287,9235,17321
ݼ,JingWuZhouZhen,431230105,10587,1264,6891,3689,14052,6861,2561,7484,14345,7521,14412
Ϫ,XiKouZhen,431230106,6015,1051,4271,2613,8456,4197,1714,4379,8576,4509,8780
¤,LongChengZhen,431230107,6225,972,4246,2170,8521,4210,1708,4496,8706,4659,8905
,JiangKouXiang,431230200,4879,714,3222,1722,6589,3211,1112,3442,6653,3483,6705
,GeChongMiaoZuXiang,431230201,781,155,582,342,1155,578,244,581,1159,598,1180
ƺ,DaGaoPingMiaoZuXiang,431230203,2049,234,1430,700,3035,1419,786,1622,3041,1639,3069
,DuPoXiang,431230204,8588,1340,6284,3531,12930,6256,3139,6717,12973,6783,13067
ɼľ,ShaMuQiaoXiang,431230209,4697,519,2720,1427,5144,2578,926,2671,5249,3422,6142
ľ,MuJiaoXiang,431230210,2693,378,1792,1002,3596,1764,603,1839,3603,1882,3674
,XiaXiangXiang,431230211,5618,740,3698,1941,7491,3683,1393,3904,7587,4053,7751
,MaLongXiang,431230212,5128,683,3373,1723,6855,3346,1360,3613,6959,3798,7171
,ChuanSuYaoZuXiang,431230214,770,149,520,342,1102,520,201,598,1118,600,1120
,HuangTuXiang,431230215,2938,560,2009,1228,4280,2006,811,2281,4287,2300,4309
ƺ̹,PingTanXiang,431230216,5095,912,3630,1882,7452,3623,1490,3828,7451,3867,7497
ƺ,PingYangXiang,431230218,5266,834,3440,1656,6997,3398,1209,3627,7025,3869,7309
Ϫ,GanXiXiang,431230219,4673,786,3162,1762,6669,3162,1271,3568,6730,3568,6730
ͨصֳ,TongDaoXianDiLianLinChang,431230400,51,3,27,24,58,25,9,33,58,36,63
ͨزũ,TongDaoXianBoYangNongChang,431230401,108,20,85,61,156,85,32,75,160,75,160
ӱ·ֵ,HeBinLuJieDao,431281001,11414,1896,7664,5493,11349,7349,1821,7062,14411,7467,15131
佭·ֵ,YuanJiangLuJieDao,431281002,5532,1204,3690,2815,6110,3458,776,3420,6878,3822,7512
½ֵֽ,XinJieJieDao,431281003,12370,2141,8339,6467,11860,8289,1945,7943,16232,8117,16456
½ֵֽ,GaoPoJieJieDao,431281004,7524,1436,5250,3931,7779,5153,1283,4870,10023,4993,10243
ǭ,QianChengZhen,431281101,34939,3951,22734,14830,33203,21609,7290,21907,43516,23446,46180
,AnJiangZhen,431281102,58923,6756,36820,24802,46140,31599,9016,31814,63413,37875,74695
п,TuoKouZhen,431281103,17667,2711,12192,8040,23353,12068,4304,11801,23869,12490,24682
ѩ,XueFengZhen,431281104,11808,1885,7824,4692,15596,7669,2314,7956,15625,8183,16007
˫Ϫ,ShuangXiZhen,431281105,13587,2082,9055,5207,17388,8958,2801,9366,18324,9415,18470
,JiangShiZhen,431281106,12447,2275,8562,5474,16915,8537,2980,8802,17339,9140,17702
,YuanHeZhen,431281107,6516,1285,4572,3020,9112,4570,1558,4767,9337,4787,9359
,TangWanZhen,431281108,8344,1409,5662,3358,10904,5614,2033,5837,11451,6124,11786
,XiaZhouXiang,431281200,18424,2967,12603,7540,24445,12583,3516,12272,24855,12304,24907
,LongTianXiang,431281201,12013,1917,7889,4542,15756,7855,2198,8185,16040,8239,16128
ͷ,ChaTouXiang,431281202,8579,1661,5678,3484,11551,5621,1557,5998,11619,6119,11797
é,MaoDuXiang,431281203,5095,982,3418,2101,6844,3418,954,3613,7031,3613,7031
,DaChongXiang,431281204,7715,1185,4991,2940,10204,4983,1346,5237,10220,5255,10246
ƺ,ShuPingXiang,431281205,8745,1639,5765,3769,11793,5762,1594,6202,11964,6213,11978
ɽ,TieShanXiang,431281206,6755,1203,4472,2781,9087,4387,1260,4609,8996,4746,9218
Ⱥ,QunFengXiang,431281207,5713,1127,3974,2753,8212,3938,1381,4148,8086,4247,8221
Ϫ,WanXiXiang,431281208,5306,1088,3601,2343,7270,3592,1257,3957,7549,4050,7651
ϴ,XiMaXiang,431281209,8893,1874,6531,4363,12761,6497,2469,6654,13151,6705,13236
ɳ,ShaWanXiang,431281211,11435,2431,8214,5178,15826,8214,2440,8073,16287,8092,16306
,ShenDuMiaoZuXiang,431281212,5549,1117,3957,2798,7999,3957,1468,4177,8134,4177,8134
,LongChuanTangYaoZuXiang,431281213,4125,894,2935,2141,5937,2933,1087,3170,6103,3171,6106
̫ƽ,TaiPingXiang,431281214,9517,1722,6467,3692,12854,6399,1918,6563,12962,6690,13157
Ϫ,TuXiXiang,431281215,4738,861,3157,1746,6465,3103,1008,3336,6439,3450,6607
,HongYanXiang,431281216,6570,1101,4352,2733,8686,4334,1418,4640,8974,4737,9089
,YanLongXiang,431281217,10192,1804,6971,4507,13648,6946,2347,7197,14143,7372,14343
,HengYanXiang,431281218,2438,361,1697,998,2997,1642,548,1528,3170,1650,3347
,ChangQingXiang,431281219,3101,504,2071,1370,3550,2068,536,2004,4072,2070,4141
԰,GuiHuaYuanXiang,431281220,6057,963,4144,2596,7746,4143,1110,3986,8129,3986,8130
ƺֵ,LePingJieDao,431302001,72463,4911,48090,27824,47761,38296,15242,37828,76124,44526,92616
ɽֵ,HuaShanJieDao,431302002,35447,2724,22770,15659,25434,22018,8955,23440,45458,24356,47126
ֵ,HuangNiTangJieDao,431302003,47914,5142,29486,21430,48347,27515,9415,28957,56472,32985,62471
ֵ,ChangQingJieDao,431302004,63322,5463,38769,27052,41411,37343,14061,38218,75561,44077,82846
ƽֵ,DaKeJieDao,431302005,37399,2290,22784,9433,22362,13784,5547,13905,27689,22452,45236
ֵ´,LianBinJieDaoBanShiChu,431302006,28496,1659,18229,11574,21908,17306,7514,18221,35527,19440,37669
Žֵ´,DaBuQiaoJieDaoBanShiChu,431302007,13588,2478,10124,6239,18411,10090,3658,9463,19553,9600,19724
ɼɽ,ShanShanZhen,431302100,12779,2067,8732,6400,16763,8665,2892,8807,17472,9006,17738
,WanBaoZhen,431302101,14286,2483,10157,5424,19573,10113,3712,10217,20330,10324,20481
԰,ChaYuanZhen,431302103,10401,2056,7387,6156,14389,7304,2724,7501,14805,7794,15181
Ķ,BaiMuXiang,431302202,9322,1416,6337,3688,12046,6225,2232,6394,12619,6633,12970
С,XiaoBiXiang,431302203,9699,1480,6609,4103,12651,6463,2536,6811,13274,7106,13715
˫,ShuangJiangXiang,431302204,9043,1811,6589,4260,13325,6584,2802,7040,13624,7067,13656
ʯ,ShiJingXiang,431302205,10595,1959,7378,5693,13867,7330,2761,7761,15091,7937,15315
,YongFengZhen,431321100,67769,8334,44862,26886,75714,40878,14862,41648,82526,46103,90965
Ҷ,HeYeZhen,431321101,33451,5572,23103,12064,46764,22869,8944,24223,47092,24864,47967
,JingZiZhen,431321102,23344,3731,15906,8654,32113,15462,5812,16046,31508,16981,32887
,ZiMenQiaoZhen,431321103,45273,6699,29526,16011,60627,28926,9935,30624,59550,32381,61907
,XingZiPuZhen,431321104,47514,7404,32304,17940,64154,31102,11610,32810,63912,34224,66528
,ZouMaJieZhen,431321105,45641,6625,31448,16900,63566,31206,12564,32978,64184,33382,64830
ɽ,SheXingShanZhen,431321106,42692,6521,28954,18043,56493,28832,10916,30716,59548,31175,60129
ɽ,HongShanDianZhen,431321107,30843,4872,21020,12760,42277,20704,7924,21680,42384,22619,43639
,GanTangZhen,431321108,52030,7671,35490,19585,73444,35129,14433,38053,73182,38644,74134
,SanTangPuZhen,431321109,26831,3889,18280,10567,35625,18155,7329,19303,37458,19769,38049
ƺ,QingShuPingZhen,431321110,45923,5988,30963,18272,59997,30142,11505,31528,61670,32453,63416
,HuaMenZhen,431321111,40185,5934,27147,14948,56853,26816,11427,29305,56121,30399,57546
ʯ,SuoShiZhen,431321112,22461,3355,15457,8491,31147,15159,6273,16172,31331,16632,32089
ʯţ,ShiNiuXiang,431321200,30751,4447,20772,10682,42717,20454,8036,21749,42203,22462,43234
ɳ,ShaTangXiang,431321201,20653,2968,13925,7585,28311,13745,5156,14462,28207,14852,28777
ӡ,YinTangXiang,431321202,26679,3996,18328,11049,36954,17976,6961,18681,36657,19308,37636
ÿ,JingJiKaiFaQu,431321400,7965,672,5519,2631,5634,3846,1699,3894,7740,4817,10336
÷,ShangMeiZhen,431322100,87869,9607,59698,35468,88353,56955,21953,56927,113882,59731,119429
ʯ,ShiChongKouZhen,431322101,34880,4641,23517,13934,48122,23191,9666,24967,48158,25670,49187
Ϫ,YangXiZhen,431322102,39240,6062,27957,16177,55476,27605,12481,29227,56832,29826,57783
Ϫ,ChaXiZhen,431322103,15974,2831,11666,7249,24039,11618,5491,12399,24017,12630,24296
ˮ,ShuiCheZhen,431322104,17856,3232,13682,8608,27195,13446,6843,13856,27302,14249,27931
,WenTianZhen,431322105,13484,1986,9259,5671,19019,9158,4205,10027,19185,10416,19675
,FengJiaZhen,431322106,11867,2171,8583,5522,17107,8572,3445,8880,17452,8900,17483
¯,LuGuanZhen,431322107,42546,5073,28307,14772,57055,28263,11225,30364,58627,30537,58844
μ,YouJiaZhen,431322108,37976,6190,26832,14791,53297,26800,11320,28579,55379,28654,55486
,XiHeZhen,431322109,40055,5382,26577,15234,53791,26419,9854,28106,54525,28714,55291
Ϲ,MengGongZhen,431322110,42558,6124,28717,15046,58225,27470,11525,29466,56936,31490,60207
,LangTangZhen,431322111,31621,5016,23074,12453,43245,22348,9627,22207,44555,23190,46264
Ϫ,BaiXiZhen,431322112,33751,6487,25524,15595,50544,25478,11206,25848,51326,25920,51444
,ZhenShangZhen,431322113,31865,5917,23217,13583,46523,23179,9636,24082,47261,24201,47418
,JiQingZhen,431322114,25558,4989,19105,11369,38154,19040,8588,19920,38960,20030,39135
,WenTangZhen,431322115,35356,5529,24570,13920,48862,24286,11325,26863,51149,27640,52210
ƺ,TianPingZhen,431322116,21072,4076,14938,8496,30350,14891,5962,16007,30898,16172,31110
ɣ,SangZiZhen,431322117,36792,5056,24534,13431,49724,24196,9734,26467,50663,27048,51582
ܼ,CaoJiaZhen,431322118,34529,5481,24169,12706,49007,23778,10641,26037,49815,26482,50651
ͷ,KeTouXiang,431322200,21716,3161,15169,8861,30939,14847,6375,15373,30220,16083,31252
άɽ,WeiShanXiang,431322201,16770,2883,12662,7341,25004,12640,6152,13088,25728,13143,25805
,TianMenXiang,431322202,6527,1207,4608,2986,9286,4498,1908,4728,9226,5034,9642
ٻ,RongHuaXiang,431322203,13865,2367,10079,5667,20220,9678,4524,10030,19708,10677,20756
,JinFengXiang,431322204,8990,1560,6251,4012,12345,6206,2541,6698,12904,6840,13091
Ϫ,YouXiXiang,431322205,17515,2890,12728,6705,25491,12595,5768,13162,25757,13445,26173
ʯ,ZuoShiXiang,431322206,14632,2671,10547,6000,21895,10534,4976,11708,22242,11732,22279
϶ɰ´,ShangDuBanShiChu,431322450,30912,2084,19381,10364,21232,16214,7126,16304,32518,20741,40122
ɽֳ,DaXiongShanGuoYouLinChang,431322500,2265,492,1637,1244,3378,1604,650,1689,3293,1770,3407
̨ɽֳ,GuTaiShanGuoYouLinChang,431322501,2319,329,1484,937,3075,1484,559,1723,3207,1723,3207
ˮֵ,LengShuiJiangJieDao,431381001,72470,6755,47857,31173,59301,45268,16344,44751,90019,47712,95569
ɽֵ,XiKuangShanJieDao,431381002,6286,1212,4457,3345,5531,4317,1503,4432,8749,4544,9001
ɳֵ,ShaTangWanJieDao,431381003,8771,1073,5913,3312,9169,5562,2130,5719,11281,6061,11974
Ϫֵ,BuXiJieDao,431381004,18110,1367,11696,7979,9285,11598,4491,11954,23552,12272,23968
,HeQingZhen,431381100,16742,2208,11321,7166,19446,11027,4299,11084,22111,11928,23249
ҿ,YanKouZhen,431381101,12898,1646,8455,6071,14828,8403,3576,9195,17598,9665,18120
,ZhaDuZhen,431381102,9370,1377,6471,4370,12643,6455,2786,7027,13482,7062,13533
ɽ,DuoShanZhen,431381103,14487,1963,9751,6518,18302,9735,4235,10699,20434,10934,20685
ë,MaoYiZhen,431381104,8587,1030,5840,3527,10305,5781,2403,6047,11828,6180,12020
,SanJianZhen,431381105,9902,1614,7137,4326,14067,7123,3370,7716,14839,7749,14886
ɽ,JinZhuShanXiang,431381106,12328,1863,8470,5996,15445,8421,3277,8893,17314,8998,17468
,PanQiaoXiang,431381200,8986,1503,6301,3887,11673,6019,2398,6237,12256,6586,12887
,ZiLongXiang,431381203,5621,881,3736,2566,6972,3668,1586,3925,7593,4352,8088
ɽ,KuangShanXiang,431381204,8641,1223,5762,3536,11467,5762,2287,6389,12151,6389,12151
,ZhongLianXiang,431381205,15665,1933,9788,6515,17942,9472,3383,10072,19544,11193,20981
ͬ,TongXingXiang,431381206,9260,933,6158,4058,8984,6143,2373,6393,12536,6408,12566
ֵ,LanTianJieDao,431382001,60136,6117,40178,25426,57584,37462,15430,38632,76094,41505,81683
Ķ,LiuMuTangZhen,431382100,40702,5306,27957,17556,50706,27161,11943,28749,55910,29994,57951
ʯɽ,ShiMaShanZhen,431382101,49658,6684,33166,18921,60879,31833,12537,33263,65096,35713,68879
ƽ,AnPingZhen,431382102,27157,5369,19597,11759,38648,17497,8341,18889,36386,21270,40867
ؽ,MeiJiangZhen,431382103,30808,4739,21796,13359,44207,21628,9665,23068,44696,23416,45212
,FuKouZhen,431382104,35773,5578,25545,15623,50736,25169,11893,26864,52033,27699,53244
ͷ,QiaoTouHeZhen,431382105,66729,9943,47068,28439,93686,45919,19607,47729,93648,49211,96279
ǽ,QiXingJieZhen,431382106,46206,7517,33369,20365,66458,33289,14958,35217,68506,35312,68681
,YangShiZhen,431382107,49753,7127,34025,18943,67740,33259,13325,35045,68304,36180,70205
ƺ,FengPingZhen,431382108,15479,2545,10753,6731,21620,10469,4508,11226,21695,11779,22532
ɽ,DouLiShanZhen,431382109,33319,5094,22336,15670,45065,22195,9390,24496,46691,25467,47803
ˮ,ShuiDongDiZhen,431382110,28648,4909,19629,11831,40202,19574,7386,21078,40652,21314,40943
,BaiMaZhen,431382111,24530,4150,16896,9010,35549,16444,7104,17984,34428,18888,35784
é,MaoTangZhen,431382112,14817,2966,11046,6160,20785,10690,4785,11048,21738,11522,22568
,HeTangZhen,431382113,27867,5008,20670,11874,40659,19948,9531,20701,40649,21736,42406
ʯ,JinShiZhen,431382114,34553,5937,24445,15209,49360,24430,10301,26306,50736,26346,50791
,LongTangZhen,431382115,44555,6708,30872,18712,63531,30422,13250,32894,63316,33641,64513
ͷ,DuTouTangZhen,431382116,20351,3397,14111,8466,28756,14035,5656,15020,29055,15293,29404
,SanJiaXiang,431382200,25926,4375,18799,12378,37369,18649,8357,19627,38276,19859,38658
,GuTangXiang,431382202,11523,2035,8115,4923,16975,8053,3554,8869,16922,8997,17112
Ἲӽֵ´,DongHeJieDaoBanShiChu,433101002,53030,4858,35035,20414,39935,29829,10357,29978,59807,33210,68245
Ǭݽֵ´,QianZhouJieDaoBanShiChu,433101004,39130,3656,25283,13643,33698,22490,8052,22284,44774,25555,50838
Ϫֵ´,ZhenXiJieDaoBanShiChu,433101005,78153,6788,48567,26765,58803,39129,12903,39079,78208,49277,97844
կ,AiZhaiZhen,433101100,7342,1392,5564,3419,10995,5502,2677,5691,11193,5847,11411
�,MaJingAoZhen,433101101,9851,1716,7145,4082,13898,7107,3099,7488,14595,7521,14666
Ϫ,HeXiZhen,433101102,6151,1126,4491,2444,8426,4462,1754,4464,8926,4540,9031
˫,ShuangTangZhen,433101103,6157,1265,4602,2665,8934,4567,1944,4668,9235,4764,9366
,DanQingZhen,433101104,2064,624,1609,1295,3263,1609,698,1777,3386,1777,3386
կ,ZhaiYangXiang,433101200,6233,1064,4320,2371,8166,4289,1669,4344,8633,4646,8966
,YiLveXiang,433101201,3285,814,2448,1605,4860,2444,944,2578,5022,2595,5043
,SheTangPoXiang,433101202,4501,957,3247,2002,6633,3246,1320,3527,6773,3531,6778
̫ƽ,TaiPingXiang,433101203,1998,584,1527,1057,3127,1517,642,1677,3194,1697,3224
,BaiYanXiang,433101204,4156,937,3005,2022,6043,2997,1241,3298,6295,3329,6334
ų,PaiChouXiang,433101205,2183,666,1944,1378,3685,1931,1060,1947,3878,1965,3909
ź,PaiHouXiang,433101206,1820,586,1443,1155,2910,1439,618,1565,3004,1581,3024
ɳ,BaiShaZhen,433122100,29933,2939,19844,12433,28723,18681,7403,19423,38104,20431,40275
,DaLanZhen,433122102,10939,1625,7510,3501,15185,7487,3026,8044,15531,8080,15590
¡,XingLongChangZhen,433122104,12880,1940,9343,4314,18438,9304,4127,9472,18776,9604,18947
̶Ϫ,TanXiZhen,433122105,10811,1603,7721,3862,15261,7604,3419,7847,15451,8112,15833
ϴϪ,XiXiZhen,433122106,7994,1166,5501,2831,10770,5443,2058,5576,11019,5717,11218
Ϫ,WuXiZhen,433122107,19064,2196,13304,7357,22122,13080,5344,12937,26017,13300,26604
,PuShiZhen,433122108,36613,5046,25385,13102,48733,24816,9631,25425,50241,25905,51290
ˮ,HeShuiZhen,433122109,15391,2217,11161,5050,22645,10927,5291,11376,22303,11738,22899
ʯƺ,ShiLiuPingXiang,433122203,8422,1346,6104,2842,12084,6080,2630,6252,12332,6294,12398
˳,YongXingChangXiang,433122205,7033,1155,5247,2503,10409,5152,2611,5381,10533,5552,10799
,JieFangYanXiang,433122206,8715,1384,6071,2709,12165,6042,2423,6373,12415,6451,12522
С,XiaoZhangXiang,433122207,6163,1075,4593,2284,9450,4587,2374,5000,9587,5019,9612
Ϫ,BaiYangXiXiang,433122208,5617,940,4198,1981,8220,4175,2028,4368,8543,4387,8585
̶,LiangJiaTanXiang,433122209,6998,953,4710,2374,9695,4679,1914,5094,9773,5155,9865
ʲƺ,BaShenPingXiang,433122210,6183,891,4090,1815,8381,4031,1366,4214,8245,4350,8440
ֳͤ,JunTingJieLinChang,433122400,368,42,231,115,440,215,83,227,442,262,493
μ,LiaoJiaQiaoZhen,433123101,13215,1552,8600,4312,16538,8086,3037,8724,16810,9204,17804
,ChaTianZhen,433123104,7970,1314,5405,3338,11069,5395,2115,5942,11337,5994,11399
,JiXinZhen,433123105,14316,1934,9792,5106,19428,9738,4049,10187,19925,10507,20299
ɽ,LaErShanZhen,433123107,11232,1431,7808,3751,15773,7757,3701,8464,16221,8556,16364
̿,HeKuZhen,433123108,8936,1226,6487,3197,12856,6471,3237,6904,13375,6912,13399
,DuoJiangZhen,433123109,52038,5554,34443,19128,47656,32569,11690,32846,65415,34839,69282
Ӫ,ALaYingZhen,433123110,17845,2284,11738,6334,22760,11653,4375,12406,24059,12766,24504
ľƺ,MuJiangPingZhen,433123111,11054,1906,7950,4429,16041,7947,3596,8586,16533,8606,16556
ɽ,ShanJiangZhen,433123112,9870,1451,6664,3630,13938,6625,2959,7525,14150,7616,14280
ׯ,GuanZhuangXiang,433123202,5879,1004,4126,2210,8029,4082,1563,4121,8203,4320,8446
ˮ,ShuiDaTianXiang,433123204,6258,919,4180,2432,8586,4168,1669,4638,8806,4666,8846
ַ,LinFengXiang,433123205,6294,941,4297,2460,8615,4294,1636,4573,8867,4574,8871
,DouLiXiang,433123206,5966,900,4099,2291,8050,4077,1777,4428,8505,4544,8643
䳱,LuoChaoJingXiang,433123207,8719,1112,5879,2878,11268,5812,2250,6051,11863,6202,12081
³,XinChangXiang,433123208,7778,1197,5261,2797,10609,5176,1997,5560,10736,5711,10972
,CiYanXiang,433123209,6906,1066,4756,2574,9505,4749,1822,4999,9748,5038,9794
,SanGongQiaoXiang,433123212,8019,1269,5929,3173,11604,5926,2853,6183,12109,6212,12141
ƺ,GanZiPingXiang,433123213,7174,922,4762,2406,9027,4636,1795,4661,9297,5129,9891
,MaChongXiang,433123216,5948,860,4077,1985,8323,4013,1646,4268,8281,4377,8454
ǧƺ,QianGongPingXiang,433123218,8175,1162,5535,3014,11530,5534,2485,6272,11806,6287,11822
ľ,MuLiXiang,433123219,6521,881,4573,2318,9471,4545,2198,4978,9523,5027,9600
,LiangLinXiang,433123220,7678,1031,5595,2689,11108,5569,2945,6009,11578,6059,11654
,LiuBaoXiang,433123221,4820,648,3354,1854,6830,3348,1885,3997,7345,3999,7353
,MiLiangXiang,433123222,2773,420,2050,1054,4133,2039,1166,2277,4316,2309,4359
̶,LongTanZhen,433124102,9916,1409,7112,3336,12881,6814,3274,6964,13778,7487,14599
,MinYueZhen,433124103,10891,1301,7696,3312,13188,7241,3547,7283,14524,8043,15739
Ž,TuanJieZhen,433124104,13333,1731,9374,4523,17338,9237,4214,9577,18814,9904,19278
,JiWeiZhen,433124105,10294,1589,7678,3532,14728,7568,3848,7919,15487,8053,15731
,MaLiChangZhen,433124106,9063,1430,6686,3351,13191,6631,3147,6877,13508,6954,13640
,YaYouZhen,433124107,5119,763,3468,1709,6976,3443,1524,3791,7234,3938,7406
߳,BianChengZhen,433124108,14652,2242,10542,5334,20337,10467,4966,11187,21654,11318,21860
ԫ,HuaYuanZhen,433124109,59896,5915,39513,19359,62660,37563,15388,37786,75349,41686,81199
,ChangLeXiang,433124200,9014,1270,6209,3040,12204,6027,2632,6480,12507,6707,12916
,LiangHeXiang,433124202,6630,1105,4853,2191,9345,4850,2174,5056,9906,5056,9909
ű,PaiBiXiang,433124204,5853,923,4299,2019,8326,4249,1936,4324,8573,4413,8712
,DongMaKuXiang,433124205,6669,967,4769,2441,9462,4719,2334,5083,9802,5201,9970
è,MaoErXiang,433124206,9347,1214,6851,3118,12700,6789,3372,6975,13764,7082,13933
,DaoErXiang,433124209,6809,1028,4837,2381,9244,4704,2062,4879,9583,5062,9899
,PaiWuXiang,433124210,5622,845,3921,1888,7510,3874,2002,4227,8101,4548,8469
,PaiLiaoXiang,433124211,3781,628,2547,1388,5260,2535,964,2800,5335,2826,5373
,YaQiaoXiang,433124212,5111,777,3711,1810,6762,3682,1774,3915,7597,3951,7662
,BuChouXiang,433124213,8331,1331,5729,2890,11751,5717,2624,6536,12253,6557,12286
,PuRongZhen,433125104,8865,1258,5877,2824,12085,5836,2133,6320,12156,6379,12256
Ұƺ,YeZhuPingZhen,433125107,6202,858,4269,2163,8763,4102,2011,4528,8630,4802,9071
,FuXingZhen,433125108,11338,1513,7516,3422,14066,7126,2810,7347,14473,8145,15661
Ǩ,QianLingZhen,433125109,45566,5906,31194,16939,50394,27717,11931,28407,56124,32209,63403
ˮƺ,QingShuiPingZhen,433125110,15093,2096,10451,5425,21021,10446,4511,11238,21684,11249,21700
ȶ,BiErZhen,433125111,9663,1626,6902,3309,13709,6817,2609,6859,13676,6996,13898
ë,MaoGouZhen,433125112,18286,2617,12443,6279,26133,12264,5529,13615,25879,13989,26432
ˮ,ShuiTianHeZhen,433125113,13565,2025,9432,4582,18525,9360,4001,10058,19418,10159,19591
«,HuLuZhen,433125114,11022,1667,7167,3832,14760,7032,2547,7776,14808,8069,15236
,WanMiPoZhen,433125115,13592,2317,9244,4592,18961,8623,3398,9412,18035,10063,19307
ˮ,ShuiYinXiang,433125202,5711,930,3899,1900,7759,3870,1442,4135,8005,4184,8083
Ϳէ,TuZhaXiang,433125203,4823,874,3223,1734,6816,3128,1161,3505,6633,3635,6858
,DaTuoXiang,433125205,12013,1702,8060,3935,15896,7962,3098,8446,16408,8753,16813
ɳ,BenShaXiang,433125210,3442,662,2519,1422,4897,2431,1142,2624,5055,2727,5246
ˮ,QingShuiXiang,433125215,5377,874,3608,1853,6987,3532,1315,3735,7267,3958,7566
,YangChaoXiang,433125217,11834,1838,7817,3731,16153,7446,2965,8284,15730,8820,16637
⳯,BianChaoMuChang,433125401,158,24,115,25,211,57,31,49,106,98,213
ɽũѳ,BaiYunShanNongKenChang,433125403,48,9,41,24,71,41,17,32,73,33,74
ɽҵ԰,ZhongLingShanGongYeYuan,433125404,122,0,41,32,0,31,2,35,66,83,124
,MaFengCun,433125405,0,0,0,0,0,0,0,0,0,0,0
,GuYangZhen,433126101,22018,2351,14882,8314,21333,13768,5576,13794,27562,15063,29945
Ϫ,LuoYiXiZhen,433126102,7143,1044,4885,2435,9346,4806,1813,4927,9733,5115,10000
ͷկ,YanTouZhaiZhen,433126103,8743,1446,5511,2946,11453,5452,1860,6380,11832,6538,12049
Ĭ,MoRongZhen,433126104,9472,1378,6256,3221,12614,6242,2195,6754,12996,6789,13045
ʯ,HongShiLinZhen,433126105,8235,1184,5522,3029,10839,5483,2271,6062,11545,6168,11690
ɽ,DuanLongShanXiang,433126200,8556,1296,6021,2819,12028,5965,2621,6340,12305,6452,12473
߷,GaoFengXiang,433126202,5280,947,3661,1757,7358,3643,1426,3965,7608,3992,7653
,HePengXiang,433126205,3968,635,2592,1327,5241,2553,849,2782,5335,2860,5452
ƺ,PingBaXiang,433126206,7083,1061,4646,2321,9450,4645,1787,5271,9916,5285,9931
ɽ,ShanZaoXiang,433126207,3676,599,2389,1253,4934,2369,896,2744,5113,2782,5171
˫Ϫ,ShuangXiXiang,433126208,4998,829,3284,1688,6591,3282,1062,3571,6853,3605,6889
,GaoWangJieXiang,433126212,2230,339,1401,833,2757,1399,430,1511,2910,1598,2999
׳,ShouCheZhen,433127101,6336,1190,4614,2397,9458,4586,2057,4885,9471,4969,9583
ܽ,FuRongZhen,433127103,16002,2126,10679,5971,21437,10583,4133,11468,22051,11582,22261
ï,YongMaoZhen,433127104,4862,740,3399,1995,6742,3323,1554,3607,6930,3757,7156
,ZhangGuanZhen,433127108,3502,603,2494,1629,4833,2490,1033,2607,5097,2644,5138
ƺ,QingPingZhen,433127109,7079,969,4564,2572,9298,4493,1933,4927,9420,5417,9981
,ZeJiaZhen,433127111,10661,1622,7362,3746,14781,7209,3090,7709,14918,8011,15373
ʯ,ShiDiZhen,433127112,25156,3820,17697,9256,35006,17188,8379,18396,35584,19658,37355
ƺ,WanPingZhen,433127113,14240,2718,10479,6250,20952,10350,4571,10925,21275,11050,21529
,TaWoZhen,433127114,19512,3074,14659,6872,28857,14521,6895,14609,29130,14822,29481
ɰ,ShaBaZhen,433127115,12438,2201,9374,4779,18741,9212,4476,9401,18613,9741,19115
Ϫ,LingXiZhen,433127116,60399,6480,42935,23441,60754,40500,19228,41105,81605,43172,86107
ɰ,SongBaiZhen,433127117,11277,1793,8103,4507,16967,7907,4060,8779,16686,9027,17130
,LiangChaXiang,433127200,6632,1080,4658,2154,9705,4609,2214,5131,9740,5268,9926
׹,ShaoHaXiang,433127201,8263,1383,6054,3126,11813,5975,2666,6154,12129,6258,12312
,XiQiXiang,433127202,4986,955,3814,2122,7745,3792,1881,3951,7743,4008,7822
ɽ,DuiShanXiang,433127203,3473,841,2795,1593,5627,2761,1412,2828,5589,2931,5726
Ϧ,LieXiXiang,433127206,3827,807,2942,1710,5817,2933,1407,3038,5971,3099,6041
ƺ,GaoPingXiang,433127210,8111,1382,5883,3074,12029,5689,2696,6046,11735,6306,12189
,HuiLongXiang,433127212,4087,813,3014,1967,6172,3004,1489,3298,6302,3375,6389
СϪ,XiaoXiXiang,433127214,3512,675,2459,1512,5112,2445,951,2613,5058,2679,5138
Ϫ,LangXiXiang,433127216,3130,505,2137,1247,4436,2131,955,2433,4564,2453,4590
,RunYaXiang,433127220,3673,769,2789,1763,5551,2788,1364,3015,5803,3017,5806
ƺ,ChePingXiang,433127222,6609,1031,4920,2592,9826,4857,2481,5050,9907,5201,10121
ë,MaoBaXiang,433127228,5890,1254,4564,2509,9214,4504,2200,4690,9194,4780,9344
,WanMinXiang,433127229,5403,1223,3959,2676,7857,3951,1610,4223,8174,4277,8236
ξ,YanJingXiang,433127230,3569,678,2636,1414,5330,2631,1307,2892,5523,2918,5554
־,FuZhiXiang,433127233,5401,879,3636,2093,7429,3550,1433,3862,7412,4077,7713
,DiaoJingXiang,433127235,6108,1080,4327,2449,8695,4273,1850,4613,8886,4711,9038
,DaBaXiang,433127237,6719,1186,4961,2623,9629,4876,2199,4987,9863,5143,10104
ɰ,KeShaXiang,433127238,8405,1498,6515,3408,13109,6449,3511,6775,13224,6899,13414
񰲽ֵ´,MinAnJieDaoBanShiChu,433130001,64109,5275,44023,24412,65299,40724,17770,40293,81017,43131,87154
ֵ´,HuaTangJieDaoBanShiChu,433130002,13223,1317,9084,4222,16563,8944,3416,8596,17540,8872,17956
³ǽֵ´,XinChengJieDaoBanShiChu,433130003,11017,1169,7651,3645,13439,7643,2953,7441,15084,7488,15139
ʯ,ShiGaoZhen,433130101,16684,2110,11681,5709,22905,11559,4638,11556,23115,11751,23432
ϴ,XiCheHeZhen,433130104,5213,1258,4026,2563,7982,3970,1780,4053,8023,4225,8251
¡ͷ,LongTouZhen,433130106,3932,822,2757,1712,5731,2735,1113,3029,5764,3110,5867
ʯ,ShiPaiZhen,433130110,9163,1309,6646,3449,13054,6574,2800,6535,13109,6626,13272
,CiYanTangZhen,433130112,12977,1772,8554,4776,17220,8497,2973,9033,17530,9168,17722
Ϫ,HongYanXiZhen,433130113,13541,2086,9647,5559,19944,9537,4432,9904,19441,10412,20059
巿,DianFangZhen,433130114,7784,1348,5648,3275,11318,5602,2442,5823,11425,5926,11574
̲,MiaoErTanZhen,433130115,10389,1926,7648,4348,15214,7630,3063,7640,15270,7730,15378
Ү,LiYeZhen,433130116,20631,2642,14472,7764,29114,14459,6262,15011,29470,15063,29535
,GuiTangZhen,433130117,12053,1461,8549,4265,17328,8497,4132,9001,17498,9097,17646
,ZhaoShiZhen,433130118,19061,2409,13698,6757,27815,13395,6571,13819,27214,14343,28041
,LuoTaXiang,433130200,8089,1423,5769,3309,11640,5715,2504,6035,11750,6247,12016
ϴ,XiLuoXiang,433130203,9008,1297,6387,3524,13005,6378,3012,6905,13283,6930,13317
,WanTangXiang,433130204,5798,700,4340,2389,8547,4310,2146,4232,8542,4304,8644
,BaiYangXiang,433130205,6858,817,4682,2738,9561,4682,1974,4966,9648,4967,9649
¡,XingLongJieXiang,433130206,9390,1307,6154,3309,12984,6151,2569,7110,13261,7112,13266
Ԫ,SanYuanXiang,433130207,8372,1271,6091,3235,12352,6041,2783,6203,12244,6335,12426
Ͱ,TongCheXiang,433130208,7498,1311,5480,3607,11467,5480,2828,6155,11635,6157,11637
,DaAnXiang,433130210,4054,743,2765,1647,5723,2744,1004,2958,5702,3036,5801
ˮ,ShuiTianBaXiang,433130211,9197,1247,5910,3097,12541,5877,2178,6587,12464,6712,12622
ѻ,WuYaXiang,433130212,2476,464,1756,1012,3539,1738,674,1811,3549,1858,3614
ͱ,MengBiXiang,433130213,2671,465,1806,994,3692,1799,653,1958,3757,1983,3789
ɰ,TaShaXiang,433130218,5615,937,4120,2218,8257,4075,1749,4066,8141,4181,8301
Ϫ,NeiXiXiang,433130220,9346,1240,6498,3245,13329,6475,2952,7003,13478,7040,13538
,JiaShiXiang,433130223,7073,846,4654,2467,9668,4636,1838,5035,9671,5103,9757
,TaNiXiang,433130231,3813,630,2785,1488,5619,2777,1235,2865,5642,2893,5678
ũ,NongCheXiang,433130232,6317,1038,4511,2570,8996,4509,1849,4690,9199,4693,9204
,LaoXingXiang,433130234,4930,797,3673,1804,7461,3673,1762,3816,7489,3816,7489
ְ,JiaBaXiang,433130235,5762,755,4264,2005,8497,4247,2074,4259,8506,4327,8591
۹,ZanGuoXiang,433130236,7411,752,4826,2401,10258,4781,2129,5350,10131,5466,10292
éƺ,MaoPingXiang,433130237,7295,1170,5518,2948,10766,5512,2468,5388,10900,5415,10933
ɳֵ,ShaMianJieDao,440103001,2618,439,1698,1152,2174,1586,340,1439,3025,1699,3397
Ͻֵ,LingNanJieDao,440103002,21685,3772,13662,10283,17472,12717,2103,12541,25258,13898,27560
ֵֽ,HuaLinJieDao,440103003,36404,5614,23514,16739,26753,21869,4291,21104,42973,22795,46309
౦ֵ,DuoBaoJieDao,440103004,25313,4206,16012,12079,21238,15320,3062,15049,30369,16569,32581
ֵ,ChangHuaJieDao,440103005,25181,4406,16677,11607,22391,15906,3191,15351,31257,16101,32778
Դֵ,FengYuanJieDao,440103006,45771,7517,29807,22507,37087,29103,6049,28486,57589,29530,59337
ֵ,LongJinJieDao,440103007,34171,5596,22055,16354,28346,20737,3751,20157,40894,21463,43518
𻨽ֵ,JinHuaJieDao,440103008,42648,7029,28241,19490,34810,27016,4993,24937,51953,26429,54670
ʺֵ,CaiHongJieDao,440103009,42569,6480,27838,17696,31084,26228,5299,24723,50951,26510,54348
Դֵ,NanYuanJieDao,440103010,53890,7762,35035,24065,44649,33928,8414,33394,67322,35031,70066
ֵ,XiCunJieDao,440103011,36241,4851,21543,13742,27527,18994,3977,18358,37352,23526,45069
վǰֵ,ZhanQianJieDao,440103012,21435,3664,13252,9031,16090,11912,2332,12168,24080,14179,27431
нֵ,QiaoZhongJieDao,440103013,27302,1418,14571,7637,7103,9214,2923,9771,18985,17072,31643
׺׶ֵ,BaiHeDongJieDao,440103014,38649,5173,22593,13862,24924,18332,4416,18791,37123,25645,48238
ڽֵ,ChongKouJieDao,440103015,39134,4216,22935,17297,23921,21198,4747,22040,43238,25162,48097
ؽֵ,HuaDiJieDao,440103016,30743,4902,19755,13598,21205,18314,3990,18008,36322,19880,39635
ʯΧֵ,ShiWeiTangJieDao,440103017,45791,5102,28520,19810,25311,26353,6299,26466,52819,28672,57192
ֵ,ChaJiaoJieDao,440103018,43504,4805,27371,17841,25490,25662,6609,25079,50741,27547,54918
]ֵ,DongJiaoJieDao,440103019,28799,2630,17684,11751,14434,15975,4460,15678,31653,18205,35889
ֵ,HaiLongJieDao,440103020,27192,1261,14261,8188,11466,11210,3348,11893,23103,17540,31801
ɳֵ,DongShaJieDao,440103021,23524,2278,13209,9571,14962,12244,3211,12786,25030,15804,29013
Ͻֵ,ZhongNanJieDao,440103022,20304,1058,11123,7933,7558,10409,3348,11565,21974,13587,24710
Žֵ,HongQiaoJieDao,440104001,32201,5577,21763,13318,31433,20118,4480,18350,38468,20495,42258
ֵ,GuangWeiJieDao,440104002,26073,4724,17069,11145,27536,15776,3187,14871,30647,16915,33984
ֵ,BeiJingJieDao,440104003,14961,2479,9693,7289,12872,9149,1711,8760,17909,9458,19151
Žֵ,LiuRongJieDao,440104004,30939,6211,21202,14208,29530,20415,3970,18889,39304,19918,41120
�ֵ,LiuHuaJieDao,440104005,13340,1661,8937,4604,11724,6330,2252,5948,12278,8316,17253
ֵ,DongFengJieDao,440104006,34139,5119,22237,12915,30144,18324,3618,17093,35417,20639,42876
ֵ,GuangTaJieDao,440104007,24842,4598,16441,11705,24572,15912,3294,15612,31524,16293,32734
ʫֵ,ShiShuJieDao,440104008,26882,5411,18037,12443,26533,17455,3101,16926,34381,17357,35394
½ֵ,DaXinJieDao,440104009,32018,5159,19884,14100,26157,18130,3108,18256,36386,20401,40285
ֵ,RenMinJieDao,440104010,23086,3602,14107,10372,19174,13060,2301,13478,26538,14882,28989
ֵ,DongHuJieDao,440104011,56869,8220,37715,24663,60414,35593,9210,33959,69552,36584,74299
ũֵֽ,NongLinJieDao,440104012,38913,6099,26069,13470,40770,20734,5140,19004,39738,24083,50152
÷ֵ,MeiHuaCunJieDao,440104013,63949,9587,43618,27812,63675,41397,11864,38792,80189,41782,85400
ƻڽֵ,HuangHuaGangJieDao,440104014,76975,10447,50252,27775,68918,41777,12147,39092,80869,49317,99569
ֵֽ,HuaLeJieDao,440104015,36102,6047,23301,14340,35574,21317,4977,20231,41548,23825,47126
ֵ,JianSheJieDao,440104016,40052,6635,26023,14708,42217,22906,5423,21440,44346,26087,52110
ֵ,DaTangJieDao,440104017,35095,5871,23625,15350,36441,22804,5158,21470,44274,22499,46124
ֵ,ZhuGuangJieDao,440104018,43292,7251,28512,19438,42272,27541,5786,26466,54007,27817,56329
󶫽ֵ,DaDongJieDao,440104019,63108,10812,43004,26863,64677,40363,9571,37561,77924,40487,83491
ƽֵ,BaiYunJieDao,440104020,35391,6207,23698,14767,32199,22348,5170,21093,43441,23070,46768
Ƿֵ,DengFengJieDao,440104021,77628,6471,43796,26551,38594,34017,8119,35133,69150,48422,92218
Ȫֵ,KuangQuanJieDao,440104022,76815,4660,40824,29017,25446,34000,8561,38739,72739,49212,90036
ڽֵ,ChiGangJieDao,440105001,88788,12061,57657,39883,72387,52332,14129,52304,104636,57321,114978
¸۽ֵ,XinGangJieDao,440105002,90864,10197,54713,30512,60888,42402,10836,41907,84309,57184,111897
ڽֵ,ChangGangJieDao,440105003,75706,12747,49725,34480,68388,47108,9533,45684,92792,48261,97986
нֵ,JiangNanZhongJieDao,440105004,57132,10522,38342,27133,52681,37213,7566,35737,72950,36878,75220
�ֵ,BinJiangJieDao,440105005,58514,7542,34628,21821,43165,29018,6268,28484,57502,37696,72324
ֵ,SuSheJieDao,440105006,52312,8005,33738,23578,40216,31999,6786,31142,63141,33365,67103
ֵ,HaiZhuangJieDao,440105007,47815,9104,31294,23115,46672,29738,5965,29428,59166,31590,62884
ϻֵ,NanHuaXiJieDao,440105008,29092,5856,18961,14251,26102,17658,3012,17504,35162,18999,37960
ֵ,LongFengJieDao,440105009,79779,12673,51708,36784,62399,49978,10109,48556,98534,50853,102561
ɳ԰ֵ,ShaYuanJieDao,440105010,50275,9233,34057,22701,46451,33375,7814,32443,65818,33265,67322
ʯͷֵ,NanShiTouJieDao,440105011,96202,13297,61891,41172,63349,59137,13544,57372,116509,61152,123043
ֵ,FengYangJieDao,440105012,141945,7015,75521,48803,43168,55759,13681,60673,116432,87120,162641
𱦽ֵ,RuiBaoJieDao,440105013,104307,6148,59408,46664,42720,52872,14944,56195,109067,65991,125399
ֵ,JiangHaiJieDao,440105014,98207,3663,53281,35027,22986,42557,13287,45511,88068,61876,115157
޽ֵ,PaZhouJieDao,440105015,24308,2304,14080,9695,13926,11574,3239,12127,23701,15771,29851
޽ֵ,NanZhouJieDao,440105016,73876,2485,38612,31055,22398,32441,8365,35687,68128,46114,84726
޽ֵ,HuaZhouJieDao,440105017,43727,1953,23520,12354,16050,15469,4062,16433,31902,26222,49742
޽ֵ,GuanZhouJieDao,440105018,51524,1613,27964,17593,17897,17572,4732,19058,36630,29905,57869
ɽֵ,WuShanJieDao,440106001,113793,7732,59237,24711,75057,32907,10270,33454,66361,72558,131795
Աֵ,YuanCunJieDao,440106002,64704,6791,39325,29698,39352,36671,10336,38116,74787,42506,81831
ֵ,CheBeiJieDao,440106003,85841,3996,47780,41270,30759,43152,12950,48133,91285,55007,102787
ɳӽֵ,ShaHeJieDao,440106004,33169,4856,20992,14468,26303,19225,4789,19820,39045,21822,42814
ʯƽֵ,ShiPaiJieDao,440106006,153406,9096,86296,45656,84202,56237,14696,56631,112868,90902,177198
ɳֵ,ShaDongJieDao,440106007,23771,2048,14051,10140,13543,12901,3703,13522,26423,15471,29522
Ͻֵ,TianHeNanJieDao,440106008,50992,5901,30359,19542,36870,24819,6019,24296,49115,32553,62912
ֺͽֵ,LinHeJieDao,440106009,48884,4398,28005,16954,33976,22364,6450,21794,44158,31727,59732
˻ֵ,XingHuaJieDao,440106010,56490,3008,32761,22665,28763,26939,8641,28919,55858,35378,68139
½ֵ,TangXiaJieDao,440106011,152622,5905,83061,65625,54920,67532,19337,74380,141912,94803,177864
԰ֵ,TianYuanJieDao,440106012,41443,3262,26747,20377,34999,25839,10064,26482,52321,28022,54769
Ե½ֵ,LieDeJieDao,440106013,17886,1750,11414,7679,11897,10799,2886,10306,21105,11108,22522
ֵ,XianCunJieDao,440106014,44913,1869,23109,13995,16120,17104,4502,17676,34780,28175,51284
Ԫڽֵ,YuanGangJieDao,440106015,27969,406,14971,8607,5616,7783,2235,9484,17267,15639,30610
ƴֵ,HuangCunJieDao,440106016,24352,1004,12385,9606,17457,11001,4145,11982,22983,17116,29501
˽ֵ,ChangXingJieDao,440106017,54893,2579,29776,23171,18886,25019,8626,28365,53384,36322,66098
ֵ,LongDongJieDao,440106018,63404,1563,37143,13496,25802,14661,5088,15742,30403,32912,70055
˽ֵ,FengHuangJieDao,440106019,15653,1067,9250,5133,11409,8262,2814,8446,16708,10284,19534
ǰֵ,QianJinJieDao,440106020,49115,1381,26954,21750,16633,25175,9204,27291,52466,32746,59700
鼪ֵ,ZhuJiJieDao,440106021,49147,817,21962,19863,8579,15193,2588,19254,34447,30590,52552
ֵ,XinTangJieDao,440106022,38515,590,17802,10672,7407,8989,2102,11504,20493,23405,41207
Ԫֵ,SanYuanLiJieDao,440111002,85904,5881,47378,34520,34928,38310,8364,41042,79352,52771,100149
޽ֵ,SongZhouJieDao,440111003,89580,5960,49063,36534,21442,42425,10734,45549,87974,57211,106274
ֵ̩,JingTaiJieDao,440111004,66746,6370,40459,26922,26201,36195,9110,36178,72373,41767,82226
ͬ½ֵ,TongDeJieDao,440111005,88018,6342,50511,41644,15884,46384,10950,49362,95746,54799,105310
ʯֵ,HuangShiJieDao,440111006,102443,3162,55161,42159,23443,41885,11734,47371,89256,62178,117339
ľֵ,TangJingJieDao,440111007,76353,4051,43136,33195,21519,37103,9491,38729,75832,46759,89895
нֵ,XinShiJieDao,440111008,133957,3988,69508,60736,28298,57191,14347,64530,121721,82784,152292
ͬͽֵ,TongHeJieDao,440111009,76206,2884,40488,31588,16052,34489,10272,37672,72161,48874,89362
Ϫֵ,JingXiJieDao,440111010,75339,3441,44711,32642,24302,38556,13190,40968,79524,47259,91970
ƽֵ,YongPingJieDao,440111011,106539,3948,56557,45656,16385,46439,13513,52021,98460,67443,124000
κֵ̽,JiaHeJieDao,440111012,76560,2172,38653,33659,21177,32271,8964,38027,70298,49043,87696
ֵ̽,JunHeJieDao,440111013,113995,2792,51816,34266,26918,32621,8122,39178,71799,73093,124909
ʯֵ,ShiJingJieDao,440111014,182939,7363,90094,56388,66472,64014,18720,73270,137284,118928,209022
ɳֵ,JinShaJieDao,440111015,43130,2930,25520,18286,11676,23742,6597,24055,47797,27137,52657
˺,RenHeZhen,440111103,103472,8460,60780,27180,67186,45944,15863,45074,91018,67015,127795
̫,TaiHeZhen,440111107,176265,10281,95118,50456,73985,67116,22043,73717,140833,113471,208589
̶,ZhongLuoTanZhen,440111108,157707,11107,92317,34923,110205,63328,23508,65322,128650,100005,192322
,JiangGaoZhen,440111113,131777,11775,73761,37727,98535,58399,17791,61036,119435,87582,161343
ҽֵ,HuangPuJieDao,440112001,49753,4778,31043,22748,40359,30056,9724,30987,61043,33212,64255
ɽֵ,HongShanJieDao,440112002,35345,1972,16938,13910,15686,14979,4810,18254,33233,25189,42127
ֵ,YuZhuJieDao,440112003,47263,3391,27118,21043,22373,25863,8875,28922,54785,32411,59529
ɳֵ,DaShaJieDao,440112005,38100,1608,20240,15820,15954,17697,4933,19812,37509,24401,44641
ĳֵ,WenChongJieDao,440112006,38061,1989,21314,17066,16603,20085,6827,22279,42364,25563,46877
붫ֵ,SuiDongJieDao,440112007,39234,1473,18975,19430,10792,17462,4318,22504,39966,26050,45025
ϸڽֵ,NanGangJieDao,440112008,63731,3863,34644,28953,26589,32050,9153,36832,68882,42103,76747
ֵ,LiLianJieDao,440112009,39070,539,18426,16460,4372,13176,2642,16751,29927,23825,42251
޽ֵ,ChangZhouJieDao,440112010,29722,2915,16735,9187,17892,11794,3841,13016,24810,19743,36478
Žֵ,ShiQiaoJieDao,440113007,131836,13484,85261,54670,129397,75387,23381,74117,149504,83440,168701
ɳͷֵ,ShaTouJieDao,440113008,29068,1788,17805,9486,18544,13614,4345,13604,27218,17396,35201
ֵ,DongHuanJieDao,440113009,45182,1656,25737,17525,15929,19958,6127,21238,41196,27228,52965
Ͻֵ,QiaoNanJieDao,440113010,58267,2962,36093,23193,31180,32779,11466,32416,65195,36602,72695
СΧֵ,XiaoGuWeiJieDao,440113011,128715,971,58383,4610,57810,4953,1784,4922,9875,73087,131470
ʯֵ,DaShiJieDao,440113012,97971,3922,51822,38858,46840,43283,14214,47304,90587,64285,116107
ֵֽ,LuoPuJieDao,440113013,69312,5322,44123,33212,57118,42721,14660,42444,85165,45171,89294
ʯڽֵ,ShiBiJieDao,440113014,26227,1834,15197,10952,17888,13569,4928,14388,27957,17792,32989
Ӵֵ,ZhongCunJieDao,440113015,83704,5404,50925,27522,38774,38376,15490,37300,75676,53673,104598
ֵ,DaLongJieDao,440113016,107803,4192,65080,40003,43097,50952,17520,52727,103679,64435,129515
ϴ,NanCunZhen,440113102,107528,6906,62785,36738,50797,48615,14642,48816,97431,66291,129076
,XinZaoZhen,440113103,21289,2247,13900,8936,12062,12136,3712,11664,23800,13348,27248
,HuaLongZhen,440113104,44071,3263,26707,11587,27501,16432,5808,15457,31889,26435,53142
ʯ¥,ShiLouZhen,440113105,72663,6712,44485,27942,62749,38846,11006,39302,78148,45896,90381
ӿ,DongYongZhen,440113107,124573,6909,70664,52684,66976,60457,15746,63938,124395,76564,147228
,DaGangZhen,440113114,101754,8090,60824,39824,77532,54583,15167,55932,110515,64187,125011
魺,LanHeZhen,440113116,59570,4733,35549,22798,47148,30277,8775,30822,61099,37529,73078
ɳ,ShaWanZhen,440113118,70054,5563,43512,26286,48103,36305,13078,36883,73188,45183,88695
ʯ,ShiJiZhen,440113120,81798,4834,47067,29256,43896,37415,10802,39520,76935,50367,97434
»ֵ,XinHuaJieDao,440114001,305197,22317,181944,103416,251859,156823,53797,158339,315162,199367,381311
,TiMianZhen,440114103,7171,972,4318,2470,7459,3998,1373,4352,8350,5198,9516
ɽ,HuaShanZhen,440114104,79163,7509,47079,20467,69564,38803,12590,38940,77743,52183,99262
,HuaDongZhen,440114105,92622,8930,57340,27673,100773,52522,17184,53197,105719,61396,118736
̿,TanBuZhen,440114107,44393,5133,25726,15369,40027,22142,6271,23008,45150,30071,55797
,ChiNiZhen,440114108,44823,5687,28031,14003,41533,20587,6099,21703,42290,28578,56609
ʨ,ShiLingZhen,440114109,182452,6877,99325,22421,71411,39463,13925,40415,79878,103929,203254
,YaYaoZhen,440114111,16646,1133,9440,4472,10188,7815,2741,8274,16089,11080,20520
ɳֵ,NanShaJieDao,440115001,97376,3526,49328,34806,32230,38154,11249,43015,81169,62823,112151
齭ֵ,ZhuJiangJieDao,440115002,22002,2711,13616,9010,17355,12961,3862,13550,26511,14959,28575
ɳ,WanQingShaZhen,440115100,36789,2909,19204,11317,28818,17602,5193,18409,36011,25687,44891
,HengLiZhen,440115101,23779,2338,14593,8796,24385,13772,4375,14179,27951,15899,30492
Ƹ,HuangGeZhen,440115102,33589,3644,20785,14337,31973,19189,6558,19796,38985,23006,43791
ĸ۽ֵ,XiaGangJieDao,440116001,38724,801,19195,13244,10569,14023,5003,16185,30208,25333,44528
ܸڽֵ,LuoGangJieDao,440116002,37941,2785,21365,10311,26794,16247,4991,17157,33404,24352,45717
ֵ,DongQuJieDao,440116003,74870,2207,37895,27016,22271,28406,8158,33167,61573,47340,85235
ͽֵ,LianHeJieDao,440116004,44714,1485,24079,7746,16906,11229,3668,11821,23050,25788,49867
ͽֵ,YongHeJieDao,440116005,50619,995,22424,18339,11681,16185,3430,20297,36482,32620,55044
,JiuLongZhen,440116101,72982,5821,46242,19174,70560,36694,14462,37745,74439,47023,93265
ǽֵ,LiChengJieDao,440183001,149067,11817,94519,50576,133641,82356,30893,85372,167728,97258,191777
�ֵ,ZengJiangJieDao,440183002,64880,4144,38412,11919,38977,22775,9048,23780,46555,39660,78072
ֵ,ZhuCunJieDao,440183003,35423,2746,20448,10809,28548,15345,5388,17058,32403,23109,43557
,XinTangZhen,440183101,324900,19850,181808,90213,209041,140357,46537,147131,287488,209479,391287
ʯ̲,ShiTanZhen,440183102,93451,9345,57371,34251,95828,51915,18878,55429,107344,64303,121674
,ZhongXinZhen,440183103,59178,5741,37987,17128,64716,32656,13374,34163,66819,40306,78293
,ZhengGuoZhen,440183104,28407,4480,19233,11200,38028,18777,7500,20322,39099,21154,40387
̶,PaiTanZhen,440183105,41861,6011,27392,17151,55288,26683,10465,29660,56343,30945,58337
С¥,XiaoLouZhen,440183106,24070,3546,15454,10171,28493,14750,6109,15063,29813,18271,33725
ֿڽֵ,JieKouJieDao,440184001,75711,5875,48215,30565,71035,42631,15260,43350,85981,48631,96846
ҽֵ,JiangPuJieDao,440184002,77126,5000,44317,22702,57546,34664,13717,36879,71543,51526,95843
ǽֵ,ChengJiaoJieDao,440184003,60297,4751,38980,21770,59280,35281,14037,36456,71737,40105,79085
Ȫ,WenQuanZhen,440184103,43353,4051,27129,12046,41852,21115,7790,22074,43189,28065,55194
,LiangKouZhen,440184104,23331,2991,15937,8879,29778,15313,6507,15457,30770,16892,32829
,LvTianZhen,440184107,16344,2513,11394,7545,21764,11174,4573,11601,22775,12036,23430
̫ƽ,TaiPingZhen,440184111,73180,6000,44398,21382,73514,38116,15189,39406,77522,49971,94369
ͷ,AoTouZhen,440184113,78962,10726,54986,31073,102518,52720,21620,53649,106369,56322,111308
Ϫֳ,LiuXiHeLinChang,440184402,3206,472,2268,1546,4116,2250,833,2178,4428,2243,4511
»ֵ,XinHuaJieDao,440203001,91818,8900,59773,38066,76187,57027,19019,56992,114019,59964,119737
ֵ,HuiMinJieDao,440203002,64968,8856,43628,29690,55226,41947,12690,41509,83456,42886,86514
,XiLianZhen,440203100,25459,1266,16999,6305,12651,9132,3726,9247,18379,13452,30451
,XiHeZhen,440203101,9460,1055,6248,3812,9467,6229,2251,6484,12713,6518,12766
,LongGuiZhen,440203102,21088,2962,14550,8092,27925,14394,5833,15031,29425,15333,29883
,JiangWanZhen,440203103,3278,515,2238,1338,4377,2209,885,2341,4550,2440,4678
,ChongYangZhen,440203104,6913,1250,5256,3541,9988,5226,2516,5350,10576,5423,10679
ӽֵ,DongHeJieDao,440204001,26123,4207,17313,12303,24691,16841,4409,16792,33633,17426,34739
վֵ,CheZhanJieDao,440204002,33888,5193,21659,16673,30619,21170,6005,22338,43508,23427,45086
ɽֵ,FengCaiJieDao,440204008,49574,8529,33718,24464,50969,31453,7603,30682,62135,31988,65706
,XinShaoZhen,440204100,36229,1783,20627,8115,20135,11493,4335,12208,23701,21720,42347
԰,LeYuanZhen,440204101,46759,4572,29637,18200,32430,26625,10639,28465,55090,32333,61970
ʮͤ,ShiLiTingZhen,440204102,55126,5250,28040,18220,41578,25166,9158,26271,51437,41494,69534
,LiShiZhen,440204103,29829,4031,16646,11297,31573,16577,6156,17278,33855,23370,40016
ƺ,HuaPingZhen,440204104,3918,468,2658,1589,5284,2630,1059,2713,5343,2787,5445
ݳ´,TianLuoChongBanShiChu,440204401,4258,398,2538,1241,2734,1755,644,1825,3580,2762,5300
ʰ´,QuRenBanShiChu,440204402,8720,2259,6533,5100,9226,5990,1896,5743,11733,6342,12875
عұ,ShaoGuanYeLianChang,440204453,7243,836,4384,4247,7086,4302,1513,4968,9270,5208,9592
ع,ShaoGuanYueBei,440204454,803,2,461,313,485,258,106,294,552,450,911
,MaBaZhen,440205100,101879,9836,66145,37588,91310,60525,22681,60666,121191,68251,134396
,DaTangZhen,440205101,20145,2672,13716,7789,25907,13589,5412,14054,27643,14513,28229
,FengWanZhen,440205102,8377,1583,5872,4076,11168,5707,2128,5902,11609,6216,12088
С,XiaoKengZhen,440205103,3386,496,2214,1351,4259,2098,855,2218,4316,2523,4737
ɳϪ,ShaXiZhen,440205104,9035,1200,6085,3559,10778,6025,2242,6101,12126,6392,12477
ʯ,WuShiZhen,440205106,9044,1958,6423,4121,12490,6149,1987,6182,12331,6566,12989
,ZhangShiZhen,440205107,12333,2540,9034,5870,17563,8973,3563,9262,18235,9402,18436
,BaiTuZhen,440205108,15306,2127,10234,5585,17051,9104,3508,9149,18253,10707,20941
޿,LuoKengZhen,440205109,4715,859,3589,2204,6749,3578,1604,3561,7139,3589,7178
عظ,ShaoGuanGangTie,440205450,30334,4014,18412,15348,34569,18304,5760,21010,39314,21696,40108
عط,ShaoGuanFaDian,440205451,250,43,128,131,99,123,21,120,243,186,314
,QuJiangQuDa,440205452,5042,873,3171,2698,5253,3110,938,3344,6454,3682,6853
عʮ,ShaoGuanShiLiu,440205453,2982,927,2306,1869,3054,2301,716,2296,4597,2319,4625
̫ƽ,TaiPingZhen,440222100,51334,6628,36060,21404,51865,33017,12460,31777,64794,34362,70422
,MaShiZhen,440222101,18698,3095,14023,8945,26585,13870,5697,13039,26909,13467,27490
ν,ChengJiangZhen,440222102,7271,1087,5414,3377,10252,5272,2304,4919,10191,5248,10662
ٸ,DunGangZhen,440222103,12669,2149,9540,5613,18140,9338,3945,8832,18170,9223,18763
ް,LuoBaZhen,440222104,9978,1710,7274,4843,13448,7108,2930,7028,14136,7344,14618
˾ǰ,SiQianZhen,440222105,8023,1104,5569,3283,10738,5360,2245,5381,10741,5803,11372
,AiZiZhen,440222106,8990,1515,6741,4413,12769,6736,2849,6598,13334,6613,13354
,ChengNanZhen,440222107,12328,2008,9110,5207,16533,8768,3575,8310,17078,8801,17911
,ShenSuoZhen,440222108,10020,1609,7445,4248,14404,7237,2960,6849,14086,7144,14589
ˮ,ShenDuShuiXiang,440222204,4271,1083,2946,1845,5528,2568,917,2536,5104,3325,6271
ϼֵ,DanXiaJieDao,440224001,44189,5495,29567,16543,46936,25732,9660,25888,51620,29777,59344
,WenShaoZhen,440224102,2994,556,2115,1216,4233,1981,870,2103,4084,2305,4420
Ϫ,FuXiZhen,440224103,6491,1021,4667,3078,8946,4621,1895,4647,9268,4740,9407
,ChangJiangZhen,440224104,14261,2204,10350,6140,19727,9910,4828,9878,19788,10943,21293
ǿ,ChengKouZhen,440224105,5922,902,4217,2469,7790,4163,1713,4144,8307,4320,8537
ɽ,HongShanZhen,440224106,5224,634,3464,2272,6805,3395,1488,3712,7107,3882,7346
ʯ,ShiTangZhen,440224107,6200,1150,4472,2754,8524,4229,1788,4345,8574,4666,9138
,DongTangZhen,440224108,22599,3515,15667,9051,26864,13873,5955,14083,27956,16402,32069
,DaQiaoZhen,440224109,5055,834,3591,2235,6429,3514,1380,3475,6989,3678,7269
,ZhouTianZhen,440224110,12854,2269,9280,5718,17163,9084,3806,9091,18175,9649,18929
ƿ,HuangKengZhen,440224111,5479,1163,4232,2867,8107,4216,1867,4219,8435,4277,8509
н,ZhongJinLingNan,440224112,7760,1001,5318,4135,2541,5281,2132,5328,10609,5575,10893
ʿ,QuRenKuangWu,440224113,2001,620,1641,1326,6,1638,579,1545,3183,1559,3200
,LongXianZhen,440229100,89635,12046,61844,39212,100256,57853,21788,57832,115685,61625,123469
,BaZaiZhen,440229104,24235,3968,17539,12036,33884,17077,7377,17180,34257,18041,35580
β,JiangWeiZhen,440229106,21650,3945,15815,10639,30709,15452,6439,15455,30907,16219,32034
ٶ,GuanDuZhen,440229109,29493,3912,20608,11295,36417,18705,7664,18744,37449,20461,41069
,ZhouBeiZhen,440229111,21324,3557,15606,9956,29670,15522,6387,15518,31040,15662,31268
̳,WengChengZhen,440229113,19676,2552,13255,7909,24646,12589,5041,13099,25688,14014,27269
½,XinJiangZhen,440229114,24418,3214,17007,10610,33242,16857,7021,17354,34211,17646,34653
ֳ,TieLongLinChang,440229450,4498,597,2597,1794,4750,2510,883,2846,5356,3381,5978
,RuChengZhen,440232100,56438,6101,37820,20577,54854,34554,13898,35059,69613,38617,76437
һ,YiLiuZhen,440232103,9256,1447,6620,4222,10232,6543,2875,6796,13339,6958,13578
ͷ,GuiTouZhen,440232104,20094,2821,14130,8857,25446,14004,5713,14093,28097,14498,28628
,LuoYangZhen,440232106,4049,819,2804,1859,5518,2762,1111,3010,5772,3175,5979
,DaBuZhen,440232108,4884,967,3484,2138,6700,3451,1442,3555,7006,3809,7293
,DaQiaoZhen,440232109,15006,2704,11961,7014,21661,11843,6058,11544,23387,11807,23768
ƺ,DongPingZhen,440232111,5700,736,3729,2613,7250,3642,1328,3912,7554,4035,7764
Ϫ,YouXiZhen,440232112,4715,611,3360,2483,6558,3335,1538,3451,6786,3504,6864
ر,BiBeiZhen,440232113,2747,366,1769,1482,3700,1769,694,2038,3807,2038,3807
쾮ɽֳ,TianJingShanLinChang,440232450,899,175,581,423,1066,543,181,576,1119,674,1255
ҵ,RuYangLinYe,440232451,1409,379,1046,703,1733,1019,310,945,1964,1052,2098
ǽֵ,FengChengJieDao,440233001,76096,8213,51330,28787,81803,48351,20352,50440,98791,53331,104661
,HuangCaZhen,440233100,7290,1299,5337,3669,10189,5325,2358,5583,10908,5610,10947
ͷ,MaTouZhen,440233101,18023,3534,13415,9055,25943,13340,5479,13398,26738,13621,27036
÷,MeiKengZhen,440233102,11537,2149,8494,5551,15826,8320,3754,8478,16798,8946,17440
ɳ,ShaTianZhen,440233103,8958,1860,6748,4478,12893,6629,3017,6812,13441,7087,13835
ң,YaoTianZhen,440233104,10350,2493,8260,5540,15798,8210,4318,8789,16999,8901,17161
,HuiLongZhen,440233105,9528,1582,7293,4150,12795,6913,3901,7019,13932,7718,15011
ֳǽֵ,LeChengJieDao,440281001,94047,11533,60841,42254,91634,58193,21795,58279,116472,66534,127375
,BeiXiangZhen,440281102,8475,1305,5935,3644,11448,5900,2338,6027,11927,6183,12118
ŷ,JiuFengZhen,440281103,10675,1629,7287,4946,14404,7131,2871,7595,14726,7888,15175
,LangTianZhen,440281104,15758,2612,11739,7634,22001,11597,5307,11698,23295,11938,23677
,ChangLaiZhen,440281105,12554,1722,8781,5651,17416,8750,3957,9282,18032,9452,18233
÷,MeiHuaZhen,440281106,22111,3488,17691,10293,32276,17554,10163,17453,35007,18071,35762
Ϫ,SanXiZhen,440281107,4519,976,3257,2713,6352,3185,1230,3282,6467,3468,6725
ƺʯ,PingShiZhen,440281108,38864,5107,24412,17120,42871,23342,9417,23672,47014,28976,53388
,HuangPuZhen,440281110,7717,1233,5710,4155,10813,5619,2641,5741,11360,5881,11591
ɽ,WuShanZhen,440281111,8250,1188,5657,3885,11344,5608,2636,6255,11863,6417,12074
,LiangJiangZhen,440281112,5686,994,3955,2911,7752,3912,1447,4077,7989,4172,8127
ɳƺ,ShaPingZhen,440281113,8351,1668,6900,3902,12391,6844,3510,6502,13346,6629,13529
,YunYanZhen,440281114,5797,1076,4795,2783,8811,4654,2702,4505,9159,4780,9575
ˮ,XiuShuiZhen,440281115,7201,1222,6083,3582,10748,5999,3714,5875,11874,6054,12137
Դ,DaYuanZhen,440281117,6209,662,3003,2035,6011,2919,864,3236,6155,4732,7735
,QingYunZhen,440281118,5046,916,3639,2695,7069,3503,1523,3576,7079,3846,7485
ʯ,BaiShiZhen,440281119,6009,1133,4309,3663,8513,4294,1690,4477,8771,4523,8832
ƺʯ´,PingShiBanShiChu,440281451,4636,1021,3470,3178,5345,3444,1355,3457,6901,3542,7012
÷´,MeiTianBanShiChu,440281452,4870,921,3564,3071,5357,3540,1438,3640,7180,3665,7229
ݽֵ,XiongZhouJieDao,440282001,74929,11655,53339,34791,66509,50360,18774,48598,98958,52019,105358
,WuJingZhen,440282100,17258,3076,14025,10092,25426,13957,7516,13642,27599,13825,27850
ַ,JieZhiZhen,440282103,4714,951,4126,2850,7552,4079,2554,3953,8032,4093,8219
ƺ,PingTianZhen,440282104,7671,1666,6539,4701,12225,6527,3618,6370,12897,6416,12955
ƿ,HuangKengZhen,440282105,10556,1754,8141,5434,13964,7643,3687,7287,14930,7856,15997
˷,DengFangZhen,440282106,5622,1257,4669,3382,8664,4649,2331,4480,9129,4541,9210
ɽ,YouShanZhen,440282107,10646,2203,8861,6148,16337,8779,4588,8362,17141,8576,17437
Ķ,NanMuZhen,440282109,5163,1176,4582,3122,8169,4515,2603,4208,8723,4360,8942
ˮ,ShuiKouZhen,440282110,7094,1525,5832,4168,10770,5761,2807,5341,11102,5594,11426
ͷ,JiangTouZhen,440282111,4352,833,3404,2460,6442,3392,1676,3438,6830,3457,6861
,HuKouZhen,440282112,11088,2325,8952,6329,16422,8837,3881,8182,17019,8342,17294
,ZhuJiZhen,440282113,14984,3125,11948,8278,21853,11732,5655,11164,22896,11816,23764
,ZhuTianZhen,440282115,3843,814,2921,2017,5516,2874,1124,2748,5622,2860,5781
,GuShiZhen,440282116,7789,1419,6054,3737,10980,5745,2711,5478,11223,5865,11919
ȫ,QuanAnZhen,440282118,10118,1793,7486,4861,13987,7391,2987,7141,14532,7412,14898
˳,BaiShunZhen,440282120,4454,991,3578,2601,6732,3525,1836,3530,7055,3703,7281
,LanHeZhen,440282121,3864,673,2916,2218,5330,2886,1414,2971,5857,3035,5951
ñӷ,MaoZiFengZhen,440282122,2996,637,2506,1738,4671,2502,1266,2370,4872,2393,4899
оϸ,NanXiongShiJingXiHuaGongJiDi,440282400,137,0,37,0,0,0,0,0,0,100,137
԰ֵ,GuiYuanJieDao,440303001,71682,3427,42060,29368,24324,33397,7585,30669,64066,40634,82694
Ʊֵ,HuangBeiJieDao,440303002,94933,4276,57604,39691,37257,51638,14173,47623,99261,55778,113382
Žֵ,DongMenJieDao,440303003,77092,2831,46684,25301,14773,35231,10531,32001,67232,43770,90454
ֵ,CuiZhuJieDao,440303004,92541,4603,55712,36945,38345,47405,13315,43643,91048,54747,110459
Ϻֵ,NanHuJieDao,440303005,82698,1895,48957,27681,12438,30855,5907,22739,53594,41543,90500
ڽֵ,SunGangJieDao,440303006,55298,1610,30436,21649,15315,25312,7096,25300,50612,33568,64004
ֵ,DongHuJieDao,440303007,69163,2635,41169,29164,20692,37283,12758,37902,75185,43387,84556
ֵ,LianTangJieDao,440303008,71429,2643,42892,28944,24445,36548,11497,34996,71544,42677,85569
ֵ,DongXiaoJieDao,440303009,84160,2145,46807,31967,16264,40459,14474,42196,82655,53972,100779
ˮӽֵ,QingShuiHeJieDao,440303010,86593,1799,46333,29663,16475,36538,12632,38801,75339,54691,101024
԰ֵ,NanYuanJieDao,440304001,94019,2956,49038,28396,23904,35675,11423,39141,74816,59360,108398
԰ֵ,YuanLingJieDao,440304002,70804,4724,42368,26130,48399,34143,12733,33421,67564,45893,88261
ֵ,FuTianJieDao,440304004,204020,5259,116392,69826,62333,88411,25582,79586,167997,118469,234861
ɳͷֵ,ShaTouJieDao,440304005,200243,4115,108080,73522,46359,79492,21703,77991,157483,117981,226061
ۺֵ,XiangMiHuJieDao,440304006,74547,3448,43615,24692,48227,38121,11476,36992,75113,45856,89471
÷ֵֽ,MeiLinJieDao,440304007,141582,5956,81522,53058,51548,67136,20968,67850,134986,86984,168506
ֵ,LianHuaJieDao,440304008,136492,8441,83657,50945,84943,71583,23459,68532,140115,84735,168392
ֵ,HuaFuJieDao,440304009,58279,3098,33945,19110,33574,26376,9457,26504,52880,36889,70834
ֵ,FuBaoJieDao,440304010,88956,4035,54173,34045,42930,44103,13820,42533,86636,52638,106811
ǿֵ,HuaQiangBeiJieDao,440304011,46207,2226,23543,11000,23062,14451,5634,15366,29817,30524,54067
ﱣ˰,FuTianBaoShuiQu,440304400,1524,0,603,6,1519,6,325,20,26,1246,1849
ͷֵ,NanTouJieDao,440305001,138656,4340,76270,62765,56225,65617,20241,70633,136250,86967,163237
ɽֵ,NanShanJieDao,440305002,130587,2800,72062,68077,50026,67254,18925,72520,139774,80250,152312
ɳӽֵ,ShaHeJieDao,440305003,104750,4229,56378,48798,37827,47974,12371,52693,100667,64972,121350
߿ڽֵ,SheKouJieDao,440305005,75192,2146,40994,35319,20605,37046,9966,39701,76747,46310,87304
ֵ̽,ZhaoShangJieDao,440305006,65482,2713,36626,29333,47583,33800,11455,36729,70529,43024,79650
ֵ,YueHaiJieDao,440305007,131164,3953,72464,43711,96968,53944,22690,54377,108321,85343,157807
Դֵ,TaoYuanJieDao,440305008,120542,2411,62249,51153,34642,52066,15900,60106,112172,76604,138853
ֵ,XiLiJieDao,440305009,171300,2194,83997,58418,26863,55003,14338,64294,119297,103835,187832
°ֵ,XinAnJieDao,440306001,345865,8765,196382,132580,97322,157952,55426,167467,325419,213674,410056
´,GuangMingBanShiChu,440306002,55739,2276,30007,21291,19365,24016,8534,27409,51425,36542,66549
ֵ,XiXiangJieDao,440306003,532291,6277,263642,217750,58212,192742,42168,218703,411445,317094,580736
ֵ,FuYongJieDao,440306004,434474,3233,218346,151874,16444,142125,35085,163923,306048,254446,472792
ɳֵ,ShaJingJieDao,440306005,489089,5299,248587,177635,28023,164202,34653,185884,350086,280454,529041
ɸڽֵ,SongGangJieDao,440306006,364510,3643,178453,131942,19130,125908,30000,146961,272869,219700,398153
´,GongMingBanShiChu,440306007,380389,3683,185481,158367,22781,134591,30286,160692,295283,228877,414358
ʯҽֵ,ShiYanJieDao,440306008,233485,1914,100147,118438,10448,73571,12740,107606,181177,147992,248139
ֵ,GuanLanJieDao,440306010,428950,3372,181391,203029,19866,125027,20276,185332,310359,271207,452598
˽ֵ,DaLangJieDao,440306011,253193,1879,121838,105313,5902,93410,22617,112856,206266,155851,277689
ֵ,LongHuaJieDao,440306012,339239,2471,151487,117426,46678,92440,25811,119709,212149,216034,367521
νֵ,MinZhiJieDao,440306013,255066,2995,119632,128653,19102,101123,23591,128882,230005,162020,281652
ƽֵ,PingHuJieDao,440307003,204925,2300,105285,72578,13535,73475,20992,83058,156533,122932,228217
ƺؽֵ,PingDiJieDao,440307006,84280,1662,40752,33014,11633,29383,8823,35921,65304,54013,94765
ƺɽֵ,PingShanJieDao,440307007,184701,3254,87920,74483,19728,65879,18044,81419,147298,118079,205999
ֵ,KengZiJieDao,440307008,83400,1470,42017,33869,8238,34011,9931,39712,73723,52784,94801
ӿֵ,KuiYongJieDao,440307009,53479,1529,28136,22770,9517,21590,6097,25237,46827,32969,61105
ֵ,DaPengJieDao,440307010,40371,1195,20137,14487,6334,16214,5301,17778,33992,26730,46867
ϰĽֵ,NanAoJieDao,440307011,15440,742,8093,5543,6236,6722,2406,7522,14244,10495,18588
ֵ,NanWanJieDao,440307012,169430,3256,96257,66585,22591,74843,24745,77615,152458,101174,197431
ֵ,BanTianJieDao,440307013,197202,2424,98854,81814,12214,71113,22141,86196,157309,122913,221767
ֵ,BuJiJieDao,440307014,290010,8640,174317,125465,50834,154223,61120,157581,311804,185453,359770
ǽֵ,LongChengJieDao,440307015,219572,4946,118984,73268,79612,81954,36178,90672,172626,141712,260696
ڽֵ,LongGangJieDao,440307016,189267,3598,94935,71610,28704,68368,22408,80112,148480,120338,215273
ڽֵ,HengGangJieDao,440307017,273165,3493,137087,104219,25846,100290,29844,117387,217677,169415,306502
ҵ,DaGongYeQu,440307400,8546,8,4586,919,135,632,125,885,1517,4093,8679
÷ɳֵ,MeiShaJieDao,440308001,16664,320,7188,3254,1735,3753,1079,3915,7668,10875,18063
ֵ,YanTianJieDao,440308002,69081,1154,35054,25074,7580,29064,10406,34325,63389,45587,80641
ɳͷǽֵ,ShaTouJiaoJieDao,440308003,41864,1377,23924,13903,10129,17988,5557,17374,35362,24874,48798
ɽֵ,HaiShanJieDao,440308004,54254,1336,29287,11175,11723,16322,6268,16430,32752,32571,61858
ֵ,CuiXiangJieDao,440402001,82766,6196,53538,33644,65218,49283,17699,48515,97798,53123,106661
÷ֵ,MeiHuaJieDao,440402002,70196,3952,44356,29545,59344,41605,17024,43136,84741,46816,91172
ǰɽֵ,QianShanJieDao,440402003,150251,6103,84500,65599,83174,75470,28384,84784,160254,100238,184738
ֵ,JiDaJieDao,440402004,66440,3969,39286,25450,41868,32299,10679,31822,64121,41802,81088
ֵ,GongBeiJieDao,440402005,87610,3718,54100,35940,49516,44130,13802,41491,85621,51030,105130
ֵ,XiangWanJieDao,440402006,37290,3344,24095,14789,27540,22139,7848,21944,44083,24387,48482
ʨɽֵ,ShiShanJieDao,440402007,43662,5110,28405,17420,35875,25304,8184,25123,50427,28551,56956
нֵ,WanZaiJieDao,440402008,22247,1235,12255,8258,11273,10092,3163,11122,21214,14390,26645
Ƽ,TangJiaWanZhen,440402100,96733,3523,54428,25685,38411,29756,8896,31840,61596,54724,109152
,NanPingZhen,440402102,60155,2297,32798,21620,24094,24700,8482,27236,51936,38136,70934
,HengQinZhen,440402104,5537,326,2976,1916,2947,2598,1051,2950,5548,3938,6914
ɽ,GuiShanZhen,440402105,1464,80,719,692,557,676,201,779,1455,1026,1745
ɽ,WanShanZhen,440402106,946,79,546,402,430,482,183,548,1030,662,1208
,DanGanZhen,440402107,1643,47,762,804,288,709,170,888,1597,1098,1860
,LianZhouZhen,440403100,26225,3629,16990,10637,30866,16528,4827,16830,33358,17691,34681
,DouMenZhen,440403103,36575,4144,22190,12327,31205,18771,5830,18841,37612,24359,46549
Ǭ,QianWuZhen,440403105,45615,4426,26823,17667,38427,24813,7311,26486,51299,30529,57352
׽,BaiJiaoZhen,440403106,81242,6652,51007,29293,67603,46526,16674,49003,95529,53561,104568
,JingAnZhen,440403107,140328,8819,82951,54705,103084,73938,23585,78519,152457,89781,172732
,SanZaoZhen,440404100,71807,2123,38876,21757,30785,25152,8291,28185,53337,43345,82221
ˮ,NanShuiZhen,440404101,32488,1098,15122,10735,8756,11619,3376,13905,25524,21840,36962
,HongQiZhen,440404103,57466,2503,30798,17691,28070,22608,7662,25819,48427,36833,67631
ƽɳ,PingShaZhen,440404104,53662,4839,31200,20039,36279,27139,8648,30246,57385,35949,67149
ϼֵ,JinXiaJieDao,440507001,53823,3902,35026,23441,30649,32637,12101,32931,65568,34800,69826
ؽֵ,ZhuChiJieDao,440507003,103969,7392,67122,40491,73386,64965,24928,65285,130250,69167,136289
½ֵ,XinJinJieDao,440507004,70316,3489,43427,25500,42567,39269,16666,40940,80209,47044,90471
Ÿֵ͡,OuTingJieDao,440507005,35171,3278,23270,10001,39797,21468,7435,21040,42508,22614,45884
ֵ,LongXiangJieDao,440507008,32859,1682,20756,10872,23722,18926,7254,19253,38179,21039,41795
ɰ,WaiShaZhen,440507100,63286,6479,43845,18982,80676,42891,16894,41857,84748,42814,86659
Ϫ,XinXiZhen,440507101,46387,5177,32882,13585,62911,32469,13868,31718,64187,32550,65432
ʯֵ̨,ShiPaoTaiJieDao,440511001,52963,9123,37083,21714,61198,36480,9981,33992,70472,34984,72067
ɰֵ,JinShaJieDao,440511002,57843,7160,38241,23600,51529,37865,11932,37207,75072,38694,76935
ýֵ,JinShaJieDao,440511003,41564,5916,28503,17362,45324,28153,8117,26816,54969,27094,55597
ֵ,DongFangJieDao,440511004,50564,6580,34806,21212,49472,34592,10674,32629,67221,33012,67818
󻪽ֵ,DaHuaJieDao,440511005,53376,8597,36527,22536,60027,36400,9498,34666,71066,34944,71471
ֵͬ,TongYiJieDao,440511006,20554,3478,14091,9554,19352,14054,3665,13448,27502,13606,27697
⻪ֵ,GuangHuaJieDao,440511007,33728,4603,22404,14630,29680,22268,6763,22318,44586,22690,45094
սֵ,DongDunJieDao,440511008,38369,3101,25652,15114,34276,25340,9954,25340,50680,25772,51424
ýֵ,GuangShaJieDao,440511009,60391,4864,41837,24142,56106,41623,17570,40778,82401,40988,82825
ֵ,HaiAnJieDao,440511010,19725,3476,13637,9804,21015,13540,3527,12917,26457,13091,26728
¸ֵ,XinFuJieDao,440511011,19967,3156,13459,9875,19199,13409,3424,12968,26377,13088,26547
Žֵ,WuQiaoJieDao,440511012,12538,2206,8417,6092,13075,8262,1990,8210,16472,8317,16734
ɽֵ,QiShanJieDao,440511013,21349,1657,13337,6814,18898,12761,4985,12849,25610,14654,27991
ֵ,YongXiangJieDao,440511014,15780,2656,10465,7899,16053,10462,2657,10581,21043,10628,21093
Dֵ,TuoLianJieDao,440511015,37846,3945,26110,11269,47895,25710,9929,24924,50634,25610,51720
Dֵ,TuoJiangJieDao,440511016,48637,3722,29865,13255,41492,26205,9504,25874,52079,31998,61863
ֵֽ,YuePuJieDao,440511017,19796,1775,13466,6344,22164,13188,5109,12788,25976,13214,26680
婽ֵ,DaHaoJieDao,440512001,57946,5864,39488,20978,70838,39008,15660,38289,77297,39982,79470
ѽֵ,MaJiaoJieDao,440512002,16631,1688,12603,5727,22216,12563,5700,11246,23809,11416,24019
Cʯֵ,QueShiJieDao,440512003,33438,3243,25518,8747,39775,22932,11094,19599,42531,22257,47775
Ľֵ,GuangAoJieDao,440512004,27298,1974,19021,5840,28103,15676,7347,14468,30144,17598,36619
�ֵ,BinHaiJieDao,440512005,18744,1911,14682,5490,25113,14078,7240,12626,26704,13213,27895
ֵֽ,HePuJieDao,440512006,22191,2351,17565,6713,33162,17397,9900,16440,33837,16877,34442
½ֵ,YuXinJieDao,440512007,10694,1364,9306,3703,15808,9198,5185,7732,16930,7937,17243
Ĺֵ,WenGuangJieDao,440513001,93146,9874,64423,40334,113217,62110,29302,62902,125012,67899,132322
ޱֵ,MianBeiJieDao,440513002,41088,4029,28369,13183,46970,26616,11457,25223,51839,28205,56574
Ͻֵ,ChengNanJieDao,440513003,82773,7661,59315,24648,95547,56043,28350,55094,111137,59469,118784
ֵֽ,JinPuJieDao,440513004,58495,4891,43461,14740,77819,41598,22614,39991,81589,42539,86000
,HaiMenZhen,440513100,84508,6512,58210,23257,110118,57468,27660,59012,116480,60470,118680
Ϫ,HeXiZhen,440513101,46660,4783,38432,14704,71596,38281,23509,36101,74382,36520,74952
ƽ,HePingZhen,440513102,127074,10128,89882,27667,162309,81892,46273,81642,163534,93593,183475
,XiLuZhen,440513103,100530,9752,76952,29138,148345,76565,42867,74882,151447,76197,153149
ز,GuanBuZhen,440513104,76518,7578,58039,24817,111542,57345,30187,55305,112650,56244,114283
,GuRaoZhen,440513106,132789,10154,93327,27924,147167,77982,46359,77224,155206,95975,189302
,GuiYuZhen,440513107,103192,9317,75662,24606,137991,71625,43233,72097,143722,80080,155742
ͭ,TongYuZhen,440513108,80932,8096,60980,21465,114695,59452,33633,59340,118792,61681,122661
,JinZaoZhen,440513110,80135,8643,60013,26397,116874,59766,31655,59683,119449,60420,120433
Ͽɽֵ,XiaShanJieDao,440514001,174626,12533,117239,35600,195614,100130,53570,98815,198945,123490,240729
,JingDouZhen,440514101,52181,5324,41381,14613,75056,40962,23819,39305,80267,39943,81324
,ChengTianZhen,440514103,54217,5847,41588,13995,76380,40688,22922,39646,80334,41398,82986
˾,SiMaPuZhen,440514104,94039,7615,66347,19769,115245,60774,34408,60141,120915,69715,136062
µ,ChenDianZhen,440514105,98591,6483,66669,20394,101094,55623,33294,55322,110945,71699,138368
Ӣ,LiangYingZhen,440514106,131002,10963,96546,31326,173091,92712,54152,92012,184724,99571,196117
ɳ,XianChengZhen,440514107,56707,5483,46242,16334,81131,45323,28919,43311,88634,44867,91109
͸,LuGangZhen,440514108,93841,8660,70740,23325,128817,68269,39241,66808,135077,71002,141742
쳡,HongChangZhen,440514109,15402,1665,12120,4853,23126,12034,8230,11906,23940,13177,25297
,LeiLingZhen,440514110,21011,1877,17080,6733,31450,16928,11366,16845,33773,17174,34254
¤,LongTianZhen,440514112,77011,8980,60547,23130,110633,59467,34186,56474,115941,59630,120177
ֵ,FengXiangJieDao,440515001,110664,11039,72624,34463,114198,64990,25225,63810,128800,74304,146928
ֵ,GuangYiJieDao,440515002,46818,3789,30023,14488,36806,27320,10921,27399,54719,31505,61528
λֵ,ChengHuaJieDao,440515003,73626,6694,48862,23056,53013,44337,17072,42717,87054,48530,97392
ϻ,ShangHuaZhen,440515100,25702,3361,17706,7366,32128,16759,6507,16341,33100,17864,35570
¡,LongDouZhen,440515101,52562,7904,36645,17198,70154,36385,11955,35234,71619,35776,72421
,LianXiaZhen,440515102,88028,9886,58456,24930,106641,55550,19979,53906,109456,59437,117893
,LianShangZhen,440515103,41485,5060,27976,12187,52507,27177,8938,26076,53253,27507,55483
Ϫ,XiNanZhen,440515104,48170,6231,32320,15331,62529,32219,9962,31553,63772,32043,64363
,DongLiZhen,440515105,59961,8359,40367,21628,72205,38730,12201,37887,76617,40154,80521
κ,YanHongZhen,440515106,31264,4044,21609,9976,41171,21399,8071,21332,42731,21770,43379
,LianHuaZhen,440515107,17897,2729,12342,6191,23410,12262,4295,12339,24601,12579,24921
լ,HouZhaiZhen,440523100,27910,3874,18678,11621,33231,18214,5188,17422,35636,18294,36972
ư,YunAoZhen,440523101,10972,1486,7644,4388,14419,7627,2497,7293,14920,7311,14955
,ShenAoZhen,440523102,6141,999,4267,2473,8189,4249,1237,4100,8349,4110,8377
ʯֵ,ShiWanZhenJieDao,440604010,231932,15584,137544,94702,130429,122286,38710,126534,248820,148682,286226
鶽ֵ,ZhangChaJieDao,440604011,209438,7568,114659,53206,64565,70046,24143,74412,144458,126490,241149
ֵ,ZuMiaoJieDao,440604012,334148,36712,207075,128589,235185,169374,45940,168644,338018,209725,416800
ׯ,NanZhuangZhen,440604100,131943,7804,67697,35578,72053,48576,17155,52899,101475,89205,156902
ǽֵ,GuiChengJieDao,440605011,447682,23891,257660,164290,206351,215028,71202,221485,436513,285115,542775
޴ֵ,LuoCunJieDao,440605012,148328,7016,78608,43360,65919,58869,22457,63204,122073,99193,177801
Ž,JiuJiangZhen,440605121,140497,10421,77749,43920,91700,63514,19261,66667,130181,92430,170179
,XiQiaoZhen,440605122,181180,14738,104826,54883,133390,83757,25752,84202,167959,116844,221670
,DanZaoZhen,440605123,130005,9028,67657,38446,73623,50307,15922,53358,103665,87298,154955
ʨɽ,ShiShanZhen,440605124,374831,17259,185604,94483,155826,126737,40623,137201,263938,247109,432713
,DaLiZhen,440605125,511916,28310,287418,164836,243130,224576,74611,233829,458405,327419,614837
ˮ,LiShuiZhen,440605126,238120,12939,119391,56520,106648,78029,22855,82164,160193,154523,273914
׽ֵ̽,LunJiaoJieDao,440606003,151462,7820,86100,59247,77305,75582,25197,82297,157879,98379,184479
ֵ,LeLiuJieDao,440606004,214153,10404,115651,76157,102300,93213,27807,102091,195304,136713,252364
ֵ,DaLiangJieDao,440606005,328092,21334,192665,119329,204384,164319,54883,168475,332794,211644,404309
ݹֵ,RongGuiJieDao,440606006,380101,18970,209898,145100,190577,179505,50616,195251,374756,239789,449687
´,ChenCunZhen,440606101,109900,8570,63527,37318,70897,55486,17216,56888,112374,72159,135686
,BeiJiaoZhen,440606102,231729,9927,118094,74948,106498,95025,28654,105261,200286,152216,270310
ִ,LeCongZhen,440606103,215821,10654,114954,63248,98245,87476,33320,94946,182422,144841,259795
,LongJiangZhen,440606104,188019,8838,97602,69734,90523,84946,25024,96856,181802,124279,221881
̳,XingTanZhen,440606105,115774,10086,69813,31991,107237,57545,18677,58722,116267,74724,144537
,JunAnZhen,440606106,116709,8808,67123,35443,82744,53147,16219,56247,109394,74613,141736
Ͻֵ,XiNanJieDao,440607001,220623,20236,136549,84742,169157,120871,42960,121529,242400,147270,283819
ƶֵ,YunDongHaiJieDao,440607004,26764,1099,16649,4763,9191,6277,2090,6109,12386,13304,29953
,DaTangZhen,440607101,37159,4226,20899,12794,27248,17232,5319,18234,35466,25805,46704
ƽ,LePingZhen,440607103,111810,7873,53004,31649,58174,42321,14825,44256,86577,81504,134508
,BaiNiZhen,440607104,53781,2821,27641,20797,21385,24245,7823,27076,51321,36784,64425
«,LuBaoZhen,440607105,31023,4233,19341,12366,28386,17677,5370,17534,35211,21285,40626
ɽ,NanShanZhen,440607106,16618,2495,10687,6869,16858,9917,3497,10429,20346,11923,22610
ɳǽֵ,HeChengJieDao,440608004,224102,14322,127589,80297,145983,115367,40030,119134,234501,150865,278454
,YangHeZhen,440608106,43704,3708,25859,16390,27889,21390,5812,21317,42707,27365,53224
,MingChengZhen,440608107,32522,4316,19494,11956,30923,16991,5000,17708,34699,22344,41838
,GengHeZhen,440608108,34351,6183,21831,16983,37640,20956,5994,22436,43392,24697,46528
ֵֺ,CangHouJieDao,440703001,46647,6088,28675,18089,37848,24908,6830,24747,49655,30890,59565
ɳֵ,BaiShaJieDao,440703002,86388,8904,55489,33666,59387,49095,14499,48232,97327,54302,109791
̶ֵ,DiDongJieDao,440703003,59586,7110,39216,25213,53998,38119,10069,36500,74619,37549,76765
ֵֽ,BeiJieJieDao,440703004,45427,4130,28283,18125,31080,26468,8817,26617,53085,30091,58374
ֵ,ChaoLianJieDao,440703005,24810,1521,13994,7532,11458,10047,3064,10884,20931,15401,29395
нֵ,HuanShiJieDao,440703006,94347,5316,57139,37991,55113,53999,19760,55807,109806,62284,119423
,TangXiaZhen,440703101,58560,6398,37653,19208,59943,33286,11063,31990,65276,38368,76021
,HeTangZhen,440703102,70650,4529,40706,19736,42405,32038,12906,32761,64799,47379,88085
,DuRuanZhen,440703103,79988,4649,47324,31323,41601,44343,17090,47909,92252,54403,101727
Ͻֵ,JiangNanJieDao,440704001,24531,2487,15898,10658,17424,15519,4682,15184,30703,15802,31700
ͷֵ,JiaoTouJieDao,440704002,29119,1735,17512,9594,14933,14995,5118,15110,30105,18460,35972
򱱽ֵ,JiaoBeiJieDao,440704003,7251,602,4399,2484,3708,3711,1510,3909,7620,4964,9363
⺣ֵ,WaiHaiJieDao,440704004,78657,5020,45679,21517,45893,34153,10989,34713,68866,48987,94666
ֵֽ,LiLeJieDao,440704005,63242,5893,40324,22201,60843,39096,13477,40083,79179,42288,82612
ǽֵ,HuiChengJieDao,440705001,297131,30920,191600,121228,271003,182677,57126,180894,363571,193577,385177
,DaZeZhen,440705101,28825,3654,18738,11557,34080,18686,5198,18798,37484,18939,37677
˾ǰ,SiQianZhen,440705102,53103,6518,34505,20687,57112,32729,10314,31979,64708,35430,69935
޿,LuoKengZhen,440705103,24214,3831,15159,10347,26676,14246,3482,14350,28596,16368,31527
˫ˮ,ShuangShuiZhen,440705104,65650,10512,42673,30274,71660,40698,11133,41130,81828,44622,87295
,YaMenZhen,440705105,28198,4941,18706,11783,32036,17412,4824,17304,34716,19257,37963
ɳ,ShaDuiZhen,440705106,28609,3693,17249,10970,27907,16400,4655,16590,32990,19708,36957
ž,GuJingZhen,440705107,32286,4275,20160,12952,33364,18737,5466,19079,37816,21867,42027
,SanJiangZhen,440705108,33290,4786,20983,12992,39433,20344,5037,20848,41192,22130,43113
,MuZhouZhen,440705109,31856,4125,20457,12294,37076,19433,6136,19784,39217,21660,42117
,DaAoZhen,440705110,27254,2621,16848,9107,32016,16540,5492,17490,34030,18519,35367
̨ǽֵ,TaiChengJieDao,440781001,193577,17538,122837,76462,162953,115517,35729,116123,231640,124007,246844
,DaJiangZhen,440781100,36404,4811,23474,14273,43153,22843,5459,21836,44679,23200,46674
ˮ,ShuiBuZhen,440781101,32724,4923,21103,12986,37635,20437,4931,19736,40173,21475,42578
ľ,SiJiuZhen,440781102,28339,4538,18676,11429,33807,18153,4525,17702,35855,18726,37402
ɳ,BaiShaZhen,440781103,38536,6718,26611,16347,47972,26074,7208,24868,50942,25851,52462
,SanHeZhen,440781104,26508,4806,18092,10883,32401,17785,4901,17551,35336,18123,36215
,ChongLouZhen,440781105,24748,3663,16159,9645,27303,15533,4072,15191,30724,16324,32483
ɽ,DouShanZhen,440781106,36472,5324,23948,13820,42832,23472,6433,23673,47145,24281,48229
,DouHuZhen,440781107,32089,5072,20819,12220,40430,20770,5496,21639,42409,21838,42657
Ϫ,ChiXiZhen,440781108,26243,3299,15773,7603,29410,15302,4908,15242,30544,18677,34450
˷,DuanFenZhen,440781109,32963,6108,22940,14045,40640,22816,6658,22428,45244,22789,45729
㺣,GuangHaiZhen,440781110,32751,4656,21550,12280,37045,21043,6058,21022,42065,21915,43465
,HaiYanZhen,440781111,50318,9067,33882,21050,60971,33324,10198,34383,67707,35701,69583
,WenCunZhen,440781112,36103,6352,23987,15561,45637,23726,7110,25036,48762,25578,49565
,ShenJingZhen,440781113,39305,6993,25723,15909,50030,25574,6469,26409,51983,27044,52767
,BeiDouZhen,440781114,20187,3721,13306,7971,26534,13056,4183,14167,27223,14785,28091
,ChuanDaoZhen,440781115,20539,4402,13796,9859,26290,13424,3331,13958,27382,14476,28272
ũ,HuaQiaoNongChang,440781401,2694,545,1728,1446,2785,1727,390,1892,3619,1901,3629
ֵ,SanBuJieDao,440783001,133983,13046,87129,51187,107796,82873,26071,81961,164834,85971,173100
ɳֵ,ChangShaJieDao,440783002,95405,9089,62301,33773,65251,58458,20335,57780,116238,62528,124829
ɳ,ShaTangZhen,440783103,17343,3142,12456,7048,22630,12230,4182,11465,23695,12211,24667
Գ,CangChengZhen,440783104,19122,2999,13338,7509,22980,12954,4629,12544,25498,13412,26750
ʤ,LongShengZhen,440783105,17622,3325,13017,7788,22241,12514,5214,12306,24820,13144,26161
ɳ,DaShaZhen,440783106,14946,2913,11129,6274,20494,10985,4439,10631,21616,11169,22298
,MaGangZhen,440783107,20041,4799,15630,9742,28375,15248,5888,14484,29732,15098,30728
,TangKouZhen,440783108,16439,2948,11758,6597,20586,11670,3239,10610,22280,10868,22626
࿲,ChiKanZhen,440783109,28083,4545,18792,10264,30994,17620,4632,16466,34086,18468,37260
ٺ,BaiHeZhen,440783110,12283,2464,9142,5626,13792,8738,2874,7963,16701,8479,17621
,XianGangZhen,440783111,9871,1907,6117,3993,9983,5619,1502,5295,10914,7163,13280
,JinJiZhen,440783112,12312,1818,7910,4443,14921,7689,2363,7928,15617,8583,16493
ɽ,YueShanZhen,440783115,35267,4557,22843,11052,38654,20935,6876,20755,41690,23857,46700
ˮ,ChiShuiZhen,440783116,18605,3527,12700,8111,21810,12467,3762,12588,25055,13194,25894
ˮ,ShuiKouZhen,440783117,70701,7064,44529,23992,56622,39009,13070,38673,77682,46306,90835
ɳƺֵ,ShaPingJieDao,440784001,156760,12563,97095,58030,115966,86849,27832,87673,174522,100060,197155
,LongKouZhen,440784101,26957,4553,17633,10225,32460,17109,5115,17294,34403,18992,36625
,YaYaoZhen,440784102,30720,3323,18665,10304,25217,15944,4808,16453,32397,20186,38851
,GuLaoZhen,440784103,27676,3277,18320,9755,22199,14943,4653,14938,29881,17286,35606
Դ,TaoYuanZhen,440784104,20214,2326,12243,5820,18979,10244,3362,10369,20613,13659,25902
׳,HeChengZhen,440784105,24722,3330,15063,7395,21156,11814,4118,11920,23734,17107,32170
,GongHeZhen,440784106,35102,2428,18412,8565,18714,12028,3808,13029,25057,22926,41338
ַɽ,ZhiShanZhen,440784107,24567,2867,15090,8946,20404,13586,4575,13815,27401,16919,32009
լ,ZhaiWuZhen,440784108,17872,3308,12593,7950,23363,12260,5074,13155,25415,13661,26254
,YunXiangZhen,440784109,4054,531,2459,1398,3474,2111,822,2321,4432,2948,5407
˫,ShuangHeZhen,440784112,11560,2082,7824,5151,14772,7646,2933,8324,15970,8751,16575
Ӫ賡,YingDingChaChang,440784401,6734,64,666,609,6090,538,248,757,1295,6380,7046
ǽֵ,EnChengJieDao,440785001,154547,14436,94334,58541,173911,90786,28805,99337,190123,103454,197788
,HengBeiZhen,440785100,22642,4331,14764,11694,28682,14652,4721,16457,31109,16930,31694
ʥ,ShengTangZhen,440785101,18447,2772,11947,6943,23114,11850,3819,12858,24708,13091,25038
,LiangXiZhen,440785102,14146,2238,9571,5831,17993,9309,3707,10054,19363,10520,20091
ɳ,ShaHuZhen,440785103,41840,6668,27203,16408,42445,24894,7709,24729,49623,29014,56217
ţ,NiuJiangZhen,440785104,17492,2733,11245,6637,17641,10976,3205,11497,22473,12185,23430
,JunTangZhen,440785105,34871,5319,22810,14502,38555,22508,6285,23234,45742,23665,46475
,DaTianZhen,440785106,19860,3153,13308,8438,25469,13065,4930,13854,26919,14635,27943
Ǽ,NaJiZhen,440785107,14272,2164,9092,5534,18702,8772,2948,9661,18433,10292,19384
,DaHuaiZhen,440785108,13587,1963,8680,5366,14714,8251,3075,9239,17490,9945,18625
,DongChengZhen,440785109,19608,2760,12515,7230,21810,12303,3761,13163,25466,13614,26129
лֵ,ZhongHuaJieDao,440802001,22689,3164,14975,8904,21443,13392,4169,13461,26853,15047,30022
ֵ,CunJinJieDao,440802002,43003,3957,29631,11145,27466,15684,5473,15956,31640,22802,52433
ֵ,MinZhuJieDao,440802003,35036,3770,22489,15481,26893,21573,7667,22631,44204,23984,46473
ɽֵ,ZhongShanJieDao,440802004,21959,3433,15072,10537,18976,14969,5158,15361,30330,15478,30550
ɳֵ,ShaWanJieDao,440802005,18906,1773,12361,7697,10533,12036,5197,12876,24912,13515,25876
˳ֵ,DiaoShunJieDao,440802006,5293,601,3412,2092,4616,3231,1511,3618,6849,3993,7405
Žֵ,NanQiaoJieDao,440802007,60001,5893,38228,23180,44870,34775,13295,36925,71700,40961,79189
Žֵ,BeiQiaoJieDao,440802008,23074,2468,15503,7754,20288,15122,6334,15830,30952,16373,31876
Žֵ,JieFangJieDao,440803001,26411,4552,18390,12234,29076,17356,5703,17700,35056,18276,36666
ֵ,AiGuoJieDao,440803002,28982,4327,18825,13027,26959,18715,6196,20346,39061,20680,39505
ũֵ,GongNongJieDao,440803003,32756,4600,21800,14044,28873,20094,6746,20611,40705,22302,44102
ֵ,YouYiJieDao,440803004,43814,5517,27693,19382,41324,27393,10688,30236,57629,32326,60019
˽ֵ,XinXingJieDao,440803005,38286,4134,25653,16143,27143,24671,10306,25985,50656,27073,52726
ֵ,HaiBinJieDao,440803006,16010,1612,10420,6441,13722,9494,3247,9695,19189,10449,20869
ֵ,JianSheJieDao,440803009,33478,4719,22173,13898,27167,21488,8069,23208,44696,24093,46266
½ֵ,DongXinJieDao,440803010,38946,3288,24546,16649,26297,24404,9674,27043,51447,27362,51908
԰ֵ,XinYuanJieDao,440803011,37091,3835,22661,13220,25874,19727,6311,20375,40102,24576,47237
ͷֵ,HaiTouJieDao,440803012,13299,1277,8636,4371,14226,7815,3068,8394,16209,9008,17644
Ȫׯֵ,QuanZhuangJieDao,440803070,4239,273,2622,1674,1995,2231,779,2224,4455,2669,5291
ֵֻ,LeHuaJieDao,440803071,51350,3403,31733,18419,25539,27392,10107,28837,56229,33127,64860
ϵֵ,NanDiaoJieDao,440804001,23039,2200,14653,7099,27069,13697,5436,14790,28487,16022,30675
бֵ,MaXieJieDao,440804002,7580,917,4802,2532,9249,4717,1577,5135,9852,5272,10074
,NanSanZhen,440804100,52147,6717,36162,18294,72723,35527,16347,37781,73308,39049,75211
ͷ,PoTouZhen,440804101,43124,5540,28226,15080,54932,26973,10563,29952,56925,31001,59227
Ǭ,QianTangZhen,440804102,20885,2896,14679,8094,29015,14364,6335,15060,29424,15437,30116
ͷ,LongTouZhen,440804103,39932,4942,25873,14416,51968,24905,10285,27697,52602,29286,55159
ٶ,GuanDuZhen,440804104,38199,4418,24764,13130,49018,23531,9909,26172,49703,27762,52526
йʯ,ZhongGuoShiYou,440804400,15287,2380,9361,7962,17589,9327,2584,10632,19959,10890,20251
,MaZhangZhen,440811100,83220,6382,52668,20243,75410,38006,18217,42099,80105,55151,107819
̫ƽ,TaiPingZhen,440811101,57572,7160,41371,20228,82247,40298,22624,44036,84334,45985,87356
,HuGuangZhen,440811102,61989,5257,36568,15440,62568,28602,13100,30476,59078,43778,80346
ɽ,DongShanZhen,440811170,41181,5001,28858,14717,58541,28270,13628,30231,58501,30952,59810
,DongJianZhen,440811171,29811,3708,21260,11144,43484,20871,10518,22200,43071,22777,44037
,MinAnZhen,440811172,34942,4397,24465,12134,49500,23884,11257,25403,49287,26131,50596
,NaoZhouZhen,440811173,31623,3834,21560,10964,42163,21400,9217,22888,44288,23114,44674
ũ,HuGuangNongChang,440811450,8447,1869,6270,4407,10982,6088,2758,6587,12675,6804,13074
,SuiChengZhen,440823100,154779,15936,101296,47923,177484,83473,42188,92297,175770,111607,212903
,HuangLveZhen,440823101,55003,7714,39408,18475,78584,38897,19632,42090,80987,42941,82349
,YangQingZhen,440823102,41879,6842,30533,17005,60544,29858,14857,31941,61799,33045,63578
,JiePaoZhen,440823103,38291,7320,28121,15963,56717,27742,12826,29667,57409,30316,58437
,LeMinZhen,440823104,20912,3706,17026,8132,31944,16937,10277,17788,34725,17869,34895
,JiangHongZhen,440823105,17220,2828,13343,6196,25664,12756,7212,12992,25748,13917,27260
,YangGanZhen,440823106,52482,8784,39222,20388,77281,38248,19415,40074,78322,41459,80681
,ChengYueZhen,440823107,57368,8075,40742,21799,80124,40226,20225,44145,84371,44926,85668
,WuTangZhen,440823108,9302,1761,7001,4298,13664,7001,3378,7440,14441,7440,14441
,JianXinZhen,440823109,13460,1987,9610,5533,18647,9504,4968,10620,20124,10805,20415
뱱,LingBeiZhen,440823110,16450,2307,11615,6633,22337,11289,5725,12434,23723,12867,24482
,BeiPoZhen,440823111,28790,4920,21131,12912,41096,21058,10194,22674,43732,22773,43904
,GangMenZhen,440823112,19742,3396,15135,8382,29424,15028,7240,15112,30140,15243,30378
̶,CaoTanZhen,440823113,39377,6884,29549,16331,57742,29094,13437,29509,58603,30149,59698
ͷ,HeTouZhen,440823114,20710,2827,15358,7272,28639,14899,8422,15918,30817,16601,31959
ǰ˾,GuangQianGongSi,440823450,10180,2384,7333,5841,12504,7151,2840,7809,14960,8071,15404
ǽֵ,XuChengJieDao,440825001,88892,8511,56388,33915,85878,53009,21309,60205,113214,62324,118712
,MaiChenZhen,440825102,39339,5631,27796,13869,54254,27709,12947,29976,57685,30121,57917
,HaiAnZhen,440825103,16110,1669,10293,5848,18368,10103,4031,11295,21398,11517,21810
,QuJieZhen,440825104,30425,3475,20758,10388,39615,20664,9576,22620,43284,22718,43476
ǰɽ,QianShanZhen,440825105,25806,3320,18007,9406,35825,17981,8577,19634,37615,19696,37703
,XiLianZhen,440825106,23550,3546,17729,8005,34518,17729,9179,18546,36275,18546,36275
,XiaQiaoZhen,440825107,27478,2865,18580,9021,36401,18521,8430,20115,38636,20193,38773
,LongTangZhen,440825108,38447,4629,26918,13729,52930,26895,13159,29258,56153,29317,56235
,XiaYangZhen,440825109,17508,2640,12337,6512,24651,12337,5744,13555,25892,13555,25892
,JinHeZhen,440825110,27557,3806,19302,9932,38177,19289,9237,21269,40558,21298,40600
Ͱ,HeAnZhen,440825111,23086,2723,16038,7947,32288,16027,8017,17774,33801,17788,33826
,XinLiaoZhen,440825112,17104,2482,12733,6304,25230,12731,6909,13759,26490,13762,26495
ɽ,NanShanZhen,440825113,50790,5702,33361,15931,63461,32770,13741,35845,68615,36872,70233
Ǳ,ChengBeiXiang,440825201,26681,3099,18073,8889,37105,17831,8294,19558,37389,20001,38074
β,JiaoWeiXiang,440825204,18396,2781,12682,7052,25396,12666,4954,13403,26069,13449,26131
ϻũ,NanHuaNongChang,440825451,4205,816,3039,2179,3997,3031,1206,3137,6168,3188,6227
һũ,WuYiNongChang,440825452,2457,717,1835,1541,2687,1813,651,1912,3725,1990,3825
˾,HuaHaiGongSi,440825453,6466,1116,4396,3328,6150,4387,1631,4772,9159,4817,9213
Ѻũ,YouHaoNongChang,440825454,1776,515,1288,1092,1728,1270,419,1334,2604,1422,2710
ũ,HongXingNongChang,440825455,3077,538,2056,1511,3010,2044,732,2234,4278,2291,4347
ݽֵ,LuoZhouJieDao,440881001,94289,8878,56940,42853,100180,51733,20921,62840,114573,67148,124088
Ͻֵ,ChengNanJieDao,440881002,29105,3203,19348,10668,25132,19127,8872,21580,40707,21832,41180
Ǳֵ,ChengBeiJieDao,440881003,32757,2699,20297,11283,30808,18195,7996,20834,39029,23155,43452
ʯ,ShiChengZhen,440881101,45887,6404,32983,16284,64237,32981,17585,36876,69857,36893,69876
,XinMinZhen,440881102,26877,4633,20390,10071,39939,20040,11280,21770,41810,22400,42790
ˮ,JiShuiZhen,440881103,52235,5734,34886,15492,63041,32528,17179,35529,68057,40262,75148
Ӵ,HeChunZhen,440881104,55524,7968,38733,21707,76895,38192,19004,42866,81058,43763,82496
ʯ,ShiJiaoZhen,440881105,28349,4936,23432,12534,43218,23404,15119,24918,48322,24972,48404
,LiangDongZhen,440881106,75043,11920,52962,28098,109336,49825,27049,55720,105545,61050,114012
ɽ,HengShanZhen,440881107,73402,10965,53256,26607,105361,53044,27816,58536,111580,58927,112183
,AnPuZhen,440881108,71924,12289,51774,29987,97891,51622,22291,54476,106098,54730,106504
Ӫ,YingZaiZhen,440881109,47016,8035,36348,19729,68868,35856,19522,37334,73190,38225,74573
ƽ,QingPingZhen,440881110,67912,9624,47502,23553,87501,47179,24949,54488,101667,54983,102485
,CheBanZhen,440881111,24790,4181,18931,10374,38066,18817,10607,20455,39272,20647,39578
,GaoQiaoZhen,440881112,20112,3088,14796,9238,29639,14245,8189,15510,29755,16593,31389
ʯ,ShiLingZhen,440881113,61278,10155,44679,28011,89638,43311,24852,48990,92301,51606,96285
,YaTangZhen,440881114,25546,4099,19330,9542,37593,19159,10971,20837,39996,21286,40616
ʯ,ShiJingZhen,440881115,26579,4081,19636,10883,40377,19526,12033,22802,42328,23057,42693
ɽ,ChangShanZhen,440881116,29838,5796,23881,14457,47944,23799,16150,27715,51514,27903,51784
,TangPengZhen,440881117,42875,6547,31803,19251,63474,31519,20230,37319,68838,37849,69652
,HeLiaoZhen,440881118,18401,3768,16162,9710,31051,16124,11742,17684,33808,17749,33911
׳ǽֵ,LeiChengJieDao,440882001,60874,6426,38002,24526,68366,34083,15520,40707,74790,44818,82820
ֵ,XiHuJieDao,440882002,21708,1433,12464,8042,12318,10376,5036,13283,23659,15713,28177
³ǽֵ,XinChengJieDao,440882003,27350,1175,15762,11333,17931,14659,7448,18992,33651,20211,35973
ɳ,BaiShaZhen,440882100,47682,5295,34769,17959,67126,33047,20306,35914,68961,38514,73283
,ShenTangZhen,440882101,30735,3839,23082,11923,47095,22947,13548,24823,47770,25040,48122
·,KeLuZhen,440882102,70806,8590,50572,25157,101838,50163,27677,55707,105870,56501,107073
,YangJiaZhen,440882103,41728,5219,32208,15954,65377,32160,20302,34942,67102,35041,67249
Ƽ,TangJiaZhen,440882104,28224,3707,21532,10999,40514,21295,12753,22826,44121,23152,44684
ˮ,QiShuiZhen,440882105,26782,3901,20576,11393,39553,20545,11224,21286,41831,21331,41907
ͼ,JiJiaZhen,440882106,60106,8415,43939,21426,85427,43586,22933,46831,90417,47515,91454
,SongZhuZhen,440882107,36119,4639,28591,14352,55588,28381,17610,29258,57639,29777,58368
,NanXingZhen,440882108,53128,6980,40325,20996,77582,39987,22836,42142,82129,42619,82944
׸,LeiGaoZhen,440882109,27008,3784,20204,12004,39964,20168,11348,21787,41955,21936,42140
,DongLiZhen,440882110,49335,6684,37994,18604,72865,37795,22674,40182,77977,40699,78693
,DiaoFengZhen,440882111,36766,4855,28874,14167,55936,28673,18430,30661,59334,31177,60051
,LongMenZhen,440882112,52664,6145,38031,19481,72572,36879,21280,40372,77251,42058,80089
Ӣ,YingLiZhen,440882113,49768,5364,35250,17309,66235,34703,18237,37409,72112,38119,73369
,BeiHeZhen,440882114,46188,6172,34652,16983,69510,34262,19739,36718,70980,37447,72099
ʯ,WuShiZhen,440882115,47974,6633,35532,17094,70680,34350,19123,35420,69770,38198,73730
,QinDouZhen,440882116,29835,4039,22954,11122,45378,22939,13339,24259,47198,24259,47213
,FuChengZhen,440882117,64785,7235,49120,24145,93560,48499,29179,50860,99359,52079,101199
ȹ,HuaQiaoGuanLi,440882450,4209,589,2722,1562,2893,2036,887,2230,4266,2963,5685
ҵ,FengShouTangYe,440882451,6267,1031,4200,3611,5391,4182,1674,4717,8899,4772,8972
ũ,HuoJuNongChang,440882452,4269,507,2670,2229,4279,2641,1202,3146,5787,3308,5978
Ҹũ,XingFuNongChang,440882453,2942,424,1997,1501,2671,1970,916,2245,4215,2285,4282
ũ,DongFangHongNongChang,440882454,4843,952,3430,2842,5350,3371,1466,3750,7121,3831,7261
ũ,JinXingNongChang,440882455,3242,604,2325,1919,3831,2317,1003,2499,4816,2524,4849
÷Ǌֵ,MeiLuJieDao,440883001,103522,11359,63868,33256,123336,53970,26659,63552,117522,77672,141540
βֵ,TangWeiJieDao,440883002,20361,2794,15009,7021,28570,14602,7619,15254,29856,15765,30774
ɽֵ,DaShanJiangJieDao,440883003,16824,1714,11184,4851,20846,10887,5426,12120,23007,12780,23964
ֵ̽,BoPuJieDao,440883004,11765,1078,7308,2970,13826,7053,2769,7887,14940,8304,15612
ֵ,HaiBinJieDao,440883005,30810,2900,20066,8590,32370,17693,8035,20200,37893,21679,41745
ǳˮ,QianShuiZhen,440883100,19445,2915,15335,7202,29513,15115,8936,15693,30808,15961,31296
,ChangQiZhen,440883101,43916,5922,33290,14710,65046,33118,18817,34854,67972,35365,68655
,QinBaZhen,440883102,43075,5858,32009,15724,62047,31740,16481,32825,64565,33405,65414
,WangCunGangZhen,440883103,12401,2150,9462,5234,18151,9277,4966,9828,19105,10055,19517
,ZhenWenZhen,440883104,59027,8746,45366,22447,87850,45134,24094,45924,91058,46501,91867
,ZhangPuZhen,440883105,22839,3826,19524,9005,36905,19517,12179,19311,38828,19320,38844
,WuYangZhen,440883106,51524,7534,39365,18172,76848,38831,21461,40213,79044,41154,80519
׺,TangZhuiZhen,440883107,68254,9215,51448,24143,101340,51346,29966,55860,107206,55987,107435
,HuangPoZhen,440883109,91445,11985,67465,33291,131769,66234,35730,69698,135932,71695,139160
ʯ,LanShiZhen,440883111,20617,3113,14830,7122,30161,14736,7203,15898,30634,16103,30933
ֵ,HongQiJieDao,440902001,22456,2231,14437,10725,20689,13919,6201,15864,29783,16451,30888
ֵ,HeXiJieDao,440902002,17382,1629,11259,6897,14863,9518,4838,10638,20156,12590,23849
Ӷֵ,HeDongJieDao,440902003,68010,7186,44867,27577,77771,43084,18394,46796,89880,48723,93590
¶ֵ,LuTianKuangJieDao,440902004,12815,1955,7401,4502,11494,6312,2460,7371,13683,9829,17230
»ֵ,XinHuaJieDao,440902005,8104,1072,5147,3851,7213,5083,2358,5939,11022,6387,11534
ٶɽֵ,GuanDuJieDao,440902006,120593,11570,72852,40055,128145,63624,26645,70252,133876,85956,158808
վǰֵ,ZhanQianJieDao,440902007,59809,3127,39400,24218,57672,34784,16639,38590,73374,40175,79575
,JinTangZhen,440902100,40536,6018,29470,14853,56467,29157,14220,30510,59667,31304,60774
,GongGuanZhen,440902101,43688,5937,30750,15081,58437,30649,14167,32445,63094,33042,63792
,XinPoZhen,440902102,26386,3230,17767,9577,24920,17547,7083,18485,36032,18932,36699
ʢ,ZhenShengZhen,440902103,36950,4778,25965,12792,49633,25816,12119,27513,53329,27882,53847
ͷ,AoTouZhen,440902104,45405,6547,34257,16448,64324,34002,18507,35647,69649,36202,70459
ǻ,MeiHuaZhen,440902105,27872,3722,19910,8990,37657,19687,9250,20619,40306,20934,40844
ɽ,GaoShanZhen,440902106,12089,1388,8129,4285,13727,7951,3273,8355,16306,8621,16750
ɽ,ShanGeZhen,440902107,21465,2987,14808,7390,28195,14601,6585,15725,30326,16229,31037
ïϿ,MaoNanKaiFa,440902400,23607,1673,14703,8068,16894,13922,5865,15030,28952,16442,31145
Ϻֵ,NanHaiJieDao,440903001,20889,2647,14729,7019,26230,14229,6929,15220,29449,15736,30465
ߵؽֵ,GaoDiJieDao,440903002,21560,3018,15092,7337,29473,15010,6772,16181,31191,16258,31350
,YangJiaoZhen,440903101,81100,9014,58614,26871,107880,58535,30276,61632,120167,61776,120390
,PoXinZhen,440903102,43241,5986,32061,17218,61453,31889,16927,33754,65643,34093,66154
,QiJingZhen,440903103,41428,5165,29508,14002,58166,29240,14781,31307,60547,31866,61374
С,XiaoLiangZhen,440903104,30879,4350,22504,10590,43062,22132,11572,23549,45681,24297,46801
ɳԺ,ShaYuanZhen,440903105,26812,4058,19307,8730,37575,19241,9371,20763,40004,20934,40241
̤,MaTaZhen,440923100,39304,5069,31488,15625,62054,31271,20944,33210,64481,33829,65317
,LingMenZhen,440923101,42849,5083,33537,15352,68230,33047,22067,35663,68710,36462,69999
,ShuZaiZhen,440923104,41246,4254,27931,12826,57871,27912,15342,32894,60806,32911,60842
,MaGangZhen,440923106,42533,4794,28733,13468,59428,28410,14889,32954,61364,33483,62216
,DanChangZhen,440923107,39695,5617,28093,13298,56346,27329,14145,29946,57275,31364,59457
ϼ,XiaDongZhen,440923115,55277,8121,41440,21257,80118,40555,22204,43006,83561,44162,85602
,GuanZhuZhen,440923116,49670,7551,37759,20160,73434,36502,22820,40206,76708,42282,80041
ɳ,ShaLangZhen,440923117,41428,6358,31261,16565,56854,30936,17018,33227,64163,33543,64804
,HuangLingZhen,440923118,18634,3404,15136,9192,28323,15060,9617,15988,31048,16519,31655
,WangFuZhen,440923119,14479,2758,11819,7462,23761,11813,7884,13270,25083,13302,25121
޿,LuoKengZhen,440923120,17170,2430,12909,6852,25245,12693,7610,13774,26467,14301,27210
ǻ,NaHuoZhen,440923121,30576,4818,23427,15685,46702,23005,14251,25491,48496,26218,49645
ˮ,ShuiDongZhen,440923123,109858,10772,68672,39956,117471,60602,25402,70680,131282,77360,146032
,BoHeZhen,440923125,47334,5269,31393,15501,65040,30544,14730,34700,65244,35940,67333
ͷ,LinTouZhen,440923126,76020,10791,54696,28014,108085,53013,27655,57471,110484,59770,114466
,DianChengZhen,440923127,97942,11038,69826,33471,145268,69689,40521,79321,149010,79675,149501
´,ChenCunZhen,440923128,34915,3833,23932,10640,47928,23900,10703,25514,49414,25519,49451
ũ,ShuGuangNongChang,440923451,3482,830,2695,2418,5550,2683,1449,3054,5737,3066,5761
ˮũ,ShuiFengNongChang,440923452,1387,333,988,863,2081,952,457,1169,2121,1189,2177
γ,DianBaiYanChang,440923454,1574,300,455,631,1989,443,212,899,1342,1631,2086
ʯֵ,ShiZaiLingJieDao,440981002,33266,3033,19976,8469,31555,15481,7791,16729,32210,24114,44090
ɽֵ,ShanMeiJieDao,440981003,15680,1972,10711,4950,17900,9474,4161,9909,19383,11102,21813
ɽֵ,JinShanJieDao,440981006,28692,3872,19396,9572,34359,17354,8533,18236,35590,21701,41097
ݽֵ,PanZhouJieDao,440981007,115259,11153,72806,44167,115124,62889,31086,71978,134867,84692,157498
ֵ,BaoGuangJieDao,440981008,46318,6994,33742,18099,62552,30985,15451,33314,64299,35021,68763
л,XieJiZhen,440981100,29480,5841,21001,12403,42817,20726,8996,22799,43525,23316,44317
,XinDongZhen,440981101,30967,6940,24442,15488,48005,23026,13131,24477,47503,26596,51038
̶,YunTanZhen,440981102,18412,3680,15362,9871,29535,15353,9762,16485,31838,16492,31854
ֽ,FenJieZhen,440981103,27667,4326,19697,10647,36236,18624,8414,19382,38006,20710,40407
,GenZiZhen,440981104,31386,6541,24090,15017,47578,23570,12157,25031,48601,25994,50084
ˮ,SiShuiZhen,440981105,29740,5592,22381,12772,44365,22273,10900,23685,45958,23851,46232
,ZhenJiangZhen,440981107,21110,4057,16709,9409,33484,16048,10449,17814,33862,18907,35616
ɳ,ShaTianZhen,440981109,16118,3596,13280,8410,25883,12671,7911,13483,26154,14345,27625
,NanTangZhen,440981110,27517,5119,20807,12317,40880,20084,11490,21871,41955,23319,44126
ɻ,HeHuaZhen,440981111,18743,3371,15782,9041,29984,15379,10325,15859,31238,16657,32439
ʯ,ShiBanZhen,440981112,16819,3398,14616,8180,27160,14303,9595,14650,28953,15196,29812
,DaJingZhen,440981115,23676,4608,18375,11301,36117,17544,9745,18396,35940,19654,38029
̶ͷ,TanTouZhen,440981116,15873,3375,14019,7787,26754,13621,9470,13999,27620,14699,28718
,DaPoZhen,440981119,27856,6026,24752,14567,47630,24305,16848,25084,49389,25978,50730
ƽɽ,PingShanZhen,440981120,16227,3111,12790,7902,25688,12715,7413,13809,26524,13961,26751
,ShenZhenZhen,440981121,12783,2294,10044,6116,19885,9987,5786,10669,20656,10819,20863
,MaGuiZhen,440981122,14464,2958,12102,6832,23130,11841,7799,12413,24254,13119,25221
Ŷ,GuDingZhen,440981123,13681,2803,11643,6572,23132,11214,7707,11762,22976,12548,24191
ܽ,CaoJiangZhen,440981124,36323,6108,26269,14535,51415,25267,11873,26492,51759,28035,54304
,HeTangZhen,440981126,14225,3019,12331,7041,24036,12132,8247,12760,24892,13160,25491
ʯ,ShiGuZhen,440981127,62487,9549,44754,23355,84814,40889,23147,44752,85641,50429,95183
,DongAnZhen,440981128,34939,7124,28765,17192,57176,28201,17157,29220,57421,30455,59220
,ChangPoZhen,440981129,44185,7466,32507,19507,64332,31639,15265,33000,64639,34409,66916
Žũ,TuanJieNongChang,440981450,1877,347,1291,904,2354,1247,482,1351,2598,1415,2706
ʤũ,ShengLiNongChang,440981451,861,228,669,511,1182,667,305,725,1392,725,1394
ũ,HuoXingNongChang,440981452,1534,269,950,741,1332,843,334,994,1837,1187,2137
ֵ,HeXiJieDao,440982001,74805,7026,46593,21048,90512,36076,20094,41003,77079,55332,101925
ɽֵ,DongShanJieDao,440982002,39185,4829,26515,13709,52379,22608,12982,25717,48325,30481,56996
¹ֵ,XiaGuoJieDao,440982003,27652,3489,18770,9608,33382,18501,8886,20906,39407,21257,40027
ʢֵ,NanShengJieDao,440982004,17465,3192,13614,7226,27211,13529,7632,14534,28063,14675,28289
ʯֵ,ShiWanJieDao,440982005,22780,3746,18553,9044,36191,17710,12079,19034,36744,20052,38605
,ChangQiZhen,440982100,26476,4240,20138,11028,40777,19948,11037,21378,41326,21615,41753
ͬ,TongQingZhen,440982101,35149,4990,27445,13114,54227,27225,16173,28540,55765,28867,56312
÷,YangMeiZhen,440982102,42909,6742,33858,17651,66088,33847,18800,34583,68430,34593,68451
,LiangGuangZhen,440982103,34096,5282,28686,14267,54390,28478,18091,28523,57001,28783,57469
,DaQiaoZhen,440982104,21358,3734,16871,9384,33628,16729,10306,18276,35005,18527,35398
,LiGangZhen,440982106,23791,3603,19244,9767,39091,19072,12328,20092,39164,20478,39722
°,XinAnZhen,440982107,28958,5447,22316,13934,44676,21728,12166,23590,45318,24255,46571
,GuanQiaoZhen,440982108,24416,4236,20003,11221,39515,19471,12912,20869,40340,21561,41564
ֳ,LinChenZhen,440982110,33880,5778,27242,14640,54327,26686,16390,28023,54709,28806,56048
Ͻ,HeJiangZhen,440982112,40642,7406,34836,18662,68381,34063,23705,35643,69706,36917,71753
,NaWuZhen,440982113,31435,6322,27237,16690,52904,26670,17901,27585,54255,28421,55658
,BoYangZhen,440982114,21669,3804,18116,9593,35388,18012,11976,19141,37153,19333,37449
,BaoWeiZhen,440982115,9110,1911,7992,4632,15115,7731,5397,7964,15695,8426,16418
ƽ,PingDingZhen,440982116,42725,7623,36237,19845,70189,35662,24564,37895,73557,38675,74912
¥,WenLouZhen,440982117,28937,5324,22728,13825,46093,22534,14550,25665,48199,26083,48811
,JiangHuZhen,440982118,11365,2182,9704,5215,18562,9508,6290,9809,19317,10133,19837
,ZhongDongZhen,440982120,49127,9303,43842,21435,85035,42619,29763,42581,85200,44351,88193
�,JianJiangKaiFa,440982400,27812,2837,18956,8269,29900,15096,9030,15612,30708,20723,39679
ʱũ,XinShiDaiNongChang,440982401,2187,638,1787,1359,3107,1768,884,1896,3664,1922,3709
»ũ,XinHuaNongChang,440982402,1073,266,882,619,1564,882,450,907,1789,907,1789
ƽũ,HePingNongChang,440982403,1604,493,1326,1197,2595,1326,648,1419,2745,1419,2745
ũ,HongYangNongChang,440982404,856,312,681,608,1396,681,256,743,1424,743,1424
ũ,HongFengNongChang,440982405,2305,508,1852,1028,3362,1591,1153,1781,3372,2114,3966
ũ,JianSheNongChang,440982406,2114,350,1542,1022,2758,1537,872,1787,3324,1794,3336
ֵ,DongZhenJieDao,440983001,155707,15770,107818,54872,177709,92630,51157,98900,191530,114816,222634
¡,ZhenLongZhen,440983101,24391,4396,20830,10879,37630,20375,12759,20014,40389,20716,41546
ˮ,ShuiKouZhen,440983102,30309,5281,24817,14135,49100,24632,14432,24834,49466,25205,50022
,DingBaoZhen,440983105,18644,3121,15955,8873,30013,15645,10240,15666,31311,16050,32005
ض,ChiDongZhen,440983106,28454,5412,24473,14396,46774,24458,15089,24462,48920,24482,48955
,GuiZiZhen,440983112,15857,3212,13301,7073,25688,13082,7654,12926,26008,13422,26723
,HuaiXiangZhen,440983113,33200,6238,28267,16304,52974,28043,17498,28230,56273,28669,56936
ɽ,ChaShanZhen,440983114,10729,2429,9020,4518,17602,8784,5148,8794,17578,9286,18306
,HongGuanZhen,440983115,14426,3473,13064,8004,25431,12706,8755,13064,25770,13590,26654
ʯ,BaiShiZhen,440983116,22536,4771,20859,11397,38733,20432,14030,19839,40271,20478,41337
,DaChengZhen,440983117,15175,3634,13923,7824,26896,13771,9424,14034,27805,14310,28233
Ǯ,QianPaiZhen,440983118,28612,4018,22495,11094,44849,22360,13786,23732,46092,23921,46416
ˮ,HeShuiZhen,440983119,16961,3340,14651,8238,27996,14559,9476,14945,29504,15126,29777
±,XinBaoZhen,440983120,13437,2860,12306,6588,23503,12106,8955,12608,24714,12946,25252
ƽ,PingTangZhen,440983121,16597,3801,15672,8571,30369,15581,11484,16079,31660,16210,31882
˼,SiHeZhen,440983122,15467,2541,13318,6883,26153,13147,9183,13549,26696,13873,27191
,JinDongZhen,440983123,23506,5632,21738,14299,41354,21548,14125,21230,42778,21525,43263
ɰ,ZhuShaZhen,440983124,32551,7340,29223,16239,55145,28856,18492,28420,57276,29160,58383
,BeiJieZhen,440983125,31880,5864,27863,15257,53602,27094,17554,26513,53607,27435,55298
йӪũ,XinYiShiGuoYingHongQiNongChang,440983400,1862,295,1370,802,2173,1348,738,1517,2865,1525,2895
Ƕֵ,DuanZhouQuChengDongJieDao,441202001,70892,9595,47208,31645,67246,46391,14305,45859,92250,47584,94792
Ǳֵ,DuanZhouQuChengBeiJieDao,441202002,89522,11202,58604,35914,77812,52527,17202,52044,104571,59322,117926
ֵ,DuanZhouQuChengXiJieDao,441202003,85371,8383,55565,36058,66421,50954,17369,51956,102910,55558,111123
Ͻֵ,DuanZhouQuChengNanJieDao,441202004,2940,458,1514,1040,2817,1447,316,1455,2902,2200,3714
Ƹ,DuanZhouQuHuangGangZhen,441202100,72805,4235,43459,20714,36307,31365,11232,32786,64151,44813,88272
,DuanZhouQuMuGangZhen,441202101,51698,3659,30549,15699,31228,24152,8158,25052,49204,32966,63515
ӿڽֵ,KengKouJieDao,441203001,17602,1313,10256,5487,12794,8690,3491,8862,17552,12150,22406
ǽֵ,GuiChengJieDao,441203002,24304,1628,14939,6511,16978,10355,3998,10898,21253,14991,29930
ֵ,GuangLiJieDao,441203003,19394,3077,12792,7199,22445,11173,3304,10939,22112,12983,25775
,YongAnZhen,441203101,22626,3062,14016,8428,23625,12604,4044,12517,25121,15716,29732
ɳ,ShaPuZhen,441203102,10945,2167,7552,5599,14485,7367,2486,7288,14655,8046,15598
,FengHuangZhen,441203103,6753,978,4385,2569,7927,4161,1379,4282,8443,4725,9110
,LianHuaZhen,441203104,24651,2514,15479,8073,24330,13278,4974,14134,27412,16660,32139
ɳ,PaiShaZhen,441223100,13256,3118,10168,7083,19054,9782,4153,9458,19240,10359,20527
ʯ,ShiJianZhen,441223101,8010,1278,5306,3188,10042,4751,1973,4378,9129,5955,11261
̶,TanBuZhen,441223102,14061,2881,9762,6459,19859,9024,3902,9432,18456,11082,20844
,JiangTunZhen,441223103,18965,3161,13347,7628,26016,12885,5780,13652,26537,14559,27906
,LianHeZhen,441223104,9950,2057,7250,4932,13592,7065,3242,7441,14506,7999,15249
ݸ,LuoGangZhen,441223105,6282,1258,4508,2671,8742,4331,1902,4457,8788,4934,9442
,BeiShiZhen,441223106,10861,1732,7905,4813,15291,7859,3865,8315,16174,8553,16458
ӿ,KengKouZhen,441223107,13388,2750,10496,7502,19427,10476,4864,10385,20861,10506,21002
,ChiKengZhen,441223108,7738,1770,6117,4414,11713,5994,3088,6072,12066,6479,12596
Ͻ,NanJieZhen,441223109,87396,9919,57882,33184,101624,55463,20944,57400,112863,60377,118259
,BinHengZhen,441223110,18726,3235,13546,8328,26089,13157,5301,12546,25703,13716,27262
,WuHeZhen,441223111,11832,1827,8785,4725,16253,8482,3980,8155,16637,8854,17639
ɽ,HengShanZhen,441223112,23583,3645,17063,10207,33208,16456,7127,15921,32377,17292,34355
ľ,MuGeZhen,441223113,7465,1500,6433,4065,11459,6423,3669,6153,12576,6201,12634
ʯ,ShiJuZhen,441223114,5411,1154,4769,3017,8406,4736,2707,4413,9149,4503,9272
ˮ,GuShuiZhen,441223115,23449,3926,16933,10176,32333,16198,7959,16249,32447,18401,35334
,ZhouZaiZhen,441223116,8823,1739,6906,4404,13154,6754,3339,6550,13304,6995,13901
,HuaiChengZhen,441224100,102656,12427,70238,36527,137303,68851,31756,72358,141209,76601,146839
բ,ZhaGangZhen,441224101,10691,1243,8795,4112,17226,8683,5731,8584,17267,8870,17665
,AoZaiZhen,441224102,21132,2682,16624,7654,31679,16294,8963,15326,31620,16153,32777
,WenLangZhen,441224103,11323,1216,6308,2999,12143,6108,4003,5527,11635,10234,16542
,GanSaZhen,441224104,9770,1940,9205,5135,16825,9050,5719,7835,16885,8224,17429
,FengGangZhen,441224105,18256,2614,15511,7987,29339,15254,9607,14083,29337,14966,30477
Ǣˮ,QiaShuiZhen,441224106,16957,1904,13989,6034,26696,13761,9332,13487,27248,14204,28193
,LiangCunZhen,441224107,39601,5458,33076,15236,62846,31944,19893,29813,61757,31876,64952
,DaGangZhen,441224108,32365,4816,31327,15792,56440,31186,22274,27616,58802,28128,59455
ƺ,GangPingZhen,441224109,17772,2531,15629,8667,29453,15597,9813,14326,29923,14487,30116
,LengKengZhen,441224110,57655,7106,49947,23648,93024,49097,31120,43948,93045,45934,95881
,MaNingZhen,441224111,23561,2891,21056,9623,38412,20796,12461,17452,38248,17857,38913
,LanZhongZhen,441224112,10674,1616,8819,4775,17552,8796,5303,8523,17319,8774,17593
,YongGuZhen,441224113,20297,2701,19164,8121,35068,19020,13711,16903,35923,17545,36709
ʫ,ShiDongZhen,441224114,31562,3976,28490,11306,52035,28443,18809,25328,53771,25857,54347
ͷ,QiaoTouZhen,441224115,27811,3576,23046,9945,42985,22846,13260,21010,43856,21601,44647
,ZhongZhouZhen,441224116,24114,3414,20528,10108,38180,20364,12996,19451,39815,19996,40524
,LianMaiZhen,441224118,18145,2405,16795,8299,30471,16555,11844,14995,31550,15599,32394
˧׳,XiaShuaiZhuangZuYaoZuXiang,441224200,4468,708,3812,2151,7483,3753,2403,3577,7330,3767,7579
,JiangKouZhen,441225100,47387,6359,31361,21438,56154,31043,11414,33023,64066,33799,65160
,JiangChuanZhen,441225101,5372,1125,3967,2652,7789,3924,1789,4219,8143,4319,8286
׹,BaiGouZhen,441225102,7407,1445,6074,3542,10650,6057,3273,5967,12024,6051,12125
,DaZhouZhen,441225103,7651,1494,6261,3828,11463,6261,3369,6253,12514,6253,12514
,YuLaoZhen,441225104,11791,1875,8977,5204,16660,8909,4521,9032,17941,9210,18187
Ӷ,HeErKouZhen,441225105,13953,1904,10618,5543,20017,10618,5626,10865,21483,10865,21483
,LianDouZhen,441225106,14895,2271,12226,5937,22673,11982,7672,12073,24055,12612,24838
ӻ,XingHuaZhen,441225107,13931,3306,11719,7778,21756,11719,6040,11545,23264,11558,23277
޶,LuoDongZhen,441225108,13217,2575,10628,5996,19869,10602,5413,10418,21020,10577,21205
,ChangGangZhen,441225109,13694,2111,10085,5397,18369,10013,4692,10162,20175,10412,20497
ƽ,PingFengZhen,441225110,10781,1990,8299,5519,15254,8294,4130,8536,16830,8602,16901
Ϸ,NanFengZhen,441225111,42179,8083,36210,20911,65078,36171,21217,35054,71225,35269,71479
,DaYuKouZhen,441225112,6925,1288,5489,3352,10341,5401,3066,5586,10987,5790,11279
ƽ,DouPingZhen,441225113,5423,1045,4430,2669,7633,4427,2445,4468,8895,4483,8913
װ,JinZhuangZhen,441225114,15881,3270,14008,8136,24408,13934,8096,12921,26855,13239,27247
,ChangAnZhen,441225115,21286,3828,17390,9287,31428,17390,9753,17477,34867,17477,34867
³ǽֵ,DeChengJieDao,441226001,42363,5078,29005,15939,45736,27722,11437,28449,56171,29873,58878
,XinWeiZhen,441226101,16479,2081,11678,6170,21057,11601,5332,12070,23671,12214,23892
,HuiLongZhen,441226102,11220,1948,8414,4739,15314,8150,4233,8424,16574,8987,17401
,GuanWeiZhen,441226103,19874,3177,14794,7910,26584,14372,7328,14765,29137,15585,30379
,MaWeiZhen,441226105,13733,1912,9730,4603,18730,9560,4569,10233,19793,10484,20214
,GaoLiangZhen,441226106,19050,2929,13768,7620,25806,13711,6965,14995,28706,15176,28944
Ī,MoCunZhen,441226107,19204,2692,13973,8000,26042,13590,6729,13692,27282,14652,28625
,YongFengZhen,441226109,12720,1907,9692,5871,17588,9562,5297,9882,19444,10232,19924
¢,WuLongZhen,441226110,9361,1572,6823,4195,13112,6685,3274,7060,13745,7384,14207
ֲ,BoZhiZhen,441226111,9548,1647,7501,4417,13667,7292,4113,7394,14686,7807,15308
,FengCunZhen,441226112,17356,2818,13087,8397,23937,13085,7170,14245,27330,14257,27344
ó,YueChengZhen,441226113,21116,3299,15351,7594,28375,14931,7129,15682,30613,16193,31544
,JiuShiZhen,441226114,15847,2765,11969,6947,21849,11764,5939,11837,23601,12582,24551
ϰֵ,NanAnJieDao,441283001,66379,4450,38986,20315,61429,30772,11057,32846,63618,42900,81886
̨,HeTaiZhen,441283100,23692,2896,16105,8068,31504,16087,7072,17532,33619,17555,33660
ֳ,LeChengZhen,441283101,17015,2566,12036,6635,23480,11850,4756,11857,23707,12301,24337
ˮ,ShuiNanZhen,441283102,8318,1272,5700,3406,11355,5680,2008,5699,11379,5898,11598
»,LuBuZhen,441283103,46847,6718,30180,16389,60655,28552,9923,29522,58074,33308,63488
С,XiaoXiangZhen,441283105,22486,3028,15066,7309,28356,14392,5450,14669,29061,15898,30964
,DaWanZhen,441283106,25220,3580,16971,9037,33004,16560,5735,16684,33244,17564,34535
,XinQiaoZhen,441283107,28457,4088,18800,11251,36639,18381,6720,19235,37616,20465,39265
,BaiZhuZhen,441283108,26142,3825,17897,10068,33952,17216,7010,17801,35017,19080,36977
,LianTangZhen,441283109,41952,5931,28236,14803,56656,27834,10546,28895,56729,30193,58429
,HuoDaoZhen,441283110,28704,5011,20139,12477,40271,20122,7643,21179,41301,21219,41358
,JiaoTangZhen,441283111,24187,2904,16083,8595,28947,14800,5969,15174,29974,16977,33060
,HuiLongZhen,441283112,18241,2626,12323,6848,23042,11827,4559,12410,24237,13103,25426
,BaiTuZhen,441283113,51653,6886,34556,17913,63483,32720,12891,33568,66288,36874,71430
,JinDuZhen,441283114,30959,4580,20923,12336,37941,19268,8084,19938,39206,22700,43623
,JinLiZhen,441283115,72713,6070,42621,18747,68082,34762,15009,37191,71953,51171,93792
,XianGangZhen,441283116,20877,3051,13624,8428,25987,12944,5364,13670,26614,15668,29292
нֵ,ChengZhongJieDao,441284001,79706,7615,46131,28207,64573,43224,14107,44044,87268,55297,101428
ǽֵ,DongChengJieDao,441284002,109022,7148,66346,40890,58108,62329,26407,67300,129629,76231,142577
ɽֵ,ZhenShanJieDao,441284003,27208,3029,17477,9067,23007,15554,5685,15729,31283,18445,35922
,LongFuZhen,441284100,14173,1680,8446,4501,12713,6839,2126,6975,13814,9533,17979
ض,DiDouZhen,441284101,12892,2852,9102,6683,17468,8959,2607,8879,17838,9249,18351
,WeiZhengZhen,441284102,8611,1450,5999,4203,11472,5977,1986,5916,11893,6048,12047
Դ,LuoYuanZhen,441284103,4027,1041,2882,2134,5159,2716,877,2669,5385,3063,5945
ɿ,JingKouZhen,441284104,8956,1978,6260,4873,11972,6079,1735,6131,12210,6409,12669
ɳ,DaShaZhen,441284105,36571,3160,20444,12939,26771,18196,6389,19589,37785,25676,46120
ʯ,ShiGouZhen,441284107,10848,2350,7812,5804,14093,7693,2972,7889,15582,8358,16170
,HuangTianZhen,441284108,7619,1450,5282,3562,10123,5185,1674,5250,10435,5461,10743
,JiangGuZhen,441284110,19018,4158,13584,9955,25756,13367,4001,13112,26479,13593,27177
,XiaMaoZhen,441284113,17364,3386,12077,8070,22024,11678,3829,11597,23275,12502,24579
¼ҵ,ZhaoQingGaoXinJiShuChanYeKaiFaQu,441284450,59524,2580,29711,17704,23077,23260,9062,26061,49321,41455,71166
Ŷֵ,QiaoDongJieDao,441302001,75589,6636,50404,31255,55405,46251,18149,46392,92643,49970,100374
ֵ,QiaoXiJieDao,441302002,118941,11205,79496,56001,108836,74371,29445,73737,148108,80095,159591
Ͻֵ,JiangNanJieDao,441302003,55642,5413,36323,22732,42568,33971,13547,34596,68567,38279,74602
ֵ,JiangBeiJieDao,441302004,83652,3314,51301,28771,35297,40345,17528,42148,82493,53193,104494
ֵ,LongFengJieDao,441302005,61658,4435,39690,25887,45466,36720,14960,37135,73855,41363,81053
ϰֵ,HeNanAnJieDao,441302006,142660,5888,86739,52651,63934,74914,33207,78901,153815,95016,181755
ݻֵ,HuiHuanJieDao,441302007,157084,1951,81219,52441,20299,48275,14817,58051,106326,92633,173852
½ֵ,ChenJiangJieDao,441302008,117347,3192,66781,38895,31483,47697,18155,53764,101461,71913,138694
ˮڽֵ,ShuiKouJieDao,441302009,110938,5709,66216,38560,50024,52412,20639,57216,109628,71070,137286
Сڽֵ,XiaoJinKouJieDao,441302010,83360,3695,50172,25949,31592,40006,18499,43738,83744,55382,105554
,RuHuZhen,441302100,33334,4011,22084,12110,32583,19675,8645,20239,39914,23906,45990
,SanDongZhen,441302103,27954,1988,15893,7554,18158,13053,5468,13539,26592,19517,35410
,TongHuZhen,441302106,26566,2168,16139,9385,22094,15149,6972,16569,31718,19567,35706
,LiLinZhen,441302107,47159,1998,25896,16700,19101,22183,8319,24934,47117,31580,57476
�,MaAnZhen,441302109,45639,3141,24709,10361,23494,16682,6634,17150,33832,30705,55414
,HengLiZhen,441302110,29138,5417,21616,12296,39425,21067,9933,21745,42812,22872,44488
«,LuZhouZhen,441302112,9802,2356,7749,5208,14353,7687,3732,7945,15632,8141,15890
,TongQiaoZhen,441302114,23823,1218,13577,8400,9278,11682,5294,13151,24833,16758,30335
ֳ,HuiZhouShiLinChang,441302450,1604,61,795,661,69,664,189,816,1480,1059,1854
ˮֵ,DanShuiJieDao,441303001,176094,9402,108153,61856,80868,95273,41207,99446,194719,118550,226703
ﳤֵ,QiuChangJieDao,441303002,68920,2467,34972,19283,23268,25956,9837,29509,55465,46252,81224
,DaYaWanAo,441303006,47070,2534,25411,15207,24971,22602,9162,24286,46888,33355,58766
ϼ,DaYaWanXia,441303007,15069,1264,8657,5819,11166,8144,2971,8976,17120,10647,19304
ɳ,ShaTianZhen,441303101,23418,1282,13983,8109,9954,11336,4576,12411,23747,15293,29276
,XinWeiZhen,441303103,71374,2137,36273,20454,19787,24960,9772,28287,53247,47010,83283
¡,ZhenLongZhen,441303104,38518,2577,21911,9243,24240,15908,5887,16229,32137,25071,46982
,YongHuZhen,441303108,18676,2441,12625,6049,20349,11644,4458,11580,23224,12950,25575
,LiangJingZhen,441303109,17711,2894,12399,7410,21989,12029,4438,12045,24074,12644,25043
ƽ̶,PingTanZhen,441303110,22795,3329,15602,8636,26878,14744,6147,15121,29865,16669,32271
�,HuiYangJingJi,441303570,19522,598,9826,4695,6166,5401,1853,6121,11522,12147,21973
,DaYaWanXi,441303580,103532,1819,48117,24187,18486,26193,9065,31160,57353,66299,114416
ʯ,ShiBaZhen,441322100,25584,4178,19521,10629,35649,18827,9387,18650,37477,19628,39149
,MaBeiZhen,441322102,14292,2279,10782,6166,17869,10338,5119,10031,20369,10908,21690
,GuanYinGeZhen,441322103,10872,2404,8435,5686,15466,8371,4033,8706,17077,8874,17309
ׯ,GongZhuangZhen,441322104,32762,5064,22762,12864,40817,21404,8987,21812,43216,24051,46813
,YangCunZhen,441322105,28882,4219,20285,11420,35540,19522,8857,20261,39783,21673,41958
,BaiTangZhen,441322106,33039,5474,24259,13971,43441,22814,11500,23267,46081,25754,50013
̩,TaiMeiZhen,441322108,23404,3606,16712,9103,29212,15916,7159,16090,32006,17457,34169
,LuoYangZhen,441322110,161835,12346,99867,54369,119656,82961,34558,86553,169514,108872,208739
,HuZhenZhen,441322113,42291,4462,26177,13241,42686,22442,9798,23579,46021,30374,56551
,ChangNingZhen,441322115,28695,2898,19177,11341,26872,18337,8390,19426,37763,20806,39983
,FuTianZhen,441322116,28228,2138,18322,9286,28502,16196,7920,17125,33321,19964,38286
,LongHuaZhen,441322117,19008,1691,12092,6490,17741,10410,5310,11032,21442,13917,26009
Ϫ,LongXiZhen,441322118,68075,4554,40810,19555,53012,33368,16335,35685,69053,48154,88964
԰,YuanZhouZhen,441322119,119242,5581,66341,38237,59892,50505,21230,56076,106581,79712,146053
ʯ,ShiWanZhen,441322121,99272,5175,56358,26524,53601,41068,18355,43701,84769,66444,122802
,YangQiaoZhen,441322122,20341,3265,14497,9486,21919,13866,6262,14266,28132,15371,29868
,HengHeZhen,441322123,13847,2404,10338,6598,18911,10047,5170,10580,20627,11083,21421
޸ɽ,LuoFuShanGuan,441322570,6191,648,4026,2458,6104,3600,1582,3726,7326,4395,8421
ƽɽֵ,PingShanJieDao,441323001,176010,14468,113489,54889,136586,103170,46399,109661,212831,123388,236877
,DaLingZhen,441323101,83377,6429,54762,21504,45663,48842,25956,51907,100749,61000,115762
׻,BaiHuaZhen,441323102,45962,5178,31480,13747,52517,28372,12764,28505,56877,32424,63904
,LiangHuaZhen,441323103,28580,4276,21695,10587,40800,21414,11266,21808,43222,22427,44122
ɽ,RenShanZhen,441323104,44737,5781,31235,14735,58531,30928,13144,31683,62611,32427,63662
ӿ,TieYongZhen,441323105,23373,2721,16866,7292,32899,16706,8559,17447,34153,17787,34653
ƽ,PingHaiZhen,441323106,42751,5274,29322,15742,50042,28538,12298,28456,56994,31001,60323
¡,JiLongZhen,441323109,63646,2590,33190,15631,33215,26099,12537,30083,56182,45583,78773
Ʋ,HuangBuZhen,441323110,67444,3209,36770,19292,37429,30400,13103,35057,65457,46986,83756
ף,DuoZhuZhen,441323113,40846,6844,31383,15259,59703,30630,15349,30899,61529,31656,63039
,AnDunZhen,441323115,24350,3594,17955,6899,35493,17939,8353,18301,36240,18342,36297
̶,GaoTanZhen,441323118,4862,956,3656,2146,7289,3652,1581,3715,7367,3743,7399
,BaoKouZhen,441323120,4778,1226,3669,2295,7311,3643,1561,3747,7390,3896,7565
,BaiPenZhuZhen,441323121,8332,1252,5973,2889,11099,5866,2674,5851,11717,6285,12258
ǽֵ,LongChengJieDao,441324001,60535,6234,40533,26498,62775,38070,15066,39229,77299,41302,81835
ե,MaZhaZhen,441324100,14771,2501,10703,6994,20350,10603,4856,11202,21805,11425,22128
,YongHanZhen,441324101,33874,4397,23227,14722,42987,22412,9409,23155,45567,24453,47680
ƽ,PingLingZhen,441324106,25197,3380,17645,9132,30485,16798,7956,16976,33774,18888,36533
,LongTianZhen,441324115,12372,1823,8729,5220,16089,8571,3615,8802,17373,9081,17810
̶,LongTanZhen,441324116,15099,2381,10890,6470,21374,10888,4826,11409,22297,11416,22306
,DiPaiZhen,441324117,9689,1492,6751,4562,12230,6563,2810,6895,13458,7240,13991
,LongHuaZhen,441324118,22638,3316,16087,9773,29899,15870,7469,16296,32166,17336,33423
,LongJiangZhen,441324119,15681,2699,11108,6433,20651,11003,4787,11347,22350,12059,23167
,LanTianYaoZuXiang,441324200,5211,785,3840,2373,6704,3803,1720,3742,7545,3876,7716
Ϫֳ,LongMenXianMiXiLinChang,441324453,473,60,212,218,374,203,58,271,474,379,591
Ͻֵ,JiangNanJieDao,441402004,77570,8921,49731,33156,74446,47002,17446,45980,92982,54206,103937
ɽֵ,JinShanJieDao,441402006,74121,9048,46565,21972,49399,33086,11304,32982,66068,47908,94473
�ֵ,XiJiaoJieDao,441402007,39054,5050,26532,12621,25166,21506,8046,20947,42453,25618,52150
,SanJiaoZhen,441402102,49664,5353,32747,16549,30470,29649,10480,28441,58090,32750,65497
ɳ,ChangShaZhen,441402103,6897,1253,4810,2926,8872,4704,1484,4597,9301,4824,9634
Ǳ,ChengBeiZhen,441402105,40340,6355,27483,13045,39138,23458,8385,22431,45889,27597,55080
³ǰ´,XinChengBanShiChu,441421001,49755,5359,35452,18435,18134,32568,13984,30936,63504,33646,69098
Ƕ,ChengDongZhen,441421101,11956,1862,8255,4054,15163,7950,2421,7348,15298,7984,16239
ʯ,ShiShanZhen,441421102,11627,2527,8187,5121,15742,8111,2201,7918,16029,8168,16355
÷,MeiXiZhen,441421103,15869,2632,11192,6606,21610,11190,3609,10917,22107,10918,22110
ƺ,DaPingZhen,441421104,10338,1797,7139,4259,13829,6900,2151,6676,13576,7147,14286
ʯ,ShiKengZhen,441421105,13443,2360,9545,5707,18730,9485,3224,9230,18715,9482,19027
ˮ,ShuiCheZhen,441421109,10208,2160,7474,4712,14280,7315,2424,7004,14319,7318,14792
÷,MeiNanZhen,441421110,9060,1555,6121,3553,11953,5847,1902,5775,11622,6396,12517
,BingCunZhen,441421113,26669,4713,18349,9746,34492,17081,5144,15846,32927,18177,36526
׶,BaiDuZhen,441421115,14218,2917,10064,6753,19052,10047,2895,9893,19940,9966,20030
Դ,SongYuanZhen,441421116,18471,3808,13735,8655,26154,13703,4689,12920,26623,13233,26968
¡,LongWenZhen,441421117,10391,2614,7718,5358,15045,7699,2365,7367,15066,7652,15370
Ң,TaoYaoZhen,441421118,7998,1904,5931,3946,11249,5749,1842,5466,11215,5813,11744
,SheJiangZhen,441421126,26190,3560,18694,8617,34938,17752,6667,16440,34192,17723,36417
,XiYangZhen,441421128,21000,3484,14510,9311,27494,14453,4024,13686,28139,13998,28508
,YanYangZhen,441421129,18131,3332,12697,7251,23168,12182,3892,11454,23636,12658,25355
ɿ,SongKouZhen,441421130,35526,6910,25103,15237,46811,24322,7460,22965,47287,24793,49896
Ͽ,NanKouZhen,441421131,38082,7325,27214,14920,50790,26125,8263,24774,50899,26456,53670
̽,ChengJiangZhen,441421132,41629,4314,27803,14473,28216,25262,9281,24446,49708,27421,55224
,FuDaZhen,441421133,6893,965,4838,2785,8588,4609,1498,4154,8763,4518,9356
÷ˮ,MeiXiShuiKu,441421500,922,150,617,442,1110,612,185,601,1213,640,1257
,HuLiaoZhen,441422100,62625,9699,46435,28196,70409,43548,19187,42461,86009,45076,91511
Ϫ,QingXiZhen,441422103,9371,1696,6507,2965,13305,5979,2536,5950,11929,7096,13603
,SanHeZhen,441422105,11918,2137,8535,4895,16423,8154,2949,7801,15955,8469,17004
,YinJiangZhen,441422108,7712,2138,6535,4423,12021,6249,3097,5905,12154,6412,12947
,ZhouRuiZhen,441422109,7196,1445,5698,3030,10400,5670,2596,5443,11113,5539,11237
,GuangDeZhen,441422112,12367,2237,9615,5255,18005,9254,4524,8947,18201,9513,19128
Դ,TaoYuanZhen,441422113,6219,1211,4952,2670,9128,4748,2365,4495,9243,4843,9795
ٺ,BaiHouZhen,441422116,11649,2697,8988,6176,16813,8468,3331,7831,16299,8689,17677
,DaDongZhen,441422117,9385,1583,6764,3669,13314,6390,2987,6437,12827,7191,13955
,DaMaZhen,441422121,17350,3923,13264,8379,25463,12867,5377,12724,25591,13386,26650
,FengLangZhen,441422122,19605,3597,15575,8028,29239,14603,7728,13748,28351,15355,30930
,ChaYangZhen,441422123,21854,4637,16809,10690,30681,15927,7159,15265,31192,16841,33650
,GaoBeiZhen,441422124,32938,6571,24822,14331,47881,23442,11140,22785,46227,25827,50649
,XiHeZhen,441422125,16972,3321,11985,7246,23553,11522,4246,11647,23169,12554,24539
Ϫֳ,FengXiLinChang,441422400,599,125,485,314,936,464,217,422,886,456,941
ֳ,ZhouRuiLinChang,441422401,193,49,164,111,288,161,89,162,323,167,331
ֳ,DaPuLinChang,441422402,59,15,44,3,119,4,45,3,7,75,119
,BeiDouZhen,441423103,4403,1003,3680,2154,6853,3626,1960,3595,7221,3686,7366
,TangXiZhen,441423104,23231,4106,17676,8456,32916,17363,7833,17059,34422,17494,35170
,TangNanZhen,441423105,21948,3861,16744,10510,32546,16571,7599,16233,32804,16664,33408
կ,PuZhaiZhen,441423106,13705,2977,11320,5342,22214,11049,5863,10800,21849,11225,22545
,JianQiaoZhen,441423110,9008,1734,7764,4253,13826,7694,4287,7125,14819,7265,15029
,LongGangZhen,441423111,6847,1279,5656,3060,10466,5443,2961,5086,10529,5431,11087
,PanTianZhen,441423112,12990,2323,11023,5622,20318,10791,5975,9947,20738,10265,21288
ƽ,HuangJinZhen,441423114,15125,2578,12208,5380,22518,11547,6314,10584,22131,11809,24017
Сʤ,XiaoShengZhen,441423122,4705,1162,4024,2284,7432,3965,1952,3646,7611,3795,7819
ɰ,ShaTianZhen,441423123,7153,1575,6164,3272,10669,6068,2999,5295,11363,5563,11727
ɽ,BaXiangShanZhen,441423124,7650,1351,5889,2742,11087,5765,3038,5828,11593,6150,12039
,FengLiangZhen,441423125,26435,4467,20851,10462,37463,20532,10328,19986,40518,20379,41230
̶,TanJiangZhen,441423126,8608,1643,7507,3745,14076,7425,4413,6965,14390,7157,14664
,TangKengZhen,441423127,105638,13859,72764,38018,124869,68365,27327,69688,138053,74060,146824
,LiuHuangZhen,441423128,39339,6164,31516,15541,59108,31317,16508,30151,61468,30495,62011
,DaLongHuaZhen,441423129,7459,1442,5752,3200,11049,5666,2710,5646,11312,5859,11611
կũ,PuZhaiNongChang,441423450,627,204,572,333,1105,543,308,491,1034,567,1139
תˮ,ZhuanShuiZhen,441424103,35303,4210,26169,11746,50697,25700,12194,24789,50489,25538,51707
̶,TanXiaZhen,441424108,25983,3415,20377,9902,40504,20271,11783,20629,40900,20804,41181
,GuoTianZhen,441424117,18171,2176,14780,5593,27659,14393,8968,13961,28354,14535,29315
˫,ShuangHuaZhen,441424118,17363,2409,13402,5038,26632,13262,7355,13356,26618,13725,27127
÷,MeiLinZhen,441424125,23796,3300,18013,8462,35838,17878,9701,18265,36143,18784,36797
,HuaYangZhen,441424126,22822,3274,19471,8441,34475,19325,12808,19066,38391,19433,38904
,HuaChengZhen,441424130,66899,8842,51105,24069,95594,47207,25424,44059,91266,50060,101165
ܽ,ZhouJiangZhen,441424131,18971,3681,16162,8473,30425,15930,9080,14950,30880,15570,31732
ˮկ,ShuiZhaiZhen,441424134,98738,9997,67047,22624,123183,48099,31758,48177,96276,73446,140493
Ӷ,HeDongZhen,441424135,66508,8022,49795,19441,96648,47857,27295,48578,96435,52030,101825
,QiLingZhen,441424136,36015,5121,29053,13926,53154,27630,14284,23626,51256,26367,55420
,ChangBuZhen,441424137,31891,4751,25632,9319,49626,24887,15391,24705,49592,26401,52033
,HengBeiZhen,441424138,50663,7453,39516,16786,75047,37675,20459,35456,73131,39059,78575
,AnLiuZhen,441424139,77543,8626,56173,25748,113001,56010,29391,58787,114797,59387,115560
,MianYangZhen,441424140,40386,7584,33998,20095,68133,33643,20501,33634,67277,34473,68471
,LongCunZhen,441424141,51670,6911,39223,16181,78154,38721,21642,39735,78456,41000,80223
ʯ,ShiZhengZhen,441426101,19291,3532,14474,8201,25869,14398,5770,13725,28123,14119,28593
˳,BaChiZhen,441426104,7493,1522,5429,3689,10161,5393,1674,5101,10494,5260,10689
,ChaGanZhen,441426105,4377,691,3118,1716,5487,3068,1126,2915,5983,3076,6194
ͷ,HeTouZhen,441426107,4808,1074,3744,2142,6697,3718,1280,3340,7058,3418,7162
,ZhongHangZhen,441426108,4911,833,3508,1896,6453,3469,1271,3415,6884,3507,7015
Ͼ,ShangJuZhen,441426109,2950,658,2196,1409,4015,2171,681,1991,4162,2093,4289
ˮ,SiShuiZhen,441426110,4230,1008,3229,2225,5844,3214,981,2940,6154,2990,6219
,ChangTianZhen,441426114,5827,1121,4227,2451,7665,4175,1532,4152,8327,4253,8480
,ReZheZhen,441426115,6002,1385,4602,2651,8593,4528,1724,4379,8907,4509,9111
ʯ,DongShiZhen,441426117,21404,3765,15454,7979,28081,14935,5550,14044,28979,15265,30719
ʾ,RenJuZhen,441426118,12162,2400,8864,5253,16586,8396,3217,7908,16304,8915,17779
,DaZheZhen,441426119,69347,7909,45695,22314,74892,38712,16539,37697,76409,48100,93795
,SanZhenZhen,441427103,9996,1888,6889,4185,12820,6861,1858,6785,13646,6853,13742
ĸ,WenFuZhen,441427106,11308,1911,7758,4661,14720,7548,2443,7238,14786,7904,15662
㸣,GuangFuZhen,441427107,8720,1612,6035,3818,10998,5781,1934,5637,11418,6231,12266
,XinPuZhen,441427112,20392,4430,14887,9454,27336,14442,4620,13633,28075,14555,29442
,LanFangZhen,441427113,8316,2036,6025,4721,11493,6000,1783,5986,11986,6110,12135
,NanCaZhen,441427114,8203,1718,5784,4476,11185,5740,1671,5624,11364,5808,11592
,JiaoChengZhen,441427115,64879,8200,44424,24571,65471,41910,15279,40722,82632,43934,88358
̶,ChangTanZhen,441427116,12525,2093,8615,4923,14333,8003,2295,7683,15686,8298,16913
ũ,HuaQiaoNongChang,441427450,3963,953,3010,1952,4918,2925,823,2594,5519,2729,5739
ֵ,XingTianJieDao,441481001,113648,13316,74634,45515,126418,68913,25568,71257,140170,77898,152532
˽ֵ,FuXingJieDao,441481002,22373,3143,15277,8406,27488,14902,4784,14382,29284,15023,30300
½ֵ,NingXinJieDao,441481003,67922,8337,45610,25470,41086,42320,15408,41934,84254,46057,91667
,YongHeZhen,441481107,24548,4028,16832,9340,32361,16328,5582,16346,32674,17326,34158
,XinWeiZhen,441481111,24206,3313,16893,9736,32747,16753,6923,17072,33825,17549,34442
޸,LuoFuZhen,441481115,24052,4092,19669,9697,32938,19479,10037,17965,37444,18512,38181
޸,LuoGangZhen,441481116,36447,5005,27275,13768,49234,27266,12325,26494,53760,26502,53777
ƻ,HuangHuaiZhen,441481117,23059,2550,15198,7267,29518,15135,5478,14478,29613,15889,31087
,LongTianZhen,441481123,24377,3877,17386,10334,32590,17362,6130,16615,33977,16998,34384
ʯ,ShiMaZhen,441481124,19717,3220,14636,7847,27271,14479,6031,13888,28367,14332,28968
,NingZhongZhen,441481128,22221,3468,15126,8650,28024,15035,4536,14850,29885,15099,30225
,JingNanZhen,441481129,16111,3185,11879,7664,22928,11845,4517,11771,23616,11934,23813
,NiBeiZhen,441481130,43484,6496,30961,15609,60646,30773,12303,30693,61466,31322,62283
ˮ,ShuiKouZhen,441481131,43121,5910,30730,16768,59531,30625,13290,30858,61483,31591,62321
,HuangBeiZhen,441481132,43075,4963,30134,13833,56931,30020,11424,28710,58730,29328,59462
ˮ,HeShuiZhen,441481133,22120,2988,14790,8062,27738,14622,5443,14860,29482,15761,30551
ƺ,DaPingZhen,441481134,28764,5258,22172,13843,41574,21942,9631,20976,42918,21481,43653
Ҷ,YeTangZhen,441481135,42694,7043,30431,16380,57427,30287,10743,29446,59733,30049,60480
,XinBeiZhen,441481136,21536,3392,14768,8429,28606,14533,4586,14292,28825,14746,29514
,DiaoFangZhen,441481137,22375,3409,15470,8522,29871,15233,5301,15159,30392,15615,31085
¸۽ֵ,XinGangJieDao,441502001,44648,3212,27666,13119,45710,26891,10195,28812,55703,30389,58055
޽ֵ,XiangZhouJieDao,441502002,83720,4276,51855,22377,78246,45635,18516,51921,97556,54657,106512
ɽֵ,FengShanJieDao,441502003,71885,5349,45297,22222,64528,42724,16034,44799,87523,47971,93268
ֵ,TianQianJieDao,441502004,29536,3502,20512,9630,39170,20317,8496,20540,40857,21022,41534
޽ֵ,DongZhouJieDao,441502005,14475,1433,10044,4614,18802,9977,4300,9528,19505,10164,20208
˽ֵ,ZheLangJieDao,441502006,16458,1813,11758,5940,21686,11658,5619,12007,23665,12132,23890
�ֵ,MaGongJieDao,441502007,11321,1298,7716,3608,14464,7586,2823,7565,15151,7726,15442
,HongCaoZhen,441502100,25736,2766,17558,7375,32913,16909,7037,17261,34170,17981,35539
ӿ,DongYongZhen,441502102,39200,3744,26591,11505,51641,26495,11533,27451,53946,27886,54477
ʤ,JieShengZhen,441502103,31374,3216,21092,10013,42686,21090,8747,22237,43327,22245,43337
÷¤,MeiLongZhen,441521101,73471,7801,48356,25174,93832,46984,19615,50070,97054,52531,100887
СĮ,XiaoMoZhen,441521102,6489,843,4583,2278,8892,4578,2045,4785,9363,4794,9377
`,HouMenZhen,441521105,14302,1405,9540,4920,15961,9277,3904,9638,18915,10071,19611
,LianAnZhen,441521106,19342,2639,12754,7544,25342,12738,4340,13547,26285,13567,26321
պ,TaoHeZhen,441521107,18108,2504,12449,6859,23428,12372,4952,12984,25356,13115,25564
,ChiKengZhen,441521108,36280,4837,25487,11748,49551,25418,11341,26583,52001,26971,52458
,DaHuZhen,441521109,4422,641,2978,1501,5926,2862,1279,3098,5960,3364,6342
,KeTangZhen,441521110,35731,4130,24499,12369,46383,24296,11485,26481,50777,26847,51346
Ǽ,HuangQiangZhen,441521112,18137,2712,13266,6719,25982,13260,6431,13977,27237,14014,27280
ƽ,PingDongZhen,441521113,12318,1649,8902,4395,16881,8850,4328,9256,18106,9393,18295
,HaiChengZhen,441521115,129085,11365,79282,46768,137719,77546,27777,86763,164309,88945,168227
첺,EBuZhen,441521116,12109,1252,8339,3477,13274,7961,3822,8032,15993,8844,17183
ʯ,ChiShiZhen,441521117,13756,1590,9383,4512,17536,9219,4075,9571,18790,10038,19421
ƽ,GongPingZhen,441521118,54840,4813,36511,15635,64185,33011,15802,35872,68883,38944,75455
,FuChengZhen,441521400,60404,5724,38978,19605,47820,37797,15602,41247,79044,42752,81730
Ƕ,ChengDongZhen,441521401,64415,5942,41742,18828,52507,38703,17269,42378,81081,45884,87626
÷¤ũ,MeiLongNongChang,441521450,4381,662,3005,1974,5684,2982,1242,3221,6203,3280,6285
,HeTianZhen,441523100,59576,6213,42008,15703,68320,35561,21888,36739,72300,45669,87677
ˮ,ShuiChunZhen,441523101,23912,2998,18088,7473,35413,17549,9471,17618,35167,18293,36381
ӿ,HeKouZhen,441523102,29074,3789,23417,9707,45969,23401,14450,23839,47240,23896,47313
,XinTianZhen,441523103,21650,2555,17001,6910,33854,17001,9956,17159,34160,17160,34161
ϻ,ShangHuZhen,441523104,18174,2499,14087,6666,27474,14068,7908,14409,28477,14494,28581
Ϫ,LuoXiZhen,441523105,17727,2853,14621,7530,27886,14415,8291,13896,28311,14250,28871
,DongKengZhen,441523106,11685,1584,9081,4602,17993,9081,5101,9288,18369,9289,18370
,NanWanZhen,441523107,6861,706,4955,2675,9958,4941,2613,5223,10164,5225,10180
ֵ,DongHaiJieDao,441581001,122435,10390,78290,31836,156351,77663,32698,85430,163093,87233,165523
ֵ,HeXiJieDao,441581002,23544,2137,17037,5848,34211,16405,9075,17022,33427,17719,34756
Ƕֵ,ChengDongJieDao,441581003,41417,4224,31139,12811,58132,30956,18789,32862,63818,33291,64430
,JiaZiZhen,441581101,76702,6940,54692,22197,105178,54663,26384,55286,109949,55334,110026
ʯ,JieShiZhen,441581102,141704,12098,103809,38822,204011,103554,56652,106546,210100,106645,210454
,HuDongZhen,441581103,45396,5010,36054,14838,70513,36011,22089,36161,72172,36441,72495
,DaAnZhen,441581104,19365,3165,17156,8809,32909,17151,11301,16632,33783,16675,33831
,BoMeiZhen,441581105,32090,3637,25327,12196,51592,25280,16704,26821,52101,27104,52431
ں,NeiHuZhen,441581106,13531,1620,11539,4428,22563,11534,7975,11585,23119,11587,23126
,NanTangZhen,441581107,61148,6465,51450,18654,94335,50996,34915,50107,101103,51078,102528
,BeiYangZhen,441581108,22013,2509,18433,7075,35981,18428,12121,18169,36597,18210,36643
,BaWanZhen,441581109,10045,2107,8894,4613,17717,8891,6077,9291,18182,9335,18229
,JinXiangZhen,441581110,20619,2466,16546,7286,33138,16546,10455,16993,33539,16994,33540
̶,TanXiZhen,441581111,34966,3950,25828,10753,52192,25805,14731,27739,53544,27819,53647
׶,JiaDongZhen,441581112,38650,3818,34113,12430,62536,34098,24186,32425,66523,32541,66654
Ӷ,HeDongZhen,441581115,20139,2151,15143,5248,30887,15143,8939,16086,31229,16086,31229
Ӣ,ShangYingZhen,441581116,16727,1831,12956,4424,25494,12645,8094,13231,25876,13696,26652
ų,QiaoChongZhen,441581117,27706,3109,22272,8402,44552,22258,14571,23100,45358,23114,45386
,JiaXiZhen,441581118,64789,6060,51806,18831,100650,51800,33929,52964,104764,52972,104778
,XiNanZhen,441581119,16501,2241,12399,5317,25433,12336,7139,13164,25500,13482,25881
ȹ,HuaQiaoGuanLi,441581400,11896,1727,9108,4859,17218,9075,4850,9241,18316,9365,18473
ͭũ,TongLuoHuNongChang,441581450,10799,1047,8600,3123,16485,8556,5573,8747,17303,8819,17419
Ƕÿ,XingDouJingJiKaiFaShiYanQu,441581451,4823,583,3483,1691,6508,3378,1886,3703,7081,3809,7292
ũ,DaAnNongChang,441581452,1100,136,845,298,1721,845,485,876,1721,876,1721
޾ֳ,LuoJingZhangLinChang,441581453,132,22,82,47,197,82,43,115,197,115,197
ֳ,HuDongLinChang,441581454,200,28,152,100,322,152,94,170,322,170,322
ֳ,DongHaiAnLinChang,441581455,150,34,91,85,223,91,39,132,223,132,223
ֳ,HongLingLinChang,441581456,162,19,96,32,189,88,51,102,190,136,232
ֳ,XuMuGuoLinChang,441581457,106,11,63,35,128,62,30,76,138,84,147
ϳǽֵ,ShangChengJieDao,441602001,33656,3809,22615,10604,34548,18853,8596,19262,38115,23446,46061
½ֵ,XinJiangJieDao,441602002,31876,3167,19352,8392,26505,17745,7036,17944,35689,22727,42079
ҽֵ,DongPuJieDao,441602003,105962,6932,68190,34474,86585,59987,26525,61816,121803,71229,139419
Դֵ,YuanXiJieDao,441602004,73728,6569,49491,24926,45753,47730,21143,50119,97849,51949,101440
Դ,YuanNanZhen,441602100,44989,2586,28483,9558,27889,18730,8264,18998,37728,27356,55839
ǰ,PuQianZhen,441602101,59278,4267,36832,14762,43461,25403,11461,26493,51896,38174,75006
Ҹũ,GaoPuGangNongChang,441602400,3033,243,1997,946,2711,1668,787,1773,3441,2066,4063
ϳ,ZiChengZhen,441621100,117716,12928,83776,33088,145099,67795,38981,68552,136347,85849,169625
,LongWoZhen,441621102,37677,6582,31567,13073,57445,30506,17977,29103,59609,30669,62236
ź,JiuHeZhen,441621103,10988,2529,9602,5206,18002,9261,5368,8777,18038,9283,18885
,ShangYiZhen,441621104,8474,1897,7397,3902,13263,7348,4374,7234,14582,7348,14745
,LanTangZhen,441621105,35357,5765,29106,12955,52562,27234,16317,26193,53427,28333,57439
ﰲ,FengAnZhen,441621106,9280,2070,8264,4362,14547,8022,4741,7518,15540,7827,16091
,YiRongZhen,441621107,27105,4534,21290,10580,39883,20988,10832,20676,41664,21181,42471
,GuZhuZhen,441621108,31536,4712,23115,13241,42365,22595,10843,23005,45600,23976,47091
ٽ,LinJiangZhen,441621109,20834,2421,14929,7461,25166,14122,7232,14050,28172,15558,30487
,BaiPuZhen,441621110,15956,2609,13062,6042,24122,12345,7094,11702,24047,12597,25659
,HuangTangZhen,441621111,13217,2781,11798,6170,21305,11528,7065,10845,22373,11265,23063
,JingZiZhen,441621112,12624,2188,11471,4532,20347,11428,7501,10701,22129,10842,22313
ˮ,ShuiDunZhen,441621114,10368,1906,8829,3534,15553,8658,5157,8238,16896,8602,17431
,NanLingZhen,441621115,6111,1278,5598,2672,10024,5565,3415,5147,10712,5206,10804
,SuQuZhen,441621116,8733,1721,7712,3117,13520,7545,4533,6960,14505,7275,14987
Ϫ,WaXiZhen,441621117,14501,3059,12175,6591,22081,12164,6496,11837,24001,11881,24056
,HaoYiZhen,441621118,6463,1286,5484,2614,9389,5435,2978,5178,10613,5243,10727
а,ZhongBaZhen,441621119,18111,3129,16826,6537,29668,16738,10783,15020,31758,15197,32023
¡,LaoLongZhen,441622100,109621,10632,78784,30920,119091,57500,36550,57365,114865,78019,156803
嶼,YiDouZhen,441622102,10874,2201,9749,4988,18715,9680,6039,9257,18937,9365,19114
٢,TuoChengZhen,441622103,22858,3567,17641,7136,31481,14762,7204,13529,28291,15988,33629
,HeShiZhen,441622104,12291,2402,9618,5060,18351,9154,4063,8417,17571,9138,18756
Ʋ,HuangBuZhen,441622105,9489,1997,8450,4409,16236,8417,4845,7714,16131,7881,16331
,ZiShiZhen,441622106,10349,2279,8876,4712,17287,8675,4881,8217,16892,8633,17509
ͨ,TongQuZhen,441622107,12594,2988,10527,6280,19868,10111,4838,9138,19249,9893,20420
,DengYunZhen,441622109,12809,1980,9214,4182,17093,8420,3683,8084,16504,9258,18472
,FengRenZhen,441622110,19862,3343,15481,7429,29701,15358,7119,14681,30039,14843,30324
Ķ,SiDouZhen,441622111,8122,1762,6706,3594,13031,6481,3356,6010,12491,6534,13240
,TieChangZhen,441622112,32063,5496,26589,12197,50891,26132,14573,24780,50912,25543,52132
ĸ,LongMuZhen,441622114,21922,4010,18874,8980,36065,18685,10612,17189,35874,17670,36544
,TianXinZhen,441622115,17079,2967,15800,6801,30067,15677,10186,14176,29853,14432,30232
,LiJuZhen,441622116,13044,2825,10756,5577,21021,10457,5684,10231,20688,10797,21553
ʯ,HuangShiZhen,441622117,5999,1598,5147,3191,9957,5130,2506,4860,9990,4956,10103
,ChiGuangZhen,441622118,18078,3581,16354,7331,30825,15752,10240,14562,30314,15545,31899
,HuiLongZhen,441622119,11307,2346,10410,5002,20190,10170,6872,9667,19837,10115,20525
,XinTianZhen,441622120,6217,1366,5595,2815,10676,5486,3391,5079,10565,5379,10974
,CheTianZhen,441622121,26756,5547,21729,12473,42155,21256,11149,20852,42108,21723,43452
,YanZhenZhen,441622123,8540,1691,7477,3753,14084,7334,4128,6544,13878,6882,14359
鲼,MaBuGangZhen,441622124,20181,3465,16779,8137,31014,16336,8810,14963,31299,15677,32456
,BeiLingZhen,441622125,6627,1534,5802,3177,11267,5643,3352,5282,10925,5711,11513
ϸ,XiAoZhen,441622126,8285,1697,7002,4108,13612,6995,3903,6870,13865,6883,13885
ƺ,ShangPingZhen,441622127,12076,2370,10259,5120,19898,10144,5809,9775,19919,9996,20255
Ԫ,YuanShanZhen,441623100,56614,6634,38800,16810,71681,33543,15006,33255,66798,39454,78254
ƺ,ShangPingZhen,441623101,16114,2318,12230,7526,23198,12213,5610,11728,23941,11812,24042
ݸ,NeiGuanZhen,441623102,8545,1373,6423,4053,12514,6412,2809,6291,12703,6304,12727
ͷ,BeiTouZhen,441623104,15333,2308,11885,6846,22318,11885,5579,11335,23220,11335,23220
Ϫɽ,XiShanZhen,441623105,8109,1288,6495,3373,12234,6365,3163,5809,12174,6065,12560
¡,LongJieZhen,441623107,19781,3559,15615,8558,29696,14915,7298,13950,28865,15023,30638
Դ,TianYuanZhen,441623108,6147,1117,4810,2795,9373,4800,2243,4657,9457,4697,9507
Ϫ,YouXiZhen,441623109,19998,2687,14620,6563,28216,14112,6401,13718,27830,14466,29086
,ZhongXinZhen,441623110,40581,5061,28705,12352,49906,25839,12132,25239,51078,29069,57774
ݸ,GaoGuanZhen,441623111,10611,1940,8559,4554,15698,8496,4193,8017,16513,8185,16744
,DaHuZhen,441623113,10306,1843,8231,4405,14689,8008,3951,7327,15335,7869,16100
,SanJiaoZhen,441623114,9979,1249,5796,3230,10267,5621,2842,5136,10757,8274,14070
,XiuDuanZhen,441623115,7866,1345,6215,3634,11697,6185,3069,6033,12218,6065,12280
,YangMingZhen,441624100,69419,7782,49466,25312,73182,44901,20694,45124,90025,48429,97895
,DaBaZhen,441624101,21102,3129,15332,7560,28723,15024,6889,15007,30031,15788,31120
,ChangTangZhen,441624102,7885,1755,6325,3865,11724,6237,2935,6014,12251,6250,12575
³,XiaCheZhen,441624103,9019,1739,7166,3914,13206,6993,3407,6640,13633,6999,14165
,ShangLingZhen,441624104,10848,2123,8955,5048,16896,8624,4563,7863,16487,8579,17534
ʤ,YouShengZhen,441624105,6657,1262,5257,2886,9566,5085,2358,4732,9817,5020,10277
,BeiDunZhen,441624106,11071,2475,9070,6214,17198,8995,4735,9075,18070,9211,18281
կ,GuZhaiZhen,441624107,5810,1264,4598,2669,8985,4511,2330,4541,9052,4806,9404
կ,PengZhaiZhen,441624108,28533,5289,22639,12459,42070,21877,11310,21218,43095,22493,45132
ˮ,HeShuiZhen,441624109,14436,2161,10679,5679,20549,10646,4808,10541,21187,10726,21405
,GongBaiZhen,441624110,5118,983,4194,2364,7676,4134,2245,4039,8173,4152,8346
,QingZhouZhen,441624111,5151,1259,4528,2784,8260,4491,2628,4371,8862,4510,9038
Դ,LianYuanZhen,441624112,7883,1396,6543,3998,12217,6426,3710,6150,12576,6446,12989
ˮ,ReShuiZhen,441624113,8347,1320,6162,3414,11977,6017,2794,5940,11957,6299,12461
ˮ,DongShuiZhen,441624114,12859,3086,11230,6605,20836,11067,6718,11051,22118,11433,22663
ʿ,LiShiZhen,441624115,8186,1500,6820,3181,13100,6764,4120,6878,13642,6986,13806
կ,LinZhaiZhen,441624116,9761,2266,8862,4900,16261,8605,5591,8198,16803,8756,17618
,XianTangZhen,441625100,51694,3237,31154,11340,38445,19994,10560,20643,40637,34337,65491
,DengTaZhen,441625101,25811,3485,18631,9741,33634,18192,8780,18450,36642,19445,38076
,LuoHuZhen,441625102,10726,1724,8018,4393,15080,7932,3742,7971,15903,8174,16192
,ChuanTangZhen,441625103,31582,5610,24551,13754,45788,24346,11431,23749,48095,24072,48623
˳,ShunTianZhen,441625104,10444,1823,8276,4330,15991,7891,4104,7485,15376,8095,16371
ݸ,ShangGuanZhen,441625105,16238,2984,12681,7137,23615,12577,6392,12708,25285,12933,25614
,CengTianZhen,441625106,10671,1966,7877,3926,15457,7818,3463,8038,15856,8223,16100
,LiuChengZhen,441625107,10128,1761,7395,3638,14230,6681,3476,6630,13311,7970,15365
,YiHeZhen,441625108,9305,1596,6829,3612,13379,6535,3164,6723,13258,7236,14065
,LanKouZhen,441625109,16880,3324,12881,7059,23970,12720,5768,12526,25246,13091,25972
,HuangTianZhen,441625110,9583,1797,7494,4248,14349,7387,3971,7591,14978,7857,15351
Ҷ̶,YeTanZhen,441625111,11745,2572,10445,5449,20044,10400,6447,10210,20610,10319,20764
ƴ,HuangCunZhen,441625112,19097,3917,17147,7436,32965,17009,11464,16953,33962,17331,34478
,KangHeZhen,441625113,9889,1984,8199,4070,15967,8126,4615,8109,16235,8289,16488
,XiChangZhen,441625114,4141,701,2904,1737,5863,2864,1198,2971,5835,3136,6040
¸,XinGangZhen,441625115,8105,878,5290,2427,9866,4030,2136,4193,8223,5829,11119
˫,ShuangJiangZhen,441625116,10427,1340,7179,3014,14671,7023,2983,7310,14333,7571,14750
ͷ,JianTouZhen,441625117,10559,1235,7528,3418,14667,7315,3407,7203,14518,7673,15201
»,XinHuiLongZhen,441625121,2480,424,1689,1225,3351,1610,729,1750,3360,1944,3633
뽭,BanJiangZhen,441625122,3864,539,2825,1355,5659,2797,1282,2777,5574,2860,5685
Ϫ,ZhangXiXiang,441625200,9668,1622,7315,3587,14114,7029,3296,6854,13883,7271,14586
϶ֵ,NanEnJieDao,441702001,47580,4507,30793,19420,36455,27490,9946,29090,56580,31240,62033
Ͻֵ,ChengNanJieDao,441702002,47956,7437,31311,19684,47138,29856,7965,31559,61415,32047,63358
Ǳֵ,ChengBeiJieDao,441702003,37487,2797,23362,12199,18200,21934,7797,23319,45253,24719,48081
޽ֵ,ZhongZhouJieDao,441702004,25715,2840,16903,9609,25506,16636,6535,17812,34448,18187,35090
Ƕֵ,ChengDongJieDao,441702006,93028,7998,57775,33839,75069,52300,16718,55489,107789,59969,117744
нֵ,GangLieJieDao,441702008,40170,4616,25629,14671,42344,24488,8646,26213,50701,27803,53432
ֵ,ChengXiJieDao,441702009,46536,5969,29365,17406,47094,29008,9310,31794,60802,32450,61815
ɳֵ,BaiShaJieDao,441702011,29661,4026,18851,10735,35030,17418,6637,18963,36381,21473,40324
,BuChangZhen,441702102,19364,3638,13261,8746,26831,13095,4618,13931,27026,14359,27620
ƽ,PingGangZhen,441702103,45267,8450,31808,20829,64381,31422,11832,32765,64187,33741,65549
,HaiLingZhen,441702104,30101,5023,21287,11583,43278,20599,8799,21333,41932,22636,43923
բ,ZhaPoZhen,441702105,24948,2995,15633,7864,30023,15485,4216,16300,31785,16526,32159
˫,ShuangJieZhen,441702106,15413,2515,10463,6224,21130,10230,4193,11179,21409,11658,22121
ֳ,YangJiangLinChang,441702401,242,41,140,113,166,116,55,161,277,198,338
ƽũ,PingGangNongChang,441702450,821,350,545,659,1261,545,110,736,1281,736,1281
ʮũ,HongShiYueNongChang,441702453,1366,320,960,484,672,758,303,789,1547,1029,1989
֯T,ZhiGongZhen,441721100,89715,10041,56180,33354,109344,54473,21943,62954,117427,65519,121699
̴,ChengCunZhen,441721101,38608,6247,25587,15118,52846,25532,9716,28750,54282,28984,54571
,TangKouZhen,441721102,24991,4037,16789,9694,34521,16707,7400,19411,36118,19639,36428
,ShangYangZhen,441721103,43772,6041,28597,15624,58305,27522,12474,31839,59361,33690,62287
Ϫͷ,XiTouZhen,441721104,52259,7118,34439,19216,70953,34414,14357,39047,73461,39295,73734
ɳ,ShaBaZhen,441721105,23598,2723,14500,7558,29189,14454,5142,16812,31266,16963,31463
嶴,RuDongZhen,441721106,31785,3890,20261,10703,40245,20024,8079,22888,42912,23493,43754
,XinWeiZhen,441721107,18259,2885,12153,7129,24786,11910,5342,13715,25625,14333,26486
֯Tũ,ZhiGongNongChang,441721501,1453,287,958,375,1658,583,329,664,1247,1111,2069
ֳ,YangJiangLinChang,441721502,97,30,41,19,124,11,7,23,34,93,134
,DongChengZhen,441723100,53527,3597,30303,15412,39440,25295,9296,28125,53420,36117,66420
,BeiGuanZhen,441723101,30240,4171,18416,11219,37143,17269,6168,19658,36927,22163,40579
,NaLongZhen,441723102,23611,2554,9973,8144,28430,9761,3450,11609,21370,19642,29615
ƽ,DongPingZhen,441723103,33066,3449,19610,9548,37351,19026,6456,20144,39170,23361,42971
,YaShaoZhen,441723104,18947,3020,12055,7001,24650,11451,3471,12334,23785,13383,25438
,DaGouZhen,441723105,24405,4006,16330,9860,33436,16191,5822,17643,33834,17903,34233
,XinZhouZhen,441723106,30725,4655,20396,10711,41718,20178,7578,22121,42299,22562,42958
ɽ,HeShanZhen,441723107,32345,3637,20871,11641,36721,20239,8063,22263,42502,23174,44045
ƺ,TangPingZhen,441723108,28671,4073,18313,10358,38962,18273,6558,20871,39144,20989,39302
,DaBaZhen,441723109,23316,4505,14870,11174,32595,14870,5174,18114,32984,18125,32995
,HongFengZhen,441723110,29592,4175,19338,10850,36087,18915,7218,20985,39900,21647,40985
ũ,HongWuYueNongChang,441723401,1549,359,1053,932,1337,1031,337,1132,2163,1192,2245
ɽũ,JiShanNongChang,441723402,724,85,445,367,708,436,148,492,928,512,957
ֳ,YangDongLinChang,441723504,18,0,6,14,17,6,1,13,19,13,19
ǽֵ,ChunChengJieDao,441781001,179739,20733,117581,64540,181922,107425,43055,114339,221764,125946,243527
Ӊi,HeLangZhen,441781101,18393,3066,14854,9112,26524,14842,8600,15146,29988,15205,30059
ɰ,SongBaiZhen,441781102,27398,3962,17624,12391,34091,17532,8652,18601,36133,22388,40012
ʯ,ShiWangZhen,441781103,15692,3199,12532,8699,23945,12527,6592,12948,25475,12951,25483
,ChunWanZhen,441781105,43918,7456,32516,20637,59780,32257,14792,33273,65530,33650,66166
ˮ,HeShuiZhen,441781106,30788,5295,22618,14306,42065,22280,9975,23096,45376,23440,46058
,BeiMianZhen,441781107,31114,5366,22552,14967,43640,22498,10127,23785,46283,24055,46607
,GuiGangZhen,441781108,22017,4461,16218,12641,31895,16211,7669,17892,34103,17929,34147
,YongNingZhen,441781109,16678,3944,13763,9691,24836,13755,7857,14620,28375,14716,28479
ˮ,MaShuiZhen,441781110,22915,4653,16391,11630,31357,16288,6601,17375,33663,17778,34169
,GangMeiZhen,441781111,31108,5551,22258,14077,43799,22198,9611,23770,45968,24012,46270
ӿ,HeKouZhen,441781112,13934,3008,9903,7488,20447,9841,4263,11085,20926,11302,21205
̶ˮ,TanShuiZhen,441781113,37351,7257,26836,18410,51557,26388,11991,28901,55289,29763,56599
,SanJiaZhen,441781114,26256,6182,20580,15711,38518,20487,10353,21936,42423,22211,42791
˫,ShuangJiaoZhen,441781116,22994,5770,18504,14068,35329,18431,9463,19605,38036,19723,38227
˼,BaJiaZhen,441781117,31362,5965,23815,16903,45463,23797,11764,25199,48996,25276,49091
Ҷũ,SanYeNongChang,441781402,390,109,288,234,448,273,115,293,566,326,614
ǽֵ,FengChengJieDao,441802006,122364,12894,79053,47698,86378,74559,24407,76665,151224,80612,159665
ǽֵ,DongChengJieDao,441802007,83871,7873,53640,26516,46584,48103,18976,50122,98225,57080,110720
Ľֵ,ZhouXinJieDao,441802008,107882,10173,69164,39087,95312,62570,22468,63665,126235,71359,140523
ɽֵ,HengHeJieDao,441802009,43915,5575,26470,14216,46711,24526,8438,25148,49674,31458,57928
Դ̶,YuanTanZhen,441802103,74343,7687,45695,21360,72477,38879,16825,40761,79640,53160,98855
,LongTangZhen,441802105,73967,5044,43559,21719,51834,35173,14824,39081,74254,50276,93835
ʯ,ShiJiaoZhen,441802106,60011,6837,37876,19652,55712,32541,13925,34280,66821,42897,80773
Ͽ,FeiLaiXiaZhen,441802107,35733,6018,25387,16892,47775,24540,11289,25523,50063,27653,53040
Զи,QingYuanShiGao,441802400,8144,112,3418,887,27,838,410,1070,1908,5248,8666
Զй,QingYuanShiGuo,441802450,6371,263,2820,1017,1881,1513,594,1681,3194,4408,7228
ʯ,ShiJiaoZhen,441821100,99171,10418,65629,35053,98487,61473,25174,63680,125153,69134,134763
ˮͷ,ShuiTouZhen,441821101,14281,2467,10372,6662,18930,10301,4307,10375,20676,10683,21055
,TangTangZhen,441821102,42609,6119,30148,15669,51229,28276,12491,28155,56431,31071,61219
ɽ,LongShanZhen,441821103,27747,4105,19821,11250,33522,19026,9279,19661,38687,21310,41131
߸,GaoGangZhen,441821104,12658,2273,9602,5978,17136,9501,4650,9726,19227,9979,19581
ͷ,JingTouZhen,441821107,17288,2578,12412,6872,21116,12075,5291,12047,24122,12745,25157
,QingLianZhen,441823100,13730,3046,10876,7196,19836,10821,4859,10680,21501,10759,21635
Ӣ,JiangYingZhen,441823101,12561,2733,10929,6082,19554,10829,5910,10000,20829,10275,21204
Ų,DuBuZhen,441823104,10643,1916,8152,4839,15240,7980,3805,7840,15820,8212,16364
߹,QiGongZhen,441823105,26510,5270,20538,13617,38205,20406,9497,20357,40763,20739,41277
̫ƽ,TaiPingZhen,441823107,15603,3356,12562,8491,22816,12427,6624,12741,25168,13021,25583
÷,YangMeiZhen,441823108,2565,471,1771,1317,3395,1743,788,1967,3710,2053,3824
~,DaNangZhen,441823110,6496,1303,4934,3215,9286,4892,2282,5001,9893,5147,10081
С,XiaoJiangZhen,441823111,15711,3145,11767,7224,22440,11589,4680,11359,22948,11769,23536
뱳,LingBeiZhen,441823113,15002,3062,12010,7816,22785,11884,5473,11351,23235,11527,23537
,HuangBenZhen,441823115,5547,1404,4316,2803,8281,4301,1725,4298,8599,4360,8676
貺,LiBuZhen,441823116,29793,5891,22789,12880,42269,22206,9510,21414,43620,22405,45194
,YangChengZhen,441823119,75374,9524,51619,28490,81596,48243,18365,48532,96775,51644,103263
Ӽ,ChengJiaYaoZu,441823201,8263,1584,5788,3581,10962,5639,2074,5866,11505,6133,11921
,YongHeZhen,441825100,11254,1887,7893,4680,15287,7625,3156,8016,15641,8404,16297
,JiTianZhen,441825104,20171,2497,13478,8517,20279,13213,5021,13409,26622,14211,27689
̫,TaiBaoZhen,441825105,6390,1074,4319,2994,8319,4254,1678,4623,8877,4823,9142
̶,HeDongZhen,441825106,3554,629,2701,1654,5002,2695,1222,2667,5362,2704,5405
,FuTangZhen,441825108,9692,1518,7149,4225,13618,7080,3693,7594,14674,7754,14903
С,XiaoSanJiangZhen,441825109,8158,1425,6408,3922,11954,6293,3588,6525,12818,6763,13171
˧,ShangShuaiZhen,441825111,1870,391,1549,1056,2814,1544,902,1603,3147,1614,3163
ɽֳ,LianShanLinChang,441825450,121,38,97,84,113,89,23,81,170,85,182
̶ũֳ,HeDongNongLinChang,441825451,539,8,86,41,108,38,16,51,89,477,563
,SanJiangZhen,441826100,28393,3769,19778,11852,30520,18763,7236,18415,37178,19620,39398
ɽ,DaMaiShanZhen,441826101,7934,898,6709,3887,11452,6642,4398,6365,13007,6521,13230
կ,ZhaiGangZhen,441826102,21719,4247,16852,10602,30180,16648,7910,16315,32963,17024,33876
,SanPaiZhen,441826105,11340,1420,9258,5787,16466,9218,5621,9040,18258,9123,18381
ˮ,WoShuiZhen,441826106,4499,420,2996,1748,6015,2959,1532,3335,6294,3455,6451
ƺ,DaPingZhen,441826108,5596,706,4199,3053,8511,4169,2451,4479,8648,4554,8753
ƺ,XiangPingZhen,441826109,6224,638,4370,2382,8975,4321,2307,4709,9030,4799,9169
̫,TaiHeZhen,441827102,143964,9684,92814,43814,64550,76480,36290,78978,155458,97124,189938
̫ƽ,TaiPingZhen,441827104,50354,5874,33280,16465,53505,29193,11128,30200,59393,34076,67356
ɽ,ShanTangZhen,441827105,35408,6120,24113,13185,44907,23277,7368,23464,46741,24783,48896
,SanKengZhen,441827106,29605,4752,20050,12630,38865,19845,6719,20555,40400,21026,41076
,LongJingZhen,441827112,65574,9163,44120,26803,86676,42644,17474,44275,86919,48091,92211
,HeYunZhen,441827113,60316,8683,41648,23491,77684,39571,17952,41423,80994,45303,86951
̶,JinTanZhen,441827117,60453,7386,43978,22951,85578,42593,21618,43673,86266,45479,89457
ʯ̶,ShiTanZhen,441827118,54414,6049,39955,19630,70882,39574,20950,40439,80013,41458,81413
ʼֳ,BiJiaLinChang,441827450,1132,166,721,561,1424,709,215,747,1456,792,1513
Ӣǽֵ,YingChengJieDao,441881001,129682,14091,80656,38519,110041,63763,25545,64595,128358,88662,169318
ɳ,ShaKouZhen,441881101,23196,3956,17543,11828,32362,17448,8401,17687,35135,18010,35553
,WangBuZhen,441881102,37296,4414,25141,15574,46214,24838,9710,25476,50314,26279,51420
ʯˮ,HengShiShuiZhen,441881103,18647,2454,13516,6780,25362,13396,6516,13887,27283,14101,27617
ͷ,QiaoTouZhen,441881105,20825,2829,14877,8414,28192,14602,7042,15303,29905,15819,30696
,QingTangZhen,441881106,21749,2514,16298,7308,28294,16219,8450,16105,32324,16415,32713
ɳ,BaiShaZhen,441881108,19540,2672,13645,8195,26343,13540,6207,14579,28119,14774,28419
վ,DaZhanZhen,441881109,27865,3673,18584,11315,32896,17715,6501,18293,36008,19455,38039
ţ,XiNiuZhen,441881110,26792,4112,18938,11496,36479,18336,7616,18649,36985,19582,38520
,JiuLongZhen,441881111,28470,4026,20091,11536,38327,19950,8560,20720,40670,20965,41056
,HanHuangZhen,441881112,41121,6129,28936,17217,52784,28160,11132,28504,56664,29446,58382
,DaWanZhen,441881114,33860,7040,27549,18827,50631,27433,14001,27148,54581,27352,54901
ʯ,ShiHuiPuZhen,441881115,22932,3371,16043,8853,31742,15697,6490,16257,31954,16750,32793
ʯ,ShiGuTangZhen,441881116,22315,3050,15007,8803,30186,14418,5542,15232,29650,15900,30907
̫,XiaTaiZhen,441881120,6530,931,4505,2371,8906,4283,2099,4585,8868,5055,9560
,BoLuoZhen,441881124,5145,1270,4136,2766,7731,4108,1986,4166,8274,4265,8401
ʯ,HengShiTangZhen,441881125,15072,2890,10980,7677,20650,10914,4661,11297,22211,11643,22623
,DaDongZhen,441881126,5923,1080,4243,2879,8455,4182,1810,4454,8636,4570,8813
,LianJiangKouZhen,441881129,22376,3118,15012,9784,28858,14865,5497,15389,30254,15979,30991
Ϫ,LiXiZhen,441881130,22800,3198,16001,8480,30640,14869,6513,15166,30035,16510,32511
ˮ,ShuiBianZhen,441881131,7888,1385,5679,3497,11068,5469,2358,5634,11103,5952,11631
Ӣ,YingHongZhen,441881136,18907,3245,13656,9855,23383,13540,5967,14086,27626,14463,28119
,DongHuaZhen,441881137,64272,8793,44415,23811,79497,40744,17622,42653,83397,46272,90687
ƻ,HuangHuaZhen,441881138,17868,3405,13674,8744,26767,13610,7009,14450,28060,14608,28282
,LianZhouZhen,441882100,112319,15773,78090,46724,112916,72409,25632,71515,143924,75634,153724
,XingZiZhen,441882101,25605,4845,19265,14214,36877,19211,8324,19310,38521,19509,38774
·,DaLuBianZhen,441882102,16473,3991,13559,10017,26169,13280,7072,13518,26798,13977,27536
ƺ,LongPingZhen,441882103,15370,3142,11198,8574,21390,11042,4482,11459,22501,11796,22994
,XiAnZhen,441882104,17500,4063,13196,9968,25549,13068,5379,13390,26458,13746,26942
,BaoAnZhen,441882105,14195,3341,11077,8041,21685,10970,4860,11173,22143,11319,22396
,FengYangZhen,441882106,11129,2497,8191,5989,16467,8048,3290,8455,16503,8725,16916
,DongBeiZhen,441882107,12105,2780,9160,6716,17990,9160,3483,9207,18367,9208,18368
,JiuBeiZhen,441882109,12186,2658,9158,6263,17049,8980,3692,8850,17830,9378,18536
,XiJiangZhen,441882118,7941,1560,5388,3664,10480,5257,1980,5706,10963,6093,11481
,YaoAnYaoZu,441882200,5169,1036,3612,2694,6939,3561,1180,3693,7254,3773,7385
ˮ,SanShuiYaoZu,441882201,1890,295,1239,805,2498,1232,405,1333,2565,1351,2590
ǽֵ,DongChengJieDao,441900003,432794,12916,229114,136253,89124,152606,47165,167324,319930,263761,492875
ϳǽֵ,NanChengJieDao,441900004,250360,6287,134354,87139,58827,95297,32608,103617,198914,154901,289255
򽭽ֵ,WanJiangJieDao,441900005,205702,8587,111249,77491,70410,87626,30476,97772,185398,133516,244765
ݸǽֵ,GuanChengJieDao,441900006,125316,14676,79800,52479,88320,65322,22124,67895,133217,82316,162116
ʯ,ShiJieZhen,441900101,222327,5152,118550,72503,38952,70725,19481,82993,153718,128410,246960
ʯ,ShiLongZhen,441900102,114700,8180,71985,42174,59906,56038,18970,56076,112114,69865,141850
ɽ,ChaShanZhen,441900103,136508,5238,71948,32225,41314,40687,14776,44805,85492,84574,156522
ʯ,ShiPaiZhen,441900104,143990,4034,70014,39708,36944,41460,12178,48906,90366,90188,160202
ʯ,QiShiZhen,441900105,105400,4178,52175,23630,39159,31753,12115,35601,67354,69518,121693
,HengLiZhen,441900106,185177,3830,93740,56563,33430,53883,15823,63359,117242,111090,204830
ͷ,QiaoTouZhen,441900107,150972,3590,78303,32159,37595,38899,12212,42913,81812,88471,166774
л,XieGangZhen,441900108,88050,1878,44542,28180,17790,29496,9459,34563,64059,54845,99387
,DongKengZhen,441900109,124079,3483,65908,43407,27578,39357,11257,47775,87132,72911,138819
ƽ,ChangPingZhen,441900110,349821,7385,188692,96703,68681,100080,29172,105875,205955,197686,386378
弲,LiaoBuZhen,441900111,377095,7805,190993,118050,63922,113478,33678,134447,247925,227585,418578
ľͷ,ZhangMuTouZhen,441900112,118567,2137,59269,40065,22549,40231,12112,45788,86019,73547,132816
,DaLangZhen,441900113,277726,7233,141542,68251,68361,79077,25930,89970,169047,169347,310889
ƽ,HuangJiangZhen,441900114,211141,2383,103749,66465,21137,61945,17875,73326,135271,127650,231399
Ϫ,QingXiZhen,441900115,290136,3672,141974,78691,33362,74522,18833,88403,162925,170667,312641
,TangShaZhen,441900116,446604,4752,218508,145935,42282,127395,30711,154044,281439,263559,482067
,FengGangZhen,441900117,288398,3348,145061,92466,22209,91663,27225,104617,196280,173910,318971
ɽ,DaLingShanZhen,441900118,251807,4374,122267,89702,41725,82892,23233,99934,182826,157147,279414
,ChangAnZhen,441900119,625895,5213,305560,211268,40716,178570,33122,210302,388872,358670,664230
,HuMenZhen,441900121,573405,13385,294585,192559,118673,198312,51867,224863,423175,344072,638657
,HouJieZhen,441900122,399643,9566,199505,83281,92606,97364,29074,111895,209259,238778,438283
ɳ,ShaTianZhen,441900123,156701,3981,75191,59598,35820,56711,16800,68061,124772,102291,177482
,DaoJiaoZhen,441900124,123520,6065,63418,40753,51981,46183,13522,51424,97607,79689,143107
÷,HongMeiZhen,441900125,50104,2133,24959,19589,17718,19993,5877,22963,42956,33155,58114
ӿ,MaYongZhen,441900126,98521,6791,49849,37591,61420,44251,12750,50177,94428,68213,118062
ţ,WangNiuDunZhen,441900127,70334,4283,38791,23483,40142,29886,10169,32528,62414,45995,84786
,ZhongTangZhen,441900128,116121,7650,62805,37190,70130,48553,15792,52832,101385,76758,139563
߈,GaoBuZhen,441900129,200232,3875,108157,83260,34770,71635,13329,81645,153280,109279,217436
ɽ,SongShanHuGuan,441900401,36712,115,16355,2018,6413,1940,799,2331,4271,21271,37626
Ÿ۹,HuMenGangGuan,441900402,1267,82,384,330,562,302,124,381,683,1089,1473
ݸ̬԰,DongGuanShengTaiYuan,441900403,2171,11,687,375,4,208,5,343,551,1500,2187
ʯֵ,ShiQiQuJieDao,442000001,162604,17921,103785,63533,138307,92137,28219,89484,181621,104959,208744
ֵ,DongQuJieDao,442000002,123113,8364,75201,44936,79460,62640,22453,62342,124982,78729,153930
濪,HuoJuKaiFa,442000003,200504,5963,106152,54292,57311,66139,21067,71707,137846,121382,227534
ֵ,XiQuJieDao,442000004,78128,4107,47194,29474,39232,42472,15438,42882,85354,50479,97673
ֵ,NanQuJieDao,442000005,53917,2880,29963,16394,19699,22236,7905,23344,45580,34739,64702
ɽֵ,WuGuiShanJieDao,442000006,44153,876,22800,10305,6780,10411,2970,12382,22793,25199,47999
С,XiaoLanZhen,442000100,265989,15034,146302,126024,151969,135836,34797,156062,291898,169518,315820
,HuangPuZhen,442000101,120200,7422,66203,43892,78359,58121,17718,64186,122307,79137,145340
,MinZhongZhen,442000102,87583,6608,51716,28739,69336,45211,14715,47143,92354,57190,108906
,DongFengZhen,442000103,101522,6203,56938,37770,69488,51184,15922,56637,107821,66709,123647
,DongShengZhen,442000104,100158,5106,53563,16377,65209,33848,12712,34073,67921,64413,117976
,GuZhenZhen,442000105,125920,6138,64052,31245,64262,45940,15713,50113,96053,83719,147771
ɳϪ,ShaXiZhen,442000106,98580,6292,58470,35797,52060,49608,14645,51254,100862,61047,119517
̹,TanZhouZhen,442000107,185829,6908,105415,78001,66206,90928,27139,98664,189592,114461,219876
ۿ,GangKouZhen,442000108,92862,5136,53917,34384,57094,48595,15693,52095,100690,59774,113691
,SanJiaoZhen,442000109,103565,5492,56754,34182,51846,43482,12755,46611,90093,65058,121812
,HengLanZhen,442000110,85369,4178,46274,20789,54092,35578,11868,37922,73500,55141,101415
ͷ,NanTouZhen,442000111,114172,3584,56430,45696,39790,48952,12614,57532,106484,73940,130370
ɳ,FuShaZhen,442000112,47197,2867,26172,14474,33282,21587,7580,23717,45304,31472,57644
,NanLangZhen,442000113,92073,4900,53059,26963,34104,36268,11217,37516,73784,55131,108190
,SanXiangZhen,442000114,173504,4863,97445,66100,36294,72107,21798,78718,150825,102720,200165
ܽ,BanFuZhen,442000115,69678,2873,39855,28145,30708,34071,9927,36711,70782,42623,82478
ӿ,DaYongZhen,442000116,65304,2973,32241,18646,25360,22762,6239,25276,48038,42275,74516
,ShenWanZhen,442000117,25759,1580,14742,8998,14691,12874,4220,13752,26626,16817,31559
Žֵ,XiangQiaoJieDao,445102001,10480,2197,7176,5639,11744,7093,1638,6899,13992,7139,14315
ֵ,XiHuJieDao,445102002,12857,2264,8831,6340,12527,8530,2024,8149,16679,8314,17145
ɽֵ,JinShanJieDao,445102003,10971,2296,7705,5229,10611,7200,1651,6963,14163,7213,14918
̫ƽֵ,TaiPingJieDao,445102004,12578,2501,8605,6702,13300,8547,1891,8178,16725,8365,16970
ϴֵ,NanChunJieDao,445102005,27276,3427,18113,11552,22376,17934,5273,17564,35498,17863,35976
½ֵ,XiXinJieDao,445102006,28007,4060,18619,11976,27832,18515,4798,18138,36653,18246,36865
Ŷֵ,QiaoDongJieDao,445102007,39514,2487,26595,7374,23623,12836,4199,12707,25543,19605,46200
ֵ,ChengXiJieDao,445102008,98970,8211,63379,37519,51331,60365,19699,59967,120332,63501,126880
½ֵ,FengXinJieDao,445102009,73929,5002,46374,24420,42548,42093,14867,42075,84168,47424,93798
Ϫ,YiXiZhen,445102100,33303,4461,22769,11746,42054,22424,7651,21902,44326,22646,45415
㶫ݾÿ,GuangDongChaoZhouJingJiKaiFaQu,445102401,3933,11,1962,518,4,480,43,546,1026,2025,3987
,GuXiangZhen,445121100,69349,5521,41555,13597,62814,31103,13364,30747,61850,46679,88234
,DengTangZhen,445121101,27178,2955,18242,8225,34436,17610,7850,17870,35480,19741,37983
,FengTangZhen,445121103,70278,6922,43916,18469,78816,39863,15948,41000,80863,49232,93148
,FuYangZhen,445121104,73067,8902,50051,21351,93607,46639,20043,46275,92914,51961,102012
,LongHuZhen,445121105,43576,5130,29963,11922,56456,28618,12209,28224,56842,30952,60915
ʯ,JinShiZhen,445121106,51579,5395,34521,14242,66217,33297,14266,33402,66699,36719,71240
ɳϪ,ShaXiZhen,445121107,40653,4564,28367,12056,54186,27699,12460,28108,55807,29310,57677
,CaiTangZhen,445121108,105473,8458,59855,23177,103589,53501,23136,53907,107408,77212,137067
,DongFengZhen,445121109,68145,8011,45408,18763,83658,42906,17592,42519,85425,48340,93748
ֲ,AnBuZhen,445121110,117829,10733,75881,34395,123229,68779,26222,68593,137372,78903,154784
Ϫ,LinXiZhen,445121111,51300,7251,35862,16302,69508,34997,13131,34111,69108,35820,71682
,TiePuZhen,445121112,25610,3556,17166,8238,32732,16241,5938,16340,32581,17938,35104
,GuanTangZhen,445121113,23396,3178,16225,7209,29331,14647,5655,14684,29331,16004,32229
,JiangDongZhen,445121114,49582,6713,34785,15368,67147,34512,13377,34277,68789,34887,69672
,GuiHuZhen,445121115,14883,2814,10629,6445,20852,10450,4068,10610,21060,11136,21765
,WenCiZhen,445121116,9841,1764,6783,3952,13481,6591,2247,6707,13298,7069,13852
,FengHuangZhen,445121117,26532,3540,18229,9565,35701,18198,7265,18971,37169,19108,37337
,ChiFengZhen,445121120,3712,893,2672,1834,5550,2574,1098,2788,5362,3031,5703
Ϫ,FengXiZhen,445121121,115764,9876,73364,38720,101411,69501,24498,70514,140015,76774,150138
ֳ,WanFengLinChang,445121400,329,95,225,166,503,216,82,225,441,281,506
Ƹ,HuangGangZhen,445122100,156715,18424,107061,48447,191112,102436,40195,102296,204732,108273,215334
,ShangRaoZhen,445122102,30317,4169,23464,11794,45165,23425,12310,23112,46537,23332,46796
,RaoYangZhen,445122103,31324,4913,23611,11823,43310,22036,10849,21100,43136,23475,47086
·,XinFengZhen,445122104,42508,4900,28503,13319,53816,27662,11482,28234,55896,30387,58890
,JianRaoZhen,445122106,7320,992,5656,2559,10873,5505,3236,5527,11032,5892,11548
,SanRaoZhen,445122107,33068,4127,23432,10886,45021,22278,10171,22223,44501,23934,47366
,XinTangZhen,445122108,11614,1743,8472,4396,16556,8470,3743,8570,17040,8628,17100
Ϫ,TangXiZhen,445122109,5172,960,3685,2378,6652,3312,1442,3286,6598,3889,7574
,FuBinZhen,445122110,12007,2455,8913,5137,17665,8367,3846,8258,16625,9395,18308
ɽ,FuShanZhen,445122112,14720,2738,10937,6020,21139,10219,4924,10297,20516,11445,22382
ɽ,DongShanZhen,445122113,10244,1600,7767,3848,14792,7515,4128,7726,15241,8205,15972
,XinWeiZhen,445122114,17107,3051,13227,7095,25086,12977,6194,12557,25534,13125,26352
Ϫ,ZhangXiZhen,445122116,9426,1597,6821,3687,13177,6793,2969,7007,13800,7171,13992
Ǯ,QianDongZhen,445122117,61583,7746,43775,19201,82452,40761,18672,39835,80596,44226,88001
,GaoTangZhen,445122118,12277,1908,9451,4453,18511,9302,4762,9232,18534,9496,18947
,LianRaoZhen,445122119,18661,3272,14424,7075,27506,14157,6676,13577,27734,14185,28609
,SuoChengZhen,445122120,21599,3612,16975,8381,31700,16590,7725,15126,31716,15961,32936
,DaChengZhen,445122121,17359,2825,13954,6780,26177,13895,6424,12190,26085,12654,26608
,ZheLinZhen,445122122,9757,1455,6783,3511,12424,6562,2104,5998,12560,6533,13316
,JingZhouZhen,445122123,41669,4573,28274,11868,54163,28179,10054,27788,55967,28022,56296
ɽ,HaiShanZhen,445122124,48492,5754,34442,15688,66524,34361,13484,32977,67338,33288,67730
ֳ,HanJiangLinChang,445122400,720,146,517,283,999,513,192,533,1046,541,1058
Żֵ,RongHuaJieDao,445202001,55298,5873,35328,20456,66397,34677,10495,35309,69986,36338,71666
˽ֵ,XinXingJieDao,445202002,41004,3985,26817,14106,51209,26045,8686,25968,52013,26858,53675
ɽֵ,ZhongShanJieDao,445202003,16534,3298,11011,6177,21613,10968,2532,10922,21890,11353,22364
ֵ,XiMaJieDao,445202004,27565,4036,17945,9089,33827,17502,4868,17562,35064,18524,36469
Ŷֵ,RongDongJieDao,445202006,29759,2296,18946,7608,31443,16596,6419,16880,33476,19528,38474
Žֵ,XianQiaoJieDao,445202007,93951,7069,61828,22795,110584,55691,27200,58192,113883,66392,128220
÷ƽֵ,MeiYunJieDao,445202008,48506,4168,32955,12128,61719,31282,15380,31950,63232,35099,68054
Ͷֵ,PanDongJieDao,445202009,57792,4978,36750,13551,65795,33039,13780,34181,67220,39800,76550
˽ֵ,DongXingJieDao,445202010,49772,3576,30797,13519,46971,23494,9872,24206,47700,32423,63220
ֵ,DongShengJieDao,445202011,32275,2626,20308,10018,36827,19254,7170,19995,39249,21763,42071
ֵ,DongYangJieDao,445202012,21551,1815,13617,5852,23462,12416,4820,12686,25102,14569,28186
,YuHuZhen,445202101,86330,8118,56497,24563,105841,53242,22662,54891,108133,60613,117110
ɽҵ԰�,DongShanGongYeYuanQuGuanLiChu,445202400,295,0,123,0,0,0,0,0,0,172,295
Ϫֵ,QuXiJieDao,445221001,80150,7183,47544,24077,87983,44313,16932,45519,89832,56721,104265
·,YunLuZhen,445221102,54261,7579,37848,18404,75776,37719,15491,39278,76997,39483,77331
,YuJiaoZhen,445221103,32918,4653,22726,11391,45579,22689,8790,23527,46216,23635,46361
Ǹ,DengGangZhen,445221104,52370,6308,35605,16069,70911,35328,13960,36342,71670,37033,72638
̨,PaoTaiZhen,445221105,85361,8218,56718,25002,109514,51895,20821,53653,105548,57682,114400
ض,DiDouZhen,445221106,69222,7297,46878,20277,93862,46112,18661,47097,93209,48302,95180
,LinPanZhen,445221107,51341,6132,36018,15417,72465,35764,16249,37104,72868,37704,73722
³,YueChengZhen,445221108,29655,3394,21614,9490,43037,21370,10934,21880,43250,22369,43983
,BaiTaZhen,445221109,60980,7719,43619,18869,87506,43063,20363,44850,87913,45443,89062
β,LongWeiZhen,445221110,21950,3199,15637,7940,32106,15558,7287,16572,32130,16799,32436
,GuiLingZhen,445221111,44065,5475,31535,13904,63884,31356,15020,32695,64051,33025,64560
,XiChangZhen,445221112,77711,8855,53162,23770,106227,52630,22026,54550,107180,55430,108592
º,XinHengZhen,445221113,69287,8386,48658,21918,97004,48283,21325,49803,98086,50340,98998
,YuHuZhen,445221114,53967,8081,40053,18885,80003,40032,19342,41210,81242,41337,81390
,PuTianZhen,445221115,38149,5419,26810,14103,54365,26803,11781,28527,55330,28539,55349
賡,DongJingChaChang,445221401,4,0,4,0,0,0,0,0,0,0,4
ئũ,SaLingNongChang,445221403,506,132,383,252,793,383,155,410,793,410,793
,GaoXinQu,445221404,54,0,12,1,0,1,0,1,2,42,54
Žֵ,HePoJieDao,445222001,87096,10755,58495,29516,118801,54656,23370,56820,111476,62726,121221
̶,LongTanZhen,445222102,22406,3436,15498,7135,32295,15253,6953,16900,32153,17297,32795
ɽ,NanShanZhen,445222103,20947,3179,15281,6080,29974,15060,6607,15070,30130,15452,30733
徭,WuJingFuZhen,445222104,33896,5491,23335,11046,48632,21441,9700,21696,43137,25752,49087
Ϫ԰,JingXiYuanZhen,445222105,29356,4323,20796,9102,41788,20478,8571,20987,41465,21454,42250
կ,HuiZhaiZhen,445222106,25306,3738,17465,7880,35554,17009,7242,18190,35199,18821,36286
ͷ,TaTouZhen,445222107,28244,3880,21003,8782,42587,20260,10835,20926,41186,21956,42959
԰,DongYuanZhen,445222108,21271,2854,16124,6226,32279,16009,8855,16576,32585,16856,32980
ｭ,FengJiangZhen,445222109,45075,5746,33996,12602,68272,32930,18306,33586,66516,35131,69127
޺,MianHuZhen,445222110,70025,8226,48767,20382,96266,47069,21518,48452,95521,51002,99769
,JinHeZhen,445222111,42465,5638,31619,12451,64238,31081,16959,32516,63597,33443,65062
Ϫ,DaXiZhen,445222112,14850,2250,11278,4999,22502,11252,6002,11795,23047,11824,23102
Ǯ,QianKengZhen,445222113,25961,3681,18932,7641,38339,17418,9739,18329,35747,20449,39381
ƺ,PingShangZhen,445222114,24800,3734,17545,8012,35046,17238,7606,18174,35412,18595,36140
,WuYunZhen,445222115,31756,3996,24044,9128,46238,24019,11917,23585,47604,23625,47669
ɰ,ShangShaZhen,445222116,27883,3625,22194,10048,44215,22150,13363,22630,44780,22677,44871
,LiangTianXiang,445222201,7405,1262,5730,2417,11490,5659,3064,5855,11514,6001,11731
ɽũֳ,BeiShanNongLinChang,445222401,161,27,75,51,78,24,8,54,78,121,196
ֳ,GuoLinChang,445222402,73,16,35,61,94,35,5,59,94,59,94
ֳͩ,YouTongLinChang,445222403,70,5,31,28,75,30,0,35,65,44,75
ũ,GaoTianNongChang,445222404,72,17,38,35,104,36,15,42,78,66,104
fũ,HeSheNongChang,445222405,24,1,7,20,12,7,0,18,25,18,25
Գ,XianMiaoPuChang,445222406,66,4,32,30,70,32,0,38,70,38,70
ݳ,HuiChengZhen,445224100,103705,10218,72713,33948,143660,71011,37051,74956,145967,78261,150974
,HuaHuZhen,445224102,35839,3898,28933,10046,54191,28853,18361,28693,57546,29165,58098
,XianAnZhen,445224103,44274,4912,37636,12647,69592,37493,23847,34831,72324,35397,73033
,JingHaiZhen,445224104,48208,5413,36032,14650,69300,35826,17370,34363,70189,34959,70991
,ZhouTianZhen,445224105,38181,5096,32851,12132,60285,32789,20344,30419,63208,30770,63621
ǰղ,QianZhanZhen,445224106,28458,3166,22796,9199,43719,22717,13339,21923,44640,22167,44963
Ȫ,ShenQuanZhen,445224107,50273,5204,40086,14727,75731,40005,24672,39839,79844,40063,80149
¤,DongLongZhen,445224108,49600,5261,41291,13903,78631,41286,26209,39774,81060,39779,81070
ʯ,QiShiZhen,445224109,36316,3667,32479,10304,58000,32435,23479,30874,63309,30983,63462
¡,LongJiangZhen,445224110,87959,8863,70293,23735,135976,70288,43922,70449,140737,70451,140744
Ϫ,XiXiZhen,445224111,38882,3831,32587,10566,62679,32354,22320,32024,64378,32446,65033
�,AoJiangZhen,445224112,27764,2869,24204,6113,44790,24038,17406,23475,47513,23835,48039
,DongGangZhen,445224113,20553,2052,16276,5754,31806,16102,10512,16370,32472,16841,33117
̶,KuiTanZhen,445224114,61722,6216,46491,22800,93333,46435,27779,49008,95443,49226,95717
ũ,DongPuNongChang,445224401,5494,708,4903,1846,9072,4903,3497,4795,9698,4796,9699
дɽȹ,JieYangShiDaNanShanHuaQiaoGuanLiQu,445224402,8652,1129,7164,3585,13241,7161,4594,7187,14348,7211,14375
̶ũ,KuiTanNongChang,445224403,2113,310,1622,598,3278,1615,997,1750,3365,1798,3420
ֳ,QingKengLinChang,445224404,671,59,538,252,992,536,361,548,1084,553,1091
ɳֵ,LiuShaDongJieDao,445281001,77761,6576,52813,19749,92682,48582,24111,51691,100273,55635,108448
ɳϽֵ,LiuShaNanJieDao,445281002,60491,3853,37969,13141,58153,29387,14462,30634,60021,40837,78806
ɳֵ,LiuShaXiJieDao,445281003,97847,6513,60981,29920,108115,56774,26246,63738,120512,69625,130606
ɳֵ,LiuShaBeiJieDao,445281004,79732,4635,48339,22314,76779,42771,19309,46824,89595,55337,103676
βֵ,ChiWeiJieDao,445281005,58088,3874,37532,13831,62219,31610,17227,33002,64612,41657,79189
,ChiGangZhen,445281102,31386,3227,23946,8192,44712,23867,12864,23389,47256,23531,47477
,DaBaZhen,445281103,57571,5719,44660,17576,82923,44647,26179,44807,89454,44809,89469
,HongYangZhen,445281104,98154,9330,72071,27414,135482,70640,36804,71218,141858,72217,144288
Ϫ,NanXiZhen,445281105,65467,6582,47797,18902,95970,47791,25698,49945,97736,49950,97747
̫,GuangTaiZhen,445281106,32311,2928,24923,8903,47470,24905,13875,24175,49080,24191,49114
,QiLinZhen,445281107,61409,6492,48883,14608,95303,48429,31897,49940,98369,50915,99798
Ͼ,NanJingZhen,445281108,71286,7088,56108,18744,107336,56078,33631,55879,111957,55897,112005
ռ¤,ZhanLongZhen,445281109,108299,9925,80508,28682,150665,78546,43215,77851,156397,80931,161439
,JunBuZhen,445281110,69974,6189,52361,17171,95717,52065,28436,51998,104063,52238,104599
¼ɽ,XiaJiaShanZhen,445281111,55944,5217,41145,15041,80068,41094,22661,42471,83565,42677,83822
ɽ,DaNanShanZhen,445281112,24175,2071,17553,6425,32813,17233,9097,17233,34466,17790,35343
,GaoPuZhen,445281113,32680,3387,27230,9988,52486,27230,17858,26695,53925,26695,53925
,YunLuoZhen,445281114,28162,3147,23873,8138,45367,23860,15800,23225,47085,23236,47109
ƺ,DaPingZhen,445281115,14410,1697,12345,4537,22744,12335,7789,11537,23872,11551,23896
,ChuanPuZhen,445281116,24579,2585,19484,7401,36379,19484,11416,19096,38580,19096,38580
÷,MeiLinZhen,445281117,31575,3726,25819,9230,45995,25819,15816,25298,51117,25298,51117
,LiHuZhen,445281119,53058,6030,39488,15085,78478,39486,21576,41175,80661,41176,80664
÷,MeiTangZhen,445281121,75146,8589,56948,21648,111060,56656,32324,58826,115482,59111,116059
ԭ,LiaoYuanZhen,445281122,47862,4831,35077,13145,69144,35063,19541,37091,72154,37157,72234
Ϫ,HouXiXiang,445281201,6064,866,5128,2023,9549,5128,3216,5018,10146,5018,10146
ũ,DaChiNongChang,445281401,3939,519,3150,1337,5929,3150,1827,3135,6285,3135,6285
�ɽũ,MaAnShanNongChang,445281402,3847,474,3502,1539,6147,3487,2543,3290,6777,3362,6864
ƺũ,DaPingNongChang,445281403,4171,414,3308,1242,6150,3306,1811,3078,6384,3088,6396
,PuQiaoQu,445281404,6297,951,4718,2210,8991,4572,2664,4926,9498,5194,9912
ũ,SanKengNongChang,445281405,206,76,138,97,320,134,55,165,299,199,337
ʯũ,WuShiNongChang,445281406,3022,20,1762,54,19,78,101,86,164,1381,3143
Ƽҵ԰,KeJiGongYeYuan,445281407,3051,3,1367,30,20,37,5,28,65,1692,3059
Ƴǽֵ,YunChengJieDao,445302001,127356,10015,78656,42443,122626,73197,27596,78853,152050,86311,164967
߷ֵ,GaoFengJieDao,445302002,21962,2713,13711,8544,20599,12956,4784,14200,27156,15748,29459
ӿڽֵ,HeKouJieDao,445302003,24923,2223,15783,6225,19902,10695,4008,11401,22096,15371,31154
ֵ,AnTangJieDao,445302004,14133,2372,9303,5830,16828,8837,3591,9480,18317,10793,20096
,YaoGuZhen,445302102,15697,2910,11550,7209,22847,11487,5065,11907,23394,12122,23672
˼,SiLaoZhen,445302103,10236,2202,7378,4865,13839,7104,3425,7348,14452,8485,15863
,DouYangZhen,445302104,21799,4216,15806,9850,31648,15631,6919,16148,31779,17128,32934
³,XinChengZhen,445321100,101863,11218,67160,34000,100425,56630,21833,58899,115529,67754,134914
,CheGangZhen,445321101,15302,2750,11543,6608,22141,11247,5380,11118,22365,11889,23432
ˮ̨,ShuiTaiZhen,445321103,9884,1390,6490,3416,11739,5847,2679,6055,11902,7463,13953
,RenCunZhen,445321104,22745,3380,15905,7946,30393,15142,6817,15200,30342,17037,32942
,DongChengZhen,445321105,16431,3002,12347,6759,24041,12045,5483,12072,24117,12569,24916
̫ƽ,TaiPingZhen,445321107,34398,6210,25168,14262,50289,24963,10472,25282,50245,25912,51080
ﶴ,LiDongZhen,445321108,9066,1556,6898,4337,13719,6855,3483,7113,13968,7207,14105
,LiuZuZhen,445321109,34760,6375,26094,14691,50904,25939,11366,25857,51796,26407,52501
,DaJiangZhen,445321110,4697,893,3331,2191,6692,3274,1440,3371,6645,3699,7030
,TianTangZhen,445321112,30268,5943,23125,13674,45129,22804,9720,22155,44959,22806,45931
ͷ,HeTouZhen,445321113,11909,2327,8732,5433,17523,8632,3814,9068,17700,9318,18050
{,LeZhuZhen,445321114,8616,1619,6286,3761,11515,5863,2546,5833,11696,6495,12781
,DuChengZhen,445322100,65527,7307,41039,25001,71205,38596,12825,41658,80254,44620,85659
ƽ̨,PingTaiZhen,445322101,14668,2435,10695,6161,20147,10495,5017,10812,21307,11425,22120
,GuiWeiZhen,445322102,18105,3614,12752,8847,25784,12591,5642,14017,26608,14609,27361
ͨ,TongMenZhen,445322104,9239,1734,6629,4340,12534,6547,2764,6833,13380,7108,13737
,JianChengZhen,445322105,20470,4269,14173,10101,28008,13684,5281,14483,28167,15847,30020
,BaoZhuZhen,445322106,7200,1411,5030,3414,9945,4946,2073,5209,10155,5654,10684
,DaFangZhen,445322108,5526,1263,4253,2967,8259,4152,2004,4292,8444,4540,8793
ǧ,QianGuanZhen,445322110,19501,4085,15484,10406,28267,15252,7725,15311,30563,15827,31311
,DaWanZhen,445322111,10429,1712,7718,4615,14123,7529,3520,7533,15062,7943,15661
ӿ,HeKouZhen,445322112,12885,2471,10418,7000,19071,10288,5378,9782,20070,10316,20734
ι,SongGuiZhen,445322113,9675,2220,7679,5385,14164,7489,3583,7136,14625,7799,15478
,DongBaZhen,445322114,15720,3493,12760,7372,23972,12574,6257,12045,24619,12710,25470
̲,LianTanZhen,445322115,27882,4797,21157,13792,38960,21055,9462,20624,41679,20984,42141
,LiDongZhen,445322116,7478,1813,5922,4175,11222,5868,2788,5969,11837,6157,12079
Ͻ,NanJiangKouZhen,445322117,18734,2998,12926,7860,24617,12599,5752,12936,25535,14558,27484
,LiuDouZhen,445323100,32845,3911,21124,10468,39857,18874,7567,19878,38752,23199,44323
ߴ,GaoCunZhen,445323101,12736,2963,9675,6587,18905,9604,4523,10174,19778,10547,20222
ʯ,BaiShiZhen,445323102,15530,2774,11823,7220,22274,11807,5311,11710,23517,11792,23615
,ZhenAnZhen,445323103,27751,3934,19739,10565,36801,19630,8681,20335,39965,20627,40366
,FuLinZhen,445323104,30901,3649,23185,10790,41871,23032,12272,23013,46045,23637,46822
ʢ,NanShengZhen,445323107,21705,3367,15292,7717,30690,14938,7133,16044,30982,16913,32205
ǰ,QianFengZhen,445323108,12539,2624,9346,5856,18182,9245,3938,9392,18637,9755,19101
ʯ,ShiChengZhen,445323109,29486,3921,20357,10077,39681,19983,9575,21666,41649,22625,42982
޳ǽֵ,LuoChengJieDao,445381001,81300,8426,51656,31835,87008,47413,21112,52224,99637,59182,110838
ֵ,SuLongJieDao,445381002,70219,8829,51604,25800,91139,50554,25417,51425,101979,52861,104465
ǽֵ,FuChengJieDao,445381003,34843,4364,26201,14374,44663,24199,12794,24285,48484,25800,52001
˫ֵ,ShuangDongJieDao,445381004,11634,1687,8724,5216,16139,8440,3942,8008,16448,8539,17263
޾,LuoJingZhen,445381100,40797,7045,32893,19252,59699,32525,18302,32371,64896,33251,66144
̫ƽ,TaiPingZhen,445381101,31602,4283,23966,12904,47183,23879,13469,25284,49163,25388,49354
ֽ,FenJieZhen,445381102,12657,2098,10488,6005,19383,10488,6235,10501,20989,10502,20990
ƽ,LuoPingZhen,445381104,42628,5646,33721,16840,63408,33634,20343,34494,68128,34896,68617
,ChuanBuZhen,445381105,38331,4882,31349,16029,61029,30542,20092,30435,60977,31956,63305
,ManTangZhen,445381106,22063,2807,17551,9157,33036,17335,10495,17225,34560,17814,35365
ƻ,PingTangZhen,445381107,21756,2820,16758,9523,33206,16688,9527,16956,33644,17345,34103
,JinJiZhen,445381108,16065,2219,13317,7325,24560,13313,8109,13071,26384,13076,26393
Χ,WeiDiZhen,445381109,24511,2985,18324,9664,35327,18178,10059,18830,37008,19231,37555
ʯ,HuaShiZhen,445381110,15677,2338,12437,7278,24437,12437,7043,12621,25058,12621,25058
W,TanBinZhen,445381111,26427,3787,20280,11288,38587,20233,10230,20137,40370,20164,40444
,LiShaoZhen,445381113,25172,4603,20034,13690,38053,19812,10191,19493,39305,19932,39966
,ShengJiangZhen,445381114,20860,3147,15730,8994,31357,15444,7878,15541,30985,16155,31885
,LianZhouZhen,445381115,25786,4113,19784,13869,38377,19591,10500,20166,39757,20615,40399
,SiLunZhen,445381116,35479,6234,27706,17732,52647,27618,13929,27486,55104,27936,55642
,JiaYiZhen,445381118,11495,2169,9484,5765,17538,9482,4970,9148,18630,9150,18634
,LongWanZhen,445381119,11510,2520,10145,6064,19391,10042,6063,9755,19797,9948,20093
ƽũ,LuoPingNongChang,445381400,276,43,230,142,419,220,173,235,455,262,492
ֵ´,MinShengJieDaoBanShiChu,450102001,96038,8275,57253,35992,55301,47183,13273,46744,93927,60333,117586
ֵ´,ZhaoYangJieDaoBanShiChu,450102002,119011,8820,69576,44095,56050,60310,20864,62451,122761,79119,148695
,SanTangZhen,450102101,40677,3472,22227,13547,35375,19773,8136,22790,42563,30058,52285
,WuTangZhen,450102102,39471,4727,24911,14470,49180,24181,9780,27047,51228,29067,53978
,KunLunZhen,450102104,11311,2153,8124,5174,17007,8083,3774,8985,17068,9114,17238
ũ,JiuQuWanNongChang,450102450,6831,421,4333,2595,3779,4149,1755,4340,8489,4674,9007
ֵ´,XinZhuJieDaoBanShiChu,450103001,105794,14824,71619,43103,92853,60062,14913,55944,116006,63912,135531
ɽֵ´,ZhongShanJieDaoBanShiChu,450103002,103024,10410,67638,40349,66921,53196,13524,50010,103206,59320,126958
ֵ´,JianZhengJieDaoBanShiChu,450103003,77492,4569,42581,29088,37960,36184,11299,36413,72597,50779,93360
Ϻֵ´,NanHuJieDaoBanShiChu,450103004,71873,3958,41488,28363,33910,36141,10975,35394,71535,45318,86806
ͷֵ´,JinTouJieDaoBanShiChu,450103005,95737,6307,54617,33565,43501,43509,12704,41452,84961,60131,114748
ɺÿίԱ,XianHuJingJiKaiFaQuGuanLiWeiYuanHui,450103006,48531,2150,25913,14579,17940,19433,7468,21801,41234,32236,58149
,LiuWeiZhen,450103100,20381,4481,15099,11397,30140,15086,6323,16042,31128,16086,31185
,NanYangZhen,450103101,11863,3012,9311,7017,18497,9292,4371,9874,19166,9935,19246
,LingLiZhen,450103102,15228,3029,11211,8366,21860,11167,5105,12040,23207,12151,23362
,ChangTangZhen,450103103,13845,2345,9580,7142,18896,9567,4116,10703,20270,10726,20306
ɽίԱ,QingXiuShanGuanLiWeiYuanHui,450103451,69,1,36,2,2,0,0,2,2,34,70
԰ֵ´,FuJianYuanJieDaoBanShiChu,450105001,139886,13603,88182,60982,95204,79485,22043,79556,159041,87350,175532
Ͻֵ´,JiangNanJieDaoBanShiChu,450105002,69637,4904,42306,26983,36464,37582,14373,38668,76250,46608,88914
ɳֵ´,ShaJingJieDaoBanShiChu,450105003,34859,3303,22022,13194,34560,20572,8971,22122,42694,25111,47133
Ǻֵ´,NaHongJieDaoBanShiChu,450105004,62516,3477,34727,23396,23834,31264,11394,34744,66008,42660,77387
,WuWeiZhen,450105102,42680,4515,26765,17140,50551,26015,11742,30522,56537,32172,58937
,SuWeiZhen,450105103,37010,4392,24240,16172,48950,24119,10780,27628,51747,27942,52182
Ӱ,YanAnZhen,450105104,14340,2075,9522,7104,19264,9491,4361,11183,20674,11254,20776
,JiangXiZhen,450105105,21534,3390,14318,9823,28387,14151,5651,15983,30134,16257,30575
ü�,JingJiJiShuKaiFaQu,450105450,9,0,0,0,1,0,0,0,0,9,9
ҵ԰ί,MingYangGongYeYuanQuGuanWeiHui,450105451,14916,632,8493,2509,5593,2966,1006,3179,6145,8061,16554
ֵ´,HengYangJieDaoBanShiChu,450107001,113588,10355,68197,49607,64641,59567,15471,60487,120054,71217,139414
ֵ´,BeiHuJieDaoBanShiChu,450107002,157611,9639,93008,74813,80823,80195,18259,82712,162907,92501,185509
ֵ´,XiXiangTangJieDaoBanShiChu,450107003,182192,9228,102775,41161,99726,54859,14886,55134,109993,103531,206306
ֵ´,AnJiJieDaoBanShiChu,450107004,80782,5345,47594,33503,44436,41699,13581,44900,86599,52114,99708
ǿֵ´,HuaQiangJieDaoBanShiChu,450107005,22422,2635,14483,9175,14118,12622,3129,12190,24812,13703,28186
ֵ´,XinYangJieDaoBanShiChu,450107006,81508,8580,51153,35604,57821,48195,13076,48809,97004,52011,103164
Ңֵ´,ShangYaoJieDaoBanShiChu,450107007,59797,2604,33535,21110,18838,23940,8296,26578,50518,37162,70697
ֵ´,AnNingJieDaoBanShiChu,450107008,39229,1890,21789,12597,16076,17648,7858,20001,37649,27188,48977
ʯֵ´,ShiBuJieDaoBanShiChu,450107009,30188,2776,18063,8538,28370,14545,6617,16182,30727,21518,39581
׽ֵ´,XinWeiJieDaoBanShiChu,450107010,41540,2258,26229,13728,24126,19283,7789,20898,40181,25358,51587
,JinLingZhen,450107100,32921,4719,22508,14986,40516,22342,10464,25331,47673,25596,48104
˫,ShuangDingZhen,450107101,19814,2293,12912,7711,26789,12807,5795,14481,27288,14990,27902
̳,TanLuoZhen,450107105,44314,6202,30706,19706,62378,30667,14421,34119,64786,34231,64937
,NaLongKuangWuJu,450107450,1154,185,789,732,1491,784,243,777,1561,793,1582
ũ,LuoWenNongChang,450107451,8769,298,4729,1424,4933,1791,713,1996,3787,5051,9780
ʯ̳,ShiBuNaiChang,450107452,1682,128,1079,614,1269,933,421,962,1895,1152,2231
ũ,JinGuangNongChang,450107453,7406,906,4621,3911,8203,4550,1339,4927,9477,5030,9651
¼�ί,GaoXinJiShuKaiFaQuGuanWeiHui,450107454,12850,504,7810,5049,2505,6915,2635,7059,13974,8179,15989
ɳֵ´,DaShaTianJieDaoBanShiChu,450108001,149845,7250,90307,61260,40386,83101,36045,91188,174289,102833,193140
,LiangQingZhen,450108100,26705,2772,19209,10447,36413,18925,9726,19376,38301,19994,39203
,NaMaZhen,450108101,16445,2052,10784,6815,20769,10461,4885,11858,22319,12598,23382
ǳ,NaChenZhen,450108102,16762,2889,11036,7997,23389,11029,4789,13372,24401,13404,24440
,DaTangZhen,450108103,25793,3722,16796,12414,34209,16523,8123,20349,36872,20842,37638
,NanXiaoZhen,450108104,17463,3455,12126,9569,25416,12098,6038,14782,26880,14830,26956
쾭ÿί,LiangQingJingJiKaiFaQuGuanWeiHui,450108452,6,3,3,4,5,3,0,4,7,6,9
,PuMiaoZhen,450109100,87189,9986,57728,35026,102106,52993,22207,56440,109433,61654,119382
¥,NaLouZhen,450109101,40815,6692,28987,19029,60917,28891,13967,32277,61168,32487,61474
½,XinJiangZhen,450109102,14695,2255,10240,6720,21288,10230,4867,11530,21760,11577,21817
ټ,BaiJiXiang,450109200,22770,3188,16050,9773,32196,15997,8977,18589,34586,18885,34935
к,ZhongHeXiang,450109202,13980,2860,10421,7317,20835,10385,5273,11600,21985,11692,22113
,ChengXiangZhen,450122100,92889,10376,58936,37249,85347,52409,17649,55267,107676,61978,120914
̫ƽ,TaiPingZhen,450122102,21725,3735,14334,9708,29394,14140,5026,15750,29890,16152,30486
˫,ShuangQiaoZhen,450122103,33328,5147,21310,14512,43563,21018,7003,23428,44446,24168,45478
,NingWuZhen,450122104,22234,3329,14510,10617,28636,14146,5033,15441,29587,16086,30596
,LuoWeiZhen,450122105,31447,5485,21406,14797,42329,20751,7372,22158,42909,22898,44304
ɺ,XianHuZhen,450122106,23762,3720,15224,9203,31439,14920,4627,16322,31242,16885,32109
,FuChengZhen,450122107,26637,4932,18234,13426,36661,17612,6782,19371,36983,20117,38351
½,LuWoZhen,450122108,31473,5913,21252,14959,42807,21207,6630,22665,43872,22764,44016
,LiangJiangZhen,450122109,18336,4051,13036,9868,25675,12875,4277,13326,26201,13628,26664
޲,LuoBoZhen,450122110,16052,3646,11557,7765,21385,10578,3840,10977,21555,11981,23538
,LingMaZhen,450122111,17213,2728,13948,8275,26204,13767,8510,14269,28036,14503,28451
,GanWeiZhen,450122112,10842,1605,8058,5652,16215,7954,4485,8601,16555,8874,16932
ͷ,MaTouZhen,450122113,10363,2562,7615,5308,15074,7560,2552,7736,15296,7862,15477
ٺũ,BaiHeNongChang,450122450,658,92,438,347,637,438,162,474,912,474,912
Ͷ,NanNingHuaQiaoTouZiQu,450122451,32206,4176,19193,11870,28490,16056,5230,16541,32597,22419,41612
ũ,DongFengNongChang,450122452,3205,681,2184,1772,4061,2176,752,2412,4588,2454,4638
,ChengXiangZhen,450123100,42839,5965,28908,17602,47647,26360,11231,28179,54539,31127,60035
,NanWeiZhen,450123101,30656,6305,22265,14236,44499,22153,9854,23820,45973,24550,46815
㽭,YanJiangZhen,450123102,11418,2219,8305,6038,15870,8289,3527,8832,17121,8859,17164
ͩ,NaTongZhen,450123103,27849,4241,19454,12465,38641,19324,9114,21534,40858,21750,41204
ǽ,QiaoJianZhen,450123104,18567,3691,14032,8651,27873,13946,7033,15013,28959,15259,29291
,DingDangZhen,450123105,17000,2832,11699,7975,23579,11641,4976,12972,24613,13109,24808
̶,GuTanXiang,450123201,14009,2195,9842,5662,19609,9788,5104,11121,20909,11466,21308
,DouJieXiang,450123203,17147,3640,13554,8870,25423,13539,6831,14053,27592,14064,27618
Ȫ,BuQuanXiang,450123204,9488,2371,7716,5059,14904,7716,3575,7704,15420,7718,15434
ɽ,PingShanXiang,450123205,6187,1730,5325,3655,10024,5295,2757,5295,10590,5349,10674
¡ȹίԱ,LongAnHuaQiaoGuanLiQuGuanLiWeiYuanHui,450123450,4157,606,2642,2132,3755,2548,1101,2912,5460,3222,5864
ɽ,BaiShanZhen,450124100,49595,6324,36053,19325,59768,33808,15766,33651,67459,35632,71685
̲,BaiLongTanZhen,450124101,9696,1647,7649,5003,14426,7641,3873,7555,15196,7567,15216
,LinWeiZhen,450124102,42917,6089,34036,19554,65675,34014,20414,35318,69332,35384,69420
,GuLingZhen,450124103,27377,4493,19921,11992,39979,19855,9036,20862,40717,20985,40906
,JinChaiZhen,450124104,14787,2348,11241,6550,21373,10963,5069,10650,21613,10963,22204
¹,ZhouLuZhen,450124105,35174,6525,28959,18746,54888,28078,16321,28337,56415,29061,58020
,YongZhouZhen,450124106,21414,4250,16310,10291,33076,16225,7892,17160,33385,17246,33556
,QiaoLiXiang,450124200,14867,2570,12021,8177,23993,11952,7009,12343,24295,12425,24446
ӷ,JiaFangXiang,450124201,14506,3189,11078,6935,21163,11078,4668,11283,22361,11285,22363
կ,GuZhaiYaoZuXiang,450124202,10339,2308,7803,4661,15146,7785,3078,7877,15662,7922,15725
ﵱ,LiDangYaoZuXiang,450124203,11293,2004,7946,5149,16192,7936,3197,8534,16470,8548,16494
ɽֳ,GuangMingShanLinChang,450124450,583,96,402,285,836,394,186,438,832,463,865
,DaFengZhen,450125100,45448,5334,30390,17342,45305,27020,11044,27785,54805,31436,61826
,MingLiangZhen,450125101,14261,2618,10015,6665,20231,9977,4020,10822,20799,10884,20899
,XiangXianZhen,450125102,16976,3724,11980,8317,25197,11954,4744,13425,25379,13464,25444
,BaiWeiZhen,450125103,34657,5767,26977,17394,53446,26970,14670,28096,55066,28117,55094
,SanLiZhen,450125104,25345,4780,19045,11256,37417,19010,8194,19218,38228,19274,38319
,QiaoXianZhen,450125105,16373,3078,12167,8123,24187,12142,5263,12499,24641,12547,24714
,XiYanZhen,450125106,18185,3835,14270,8892,28090,14240,6554,14225,28465,14304,28574
̩,ChengTaiXiang,450125200,18227,3329,13414,8732,26958,13403,6245,14297,27700,14387,27801
ľɽ,MuShanXiang,450125202,10868,1879,7684,4567,15639,7646,3037,8023,15669,8100,15784
,TangHongXiang,450125203,16240,3914,13306,9162,25832,13278,6218,13026,26304,13066,26372
,ZhenWeiYaoZuXiang,450125205,12314,2212,9369,5430,18363,9351,4237,9383,18734,9394,18763
,BinZhouZhen,450126100,153443,16507,96027,54386,173821,90013,38124,99368,189381,112047,208074
,LiTangZhen,450126101,78754,10211,53655,34427,89432,50842,21829,53725,104567,57139,110794
,GanTangZhen,450126102,21495,4969,17259,12164,34899,17092,9166,18213,35305,18371,35630
˼¤,SiLongZhen,450126103,27057,4012,19303,11887,40770,19013,10124,21330,40343,21890,41193
,XinQiaoZhen,450126104,47709,5206,31212,17778,63205,30305,13068,33821,64126,34771,65983
,XinWeiZhen,450126105,12370,1904,9357,6101,18769,9331,4868,9733,19064,9785,19142
,ZouWeiZhen,450126106,19293,3182,14885,9389,30060,14797,8251,15576,30373,15841,30726
,DaQiaoZhen,450126107,34391,5530,25799,16044,52274,25742,13563,27567,53309,27685,53484
,WuLingZhen,450126108,25047,4294,18664,12453,38018,18511,9506,19971,38482,20183,38847
л,ZhongHuaZhen,450126109,12656,2502,9835,7016,20357,9794,5637,10777,20571,10960,20795
,GuLaZhen,450126110,23646,4247,17465,11640,35491,17407,8676,18781,36188,19104,36569
¶,LuWeiZhen,450126111,13543,3077,10944,8724,22413,10906,6300,11892,22798,11976,22920
,WangLingZhen,450126112,17509,2778,12800,8534,25063,12690,6493,13682,26372,13980,26780
ͼ,HeJiZhen,450126113,21244,2951,15601,8966,31260,15567,7901,16228,31795,16495,32096
,YangQiaoZhen,450126114,14285,2165,10799,6950,21492,10765,5920,11367,22132,11571,22370
ƽ,ChenPingXiang,450126200,8558,1742,5454,4030,11038,5291,2865,5860,11151,7711,13165
ƽũ,LiaoPingNongChang,450126451,2735,406,1766,1664,2939,1714,546,1843,3557,1921,3687
,HengZhouZhen,450127100,120735,13090,79710,43862,135692,73537,29228,76799,150336,83343,163053
ٺ,BaiHeZhen,450127101,44013,8807,34716,20785,64807,33766,17996,35015,68781,36100,70816
,NaYangZhen,450127102,29138,4644,22188,13129,43038,22145,11682,23156,45301,23276,45464
,NanXiangZhen,450127103,35640,7103,29434,19295,54847,29306,18565,31592,60898,31874,61308
¸,XinFuZhen,450127104,20516,3996,16254,10621,32078,16181,9450,17490,33671,17708,33962
,LianTangZhen,450127105,19724,3154,14829,9328,29989,14543,7986,15813,30356,16035,30864
ƽ,PingMaZhen,450127106,17010,2799,12841,8184,25004,12742,6680,13457,26199,13648,26489
ͳ,LuanChengZhen,450127107,24901,5135,18317,12147,33939,18023,7724,18928,36951,19443,37760
,LiuJingZhen,450127108,44122,8070,31811,20268,62104,31479,14687,33563,65042,35068,66879
ʯ,ShiTangZhen,450127110,31571,5361,22918,15408,44403,22765,11098,24852,47617,25112,48030
,TaoWeiZhen,450127112,33647,6954,25738,17580,52023,25188,13067,26941,52129,27930,53668
У,XiaoYiZhen,450127113,42661,8049,31828,20996,64169,31523,15886,34317,65840,34768,66596
Ʊ,YunBiaoZhen,450127114,42749,6491,29567,18639,59178,29260,12923,32349,61609,32596,62163
,MaLingZhen,450127115,15735,2152,11366,6600,22329,11309,5194,11665,22974,11715,23081
ɽ,MaShanXiang,450127200,23295,5316,19289,14268,36212,19199,11154,20288,39487,20476,39765
ƽ,PingLangXiang,450127203,10010,2576,7904,5561,15052,7839,3886,8215,16054,8568,16472
,ZhenLongXiang,450127204,6801,1585,4783,3282,10289,4741,2124,5552,10293,5727,10510
ũ,LiangQiNongChang,450127450,4467,532,2935,2141,4675,2871,1122,3041,5912,3186,6121
нֵ´,ChengZhongJieDaoBanShiChu,450202001,7284,1087,4978,3037,5887,4417,1001,3851,8268,4394,9372
԰ֵ´,GongYuanJieDaoBanShiChu,450202002,12140,2355,8727,5517,12236,8266,1911,7362,15628,7679,16406
Ͻֵ´,ZhongNanJieDaoBanShiChu,450202003,17990,2573,12049,7446,15358,10896,2360,10044,20940,10874,22923
ˮϽֵ´,ShuiShangJieDaoBanShiChu,450202004,618,4,15,12,385,12,5,13,25,612,627
̶нֵ´,TanZhongJieDaoBanShiChu,450202005,48549,3949,27206,15049,34044,21677,6758,21175,42852,32050,59256
Ӷֵ´,HeDongJieDaoBanShiChu,450202006,28781,1759,18662,10769,16185,16468,7259,16876,33344,19137,37799
ֵ´,JingLanJieDaoBanShiChu,450202007,10289,1007,6320,4272,5547,6087,2538,6590,12677,7514,13834
ֵ´,TianMaJieDaoBanShiChu,450203001,24616,3187,15914,10491,20434,15173,3518,14660,29833,15407,31321
ݺ׽ֵ´,JiaHeJieDaoBanShiChu,450203002,24987,2982,15771,10882,17653,14971,3715,14702,29673,15913,31684
ɽֵ´,JianPanShanJieDaoBanShiChu,450203003,34893,3423,23347,14025,26668,20401,6007,19760,40161,20976,44323
ֵͤ´,WuLiTingJieDaoBanShiChu,450203004,42956,3844,27184,19171,27684,26580,8599,27110,53690,28215,55399
پֵ´,RongJunJieDaoBanShiChu,450203005,59769,5742,36857,24684,41896,35074,9871,34742,69816,38525,75382
ֵ´,BaiLianJieDaoBanShiChu,450203006,25496,1840,15548,10082,11676,14406,5539,15790,30196,17327,32875
ֵ´,QiLinJieDaoBanShiChu,450203007,44009,3075,24925,15708,19631,21116,7417,22573,43689,29576,54501
ͽֵ´,YangHeJieDaoBanShiChu,450203008,23554,1655,14254,8680,12711,13848,5602,14821,28669,16557,30811
ֵ´,HeXiJieDaoBanShiChu,450204001,58387,5565,34949,23279,43041,32562,9939,33490,66052,38942,73891
վֵ´,NanZhanJieDaoBanShiChu,450204002,45762,7825,30180,20917,38195,28479,7075,28251,56730,30482,60662
ɽֵ´,EShanJieDaoBanShiChu,450204003,43842,6437,28028,19884,41076,27414,7323,27870,55284,29574,57602
Ͻֵ´,LiuNanJieDaoBanShiChu,450204004,25996,2444,16659,11259,14687,15937,4569,15710,31647,16350,33009
ʯֵ´,LiuShiJieDaoBanShiChu,450204005,19705,2114,11558,7088,13207,10363,2432,10235,20598,12693,24251
ɽֵ´,YinShanJieDaoBanShiChu,450204006,60534,5159,39010,24870,36708,37856,12313,37498,75354,38996,78006
̶ֵ´,TanXiJieDaoBanShiChu,450204007,47616,4205,28659,20587,25883,27579,10548,29497,57076,33710,62369
ϻֵ´,NanHuanJieDaoBanShiChu,450204008,44699,2081,27865,16956,11530,26773,12684,29597,56370,31599,59464
̫,TaiYangCunZhen,450204100,32010,2667,19558,12240,20840,19035,8112,21082,40117,23231,42789
Žֵ´,JieFangJieDaoBanShiChu,450205001,35214,5294,23013,14090,27759,20372,4182,19248,39620,21677,44690
ֵ´,YaRuJieDaoBanShiChu,450205002,41676,4965,27026,18622,29642,25953,6625,25145,51098,26240,53266
ʤֵ´,ShengLiJieDaoBanShiChu,450205003,49001,5500,31799,21653,36844,30770,9194,30365,61135,31896,63695
ȸɽֵ´,QiaoErShanJieDaoBanShiChu,450205004,33108,3658,21126,13620,25413,18671,5735,19189,37860,21375,42501
ֳǽֵ´,GangChengJieDaoBanShiChu,450205005,30348,4331,18753,13160,32897,18293,5134,19011,37304,21060,39813
ֵ´,JinXiuJieDaoBanShiChu,450205006,51718,4259,32603,23938,30476,32191,9875,32238,64429,33249,65852
¶ֵ´,BaiLuJieDaoBanShiChu,450205007,16416,1117,9501,6461,8071,9337,3902,10469,19806,11934,21435
ʯƺ,ShiBeiPingZhen,450205100,14545,2149,9511,6767,16119,9379,3392,10135,19514,10575,20086
ɳ,ShaTangZhen,450205101,24336,2199,14753,7143,16284,10822,4156,11537,22359,15938,30691
,ChangTangZhen,450205102,30232,2259,18205,12201,16694,17685,7335,19889,37574,21621,39826
岺,LuoBuZhen,450205103,4708,618,3026,2209,5154,2952,862,2997,5949,3162,6188
,LaBaoZhen,450221100,130814,8938,80767,44283,67035,71023,27618,75161,146184,86603,167370
Ӻ,LiYongZhen,450221101,16891,2562,11215,7251,22054,11161,4447,12575,23736,12685,23900
,BaiPengZhen,450221102,42944,5741,28059,14745,55018,27843,9958,29948,57791,30584,58643
,ChengTuanZhen,450221103,32958,4337,21421,11953,43077,21370,7626,23400,44770,23500,44921
,LuoManZhen,450221104,20535,2993,13313,8198,26204,13294,4392,14496,27790,14607,27920
ɽ,LiuShanZhen,450221105,12295,2025,7866,5303,15825,7860,2196,8637,16497,8650,16516
,SanDouZhen,450221106,16986,2733,11728,7630,22893,11634,4751,12635,24269,12742,24470
,LiGaoZhen,450221107,16306,2096,10855,5863,21017,10743,4182,11555,22298,11729,22584
,JinDeZhen,450221108,36856,4169,23354,12207,44143,22694,8000,24619,47313,25671,49025
ɽ,ChuanShanZhen,450221109,47142,4290,29887,16405,57858,29500,12240,32287,61787,33785,63672
,TuBoZhen,450221110,19013,3551,13085,8686,26747,13064,5076,14475,27539,14555,27640
,XuNiDiQu,450221111,7730,358,1522,1422,3,1448,374,1557,3005,6940,8462
ɳ,BaiShaXiang,450221200,11735,1605,7607,4886,14989,7605,2731,8461,16066,8464,16071
ũѹũ,GuangXiNongKenGuoYouXinXingNongChang,450221401,8607,503,5147,3060,5929,4893,2047,5363,10256,6010,11157
,DaPuZhen,450222100,54012,6369,35888,20106,55180,32720,11134,32869,65589,35627,71515
ͷ,LongTouZhen,450222101,11489,1690,7679,4728,14578,7644,2775,8224,15868,8275,15954
̫ƽ,TaiPingZhen,450222102,28991,3842,19496,10581,38163,19407,7683,20918,40325,21020,40516
ɳ,ShaPuZhen,450222103,22638,2980,14445,8454,27229,14162,4816,15548,29710,15989,30434
Ȫ,DongQuanZhen,450222104,38580,5375,25275,15879,48316,25095,9313,27644,52739,27993,53268
ɽ,FengShanZhen,450222105,12886,2153,8584,5865,16212,8567,2779,9171,17738,9234,17818
,LiuTangZhen,450222106,20698,2851,13523,8850,25144,13302,4104,13876,27178,14130,27653
,ChongMaiZhen,450222107,10122,1771,6872,4290,12797,6848,2124,7096,13944,7145,14017
կ¡,ZhaiLongZhen,450222108,9462,1383,6612,4315,12204,6608,2709,6902,13510,6942,13554
,GuZhaiMuLaoZuXiang,450222200,20609,3486,14349,8759,27697,14289,5675,15303,29592,15421,29770
ɽ,MaShanXiang,450222201,19035,2349,10409,7120,23016,10315,3558,10656,20971,14533,24942
,SheChongXiang,450222202,10438,1516,6888,4498,12828,6858,2401,7411,14269,7467,14355
¹կ,LuZhaiZhen,450223100,90834,10414,59712,35487,88657,54448,19541,55769,110217,61077,120789
,LuoRongZhen,450223101,62793,4881,36640,18157,52476,30241,12815,32044,62285,43849,80489
ж,ZhongDuZhen,450223102,22373,3933,14811,9707,30062,14723,5897,16856,31579,17392,32203
կɳ,ZhaiShaZhen,450223103,45033,6166,28389,16688,58877,28247,10875,33440,61687,33685,62074
ƽɽ,PingShanZhen,450223104,27110,3159,16988,10156,35016,16783,6747,19702,36485,20028,37016
,GuangXiXuNiDiQu,450223105,5998,374,1123,1032,1986,1075,268,1146,2221,5517,6640
,GuangXiXuNiDiQu,450223106,3084,49,18,2,137,2,1,2,4,3116,3134
,GuangXiXuNiDiQu,450223107,2565,112,367,354,643,364,79,442,806,2389,2756
,GuangXiXuNiDiQu,450223108,2370,62,313,345,626,304,89,409,713,2208,2521
,HuangMianXiang,450223200,13635,2753,9417,6708,18093,9346,3611,10428,19774,10582,19999
,JiangKouXiang,450223201,7077,1353,4892,3460,9222,4817,1828,5213,10030,5366,10258
,DaoJiangXiang,450223202,7445,1351,5048,3845,9660,5007,2092,5730,10737,5840,10888
,LaGouXiang,450223203,4212,986,3000,2386,6165,2998,1329,3506,6504,3527,6527
,SiPaiXiang,450223204,16622,3980,12096,8945,23667,12068,5123,13569,25637,13629,25725
,ChangAnZhen,450224100,81698,9207,52908,31884,84537,50217,17313,52943,103160,55310,108218
ʯ,FuShiZhen,450224101,18842,2884,12247,7425,24473,12165,4481,13773,25938,13960,26207
,SiDingZhen,450224102,12098,2208,7886,5047,16190,7877,3127,9488,17365,9547,17433
,BanLanZhen,450224103,14540,2589,9290,6150,18771,9275,3067,10874,20149,10906,20196
,DaJiangZhen,450224104,14330,2695,9251,6280,18685,9237,2866,10620,19857,10640,19891
,DaLiangZhen,450224105,14271,2194,9195,5280,18313,9142,3210,10411,19553,10480,19675
,YaYaoXiang,450224200,9164,1700,5809,3874,11995,5786,1805,6836,12622,6860,12669
,DaPoXiang,450224201,8620,1557,5360,3497,11386,5351,1816,6627,11978,6633,11993
,DongQiXiang,450224202,5133,983,3479,2242,7106,3474,1290,3925,7399,3927,7406
ɳ,ShaZiXiang,450224203,6773,1311,4399,2974,9226,4343,1746,5318,9661,5431,9830
Ű,QiaoBanXiang,450224204,8362,1603,5786,3529,11605,5736,2645,6761,12497,6824,12610
̶ͷ,TanTouXiang,450224205,13706,2126,9048,5643,18649,9011,3681,10384,19395,10465,19513
ˮ,RongShuiZhen,450225100,74953,7995,49158,28153,73319,45798,17383,47774,93572,51173,100331
,HeMuZhen,450225101,14243,2184,10014,5732,18914,10008,4598,10990,20998,11011,21025
,SanFangZhen,450225102,13152,2199,9061,5259,17879,9043,3245,9497,18540,9535,18596
,HuaiBaoZhen,450225103,10261,1526,6833,4213,14058,6829,2576,7527,14356,7530,14363
,YongLeXiang,450225200,13975,2255,10254,6016,19970,10254,5164,11138,21392,11140,21394
,SiRongXiang,450225201,9213,1733,6247,4181,12825,6237,2438,7088,13325,7137,13384
,XiangFenXiang,450225202,7270,1179,4986,3298,10210,4984,2126,5586,10570,5589,10575
̫,AnTaiXiang,450225203,11045,2107,7725,5000,15826,7718,3043,8444,16162,8470,16195
ͷ,DongTouXiang,450225204,8762,1716,6340,4043,12881,6329,2790,6902,13231,6928,13268
,WangDongXiang,450225205,9324,1586,6378,4152,12741,6334,2398,6870,13204,6930,13308
ͬ,TongLianYaoZuXiang,450225206,6814,1044,4568,2699,9355,4562,1863,5137,9699,5153,9721
�,GunBeiDongZuXiang,450225207,9009,1575,6389,3942,12986,6382,2885,7005,13387,7080,13469
˶,GanDongXiang,450225208,12574,2570,9325,5837,19113,9324,4357,10170,19494,10176,19501
,AnChuiXiang,450225209,11093,1948,7735,5360,15536,7719,3560,8711,16430,8866,16601
,DaLangXiang,450225210,11240,1917,7795,4591,16128,7779,3582,8896,16675,8944,16739
,BaiYunXiang,450225211,15662,2719,11464,6741,23204,11453,5537,12444,23897,12454,23918
ˮ,HongShuiXiang,450225212,10111,1859,7825,4529,15626,7795,4472,8512,16307,8617,16442
,GongDongXiang,450225213,10310,2184,8430,5169,16421,8404,5139,9165,17569,9203,17633
կ,LiangZhaiXiang,450225214,7303,1361,6505,3853,11415,6501,4592,6741,13242,6751,13256
,DaNianXiang,450225215,7191,1203,6107,3527,10718,6103,3941,6215,12318,6228,12335
,GuYiZhen,450226100,38100,4148,25397,13761,39377,23179,8980,23557,46736,25831,51228
,DouJiangZhen,450226101,11759,2095,8206,5340,16297,8199,2971,8573,16772,8619,16825
,DanZhouZhen,450226102,10697,1547,6947,4343,13506,6868,2306,7453,14321,7603,14550
,DuDongXiang,450226200,21405,3899,17758,10752,33828,17698,10661,18137,35835,18207,35965
˽,BaJiangXiang,450226201,15420,3191,12187,7743,24141,12160,6404,12745,24905,12828,25015
Ϫ,LinXiXiang,450226202,11873,2978,9909,6430,19317,9867,5010,9894,19761,9952,19861
ͬ,TongLeMiaoZuXiang,450226203,21814,3301,16535,9611,32702,16446,9390,17430,33876,17970,34505
÷,MeiLinXiang,450226204,5754,1136,4732,2956,9199,4645,2875,4875,9520,5033,9765
»,FuLuMiaoZuXiang,450226205,11997,2363,10578,6242,18729,10558,7367,11130,21688,11149,21727
Ϫ,YangXiXiang,450226206,7834,1693,6545,3979,13102,6461,3946,6791,13252,6928,13473
,LiangKouXiang,450226207,14193,2557,11261,6502,22597,11234,6456,11814,23048,11945,23206
ϱ,LaoBaoXiang,450226208,8450,1356,5922,3679,11975,5922,2590,6474,12396,6474,12396
߻,GaoJiYaoZuXiang,450226209,4851,784,3038,1858,5892,2966,1148,3212,6178,3745,6783
ƽ,HePingXiang,450226210,3838,761,2609,1954,5185,2593,957,2911,5504,2947,5556
̴,ChengCunXiang,450226211,4622,742,2959,1775,5659,2840,1025,2891,5731,3430,6389
ֵ´,XiuFengJieDaoBanShiChu,450302001,21482,3784,15289,9014,18440,12705,2656,11406,24111,12633,27922
ֵ´,LiJunJieDaoBanShiChu,450302002,40678,5061,27586,17235,29378,23390,5902,22272,45662,24055,51641
ɽֵ´,JiaShanJieDaoBanShiChu,450302003,60466,3580,36671,26039,23603,34990,12895,36953,71943,40270,76941
ʽֵ´,DieCaiJieDaoBanShiChu,450303001,50774,7228,33431,23559,45894,32773,7938,31334,64107,32509,65940
Žֵ´,BeiMenJieDaoBanShiChu,450303002,50907,6531,33489,23158,38979,32633,9267,32158,64791,33216,66705
,DaHeXiang,450303200,29238,2570,18411,11984,21328,18091,6175,18960,37051,19572,37983
Žֵ´,NanMenJieDaoBanShiChu,450304001,78596,9226,50581,35062,65508,49418,12101,47570,96988,49342,99923
ɽֵ´,XiangShanJieDaoBanShiChu,450304002,30669,4413,21178,13172,27837,19087,4471,17372,36459,18375,39553
ƽɽֵ´,PingShanJieDaoBanShiChu,450304003,90465,8764,58600,41555,68012,56532,17573,55652,112184,58202,116802
,ErTangXiang,450304200,14249,1347,9183,4566,14041,8664,3410,8996,17660,9823,19006
ֵ´,QiXingQuJieDaoBanShiChu,450305001,91833,9096,55059,35527,70894,49766,14251,47215,96981,60121,115180
ֵ´,DongJiangJieDaoBanShiChu,450305002,66995,5130,38405,18429,35611,25501,7485,24230,49731,41205,79610
ɽֵ´,ChuanShanJieDaoBanShiChu,450305003,65843,2572,38876,30394,25273,35404,11547,36783,72187,41086,79962
,ZhaoYangXiang,450305200,15422,884,8995,4413,10020,6842,2746,7072,13914,10057,19052
ֻξίԱ,GuiLinHuaQiaoLvYouJingJiQuGuanLiWeiYuanHui,450305400,2301,410,1677,1189,2826,1657,514,1526,3183,1548,3225
ɽֵ´,YanShanJieDaoBanShiChu,450311001,2242,189,1405,774,1316,1003,348,991,1994,1374,2779
ɽ,YanShanZhen,450311100,35640,2280,23824,5351,21342,8579,2853,8631,17210,16949,40773
ľ,ZheMuZhen,450311101,15636,1833,10105,5194,19451,10016,3210,10350,20366,10574,20679
,DaBuXiang,450311200,5559,1294,4215,2710,8184,4213,1608,4241,8454,4246,8461
ƺ,CaoPingHuiZuXiang,450311201,2391,481,1750,1125,3240,1750,629,1744,3494,1751,3501
˷,YangShuoZhen,450321100,42342,4302,27903,15468,38788,24255,7583,23667,47922,26324,54227
ɳ,BaiShaZhen,450321101,30518,4466,20163,11913,39275,19981,6970,21494,41475,21791,41954
,FuLiZhen,450321102,25534,4561,17599,11346,35231,17546,6753,19028,36574,19249,36848
ƺ,XingPingZhen,450321103,28119,4645,17953,11363,37408,17928,5676,20414,38342,20487,38440
,PuTaoZhen,450321104,21337,3432,14095,8484,28952,14027,5168,15775,29802,15842,29937
,GaoTianZhen,450321105,23346,3418,15205,8855,30494,15065,4690,16123,31188,16249,31454
,JinBaoXiang,450321200,14043,3202,10453,7587,20722,10423,4331,11084,21507,11123,21576
,PuYiXiang,450321201,6096,1127,4260,2932,8289,4242,1453,4387,8629,4416,8676
,YangDiXiang,450321202,6335,1234,4269,2810,8863,4230,1542,4776,9006,4842,9111
ٹ,LinGuiZhen,450322100,105345,8535,64116,32467,88546,54731,20639,57076,111807,70403,134519
,LiuTangZhen,450322101,25744,4322,16876,9194,34310,15891,5564,17984,33875,18754,35630
,HuiXianZhen,450322102,31952,4893,20855,11354,43032,20787,7157,22972,43759,23147,44002
,LiangJiangZhen,450322103,42609,6034,28245,15213,57418,27488,10959,30719,58207,31357,59602
ͨ,WuTongZhen,450322104,33603,5548,22387,12158,44665,21416,7806,23438,44854,24570,46957
ϱɽ,NanBianShanXiang,450322200,17003,3040,11207,6699,23577,11198,3998,12799,23997,12834,24041
,SiTangXiang,450322201,28978,3773,19044,9924,38532,18954,6904,20310,39264,20611,39655
趴,ChaDongXiang,450322202,14422,2226,9097,5505,19585,9035,3079,10387,19422,10630,19727
ӹ,ZhongYongXiang,450322203,10997,2010,7485,4175,15115,7436,2594,8006,15442,8116,15601
,WanTianYaoZuXiang,450322204,14363,2312,9294,5317,18953,9282,2882,10233,19515,10263,19557
ɳ,HuangShaYaoZuXiang,450322205,3537,512,1950,1333,4061,1922,654,2313,4235,2753,4703
鴨,LingChuanZhen,450323100,88508,8491,56455,36786,66278,53461,18243,54287,107748,58787,115242
,DaWeiZhen,450323101,33480,4897,22939,13418,43168,22499,7844,22853,45352,23282,46221
,DingJiangZhen,450323102,22956,2153,14296,9327,18358,13868,5035,14814,28682,15848,30144
,SanJieZhen,450323103,11550,2005,7282,5418,13489,7053,2242,7601,14654,8515,15797
̶,TanXiaZhen,450323104,19758,3753,13402,8888,24886,12819,3906,13602,26421,14015,27417
ʨ̶,QingShiTanZhen,450323105,20949,4109,14740,9958,28417,14590,4794,14976,29566,15112,29852
,ChaoTianXiang,450323200,13909,2816,9291,6183,17630,9137,3221,9846,18983,10655,19946
,DaJingYaoZuXiang,450323201,7009,1398,4601,3155,9237,4596,1340,5138,9734,5146,9747
,HaiYangXiang,450323202,13153,2342,9092,5687,17710,9086,2908,9294,18380,9311,18403
,LingTianXiang,450323203,27582,2614,13295,6595,18202,9442,3290,9962,19404,20191,33486
,LanTianYaoZuXiang,450323204,3211,683,2215,1534,4394,2214,683,2356,4570,2362,4577
ȫ,QuanZhouZhen,450324100,80808,8833,55697,36445,77868,53538,22979,54582,108120,56923,112620
ɳ,HuangShaHeZhen,450324101,13591,2335,9783,7160,18576,9711,4645,10444,20155,10788,20571
ͷ,MiaoTouZhen,450324102,14621,3212,10640,7433,20710,10263,4607,11325,21588,11800,22440
,WenQiaoZhen,450324103,28744,5145,20473,14409,41259,20447,9353,22708,43155,22769,43242
,DaXiJiangZhen,450324104,19343,3064,13508,9814,27025,13492,6003,14842,28334,14902,28410
ˮ,LongShuiZhen,450324105,25022,4332,17205,12444,34907,17166,6773,18873,36039,18922,36127
,CaiWanZhen,450324106,31772,4942,20937,14606,42137,20546,8089,23296,43842,23866,44803
ˮ,ShaoShuiZhen,450324107,29450,4468,19441,14357,39855,19415,7328,21744,41159,21805,41246
ʯ,ShiTangZhen,450324108,38850,6293,25981,18886,54242,25541,11807,30374,55915,30969,56950
,YongSuiXiang,450324200,22271,3682,14658,10060,30336,14574,5486,16565,31139,16781,31439
,JianTangXiang,450324201,15266,2854,10520,7722,21725,10493,4340,11837,22330,11940,22460
ˮ,XianShuiXiang,450324202,18967,2916,12491,8867,25096,12446,4646,13907,26353,14038,26529
,FengHuangXiang,450324203,30685,5200,20802,15860,43356,20768,8995,24020,44788,24078,44880
,JiaoJiangYaoZuXiang,450324204,7771,1322,5346,3759,10685,5302,2224,5887,11189,5971,11317
,AnHeXiang,450324205,17717,3748,12795,9853,25608,12769,5633,14219,26988,14303,27098
,LiangHeXiang,450324206,18124,3132,12872,10167,26556,12811,5895,14090,26901,14279,27151
ױ,BaiBaoXiang,450324207,8092,1774,5717,4668,11869,5716,2359,6501,12217,6508,12225
ɽ,DongShanYaoZuXiang,450324208,15841,2785,11319,7106,23322,11136,5040,11863,22999,12347,23666
˰,XingAnZhen,450325100,70720,8011,46223,28218,69718,43580,13793,44388,87968,46301,92524
,XiangLiZhen,450325101,31567,5014,20029,14389,40068,20004,5773,22283,42287,22325,42354
,JieShouZhen,450325102,26586,3655,16469,11248,32437,16175,5001,18205,34380,18773,35242
,GaoShangZhen,450325103,27982,4844,18567,11397,37177,18553,5750,20003,38556,20009,38576
Ϲ,YanGuanZhen,450325104,13454,1953,8532,5440,16855,8430,2486,9069,17499,9361,17893
ܽ,RongJiangZhen,450325105,37433,5454,23835,14694,47005,23395,6713,25152,48547,25765,49600
Į,MoChuanXiang,450325200,10700,2280,7352,5523,14916,7348,2488,8102,15450,8116,15468
ʯ,BaiShiXiang,450325201,5088,1378,3848,3004,7550,3847,1405,4011,7858,4023,7871
޼,CuiJiaXiang,450325202,10878,2217,7639,5691,14909,7618,2677,8106,15724,8133,15772
,HuaJiangYaoZuXiang,450325203,10279,1608,6929,4788,13206,6820,2320,7012,13832,7278,14207
,YongFuZhen,450326100,40434,5121,26530,15256,46418,25931,8246,26364,52295,27271,53801
޽,LuoJinZhen,450326101,22268,4066,15615,9553,30765,15569,6367,17036,32605,17086,32701
,BaiShouZhen,450326102,18804,3340,12530,8424,24719,12271,4517,13863,26134,14131,26661
,SuQiaoZhen,450326103,19114,2419,12097,6524,22879,11774,4564,12592,24366,14000,26097
,BaoLiXiang,450326201,15024,2715,10257,6332,20706,10220,3562,10962,21182,11044,21301
㸣,GuangFuXiang,450326202,11555,1992,7783,4750,15504,7773,2603,8319,16092,8367,16150
,SanHuangXiang,450326203,12391,2252,8536,5991,16960,8502,3487,9524,18026,9594,18130
,YongAnXiang,450326204,14435,2388,8954,5490,19037,8938,3122,10647,19585,10991,19945
,LongJiangXiang,450326205,13270,2072,8642,5075,17728,8624,3376,10047,18671,10076,18718
,GuanYangZhen,450327100,47646,6668,31520,21336,58959,30742,11929,33877,64619,34723,66243
ƹ,HuangGuanZhen,450327101,27639,4272,18020,11640,37405,17937,6671,20449,38386,20562,38582
,WenShiZhen,450327102,20688,3346,13467,9436,28074,13409,5293,15772,29181,15860,29327
,DongJingYaoZuXiang,450327200,5169,847,3603,2267,7098,3581,1435,3832,7413,3848,7451
,GuanYinGeXiang,450327201,5600,841,3844,2272,7569,3814,1456,4001,7815,4053,7897
ɽ,XiShanYaoZuXiang,450327202,7423,1120,5010,3367,10309,4889,1977,5355,10244,5510,10520
½,XinJieXiang,450327203,23442,4455,15592,11183,32716,15348,5826,17773,33121,18131,33723
,XinWeiXiang,450327204,12922,2509,8509,6695,18596,8481,3400,10252,18733,10322,18831
ˮ,ShuiCheXiang,450327205,14626,2756,9708,7130,20741,9699,3642,11292,20991,11316,21024
ʤ,LongShengZhen,450328100,30599,3341,20223,12256,29036,19011,6254,18679,37690,19971,40194
ư,PiaoLiZhen,450328101,9900,1484,6336,3872,12256,6210,1874,6613,12823,6922,13258
,SanMenZhen,450328102,11039,1445,6740,4280,12366,6553,2105,7052,13605,7849,14589
ƽ,HePingXiang,450328200,9840,1705,6697,3806,12800,6629,2108,6845,13474,6956,13653
ˮ,SiShuiXiang,450328201,8745,1194,5832,3139,11028,5789,2038,6010,11799,6145,11977
,JiangDiXiang,450328202,6067,801,3880,2180,7415,3753,1228,4058,7811,4216,8096
,MaDiXiang,450328203,6544,946,4320,2657,8517,4318,1614,4772,9090,4784,9104
ΰ,WeiJiangXiang,450328204,5514,863,3526,2199,7210,3511,1108,3871,7382,3959,7485
ƽ,PingDengXiang,450328205,15206,2872,9874,6665,20589,9857,3113,11290,21147,11317,21191
ֽ,LeJiangXiang,450328206,10939,1986,7240,4590,14695,7226,2417,8055,15281,8102,15342
Դ,ZiYuanZhen,450329100,36361,4175,23630,13953,40447,21881,8372,23039,44920,25278,48908
з,ZhongFengXiang,450329200,17150,2750,11833,7649,22557,11664,4485,12157,23821,12552,24385
÷Ϫ,MeiXiXiang,450329201,16879,3057,11761,7783,23878,11745,4959,13096,24841,13134,24895
,GuaLiXiang,450329202,11673,2256,8158,5603,16559,8151,3144,8864,17015,8915,17073
,CheTianMiaoZuXiang,450329203,13785,2425,9305,6474,18811,9293,3444,10319,19612,10349,19654
ˮ,LiangShuiMiaoZuXiang,450329204,5899,1143,3945,2812,7790,3937,1142,4213,8150,4239,8184
ӿ,HeKouYaoZuXiang,450329205,2755,488,1770,1253,3490,1769,482,1948,3717,1955,3725
ƽ,PingLeZhen,450330100,64858,9307,42463,25563,77228,39839,12194,41747,81586,43896,86359
,ErTangZhen,450330101,48209,6076,31622,18468,62592,31040,12670,34770,65810,35333,66955
ɳ,ShaZiZhen,450330102,27308,3542,17639,11168,35568,17478,6232,19228,36706,19443,37082
ͬ,TongAnZhen,450330103,26362,4356,18518,10813,37076,18449,7974,20040,38489,20174,38692
ż,ZhangJiaZhen,450330104,25226,3991,17154,10029,34738,17133,6958,18984,36117,19021,36175
Դͷ,YuanTouZhen,450330105,26947,4489,18415,11451,36824,18311,7540,20428,38739,20561,38976
,YangAnXiang,450330200,13383,2232,9285,6063,19126,9282,4043,10354,19636,10373,19658
,QingLongXiang,450330201,13091,2078,8898,5756,17928,8895,3508,9766,18661,9779,18677
ͤ,QiaoTingXiang,450330202,9626,1671,6610,4283,13466,6609,2544,7230,13839,7231,13841
,DaFaYaoZuXiang,450330203,10122,1786,6569,4318,13432,6558,2132,7453,14011,7471,14040
,LiChengZhen,450331100,62997,7636,41794,23717,63672,39452,12135,38505,77957,40974,82768
,DongChangZhen,450331101,16161,2704,10567,6264,21370,10538,3290,11528,22066,11588,22155
ƺ,XinPingZhen,450331102,18984,3484,12623,8109,24959,12543,3978,13677,26220,13823,26446
Ī,DuMoZhen,450331103,15067,2862,10288,6091,20345,10281,3394,11015,21296,11035,21323
ɽ,QingShanZhen,450331104,25412,3618,16634,9202,31052,16251,5022,17024,33275,17418,34052
,XiuRenZhen,450331105,22464,3667,15116,8644,28874,15016,4946,15820,30836,15961,31077
,DaTangZhen,450331106,15274,2494,9674,6028,19932,9661,3009,11082,20743,11103,20777
,HuaZeZhen,450331107,14532,2502,9553,5933,19203,9542,2996,10452,19994,10477,20030
˫,ShuangJiangZhen,450331108,19786,3317,12835,7708,25685,12589,4064,13995,26584,14332,27167
,MaLingZhen,450331109,28919,4377,18755,10998,36496,18344,6193,20111,38455,20734,39489
,LongHuaiXiang,450331200,6308,1244,4265,2554,8365,4247,1363,4608,8855,4650,8915
,ChaChengXiang,450331201,6823,1346,4518,2620,9081,4494,1431,5019,9513,5082,9600
«,PuLuYaoZuXiang,450331202,6137,1224,4073,2489,8231,4058,1312,4552,8610,4600,8673
,GongChengZhen,450332100,37447,5188,24905,14819,42684,23510,7948,23960,47470,25678,50583
ľ,LiMuZhen,450332101,26209,4892,17756,12381,35196,17452,5663,18777,36229,19008,36764
,LianHuaZhen,450332102,34796,5105,23531,14628,48342,23181,9839,25515,48696,26209,49740
ƽ,PingAnXiang,450332200,23288,3518,15505,9737,31442,15419,6026,17030,32449,17327,32832
,SanJiangXiang,450332201,8772,1327,5954,3437,11786,5943,2211,6325,12268,6356,12310
λ,JiaHuiXiang,450332202,14895,2686,9962,6950,20479,9952,3744,11290,21242,11363,21325
,XiLingXiang,450332203,22232,3910,14862,9609,30296,14781,5780,16260,31041,17060,31922
,GuanYinXiang,450332204,4980,850,3617,2449,7131,3614,1525,3720,7334,3738,7355
,LongHuXiang,450332205,5555,995,3733,2770,7829,3733,1472,4289,8022,4289,8022
Ƕֵ´,ChengDongJieDaoBanShiChu,450403001,19858,4077,13660,9309,21348,13328,2851,12851,26179,13126,26786
Ͻֵ´,ChengNanJieDaoBanShiChu,450403002,9906,1895,6715,4804,10336,6690,1423,6476,13166,6509,13224
аֵ´,ChengZhongBanJieDaoShiChu,450403003,18928,3734,12976,8653,20820,12819,2504,12125,24944,12190,25166
Ǳֵ´,ChengBeiBanJieDaoShiChu,450403004,12837,1995,8175,5759,13404,8060,2100,8343,16403,8757,16932
Ƕ,ChengDongZhen,450403101,13105,1470,8762,3831,14373,7540,3132,7701,15241,8945,17707
,WangFuZhen,450403102,26449,3652,18872,9798,36527,18848,8926,19977,38825,20155,39027
ֵ´,JiaoZuiJieDaoBanShiChu,450404001,25939,3731,17367,11110,22377,15901,4265,15153,31054,16568,33935
˽ֵ´,DongXingJieDaoBanShiChu,450404002,47932,5302,31655,20342,35494,30291,10012,30128,60419,31591,63246
ֵ´,FuMinJieDaoBanShiChu,450404003,48436,4851,30388,17123,36917,25201,7187,24878,50079,30086,60474
,LongHuZhen,450404101,8502,1181,5888,3129,9439,5789,2294,5834,11623,6089,11977
۫,XiaYingZhen,450404102,24252,4660,17646,11772,35993,17614,8336,19454,37068,19602,37248
ֵ´,DaTangJieDaoBanShiChu,450405001,53739,4837,35489,22689,35489,34850,12413,33968,68818,35500,70989
ֵ´,XingLongJieDaoBanShiChu,450405002,29931,1608,18122,10240,14313,15931,7004,16933,32864,20421,38543
,ChangZhouZhen,450405101,29458,3855,20506,10885,37662,19528,8038,19228,38756,20845,41351
ˮ,DaoShuiZhen,450405102,22812,3809,16720,10037,32123,16720,8070,17971,34691,17971,34691
,LongWeiZhen,450421100,71049,7201,48212,23572,73909,40686,18851,42084,82770,48889,97101
,DaPoZhen,450421101,31866,5047,24228,12890,45022,24095,13170,25690,49785,25855,50083
ƽ,GuangPingZhen,450421102,39071,5625,28723,15717,54256,28525,17438,32896,61421,33411,62134
µ,XinDiZhen,450421103,37591,5621,28764,15272,54848,28722,17149,31392,60114,31597,60361
,LingJiaoZhen,450421105,32689,4671,24115,12619,45237,24020,13245,26339,50359,26490,50605
,JingNanZhen,450421108,20784,3820,15169,10020,30014,15139,7902,17289,32428,17337,32506
ʨկ,ShiZhaiZhen,450421109,11697,1889,7765,4427,15941,7763,3515,9335,17098,9336,17101
,LiuBaoZhen,450421112,13675,2358,9908,6050,19668,9886,5071,11126,21012,11196,21104
沺,LiBuZhen,450421113,18848,2651,13615,7816,27306,13614,7254,15132,28746,15138,28753
ľ˫,MuShuangZhen,450421114,8163,1392,6190,3389,11994,6179,3293,6628,12807,6658,12848
ʯ,ShiQiaoZhen,450421115,35783,4567,27710,14503,50465,27649,15931,28506,56155,28571,56281
ɳͷ,ShaTouZhen,450421116,39245,4918,29924,15520,56367,29904,17328,31522,61426,31567,61491
,TengZhouZhen,450422100,102308,11614,70562,37022,118568,63387,32113,67105,130492,75473,146035
,TangBuZhen,450422103,33969,4635,25299,14381,50593,25080,14975,27274,52354,28280,53579
,LangNanZhen,450422104,24783,3588,18695,10242,37361,18520,10625,20040,38560,20301,38996
ͬ,TongXinZhen,450422105,11799,2038,9231,5380,18234,9150,5818,10232,19382,10424,19655
,JinJiZhen,450422106,35777,6038,28417,17112,55193,28213,16970,30026,58239,30368,58785
,XinQingZhen,450422107,18866,3370,14512,9036,29523,14323,8460,15827,30150,16184,30696
,XiangQiZhen,450422108,21220,3535,16653,10769,31812,16622,9791,17832,34454,17893,34546
뾰,LingJingZhen,450422109,20526,3475,15450,9992,30526,15171,9357,17302,32473,17908,33358
ƽ,TianPingZhen,450422110,38337,6220,29717,17650,57673,29417,18041,32186,61603,32881,62598
ɽ,MengJiangZhen,450422111,40060,6777,31403,17775,60605,31298,18073,33413,64711,33507,64910
ƽ,HePingZhen,450422112,34815,5615,27985,16630,53683,27951,17010,29342,57293,29455,57440
̫ƽ,TaiPingZhen,450422113,62375,7701,45157,23726,84665,44176,22692,46773,90949,47611,92768
,GuLongZhen,450422114,24947,3294,18092,10293,35960,18050,9441,19543,37593,19590,37682
,DongRongZhen,450422115,19427,2996,14122,8935,28028,14100,7897,16177,30277,16198,30320
,DaLiZhen,450422116,27812,4920,20601,13038,40049,20557,12330,24235,44792,24461,45062
ƽ,PingFuXiang,450422200,19358,2556,13233,7234,27027,13094,7126,15548,28642,15807,29040
ɽ,MengShanZhen,450423100,39107,4790,26470,13896,47628,25016,9173,25066,50082,26600,53070
,XiHeZhen,450423101,19834,3144,13313,7680,27645,13313,5295,14960,28273,14960,28273
,XinWeiZhen,450423102,14992,2376,10142,5947,20781,10046,4168,11253,21299,11394,21536
,WenWeiZhen,450423103,21462,3298,14605,9709,30682,14478,6372,16283,30761,16527,31132
ƴ,HuangCunZhen,450423104,13595,2224,9073,5676,18943,9033,3929,10599,19632,10675,19748
,ChenTangZhen,450423105,14101,2159,9801,5736,19623,9686,4824,11066,20752,11283,21084
,HanHaoXiang,450423200,7527,1185,5225,3154,10834,5198,2689,6122,11320,6176,11401
ƺ,ChangPingYaoZuXiang,450423201,1057,296,749,644,1549,747,253,851,1598,857,1606
,XiaYiYaoZuXiang,450423202,3251,701,2332,1750,4941,2323,1151,2734,5057,2771,5103
᯳,CenChengZhen,450481100,124915,10013,81390,42828,138131,72569,37219,80842,153411,90757,172147
·,MaLuZhen,450481102,40530,5348,29722,16096,59241,29425,17121,32641,62066,33277,62999
϶,NanDuZhen,450481103,39425,6371,30623,18843,59925,30271,17392,32188,62459,32565,63188
ˮ,ShuiWenZhen,450481105,27079,4437,20950,11311,40455,20599,11715,21885,42484,22281,43231
¡,DaLongZhen,450481106,16747,2744,13068,7396,25829,13044,7406,13716,26760,13829,26897
ľ,LiMuZhen,450481107,23799,3633,19313,11064,37493,19274,12445,20518,39792,20564,39877
ҵ,DaYeZhen,450481108,26498,3392,20947,11124,38816,20853,12422,21101,41954,21365,42312
,JinZhuZhen,450481109,27049,3408,20440,11304,40594,20217,11540,21206,41423,21557,41997
,ChengJianZhen,450481110,23516,3452,18104,9927,35166,17571,11789,19603,37174,20653,38757
,GuiYiZhen,450481111,42326,5410,31713,14568,62565,31370,17643,33221,64591,33666,65379
Ŵ,NuoDongZhen,450481112,39934,5384,30223,18340,60299,30179,17587,32594,62773,32682,62905
ƽ,AnPingZhen,450481113,17014,2622,12881,7413,26235,12862,7666,14376,27238,14421,27302
,SanBaoZhen,450481114,34147,5077,26093,15932,52307,26062,16209,29274,55336,29340,55433
,BoTangZhen,450481115,18522,3097,13777,9391,27764,13777,8070,15905,29682,15912,29689
нֵֽ´,ZhongJieJieDaoBanShiChu,450502001,44119,5485,28414,16979,40282,26661,7569,25718,52379,28759,57173
ֵֽ´,DongJieJieDaoBanShiChu,450502002,32640,3492,21129,12584,24737,19948,6443,19933,39881,21446,42575
ֵֽ´,XiJieJieDaoBanShiChu,450502003,26066,1861,16178,9927,17364,15116,4911,15447,30563,16660,32838
ǽֵ´,HaiJiaoJieDaoBanShiChu,450502004,30242,3486,19818,11454,26610,19554,5800,19350,38904,19710,39528
ؽǽֵ´,DiJiaoJieDaoBanShiChu,450502005,22108,1806,13230,5845,17173,11237,3883,11933,23170,14567,27797
ߵ½ֵ´,GaoDeJieDaoBanShiChu,450502006,41201,3664,27329,13360,30200,23153,8117,23664,46817,25653,52982
ֵ´,YiMaJieDaoBanShiChu,450502007,67771,4646,41515,24640,39421,38799,14066,40392,79191,44968,86483
,WeiZhouZhen,450502100,6404,1366,4462,3269,8588,4425,1398,4646,9071,4706,9168
,FuChengZhen,450503100,48448,6953,34402,20360,65049,34237,16726,37294,71531,37725,72127
̲,YinTanZhen,450503101,58285,3594,33643,17066,27632,26356,10942,28087,54443,39178,72821
ƽ,PingYangZhen,450503102,10057,1177,5370,3396,11800,5248,2130,5784,11032,7994,13364
ȸ,QiaoGangZhen,450503103,13289,1276,8954,4869,12148,8813,3908,9342,18155,9519,18473
Ͽ,NanKangZhen,450512100,37131,5622,25899,14059,48415,25060,10985,27205,52265,27839,53738
Ӫ,YingPanZhen,450512101,32254,5247,23012,13486,46097,22901,9943,24230,47131,24432,47444
˸,XingGangZhen,450512102,28694,4258,19679,11448,39156,19551,8581,20693,40244,21854,41533
,LianZhouZhen,450521100,142516,17688,94373,51027,160272,88368,32609,93978,182346,98440,192813
,DangJiangZhen,450521101,31746,5090,21554,11484,43365,21539,8572,23810,45349,23854,45408
,XiChangZhen,450521102,54629,8422,37147,21875,75516,36630,17013,42419,79049,42917,80064
ɳ,ShaGangZhen,450521103,20080,3648,14388,8935,29006,14374,6982,16253,30627,16322,30710
ڼ,WuJiaZhen,450521104,10706,1380,7084,4021,13613,6979,3463,8141,15120,8465,15549
բ,ZhaKouZhen,450521105,19992,3524,14971,8442,29437,14908,7657,16035,30943,16202,31173
,GongGuanZhen,450521106,62690,8943,44890,22754,89754,44119,24859,50992,95111,51602,96492
ɳ,BaiShaZhen,450521107,56420,8049,43785,21590,85636,43712,25290,45797,89509,45974,89759
ɽ,ShanKouZhen,450521108,44109,6197,34593,14159,66443,33869,19847,34880,68749,35560,70153
ɳ,ShaTianZhen,450521109,8714,1807,7210,3707,13846,7154,4165,7402,14556,7476,14686
ʯ,ShiWanZhen,450521110,27663,4511,18596,11420,38323,18556,8156,21663,40219,21734,40330
ʯ,ShiKangZhen,450521111,44659,6766,30406,16785,59216,29671,13393,33497,63168,34412,64818
,ChangLeZhen,450521112,41322,6398,29538,17905,58807,29381,15043,32892,62273,33225,62763
,QuZhangXiang,450521200,7178,1604,5807,3691,11459,5794,3659,6620,12414,6634,12441
ǵ,XingDaoHuXiang,450521201,16638,2696,11019,6747,21851,10826,4714,12620,23446,13029,24048
ƺֵ´,YuZhouPingJieDaoBanShiChu,450602001,33170,1332,16975,9591,15087,14405,6369,16544,30949,23896,40871
ɳֵ´,BaiShaWanJieDaoBanShiChu,450602002,27184,1102,15292,10456,16664,14023,5839,15640,29663,18833,34125
ɳ,QiShaZhen,450602100,21376,2954,14379,7754,26370,13957,6680,15337,29294,16631,31010
,GuangPoZhen,450602101,14651,2184,9497,5524,18465,9338,4407,10512,19850,11745,21242
,GongCheZhen,450602102,22240,1429,10313,5838,17111,9135,4319,10134,19269,17675,27988
,FangChengZhen,450603100,88538,8583,56866,29922,87350,54561,23958,60103,114664,64213,121079
Ǌ,DaLuZhen,450603101,21015,2919,14193,7850,29357,14179,8522,18232,32411,18263,32456
ʯ,HuaShiZhen,450603102,8201,1369,5519,3411,10885,5487,2795,6771,12258,6846,12365
,NaSuoZhen,450603103,16445,2462,11201,6306,21830,11152,5670,13298,24450,13376,24577
,NaLiangZhen,450603104,27397,4154,19074,11419,39033,19050,10026,22420,41470,22503,41577
,DongZhongZhen,450603105,15488,2249,10617,6460,21540,10594,5182,12234,22828,12302,22919
é,MaoLingXiang,450603201,11977,1807,8182,4865,15925,8036,4270,9331,17367,9872,18054
¡,FuLongXiang,450603202,17568,2439,11933,6649,24198,11908,6425,14432,26340,14499,26432
̲Ӫ,TanYingXiang,450603203,20894,3083,14167,7885,27816,14060,7993,17334,31394,17803,31970
ɽ,JiangShanXiang,450603204,11658,1597,7968,4426,14647,7726,4075,8785,16511,9362,17330
С徭ﳡ,XiaoFengJingJiZuoWuChang,450603450,2665,358,1914,1214,4069,1914,1147,2256,4170,2256,4170
ٹũ,RongGuangNongChang,450603451,288,63,218,160,389,218,104,237,455,237,455
ʮɽֳ,ShiWanShanHuaQiaoLinChang,450603452,5231,580,3840,1901,7437,3836,2738,4695,8531,4709,8549
ũ,DongMeiNongChang,450603453,359,93,280,205,536,270,119,281,551,291,571
ũ,NaSuoNongChang,450603454,234,75,166,145,348,164,75,209,373,218,384
˼,SiYangZhen,450621100,51313,5314,32524,18829,53159,32081,14841,37608,69689,38944,71468
,ZaiMiaoZhen,450621101,18056,2371,12167,6873,21730,12155,6422,14502,26657,14682,26849
а,JiaoAnXiang,450621201,21216,3113,14281,8712,27212,14248,7741,17668,31916,17789,32070
,HuaLanXiang,450621202,6289,975,4434,2662,7898,4405,2680,5471,9876,5510,9944
,NanPingYaoZuXiang,450621203,7935,884,5259,2853,9779,5250,3123,6647,11897,6683,11942
ƽ,PingFuXiang,450621204,11415,1549,8055,4651,13826,8015,4921,9736,17751,9830,17885
,NaQinXiang,450621205,10167,1671,6706,4321,12853,6693,3161,8220,14913,8293,14999
,GongZhengXiang,450621206,8711,1307,5531,3515,11707,5480,2715,6964,12444,7202,12733
вũ,GuoYouChangLingNongChang,450621450,4324,633,2903,1943,5282,2900,1247,3283,6183,3301,6204
,DongXingZhen,450681100,64797,4860,40399,23730,57066,38360,18950,44032,82392,48208,88607
ƽ,JiangPingZhen,450681101,29062,4589,19818,10531,37055,19674,9334,22832,42506,23167,42985
·,MaLuZhen,450681102,8965,1566,5913,4141,11626,5876,2586,7067,12943,7204,13117
ֵ´,XiangYangJieDaoBanShiChu,450702001,45137,3684,28691,16454,34658,26498,10780,27973,54471,30910,59601
ˮֵ´,ShuiDongJieDaoBanShiChu,450702002,32760,2205,19594,10236,21662,17241,7605,18454,35695,22976,42570
ķֵ´,WenFengJieDaoBanShiChu,450702003,37986,4573,25137,14155,33994,24735,9633,26434,51169,27055,52192
ֵ´,NanZhuJieDaoBanShiChu,450702004,66817,4662,39264,20246,45995,32761,13388,35127,67888,45603,84867
ɳ,ShaBuZhen,450702100,23042,2710,15482,7598,27571,14700,7980,17037,31737,18250,33732
,KangXiLingZhen,450702101,21639,2873,14993,7302,28946,14869,8034,17158,32027,17553,32546
,HuangWuTunZhen,450702102,24763,4374,17818,10186,35719,17746,10331,21412,39158,21650,39468
ɽ,JianShanZhen,450702103,14882,1836,10159,5044,19683,10151,4986,11497,21648,11545,21704
,DaFanPoZhen,450702104,10320,1554,7221,4256,13726,7072,4028,8128,15200,8681,15902
Ÿ,LongMenGangZhen,450702105,5171,712,3418,2250,6249,3409,1484,3865,7274,3949,7367
¡,JiuLongZhen,450702107,19201,2917,14399,8023,28451,14341,9497,17004,31345,17216,31615
,DongChangZhen,450702108,9187,1743,7070,4236,14165,7052,4407,8202,15254,8267,15337
,NaLiZhen,450702109,16730,2781,12034,7012,23252,11845,7491,14552,26397,14968,27002
,NaPengZhen,450702110,18541,3324,13800,8708,26600,13653,9055,16867,30520,17120,30920
˼,NaSiZhen,450702111,13722,2145,9973,5739,20134,9915,6500,12272,22187,12394,22367
Ϭţ,XiNiuJiaoZhen,450702112,28319,4435,20956,11281,41558,20843,11631,23075,43918,23429,44385
⻪ũ,LiGuangHuaQiaoNongChang,450702400,6021,1038,4630,3132,8917,4626,3076,5481,10107,5505,10135
ݸ۾ÿ,QinZhouGangJingJiKaiFaQu,450702401,31091,1662,16332,10202,17912,14325,7340,16268,30593,23761,40093
ι,SanNiangWanLvYouGuanLiQu,450702402,3339,566,2524,1321,5090,2517,1339,2711,5228,2720,5244
ֵ´,ChangTianJieDaoBanShiChu,450703001,10750,605,5905,3186,7322,5566,3012,6577,12143,8462,14367
,DaDongZhen,450703100,17340,2311,12320,6832,22911,12175,7786,14190,26365,15117,27437
ƽ,PingJiZhen,450703101,44375,5756,32068,16381,65715,31913,21324,39052,70965,39387,71455
,QingTangZhen,450703102,26345,3312,19148,9394,38055,19115,12285,22728,41843,22794,41942
С,XiaoDongZhen,450703103,40603,6233,30825,18085,58269,30265,19938,34665,64930,35949,66774
,BanChengZhen,450703104,47622,6200,35901,18384,71103,35816,23228,41023,76839,41149,77050
,NaMengZhen,450703105,21862,3795,16721,10564,32989,16616,11409,19907,36523,20345,37066
̲,ChangTanZhen,450703106,22695,4235,18239,10728,35428,18217,13210,21816,40033,21901,40140
,XinTangZhen,450703107,21644,3430,16940,9357,34031,16938,11745,19872,36810,19879,36819
ֱ,DaZhiZhen,450703108,41968,6084,29499,17457,60659,29359,19223,37344,66703,37776,67275
,DaSiZhen,450703109,46879,6973,32332,19249,67683,32026,19855,40962,72988,41375,73707
̨,GuiTaiZhen,450703110,12964,2992,10137,7185,20952,10048,6899,12467,22515,12718,22855
ݿ,QinZhouKuangWuJu,450703400,3050,268,2089,1322,3013,2085,1176,2399,4484,2405,4494
,LingChengZhen,450721100,105635,12524,75059,40950,123071,70439,37445,74534,144973,80545,155604
,XinWeiZhen,450721101,59925,7729,43082,20640,82411,41611,24522,47595,89206,49094,92176
,FengTangZhen,450721102,17252,3754,15252,9674,29245,15220,9676,15360,30580,15430,30682
ƽɽ,PingShanZhen,450721103,17668,3816,15797,10151,29661,15762,10416,16002,31764,16103,31900
ʯ,ShiTangZhen,450721104,20136,4229,17257,11827,32471,16984,10886,17653,34637,17994,35251
,FoZiZhen,450721105,26559,4958,22362,13504,43785,22287,14652,23653,45940,23807,46169
ƽ,PingNanZhen,450721106,21858,4398,19907,13022,36978,19876,13852,20153,40029,20201,40108
̶,YanDunZhen,450721107,29268,5524,26006,16207,50987,25856,19072,27626,53482,27858,53864
̴,TanWeiZhen,450721108,48504,6731,38740,21865,76038,38130,26418,42408,80538,42913,81653
¡,NaLongZhen,450721109,44787,7081,40484,24478,76202,40211,31746,42770,82981,43130,83614
¡,SanLongZhen,450721110,26105,4236,23343,13780,43481,23295,17773,24646,47941,24771,48114
½,LuWuZhen,450721111,50212,6473,38784,20582,72293,38684,26318,43986,82670,44219,83003
,JiuZhouZhen,450721112,44946,6683,38515,20920,75282,38493,28558,41596,80089,41672,80187
̫ƽ,TaiPingZhen,450721113,49022,8450,43168,25754,85992,43107,32062,46282,89389,46366,89534
ɳƺ,ShaPingZhen,450721114,20045,3398,18741,11439,34282,18685,14156,18617,37302,18858,37599
,WuLiZhen,450721115,34140,5037,27945,16641,52912,27145,20102,30293,57438,31334,59279
,WenLiZhen,450721116,14978,2785,11856,7586,22993,11790,8124,13906,25696,14031,25887
,BoLaoZhen,450721117,42678,6293,34134,19751,68570,34054,24769,39526,73580,39606,73740
Ӫ¹ũ,GuoYingXinGuangNongChang,450721400,1727,351,1224,904,2170,1188,612,1248,2436,1466,2690
Ӫɽũ,GuoYingHuaShanNongChang,450721401,989,192,786,576,1304,782,439,829,1611,834,1620
С,XiaoJiangZhen,450722100,80407,10209,57452,31615,107050,53723,28036,57465,111188,61200,118652
Ȫˮ,QuanShuiZhen,450722101,16478,2383,11435,6408,22920,11281,5564,12791,24072,12990,24425
ʯ,ShiYongZhen,450722102,8708,1534,6780,4187,12997,6750,3888,7300,14050,7350,14130
ʯ,AnShiZhen,450722103,14426,2870,11307,7655,23031,11274,6681,12625,23899,12670,23977
Ż,ZhangHuangZhen,450722104,46330,7084,32084,19411,65002,31746,15820,36829,68575,37150,69234
,DaChengZhen,450722105,17041,2722,11758,8115,24890,11748,6136,14104,25852,14141,25899
ʯˮ,BaiShiShuiZhen,450722106,20995,2998,14967,9137,30921,14964,8892,17913,32877,17918,32885
ͨ,BeiTongZhen,450722107,34090,4917,24803,16231,52558,24780,15544,29705,54485,29748,54551
,SanHeZhen,450722108,18141,2669,13702,7575,28224,13700,8846,15938,29638,15954,29656
,LongMenZhen,450722109,51185,7673,36922,20203,77275,36915,20919,42800,79715,42855,79777
,FuWangZhen,450722110,30542,5953,26108,15028,49945,26053,17025,27341,53394,27412,53520
կ,ZhaiWeiZhen,450722111,42811,5669,31303,16654,63125,30959,17591,34177,65136,34768,66071
,LeMinZhen,450722112,23382,3485,17242,10587,34625,17234,9232,18825,36059,18857,36099
w,LiuYinZhen,450722113,23724,3520,18181,10274,37706,18152,11470,20464,38616,20533,38714
ƽ,PingMuZhen,450722114,11454,2087,9991,5652,20091,9974,7106,10636,20610,10656,20647
,GuanDongZhen,450722115,25986,3268,19340,10341,39360,19298,11128,20971,40269,21042,40382
ǽֵ´,GuiChengJieDaoBanShiChu,450802001,164108,15529,102954,61604,139377,92830,35583,97511,190341,112266,215220
۳,GangChengZhen,450802100,49735,4671,35034,17031,56661,32889,17323,33503,66392,36695,71729
,DaWeiZhen,450802101,56440,6677,41912,21334,82996,41709,21740,42676,84385,42945,84857
,QingFengZhen,450802102,49136,5599,37763,18668,73358,37685,21438,38255,75940,38410,76173
ʯ,QiShiXiang,450802200,14415,2049,11502,5720,23409,11490,7338,12287,23777,12300,23802
,ZhongLiXiang,450802201,27888,5008,24828,13372,47878,24669,17363,25210,49879,25431,50259
,GenZhuXiang,450802202,18495,2098,12608,7395,24829,12417,5823,13300,25717,13808,26416
,WuLeXiang,450802203,19174,2300,14324,8290,28829,14265,8435,15344,29609,15585,29909
Ͻֵ´,JiangNanJieDaoBanShiChu,450803001,39093,3305,24554,13834,22485,21161,8750,22439,43600,26594,51148
,QiaoWeiZhen,450803100,53943,8097,39237,23844,77424,38781,19636,41828,80609,42439,81676
ľ,MuGeZhen,450803101,49386,8179,37258,22212,73744,36987,19955,39964,76951,40262,77520
ľ,MuZiZhen,450803102,28268,5030,21278,13379,44941,21184,12300,24162,45346,24320,45598
տ,ZhanJiangZhen,450803103,25143,5285,21221,14868,41459,21170,12307,21434,42604,21514,42735
,DongJinZhen,450803104,30898,5141,24739,15403,48707,24680,14063,25315,49995,25363,50102
,BaTangZhen,450803105,49940,5806,36133,19734,63939,32146,17766,33984,66130,37379,73512
,XinTangXiang,450803200,33066,4646,24667,14012,46698,23826,11863,23891,47717,24908,49575
,WaTangXiang,450803201,19986,5047,17826,12691,35345,17823,11063,18270,36093,18270,36096
,QinTangZhen,450804100,42386,5457,31741,20120,59044,31339,16467,32087,63426,32569,64310
,DongLongZhen,450804101,26006,4651,21932,12631,42874,21778,13022,21486,43264,21747,43679
,SanLiZhen,450804102,31894,4090,23993,13630,47596,23803,12804,24424,48227,24795,48788
,HuangLianZhen,450804103,20568,3822,17652,10282,33647,17504,10329,16619,34123,17067,34719
ʯ,ShiKaZhen,450804104,35651,6334,27596,16375,52912,26792,13328,26713,53505,27717,55313
,WuLiZhen,450804105,22313,2953,16563,9359,32418,16530,8501,17144,33674,17204,33767
ɽ,ShanBeiXiang,450804200,14197,2785,13212,8352,25496,13131,9034,12630,25761,12804,26016
ľ,ZhangMuXiang,450804201,29207,6102,26325,16715,50236,24983,17149,24834,49817,26133,52458
ɹ,MengGongXiang,450804203,16124,2907,14500,9069,27650,14367,9493,13844,28211,14024,28524
,DaLingXiang,450804204,12039,2488,9729,6818,18464,9572,5446,9905,19477,10244,19973
ƽ,PingNanZhen,450821100,115618,11518,73969,39766,135218,68912,33524,75987,144899,86691,160660
ƽɽ,PingShanZhen,450821101,22369,3984,18190,11655,34811,17775,11524,19164,36939,19687,37877
,SiMianZhen,450821102,22635,3425,17711,10547,35992,17490,10984,19002,36492,19333,37044
,LiuChenZhen,450821103,36148,6082,26645,17352,53818,26409,14590,29949,56358,30175,56820
,DaXinZhen,450821104,39178,7020,33080,20452,65197,32946,21781,34622,67568,34899,67979
,DaAnZhen,450821105,56451,7709,43288,25174,82864,41800,25028,44101,85901,45900,89188
,WuLinZhen,450821106,14561,1986,11078,6041,22021,11076,6181,11622,22698,11650,22728
,DaPoZhen,450821107,18978,2875,14579,8349,28566,14509,9140,16324,30833,16414,30993
,DaZhouZhen,450821108,19064,3142,15506,9731,30588,15503,9530,16202,31705,16230,31736
¡,ZhenLongZhen,450821109,43448,5729,31711,19055,64221,31178,18422,35008,66186,35888,67599
϶,ShangDuZhen,450821110,43253,5469,31665,17789,63840,31459,17664,34388,65847,34721,66386
,AnHuaiZhen,450821112,37008,4456,25727,13733,54467,25684,13992,29639,55323,29729,55456
,DanZhuZhen,450821113,48772,7209,38461,23538,74477,38395,22377,39724,78119,39897,78358
ٳ,GuanChengZhen,450821114,49874,7137,36506,22556,73534,36485,20333,40810,77295,40838,77344
˼,SiWangZhen,450821115,50227,6879,35550,24291,71493,35059,19195,40103,75162,40751,76301
,DaPengZhen,450821116,21857,2989,15294,9506,33396,15206,9567,18986,34192,19119,34413
ͬ,TongHeZhen,450821117,21571,4114,16979,12341,35154,16970,10415,19094,36064,19121,36100
,DongHuaXiang,450821202,18195,2821,14120,8498,28622,14104,8209,15073,29177,15105,29225
˼,SiJieXiang,450821204,15134,2361,11798,7623,24256,11611,7495,12827,24438,13192,24990
,GuoAnYaoZuXiang,450821205,6725,1585,6222,4524,11672,6218,4698,6630,12848,6786,13008
,MaLianYaoZuXiang,450821206,21839,3060,15552,9274,33207,15482,8926,18137,33619,18273,33825
ľ,MuLeZhen,450881101,39060,3999,29114,14015,55109,28999,18076,31862,60861,32021,61135
ľ,MuGuiZhen,450881102,37746,4951,29191,15970,58791,29177,17879,31232,60409,31385,60576
ʯ,ShiJuZhen,450881103,28450,3690,21397,12372,42043,20897,12078,22180,43077,22821,44218
,YouMaZhen,450881104,25423,4230,20150,12432,40211,20078,13026,22449,42527,22529,42679
,ShePoZhen,450881105,41009,5497,30634,17614,61169,30190,17955,33186,63376,33827,64461
,LuoXiuZhen,450881106,36365,5867,27387,18758,55610,27147,15452,29918,57065,30297,57684
,MaDongZhen,450881107,44383,6995,35389,22817,71085,34941,22219,37665,72606,38208,73597
粽,SheBuZhen,450881108,30087,4920,22968,14994,46727,22966,13388,25415,48381,25427,48395
,XiaWanZhen,450881109,33263,5100,27086,14850,52705,26958,16944,28018,54976,28221,55307
ľ,MuGenZhen,450881110,24444,4106,21451,12470,42360,21404,15414,22449,43853,22513,43964
ɳ,ZhongShaZhen,450881111,26227,4515,21161,13646,41824,21142,13180,22733,43875,22761,43922
,DaYangZhen,450881113,32701,4998,27516,16057,54464,27214,18525,28342,55556,28708,56224
,DaWanZhen,450881114,28900,4012,23063,13183,43344,23037,14731,24515,47552,24580,47643
ɳ,BaiShaZhen,450881115,39423,4832,30091,16312,57184,29815,17573,31176,60991,31737,61828
ʯ,ShiLongZhen,450881116,38248,5633,30204,17223,59326,29985,17973,31240,61225,31650,61854
,MengWeiZhen,450881117,45360,6391,34172,21151,67557,34036,19277,36485,70521,36856,71028
ɽ,XiShanZhen,450881118,125689,13134,83210,43883,125071,75554,33317,80127,155681,88930,172140
ľ,NanMuZhen,450881119,57170,8205,43484,26693,85991,43417,25139,46963,90380,47030,90514
,JiangKouZhen,450881120,44421,7382,34667,23351,70331,34170,21815,38299,72469,38951,73618
,JinTianZhen,450881121,44895,5885,32582,18850,65015,32191,17971,35663,67854,36169,68751
Ͼ,ZiJingZhen,450881122,12017,1739,8601,4987,18490,8533,5017,10017,18550,10172,18773
Ƥ,MaPiXiang,450881200,23343,2981,18392,10167,35663,18152,11474,18964,37116,19406,37798
Ѱ,XunWangXiang,450881202,34339,4330,25347,14218,49770,24712,13830,26573,51285,27152,52499
޲,LuoBoXiang,450881203,19499,3378,16963,9903,33546,16776,11592,17025,33801,17506,34469
»,HouLuXiang,450881204,22225,2495,17326,10252,35318,17317,10987,18342,35659,18381,35707
,DongXinXiang,450881206,10809,1877,8659,4340,16679,8614,5434,9399,18013,9461,18120
ǽֵ´,YuChengJieDaoBanShiChu,450902001,131331,14334,85664,48017,108436,79209,27991,80514,159723,87992,173656
Ͻֵ´,NanJiangJieDaoBanShiChu,450902002,103057,9654,66433,37348,97581,63044,27488,69421,132465,73766,140199
ֵ´,ChengXiJieDaoBanShiChu,450902003,52148,4584,32621,16238,37540,28652,12835,31815,60467,36946,69567
Ǳֵ´,ChengBeiJieDaoBanShiChu,450902004,34431,3587,22530,10999,43621,22288,9596,24732,47020,25084,47614
ɽֵ´,MingShanJieDaoBanShiChu,450902005,60536,5005,40488,17893,45638,29599,11880,30973,60572,36933,77421
,DaTangZhen,450902100,12109,1626,8270,4597,17137,8264,4128,9580,17844,9593,17863
ï,MaoLinZhen,450902105,58677,5392,37869,17480,66285,31794,16291,34741,66535,42491,80360
ʶ,RenDongZhen,450902106,31779,4082,21342,12163,43783,21231,9767,24038,45269,24286,45628
,FuMianZhen,450902107,71080,6981,44762,19970,80702,37103,19014,42675,79778,52313,97075
ɾ,ChengJunZhen,450902108,50372,6084,32701,16758,68153,32137,16259,38554,70691,40014,72715
ľ,ZhangMuZhen,450902109,55798,6336,35997,18851,73802,33776,17638,40663,74439,43775,79772
,XinQiaoZhen,450902110,37573,4202,25074,11426,51511,24563,12219,28088,52651,28920,53994
ɳ,ShaTianZhen,450902111,32295,3939,23974,11049,45222,23974,13919,26179,50153,26179,50153
ʯ,ShiHeZhen,450902112,17236,2044,11873,5693,23021,11586,6419,13291,24877,13826,25699
ʺ,RenHouZhen,450902113,16935,2177,11402,6508,24144,11309,5915,13476,24785,13625,25027
,RongZhouZhen,450921100,104024,12548,73533,42480,121632,68948,31534,70193,139141,74573,148106
÷,YangMeiZhen,450921102,28275,4276,21841,13128,39171,20641,11955,21152,41793,22665,44506
ɽ,LingShanZhen,450921103,19332,3511,15544,9798,30219,15476,9078,16286,31762,16377,31921
,LiuWangZhen,450921104,32000,5222,25762,15917,48047,25599,15076,26278,51877,26536,52298
,LiCunZhen,450921105,36949,6819,30406,21656,57770,30033,18625,31429,61462,31987,62393
,YangCunZhen,450921106,25208,4462,21299,13417,39749,21255,13161,21411,42666,21532,42831
ص,XianDiZhen,450921107,24058,4999,19900,14389,37656,19839,12051,21153,40992,21208,41108
,ZiLiangZhen,450921108,17755,2933,14049,8929,26427,14019,8187,14802,28821,14826,28875
ɽ,SongShanZhen,450921109,18829,3829,15617,10502,28979,15500,9155,16080,31580,16196,31813
޽,LuoJiangZhen,450921110,11213,2116,9540,6123,16563,9281,5853,9588,18869,9642,19182
ʯͷ,ShiTouZhen,450921111,24194,5218,20585,15402,38201,20335,13150,21560,41895,21977,42562
ʯկ,ShiZhaiZhen,450921112,17014,2915,13760,9040,25275,13616,7863,13846,27462,14032,27792
,RongXiXiang,450921200,8590,1329,6664,4441,12623,6552,3716,6863,13415,6971,13635
ʮ,ShiLiXiang,450921201,19622,3633,14743,9921,29026,14687,7346,15727,30414,15858,30601
ˮ,LangShuiXiang,450921202,9206,1761,7282,5721,14296,7193,4549,7995,15188,8234,15516
Ȫ,WenQuanZhen,450922101,105391,10412,70583,45063,125597,66501,32884,73938,140439,78104,148687
׳,MiChangZhen,450922102,24988,3617,20190,12345,39222,20167,13068,21434,41601,21483,41673
,MaPoZhen,450922103,45708,5905,34525,20657,67427,34404,20080,36836,71240,37168,71693
ɺ,ShanLuoZhen,450922104,33612,3251,24484,13155,48967,24439,14111,26160,50599,26490,50974
ƽ,PingLeZhen,450922105,27969,2966,20353,11561,40823,20284,11765,22197,42481,22347,42700
ɳ,ShaPoZhen,450922106,33740,4568,27733,17016,52512,27696,17765,28238,55934,28340,56073
,DaQiaoZhen,450922107,22125,3815,17326,11119,34121,17257,10153,18531,35788,18767,36093
ʯ,WuShiZhen,450922108,53510,8300,42236,25321,84275,42176,26700,46135,88311,46274,88510
,LiangTianZhen,450922109,37519,5739,30229,17830,60464,30218,19460,32468,62686,32489,62718
,QingHuZhen,450922110,24989,4408,21176,12799,40120,21060,14072,22152,43212,22293,43469
ų,GuChengZhen,450922111,28669,4630,23904,13860,47317,23894,15438,24786,48680,24833,48737
ɳ,ShaHuXiang,450922200,12046,1962,9599,5701,18905,9480,5571,9830,19310,9980,19579
ɽ,HengShanXiang,450922201,17363,3370,14230,9468,27943,14210,8725,15131,29341,15228,29458
̲,TanMianXiang,450922203,13258,2319,10400,6932,20270,10356,6431,11522,21878,11608,22008
,BoBaiZhen,450923100,126425,13797,85928,47054,151495,79037,42880,88893,167930,97174,183102
˫,ShuangFengZhen,450923102,10904,1951,9140,5459,18068,9101,6107,9745,18846,9822,18962
ٹ,DunGuZhen,450923105,23583,3170,18976,10347,38549,18934,12455,20144,39078,20232,39208
ˮ,ShuiMingZhen,450923106,33566,3958,26154,13772,53612,26004,16804,27838,53842,28174,54328
,NaLinZhen,450923107,24161,3465,19010,8803,37643,18955,11010,19534,38489,19626,38636
,JiangNingZhen,450923108,23085,3553,18366,9643,36262,18357,11410,19666,38023,19682,38048
̲,SanTanZhen,450923109,37778,4360,27223,14479,53997,27211,15112,30002,57213,30027,57250
,HuangLingZhen,450923110,15549,1846,11354,5612,23773,11333,6815,12777,24110,12856,24210
ɽ,YaShanZhen,450923111,36168,4675,28522,16242,56631,28292,18430,30466,58758,30751,59273
ï,WangMaoZhen,450923112,31158,4143,25075,13134,49497,25063,17230,27431,52494,27456,52531
ƽ,DongPingZhen,450923114,50998,7791,41644,23481,78007,41576,27945,44856,86432,45090,86734
ɳ,ShaHeZhen,450923115,32378,4992,25582,13569,49291,25236,16070,27435,52671,27858,53440
,LingJiaoZhen,450923116,17580,3217,14648,8723,29632,14640,9482,15623,30263,15631,30279
,XinTianZhen,450923117,22529,3546,17259,10875,35207,17229,11774,20474,37703,20590,37849
ɽ,FengShanZhen,450923118,40685,4662,32983,16340,64570,32886,23098,35325,68211,35462,68445
̶,NingTanZhen,450923119,24552,3953,21696,12096,39588,21696,15564,22372,44068,22373,44069
ĵ,WenDiZhen,450923120,49371,6167,38874,19689,75972,38665,24463,40875,79540,41127,80001
Ӣ,YingQiaoZhen,450923121,27004,4517,22725,14299,44361,22723,16899,25690,48413,25695,48420
ǲ,NaBuZhen,450923122,9117,1631,7022,4674,14904,6919,4737,8335,15254,8463,15485
,DaDongZhen,450923123,14337,2426,10322,6386,22235,10186,6500,12723,22909,12941,23263
ɳ,ShaBeiZhen,450923124,22183,2643,16213,8557,33092,16204,10157,18768,34972,18770,34983
˫,ShuangWangZhen,450923125,18134,2553,13790,7508,28121,13784,9082,15940,29724,15979,29769
,SongWangZhen,450923126,19368,2878,14588,7711,30157,14546,8988,16394,30940,16646,31234
̶,LongTanZhen,450923127,50865,6075,36865,17191,73049,35785,20803,39522,75307,40878,77743
,DaBaZhen,450923128,11631,2019,10364,5871,20585,10363,7752,11038,21401,11038,21402
,YongAnZhen,450923129,18186,2100,14164,7184,28664,14158,9280,15385,29543,15402,29566
,JingKouZhen,450923130,24878,3916,19569,11122,39086,19559,11854,21052,40611,21079,40648
ƽ,LangPingXiang,450923201,14558,2070,11137,6315,23239,11137,6998,12488,23625,12489,23626
ʯ,ShiNanZhen,450924100,53837,7574,36077,20680,69642,34531,15451,38641,73172,40785,76862
ƽɽ,DaPingShanZhen,450924101,27987,4232,19047,12016,40043,18740,9437,22167,40907,22609,41656
,KuiYangZhen,450924102,41001,6617,30013,17242,61442,29113,15510,31480,60593,33115,63128
,ChengHuangZhen,450924103,29973,5269,22739,14204,45764,22733,12326,24768,47501,24829,47568
ɽ,ShanXinZhen,450924104,40511,7007,30205,17004,61225,29819,16572,33285,63104,33885,64090
ɳ,ShaTangZhen,450924105,29032,5075,22540,13640,44419,22504,12843,24341,46845,24410,46950
,PuTangZhen,450924106,17677,4409,15831,11238,30764,15580,10051,15856,31436,16306,32137
,BeiShiZhen,450924107,28016,4975,21514,12778,42163,21394,12106,23336,44730,23583,45097
,LongAnZhen,450924108,20507,3608,15080,8945,31148,15062,8636,17643,32705,17671,32751
߷,GaoFengZhen,450924109,20973,3917,16877,11535,33718,16836,10734,18677,35513,18747,35624
Сƽɽ,XiaoPingShanZhen,450924110,19842,3036,14199,8216,28944,14162,7129,15745,29907,15808,30007
,MaiJiuZhen,450924111,15911,2432,11975,7577,23106,11895,6538,12830,24725,12906,24881
,LuoYangZhen,450924112,12064,2383,9248,5367,18987,9113,5196,10237,19350,10395,19643
ǽֵ´,LingChengJieDaoBanShiChu,450981001,41603,3355,25695,12492,35034,21668,9166,23294,44962,28429,54124
Ͻֵ´,ChengNanJieDaoBanShiChu,450981002,27976,2761,18558,10221,23118,18452,7980,20100,38552,20159,38717
Ǳֵ´,ChengBeiJieDaoBanShiChu,450981003,17866,1452,11565,5870,13265,10593,4950,11661,22254,12703,24268
,BeiLiuZhen,450981100,55990,6111,40238,24446,78195,40166,20559,42305,82471,42422,82660
,XinRongZhen,450981101,18405,2921,15004,9676,28560,14964,9481,15757,30721,15803,30807
,MinAnZhen,450981102,22557,2950,17401,10121,32608,17181,10426,18117,35298,18532,35933
ɽΧ,ShanWeiZhen,450981103,15886,2648,13197,8077,25382,13192,8257,13588,26780,13594,26791
,MinYueZhen,450981104,40537,5685,30468,18203,60251,30374,16709,32286,62660,32463,62931
,XiYinZhen,450981105,30290,4190,23255,13046,43772,23216,13407,24566,47782,24632,47887
,XinWeiZhen,450981106,35871,4689,25811,14462,51048,24886,13074,26585,51471,27823,53634
,DaLiZhen,450981107,27630,4005,19954,11287,39966,19773,10466,21746,41519,22147,42101
,TangAnZhen,450981108,30597,3663,22786,13668,42823,22051,13253,23665,45716,24727,47513
ˮ,QingShuiKouZhen,450981109,23227,3267,18556,11300,33907,18480,12255,20032,38512,20193,38749
¡ʢ,LongShengZhen,450981110,42660,5338,32802,18078,62088,32742,19626,34729,67471,34822,67624
,DaPoWaiZhen,450981111,23620,3188,18158,10543,34646,18158,11348,19998,38156,19998,38156
,LiuMaZhen,450981112,37611,5009,30439,17215,59473,30239,19247,31139,61378,31428,61867
·,XinFengZhen,450981113,23644,3392,18834,11939,37267,18467,11955,19538,38005,20157,38991
ɳ,ShaDongZhen,450981114,12602,2301,11731,7490,21403,11730,8391,11563,23293,11563,23294
ƽ,PingZhengZhen,450981115,37780,5067,30287,17617,57565,29574,19913,31407,60981,32473,62760
,BaiMaZhen,450981116,24698,3468,20008,11142,40387,19838,13721,21397,41235,21879,41887
,DaLunZhen,450981117,18361,2696,15394,9243,29764,15392,10836,16495,31887,16499,31893
,FuXinZhen,450981118,10031,1835,9505,5788,17772,9378,7104,9195,18573,9465,18970
,LiuJingZhen,450981119,38330,4902,29817,18677,56809,29270,19117,31874,61144,32532,62349
ʯ,ShiWoZhen,450981120,29577,4173,23549,14431,47287,23526,15707,25884,49410,25908,49457
,QingWanZhen,450981121,29105,4213,23672,14804,46011,23672,15535,25181,48853,25181,48853
ٳǽֵ´,BaiChengJieDaoBanShiChu,451002001,117439,10182,73612,42169,86838,58860,17828,58528,117388,71837,145449
ֵ´,LongJingJieDaoBanShiChu,451002002,50456,3912,30663,17235,47172,27367,9644,28411,55778,33349,64012
,YangWeiZhen,451002101,21592,2511,14410,7786,28722,14255,5583,14921,29176,15276,29686
,SiTangZhen,451002102,20941,2183,13358,7735,24408,13135,4462,13626,26761,14228,27586
,LongChuanZhen,451002103,22451,2739,14866,7948,30863,14773,6452,16435,31208,16776,31642
,YongLeXiang,451002201,12813,1435,8163,4561,15416,8080,2812,8620,16700,8897,17060
,WangDianYaoZuXiang,451002202,18703,1898,12185,6175,23912,11995,4901,12663,24658,13317,25502
,DaLengXiang,451002203,15973,2095,10569,5754,20889,10464,3953,11208,21672,11452,22021
ˮ,PanShuiXiang,451002204,7097,913,4767,2629,9236,4763,1857,5081,9844,5100,9867
,TianZhouZhen,451021100,64739,6351,42440,24313,58751,38979,12960,37756,76735,41610,84050
,NaPoZhen,451021101,27820,3474,18081,11015,35274,17767,6024,18338,36105,19237,37318
º,PoHongZhen,451021102,21747,3742,15420,9002,29717,15398,5564,15579,30977,15633,31053
,NaManZhen,451021103,13347,2121,9215,5468,18110,9117,3104,9297,18414,9357,18572
,BaiYuZhen,451021104,19485,2364,12710,7444,23954,12686,3782,12885,25571,12921,25631
,YuFengZhen,451021105,22666,3137,15876,8819,31418,15788,6838,16493,32281,16765,32641
ͷ,TouTangZhen,451021106,17716,2054,11508,6769,20878,11417,3662,11691,23108,11924,23432
,DongJingXiang,451021202,17178,3432,12136,7198,24672,12055,4345,12631,24686,12819,24955
ͱ,BaBieXiang,451021204,11244,2220,7710,4594,15922,7610,2953,8512,16122,8707,16417
,WuCunXiang,451021205,12386,2784,9549,6398,18449,9532,4014,9578,19110,9635,19184
ƽ,PingMaZhen,451022100,75826,7356,48566,29260,67806,44583,15803,45086,89669,50419,98985
,XiangZhouZhen,451022101,38818,4659,25954,15902,48745,25775,9089,26268,52043,26612,52566
ַ,LinFengZhen,451022103,30751,3754,20651,12304,39942,20354,8213,21410,41764,22067,42718
˼,SiLinZhen,451022105,29587,4346,21450,13253,41429,21054,10479,22238,43292,22962,44412
ӡ,YinChaZhen,451022106,11122,1805,8762,5606,16397,8616,4908,8837,17453,9073,17835
,JiangChengZhen,451022107,9464,1751,7666,4588,14472,7630,4067,7522,15152,7616,15282
˷,ShuoLiangZhen,451022108,18778,2656,13519,7687,26109,13446,6194,13962,27408,14109,27628
,YiWeiZhen,451022109,12202,2094,9289,5532,17831,9220,4673,9420,18640,9680,18969
ǰ,NaBaZhen,451022110,9837,1266,6839,3968,13381,6784,3061,7199,13983,7325,14164
,ZuoDengYaoZuXiang,451022201,14904,2603,12295,7590,21705,12214,6744,11781,23995,11956,24251
ͷ,MaTouZhen,451023100,84148,7289,54324,30520,69255,48753,19137,50892,99645,56250,110574
°,XinAnZhen,451023101,35317,4214,23711,12354,44981,22874,9706,24582,47456,25526,49237
,GuoHuaZhen,451023102,30677,3922,21451,12030,43447,21437,9888,22992,44429,23036,44487
̫ƽ,TaiPingZhen,451023103,41519,5844,29463,17576,60038,29426,13199,31033,60459,31099,60562
,PoZaoZhen,451023104,10669,1711,7757,4770,15438,7742,3631,8233,15975,8254,16011
,SiTangZhen,451023105,12666,1568,8386,5271,17204,8352,3661,9452,17804,9509,17895
ɳ,JiuChengZhen,451023106,23694,3951,16158,9266,32287,16122,6343,17729,33851,17830,33988
,BangWeiZhen,451023107,16899,3569,12587,8113,23771,12553,4283,12117,24670,12164,24751
,HaiChengXiang,451023200,15134,2568,11436,6984,22443,11429,5615,11853,23282,11881,23317
,FengWuXiang,451023201,15330,3110,11238,6291,22147,11230,4414,11598,22828,11616,22854
,LiMingXiang,451023202,7599,1263,5194,3266,10264,5191,1848,5510,10701,5516,10710
ͬ,TongLaoXiang,451023203,7266,1119,5133,3278,10102,5133,2107,5359,10492,5359,10492
ƽ,PingGuoLv,451023450,7288,306,4637,3702,6079,4414,1817,4645,9059,4774,9411
ǹ,ChengGuanZhen,451024100,41972,4758,27196,15652,39638,25043,8815,26199,51242,28349,55545
,ZuRongZhen,451024101,14570,2444,9626,5626,19809,9519,3255,10516,20035,10643,20269
¡ɣ,LongSangZhen,451024102,11592,1847,7784,4630,16090,7782,2904,8544,16326,8559,16343
,JingDeZhen,451024103,18132,3348,12417,6650,25885,12381,5092,14094,26475,14155,26572
�,MaAiZhen,451024104,22364,4350,15287,8428,32080,15266,6189,17454,32720,17616,32903
,DouAnXiang,451024200,8035,2182,6255,4066,12389,6167,2900,6542,12709,6862,13117
Ǽ,NaJiaXiang,451024202,16339,3193,10937,6110,22989,10838,3896,12203,23041,12491,23428
ٻ,RongHuaXiang,451024203,7608,1778,6175,4004,12082,6148,3262,6393,12541,6473,12648
,YanDongXiang,451024204,15307,3461,11215,7915,22894,11211,4706,12209,23420,12259,23474
,LongGuangXiang,451024205,15372,2965,11732,6969,23097,11589,6237,12585,24174,12842,24574
ͷ,BaTouXiang,451024206,8635,2452,6948,4843,14091,6940,3325,7446,14386,7464,14412
,DongLingXiang,451024207,21041,3850,14697,8020,30460,14638,6415,16437,31075,16609,31306
±ҵ,DeBaoLvYe,451024450,2823,46,1285,1652,157,1281,447,1991,3272,2031,3316
¾,XinJingZhen,451025100,69651,8531,46779,27261,74588,44301,17371,46394,90695,48774,95553
,HuaDongZhen,451025101,10866,2075,7745,4383,15625,7707,3252,8314,16021,8448,16193
,HuRunZhen,451025102,15963,1787,10388,6020,19296,10250,4604,11215,21465,11966,22354
,AnDeZhen,451025103,16816,4200,13630,8275,26569,13505,6901,13963,27468,14287,27917
,LongLinZhen,451025104,16633,3297,12662,6708,25245,12592,6734,13817,26409,14002,26664
,QuYangZhen,451025105,20295,4235,14701,7879,28999,14516,7179,15343,29859,17008,31709
,YueWeiZhen,451025106,6974,1187,5073,2872,10186,5010,2265,5252,10262,5353,10426
,LongBangZhen,451025107,10338,1579,8014,4676,16072,7992,4822,8656,16648,8725,16739
ͬ,TongDeXiang,451025200,13811,2432,9630,5459,19978,9597,4152,10662,20259,10765,20395
ׯ,RenZhuangXiang,451025201,10217,1829,7930,4452,16118,7920,4366,8422,16342,8482,16412
,AnNingXiang,451025202,8130,1385,6283,3671,12744,6266,3506,6649,12915,6738,13021
,DiZhouXiang,451025203,14663,2757,11114,6248,22133,11111,5517,11822,22933,11823,22937
»,LuDongXiang,451025204,24892,5005,18272,9958,36902,18258,8758,20292,38550,20383,38655
,NanPoXiang,451025206,13452,2682,9992,5428,20190,9948,4833,10865,20813,10975,20967
,TunPanXiang,451025207,8063,1507,6397,3502,12652,6397,3574,6747,13144,6747,13144
,GuoLeXiang,451025209,12026,2747,9588,5152,18905,9532,5036,10113,19645,10221,19809
¼,XinJiaXiang,451025211,21916,4153,16001,9096,32753,15948,8073,17691,33639,18141,34142
ƽ,WuPingXiang,451025212,20665,4195,16078,9163,31800,16005,8528,17107,33112,17310,33388
,KuiWeiXiang,451025215,11617,2454,8813,4798,17454,8813,4028,9286,18099,9286,18099
,ChengXiangZhen,451026100,33585,4858,23227,14337,40978,22548,9422,23395,45943,24638,47865
ƽ,PingMengZhen,451026101,7473,1484,5542,3579,11058,5497,2493,5810,11307,5908,11450
º,PoHeXiang,451026200,5774,1510,4593,3257,9283,4586,2319,4983,9569,5010,9603
,LongHeXiang,451026201,13094,3466,10966,6971,21710,10946,5699,11240,22186,11293,22259
¡,DeLongXiang,451026203,9114,1642,6793,4304,13554,6741,3262,7111,13852,7225,14018
ٺ,BaiHeXiang,451026204,7629,1373,5554,3676,10933,5538,2432,5821,11359,5880,11434
,BaiNanXiang,451026205,5093,804,3618,2454,7404,3614,1829,4043,7657,4108,7726
ʡ,BaiShengXiang,451026207,9419,1395,6718,4047,13626,6668,3232,7153,13821,7328,14046
ٶ,BaiDouXiang,451026208,9749,1947,7405,4969,15063,7395,3589,7863,15258,7880,15285
,SiChengZhen,451027100,34943,3563,24038,12799,41838,23425,11192,24880,48305,25660,49698
¥,LuoLouZhen,451027101,22699,3081,15970,8562,33300,15941,8113,17826,33767,17923,33893
,JiaYouZhen,451027102,15452,2067,11220,6058,22638,11180,5998,12199,23379,12297,23517
¼,XiaJiaXiang,451027200,12846,1703,9225,4441,18309,9194,4577,9824,19018,9901,19126
վ,LingZhanYaoZuXiang,451027201,10276,1139,7183,3716,13792,7005,3883,7566,14571,8115,15298
,ChaoLiYaoZuXiang,451027202,5292,592,3697,1838,7459,3680,1965,4122,7802,4152,7849
ɳ,ShaLiYaoZuXiang,451027203,9816,1437,7424,3959,14828,7340,4130,7832,15172,7959,15383
,YuHongYaoZuXiang,451027205,14003,1582,10047,5076,20077,10044,5520,11042,21086,11058,21105
ͬ,TongLeZhen,451028100,28461,2913,20387,11431,34923,20181,10756,21480,41661,21743,42130
,GanTianZhen,451028101,8589,1433,6516,3752,12737,6476,3462,6884,13360,6968,13484
»,XinHuaZhen,451028102,13619,1763,10483,5421,19784,10482,6090,10976,21458,10989,21472
ƺ,HuaPingZhen,451028103,8711,898,6369,3435,12190,6352,3704,6895,13247,6944,13313
ɳ,LuoShaXiang,451028201,8771,1403,6702,4088,13423,6651,3803,7160,13811,7275,13977
,LuoXiXiang,451028203,12122,1426,9026,4784,16668,9021,5395,9912,18933,9917,18943
ƽ,YouPingXiang,451028204,11184,1184,8171,4324,16299,8158,4724,8838,16996,8921,17092
ų,YaChangXiang,451028205,5289,512,3886,2013,7347,3860,2292,4133,7993,4207,8093
,LeLiZhen,451029100,28802,2291,18867,11121,25250,17442,7752,18185,35627,19978,38845
,JiuZhouZhen,451029101,10554,1467,8270,4850,15041,8244,4214,7943,16187,7965,16235
,DingAnZhen,451029102,7970,935,5749,3092,10930,5672,2733,5749,11421,5889,11638
¡,LiuLongZhen,451029103,12569,1345,8807,4947,16094,8786,4184,9223,18009,9291,18098
º,LuChengYaoZuXiang,451029200,16799,1804,11671,6390,21872,11444,5636,11868,23312,12568,24239
,LiZhouYaoZuXiang,451029201,9658,1258,6861,3828,13317,6844,3248,7275,14119,7303,14164
ƽ,PingTangXiang,451029202,6732,1030,5165,3106,9917,5158,2791,5373,10531,5388,10553
ƽ,LangPingXiang,451029203,14446,2710,12132,7184,24034,12115,7834,12828,24943,12858,24990
˹,BaGuiYaoZuXiang,451029204,7918,1101,5779,3336,11049,5761,2882,6051,11812,6122,11901
˶,BaDuYaoZuXiang,451029205,12873,1429,9710,4988,18642,9661,5289,9768,19429,9881,19591
Ǳ,NaBiXiang,451029206,5081,610,3713,1847,6981,3706,1883,3758,7464,3861,7574
,GaoLongXiang,451029207,5577,596,3976,2170,7368,3949,2234,4363,8312,4431,8407
,BaiLeXiang,451029208,7293,891,5407,2944,10567,5389,3038,5753,11142,5815,11222
,ZheMiaoXiang,451029209,4938,705,3847,2310,7132,3847,1943,3739,7586,3739,7586
˴,BaDaZhen,451030100,28034,2064,19140,10653,29682,18211,9391,19025,37236,20349,39489
,GuZhangZhen,451030101,18298,1897,13255,7455,24201,13194,7506,14272,27466,14446,27701
,MaBangXiang,451030200,9033,1036,6689,3650,12647,6683,3831,7203,13886,7211,13900
պ,PuHeMiaoZuXiang,451030203,6551,608,4705,2519,8371,4615,2389,4735,9350,4843,9548
ƽ,XiPingXiang,451030204,7552,959,5607,3247,10365,5601,2752,5638,11239,5656,11263
,NaZuoMiaoZuXiang,451030206,13579,1790,10252,5746,19764,10235,5695,10766,21001,10812,21064
,NaLaoXiang,451030207,5393,569,3851,2209,6784,3774,1781,3786,7560,3892,7743
,ZuBieYaoZuMiaoZuXiang,451030208,5408,518,3818,1958,7467,3818,2013,4121,7939,4121,7939
,XinZhouZhen,451031100,40272,2879,26655,14058,44971,24811,10758,25380,50191,27254,53909
,YaChaZhen,451031101,6701,828,5065,3040,9867,5064,2710,5139,10203,5174,10239
,TianShengQiaoZhen,451031102,11889,1671,9635,5437,17595,9634,5417,9338,18972,9342,18977
ƽ,PingBanZhen,451031103,18298,2405,13894,7304,26157,13808,6915,13480,27288,13724,27618
ɳ,ShaLiXiang,451031200,9042,1112,6983,3545,12604,6945,3538,6639,13584,6709,13692
¡,LongHuoXiang,451031201,15733,2115,12339,6533,23515,12332,7244,12748,25080,12753,25092
߱,ZheBaoXiang,451031203,14292,1850,11281,6515,21353,11281,6518,11359,22640,11379,22660
,ZheLangXiang,451031204,11236,1141,8151,4035,15563,8142,4260,8461,16603,8486,16637
ﲽ,GeBuXiang,451031205,11115,1608,9013,5234,17079,9010,5400,9110,18120,9110,18123
ɽ,JinZhongShanXiang,451031206,9122,1000,6809,3488,13641,6809,3878,7191,14000,7191,14000
¶,DeEXiang,451031207,21637,2078,15790,7772,30138,15790,9465,17390,33180,17390,33180
�,ZhuChangXiang,451031208,13454,967,9519,4559,18232,9500,5474,10342,19842,10376,19895
߳,SheChangXiang,451031210,9906,1052,7525,3806,12581,7523,4603,8028,15551,8036,15561
˳,KeChangXiang,451031211,14680,1686,11354,5895,22086,11330,6544,11505,22835,11556,22910
Ҳ,YanChaXiang,451031213,11445,1426,8492,4512,16858,8476,4443,8786,17262,8822,17314
͢,JieTingXiang,451031215,7555,964,5648,3093,11032,5648,3075,5946,11594,5946,11594
ֵ´,XiWanJieDaoBanShiChu,451101001,20810,3155,13478,8184,22546,12632,4105,12809,25441,14592,28070
,HuangTianZhen,451101101,51722,6201,34578,17509,63486,34182,13987,36223,70405,37332,71910
,ETangZhen,451101102,32824,3742,22840,10751,44349,22725,10966,24448,47173,24692,47532
ɳ,ShaTianZhen,451101103,64074,7297,44638,20653,87531,43086,21480,46697,89783,48213,92851
,GongHuiZhen,451101104,42811,5859,29873,16786,62371,29819,14943,33664,63483,33740,63613
ˮ,ShuiKouZhen,451101105,7012,1141,4975,2607,10045,4958,2475,5614,10572,5653,10628
,WangGaoZhen,451101106,21966,2771,15095,7474,29232,14836,6549,15885,30721,16191,31286
ͷ,YangTouZhen,451101107,25342,3341,17451,8242,35665,17186,7749,18526,35712,18981,36432
ƽ,DaPingYaoZuXiang,451101200,6187,1156,4670,2812,8685,4666,2364,5029,9695,5037,9707
˲ֵ´,BaBuJieDaoBanShiChu,451102001,95497,8171,61698,32283,81226,51740,18577,50717,102457,60547,122245
ؽ,HeJieZhen,451102101,42745,5053,30560,14856,56876,29062,14443,30074,59136,31681,62241
ͷ,BuTouZhen,451102102,18166,2499,13589,6875,25876,13437,7688,13939,27376,14764,28353
,LianTangZhen,451102103,53420,6486,37442,17771,71659,36950,17164,38819,75769,39628,77070
,DaNingZhen,451102104,24758,3462,18025,8951,36286,17850,9118,18956,36806,19313,37338
,NanXiangZhen,451102105,11076,1660,7907,4992,16157,7892,4040,8762,16654,8869,16776
,GuiLingZhen,451102106,46399,7167,36340,20076,70270,36061,20683,37618,73679,37909,74249
ɽ,KaiShanZhen,451102107,7425,1295,5893,3101,11454,5860,3242,6017,11877,6069,11962
,LiSongZhen,451102109,11271,1712,7838,4153,15702,7740,3277,8300,16040,8422,16260
Ŷ,XinDouZhen,451102114,32865,4220,23338,12101,42976,22689,11151,23549,46238,24898,48236
,LingFengZhen,451102115,4410,506,3165,1581,5654,3103,1719,3236,6339,3470,6635
,RenYiZhen,451102116,32829,4422,25109,12804,48181,24780,13158,24621,49401,25300,50409
,PuMenZhen,451102117,35732,4918,27369,13205,54459,27285,14947,28100,55385,28228,55597
ƶ,HuangDongYaoZuXiang,451102200,4399,567,2841,1597,5534,2791,1124,3170,5961,3249,6090
ƽ,ZhaoPingZhen,451121100,53850,6624,36216,18661,60079,33790,13426,35326,69116,37684,73900
,WenZhuZhen,451121101,6145,1096,4302,2468,8619,4299,1514,4442,8741,4453,8755
Ҧ,HuangYaoZhen,451121102,32290,4984,23339,12173,47934,23297,12114,25931,49228,26049,49388
,FuLuoZhen,451121103,14644,2421,10021,6275,20792,9805,4591,11265,21070,11635,21656
,BeiTuoZhen,451121104,18808,3067,13447,7971,27150,13428,6490,14856,28284,14918,28365
�,MaJiangZhen,451121105,20366,3406,13950,8352,28331,13915,5867,15593,29508,15689,29639
彫,WuJiangZhen,451121107,17242,2958,12082,6946,25665,12021,6106,14205,26226,14224,26306
ɻ,XianHuiYaoZuXiang,451121201,6697,1475,4786,3390,9862,4771,1935,5280,10051,5321,10107
,ZouMaXiang,451121202,16563,2761,11227,6091,23035,11137,4787,12573,23710,12884,24111
ľ,ZhangMuLinXiang,451121205,19637,3208,13906,7898,29562,13903,7300,16234,30137,16239,30145
,FengHuangXiang,451121206,12883,2250,9556,5903,20073,9550,5370,10926,20476,10947,20503
ľ,MuGeXiang,451121208,11679,2004,8244,4913,17282,8231,4089,9478,17709,9528,17772
ɽ,ZhongShanZhen,451122100,71050,7662,46140,24516,80485,42707,17870,43957,86664,50442,96582
,HuiLongZhen,451122104,22507,2981,16761,7820,34028,16618,9278,17685,34303,18005,34766
ʯ,ShiLongZhen,451122105,15074,2247,11636,5538,22232,11629,6314,11951,23580,11999,23635
,FengXiangZhen,451122106,14928,2184,11155,5503,22045,11131,6129,11975,23106,12086,23241
ɺ,ShanHuZhen,451122107,9734,1680,6869,4090,13316,6754,2744,6836,13590,7289,14158
ͬ,TongGuZhen,451122108,12237,2209,9339,5313,19254,9308,5115,10149,19457,10222,19561
,GongAnZhen,451122109,28651,4512,21087,9475,42216,21071,10343,22363,43434,22419,43506
,QingTangZhen,451122111,22720,4877,18495,10348,36103,18458,10672,19687,38145,19774,38269
,YanTangZhen,451122112,12448,2109,9207,5195,18330,9200,4882,10139,19339,10232,19439
컨,HongHuaZhen,451122113,12887,1881,8743,4241,17858,8727,3488,9434,18161,9513,18256
ɽ,HuaShanYaoZuXiang,451122200,4014,686,2745,1565,5414,2732,963,2841,5573,2918,5663
,LiangAnYaoZuXiang,451122201,10060,1420,6611,3250,12900,6564,2568,6818,13382,7437,14048
,FuYangZhen,451123100,48865,5500,32274,17829,60531,31618,12491,34056,65674,34582,66856
ɳ,BaiShaZhen,451123101,5914,1139,4518,2812,8858,4510,2240,4761,9271,4775,9293
ɽ,LianShanZhen,451123102,14690,2570,10484,5507,21201,10427,4582,11120,21547,11358,21842
ų,GuChengZhen,451123103,13705,2017,9391,5140,19266,9357,4146,10399,19756,10477,19868
,FuLiZhen,451123104,12188,1898,8586,4795,17202,8586,3717,9217,17803,9217,17803
,MaiLingZhen,451123105,13346,1778,9490,4917,19284,9490,4413,10044,19534,10047,19537
,GePoZhen,451123106,11432,1790,8118,4422,16426,8113,3630,8733,16846,8734,16852
Ǳ,ChengBeiZhen,451123107,11369,1734,8113,4944,16434,8113,3585,8575,16688,8575,16688
,ChaoDongZhen,451123108,17340,2645,12661,7094,24810,12637,5653,12933,25570,12977,25638
»,XinHuaXiang,451123200,10801,1836,8001,4040,15739,7897,3543,8045,15942,8179,16180
ʯ,ShiJiaXiang,451123201,8215,1146,5708,3178,11949,5708,2730,6383,12091,6383,12091
,LiuJiaXiang,451123203,9928,1477,6746,3531,13757,6746,2758,7416,14162,7417,14163
ǽֵ´,JinChengJiangJieDaoBanShiChu,451202001,109866,8943,68156,44617,83253,60013,20600,60462,120475,71253,139409
,DongJiangZhen,451202101,33055,2533,21339,12796,29614,19691,7775,20843,40534,22024,43363
,LiuWeiZhen,451202102,18484,1975,12262,7623,23103,12251,4651,12754,25005,12848,25110
,LiuJiaZhen,451202103,8578,928,5478,4114,10071,5468,1806,5804,11272,5834,11312
ӳ,HeChiZhen,451202104,16380,2131,10440,6504,20095,10235,3844,11360,21595,11915,22355
ι,BaGongZhen,451202105,10096,1218,6258,3737,12721,6129,2135,6819,12948,7191,13449
,JiuWeiZhen,451202106,14798,2789,10531,7213,20853,10501,4271,11284,21785,11327,21858
,WuWeiZhen,451202107,8456,983,5271,3206,10449,5236,1797,5715,10951,5965,11236
,BaiTuXiang,451202200,7563,1223,5657,3918,10799,5648,2664,5774,11422,5793,11450
,CeLingXiang,451202203,7396,753,4657,2565,9407,4440,1883,4954,9394,5375,10032
ƽ,BaoPingXiang,451202204,6475,871,4389,2706,8660,4385,1734,4668,9053,4691,9080
,ZhangLaoXiang,451202205,8247,1363,5230,3594,11016,5213,1867,6194,11407,6247,11477
ǹ,ChengGuanZhen,451221100,49390,4515,32819,19345,50001,31317,13899,32752,64069,34985,67804
,DaChangZhen,451221101,21095,2133,12893,9612,20115,12599,4881,14052,26651,15216,28109
,CheHeZhen,451221102,16106,1285,8823,6131,14032,8390,3179,9285,17675,11747,20570
â,MangChangZhen,451221103,15752,1844,10742,6057,20671,10472,5598,11780,22252,12452,23194
կ,LiuZhaiZhen,451221104,24693,3004,17395,10243,34366,17367,9084,19332,36699,19386,36781
,YueLiZhen,451221105,10309,1828,8540,5679,16079,8526,5690,9249,17775,9287,17827
ᰯ,WuAiZhen,451221106,9866,1366,6999,4390,14053,6997,3704,7922,14919,7937,14936
޸,LuoFuXiang,451221200,13825,2088,9917,6296,19447,9897,4683,10645,20542,10679,20596
б,ZhongBaoMiaoZuXiang,451221202,4171,581,2975,1815,6127,2972,1716,3475,6447,3493,6468
,BaWeiYaoZuXiang,451221203,14285,1906,10584,5706,19908,10543,5982,11512,22055,11589,22173
,LiHuYaoZuXiang,451221204,12872,1472,9543,5055,17253,9542,5548,10336,19878,10349,19892
,LiuPaiZhen,451222100,33063,3228,22877,12836,28835,21921,11081,22752,44673,24495,47372
,XiangYangZhen,451222101,15400,1926,11406,5776,21943,11300,6592,12333,23633,12512,23918
ĺ,BaMuXiang,451222200,6186,1260,4899,2833,9229,4868,2656,5135,10003,5203,10102
,BaLaYaoZuXiang,451222201,11389,2031,8685,4779,17129,8655,4662,9356,18011,9397,18082
ֱ,NaZhiXiang,451222203,4189,583,3147,1787,5780,3145,1812,3425,6570,3437,6584
,GengXinXiang,451222204,8409,1314,6708,3631,12653,6690,3918,6875,13565,6933,13641
,XiaLaoXiang,451222206,6087,787,4786,2357,9028,4762,2906,4896,9658,4994,9780
½,PoJieXiang,451222207,7807,1085,5705,3166,11076,5693,3299,6430,12123,6486,12191
,SanBaoXiang,451222208,7990,1214,6340,3496,12224,6330,4143,6978,13308,7007,13347
,FengChengZhen,451223100,28100,3176,19833,11546,34838,19679,9191,20343,40022,20634,40467
,PaoLiXiang,451223200,5596,1228,4558,2752,8835,4510,2447,4612,9122,4713,9271
,ZhaiYaXiang,451223201,7962,1433,5863,3863,11742,5863,2689,6219,12082,6221,12084
,ChangZhouXiang,451223202,9937,1868,8083,5168,15771,8070,4327,8025,16095,8049,16132
,QiaoYinXiang,451223203,15547,2688,11917,7162,23559,11907,5897,12187,24094,12215,24132
,JinYaYaoZuXiang,451223205,12926,1781,10423,5448,20407,10376,6305,10473,20849,10589,21012
ͤ,ZhongTingXiang,451223207,7243,1072,5671,3139,11048,5668,3238,5874,11542,5882,11553
ƽ,PingLeYaoZuXiang,451223208,10936,1736,8320,4985,16330,8302,4483,8775,17077,8835,17155
,JiangZhouYaoZuXiang,451223209,5956,1039,4644,2457,9086,4586,2656,4734,9320,5007,9651
,DongLanZhen,451224100,32421,4544,23320,14635,38043,22268,10810,23009,45277,24455,47775
,AiDongZhen,451224101,17342,3405,13939,9455,27063,13923,8033,14811,28734,14841,28780
,ChangLeZhen,451224102,8338,1800,7105,4774,12873,7084,3913,6915,13999,6946,14051
ʯ,SanShiZhen,451224103,8790,2354,7648,5054,14212,7642,4013,7496,15138,7509,15157
׭,WuZhuanZhen,451224104,10018,2392,8450,5645,15615,8441,4233,8169,16610,8193,16643
,SiMengXiang,451224200,4892,1168,4211,2872,7937,4196,2437,4256,8452,4286,8497
ľ,LanMuXiang,451224201,6544,1655,5360,3525,10271,5339,2801,5600,10939,5640,11000
,ChangJiangXiang,451224202,9045,1821,7731,5152,14384,7670,4684,7643,15313,7819,15550
ͳ,BaChouXiang,451224203,6721,1231,5476,3395,10550,5475,3391,5851,11326,5867,11343
,JinGuXiang,451224204,5679,1178,4337,2714,8502,4335,2257,4756,9091,4777,9114
Ū,SanNongYaoZuXiang,451224205,2444,526,1978,1260,3677,1973,1021,1995,3968,2013,3991
ͬ,DaTongXiang,451224206,6761,1296,5540,3424,10331,5521,3038,5500,11021,5555,11095
,HuaXiangXiang,451224207,8623,1743,6913,4635,13065,6905,3891,7320,14225,7344,14257
ѧ,QieXueXiang,451224208,3374,705,2713,1894,5306,2696,1696,3011,5707,3062,5775
,DongMenZhen,451225100,61139,7427,41489,22975,78051,40754,15109,41382,82136,42186,83675
,LongAnZhen,451225101,28089,4708,19220,10795,39007,18947,7390,20745,39692,20967,40187
ƽ,HuangJinZhen,451225102,11032,2111,8010,5038,16072,7983,3697,8411,16394,8830,16840
С,XiaoChangAnZhen,451225103,18586,3429,13982,8425,27125,13942,6666,14627,28569,14699,28681
İ,SiBaZhen,451225105,31875,5011,21847,12192,43753,21782,8165,22936,44718,23204,45051
,TianHeZhen,451225106,11657,2264,8090,5222,16297,8050,2919,8678,16728,8750,16840
Ⱥ,HuaiQunZhen,451225107,11926,2120,8483,5313,16820,8462,3228,8758,17220,8791,17274
̳,BaoTanXiang,451225200,12005,1654,7948,4488,16422,7834,3171,8689,16523,8882,16830
,QiaoShanXiang,451225202,12879,1891,8792,4708,17646,8792,3151,9128,17920,9129,17921
,NaWengXiang,451225203,4076,506,2684,1678,5417,2684,1061,2958,5642,2959,5643
氮,JianAiXiang,451225204,5873,1242,4602,3101,8966,4595,2204,4681,9276,4717,9319
˼,SiEnZhen,451226100,35114,3977,23708,15279,35968,22117,9292,23208,45325,24675,48383
ˮԴ,ShuiYuanZhen,451226101,19066,3446,13445,9535,27079,13375,5782,14725,28100,14849,28294
,LuoYangZhen,451226102,23762,3059,16169,11250,31324,16047,7339,17756,33803,17991,34160
ɽ,ChuanShanZhen,451226103,24584,3617,17107,10935,34409,17050,8121,19104,36154,19215,36322
,MingLunZhen,451226104,16041,3239,12344,9109,23858,12287,5928,12618,24905,12864,25208
,DongXingZhen,451226105,12896,2025,8675,5794,17332,8646,3431,9605,18251,9677,18352
,DaCaiXiang,451226200,6025,1083,4391,3176,8417,4376,1738,4424,8800,4455,8846
,XiaNanXiang,451226202,6873,1661,5348,4356,10722,5331,2494,5641,10972,5680,11028
,DaAnXiang,451226204,9298,1670,6814,4853,13556,6800,3308,7439,14239,7462,14276
,ZhangMeiXiang,451226205,6373,1116,4904,3448,9436,4891,2660,5217,10108,5245,10149
,LongYanXiang,451226206,9144,2009,6740,4860,13363,6698,2688,6998,13696,7101,13841
ѱ,XunLeMiaoZuXiang,451226207,15741,2299,11030,7917,21370,10970,5429,12287,23257,12439,23469
,BaMaZhen,451227100,49737,5115,34508,17926,54167,32194,15673,33285,65479,36017,70525
ප,YanDongXiang,451227200,10482,2124,9163,5795,16937,9139,5530,8916,18055,8973,18136
׭,JiaZhuanXiang,451227201,12934,2262,10029,5710,19856,9942,5321,10323,20265,10488,20517
,NaSheXiang,451227202,8476,1311,6957,3572,13275,6944,4230,7036,13980,7060,14017
,SuoLveXiang,451227203,19062,2804,14921,8033,29249,14913,8375,15287,30200,15320,30241
ɽ,XiShanXiang,451227205,9925,1574,7547,4363,15124,7510,4023,7882,15392,7975,15522
ɽ,DongShanXiang,451227207,7186,715,5410,2607,9015,5389,3187,5633,11022,5678,11088
,FengHuangXiang,451227208,5705,791,4270,2315,7770,4233,2211,4371,8604,4437,8707
,BaiLinXiang,451227209,6286,1239,5554,3461,10508,5542,3451,5395,10937,5422,10976
,NaTaoXiang,451227210,15870,2297,12148,6722,23751,12134,6741,12673,24807,12760,24908
,AnYangZhen,451228100,38777,4360,26928,14904,42520,25408,11210,25436,50844,27419,54347
,GaoLingZhen,451228101,37678,6489,29945,17017,58241,29865,15238,29295,59160,29460,59405
ν,ChengJiangXiang,451228200,33294,5196,25488,14443,45064,25296,12286,25129,50425,25288,50776
,DiSuXiang,451228202,33894,5736,27545,16061,53350,27449,14534,26463,53912,26619,54164
,DongMiaoXiang,451228204,13979,2567,11110,6725,21548,11104,5639,11059,22163,11075,22185
,DaXingXiang,451228206,16853,3106,13356,7655,25808,13283,7084,13576,26859,13687,27043
,XiaAoXiang,451228207,19225,3026,15260,9210,30203,15228,8923,15861,31089,15914,31174
¡,LongFuXiang,451228208,8745,1559,7799,4247,14660,7786,5432,7920,15706,7937,15736
,BaoAnXiang,451228209,15836,3073,11893,7170,24126,11885,6135,13129,25014,13151,25044
,BanLingXiang,451228210,14762,2786,11926,8010,23306,11913,6679,12254,24167,12301,24227
,YongAnXiang,451228211,9778,1911,8238,4997,15882,8225,5126,8548,16773,8577,16815
ֻ,SanZhiYangXiang,451228212,8299,1412,6657,4087,12499,6623,3901,6893,13516,6955,13612
,LongWanXiang,451228213,6867,1742,5294,3289,10518,5209,2148,5373,10582,5463,10757
ݼʢ,JingShengXiang,451228214,10316,2345,8099,4991,16024,8096,3803,8334,16430,8365,16464
,LaLieXiang,451228215,16164,3137,12668,8143,24797,12607,6387,12857,25464,13020,25688
,BaiWangXiang,451228216,14642,2782,11028,7364,21529,10974,5019,11323,22297,11415,22443
ӹ,JiaGuiXiang,451228217,8837,1834,7226,4682,13983,7093,3892,7272,14365,7337,14563
,LaRenXiang,451228218,10574,1954,8983,5883,16646,8982,5590,9132,18114,9135,18118
Ŷ,JiuDuXiang,451228219,8104,1513,6963,3996,12387,6860,4451,6896,13756,7105,14068
,DaHuaZhen,451229100,64681,7740,44804,26207,74058,42381,18825,43907,86288,46442,91246
,DouYangZhen,451229101,14846,2012,10236,6179,20418,10222,4432,10998,21220,11054,21290
̲,YanTanZhen,451229102,19956,2388,13835,7899,27019,13833,6052,14540,28373,14561,28396
,GongHeXiang,451229200,11936,1972,8390,4584,16743,8348,3547,8995,17343,9065,17455
,GongChuanXiang,451229201,7046,1409,5592,3597,10765,5571,2695,5522,11093,5558,11150
,BaiMaXiang,451229202,9424,1802,7396,4717,14369,7369,3429,7187,14556,7259,14655
ź,GuHeXiang,451229203,3316,741,2572,1696,4911,2524,1090,2502,5026,2575,5147
,GuWenXiang,451229204,5392,1395,4050,2824,7931,4000,1540,4190,8190,4277,8327
,JiangNanXiang,451229205,14603,2243,10835,6597,21085,10824,5158,11148,21972,11169,22004
Ǽ,QiangWeiXiang,451229206,10021,1401,7541,4378,14488,7533,3952,7817,15350,7833,15374
,YiWeiXiang,451229207,9917,1251,7155,3824,14043,7155,3275,7288,14443,7288,14443
,BeiJingXiang,451229208,17136,2165,12500,6050,24387,12396,5886,12521,24917,12687,25187
,BanShengXiang,451229210,14664,2274,11318,5649,20395,11284,6621,12158,23442,12241,23559
߰Ū,QiBaiNongXiang,451229211,9652,1375,7980,4412,13551,7974,5111,8139,16113,8158,16138
,YaLongXiang,451229213,15941,2591,11919,6778,23029,11874,5835,12346,24220,12448,24367
Ҳ,LiuYeXiang,451229214,14694,3004,10667,6637,21565,10548,4366,11191,21739,11397,22064
Զ,QingYuanZhen,451281100,119087,12034,75974,44538,120935,68973,24751,69904,138877,79898,155872
,SanChaZhen,451281101,9925,1802,6902,4088,13601,6894,2385,7194,14088,7210,14112
,LuoXiZhen,451281102,14196,2425,10495,6993,20392,10474,4754,10856,21330,10880,21375
Զ,HuaiYuanZhen,451281103,22989,2752,15043,8603,29331,15018,5522,16091,31109,16220,31263
ʤ,DeShengZhen,451281104,30038,3871,20484,12394,36801,20218,8804,21607,41825,22229,42713
ʯ,ShiBieZhen,451281105,19812,2345,13975,7995,27195,13967,6254,14425,28392,14436,28411
ɽ,BeiShanZhen,451281106,20353,2403,13951,8122,27745,13937,6286,15047,28984,15091,29042
鱴,XiangBeiXiang,451281200,8128,2005,6377,4746,12436,6355,2880,6608,12963,6636,13013
,LiuSanJieXiang,451281201,23898,3268,16390,9411,32469,16323,6642,17311,33634,17418,33808
,PingNanXiang,451281203,10898,2389,8747,5833,16416,8743,3815,8342,17085,8355,17102
嶫,LuoDongXiang,451281204,13025,2092,9090,5960,17704,9038,3603,9450,18488,9630,18720
,FuLongYaoZuXiang,451281207,22614,3190,15285,8322,31435,15220,6547,16945,32165,17066,32351
,BeiYaYaoZuXiang,451281208,35004,4379,24755,12971,49456,24598,12053,26508,51106,26681,51436
ͬ,TongDeXiang,451281210,12522,1613,8631,5052,17248,8624,3862,9270,17894,9366,17997
,AnMaXiang,451281211,10544,1951,7837,5543,15506,7836,3518,8169,16005,8176,16013
ͷ,LongTouXiang,451281213,24329,2946,16880,9373,32215,16820,8108,18403,35223,18503,35383
Ƕֵ´,ChengDongJieDaoBanShiChu,451302001,59289,4802,38009,17963,43116,31421,12318,32118,63539,38400,76409
Ǳֵ´,ChengBeiJieDaoBanShiChu,451302002,27982,1929,18247,10223,20006,17443,7956,18210,35653,19620,37867
ֵ´,HeXiJieDaoBanShiChu,451302003,45207,2615,28402,13831,24703,23772,11211,25949,49721,30631,59033
һֵ´,BaYiJieDaoBanShiChu,451302004,10771,1708,7011,5390,11695,6846,2276,7123,13969,7744,14755
,FengHuangZhen,451302101,48414,4988,33775,16853,65918,33692,16205,35646,69338,35832,69607
,LiangJiangZhen,451302102,31336,3599,21208,10940,40911,20797,9296,21979,42776,23023,44231
Сƽ,XiaoPingYangZhen,451302103,30953,4466,22592,12195,43937,22553,11220,23790,46343,24047,46639
Ǩ,QianJiangZhen,451302104,49262,5620,33284,18906,63589,33022,14329,34710,67732,35927,69211
ʯ,ShiLingZhen,451302105,22461,2600,15520,7882,30193,15512,6770,16290,31802,16311,31831
ƽ,PingYangZhen,451302106,32797,4695,22192,11888,43520,22164,8637,23581,45745,23937,46129
,SanWuXiang,451302201,29852,3989,21030,11088,42531,20871,10063,22457,43328,22874,43904
ɽ,WuShanXiang,451302202,14195,2532,10737,5926,20893,10734,5248,11230,21964,11238,21975
յ,TaoDengXiang,451302203,19828,3106,14647,8460,29366,14642,7327,15609,30251,15614,30261
Ź,QiaoGongXiang,451302204,23925,2612,16316,8167,31795,16253,7335,17438,33691,17556,33872
,LiangTangXiang,451302205,16125,2516,11784,7146,22501,11783,5571,12412,24195,12428,24212
߶,QiDongXiang,451302206,9019,1669,6665,3831,13335,6650,3242,7217,13867,7265,13930
,ChengXiangXiang,451302209,22440,2340,15001,7576,25987,14784,7188,16269,31053,16967,31968
ɴ,MengCunXiang,451302210,25167,3951,18252,9645,36054,18247,8907,19734,37981,19773,38025
ɽ,SiShanXiang,451302211,26909,4413,20184,10001,39302,20169,10609,21703,41872,21747,41931
ʯ,ShiYaXiang,451302212,21238,2979,16776,7969,31148,16758,9974,17377,34135,17415,34191
,NanSiXiang,451302213,19763,2404,14057,7492,27216,14052,6952,15058,29110,15062,29119
߰,GaoAnXiang,451302214,8624,1233,6177,3586,12181,6145,3128,6739,12884,6808,12985
,DaWanXiang,451302215,18753,2339,13496,7309,26501,13442,7053,14565,28007,14649,28145
,ZhengLongXiang,451302216,12063,1772,8842,4754,17916,8841,4889,9882,18723,9882,18724
ũ,HongHeNongChang,451302401,2926,350,1676,1308,2609,1589,597,1777,3366,2197,3873
Ͷ,LaiHuaTouZiQu,451302402,5547,539,3493,2055,5117,3261,1369,3185,6446,3962,7455
ǹ,ChengGuanZhen,451321100,56535,7091,38243,23649,68231,35760,13293,36884,72644,38676,76919
,DaTangZhen,451321101,20104,3637,14895,10143,28753,14812,6871,15548,30360,15717,30612
˼,SiLianZhen,451321102,25919,4265,18056,11622,36132,18021,7585,19642,37663,19713,37769
,HongDuZhen,451321103,21000,3542,14408,9299,28867,14383,5016,15097,29480,15150,29558
,GuPengZhen,451321104,19370,3337,13744,9356,26977,13744,5072,14025,27769,14035,27779
,MaSiXiang,451321201,11629,1651,7758,4758,15531,7749,2619,8122,15871,8141,15899
ŷ,OuDongXiang,451321202,9452,1352,6425,3995,12511,6412,2485,6824,13236,6864,13289
,AnDongXiang,451321203,8149,1447,5892,3859,11912,5890,2686,6374,12264,6390,12282
,GuoSuiXiang,451321204,14811,2551,10044,6404,20252,10037,3879,11184,21221,11197,21241
,XinWeiXiang,451321205,6283,1358,4739,3365,9064,4729,1783,4669,9398,4685,9424
,SuiYiXiang,451321206,12618,2813,9015,6331,18122,9011,3101,9510,18521,9517,18532
,BeiGengXiang,451321207,12232,3180,9645,7279,18457,9639,3725,9475,19114,9492,19137
,XiangZhouZhen,451322100,40110,4439,26447,15148,37039,23551,8666,24168,47719,26768,53215
ʯ,ShiLongZhen,451322101,15089,1767,10113,6295,19107,10048,4407,10875,20923,11150,21263
˽,YunJiangZhen,451322102,19416,3817,13760,8665,27950,13629,5863,15172,28801,15336,29096
´,SiCunZhen,451322103,26860,4644,18670,11350,36090,18195,7168,19663,37858,20002,38672
ƽ,ZhongPingZhen,451322104,16827,3430,12089,8352,23655,12042,4783,12870,24912,12951,25040
,LuoXiuZhen,451322105,15670,2806,10838,7326,21394,10784,4317,11861,22645,11955,22793
,DaLeZhen,451322106,14684,2990,10332,7101,20341,10290,3822,10980,21270,11164,21496
ƺ,MaPingXiang,451322200,17639,2542,12439,7490,25110,12426,6061,13734,26160,13803,26242
,MiaoHuangXiang,451322201,11626,2322,8163,5743,16483,8157,3333,9099,17256,9118,17281
,BaiZhangXiang,451322202,8930,1903,6502,4519,12674,6482,2601,6904,13386,6932,13434
ˮ,ShuiJingXiang,451322203,11230,1835,7859,4893,15622,7832,3605,8778,16610,8811,16670
,WuXuanZhen,451323100,56260,6041,37950,20400,55317,34112,15331,35597,69709,39682,77632
ͩ,TongLingZhen,451323101,28849,4605,20532,12922,42157,20391,10465,22653,43044,23387,43919
ͨ,TongWanZhen,451323102,19190,3440,14811,9223,29557,14725,7683,15344,30069,15502,30313
,DongXiangZhen,451323103,25251,4600,17593,11622,36629,17583,8424,20651,38234,20682,38275
,SanLiZhen,451323104,19087,3162,13435,9422,27288,13430,6275,15048,28478,15089,28524
,ErTangZhen,451323105,26485,3655,18187,11039,37356,18159,8764,20567,38726,20717,38904
,HuangMaoZhen,451323106,15326,2038,10358,6044,20640,10331,4430,11358,21689,11436,21794
»,LuXinXiang,451323201,21563,2918,16656,8298,32697,16639,9487,17281,33920,17312,33968
˼,SiLingXiang,451323202,12268,1907,9522,5194,18606,9518,5210,9847,19365,9863,19385
,JinJiXiang,451323204,10791,1508,7677,4550,15351,7621,3921,8403,16024,8543,16220
ǭũ,QianJiangNongChang,451323401,3107,465,2064,1576,3463,2051,747,2218,4269,2255,4319
,JinXiuZhen,451324100,13090,1472,8723,5179,14389,8114,3062,8240,16354,8901,17624
ͩľ,TongMuZhen,451324101,31876,5056,21448,12619,40681,21183,7898,22819,44002,23382,44830
ͷ,TouPaiZhen,451324102,10381,1869,7321,5101,13209,7268,2979,7726,14994,7908,15229
,SanJiaoXiang,451324200,3120,490,2116,1344,4179,2107,810,2259,4366,2304,4420
,ZhongLiangXiang,451324201,5158,1063,3808,2480,7550,3787,1685,4051,7838,4098,7906
,LuoXiangXiang,451324202,6179,1007,4186,3092,8662,4171,2024,4975,9146,5024,9210
,ChangDongXiang,451324203,3315,515,2294,1401,4474,2273,985,2444,4717,2521,4815
,DaZhangXiang,451324204,5857,1157,4113,2936,8102,4095,1655,4499,8594,4556,8669
,LiuXiangXiang,451324205,2743,518,1887,1286,3892,1879,859,2219,4098,2233,4120
,SanJiangXiang,451324207,4839,1146,3387,2415,6410,3360,1229,3606,6966,3827,7214
,LingNanZhen,451381100,53261,6196,32992,23266,59289,32297,10434,33664,65961,36899,69891
,BeiSiXiang,451381200,17075,2165,11624,7078,22753,11619,4268,11849,23468,11884,23508
,HeLiXiang,451381201,14763,1818,10375,6528,20132,10372,4516,10694,21066,10722,21097
̫ƽ,TaiPingZhen,451402100,76600,6215,44608,26744,63918,38490,13597,41925,80415,51804,96412
º,XinHeZhen,451402101,13388,1673,8633,5297,16591,8588,2933,9245,17833,9361,17994
,LaiTuanZhen,451402102,13795,1943,8965,5909,18351,8944,3761,10359,19303,10534,19499
,JiangZhouZhen,451402103,26155,3057,16105,10572,32257,16046,6352,19231,35277,19459,35564
,ZuoZhouZhen,451402104,22220,3013,14611,9350,29911,14600,5803,16382,30982,16425,31036
¡,NaLongZhen,451402105,19560,3353,12979,8531,26583,12901,5085,14880,27781,15019,27998
¬,TuoLuZhen,451402106,33055,5041,21765,14473,43425,21671,7928,24082,45753,24259,46024
ް,LuoBaiXiang,451402201,14869,1731,9459,5558,19810,9406,4334,11321,20727,11475,20934
,BanLiXiang,451402202,8222,943,5327,3276,10606,5172,2428,5983,11155,6266,11593
ºͻũ,XinHeHuaQiaoNongChang,451402400,2856,352,1764,1300,2734,1635,669,1827,3462,2113,3877
󽭻ũ,ZuoJiangHuaQiaoNongChang,451402401,4101,611,2726,2284,4801,2703,1095,3024,5727,3081,5807
,XinNingZhen,451421100,67329,6232,41590,24860,57740,36088,14278,38071,74159,46249,87839
,QuLiZhen,451421101,31239,4451,21264,14095,41944,21088,8592,22625,43713,23018,44282
,QuJiuZhen,451421102,16362,2228,11094,7308,22247,11092,4678,12160,23252,12174,23268
,LiuQiaoZhen,451421103,20034,2493,13077,7828,26496,12889,6063,15090,27979,15513,28590
,DongMenZhen,451421104,29152,3710,18510,11236,35538,18131,7883,21540,39671,22235,40745
ɽ,ShanWeiZhen,451421105,21999,2689,14754,9133,29037,14623,6936,16633,31256,16870,31624
ж,ZhongDongZhen,451421106,21841,3442,14694,9813,29710,14679,6146,16704,31383,16735,31429
,DongLuoZhen,451421107,19913,2631,13234,8836,26299,13165,5671,14736,27901,14981,28215
ͷ,LongTouXiang,451421201,14395,2862,9714,6715,20167,9670,3655,11055,20725,11198,20912
,BaPenXiang,451421202,15255,2499,10472,7182,21152,10387,4554,11647,22034,11836,22308
ƽ,ChangPingXiang,451421203,13795,2343,9379,6345,18978,9363,3768,10517,19880,10527,19906
,ChengZhongZhen,451422100,47767,4926,31241,19163,52362,30945,11759,32357,63302,33211,64452
,AiDianZhen,451422101,4938,571,3287,2199,6116,3267,1615,3804,7071,3837,7124
,MingJiangZhen,451422102,19731,2489,13191,8676,26083,13170,5149,14096,27266,14178,27369
Ԩ,HaiYuanZhen,451422103,23610,3064,16183,9821,31377,16145,7953,18358,34503,18444,34627
ͤ,TingLiangXiang,451422201,19644,2654,13237,7722,26722,13226,5977,15015,28241,15038,28275
կ,ZhaiAnXiang,451422202,12194,1612,8270,5231,16765,8251,3684,9177,17428,9220,17490
,ZhiLangXiang,451422203,11694,1657,8096,5060,15873,8086,3928,9151,17237,9183,17279
,DongAnXiang,451422204,9961,1287,6709,4552,13698,6708,2902,7433,14141,7441,14150
,BanGunXiang,451422205,11909,1564,8082,4373,16582,8047,3836,9176,17223,9227,17309
,BeiJiangXiang,451422206,12421,1564,8049,5120,16680,8046,3658,9521,17567,9594,17643
ͩ,TongMianXiang,451422207,23829,2776,16783,8640,33012,16781,8318,18123,34904,18140,34923
ǿ,NaKanXiang,451422208,19649,2993,13987,8756,27935,13948,7798,16424,30372,16453,30440
,NaNanXiang,451422209,13688,1637,9672,5354,19502,9638,5624,11194,20832,11277,20949
Ӫũ,GuoYingNingMingHuaQiaoNongChang,451422401,2272,552,1613,1309,2869,1586,528,1673,3259,1739,3352
Ӫũ,GuoYingTianXiHuaQiaoNongChang,451422402,1254,203,820,656,1354,808,294,915,1723,931,1751
,LongZhouZhen,451423100,51680,5895,33857,19937,47070,29625,8991,30018,59643,32709,66566
¶,XiaDongZhen,451423101,11512,2018,8022,5525,15724,8001,2967,8406,16407,8475,16497
ˮ,ShuiKouZhen,451423102,12782,1893,8579,6011,17059,8561,3103,9165,17726,9199,17778
,JinLongZhen,451423103,12200,2640,9340,6246,17912,9335,3525,9021,18356,9025,18365
ˮ,XiangShuiZhen,451423104,9240,1461,6138,3930,12055,6112,1951,6497,12609,6514,12652
˽,BaJiaoXiang,451423201,4420,971,3115,2376,6209,3112,1081,3352,6464,3357,6472
Ͻ,ShangJiangXiang,451423202,4552,979,3303,2462,6474,3289,1195,3395,6684,3423,6726
,BinQiaoXiang,451423203,11448,1581,7504,4937,14554,7455,2500,7957,15412,8025,15529
,ShangLongXiang,451423204,12345,1621,8042,4692,16046,8028,2491,8382,16410,8415,16457
,WuDeXiang,451423205,11219,1527,7472,4467,15063,7392,2734,7881,15273,8008,15480
,ZhuBuXiang,451423206,10449,1973,7176,4306,13968,7168,2052,7286,14454,7298,14474
Ͻ,ShangJinXiang,451423207,10731,1559,7015,4308,14148,6857,2482,7458,14315,7757,14772
ҳ,TaoChengZhen,451424100,48880,6291,32772,19528,52474,31255,11698,32505,63760,34097,66869
ȫ,QuanMingZhen,451424101,13662,2697,9745,5696,19517,9732,3643,10237,19969,10257,20002
ƽ,LeiPingZhen,451424102,30940,4697,20757,12431,40823,20699,6641,21427,42126,21521,42278
˶,ShuoLongZhen,451424103,7241,1306,5092,2953,9910,5044,1993,5326,10370,5448,10540
,XiaLeiZhen,451424104,16977,2456,11593,6692,21689,11438,4603,11923,23361,12443,24036
ɽ,WuShanXiang,451424200,9249,2288,7246,4341,13768,7235,2719,6999,14234,7010,14256
,LongMenXiang,451424201,8600,1739,6044,3716,12350,6022,2308,6581,12603,6603,12647
,ChangMingXiang,451424202,8828,1855,6606,3868,13206,6597,2940,6987,13584,7017,13623
¡,FuLongXiang,451424203,7644,1731,5708,3104,11170,5672,2223,5820,11492,5890,11598
,NaLingXiang,451424204,7839,1625,5611,3531,11185,5611,2048,5901,11512,5901,11512
,EnChengXiang,451424205,8818,1464,6022,3433,12018,6019,1835,6087,12106,6095,12117
,LanWeiXiang,451424206,17214,2852,11727,7171,23359,11717,4028,12350,24067,12367,24094
,BaoWeiXiang,451424207,9762,2101,7034,3965,13552,7031,2193,7008,14039,7022,14056
,KanWeiXiang,451424208,10589,1951,7388,3929,14478,7362,2262,7385,14747,7414,14802
Ӫҳǻũ,GuoYingTaoChengHuaQiaoNongChang,451424400,2739,468,1948,1231,3524,1927,918,2146,4073,2177,4125
,TianDengZhen,451425100,47230,6553,32647,18343,55307,31291,13643,32769,64060,34779,67426
,LongMingZhen,451425101,10981,2239,8142,5010,15977,8124,3444,8478,16602,8522,16664
,JinJieZhen,451425102,18000,3615,13038,8439,26548,13037,5703,14264,27301,14280,27318
,XiangDouZhen,451425103,23593,3971,18054,9655,34877,17990,9532,18931,36921,19042,37096
,DouKangXiang,451425200,15870,3197,11800,6439,23266,11777,5130,12359,24136,12397,24197
,NingGanXiang,451425201,11156,1628,8113,4487,16096,8083,4029,8665,16748,8700,16813
Կ,TuoKanXiang,451425202,18028,3281,13642,7603,26901,13621,6623,14272,27893,14290,27932
,FuXinXiang,451425203,16959,3466,12247,6640,24295,12172,4615,12590,24762,12793,25040
ƽ,DongPingXiang,451425204,13818,2019,9653,5504,19127,9613,4802,10706,20319,10986,20639
Զ,JinYuanXiang,451425205,5214,1405,4151,2563,8168,4149,1827,4287,8436,4295,8446
ӳ,ShangYingXiang,451425206,18757,3035,13913,7336,27581,13884,7109,14913,28797,14988,28901
Ѻ,BaHeXiang,451425207,12443,2008,9347,4995,18190,9341,4727,9821,19162,9831,19178
Сɽ,XiaoShanXiang,451425208,7409,1518,5454,3136,10810,5436,2237,5662,11098,5710,11164
ƾ,PingXiangZhen,451481100,47310,3448,28888,18290,37221,27146,10211,28381,55527,32081,60969
,YouYiZhen,451481101,14704,1217,8594,5653,13499,8395,3291,9940,18335,10618,19212
ʯ,ShangShiZhen,451481102,9947,1247,6242,4263,12784,6186,2724,7490,13676,7676,13918
ʯ,XiaShiZhen,451481103,12586,1813,8421,6448,15598,8291,3661,9304,17595,9639,18060
Ӣֵ´,XiuYingJieDaoBanShiChu,460105001,43863,2477,27216,15247,18470,21875,8863,23306,45181,27987,55203
ֵ,HaiXiuJieDaoBan,460105002,39372,3262,23095,14555,21755,20945,7842,21949,42894,27381,50476
,ChangLiuZhen,460105100,30267,2856,17984,8929,31817,17087,6439,18190,35277,21578,39562
,XiXiuZhen,460105101,26628,3151,17250,8452,32479,16399,6646,17389,33788,19175,36425
,HaiXiuZhen,460105102,30777,1011,15501,7931,8458,11089,5162,12667,23756,21449,36950
ʯɽ,ShiShanZhen,460105103,23455,2949,15811,8434,32243,15609,7245,17394,33003,17838,33649
,YongXingZhen,460105104,19971,2516,13001,7054,24539,12398,6069,13975,26373,15555,28556
ɽ,DongShanZhen,460105105,47875,5751,33227,14971,62442,33038,15094,34893,67931,35493,68720
ɽֵ´,ZhongShanJieDaoBanShiChu,460106001,21018,3204,14002,9572,18312,13242,3624,13199,26441,13844,27846
�ֵ´,BinHaiJieDaoBanShiChu,460106002,52874,5652,34201,20756,38231,32487,10519,32553,65040,34844,69045
óֵ´,JinMaoJieDaoBanShiChu,460106003,51182,3874,31537,19115,25492,27501,8475,26809,54310,31994,63531
ֵͬ´,DaTongJieDaoBanShiChu,460106004,56038,4202,35412,18246,30932,27001,9693,26418,53419,34521,69933
ѽֵ´,HaiKenJieDaoBanShiChu,460106005,72054,4674,44164,27246,32860,38369,15088,40456,78825,47652,91816
ֵ´,JinYuJieDaoBanShiChu,460106006,72422,3561,43986,28251,25934,39573,15369,41897,81470,47366,91352
,ChengXiZhen,460106100,62318,3239,37324,20478,26165,29662,12347,31444,61106,40580,77904
,LongQiaoZhen,460106101,10325,1834,7628,4520,14686,7553,3697,8042,15595,8228,15856
,XinPoZhen,460106102,20620,2745,14719,7415,29020,14673,6953,15503,30176,15599,30318
̷,ZunTanZhen,460106103,14397,2213,10385,5576,20851,10367,5310,11473,21840,11535,21920
Ȫ,LongQuanZhen,460106104,21607,3624,15746,10199,31502,15696,8266,17500,33196,17751,33497
˽ֵ,GuoXingJieDaoBan,460107001,51848,2462,30072,15471,14949,21131,7789,22407,43538,32027,62099
,FuChengZhen,460107100,187737,12176,113624,59486,99389,94586,40127,100425,195011,126416,240040
,LongTangZhen,460107101,19803,3384,14325,7834,27341,14105,6343,14763,28868,15205,29530
,YunLongZhen,460107102,11364,1967,7967,4429,14056,7811,3218,8348,16159,8582,16549
,HongQiZhen,460107103,14645,2380,10354,5675,19464,10216,4681,11135,21351,11352,21706
,SanMenPoZhen,460107104,14636,2312,10479,5774,18317,10399,4880,11227,21626,11349,21828
,DaPoZhen,460107105,6586,1310,4819,3071,8576,4808,2148,5209,10017,5225,10044
,JiaZiZhen,460107106,14503,2782,10494,6706,19217,10435,4988,11586,22021,11779,22273
,JiuZhouZhen,460107107,15230,2553,11003,6225,21492,10964,5460,12160,23124,12240,23243
Ӫũ,GuoYingHongMingNongChang,460107400,11770,2126,8230,4983,15121,8139,3159,8712,16851,8825,17055
Ӫũ,GuoYingDongChangNongChang,460107401,7151,1582,5086,3266,8523,4977,1984,5416,10393,5631,10717
ʡȴﳡ,ShengLingJiaoReDaiZuoWuChang,460107500,866,133,571,398,1015,565,225,638,1203,653,1224
ʡú,ShengZhangChangMeiKuang,460107501,2358,380,1710,1146,2886,1627,912,1792,3419,1940,3650
ֵ´,HaiFuJieDaoBanShiChu,460108001,63498,4701,41198,22820,33929,33664,11462,32497,66161,38463,79661
ֵ´,LanTianJieDaoBanShiChu,460108002,26980,1947,16542,10119,12260,14891,5480,15075,29966,17865,34407
ֵ´,BoAiJieDaoBanShiChu,460108003,33792,4355,22728,12707,25793,21309,6848,21076,42385,22267,44995
ֵ´,HaiDianJieDaoBanShiChu,460108004,40627,3490,25731,16341,18340,23633,7944,23866,47499,26330,52061
·ֵ´,RenMinLuJieDaoBanShiChu,460108005,66995,4355,40922,19544,31377,28580,10328,28963,57543,40756,81678
ֵ´,BaiLongJieDaoBanShiChu,460108006,50405,3152,26311,15343,25516,24714,9604,26102,50816,36850,63161
ƽϽֵ´,HePingNanJieDaoBanShiChu,460108007,23668,2974,15683,9375,18676,14461,4694,14608,29069,15653,31336
ɳֵ´,BaiShaJieDaoBanShiChu,460108008,27859,2806,17937,10984,17513,17291,5957,17604,34895,18685,36622
²ֵ´,XinBuJieDaoBanShiChu,460108009,10330,1129,6509,3837,9739,6304,2138,6448,12752,7088,13597
ɽ,LingShanZhen,460108101,56219,6409,35512,18293,59824,32117,12500,33243,65360,39616,75128
ݷ,YanFengZhen,460108102,13898,3090,10231,6965,16486,10031,3992,10366,20397,10749,20980
,SanJiangZhen,460108103,9345,1819,6683,4455,10509,6570,2983,7160,13730,7464,14147
,DaZhiPoZhen,460108104,17961,2929,12327,7525,18530,11937,5175,13107,25044,13738,26065
Ӫũ,GuoYingGuiLinYangNongChang,460108400,33303,1825,21790,5685,12582,8608,4093,8887,17495,17431,39221
Ӫũ,GuoYingSanJiangNongChang,460108401,6350,1607,4629,3665,8436,4551,1700,4852,9403,5028,9657
ţɽũ,LuoNiuShanNongChang,460108500,777,10,419,385,18,415,150,489,904,518,937
,HaiTangWanZhen,460201100,31859,2818,21457,9981,40062,21067,9941,21787,42854,23161,44618
,TianDuZhen,460201101,78331,2581,44015,13681,53709,25642,11404,28125,53767,48301,92316
,FengHuangZhen,460201102,50146,2778,31140,12284,51977,28188,13877,30077,58265,35661,66801
³,YaChengZhen,460201103,54154,5250,35937,17007,69591,35718,15375,38330,74048,38842,74779
,TianYaZhen,460201104,24234,1953,16581,6892,31818,16513,8587,18034,34547,18193,34774
,YuCaiZhen,460201105,12633,1102,8064,4100,16447,8040,3748,9375,17415,9419,17483
Ӫũ,GuoYingNanTianNongChang,460201400,16951,2155,11578,6490,19652,11310,5154,12204,23514,12682,24260
Ӫũ,GuoYingNanXinNongChang,460201401,13136,617,7204,4200,6538,6301,2886,7225,13526,9435,16639
Ӫũ,GuoYingLiCaiNongChang,460201403,11708,1134,7787,4952,12539,7724,3696,8574,16298,8751,16538
Ӫϱũ,GuoYingNanBinNongChang,460201404,10806,963,6724,3802,9912,6544,2967,7421,13965,8012,14736
ֵ,HeXiQuJieDaoBan,460201451,106557,5964,65796,32479,66017,54865,21429,55927,110792,68154,133950
Ӷֵ,HeDongQuJieDaoBan,460201452,120865,4910,66329,36656,56428,54465,22739,57529,111994,82185,148514
ɽ,ChongShanZhen,469001100,42159,2637,25446,13837,34933,20055,9250,22027,42082,28600,54046
ʥ,NanShengZhen,469001101,5813,539,3860,2349,7366,3777,1925,4278,8055,4417,8277
ë,MaoYangZhen,469001102,8991,952,5715,3892,11557,5683,2780,6905,12588,7008,12723
,FanYangZhen,469001103,5609,663,3731,2324,7462,3691,1956,4373,8064,4497,8228
,ChangHaoXiang,469001200,3667,366,2300,1572,4478,2267,1097,2716,4983,2830,5130
ë,MaoDaoXiang,469001201,3328,344,2181,1555,4525,2156,1130,2582,4738,2621,4802
ˮ,ShuiManXiang,469001202,2664,235,1794,1043,3554,1777,932,1992,3769,2037,3831
Ӫũ,GuoYingChangHaoNongChang,469001400,5557,528,3382,1903,4210,2427,997,2693,5120,3700,7082
λ,JiaJiZhen,469002100,124098,13833,77321,40915,112580,68961,27989,75187,144148,88599,165920
Ȫ,WanQuanZhen,469002101,18129,2946,12209,7233,24343,12094,5160,13851,25945,14026,26235
ʯ,ShiBiZhen,469002102,9944,1742,6991,3914,12864,6901,3016,7486,14387,7711,14702
ԭ,ZhongYuanZhen,469002103,18329,3982,13008,7997,22410,12533,4575,13281,25814,13878,26886
,BoAoZhen,469002104,19362,3560,12840,6833,22416,11982,4233,11836,23818,14315,27155
,YangJiangZhen,469002105,16146,3153,11193,7228,21005,11037,4493,12320,23357,12599,23792
,LongJiangZhen,469002106,12411,2535,8617,5799,16882,8547,3439,9642,18189,9768,18385
̶,TanMenZhen,469002107,22063,3274,14589,8025,27671,14096,5985,15877,29973,16733,31322
,TaYangZhen,469002108,17395,2971,11783,7489,22287,11638,4890,13035,24673,13473,25256
,ChangPoZhen,469002109,30635,5291,21204,12564,40522,20691,8400,22364,43055,23122,44326
·,DaLuZhen,469002110,17101,2750,11697,6955,22218,11488,5072,12904,24392,13226,24923
ɽ,HuiShanZhen,469002111,5600,482,3994,1651,7187,3873,2199,4061,7934,4287,8281
Ӫ̫ũ,GuoYingDongTaiNongChang,469002400,16226,3795,11792,9243,21144,11723,4839,12984,24707,13068,24860
Ӫũ,GuoYingDongHongNongChang,469002402,6570,1472,4621,3725,8244,4501,1676,4931,9432,5097,9718
Ӫũ,GuoYingDongShengNongChang,469002403,3919,730,2629,2328,4603,2614,894,2884,5498,2914,5543
ɽũ,BinCunShanHuaQiaoNongChang,469002500,4050,747,2821,2043,5334,2795,1116,2994,5789,3092,5913
Ǵ,NaDaZhen,469003100,162742,13985,97955,56129,131308,91488,43273,113625,205113,122045,220000
,HeQingZhen,469003101,14162,1760,9519,5206,17582,9448,4807,11002,20450,11210,20729
Ϸ,NanFengZhen,469003102,16626,1944,10958,6263,21714,10928,5099,12638,23566,12711,23669
,DaChengZhen,469003103,20157,2131,14414,6953,24732,14358,8248,16016,30374,16122,30536
,YaXingZhen,469003104,28365,3197,20603,9608,37651,20557,12141,22946,43503,23100,43703
,LanYangZhen,469003105,10508,1172,7185,3877,13661,7061,3776,8036,15097,8271,15456
,GuangCunZhen,469003106,18618,1920,13151,6172,26724,13145,7265,14628,27773,14652,27803
ľ,MuTangZhen,469003107,27794,3298,17458,11257,39134,17361,9281,22348,39709,22915,40373
ͷ,HaiTouZhen,469003108,22808,2653,16333,8809,31966,16284,9187,18222,34506,18315,34648
,EManZhen,469003109,11553,1496,7487,4974,16773,7480,4268,9818,17298,9830,17317
,SanDouZhen,469003110,14983,1711,10261,6180,21774,10186,6425,12467,22653,12858,23119
,WangWuZhen,469003111,16441,2172,11405,5965,22695,11387,5661,12836,24223,12869,24274
�,BaiMaJingZhen,469003112,39415,3800,28263,15059,54862,28196,16370,31205,59401,31322,59585
к,ZhongHeZhen,469003113,21514,2738,14625,8752,30771,14603,7394,16961,31564,17021,31646
,PaiPuZhen,469003114,11796,1245,8282,3912,16752,8257,4536,9170,17427,9295,17577
,DongChengZhen,469003115,33561,3544,22694,12642,45605,22560,12147,26230,48790,26558,49252
,XinZhouZhen,469003116,44800,4650,31867,15249,65110,31707,17866,35227,66934,35449,67316
Ӫũ,GuoYingXiPeiNongChang,469003400,26177,3778,17825,12599,31908,17773,8283,20272,38045,20413,38238
Ӫũ,GuoYingXiLianNongChang,469003404,25023,3629,16512,12869,30887,16451,8000,19993,36444,20140,36652
Ӫũ,GuoYingLanYangNongChang,469003405,5824,724,3769,2868,6123,3720,1707,4349,8069,4486,8255
Ӫһũ,GuoYingBaYiNongChang,469003407,23621,3246,15209,10691,24483,14224,5857,16161,30385,17515,32724
־ÿ,YangPuJingJiKaiFaQu,469003499,40615,2311,23016,13403,41677,21902,10712,24746,46648,30622,53638
ѧԺ,HuaNanReZuoXueYuan,469003500,12356,1164,7090,4550,9530,5645,2326,5764,11409,8756,15846
ĳ,WenChengZhen,469005100,106721,15656,71615,39655,101538,60542,21382,62601,123143,72144,143759
,ZhongXingZhen,469005101,18239,3981,12888,8480,24519,12721,4754,13856,26577,14086,26974
,PengLaiZhen,469005102,9962,2141,7045,4524,12888,6980,2997,7898,14878,8055,15100
,HuiWenZhen,469005103,21044,4512,14795,9175,24636,14263,5088,15011,29274,15849,30644
·,DongLuZhen,469005104,14306,2586,10135,5549,16692,10070,3982,10606,20676,10739,20874
̶ţ,TanNiuZhen,469005105,22452,4591,15641,10529,27425,15387,5720,16636,32023,17122,32763
,DongGeZhen,469005106,13153,3510,9952,6253,17306,9832,3730,10280,20112,10441,20393
Ľ,WenJiaoZhen,469005107,12532,3060,9310,5970,16110,9025,3473,9415,18440,9755,19065
,DongJiaoZhen,469005108,27318,5532,19865,11920,37074,19737,7000,19842,39579,19985,39850
¥,LongLouZhen,469005109,14328,2421,10071,5701,19198,9961,3678,10146,20107,10356,20427
,ChangSaZhen,469005110,10515,2397,7706,4480,12990,7350,3068,7747,15097,8274,15980
,WengTianZhen,469005111,18152,3838,13159,8486,25194,12852,5579,13980,26832,14410,27569
,BaoLuoZhen,469005112,8369,2048,6241,3968,11778,6161,2476,6518,12679,6652,12893
,FengPoZhen,469005113,7598,1756,5605,3621,9461,5410,2393,5810,11220,6142,11747
ɽ,JinShanZhen,469005114,23333,5282,17176,10871,30536,16934,6485,17562,34496,17924,35100
ǰ,PuQianZhen,469005115,23145,4682,16506,11335,31873,16407,6200,17282,33689,17521,34027
,GongPoZhen,469005116,6299,1720,4863,3162,8168,4758,1887,4874,9632,5043,9906
Ӫ·ũ,GuoYingDongLuNongChang,469005400,2946,618,1935,1804,3422,1914,606,2197,4111,2235,4170
Ӫũ,GuoYingNanYangNongChang,469005401,3117,638,2050,1957,3624,2039,578,2266,4305,2283,4333
Ӫ޶ũ,GuoYingLuoDouNongChang,469005402,7221,2469,5888,4097,9922,5842,2162,5884,11726,5964,11852
,WanChengZhen,469006100,104075,10582,64536,38522,119836,62584,25358,72022,134606,75479,140015
,LongGunZhen,469006101,15046,3080,10792,6459,19611,10484,3949,10937,21421,11283,22075
,HeLeZhen,469006102,40790,4705,27049,15297,54643,26854,11670,29742,56596,30116,57165
,HouAnZhen,469006103,30608,3822,20905,12058,42247,20901,9415,22922,43823,22940,43845
ï,DaMaoZhen,469006104,17610,1973,11642,6700,22085,11495,5726,13396,24891,13667,25309
,DongAoZhen,469006105,26358,3154,15741,10489,33466,15501,6889,19015,34516,20660,36401
,LiJiZhen,469006106,28080,2702,17783,9933,35466,17257,8137,19870,37127,21136,38919
,ChangFengZhen,469006107,21928,2274,13984,8584,26912,13238,6046,15349,28587,16264,30248
ɽ,ShanGenZhen,469006108,8129,1079,5632,3004,11102,5568,2483,5937,11505,6059,11691
,BeiDaZhen,469006109,13701,1476,9479,5455,18463,9284,4679,10214,19498,10377,19856
,NanQiaoZhen,469006110,7659,732,4715,2839,9795,4651,2191,5742,10393,5867,10582
,SanGengLuoZhen,469006111,6891,698,4497,2525,8951,4493,2312,5371,9864,5404,9901
Ӫũ,GuoYingDongXingNongChang,469006400,14910,3075,10344,7276,19316,10064,3895,11214,21278,11536,21880
Ӫũ,GuoYingDongHeNongChang,469006401,9023,1568,6065,4223,10940,5996,2452,6831,12827,6978,13043
Ӫũ,GuoYingXinZhongNongChang,469006404,19767,3035,12877,9384,23411,12348,4840,14153,26501,14765,27642
¡ũ,XingLongHuaQiaoNongChang,469006500,27225,3510,17307,13007,24302,16264,5835,16927,33191,19263,36570
طӪֳ,DiFangGuoYingLiuLianLinChang,469006501,317,56,204,184,263,203,82,244,447,251,455
,BaSuoZhen,469007100,120170,11338,78936,44026,139283,75946,36128,83985,159931,88700,167636
,DongHeZhen,469007101,15290,1532,10301,5487,20223,10256,4910,11316,21572,11431,21732
,DaTianZhen,469007102,18882,1620,12741,6373,24234,12639,6241,13801,26440,14002,26743
г,GanChengZhen,469007103,30679,2808,21622,10330,44358,21558,11878,23576,45134,23743,45365
,BanQiaoZhen,469007104,22381,2129,15611,7454,31690,15534,8203,16922,32456,17102,32713
,SanJiaZhen,469007105,19089,2203,13269,7662,27072,13267,6656,14671,27938,14679,27948
ĸ,SiGengZhen,469007106,19103,2328,12395,8159,26085,12383,5521,14555,26938,14557,26952
,XinLongZhen,469007107,11815,1267,8264,4325,16345,8251,3965,8718,16969,8783,17047
찲,TianAnXiang,469007200,8510,841,5667,3171,11554,5664,2786,6460,12124,6470,12137
,JiangBianXiang,469007201,4294,414,2920,1488,6061,2912,1526,3304,6216,3314,6234
Ӫũ,GuoYingGuangBaNongChang,469007400,11741,801,7163,5262,12777,7139,3235,8539,15678,8614,15777
ũ,DongFangHuaQiaoNongChang,469007500,5403,482,3822,2239,7031,3805,2140,4174,7979,4203,8025
,DingChengZhen,469021100,63336,7756,39535,23769,71101,37615,15275,42339,79954,46832,86367
,XinZhuZhen,469021101,10520,1786,7461,4852,13788,7379,3557,8254,15633,8402,15863
,LongHuZhen,469021102,11890,2115,8266,5434,16171,8218,3596,9200,17418,9335,17601
,HuangZhuZhen,469021103,7028,1133,4877,3203,8180,4864,2156,5410,10274,5440,10317
,LeiMingZhen,469021104,17500,2809,11902,8023,23724,11577,4891,12982,24559,13298,25200
,LongMenZhen,469021105,13140,2120,9296,6119,16937,9272,4554,10450,19722,10518,19814
,LongHeZhen,469021106,17606,2617,12319,6360,24368,12262,5975,13754,26016,13879,26198
,LingKouZhen,469021107,13982,2146,10036,6152,19237,10009,5165,11171,21180,11257,21293
,HanLinZhen,469021108,9929,1242,6993,4037,13228,6967,3521,7658,14625,7699,14692
,FuWenZhen,469021109,9179,1696,6480,4567,12356,6385,2966,7143,13528,7361,13841
Ӫũ,GuoYingZhongRuiNongChang,469021400,6205,1179,4172,3092,8169,4086,1586,4705,8791,4798,8970
ӪϺũ,GuoYingNanHaiNongChang,469021401,13587,2405,9183,7473,17545,9152,3177,9894,19046,9986,19169
Ӫũ,GuoYingJinJiLingNongChang,469021402,4196,410,2367,2240,4887,2348,683,2861,5209,2922,5289
ͳ,TunChengZhen,469022100,62213,6294,40716,23064,72395,39407,17967,43969,83376,45758,86474
,XinXingZhen,469022101,14054,2255,10508,6388,20255,10409,5593,11157,21566,11394,21902
ľ,FengMuZhen,469022102,9281,1017,6259,3719,12401,6148,3154,6953,13101,7193,13452
,WuPoZhen,469022103,11267,1581,8078,4902,15520,8047,4119,8830,16877,8889,16967
,NanLvZhen,469022104,16365,2201,11770,6778,23470,11633,6140,12677,24310,12936,24706
,NanKunZhen,469022105,19587,2669,13958,7989,26730,13719,7591,15453,29172,15889,29847
,PoXinZhen,469022106,6777,996,4810,2919,9210,4745,2501,5330,10075,5464,10274
,XiChangZhen,469022107,4827,841,3634,2030,6830,3557,1916,3782,7339,3950,7584
Ӫнũ,GuoYingZhongJianNongChang,469022400,14015,2435,9820,7066,18227,9803,4381,10899,20702,11011,20831
Ӫũ,GuoYingZhongKunNongChang,469022401,17572,2216,11574,8006,21330,11530,5106,13169,24699,13320,24894
,JinJiangZhen,469023100,99998,14080,64208,42927,123119,62920,28870,76353,139273,78740,142948
ϳ,LaoChengZhen,469023101,44951,4565,24740,14726,42695,22193,9640,26176,48369,34416,59156
Ϫ,RuiXiZhen,469023102,16920,3343,12199,7661,23968,12177,6096,14133,26310,14160,26359
,YongFaZhen,469023103,22289,3618,15726,10334,30301,15586,8367,18284,33870,18548,34274
,JiaLeZhen,469023104,12278,2224,9174,5338,18170,9169,5514,10819,19988,10842,20016
,WenRuZhen,469023105,14379,2680,10838,6671,21709,10824,6334,12524,23348,12555,23393
,ZhongXingZhen,469023106,12607,2310,8766,6483,17334,8751,4926,11040,19791,11077,19843
,RenXingZhen,469023107,5103,726,3635,2303,6361,3616,2077,4201,7817,4271,7906
ɽ,FuShanZhen,469023108,12011,1316,7781,4194,12750,7597,3681,8842,16439,9227,17008
ͷ,QiaoTouZhen,469023109,12879,1651,8912,5206,17949,8884,4641,10171,19055,10259,19171
,DaFengZhen,469023110,9583,1197,6096,3853,12383,6012,2690,7105,13117,7374,13470
Ӫũ,GuoYingHongGuangNongChang,469023400,14928,2049,9576,7405,16964,9549,4010,11289,20838,11411,20987
Ӫũ,GuoYingXiDaNongChang,469023402,36134,5485,24078,18555,45421,24008,11503,28904,52912,29044,53122
Ӫũ,GuoYingJinAnNongChang,469023405,5949,1058,4450,2798,8133,4441,2501,5049,9490,5058,9508
ٳ,LinChengZhen,469024100,77490,8544,52829,27240,98370,49831,26606,55884,105715,59811,112640
,BoLianZhen,469024101,17408,2546,12603,7194,24865,12575,6758,14015,26590,14109,26712
Ӣ,DongYingZhen,469024102,14776,2050,10661,5807,22199,10575,5978,11996,22571,12143,22804
,BoHouZhen,469024103,22753,3271,15781,9579,32709,15668,8463,18066,33734,18706,34487
ͩ,HuangTongZhen,469024104,13016,1717,9067,5328,17422,8928,5020,10381,19309,10686,19753
,DuoWenZhen,469024105,12950,1889,9035,5499,17794,9019,4894,10648,19667,10698,19733
,HeSheZhen,469024106,15523,2109,10752,6329,21616,10714,5734,12507,23221,12614,23366
ϱ,NanBaoZhen,469024107,8453,1439,6011,3971,11995,5968,3265,7095,13063,7146,13157
ӯ,XinYingZhen,469024108,34685,3766,24939,11576,49136,24827,13565,26936,51763,27077,52016
¥,DiaoLouZhen,469024109,31958,3514,23246,11802,47337,23101,13520,25443,48544,25746,48992
Ӫ컪ũ,GuoYingHongHuaNongChang,469024400,16443,2596,11281,7918,22354,11156,5729,13309,24465,13487,24768
Ӫũ,GuoYingJiaLaiNongChang,469024401,18779,3335,13766,8395,26151,13290,7331,15076,28366,15679,29445
,YaChaZhen,469025100,27810,2426,17350,11792,31375,16548,7610,19434,35982,20496,37846
߷,QiFangZhen,469025101,15270,1295,10396,5842,19841,10293,5850,11865,22158,12019,22415
Ϫ,BangXiZhen,469025102,7922,723,4969,2676,8816,4803,2465,5579,10382,6141,11110
,DaAnZhen,469025103,8829,940,6275,3656,11618,6254,3805,7203,13457,7299,13574
ϸˮ,XiShuiXiang,469025200,3670,338,2378,1495,4905,2372,1360,2973,5345,2990,5368
Ԫ,YuanMenXiang,469025201,4583,502,2861,2194,5721,2849,1299,3501,6350,3523,6384
Ͽ,NanKaiXiang,469025202,3118,324,2029,1158,4241,2028,1141,2535,4563,2554,4583
,FuLongXiang,469025203,3222,319,2253,1237,4222,2235,1385,2635,4870,2673,4926
,QingSongXiang,469025204,5678,575,3702,2180,7520,3698,2024,4566,8264,4575,8277
,JinBoXiang,469025205,2765,269,1858,1099,3684,1857,981,2151,4008,2157,4015
ٰ,RongBangXiang,469025206,4107,469,2836,1508,5388,2826,1458,3186,6012,3198,6034
Ӫɳũ,GuoYingBaiShaNongChang,469025401,5646,513,3522,2532,4830,3456,1457,3931,7387,4094,7616
Ӫũ,GuoYingLongJiangNongChang,469025404,17808,2255,11706,8856,21801,11643,5310,13496,25139,13667,25373
ӪϪũ,GuoYingBangXiNongChang,469025408,7593,817,4739,3631,8648,4713,1987,5519,10232,5658,10397
ʯµ,ShiLuZhen,469026100,44615,3588,28624,15012,43363,27256,13055,30141,57397,32634,61258
,ChaHeZhen,469026101,8619,947,5303,3426,10498,5195,2399,6215,11410,6662,11965
ʮ,ShiYueTianZhen,469026102,14345,1524,9562,4710,18607,8817,4515,9997,18814,10822,20384
,WuLieZhen,469026103,16556,2306,11147,6823,22762,10975,5342,12670,23645,13057,24204
,ChangHuaZhen,469026104,14718,2251,9665,6305,20129,9522,4042,11105,20627,11346,21011
β,HaiWeiZhen,469026105,17666,2019,11980,6386,23426,11790,5883,12677,24467,13588,25568
߲,QiChaZhen,469026106,10906,956,6748,3662,14264,6660,3075,8019,14679,8189,14937
,WangXiaXiang,469026200,2255,184,1314,695,2883,1308,503,1559,2867,1628,2942
Ӫũ,GuoYingHongLinNongChang,469026401,8825,831,5524,3476,7539,5168,2313,5924,11092,6445,11969
Ӫֳ,GuoYingBaWangLingLinChang,469026500,1255,249,852,588,1335,803,314,880,1683,966,1818
Ͽҵ޹˾,HaiNanKuangYeLianHeYouXianGongSi,469026501,19423,3438,13327,9119,20331,13097,4922,13836,26933,14456,27783
,BaoYouZhen,469027100,43297,3826,26938,14583,49291,25139,10888,28973,54112,31073,58011
,WanChongZhen,469027101,17070,2007,11146,6036,22590,11145,5004,12932,24077,12935,24081
,DaAnZhen,469027102,17807,2371,11973,6424,24003,11955,5061,13128,25083,13266,25239
־,ZhiZhongZhen,469027103,18157,1777,11774,5274,24109,11752,4825,12975,24727,12985,24759
ǧ,QianJiaZhen,469027104,18950,1787,12380,6193,25287,11974,5982,13738,25712,14339,26719
,JiuSuoZhen,469027105,52831,4950,34730,18359,70950,34697,16360,38192,72889,39411,74141
,LiGuoZhen,469027106,32273,3009,21299,11517,44105,21204,10084,23986,45190,24067,45366
,HuangLiuZhen,469027107,41179,4236,28490,14158,56991,28109,13213,29806,57915,30138,58628
,FoLuoZhen,469027108,22871,2434,16538,7869,32997,16479,8539,17220,33699,17306,33844
,JianFengZhen,469027109,15323,1241,10575,5102,21450,10575,5470,11459,22034,11459,22034
ݺ躣,YingGeHaiZhen,469027110,12394,1578,8708,4519,16414,8684,3842,9077,17761,9106,17814
Ӫɽũ,GuoYingShanRongNongChang,469027401,6900,557,4414,2860,6945,4397,1874,4877,9274,4917,9331
Ӫֹũ,GuoYingLeGuangNongChang,469027402,10827,701,6742,4450,10376,6709,3107,7775,14484,7893,14635
Ӫũ,GuoYingBaoGuoNongChang,469027405,11300,891,6865,4544,12446,6849,2682,7973,14822,8008,14873
Ӫҵ˾,GuoYingJianFengLingLinYeGongSi,469027500,3644,1015,2774,1681,4871,2665,1187,2824,5489,3072,5846
Ӫݺ躣γ,GuoYingYingGeHaiYanChang,469027501,2437,506,1739,1290,2995,1737,611,1808,3545,1815,3554
Ҭ,YeLinZhen,469028100,66345,7292,43449,19732,83432,42670,17078,46471,89141,47266,90715
,GuangPoZhen,469028101,15879,1731,10479,4779,21151,10391,4846,11514,21905,11977,22456
,SanCaiZhen,469028102,8943,981,5789,2619,11432,5763,2181,6284,12047,6316,12105
Ӣ,YingZhouZhen,469028103,29623,2424,19193,8985,36045,18454,8878,20287,38741,21732,40925
¡,LongGuangZhen,469028104,13929,1287,8852,4517,17789,8799,4024,10307,19106,10388,19240
,WenLuoZhen,469028105,9685,1071,6203,3369,12933,6194,2725,7266,13460,7278,13481
,BenHaoZhen,469028106,21470,1910,13131,7048,27366,13058,5915,16036,29094,16164,29295
´,XinCunZhen,469028107,19372,1928,12788,6131,24875,12737,5274,13702,26439,13786,26574
谲,LiAnZhen,469028108,11397,935,7634,3754,15649,7626,3925,8602,16228,8623,16257
,TiMengXiang,469028200,11521,1332,7358,3950,14937,7345,3301,8727,16072,8796,16154
ȺӢ,QunYingXiang,469028201,4535,350,2631,1647,5616,2631,1269,3519,6150,3523,6154
Ӫũ,GuoYingLingMenNongChang,469028400,9523,839,6097,3665,11538,6043,2512,6683,12726,6777,12874
Ӫƽũ,GuoYingNanPingNongChang,469028401,8796,1287,5995,3768,10797,5931,2449,6428,12359,6537,12532
Ӫɽҵ˾,GuoYingDiaoLuoShanLinYeGongSi,469028500,1101,258,798,511,1417,796,347,865,1661,908,1706
,BaoChengZhen,469029100,25952,1733,15255,8661,24478,13534,5453,15190,28724,17883,33138
ʲ,ShenLingZhen,469029101,9727,883,6084,3500,12082,6068,2674,7156,13224,7200,13284
ï,JiaMaoZhen,469029102,6322,664,4004,2661,7915,3993,1856,4805,8798,4838,8842
ˮ,XiangShuiZhen,469029103,8702,867,5531,3182,10910,5520,2346,6348,11868,6384,11915
,XinZhengZhen,469029104,9867,795,6041,3280,11870,5994,2520,7011,13005,7141,13182
,SanDaoZhen,469029105,7940,641,4680,2926,8359,4283,1777,5029,9312,5678,10358
,LiuGongXiang,469029200,4550,348,2925,1513,5973,2903,1501,3435,6338,3474,6399
,NanLinXiang,469029201,3413,365,2013,1219,4293,2006,841,2585,4591,2606,4619
ë,MaoGanXiang,469029202,2477,202,1529,948,3178,1505,733,1827,3332,1883,3412
Ӫũ,GuoYingXinXingNongChang,469029401,9427,1344,6176,4339,9805,5943,2387,6677,12620,6982,13158
Ӫũ,GuoYingJinJiangNongChang,469029403,14813,2658,10123,7649,17033,9938,4261,11178,21116,11609,21732
Ӫũ,GuoYingSanDaoNongChang,469029405,4781,574,3149,2059,4549,3079,1290,3389,6468,3496,6645
Ӫ,YingGenZhen,469030100,30694,2630,19747,11198,34794,18841,8511,21212,40053,22088,41835
,WanLingZhen,469030101,13282,1405,8901,5129,17741,8860,4521,10122,18982,10307,19208
ĸɽ,LiMuShanZhen,469030102,11636,1185,7807,4036,15354,7796,3824,8781,16577,8838,16645
ƽ,HePingZhen,469030103,5981,506,3929,1996,7982,3922,1965,4495,8417,4523,8452
,ChangZhengZhen,469030104,4910,522,3090,1754,6498,3055,1534,3813,6868,3876,6966
ë,HongMaoZhen,469030105,6003,513,3498,2030,7882,3473,1637,4584,8057,4655,8153
ƽ,ZhongPingZhen,469030106,5457,583,3581,2092,7265,3576,1758,4190,7766,4217,7798
ɽ,DiaoLuoShanXiang,469030200,4094,356,2508,1418,5334,2504,1215,3136,5640,3157,5665
ϰ,ShangAnXiang,469030201,4316,412,2671,1590,5714,2645,1385,3333,5978,3442,6113
ʲ,ShenYunXiang,469030202,3618,319,2146,1371,4626,2131,963,2679,4810,2754,4900
Ӫũ,GuoYingYangJiangNongChang,469030402,13736,2089,9249,6916,14958,8967,3759,9912,18879,10335,19584
Ӫʯũ,GuoYingWuShiNongChang,469030403,10158,1737,6323,5877,11605,6251,2392,7673,13924,7964,14287
Ӫũ,GuoYingJiaChaiNongChang,469030406,4474,541,2795,2208,4750,2721,1012,3079,5800,3232,6027
Ӫũ,GuoYingZhangZhengNongChang,469030407,5897,488,3539,2846,5861,3524,1386,4150,7674,4232,7771
Ӫĸɽҵ˾,GuoYingLiMuShanLinYeGongSi,469030500,515,72,293,206,453,242,85,284,526,379,672
˵,YongXingDao,469031451,440,2,54,45,135,38,2,93,131,390,444
,YongShuJiao,469032451,0,0,0,0,0,0,0,0,0,0,0
ɳ,ZhongShaDaoJiao,469033451,0,0,0,0,0,0,0,0,0,0,0
ֵ,GaoSunTangJieDao,500101001,82381,10474,52794,34037,72005,49001,11127,46719,95720,51188,103982
̫׽ֵ,TaiBaiJieDao,500101017,85285,10972,51796,33516,83636,50465,12130,49735,100200,56591,108387
¥ֵ,PaiLouJieDao,500101018,83629,7596,52214,31057,62959,45956,13126,44337,90293,52137,104351
˫ӿڽֵ,ShuangHeKouJieDao,500101019,27133,3026,17497,10490,22927,13850,3556,13342,27192,16218,33715
ֵ,LongDouJieDao,500101020,30243,2781,16427,8710,20440,11997,3110,12030,24027,19707,36134
ܼҰӽֵ,ZhouJiaBaJieDao,500101021,67016,7362,45185,28973,62501,43348,14116,41700,85048,43309,88494
ɳӽֵ,ShaHeJieDao,500101022,20158,1826,12644,7231,15070,9940,2931,9788,19728,12271,24915
ӹ¥ֵ,ZhongGuLouJieDao,500101023,66095,8960,43903,29047,63626,42282,10818,40052,82334,41970,85873
ٰӽֵ,BaiAnBaJieDao,500101024,73108,6481,49710,24367,58844,36518,12358,35130,71648,42237,91947
Žֵ,WuQiaoJieDao,500101025,15609,2161,10507,7257,17608,10261,2902,9923,20184,10165,20672
¼Ұӽֵ,ChenJiaBaJieDao,500101026,18544,3022,12696,9214,23841,12598,3179,11781,24379,12049,24745
С,XiaoZhouZhen,500101109,6749,1124,4503,3096,8881,4466,1263,4526,8992,4633,9136
,DaZhouZhen,500101110,9515,1077,5902,4364,11951,5820,1592,6068,11888,6282,12184
,XinXiangZhen,500101123,4194,1087,3409,2711,6336,3407,1402,3273,6680,3274,6683
,SunJiaZhen,500101132,6183,1365,4882,4064,9482,4832,2189,4751,9583,4855,9737
߷,GaoFengZhen,500101134,14702,2655,9815,7137,17764,9494,2193,9048,18542,9735,19550
ɳ,LongShaZhen,500101135,19762,4080,14249,10350,26823,14189,4285,13748,27937,13878,28127
ˮ,XiangShuiZhen,500101136,11326,2868,8508,6483,16556,8507,2695,8361,16868,8381,16889
,WuLingZhen,500101137,16239,3774,12675,9469,23237,12281,4619,11644,23925,11957,24632
,RangDuZhen,500101138,8832,1458,5687,4432,11549,5676,1323,5897,11573,5926,11613
,GanNingZhen,500101139,20901,5520,15880,12912,29996,15858,4452,14869,30727,14993,30873
,TianChengZhen,500101140,32948,4015,22681,12416,34316,17298,4799,17498,34796,19081,41762
ܼ,XiongJiaZhen,500101141,24865,4043,16000,11663,32691,15717,4268,16828,32545,17176,33176
,GaoLiangZhen,500101142,37746,5139,24312,17174,48041,24240,6472,24856,49096,25045,49357
,LiHeZhen,500101143,15635,3691,11926,9408,22280,11916,3938,11318,23234,11338,23264
ˮ,FenShuiZhen,500101144,39034,9244,30528,23866,59006,29873,12030,29119,58992,29780,60308
,YuJiaZhen,500101145,18318,5358,15159,12990,29662,14785,6778,14858,29643,15295,30454
ɽ,HouShanZhen,500101146,9346,2617,7598,6098,14924,7506,3375,7552,15058,7740,15338
,DanZiZhen,500101147,12298,2460,8744,5945,18008,8640,3560,9371,18011,9574,18318
,ChangLingZhen,500101148,26133,4378,17162,12363,34242,17038,4451,17579,34617,17800,34962
,XinTianZhen,500101149,24896,4392,17038,12173,31627,15960,4857,16007,31967,17107,34145
,BaiYangZhen,500101150,26064,5504,18768,13410,36008,18714,6510,19086,37800,19310,38078
,LongJuZhen,500101151,19752,4985,15955,11610,30589,15519,7245,15502,31021,16027,31982
,ZouMaZhen,500101152,15662,4408,12858,9709,25749,12426,5947,12723,25149,13159,26017
,LuoTianZhen,500101153,19081,3113,13528,8421,26798,13527,5475,14140,27667,14141,27669
̫,TaiLongZhen,500101154,9197,2812,7083,6293,13691,7078,2139,7053,14131,7065,14148
̲,ChangTanZhen,500101155,10713,3173,9009,7036,17221,8924,4018,8696,17620,8895,17904
̫,TaiAnZhen,500101156,12282,3343,9852,7383,19094,9852,3958,9727,19579,9731,19583
,BaiTuZhen,500101157,10320,1978,8130,5905,16226,8122,4492,8595,16717,8660,16790
,GuoCunZhen,500101158,15284,2740,10274,6596,20530,10247,3302,10989,21236,11052,21326
ɽ,ZhuShanXiang,500101201,12508,1989,7784,5316,16141,7784,1834,8547,16331,8547,16331
ر,DiBaoTuJiaZuXiang,500101202,3420,626,2631,1804,5279,2621,1456,2838,5459,2871,5502
,TieFengXiang,500101212,5067,1167,3931,3066,7779,3926,1700,3976,7902,4003,7934
Ϫ,XiKouXiang,500101225,3674,1047,2894,2411,5447,2843,974,2714,5557,2801,5695
ƺ,ChangPingXiang,500101226,5772,1113,4238,2843,8383,4238,1695,4336,8574,4342,8580
ɽ,YanShanXiang,500101227,7090,1215,4839,3268,9758,4811,1540,4969,9780,5006,9845
,LiShuXiang,500101234,4148,752,2845,1794,5797,2839,1216,3260,6099,3271,6116
,PuZiXiang,500101237,4900,1294,4025,3099,8120,4020,2101,4248,8268,4270,8295
,HengHeTuJiaZuXiang,500101239,7728,2321,6748,5354,13134,6683,3557,6729,13412,6858,13606
ư,HuangBoXiang,500101244,7984,1569,5295,3818,10774,5295,1396,5654,10949,5654,10949
ų,JiuChiXiang,500101245,14139,1881,8605,5056,14620,7193,1685,7030,14223,9100,17705
,CiZhuXiang,500101247,3292,992,2581,2176,5164,2574,988,2683,5257,2691,5272
ʽֵ´,DunRenJieDaoBanShiChu,500102006,79642,10739,53084,23826,76851,34746,14915,33032,67778,52212,105296
ֵ´,ChongYiJieDaoBanShiChu,500102007,59136,5962,37157,22503,42632,32906,10648,31993,64899,38589,75746
ֵ֦´,LiZhiJieDaoBanShiChu,500102008,118241,13601,78938,49456,91357,74176,24911,71815,145991,77815,156753
ֵ´,JiangBeiJieDaoBanShiChu,500102009,25242,4891,18400,11544,35389,18340,6405,17924,36264,18138,36538
ֵ´,JiangDongJieDaoBanShiChu,500102010,38122,5416,25551,14797,43836,21330,7540,21692,43022,25527,51078
ɽֵ´,LiDuJieDaoBanShiChu,500102011,65154,10846,45435,28656,76121,37333,12124,37693,75026,42689,88124
Žֵ´,LongQiaoJieDaoBanShiChu,500102012,24676,4648,16948,10423,32173,15776,5217,16023,31799,17593,34541
νֵ´,BaiTaoJieDaoBanShiChu,500102013,31889,6066,22285,14547,43102,21547,8205,22572,44119,23875,46160
,NanDuoZhen,500102103,18032,3689,13118,7776,25302,12787,4726,12651,25438,13329,26447
,QingYangZhen,500102107,10720,2826,7903,5873,15610,7892,2651,8272,16164,8294,16197
ʤ,BaiShengZhen,500102118,28253,5324,20263,13977,40317,20263,7537,20849,41112,20851,41114
Ϫ,ZhenXiZhen,500102119,31422,8069,25381,17608,48250,25210,10526,24392,49602,24636,50017
Ϫ,QingXiZhen,500102120,20355,4007,14109,9118,27767,13627,4923,14271,27898,15176,29285
ʯ,JiaoShiZhen,500102121,15039,3587,11308,7645,21802,11198,4828,11964,23162,12146,23454
,MaWuZhen,500102122,22124,5102,15779,10664,30944,15756,5134,16438,32194,16581,32360
̶,LongTanZhen,500102123,25633,4692,17744,11169,35179,17135,6186,18045,35180,18767,36511
,LinShiZhen,500102124,29800,6244,20516,15725,39792,20227,5686,20756,40983,21214,41730
,XinMiaoZhen,500102125,24026,5631,16788,12736,32358,16576,4642,17218,33794,17511,34299
ʯ,ShiDuoZhen,500102126,18487,3973,12789,9420,25358,12708,3684,13016,25724,13355,26144
,YiHeZhen,500102127,26267,5451,18289,11391,36497,18175,5672,18850,37025,19101,37390
,LuoYunXiang,500102204,9837,1992,7157,4839,14174,7144,3111,7731,14875,7783,14940
ľ,DaMuXiang,500102206,2066,498,1451,901,2893,1430,636,1672,3102,1749,3200
ɽ,WuLingShanXiang,500102208,4166,919,2861,1867,5714,2831,1275,3246,6077,3499,6360
˳,DaShunXiang,500102216,13199,2711,9055,6841,18470,9043,2934,9739,18782,9789,18844
,ZengFuXiang,500102217,10751,2569,7445,5775,15044,7428,2207,7994,15422,8082,15527
ͬ,TongLeXiang,500102222,12807,2697,9055,5502,18278,9047,3155,9584,18631,9604,18659
Ǹڽֵ´,QiXingGangJieDaoBanShiChu,500103001,55454,7672,35310,26127,36208,33867,5746,31560,65427,33562,68872
űֵ´,JieFangBeiJieDaoBanShiChu,500103003,52879,6646,32834,24686,31689,29298,5104,27132,56430,31795,64629
·ڽֵ´,LiangLuKouJieDaoBanShiChu,500103004,42046,5696,26522,18985,26347,23552,4069,22478,46030,25289,51811
½ֵ´,ShangQingSiJieDaoBanShiChu,500103005,44265,6613,28175,20934,28900,26133,5025,25195,51328,27728,55903
԰ӽֵ´,CaiYuanBaJieDaoBanShiChu,500103007,31662,2914,18778,14860,14612,18114,3804,18327,36441,19602,38380
ϼŽֵ´,NanJiMenJieDaoBanShiChu,500103008,37676,5071,23859,17407,25955,22614,4115,21407,44021,23003,46862
Žֵ´,WangLongMenJieDaoBanShiChu,500103009,33396,3306,20872,15239,16446,20227,4656,19493,39720,20486,41358
Žֵ´,ChaoTianMenJieDaoBanShiChu,500103010,22245,2047,13449,10259,9559,12809,3046,12576,25385,13889,27338
Ϫֵ´,DaXiGouJieDaoBanShiChu,500103011,51748,8258,34199,23730,37791,31549,6313,29351,60900,32120,66319
ƺֵ´,DaPingJieDaoBanShiChu,500103012,65570,7915,41682,30856,36966,38295,8173,36829,75124,39976,81658
Žֵ´,HuaLongQiaoJieDaoBanShiChu,500103013,13433,1386,7267,5561,7407,5562,987,5591,11153,8539,15806
ʯ·ֵ´,ShiYouLuJieDaoBanShiChu,500103014,59026,5773,34432,22252,32187,28279,6355,27352,55631,36722,71154
ɽֵ,XinShanCunJieDao,500104001,27998,4157,17777,13198,24202,17525,3719,17396,34921,18097,35874
Ծֵ,YueJinCunJieDao,500104002,37550,5828,24054,17015,29339,23010,4653,22733,45743,23977,48031
Źֵ,JiuGongMiaoJieDao,500104003,23056,2760,14226,10444,14644,13498,2859,13408,26906,14449,28675
Ϫֵ,QieZiXiJieDao,500104004,15259,2698,9477,7787,13651,9205,1781,9526,18731,10261,19738
·ֵ,ChunHuiLuJieDao,500104005,67401,7321,44303,28726,45723,43159,11584,40417,83576,42003,86306
,BaQiaoZhen,500104101,31724,1627,16339,17176,12509,14647,3313,16448,31095,20325,36664
ʤ,JianShengZhen,500104102,17245,1897,10508,7579,14390,9803,2720,9662,19465,11354,21862
,TiaoDengZhen,500104103,18078,2770,11394,7934,19297,11168,3044,11415,22583,12498,23892
½ֵֽ´,HuaXinJieJieDaoBanShiChu,500105001,75671,8145,45583,29295,43166,38385,7342,37785,76170,45575,91158
ǽֵ´,JiangBeiChengJieDaoBanShiChu,500105002,373,126,241,449,516,233,17,255,488,275,516
ʯӽֵ´,ShiMaHeJieDaoBanShiChu,500105003,83917,9966,51105,36155,56696,48194,10013,48689,96883,52791,103896
ʯӽֵ´,DaShiBaJieDaoBanShiChu,500105004,63432,8324,38368,27134,48171,35607,6974,35284,70891,40362,78730
ֵ̲´,CunTanJieDaoBanShiChu,500105005,33882,3388,20914,14730,25147,19132,5112,18745,37877,21468,42382
Žֵ´,GuanYinQiaoJieDaoBanShiChu,500105006,171022,16095,100833,64591,101186,84650,16652,81839,166489,102936,203769
ֵ´,WuLiDianJieDaoBanShiChu,500105007,79251,9528,49281,37905,54577,48447,9614,47385,95832,49112,98393
ֵ´,GuoJiaDuoJieDaoBanShiChu,500105008,22104,4919,14335,10773,25859,13893,2247,14096,27989,14935,29270
ɽƺֵ´,TieShanPingJieDaoBanShiChu,500105009,36157,3100,18518,10103,21077,12618,2985,12443,25061,23724,42242
,YuZuiZhen,500105100,20146,3342,13315,9622,23952,12834,3260,12547,25381,13433,26748
ʢ,FuShengZhen,500105101,8712,1746,5904,4702,11214,5869,1669,6064,11933,6223,12127
屦,WuBaoZhen,500105102,6000,1673,4052,3864,7828,3983,1099,4120,8103,4720,8772
Сֵ,XiaoLongKanJieDao,500106001,28231,3270,17917,11482,22832,15876,3666,14990,30866,17250,35167
ɳƺӽֵ,ShaPingBaJieDao,500106002,62302,5748,32521,18131,50980,23473,5240,22954,46427,40769,73290
·ֵ,YuBeiLuJieDao,500106003,83526,7551,51772,32617,61715,41437,8935,39806,81243,48240,100012
ڽֵ,CiQiKouJieDao,500106004,15043,2192,9621,7185,12930,9442,1728,9074,18516,9342,18963
ͯŽֵ,TongJiaQiaoJieDao,500106005,41013,3419,27256,11837,24132,15615,3441,14878,30493,20617,47873
ʯ½ֵ,ShiJingPoJieDao,500106006,25314,5044,16511,11745,28169,16272,2826,16155,32427,16673,33184
ղϪֵ,ZhanJiaXiJieDao,500106007,24954,4171,15841,12058,26385,15188,2558,14851,30039,15842,31683
ڽֵ,JingKouJieDao,500106008,21065,2308,13067,8316,13245,10676,2306,10636,21312,12612,25679
ɽֵ,GeLeShanJieDao,500106009,9076,901,4462,2544,4391,3113,973,3096,6209,6488,10950
ɽֵ,ShanDongJieDao,500106010,2361,453,1600,1163,1918,1332,261,1281,2613,1475,3075
Žֵ,XinQiaoJieDao,500106011,44827,3873,23365,15198,34208,18608,4062,18073,36681,29397,52762
Žֵ,TianXingQiaoJieDao,500106012,62058,7510,39385,28631,42756,38314,7902,36560,74874,38085,77470
ֵ,TuWanJieDao,500106013,36459,4359,23010,17332,27428,22744,4326,21583,44327,22134,45144
Ҹڽֵ,QinJiaGangJieDao,500106014,65918,3784,38902,31975,24881,37551,9842,37986,75537,40642,79544
,JingKouZhen,500106102,23000,1574,12321,9531,10307,11662,2830,12144,23806,15083,27404
ɽ,GeLeShanZhen,500106103,34601,3362,21045,11140,20757,15095,3711,15086,30181,20629,41674
ľ,QingMuGuanZhen,500106104,23670,2829,15188,9541,17871,13890,3970,13906,27796,15281,30469
,FengHuangZhen,500106105,15003,2314,9773,6523,15087,9569,2585,9793,19362,10129,19902
,HuiLongBaZhen,500106106,20285,3238,13459,7754,22875,12165,3059,11873,24038,13123,26582
¼,ChenJiaQiaoZhen,500106107,46929,3781,23152,10723,24488,16482,4118,16047,32529,31676,54828
,CengJiaZhen,500106108,18034,3079,11958,7741,13579,11824,2834,11624,23448,11989,23947
Ϫ,HuXiZhen,500106109,53569,251,30315,935,7755,1065,259,1162,2227,23764,54079
,XiYongZhen,500106110,21648,2147,11718,6285,15105,9444,2345,9642,19086,14422,26140
,TuZhuZhen,500106111,13794,2152,8969,5699,15793,8794,2357,8784,17578,9334,18303
,ZhongLiangZhen,500106112,13046,2106,8248,6176,14001,7963,1959,8278,16241,8863,17111
԰,LianFangYuanQuZhen,500106113,20265,1367,12211,9273,9111,11940,3146,12143,24083,12567,24778
ƺֵ´,YangJiaPingJieDaoBanShiChu,500107001,88518,11293,56754,38873,71587,53646,11767,51177,104823,54824,111578
ƺֵ´,HuangJuePingJieDaoBanShiChu,500107002,52765,5991,30832,20568,35736,26534,5356,26453,52987,33280,64112
лֵ´,XieJiaWanJieDaoBanShiChu,500107003,61452,10035,39142,26201,50958,37074,6740,36184,73258,39085,78227
ʯƺŽֵ´,ShiPingQiaoJieDaoBanShiChu,500107004,57791,6798,36126,25735,39308,35004,7692,34723,69727,36155,72281
ʯֵ̽´,ShiQiaoPuJieDaoBanShiChu,500107005,116360,9751,70054,47466,59447,62036,17817,61802,123838,73874,143928
ɽֵ´,ZhongLiangShanJieDaoBanShiChu,500107006,70940,8223,42509,28502,52447,37919,9576,38381,76300,46230,88739
·ֵ´,YuZhouLuJieDaoBanShiChu,500107007,73909,4024,43392,33875,28435,40360,12907,41179,81539,47448,90840
,JiuLongZhen,500107100,66346,5085,41304,28307,38227,37870,10621,36260,74130,40748,82052
,HuaYanZhen,500107102,39096,2661,20850,16672,17265,19150,4920,21077,40227,25827,46677
,HanGuZhen,500107103,30972,2304,17017,12267,15165,14563,3899,16194,30757,20158,37175
,JinFengZhen,500107104,12005,2292,7921,5854,13679,7738,2008,7873,15611,8384,16305
,BaiShiYiZhen,500107105,60740,5485,35127,28035,36395,33423,8764,35267,68690,39862,74989
,ZouMaZhen,500107106,11230,2471,7578,5714,13645,7463,1931,7719,15182,8054,15632
ʯ,ShiBanZhen,500107107,6885,1243,4510,3638,6597,4419,1180,4529,8948,4798,9308
͸,BaFuZhen,500107108,11361,1773,6732,4984,8059,6310,1594,6596,12906,7996,14728
ռ,TaoJiaZhen,500107109,12198,2360,7896,6101,13022,7624,1909,7874,15498,8571,16467
,XiPengZhen,500107110,76535,12662,50536,35796,85104,49619,12823,49557,99176,51484,102020
ͭ,TongGuanYiZhen,500107111,14099,3173,9859,7947,16372,9703,2089,9326,19029,9502,19361
ͭԪֵֽ´,TongYuanJuJieDaoBanShiChu,500108001,38947,4937,25326,19389,29188,24855,6088,23728,48583,24646,49972
԰·ֵ´,HuaYuanLuJieDaoBanShiChu,500108002,78728,8697,48320,34508,58283,43985,10895,43684,87669,50000,98320
ƺֵ,NanPingJieDao,500108003,92128,9789,54926,38439,69386,50196,11276,47930,98126,58267,113193
Ϫֵ,HaiTangXiJieDao,500108004,96952,6057,53618,26447,52927,32417,7301,31347,63764,56692,110310
źƽֵ,LongMenHaoJieDao,500108005,21866,3124,13905,11131,17362,13629,2625,13367,26996,13710,27615
ʯֵ,DanZiShiJieDao,500108006,28767,3967,18517,13564,23361,17653,3565,17048,34701,17782,36299
ɽֵ,NanShanJieDao,500108007,47552,4519,26940,13255,38872,18597,4817,18068,36665,29948,56888
ƺ,NanPingZhen,500108101,79074,5581,48624,41077,38390,46502,12426,45028,91530,48457,97081
Ϳɽ,TuShanZhen,500108102,42990,4272,26958,21054,23215,25497,5884,24568,50065,26188,53146
ʯ,JiGuanShiZhen,500108103,13025,1216,7667,6069,9157,7106,1812,7245,14351,8386,16053
Ͽ,XiaKouZhen,500108105,8511,1698,5788,4512,10323,5702,1578,5653,11355,5999,11787
,ChangShengQiaoZhen,500108106,46243,5089,27978,17038,38174,24407,6628,24069,48476,29982,57960
ӭ,YingLongZhen,500108107,11682,2595,7935,6306,15020,7850,2042,8135,15985,8384,16319
,GuangYangZhen,500108108,10647,2213,7016,5233,13399,6950,1767,7185,14135,7611,14627
ֵ,TianShengJieDao,500109001,105719,10520,64563,29830,79172,40067,8489,37951,78018,60165,124728
ֵ,ZhaoYangJieDao,500109002,29515,4881,19524,13739,23257,18872,3731,17799,36671,18603,38127
Ȫֵ,BeiWenQuanJieDao,500109003,68365,6787,42529,27195,39219,36958,9695,35572,72530,42318,84847
ֵ,DongYangJieDao,500109004,31963,4696,17984,13170,29582,17460,3484,17448,34908,22159,40143
Žֵ,LongFengQiaoJieDao,500109005,26841,3518,16820,11793,20908,15363,3622,15764,31127,17161,33981
Ъ,XieMaZhen,500109101,47596,6627,30006,20431,46194,27157,6710,27478,54635,30927,60933
ν,ChengJiangZhen,500109102,20924,4131,13605,10650,24147,13050,3001,13516,26566,14451,28056
̼Ҹ,CaiJiaGangZhen,500109103,27777,4222,16910,11931,27652,15898,3565,15642,31540,18654,35564
ͯϪ,TongJiaXiZhen,500109104,17653,1990,10127,6668,12552,9155,2177,9303,18458,11693,21820
츮,TianFuZhen,500109105,23127,5066,15414,11753,27990,15092,2787,15009,30101,15566,30980
ʩ,ShiJiaLiangZhen,500109108,6666,1140,4356,3003,7323,4062,967,3971,8033,4417,8773
ˮ,ShuiTuZhen,500109109,34635,5392,21939,15267,36684,20009,4524,19890,39899,22612,44551
,JingGuanZhen,500109110,32384,6363,21784,15619,41054,21201,4927,21375,42576,21890,43674
,LiuYinZhen,500109111,12356,2957,8515,6842,15915,8493,2192,8915,17408,8990,17505
,FuXingZhen,500109112,25736,4381,16491,12773,29976,16063,3504,16463,32526,17130,33621
ʥ,SanShengZhen,500109113,13472,3555,9548,8088,18141,9504,2278,9671,19175,9757,19305
Ͽ,JinDaoXiaZhen,500109116,10018,2081,6387,5342,12012,6351,1653,6707,13058,7365,13752
ʢֵ,WanShengJieDao,500110001,32043,5153,21579,14992,35127,21084,5223,20149,41233,20840,42419
ֵֽ,DongLinJieDao,500110002,23730,4245,15698,10775,26343,15046,3343,14719,29765,15620,31318
,WanDongZhen,500110100,30289,4311,20144,13491,31200,19815,5414,19147,38962,19870,40014
ͩ,NanTongZhen,500110101,34531,6194,22954,14107,42855,21163,5959,20859,42022,23730,46684
,QingNianZhen,500110102,15754,2654,10990,6980,20557,10966,3754,11106,22072,11172,22162
ذ,GuanBaZhen,500110103,16790,2469,11678,7232,20915,11298,4639,11119,22417,12220,23898
,CongLinZhen,500110104,12382,2243,8096,5802,14361,8022,2428,8088,16110,8957,17053
ʯ,ShiLinZhen,500110105,6307,1289,4522,2953,8609,4510,1808,4834,9344,4882,9404
,JinQiaoZhen,500110106,9671,2362,6955,5218,13534,6928,2179,7215,14143,7257,14212
ɽ,HeiShanZhen,500110107,5958,1103,4192,2294,8121,4005,1551,4170,8175,4420,8612
̲ӽֵ´,LongTanZiJieDaoBanShiChu,500111001,9389,1843,6509,5153,11510,6395,2026,6312,12707,6749,13258
˫·,ShuangLuZhen,500111100,19744,2049,13208,9489,18866,12939,4789,12859,25798,13374,26582
ͨ,TongQiaoZhen,500111101,7366,859,5069,3834,8793,5015,2051,4985,10000,5207,10276
˫ֵ,ShuangLongHuJieDao,500112002,102587,10475,63576,39310,67509,59363,15501,57724,117087,64987,128563
˽ֵ,HuiXingJieDao,500112004,156583,9408,94884,54772,63135,73637,20981,74755,148392,92088,186972
ԧֵ,YuanYangJieDao,500112007,30738,1911,16552,10457,15964,14136,4360,13370,27506,20457,37009
ƽֵ,CuiYunJieDao,500112008,14769,1636,8649,6353,12506,8117,2231,8160,16277,9987,18636
˺ͽֵ,RenHeJieDao,500112009,50333,3832,29975,19587,24054,27381,7444,26704,54085,31634,61609
칬ֵ,TianGongDianJieDao,500112010,45440,3656,27648,18977,18172,25742,6752,24324,50066,28200,55848
Ϫֵ,LongXiJieDao,500112011,116531,11002,70220,45400,49578,62920,13399,61367,124287,70712,140932
ɽֵ,LongShanJieDao,500112012,95305,8348,58998,39394,46707,56172,14047,53569,109741,58702,117700
ֵ,LongTaJieDao,500112013,75480,6748,47701,31022,28376,44631,11894,40949,85580,46421,94122
ֵֽ,DaZhuLinJieDao,500112014,30596,2646,16172,11815,17148,14692,3683,14745,29437,20753,36925
ֵ,YueLaiJieDao,500112015,8078,1373,4906,4330,9016,4762,1203,4984,9746,5748,10654
·ֵ,LiangLuJieDao,500112016,48002,5439,29765,22820,34072,27993,7025,27644,55637,30701,60466
˫Žֵ,ShuangFengQiaoJieDao,500112017,56206,3629,32299,17756,29688,26817,7882,25613,52430,35418,67717
ҽֵ,WangJiaJieDao,500112018,11432,2124,7456,5811,12434,7165,1895,7249,14414,7995,15451
,LiJiaZhen,500112103,12206,1794,7466,5776,13250,7013,1923,6989,14002,8457,15923
ɽ,YuFengShanZhen,500112129,17394,3604,11677,9035,22555,11463,2919,11916,23379,12240,23917
,LongXingZhen,500112131,24975,6574,17977,16414,34034,17452,4748,17421,34873,18320,36297
ͳ,TongJingZhen,500112133,20195,5520,14928,12882,28509,14713,4958,15181,29894,15745,30673
,DaWanZhen,500112135,13563,4373,11073,10221,21210,11001,4548,11209,22210,11411,22484
¡,XingLongZhen,500112138,13458,3781,9931,9640,19339,9862,3094,10125,19987,10402,20333
ľ,MuErZhen,500112139,15889,3989,11266,10174,21687,11146,3279,11562,22708,11891,23157
,CiZhuZhen,500112140,15051,3832,11348,9437,19709,10719,4113,10850,21569,11648,22996
·,GuLuZhen,500112141,12459,3643,9031,8829,18014,9008,2567,9521,18529,9638,18669
ʯ,ShiChuanZhen,500112142,26083,7611,19421,17068,37874,19225,5951,19611,38836,20224,39645
ʢ,DaShengZhen,500112143,13228,4494,10713,9926,20767,10703,4128,10965,21668,11137,21850
,LuoQiZhen,500112144,26444,5644,18134,15432,34679,18094,4774,18368,36462,18728,36862
ֵ´,LongZhouWanJieDaoBanShiChu,500113003,33151,4272,20921,15833,30997,19828,5363,19363,39191,21865,42786
㶴ֵ´,YuDongJieDaoBanShiChu,500113004,132640,17539,85920,58401,126942,80247,21184,78820,159067,85443,171363
Ϫֵ´,HuaXiJieDaoBanShiChu,500113005,108868,9429,60155,38083,65756,47684,12340,47374,95058,70482,130637
ֵ´,LiJiaDuoJieDaoBanShiChu,500113006,72017,8367,44104,28810,47368,38933,8829,37431,76364,45109,89213
Ȫֵ´,NanQuanJieDaoBanShiChu,500113007,41869,5112,25578,16540,39388,22065,6075,22270,44335,27478,53056
һƷֵ´,YiPinJieDaoBanShiChu,500113008,16113,2942,10680,8894,19063,10551,2593,10693,21244,10968,21648
ֵ´,NanPengJieDaoBanShiChu,500113009,34771,6550,22629,16698,44640,22229,5465,23671,45900,24157,46786
ֵ´,HuiMinJieDaoBanShiChu,500113010,16340,3774,10929,9958,21159,10736,2903,11682,22418,12088,23017
ʯ,JieShiZhen,500113103,36269,5341,23495,16082,39037,22605,6026,22755,45360,24141,47636
,AnLanZhen,500113107,22712,5264,14989,11871,30175,14788,3570,16170,30958,16557,31546
ʯ,TiaoShiZhen,500113108,20517,4787,13677,11215,27906,13644,3521,15076,28720,15148,28825
ľ,MuDongZhen,500113109,26817,6279,18100,15255,33653,17271,3608,17732,35003,18604,36704
˫ӿ,ShuangHeKouZhen,500113110,8742,2525,6040,5536,11764,5965,1472,6283,12248,6699,12739
,MaLiuZuiZhen,500113111,12554,3451,9307,7836,17773,9289,2842,9465,18754,9540,18847
ʢ,FengShengZhen,500113112,9148,2911,6529,6328,13056,6513,1590,6998,13511,7120,13649
ʥ,ErShengZhen,500113113,11608,3021,7865,6778,15822,7799,1832,8480,16279,8596,16461
Ȫ,DongQuanZhen,500113114,20100,5382,14213,11283,27555,13932,3652,14550,28482,14921,29134
,JiangJiaZhen,500113115,11410,3218,7847,6602,16033,7812,1890,8605,16417,8671,16518
,TianXingSiZhen,500113116,5658,1918,3894,3759,8013,3854,807,4356,8210,4489,8383
,JieLongZhen,500113117,34203,7761,23084,16848,46640,22806,6054,24463,47269,24934,48018
ʯ̲,ShiTanZhen,500113118,7405,2059,5550,4179,10827,5501,1831,5644,11145,5745,11295
ʯ,ShiLongZhen,500113119,13661,3828,10044,8324,19675,10018,2942,10285,20303,10387,20431
Ƕֵ´,ChengDongJieDaoBanShiChu,500114001,53482,3437,34476,24813,43297,31492,14385,33309,64801,36828,71304
Ͻֵ´,ChengNanJieDaoBanShiChu,500114002,24346,1824,16321,10548,20490,15977,7674,16968,32945,17523,33844
ֵ´,ChengXiJieDaoBanShiChu,500114003,27363,2218,18887,12645,26554,18627,8998,19242,37869,19692,38579
ֵ´,ZhengYangJieDaoBanShiChu,500114004,8762,1057,6346,4318,12536,6324,3179,6623,12947,6652,12998
۰׽ֵ´,ZhouBaiJieDaoBanShiChu,500114005,18620,1697,11482,5464,19228,8405,4830,9173,17578,13665,25147
ҽֵ´,FengJiaJieDaoBanShiChu,500114006,14690,2137,10421,7273,21160,9933,4983,10793,20726,11389,21810
,APengJiangZhen,500114105,11498,2859,9253,6854,17817,9206,4239,9206,18412,9343,18596
ʯ,ShiHuiZhen,500114106,9861,1895,7479,5060,14276,7243,3449,7407,14650,7726,15205
Ϫ,HeiXiZhen,500114107,9147,1829,7100,5129,14093,7092,3834,7656,14748,7710,14810
Ϫ,HuangXiZhen,500114108,6027,984,4760,3433,9211,4739,2851,5038,9777,5102,9862
ˮ,LiShuiZhen,500114109,5470,1074,4301,3378,8475,4301,2352,4595,8896,4595,8896
Ϫ,JinXiZhen,500114110,5877,1111,4272,3228,8705,4238,1952,4589,8827,4668,8940
,MaLaZhen,500114111,7283,1676,5838,4993,11348,5827,2854,5911,11738,5975,11813
ˮ,ZhuoShuiZhen,500114112,13578,2333,9870,6792,19214,9541,4475,9976,19517,10516,20386
ʯ,ShiJiaZhen,500114113,5981,1284,4679,3518,8996,4552,2364,4697,9249,4950,9629
,EChiZhen,500114114,5095,1124,4119,3159,8259,4070,2362,4355,8425,4462,8581
СϺ,XiaoNanHaiZhen,500114117,4352,778,3208,2351,6100,3132,1532,3282,6414,3454,6662
ڶ,LinEZhen,500114119,6351,1061,4818,3337,9482,4807,2530,5007,9814,5124,9942
,ZhongTangXiang,500114245,6765,1410,5618,3970,10595,5597,3149,5675,11272,5706,11324
,PengDongXiang,500114246,3896,692,2969,2289,5886,2968,1478,3094,6062,3097,6066
ɳ,ShaBaXiang,500114247,7160,1453,5463,3946,10936,5359,2801,5761,11120,5951,11414
ʯ,BaiShiXiang,500114248,7209,1369,5728,4076,10947,5651,3128,5810,11461,5978,11706
ɼ,ShanLingXiang,500114249,4137,754,3233,2419,6449,3223,1862,3500,6723,3520,6753
̫,TaiJiXiang,500114250,5274,999,3990,3063,7746,3854,1969,4017,7871,4252,8242
ˮ,ShuiTianXiang,500114251,3903,660,2894,1988,5719,2887,1421,3042,5929,3090,5984
,BaiTuXiang,500114252,3274,725,2456,2019,4943,2449,1189,2726,5175,2732,5188
,JinDongXiang,500114253,4206,1110,3510,2915,6732,3502,1754,3512,7014,3560,7070
,WuLiXiang,500114254,4891,1036,3940,3027,7681,3894,2083,3979,7873,4070,8010
ˮ,ShuiShiXiang,500114255,5898,1207,4462,3183,8810,4419,2065,4558,8977,4708,9170
»,XinHuaXiang,500114256,4487,895,3428,2486,6787,3394,1699,3575,6969,3653,7081
ǽֵ´,FengChengJieDaoBanShiChu,500115001,134307,18629,88951,65965,133984,84973,22640,82753,167726,86625,175576
̼ҽֵ´,YanJiaJieDaoBanShiChu,500115002,56138,7514,34846,27409,63049,33824,9173,34541,68365,37979,72825
Ͻֵ´,JiangNanJieDaoBanShiChu,500115003,16380,2683,10306,7962,19075,9555,2446,9639,19194,11203,21509
۽ֵ´,DuZhouJieDaoBanShiChu,500115004,39430,5665,25654,17471,43215,24318,6793,23804,48122,26234,51888
ڷ,LinFengZhen,500115123,16875,3898,11558,9708,23607,11553,3095,12293,23846,12310,23868
,DanDuZhen,500115124,10394,2294,7003,5600,14312,7001,1809,7458,14459,7494,14497
Ƽ,YunJiZhen,500115125,18954,3953,13321,10853,27225,13304,4657,14201,27505,14243,27564
ٺ,ChangShouHuZhen,500115126,27156,5600,18305,14418,37128,18302,5083,19516,37818,19534,37839
˫,ShuangLongZhen,500115127,20493,4774,14686,14021,27388,14418,3946,14178,28596,14527,29213
,LongHeZhen,500115128,25083,5104,17498,14551,34846,17494,5374,18045,35539,18063,35561
ʯ,ShiYanZhen,500115129,32447,6875,23877,18869,47678,23796,8871,24145,47941,24316,48193
̨,YunTaiZhen,500115130,26872,5346,19649,15778,39419,19610,8110,20480,40090,20679,40328
,HaiTangZhen,500115131,16039,2966,11618,8368,23991,11561,5247,12571,24132,12634,24252
,GeLanZhen,500115132,39091,7090,27621,21591,54964,27413,9757,28072,55485,28317,55938
,XinShiZhen,500115133,15220,3044,10669,8261,20978,10652,3314,10847,21499,10909,21578
˿,BaKeZhen,500115135,26199,5055,18477,15038,36276,18403,5444,18037,36440,18221,36698
,HongHuZhen,500115136,21362,4158,14769,11748,29940,14769,4906,15652,30421,15657,30426
˳,WanShunZhen,500115137,15411,2891,11141,8990,21991,11096,3954,11078,22174,11115,22256
ֵ´,JiJiangJieDaoBanShiChu,500116001,148775,19991,101719,70721,132964,98573,28021,91950,190523,95068,196787
¸нֵ´,DeGanJieDaoBanShiChu,500116002,62877,10271,40924,28422,73022,38314,10802,38402,76716,43026,83950
֧ƺֵ´,ZhiPingJieDaoBanShiChu,500116003,25452,5780,17917,14242,35342,17882,5448,18589,36471,18763,36680
˫ֵ´,ShuangFuJieDaoBanShiChu,500116004,36335,5605,22384,15674,37573,20393,6022,20920,41313,25578,47962
Ϫ,YouXiZhen,500116101,43370,10454,31260,23595,59691,30823,9562,31157,61980,32126,63386
̲,WuTanZhen,500116102,19353,5404,14398,11576,28210,14256,4449,14615,28871,14808,29206
ʯ,ShiMenZhen,500116103,24687,5369,17592,13262,33316,17173,5609,17692,34865,18073,35665
,ZhuYangZhen,500116104,17499,3968,13221,10272,24767,12628,4868,12506,25134,13114,26335
ʯ,ShiMaZhen,500116105,45052,11794,34499,24831,65904,32891,13035,33991,66882,35382,69881
,YongXingZhen,500116106,20478,5242,15782,11513,31115,15704,6815,16608,32312,16753,32535
,TangHeZhen,500116107,8883,2028,6631,4787,12464,6594,2902,6924,13518,7182,13813
ɳ,BaiShaZhen,500116108,80968,15693,57584,38604,102289,53240,19100,53051,106291,58177,115761
,LongHuaZhen,500116109,17999,5000,13615,10460,26470,13528,4850,14058,27586,14234,27849
,LiShiZhen,500116110,45346,9977,31846,21689,64290,30950,11297,33709,64659,34774,66620
,CiYunZhen,500116111,11599,3320,9144,7628,17504,9026,3632,9200,18226,9407,18551
̼,CaiJiaZhen,500116112,28327,6942,21167,15250,42082,20201,8653,21730,41931,22755,43922
ɽ,ZhongShanZhen,500116113,12809,3269,9875,7244,19326,9725,4431,10403,20128,10634,20509
ƽ,JiaPingZhen,500116114,12280,3161,8852,6278,17840,8489,3442,9587,18076,10031,18883
,BoLinZhen,500116115,23934,6055,18481,13821,35939,18337,8575,19920,38257,20083,38564
ȷ,XianFengZhen,500116116,33223,8046,23421,18360,46455,23159,7317,24616,47775,25165,48586
,LuoHuangZhen,500116117,50999,9603,34417,25516,62205,33203,10913,34161,67364,37098,71515
,JiaSiZhen,500116118,18589,4439,13145,10208,25743,13136,4299,14119,27255,14182,27327
İ,XiaBaZhen,500116119,13105,2220,8393,7528,15943,8061,2161,8661,16722,9093,17486
,XiHuZhen,500116120,25050,6676,18291,14086,37037,18102,6660,19856,37958,20095,38386
,DuShiZhen,500116121,18797,4512,13088,10693,25324,12832,3570,13464,26296,13791,26879
,GuangXingZhen,500116122,7641,1986,5491,4172,10135,5349,1595,5375,10724,5731,11222
ɽίԱ,SiMianShanGuanLiWeiYuanHui,500116400,3456,536,2325,1608,4409,2148,897,2293,4441,2564,4889
ǽֵ´,HeYangChengJieDaoBanShiChu,500117001,148174,15606,97532,57910,109607,79663,22462,74164,153827,88710,186242
ǽֵ´,DiaoYuChengJieDaoBanShiChu,500117002,34884,6179,23976,20288,38228,23295,6142,22283,45578,23229,47205
Ͻֵֽ´,NanJinJieJieDaoBanShiChu,500117003,108687,16055,72173,51200,106411,69307,19024,65905,135212,71593,143766
ξֵ,YanJingJieDao,500117004,18255,3425,11202,9401,21031,10906,3000,11572,22478,13478,24680
ݽֵֽ,CaoJieJieDao,500117005,35187,4753,22212,12889,31999,14883,4297,15501,30384,22025,44237
Žֵ,YunMenJieDao,500117006,47514,9163,35135,23993,63862,33588,12021,31942,65530,33563,68698
ʯֵ,DaShiJieDao,500117007,42676,8815,29799,23169,58193,29062,9935,30668,59730,31627,61426
ɳ,ShaYuZhen,500117100,6359,1693,5004,4489,9426,5002,2065,5096,10098,5113,10117
ٶ,GuanDuZhen,500117101,16006,4419,12310,10275,23594,12295,4488,12567,24862,12603,24913
̲,LaiTanZhen,500117102,15560,4332,12048,10111,23373,12034,4539,12317,24351,12383,24431
Ф,XiaoJiaZhen,500117103,10479,2473,7946,6346,15551,7926,3411,8336,16262,8417,16363
¥,GuLouZhen,500117104,13128,2867,9416,7396,18676,9302,3452,9810,19112,10031,19447
,SanMiaoZhen,500117105,23830,5394,17375,13872,34327,17228,6653,18101,35329,18502,35877
,ErLangZhen,500117106,11832,2447,8308,6463,16178,8302,3016,8963,17265,8987,17295
,LongFengZhen,500117107,13661,2758,9821,7390,19529,9769,3915,10399,20168,10513,20334
¡,LongXingZhen,500117108,19410,4365,13896,11215,27871,13891,4971,14841,28732,14850,28746
ͭϪ,TongXiZhen,500117109,20741,4976,14715,12691,27993,14439,3982,14580,29019,14984,29699
˫,ShuangFengZhen,500117112,23367,5069,15960,12907,32113,15960,4846,17322,33282,17322,33282
ʨ̲,ShiTanZhen,500117113,12792,3448,9396,8263,18393,9388,3135,9921,19309,9979,19375
ƽ,QingPingZhen,500117114,15980,2589,10338,7681,18042,9976,2591,10366,20342,10822,21160
,TuChangZhen,500117115,12713,2356,8386,7306,15994,8358,2152,8775,17133,8835,17221
С,XiaoMianZhen,500117116,18716,4380,13310,10497,24471,12706,4058,13160,25866,13844,27154
,SanHuiZhen,500117117,37916,5906,24672,20172,42635,24596,7591,25613,50209,26741,51413
,XiangLongZhen,500117118,15545,4039,12138,9694,23667,12085,5422,12798,24883,12868,25006
Ǯ,QianTangZhen,500117120,43423,10039,31470,28272,62863,30966,12432,33614,64580,34424,65894
,LongShiZhen,500117121,37266,8752,27886,21749,51709,25991,10124,26579,52570,28256,56142
,YanWoZhen,500117123,20396,4184,14737,11028,28763,14626,5844,15379,30005,15687,30424
̫,TaiHeZhen,500117124,45638,9388,33128,25354,61849,31693,11480,32206,63899,33378,66506
μ,WeiDuoZhen,500117125,24335,6350,17583,14256,34958,17179,5383,17729,34908,18485,36068
˫,ShuangHuaiZhen,500117126,25206,6142,19625,15371,37638,19559,8559,20007,39566,20282,39907
ɽ·ֵ,ZhongShanLuJieDao,500118001,152861,14280,93601,54436,119177,81626,25813,77852,159478,99353,192954
ʤ·ֵ,ShengLiLuJieDao,500118002,103335,12040,66894,38185,91584,57808,18843,55473,113281,67324,134218
ϴֵֽ,NanDaJieJieDao,500118003,70389,7082,46262,23524,60330,33987,11477,33822,67809,42686,88948
ɽ񺣽ֵ,ChaShanZhuHaiJieDao,500118004,37749,1645,18371,5629,16251,7449,2989,7967,15416,24012,42383
󰲽ֵ,DaAnJieDao,500118005,33189,5997,23792,16445,44141,23133,9185,23642,46775,24579,48371
ʳֵ,ChenShiJieDao,500118006,27432,5290,19533,13117,37886,19363,7141,19998,39361,20330,39863
Ǻֵ,WeiXingHuJieDao,500118007,27605,4210,18431,11660,35415,18220,6297,19216,37436,19681,38112
,QingFengZhen,500118100,13403,2545,9653,6799,17795,9544,3679,9709,19253,9974,19627
,JinLongZhen,500118102,13338,3407,10601,8015,20682,10587,4920,10999,21586,11064,21665
ٽ,LinJiangZhen,500118104,16360,4368,13033,10152,23977,12745,5012,12415,25160,12707,25740
ι,HeGengZhen,500118106,23316,6277,19489,13826,35286,19440,8513,18458,37898,18617,38106
ɸ,SongGaiZhen,500118107,9063,2261,7145,5135,12863,6993,2946,6828,13821,7125,14270
,XianLongZhen,500118108,22097,5762,18415,12799,34301,18386,8702,18057,36443,18146,36561
,JiAnZhen,500118109,13051,2914,10320,7061,19342,10276,5013,10426,20702,10658,20978
,WuJianZhen,500118110,12808,2828,10006,6396,17175,9121,4225,9033,18154,9855,19861
,LaiSuZhen,500118111,27182,5935,20926,14880,37740,20578,8244,20032,40610,20435,41361
,BaoFengZhen,500118112,8900,2082,6950,5091,12912,6937,3025,7028,13965,7057,14007
˫ʯ,ShuangShiZhen,500118113,17057,3061,11817,8882,21895,11712,4197,12178,23890,12498,24315
¯,HongLuZhen,500118114,14991,3117,10690,8458,19203,10671,3510,10792,21463,10928,21618
,YongRongZhen,500118115,9999,1795,6983,5338,12203,6953,2511,7037,13990,7322,14305
,SanJiaoZhen,500118116,30587,5906,22873,15169,42385,22756,9965,23046,45802,23585,46458
,BanQiaoZhen,500118117,14359,3476,11416,8119,21111,11372,4890,11219,22591,11309,22725
,ZhuDuoZhen,500118118,34891,9015,29407,20939,53514,29151,14356,27756,56907,28855,58262
ǽֵ´,DongChengJieDaoBanShiChu,500119001,62923,7405,43022,28066,70531,41237,13836,40348,81585,41142,84164
ϳǽֵ´,NanChengJieDaoBanShiChu,500119002,58895,7179,40558,25540,60191,40437,14411,39552,79989,39927,80485
ǽֵ´,XiChengJieDaoBanShiChu,500119003,28508,4244,20277,12668,31787,19983,7374,19309,39292,19849,40126
Ȫ,SanQuanZhen,500119100,9250,1864,6885,4544,13348,6863,2708,6886,13749,6937,13822
ƽ,NanPingZhen,500119101,22925,3573,16705,9873,29133,15810,6390,15470,31280,16183,32888
ͯ,ShenTongZhen,500119102,4330,1105,3462,2434,6403,3456,1346,3300,6756,3319,6781
,MingYuZhen,500119103,7558,1906,5911,4304,11037,5910,2470,6014,11924,6023,11934
,DaGuanZhen,500119104,14164,2902,10312,6594,17879,8707,3472,8632,17339,10226,20538
¡,XingLongZhen,500119105,14132,2425,10109,6038,19966,10049,3932,10306,20355,10380,20489
̫ƽ,TaiPingChangZhen,500119106,6333,2273,4996,4121,10019,4921,1602,5069,9990,5212,10208
ɳ,BaiShaZhen,500119107,3973,1254,3151,2550,6131,3128,1185,3200,6328,3261,6412
ˮ,ShuiJiangZhen,500119108,37073,5098,23007,15658,43516,22756,8747,23479,46235,27911,50918
ʯǽ,ShiQiangZhen,500119109,4384,1072,3392,2272,6643,3195,1376,3064,6259,3440,6832
ɽ,JinShanZhen,500119110,6781,1237,5215,3232,9866,5138,2591,5242,10380,5394,10609
ͷ,TouDuZhen,500119111,4678,849,3545,2513,7035,3545,1728,3709,7254,3710,7255
,DaYouZhen,500119112,6232,1496,5125,3539,9787,5073,2312,4809,9882,4915,10040
Ϫ,HeXiZhen,500119113,4118,910,3229,2186,6348,3223,1576,3354,6577,3375,6604
,LiXiangHuZhen,500119114,3313,1032,2587,2092,5048,2577,804,2552,5129,2562,5149
ʯ,ShiLianXiang,500119200,3296,927,2537,1815,4896,2504,930,2550,5054,2616,5153
ľ,MuLiangXiang,500119201,4479,1088,3374,2423,6581,3357,1203,3360,6717,3396,6770
ͼ,HeTuXiang,500119202,3147,977,2541,2009,4843,2522,935,2483,5005,2518,5059
Ǭ,QianFengXiang,500119204,3135,1069,2547,2051,4969,2545,970,2613,5158,2627,5174
,QiLongXiang,500119205,3847,1202,3064,2200,6113,3056,1200,3145,6201,3185,6249
Ȫ,YuQuanXiang,500119206,4220,820,3168,1976,6278,3166,1492,3345,6511,3364,6532
,ZhongQiaoXiang,500119207,5000,1200,3749,2587,7303,3737,1468,3890,7627,3919,7668
,TieCunXiang,500119208,5237,955,3776,2474,7463,3770,1465,3861,7631,3881,7657
¡,DeLongXiang,500119209,3359,750,2581,1812,5196,2580,1170,2683,5263,2698,5279
Ԫ,QingYuanXiang,500119210,4513,1010,3745,2573,7207,3745,1884,3662,7407,3662,7407
Ż,GuHuaXiang,500119211,4365,1048,3579,2499,6963,3558,1808,3604,7162,3642,7221
,FengYanXiang,500119212,3990,1239,3176,2442,6201,3167,1244,3276,6443,3297,6473
,MinZhuXiang,500119213,4191,1394,3541,2616,6857,3526,1507,3481,7007,3551,7092
ˮ,LengShuiGuanXiang,500119214,4340,1496,3595,2914,7121,3595,1509,3750,7345,3750,7345
ʯϪ,ShiXiXiang,500119215,6195,1819,4983,3706,9684,4949,1968,4909,9858,4999,9982
,FuShouXiang,500119216,5371,1299,3961,2908,7841,3956,1344,4043,7999,4053,8014
Ͻֵ´,GuNanJieDaoBanShiChu,500222001,65896,9557,44313,30384,67813,39151,11499,38000,77151,42639,86952
ֵ´,WenLongJieDaoBanShiChu,500222002,91368,11467,60814,43164,92088,59562,18223,58922,118484,60244,121058
ֵ´,SanJiangJieDaoBanShiChu,500222003,29293,5625,19619,16326,36825,19290,4867,19830,39120,20166,39785
ʯ,ShiJiaoZhen,500222102,30189,8419,22878,18216,43639,22567,7489,22787,45354,23219,46097
Ϫ,DongXiZhen,500222103,39205,8834,29211,21042,55216,28369,10130,27862,56231,28958,58169
ˮ,GanShuiZhen,500222104,45210,9671,32473,25575,58751,32118,11113,31865,63983,33521,65994
ͨ,DaTongZhen,500222105,36586,5429,25285,17313,44735,24482,9010,24636,49118,25740,51025
ʯ,ShiHaoZhen,500222106,30289,4676,20930,15409,37502,20789,8715,21632,42421,22750,43680
,YongXinZhen,500222107,33394,8923,24150,20405,48784,23741,7634,25310,49051,25801,49951
,SanJiaoZhen,500222108,23312,5814,17490,14257,34291,17408,6360,17875,35283,17996,35486
¡ʢ,LongShengZhen,500222109,20639,4628,14818,10631,29584,14710,5394,15566,30276,15843,30661
,GuoFuZhen,500222110,20774,5783,16038,13304,31863,16026,6274,16721,32747,16793,32831
׭,ZhuanTangZhen,500222111,14048,3372,10537,7695,19438,10427,3628,10175,20602,10511,21048
ɽ,DingShanZhen,500222112,5099,1133,3985,2740,7368,3906,2164,3979,7885,4411,8396
,AnWenZhen,500222113,21135,3482,14860,9964,26690,14767,5936,15196,29963,15693,30553
,FuHuanZhen,500222114,16813,3652,12872,8937,23911,12760,4699,12076,24836,12292,25164
,YongChengZhen,500222115,11375,2807,8793,6123,16136,8734,3452,8667,17401,8841,17634
ʢ,XinShengZhen,500222116,9325,2455,6628,5732,13297,6567,2092,7097,13664,7244,13872
з,ZhongFengZhen,500222117,7636,1822,5549,4569,11263,5512,2164,6013,11525,6073,11622
ɽ,HengShanZhen,500222118,7654,1726,5287,4062,10741,5178,1683,5599,10777,5776,11063
ֵֽ´,GuiLinJieDaoBanShiChu,500223001,43054,6040,29620,21043,38209,28617,11200,28733,57350,30674,60294
ֵ´,ZiTongJieDaoBanShiChu,500223002,113119,13655,76190,52648,104212,71423,25751,71118,142541,76335,152525
Ϻ,ShangHeZhen,500223101,13163,2868,9956,7433,19660,9888,4623,10486,20374,10698,20654
,LongXingZhen,500223102,16236,3130,12101,8191,23661,12098,5160,12406,24504,12425,24526
Ϫ,GuXiZhen,500223103,21284,6087,17361,14299,32517,16835,7262,16710,33545,17272,34633
,BaoLongZhen,500223104,9074,2545,7280,5355,13870,7221,2981,7235,14456,7320,14600
Ϫ,YuXiZhen,500223107,9704,2761,8298,7026,15270,8292,3998,8151,16443,8165,16463
,MiXinZhen,500223108,8311,2668,6823,5679,13429,6820,2875,7025,13845,7031,13854
Ⱥ,QunLiZhen,500223109,6676,1902,5337,4208,10517,5229,2373,5411,10640,5614,10951
˫,ShuangJiangZhen,500223110,22992,4950,16511,12841,31406,16251,5829,16813,33064,17260,33771
,HuaYanZhen,500223112,3902,1160,2958,2666,5762,2949,988,3032,5981,3092,6050
,BaiZiZhen,500223113,30614,7095,23889,17769,46333,23555,10170,23500,47055,23990,47879
,ChongKanZhen,500223114,17900,4284,13695,10069,26912,13695,5561,14033,27728,14050,27745
,TangBaZhen,500223115,30673,5680,22358,15064,42063,21503,9032,22145,43648,23027,45385
ʤ,XinShengZhen,500223116,9829,2628,7743,6050,15310,7674,3286,7845,15519,8000,15743
̫,TaiAnZhen,500223117,16696,3151,11900,7872,23247,11825,4411,12200,24025,12358,24258
С,XiaoDuZhen,500223119,17714,4344,13625,10877,26923,13509,5411,13710,27219,13844,27469
Է,WoFoZhen,500223120,14813,3906,11909,9532,23370,11833,5490,12132,23965,12300,24209
,WuGuiZhen,500223121,5016,1401,4170,3215,7869,4159,1924,4138,8297,4171,8341
,TianJiaXiang,500223200,10297,2658,8052,6885,15719,8037,3413,8281,16318,8316,16368
,BieKouXiang,500223203,4865,1504,3865,3423,7544,3845,1510,3953,7798,4014,7879
,ShouQiaoXiang,500223208,3989,1083,3087,2526,6244,3071,1316,3251,6322,3301,6388
ʹֵ,BaChuanJieDao,500224001,60117,7988,41409,26799,57464,38740,12429,36365,75105,39125,80534
ǽֵ,DongChengJieDao,500224002,59537,6706,39873,24150,45070,35871,12478,34671,70542,38848,78721
ϳǽֵ,NanChengJieDao,500224003,36313,5285,25300,16658,34485,22917,7667,21741,44658,23965,49265
,TuQiaoZhen,500224101,8495,2461,6922,5621,12733,6894,2540,6520,13414,6574,13496
ƺ,ErPingZhen,500224103,4981,1501,3822,3661,7545,3819,1324,3943,7762,3984,7806
ˮ,ShuiKouZhen,500224104,3557,1189,2904,2578,5474,2897,983,2793,5690,2825,5729
,AnJuZhen,500224105,13689,4070,10731,9910,19983,10730,3241,10260,20990,10269,21000
,BaiYangZhen,500224106,5765,2017,4658,4318,8850,4646,1502,4581,9227,4626,9284
ƽ̲,PingTanZhen,500224107,19728,4749,15112,11541,29768,15050,6339,15573,30623,15704,30816
ʯ,ShiYuZhen,500224110,9490,2228,6996,5499,13024,6965,2332,6981,13946,7054,14050
,FuGuoZhen,500224111,8116,2237,6054,4847,11685,5994,1808,6001,11995,6107,12161
ά,WeiXinZhen,500224113,6974,2009,5296,4495,10636,5276,1889,5487,10763,5576,10872
¥,GaoLouZhen,500224114,4071,1287,3150,3051,6110,3146,1006,3197,6343,3214,6364
,DaMiaoZhen,500224115,10298,2895,8249,6684,15409,8242,3084,7982,16224,8028,16277
Χ,WeiLongZhen,500224116,9436,2647,7467,5963,13851,7437,2607,7169,14606,7223,14690
,HuaXingZhen,500224117,6020,1666,4537,3645,8647,4497,1630,4660,9157,4779,9316
,YongJiaZhen,500224120,14329,3700,11420,8717,21310,11414,4348,10946,22360,10957,22377
Ϫ,AnXiZhen,500224121,3833,1164,3061,2469,5759,3037,1078,2946,5983,3014,6075
,XiHeZhen,500224122,8107,2010,6300,4825,11434,6291,2450,6201,12492,6267,12567
̫ƽ,TaiPingZhen,500224124,11989,3055,8945,7262,17377,8919,2865,8906,17825,8964,17909
,JiuXianZhen,500224125,20111,5440,15699,12898,29663,15601,5948,15524,31125,15800,31499
,HuFengZhen,500224126,20121,5111,15252,12700,29212,15216,5016,14910,30126,14996,30248
,ShaoYunZhen,500224127,11942,3615,9668,7890,18249,9656,3617,9449,19105,9506,19174
,PuLvZhen,500224128,14774,3724,11273,9050,21864,11264,4221,11405,22669,11446,22719
ٺ,LvFengZhen,500224129,22580,5248,16907,12849,31965,16841,6140,16848,33689,17061,33968
С,XiaoLinXiang,500224201,3946,1343,3311,2718,6532,3307,1464,3412,6719,3442,6753
˫ɽ,ShuangShanXiang,500224202,4344,1445,3643,2967,7079,3633,1540,3658,7291,3686,7329
¡,QingLongXiang,500224205,5868,1583,4539,3651,8719,4533,1636,4533,9066,4548,9087
ڽֵ´,LongGangJieDaoBanShiChu,500225001,55407,6726,37526,22623,60798,35706,12472,34961,70667,37079,74605
ֵ´,TangXiangJieDaoBanShiChu,500225002,50092,5013,33168,18580,50783,30583,11220,30266,60849,33157,66325
ˮ,LongShuiZhen,500225100,91592,10018,59293,37010,98085,56634,19999,59032,115666,62316,121609
Ƿ,ZhiFengZhen,500225101,19007,3638,13945,8821,27166,13787,5822,14289,28076,14522,28467
,BaoDingZhen,500225102,11328,2672,8375,6045,16996,8374,3591,9204,17578,9216,17591
а,ZhongAoZhen,500225103,19441,5222,15465,11513,29464,15387,6455,15591,30978,15653,31118
,SanQuZhen,500225104,18957,4360,13913,10464,26757,13662,5246,14426,28088,14650,28563
,BaoXingZhen,500225105,12552,2636,9126,6324,17748,9112,3775,9810,18922,9837,18963
,YuLongZhen,500225106,11339,1785,7723,4701,14752,7380,2948,7846,15226,8349,16072
ʯ,ShiMaZhen,500225107,16091,2913,10963,7246,22141,10950,3816,11829,22779,11857,22820
ʰ,ShiWanZhen,500225108,10747,2579,7958,6331,15585,7958,2777,8134,16092,8145,16103
,HuiLongZhen,500225109,8003,2178,6391,4742,12595,6366,2793,6550,12916,6583,12974
ɽ,JinShanZhen,500225110,6921,1957,5498,4399,10629,5471,2156,5517,10988,5536,11034
,WanGuZhen,500225111,19280,4469,14346,10876,28082,14303,5122,14421,28724,14525,28871
,GuoLiangZhen,500225112,7090,2102,5553,4524,11220,5551,2200,5833,11384,5839,11392
ӺϪ,YongXiZhen,500225113,9457,2745,7595,5813,14544,7505,3011,7419,14924,7618,15213
Ϫ,ZhuXiZhen,500225114,22779,5044,16489,12356,32158,16453,6290,17521,33974,17624,34113
ʯ,LongShiZhen,500225115,6427,1897,5067,4109,9679,5050,2153,5394,10444,5410,10477
ͤ,YouTingZhen,500225116,30809,5517,21355,15907,41293,21002,8037,21916,42918,23008,44363
ɽ,TieShanZhen,500225117,9933,2653,7764,6043,14824,7750,3083,7865,15615,7905,15669
,GaoShengZhen,500225118,8954,2131,6792,4724,13151,6789,2910,7195,13984,7203,13995
,JiJiaZhen,500225119,7074,1894,5352,4434,10326,5352,1973,5589,10941,5589,10941
,GuLongZhen,500225120,4306,964,3217,2198,6236,3213,1172,3209,6422,3225,6442
ƺ,GaoPingZhen,500225121,8440,2332,6645,5197,13063,6609,2751,6850,13459,6878,13523
Ԫֵ´,ChangYuanJieDaoBanShiChu,500226001,88489,12236,60320,42174,90370,56429,17637,53221,109650,58042,118362
ݽֵ´,ChangZhouJieDaoBanShiChu,500226002,49050,6689,34707,25734,56636,34408,12552,32782,67190,33584,68291
˳ֵ´,GuangShunJieDaoBanShiChu,500226003,35337,6726,24886,16915,43490,22960,7325,21546,44506,24502,49388
˫ӽֵ´,ShuangHeJieDaoBanShiChu,500226004,34099,7182,24341,19670,46025,24217,8130,24108,48325,25070,49411
ֵ´,AnFuJieDaoBanShiChu,500226005,27320,5782,21142,16142,35309,20070,7166,18186,38256,19126,40268
ֵ߽´,FengGaoJieDaoBanShiChu,500226006,21878,4216,15897,12435,30026,15854,5765,15808,31662,15962,31859
ֱ,ZhiShengZhen,500226103,8740,1673,6265,4882,12280,6250,2337,6411,12661,6485,12750
·,LuKongZhen,500226104,7132,1529,5198,4433,10030,5162,1965,5382,10544,5428,10626
彭,QingJiangZhen,500226106,6129,1580,5011,3937,9217,5010,2219,4903,9913,4917,9928
,RenYiZhen,500226107,26045,5356,19537,15504,35097,18719,7463,18560,37279,19327,38864
Ӱ,HeBaoZhen,500226108,18211,4158,13520,10914,25729,13518,5228,14070,27588,14077,27597
Ų,GuChangZhen,500226109,12362,2253,9002,7040,17258,8997,3712,9252,18249,9325,18327
,WuJiaZhen,500226110,23852,4206,17220,13776,32016,17203,6491,17265,34468,17329,34549
ʤ,GuanShengZhen,500226111,8815,1933,6429,5231,12666,6429,2355,6674,13103,6674,13103
ͭ,TongGuZhen,500226112,7466,1566,5427,4718,10597,5425,2190,5787,11212,5795,11222
,QingLiuZhen,500226113,6116,1303,4464,3517,8643,4364,1753,4564,8928,4708,9172
,PanLongZhen,500226114,34206,6998,25381,18922,48625,25371,9973,25773,51144,25796,51177
Զ,YuanJiaoZhen,500226115,6418,1316,4707,3826,9178,4705,1895,4899,9604,4922,9629
,QingShengZhen,500226117,8759,1998,6913,5304,12800,6888,2879,6643,13531,6723,13636
¡,RongLongZhen,500226118,21805,4392,16509,12247,30814,16469,6786,16288,32757,16474,32983
,LongJiZhen,500226119,6404,1568,5011,3833,9462,5010,2139,5053,10063,5100,10111
赳ǽֵ´,BiChengJieDaoBanShiChu,500227001,158188,16819,101531,66878,129893,95426,29695,93332,188758,103171,204702
ֵܽ´,QingGangJieDaoBanShiChu,500227002,58652,8974,38873,28812,60875,36010,10956,36309,72319,39709,78582
,BaTangZhen,500227100,16723,3440,11487,9680,22067,11450,3688,12200,23650,12364,23851
,QiTangZhen,500227101,14192,3495,10275,8894,19416,10231,3498,10760,20991,10910,21185
·,DaLuZhen,500227102,33646,6643,23503,18343,44072,22570,7856,23244,45814,24642,48145
ӱ,HeBianZhen,500227103,13903,3148,9612,7498,18383,9461,2986,9933,19394,10425,20037
»,FuLuZhen,500227104,9207,2358,6544,5516,12882,6531,2021,6990,13521,7042,13586
,DaXingZhen,500227105,26438,6914,19696,16647,37444,19595,6716,20100,39695,20372,40068
,ZhengXingZhen,500227106,18163,4824,13944,11207,26071,13806,4817,13651,27457,13860,27804
,DingJiaZhen,500227107,43131,7769,29899,22941,53324,29793,9685,30477,60270,30686,60585
,GuangPuZhen,500227108,11954,3241,8794,7621,16929,8724,2807,9078,17802,9208,18002
,SanHeZhen,500227109,7516,2063,5425,4608,10743,5417,1757,5868,11285,5911,11336
,JianLongZhen,500227110,12288,3243,8699,7523,17134,8645,2620,9299,17944,9452,18151
ƽɽֵ´,LiangPingXianLiangShanJieDaoBanShiChu,500228001,70504,8550,48716,33217,67296,45307,15008,41982,87289,45346,94062
ƽ˫ֵ´,LiangPingXianShuangGuiJieDaoBanShiChu,500228002,25266,3353,17405,13266,27304,15572,5721,15035,30607,16935,34340
,RenXianZhen,500228101,14703,2504,10642,8792,20611,10614,4292,10817,21431,10857,21499
,LiRangZhen,500228102,13595,2177,9630,6884,19215,9624,4027,10154,19778,10169,19799
,YunLongZhen,500228103,19890,3399,14545,10200,28440,14530,6384,15103,29633,15128,29673
,PingJinZhen,500228104,38694,5698,26778,18743,52361,26019,10747,27679,53698,28361,55139
Ԭ,YuanYiZhen,500228106,13452,2212,9533,7721,18031,9480,4140,10153,19633,10271,19804
ʢ,XinShengZhen,500228107,18703,3006,13281,8728,26922,13277,6032,14458,27735,14460,27741
»,FuLuZhen,500228108,12764,3093,10135,7350,19422,10074,4368,10033,20107,10090,20225
,JinDaiZhen,500228109,7651,1576,5768,4691,11002,5732,2417,5796,11528,5876,11644
ۿ,JuKuiZhen,500228110,22787,3579,15678,11496,32204,15671,6605,17271,32942,17293,32971
,MingDaZhen,500228111,15074,2601,11094,7604,22012,11090,5011,11576,22666,11592,22686
ƽ,YinPingZhen,500228112,12551,2301,9025,6439,17712,9016,3722,9518,18534,9549,18574
,HeLinZhen,500228113,13304,2418,9084,6869,18890,9084,3546,10171,19255,10184,19268
,HuiLongZhen,500228114,20974,3841,15176,11262,30802,15136,7255,16830,31966,16894,32070
ɽ,BiShanZhen,500228115,11567,2390,8812,6013,17092,8803,4145,9277,18080,9290,18102
,HuChengZhen,500228116,14667,4011,11966,9777,23502,11901,5775,12385,24286,12487,24453
,QiXingZhen,500228117,4762,1013,3783,3023,7361,3783,2029,4021,7804,4021,7804
,LongMenZhen,500228118,12917,2372,9294,6182,18711,9294,4091,10084,19378,10086,19380
Ļ,WenHuaZhen,500228119,7832,1558,6004,4470,11670,5992,3045,6412,12404,6431,12435
,HeXingZhen,500228120,11402,2227,8450,6078,16228,8411,3469,8524,16935,8648,17098
ʯ,ShiAnZhen,500228121,5921,2233,5439,4481,10358,5428,2703,5385,10813,5418,10857
ؼ,BaiJiaZhen,500228122,9051,2127,7005,5362,13755,7004,2985,7143,14147,7158,14163
,DaGuanZhen,500228123,6927,1926,5237,4602,10458,5237,1914,5530,10767,5530,10767
ɽ,ZhuShanZhen,500228124,3870,690,2761,2091,5433,2761,1088,2858,5619,2887,5648
,PanLongZhen,500228125,12669,2402,9127,6622,18469,9127,3538,9481,18608,9482,18609
ʤ,AnShengXiang,500228200,5829,1216,4382,3425,8360,4382,1630,4290,8672,4293,8675
,TieMenXiang,500228201,3608,637,2486,1729,5140,2472,967,2686,5158,2726,5212
ʤ,LongShengXiang,500228202,4379,783,3116,2169,6227,3104,1414,3304,6408,3460,6576
ƽ,FuPingXiang,500228203,3729,844,2629,1959,5477,2628,1004,2948,5576,2948,5577
Ƕ,ChengDongXiang,500228204,4173,1112,3231,2916,6313,3230,1234,3265,6495,3288,6519
,ZiZhaoXiang,500228205,5292,1430,4402,3123,8615,4397,2069,4383,8780,4389,8791
Ǳ,ChengBeiXiang,500228206,9656,1929,7034,4920,13829,7016,2721,7231,14247,7272,14306
ˮ,QuShuiXiang,500228207,6404,1818,5241,3971,10034,5240,2137,5112,10352,5118,10359
ƽũ,LiangPingXianNongChang,500228400,716,136,503,443,917,503,144,493,996,493,996
ƽ˫ҵ԰,LiangPingXianShuangGuiGongYeYuanQu,500228401,1434,68,817,419,485,524,201,528,1052,886,1703
ǽֵ´,GeChengJieDaoBanShiChu,500229001,19694,1597,13380,8352,18801,13011,5358,12663,25674,13269,26649
˽ֵ´,FuXingJieDaoBanShiChu,500229002,7469,739,5387,3089,8227,5365,2455,5217,10582,5276,10663
ɽ,BaShanZhen,500229102,7249,929,5239,3248,10452,5221,2642,5548,10769,5581,10820
ƺ,PingBaZhen,500229103,6809,829,5131,3070,9067,5120,2704,5178,10298,5211,10342
,MiaoBaZhen,500229104,6994,1022,5087,3290,9736,5072,2326,5202,10274,5255,10342
ͨ,MingTongZhen,500229105,4226,667,3127,2158,5482,3101,1544,3240,6341,3310,6437
,XiuQiZhen,500229106,8928,1342,6933,4430,12903,6908,3604,6882,13790,6941,13874
߹,GaoGuanZhen,500229107,4900,757,3588,2499,6892,3566,1637,3639,7205,3706,7294
,GaoYanXiang,500229200,7963,1065,5585,3329,10632,5512,2627,5728,11240,6070,11655
,LongTianXiang,500229201,4760,569,3407,2091,6752,3401,1654,3547,6948,3576,6983
,BeiPingXiang,500229202,3180,541,2458,1547,4606,2452,1243,2484,4936,2506,4964
,GaoNanXiang,500229204,3183,474,2517,1565,4884,2496,1442,2527,5023,2582,5099
,ZuoLanXiang,500229205,2997,533,2534,1595,4749,2531,1438,2431,4962,2434,4968
غ,YanHeXiang,500229208,3292,656,2617,1748,4984,2601,1496,2797,5398,2827,5444
˫,ShuangHeXiang,500229210,5016,950,3781,2509,7348,3768,1905,4013,7781,4090,7871
ޤ,LiaoZiXiang,500229211,5691,935,4101,2653,8303,4076,2118,4526,8602,4643,8744
,JiMingXiang,500229212,2328,445,1795,1168,3370,1786,928,1871,3657,1906,3701
,XianYiXiang,500229213,4564,855,3508,2501,6811,3491,1813,3667,7158,3724,7232
Ϫ,ZhouXiXiang,500229214,3079,507,2335,1394,4697,2328,1287,2517,4845,2538,4873
,MingZhongXiang,500229216,2608,480,1954,1359,3952,1940,1085,2174,4114,2219,4173
ƽ,ZhiPingXiang,500229217,2056,379,1617,1147,3098,1600,899,1687,3287,1717,3334
,LanTianXiang,500229219,1798,270,1278,834,2532,1274,576,1349,2623,1366,2644
ƺ,HouPingXiang,500229220,3002,524,2251,1636,4428,2244,1119,2378,4622,2394,4645
,HeYuXiang,500229221,2317,336,1602,1123,3154,1586,729,1742,3328,1780,3382
,DongAnXiang,500229223,4449,721,3368,2516,6618,3349,1664,3423,6772,3466,6834
Ͻֵ,SanHeJieDao,500230001,99717,12927,71424,45456,114905,69501,28310,65966,135467,69530,140954
ɽֵ,MingShanJieDao,500230002,27878,4327,20441,15125,34604,19847,7692,18918,38765,19456,39897
,HuWeiZhen,500230101,10595,2757,8580,6629,16548,8580,3599,8371,16951,8371,16951
̳,SheTanZhen,500230102,21020,4753,16598,11940,32364,16406,7679,16671,33077,16854,33452
Ԫ,SanYuanZhen,500230103,7752,2162,6345,4439,12664,6090,3029,6222,12312,6598,12943
,XuMingSiZhen,500230104,6554,2012,5591,4537,11129,5564,2863,5820,11384,5838,11429
,DongJiaZhen,500230105,11013,3225,9476,7998,18333,9476,4489,9247,18723,9251,18727
,ShuRenZhen,500230106,13596,3385,10258,8275,20683,10164,4028,10557,20721,10751,21009
ʮֱ,ShiZhiZhen,500230107,18579,4244,14244,11274,28619,14075,6262,14643,28718,14841,29085
߼,GaoJiaZhen,500230109,29081,4954,22175,14518,37205,20546,9909,19867,40413,21769,43944
,XingYiZhen,500230110,19697,4224,15179,11195,29221,14460,6708,14822,29282,15450,30629
˫·,ShuangLuZhen,500230111,8857,2077,6966,4853,13536,6802,3341,6801,13603,7309,14275
,JiangChiZhen,500230112,7699,1880,5587,4040,10866,5462,2552,5679,11141,6544,12131
,LongHeZhen,500230113,21476,5411,17528,12345,34400,17202,8814,17863,35065,18173,35701
ƽ,WuPingZhen,500230114,6160,1623,5247,3975,10281,5191,3017,5319,10510,5553,10800
,BaoLuanZhen,500230115,12308,3652,10412,7634,20593,10348,5457,10817,21165,11005,21417
տ,ZhanPuZhen,500230116,5531,1102,3834,2412,7339,3518,1616,3400,6918,4415,8249
,NanTianHuZhen,500230118,6331,1749,5698,3936,11135,5635,3463,5735,11370,5845,11543
,BaoHeZhen,500230119,11182,2964,8967,6653,17766,8954,3966,9103,18057,9145,18112
,XingLongZhen,500230120,7998,1977,6421,4625,12831,6421,3106,6660,13081,6660,13081
ɳ,RenShaZhen,500230121,12297,3180,9700,6304,19884,9306,4577,9633,18939,10354,20054
,LongKongZhen,500230122,11580,2915,9667,7003,19272,9665,4940,9764,19429,9768,19435
,JiLongZhen,500230123,4953,1315,4156,2925,8053,4121,2202,4246,8367,4314,8470
,QingLongXiang,500230202,5246,1484,4624,3570,9247,4624,2597,4699,9323,4703,9327
˫,ShuangLongChangXiang,500230203,6972,2203,6085,4576,12134,5903,3197,5975,11878,6287,12372
̫ƽ,TaiPingBaXiang,500230206,1936,488,1590,1118,3070,1571,833,1616,3187,1667,3257
,DouDuXiang,500230207,2107,494,1662,1234,3254,1662,891,1828,3490,1830,3492
,LiZiXiang,500230209,4878,1192,3902,2823,7604,3804,1872,3892,7696,4040,7942
,SanJianXiang,500230210,5722,1466,4613,3009,8410,4327,2525,4216,8543,5100,9713
,SanBaXiang,500230211,6266,1419,5185,3143,10274,5084,3106,5375,10459,5606,10791
Ϫ,GuiXiZhen,500231100,135769,16102,93817,60620,129382,84266,37109,81406,165672,95163,188980
,XinMinZhen,500231101,17194,3698,14222,8791,26625,13755,7141,13063,26818,13811,28033
ɳƺ,ShaPingZhen,500231102,17573,4226,15578,9789,28752,15407,9129,15015,30422,15350,30928
ܼ,ZhouJiaZhen,500231103,19838,4841,15920,11086,30030,14915,7883,15436,30351,16642,32562
˳,PuShunZhen,500231104,12378,3428,11044,7672,21184,10687,6134,10301,20988,10896,21940
,YongAnZhen,500231105,15130,4544,13102,9297,24975,12798,6716,12819,25617,13288,26390
߰,GaoAnZhen,500231106,31189,5952,24468,15648,46519,22568,12077,22754,45322,24750,49218
߷,GaoFengZhen,500231107,12195,2955,10376,6790,19622,10282,5597,10110,20392,10371,20747
嶴,WuDongZhen,500231108,10062,2387,8484,5948,16146,8248,4741,8392,16640,8706,17190
Ϫ,ChengXiZhen,500231109,25730,4603,20806,11409,39432,17968,10988,17649,35617,20515,41321
̫ƽ,TaiPingZhen,500231110,14226,3510,11892,8467,23143,11383,6657,11352,22735,12501,24393
,HeYouZhen,500231111,8290,1786,6302,3968,10034,5162,2298,5006,10168,6072,12374
ƺɽ,PingShanZhen,500231112,17274,4475,14545,9228,27194,13159,7660,13263,26422,14864,29409
̨,YanTaiZhen,500231113,18927,4072,14634,8654,28874,14354,6696,14531,28885,15061,29695
ܻ,CaoHuiZhen,500231114,12666,3272,10152,7363,20285,10147,5090,10822,20969,10876,21028
ܼ,GangJiaZhen,500231115,11005,3119,9401,6443,18244,9233,4948,9401,18634,9671,19072
,BaoJiaZhen,500231116,8467,2249,6640,4715,13108,6638,2736,6802,13440,6812,13452
׼,BaiJiaZhen,500231117,12124,2961,9534,6400,18516,9427,4048,9442,18869,9599,19133
ƽ,YongPingZhen,500231118,6202,1607,5069,3269,9861,4975,2506,5106,10081,5246,10315
Ϫ,SanXiZhen,500231119,6794,1682,5547,3485,10755,5466,2851,5608,11074,5780,11327
,PeiXingZhen,500231120,5839,2054,5255,3512,10079,5244,2700,5314,10558,5338,10593
,ChangLongXiang,500231201,9916,2319,8288,5463,16021,8288,4370,8313,16601,8317,16605
ɳ,ShaHeXiang,500231202,3688,1106,3098,2258,6080,3041,1434,3028,6069,3130,6228
ʯ,DaShiXiang,500231204,5426,1594,4683,3256,8895,4633,2414,4604,9237,4751,9434
ɳ,HuangShaXiang,500231205,8661,1938,7139,4554,13621,7080,3492,6854,13934,6952,14091
,XiangKouZhen,500232100,56141,7419,38885,24943,64354,37794,14665,38072,75866,39340,78225
¯,HuoLuZhen,500232101,16460,3341,12370,8107,25379,12072,6017,12984,25056,13448,25818
,BaiMaZhen,500232102,17587,3383,12513,8342,22826,11995,4659,12681,24676,13116,25629
Ѽ,YaJiangZhen,500232103,12895,3314,9617,7080,18319,9201,3427,9538,18739,10019,19636
,ChangBaZhen,500232104,10179,2442,7583,5444,14461,7253,2665,7304,14557,7703,15286
,JiangKouZhen,500232105,14068,2052,10018,6764,19105,9921,4709,10461,20382,10811,20829
ƽ,PingQiaoZhen,500232106,9850,2343,7276,5404,14007,7099,2733,7263,14362,7650,14926
,YangJiaoZhen,500232107,9642,2162,7190,5006,14285,7143,2855,7366,14509,7469,14659
Ůɽ,XianNvShanZhen,500232108,9227,1820,6508,3965,12805,6219,2761,6951,13170,7300,13808
ͩ,TongZiZhen,500232109,5557,1296,4363,3199,8684,4359,2043,4507,8866,4533,8896
,TuKanZhen,500232110,5533,982,4051,2741,7802,4045,1613,4062,8107,4077,8128
˳,HeShunZhen,500232111,8100,1617,5552,4262,11214,5526,2182,6272,11798,6347,11899
,FengLaiXiang,500232200,6828,2077,5406,4099,10802,5400,2131,5594,10994,5630,11036
,MiaoYaXiang,500232202,5428,1705,4308,3279,8517,4308,1619,4441,8749,4444,8752
ʯ,ShiQiaoMiaoZuTuJiaZuXiang,500232203,5360,1025,4140,2877,7919,4140,1766,4011,8151,4011,8151
˫,ShuangHeXiang,500232204,6349,1400,4572,3024,9441,4544,2077,5219,9763,5254,9826
ݺ,HuangYingXiang,500232205,5113,1198,3836,2639,7750,3822,1644,4031,7853,4119,7955
׹,CangGouXiang,500232206,5300,1140,3952,2607,8181,3898,2057,4456,8354,4545,8497
ĸ,WenFuMiaoZuTuJiaZuXiang,500232207,4307,955,3345,2258,6567,3319,1664,3473,6792,3581,6926
,TuDiXiang,500232208,3372,735,2618,1923,5238,2618,1326,2815,5433,2815,5433
,BaiYunXiang,500232209,3474,895,2689,1932,5156,2675,1088,2739,5414,2768,5457
ƺ,HouPingMiaoZuTuJiaZuXiang,500232210,2855,775,2368,1701,4746,2356,1223,2434,4790,2485,4853
ƿ,HaoKouMiaoZuYiLaoZuXiang,500232211,3700,587,2637,1675,5284,2627,1188,2799,5426,2838,5475
,JieLongXiang,500232212,2454,731,1939,1430,3968,1937,927,2156,4093,2173,4112
Լ,ZhaoJiaXiang,500232213,2320,623,1721,1196,3500,1697,673,1808,3505,1895,3616
,TieKuangXiang,500232214,2133,469,1571,1081,3084,1561,608,1587,3148,1639,3210
,ZhongZhouZhen,500233100,98017,13781,69569,47975,106070,66272,25669,64070,130342,67898,137467
,XinShengZhen,500233101,16426,3165,12254,8728,24362,12254,5380,12715,24969,12717,24971
μ,RenJiaZhen,500233102,10467,2170,7941,5021,15906,7939,3590,8277,16216,8286,16227
,WuYangZhen,500233103,24617,5080,18017,13489,35841,17564,7036,18085,35649,18716,36733
,YangDuZhen,500233104,11979,2992,9622,6280,18445,9411,4338,9372,18783,9687,19309
Ϫ,DongXiZhen,500233105,11751,2681,8907,7530,17347,8872,3432,8865,17737,8957,17864
,FuXingZhen,500233106,8966,1890,6575,4700,12855,6574,2530,6808,13382,6811,13386
ʯ,ShiBaoZhen,500233107,24328,4791,18164,12340,34935,17689,6743,17091,34780,17698,35862
Ϫ,RuXiZhen,500233108,22118,4527,16603,10881,32534,16267,7420,17013,33280,17462,34065
Ұ,YeHeZhen,500233109,13037,2895,9704,6384,19734,9673,4032,10182,19855,10260,19964
ٰ,GuanBaZhen,500233110,21504,4894,16531,9890,32854,16503,6951,16759,33262,16818,33349
ʯ,ShiHuangZhen,500233111,8061,1801,5830,3767,11674,5829,1986,6017,11846,6018,11848
,MaGuanZhen,500233112,22686,5683,17195,13465,33720,17161,6079,17199,34360,17253,34448
,JinJiZhen,500233113,10709,3047,8493,6590,16849,8493,3655,8916,17409,8918,17411
,XinLiZhen,500233114,20708,5192,16203,12203,31112,15761,6396,15696,31457,16093,32296
˫,ShuangGuiZhen,500233115,12244,2795,9179,5958,18315,9178,3581,9441,18619,9441,18620
ɽ,BaShanZhen,500233116,32465,6577,23605,15469,44267,22155,8935,22719,44874,24372,47977
,HuaQiaoZhen,500233117,13501,3040,9854,6705,19682,9792,3576,10149,19941,10263,20117
,YongFengZhen,500233118,12388,2474,9041,6018,17644,8956,3190,8861,17817,9011,18052
,SanHuiZhen,500233119,16224,4511,13017,8926,24558,12395,5213,12305,24700,12931,25948
ʯ,BaiShiZhen,500233120,20342,4937,15851,11971,31125,15813,6745,16051,31864,16173,32024
ƽ,HuangJinZhen,500233122,23422,4592,17219,11971,34743,17213,7064,17834,35047,17859,35078
ƹ,ShanGuangXiang,500233201,6453,1499,5317,3752,10155,5310,2571,5199,10509,5206,10523
ʯ,ShiZiXiang,500233203,3859,726,2772,1918,5569,2760,1188,2925,5685,3001,5773
ĥ,MoZiTuJiaZuXiang,500233204,9909,2297,7262,5311,14967,7205,2918,7806,15011,7862,15124
Ϳ,TuJingXiang,500233206,9869,2585,8053,5281,15795,8040,3564,7932,15972,7965,16018
,JinShengXiang,500233208,5862,1593,4755,3488,9571,4755,2235,4930,9685,4935,9690
˷,XingFengXiang,500233210,7706,1440,5445,3522,11144,5443,2134,5824,11267,5835,11280
򶫽ֵ´,ZhenDongJieDaoBanShiChu,500234002,12839,1999,9579,7432,15042,9576,3981,9227,18803,9240,18819
ֵֽ´,FengLeJieDaoBanShiChu,500234003,13483,1913,10284,6950,15263,10268,4455,9543,19811,9567,19851
׺׽ֵ´,BaiHeJieDaoBanShiChu,500234004,26329,5153,20469,14429,39179,19931,9455,19725,39656,20468,40937
ֵ´,HanFengJieDaoBanShiChu,500234005,61833,6868,42985,26493,56099,41430,16406,40179,81609,42122,85107
ķֵ´,WenFengJieDaoBanShiChu,500234006,51250,5957,35337,22492,49666,33793,12540,33191,66984,34410,69747
Ʒֵ´,YunFengJieDaoBanShiChu,500234007,32293,3037,21278,12113,23682,17283,6344,17129,34412,20396,41674
Լҽֵ´,ZhaoJiaJieDaoBanShiChu,500234008,23712,6111,19622,15921,38455,19133,10087,19748,38881,20288,39910
,GuoJiaZhen,500234103,20609,3739,15233,10903,29203,15038,7046,15698,30736,16161,31394
Ȫ,WenQuanZhen,500234106,25763,4537,19281,13328,35913,18405,9102,18803,37208,20121,39402
,TieQiaoZhen,500234107,27580,5062,20673,14461,40192,20059,9443,20666,40725,21412,42085
,NanYaZhen,500234112,17978,3795,13911,10871,27967,13901,6609,14437,28338,14471,28382
ǫ,HeQianZhen,500234114,14181,2288,9922,7196,19078,9756,4163,10303,20059,10710,20632
,ZhenAnZhen,500234116,9067,2177,7742,6366,14655,7683,4208,7537,15220,7710,15452
Ϫ,ZhuXiZhen,500234118,12946,3404,11484,9551,22416,11461,6550,11320,22781,11416,22900
,QuKouZhen,500234119,8944,2272,7105,5592,14032,6817,3221,6800,13617,7332,14437
,HouBaZhen,500234120,11027,2421,8642,6531,17077,8481,3910,8478,16959,8716,17358
,GaoQiaoZhen,500234122,14902,2502,11593,8364,23175,11462,6204,11754,23216,12015,23608
,YiHeZhen,500234127,16821,3364,12646,9205,25816,12575,6128,13488,26063,13667,26313
,DaJinZhen,500234128,20605,3542,15512,11543,31101,15396,8066,16434,31830,16701,32213
ɳ,ChangShaZhen,500234129,29368,6971,23561,19071,44159,22338,10831,22194,44532,23609,47170
ٽ,LinJiangZhen,500234130,44473,8546,36013,27315,66393,34813,18130,33938,68751,35136,71149
غ,DunHaoZhen,500234132,23690,4296,17869,12959,34775,17502,8877,18147,35649,18994,36863
к,ZhongHeZhen,500234133,26818,5614,21285,15188,41989,21099,10886,21833,42932,22033,43318
Ϫ,YueXiZhen,500234134,26197,7315,23767,19435,46452,23640,14290,23824,47464,24035,47802
,NanMenZhen,500234135,23324,6380,20109,16218,40563,19573,11237,19970,39543,20832,40941
,HeYanZhen,500234136,11644,2613,9603,7164,18731,9499,5332,9728,19227,9986,19589
ɽ,JiuLongShanZhen,500234137,19480,4536,16335,12835,31870,16056,8680,15762,31818,16361,32696
,BaiQiaoZhen,500234138,7786,2351,6867,5595,13274,6828,3659,6814,13642,6929,13796
,TianHeZhen,500234139,9729,1622,7199,4765,14372,6911,3467,7056,13967,7619,14818
,JinFengZhen,500234140,8098,2368,6561,5732,13101,6496,2889,6678,13174,6794,13355
̷,TanJiaZhen,500234141,9780,1805,7495,5652,14725,7494,3676,7765,15259,7766,15261
ɽ,WuShanZhen,500234142,12495,2906,9565,8118,19399,9545,4428,10148,19693,10264,19829
,DaDeZhen,500234143,19106,4681,16200,12135,30924,15912,7761,14843,30755,15348,31548
Ȫ,BaiQuanXiang,500234202,5067,784,3956,2392,7901,3941,2378,4217,8158,4273,8229
,GuanMianXiang,500234203,4398,801,3359,2548,6762,3357,1928,3754,7111,3768,7127
,ManYueXiang,500234204,6361,1092,4888,3300,9595,4886,2604,5098,9984,5169,10057
ͨ,WuTongXiang,500234211,3256,981,2717,2160,5424,2695,1293,2737,5432,2813,5530
,MaLiuXiang,500234215,10557,2257,8407,6583,17200,8405,4637,9029,17434,9044,17451
ˮ,ZiShuiXiang,500234216,13103,2412,9945,6719,20025,9865,4881,10202,20067,10451,20396
,SanHuiKouXiang,500234225,7779,1982,6491,5027,12896,6461,3429,6639,13100,6699,13190
˫ֵ´,ShuangJiangJieDaoBanShiChu,500235001,57163,6585,39926,24181,49777,37369,13666,36362,73731,37488,77414
ֵ´,QingLongJieDaoBanShiChu,500235002,69860,8136,47568,30088,69963,45982,16901,45047,91029,47329,94897
,LongJiaoZhen,500235105,8439,1774,6335,5291,12294,6309,2861,6665,12974,6739,13074
,GuLingZhen,500235107,10335,2021,8828,6725,16010,8705,4641,7971,16676,8169,16997
ʨ,HongShiZhen,500235108,17354,2625,12086,9036,24635,11951,5041,12707,24658,12934,25020
·,LuYangZhen,500235115,7938,2414,6836,5477,13365,6759,3243,6689,13448,6759,13595
ũ,NongBaZhen,500235116,7915,1970,6908,5091,13189,6862,3856,6738,13600,6833,13741
,QuMaZhen,500235118,6377,1642,5392,4531,10338,5385,2625,5231,10616,5252,10644
ʯ,HuangShiZhen,500235121,5497,1387,4361,3582,8459,4340,1894,4376,8716,4417,8778
,BaYangZhen,500235122,6885,1869,5417,4744,10576,5416,2086,5357,10773,5423,10840
ɳ,ShaShiZhen,500235123,8438,1814,6434,5364,12913,6399,2925,6687,13086,6743,13177
Ȫ,YuQuanZhen,500235124,7977,2284,6771,5867,12910,6769,3241,6730,13499,6731,13502
,FengMingZhen,500235125,28475,6365,22399,16045,40520,20319,10006,20408,40727,22447,44846
,PanLongZhen,500235126,19662,4630,15284,12281,28596,14996,6317,14829,29825,15325,30609
ƺ,BaoPingZhen,500235127,12128,3534,9712,8322,19330,9668,4066,9951,19619,10016,19728
Ϫ,NanXiZhen,500235128,55228,9788,41561,31467,79342,40517,17714,39982,80499,41169,82730
˫,ShuangTuZhen,500235129,11554,2995,9459,7201,18624,9271,4512,9261,18532,9602,19061
ɣƺ,SangPingZhen,500235130,10869,2689,9145,7892,18005,9113,4748,9091,18204,9161,18306
,JiangKouZhen,500235131,59772,8626,44918,30649,83926,43331,20583,41787,85118,44063,88981
,GaoYangZhen,500235132,14692,3564,11558,9453,21302,11052,5083,11148,22200,11781,23339
ƽ,PingAnZhen,500235133,16581,3716,12712,9766,25256,12196,5858,12587,24783,13443,26155
˺,RenHeZhen,500235134,20557,3776,15074,11061,29009,14771,6065,15020,29791,15324,30398
,YunYangZhen,500235135,10846,2564,8407,7579,15969,8355,3607,8400,16755,8610,17017
ư,YunAnZhen,500235136,8765,2186,6844,6414,13233,6829,2622,6691,13520,6729,13573
ϼ,QiXiaZhen,500235137,8273,1687,6423,5409,12490,6423,2816,6353,12776,6353,12776
˫,ShuangLongZhen,500235138,10845,3015,9390,7548,18600,9367,5064,9491,18858,9534,18924
,WaiLangXiang,500235208,3252,1136,2705,2356,5453,2692,1169,2827,5519,2852,5557
Ϫ,NiXiXiang,500235209,5191,1612,4360,3796,8834,4355,2204,4635,8990,4647,9007
ҫ,YaoLingXiang,500235210,4469,1155,3797,2744,7414,3795,2167,3976,7771,3994,7791
Ʊ,PiaoCaoXiang,500235213,8644,2134,7297,5267,14276,7227,3859,7220,14447,7340,14637
ƺ,YanPingXiang,500235214,6429,990,4689,3109,9349,4654,2351,4996,9650,5081,9770
½,XinJinXiang,500235215,3632,1090,3448,2753,6342,3447,1783,3055,6502,3057,6505
հ,PuAnXiang,500235216,4381,1225,3781,3182,7186,3766,1834,3593,7359,3659,7440
,LongDongXiang,500235217,13691,1819,9853,5939,19482,9849,4679,10316,20165,10336,20189
¹,DongLuXiang,500235218,5175,1179,4011,2999,7997,3955,1853,4101,8056,4196,8207
ʯ,ShiMenXiang,500235219,3209,771,2577,2261,5086,2572,1280,2644,5216,2683,5260
,DaYangXiang,500235220,5339,1255,4231,3478,8502,4198,2008,4257,8455,4371,8602
Ҷ,HouYeXiang,500235229,7845,1423,5962,4148,11956,5945,2723,5990,11935,6029,11991
¹,YangLuXiang,500235235,7006,1903,5987,5029,11418,5981,3078,5973,11954,6000,11987
ˮ,ShuiKouXiang,500235236,6254,1473,4877,3946,9037,4854,2187,4949,9803,5037,9914
ϰ,ShangBaXiang,500235239,4344,1123,3292,2717,6697,3272,1425,3549,6821,3600,6892
ˮ,QingShuiTuJiaZuZiZhiXiang,500235242,6680,1523,5504,4097,10390,5479,2838,5403,10882,5537,11041
,YongAnZhen,500236116,105102,10107,72234,45395,90045,70324,29105,70081,140405,72080,144314
׵,BaiDiZhen,500236117,20878,2765,14629,10539,28157,14609,6608,15559,30168,15622,30251
,CaoTangZhen,500236118,19624,3083,14272,9574,28633,14167,6940,15117,29284,15375,29647
ں,FenHeZhen,500236119,22131,3008,14990,10847,29323,14811,6920,16075,30886,17069,32059
,KangLeZhen,500236120,24863,3417,17067,13031,33072,16719,7241,17982,34701,18454,35521
,DaShuZhen,500236121,14740,2666,10506,8746,21389,10497,4387,11270,21767,11287,21793
԰,ZhuYuanZhen,500236122,26161,3943,19399,14736,36407,19317,9234,19712,39029,19939,39338
ƽ,GongPingZhen,500236123,25917,4359,19000,14984,34478,17948,8576,18169,36117,19852,38852
,ZhuYiZhen,500236124,39901,4405,27187,18677,49422,25645,11321,26776,52421,28440,55627
׸,JiaGaoZhen,500236125,14420,3032,11978,10145,23912,11975,6955,12400,24375,12429,24407
,YangShiZhen,500236126,5868,1314,4945,4047,9684,4943,2845,5070,10013,5082,10027
,TuXiangZhen,500236127,27126,4912,20236,14934,39082,19576,8973,20061,39637,20775,41011
¡,XingLongZhen,500236128,27485,4914,20477,15079,38540,20404,9012,20782,41186,20934,41411
,QingLongZhen,500236129,9363,2217,7416,6267,14611,7399,3755,7757,15156,7919,15335
,XinMinZhen,500236130,14185,2661,10205,8150,21048,10133,5066,11561,21694,11707,21912
,YongLeZhen,500236131,14863,2555,10795,8157,21492,10779,5016,11601,22380,11639,22434
ƺ,AnPingXiang,500236132,15850,2790,12148,9274,24166,12142,6127,12593,24735,12619,24767
,WuMaXiang,500236133,16114,3531,12343,9013,25540,12314,6274,13517,25831,13576,25919
,YanWanXiang,500236265,5859,926,4112,2880,8563,4104,1897,4497,8601,4570,8682
ƽ,PingAnXiang,500236266,8537,1901,6591,4934,12705,6564,2723,6482,13046,6570,13161
,HongTuXiang,500236267,9043,2112,7264,6278,14093,7259,3328,7195,14454,7219,14483
,XinZhengXiang,500236268,18025,3575,12955,10492,25751,12884,5369,13533,26417,14014,26969
ʯ,ShiGangXiang,500236269,15057,2867,10603,8933,21892,10559,4202,11435,21994,11523,22126
ƺ,KangPingXiang,500236270,5601,878,4212,3156,8314,4211,2002,4268,8479,4269,8481
̫,TaiHeTuJiaZuXiang,500236272,6569,1306,4775,3600,9419,4738,1909,4946,9684,5009,9784
׷,HeFengXiang,500236274,6518,1476,5106,3866,10079,5072,2620,5445,10517,5508,10614
ƺ,FengPingXiang,500236275,9700,1806,7322,4953,14974,7275,3991,8082,15357,8175,15497
,ChangAnTuJiaZuXiang,500236276,7935,1400,5760,3867,11440,5736,2641,6138,11874,6216,11976
,LongQiaoTuJiaZuXiang,500236277,5816,1076,4273,3063,8102,4259,1717,4306,8565,4336,8609
,YunWuTuJiaZuXiang,500236278,2144,466,1583,1080,3144,1575,677,1678,3253,1704,3287
׵۳Ƿ羰ίԱ,BaiDiChengFengJingQuGuanLiWeiYuanHui,500236400,18701,2422,12988,8617,21120,11940,4842,11902,23842,12977,25965
Ͽ,WuXiaZhen,500237100,73969,6473,49311,30177,74875,46011,18301,46245,92256,49432,98743
,MiaoYuZhen,500237101,22602,3822,16852,11683,33697,16830,8489,18030,34860,18061,34913
,DaChangZhen,500237102,23819,4282,18281,12519,32620,17283,8116,16958,34241,17936,36217
,FuTianZhen,500237103,20921,3582,15955,11613,29310,15938,7837,16332,32270,16385,32340
Ϫ,LongXiZhen,500237104,9997,1882,8118,5277,15590,8104,4425,8165,16269,8186,16304
˫,ShuangLongZhen,500237105,11717,2645,9275,6902,17897,9263,4284,9335,18598,9371,18646
,GuanYangZhen,500237106,10062,1685,7308,4435,14414,7195,3015,7266,14461,7454,14762
ƺ,LuoPingZhen,500237107,16737,2471,11573,8197,23724,10849,5651,12399,23248,13286,24859
,BaoLongZhen,500237108,12921,2919,9370,8303,18964,9314,3632,9924,19238,10102,19472
ٶ,GuanDuZhen,500237109,28930,5279,20743,15575,40859,19829,8557,20853,40682,22023,42766
ͭ,TongGuZhen,500237110,12061,2447,9009,6880,18016,8986,4082,9548,18534,9581,18590
촻,HongChunTuJiaZuXiang,500237200,3411,540,2244,1525,4799,2229,1029,2680,4909,2736,4980
,LongJingXiang,500237205,13326,1732,9178,6906,18338,9178,4072,9948,19126,9952,19130
ƺ,LiangPingXiang,500237207,11181,1628,7749,5445,15832,7688,3985,8822,16510,9045,16794
,QuChiXiang,500237208,9024,1305,5978,4173,12440,5970,2399,6740,12710,6750,12728
ƽ,JianPingXiang,500237210,7054,1255,4915,3355,10110,4915,2155,5549,10464,5549,10464
Ϫ,DaXiXiang,500237211,4869,790,3456,2418,7003,3439,1662,3819,7258,3865,7321
ƺ,JinPingXiang,500237214,1936,429,1385,1065,2832,1372,589,1533,2905,1569,2954
ƽ,PingHeXiang,500237216,6620,1354,4926,3422,9514,4898,2016,4988,9886,5064,9990
,DangYangXiang,500237219,3484,669,2520,1706,4737,2464,1007,2522,4986,2640,5160
,ZhuXianXiang,500237222,2635,531,1847,1351,3850,1840,762,2061,3901,2081,3928
Ϫ,SanXiXiang,500237225,13063,1992,8882,6626,18204,8881,3906,10041,18922,10079,18961
ʯ,PeiShiXiang,500237227,4158,861,3167,2541,6204,3158,1441,3280,6438,3293,6460
ƺ,DuPingXiang,500237229,10650,1548,6589,5030,13602,6528,2767,7396,13924,8376,14965
˼,DengJiaTuJiaZuXiang,500237231,2530,431,1648,1256,3299,1637,664,1815,3452,1977,3625
,ChengXiangZhen,500238100,65440,6890,44503,28779,62580,40413,16750,40456,80869,44577,89080
,FengHuangZhen,500238101,9981,1823,7220,5160,13920,7139,2770,7246,14385,7354,14574
,NingChangZhen,500238102,3451,715,2356,2349,4874,2343,902,2670,5013,2712,5068
ϻ,ShangHuangZhen,500238103,17030,2628,12833,8892,23512,12258,5990,12133,24391,12815,25648
·,GuLuZhen,500238104,14545,2651,11138,7822,21246,11004,5135,10926,21930,11193,22331
ķ,WenFengZhen,500238105,22030,3475,15614,10416,29958,15164,5833,15152,30316,15724,31338
,XuJiaZhen,500238106,9507,1312,6630,4779,12541,6561,2642,6677,13238,6831,13461
¹,BaiLuZhen,500238107,9983,1628,7397,5253,14367,7366,3259,7425,14791,7473,14870
ɽ,JianShanZhen,500238108,11786,2064,8501,6169,15349,7643,3484,7949,15592,8833,17334
±,XiaBaoZhen,500238109,10238,1554,6679,4957,14061,6613,2666,7624,14237,7779,14458
,FengLingZhen,500238110,9891,1882,8032,5720,15140,8032,3744,7485,15517,7485,15517
,TangFangZhen,500238111,11669,2122,8648,5787,16616,8615,3274,8371,16986,8417,17065
,ZhaoYangZhen,500238112,9329,1701,6504,4767,13214,6448,2494,6897,13345,7020,13524
,TianBaZhen,500238113,6050,1337,4530,3622,9159,4444,2181,4839,9283,5038,9568
ͨ,TongChengZhen,500238114,7752,1628,5669,4503,11161,5664,2361,6062,11726,6072,11741
ʤ,ShengLiXiang,500238204,5001,1073,3621,2785,7039,3608,1254,3670,7278,3707,7328
,LingJiaoXiang,500238205,8840,1916,6839,5023,12889,6760,2608,6428,13188,6525,13364
,DaHeXiang,500238207,5743,965,3917,3014,8089,3917,1633,4409,8326,4424,8341
,TianXingXiang,500238208,2282,444,1415,1248,2987,1387,395,1645,3032,1706,3121
,ChangGuiXiang,500238210,3348,575,2204,1524,4606,2162,847,2457,4619,2566,4770
,PuLianXiang,500238212,5934,1188,4782,3312,8900,4768,2321,4567,9335,4661,9443
,YuLinXiang,500238226,3713,584,2533,2034,5160,2515,1039,2775,5290,2803,5336
,WuLongXiang,500238227,3996,761,2879,2143,5656,2853,1236,3056,5909,3114,5993
и,ZhongGangXiang,500238234,9291,1801,6984,4571,14297,6903,3475,7411,14314,7583,14567
̨,HuaTaiXiang,500238237,3078,669,2568,1798,4764,2520,1281,2362,4882,2460,5028
Ӣ,LanYingXiang,500238239,1790,357,1238,918,2563,1230,520,1409,2639,1429,2667
˫,ShuangYangXiang,500238240,1463,294,998,783,2084,993,354,1099,2092,1113,2111
,ZhongLiangXiang,500238242,2579,477,1819,1280,3403,1769,805,1811,3580,2042,3861
Ԫ,TianYuanXiang,500238243,3686,734,2724,2144,5490,2713,1243,2918,5631,2939,5663
,TuChengXiang,500238245,3818,1024,3125,2321,6012,3092,1403,3058,6150,3120,6245
ذӾÿ,HongChiBaJingJiKaiFaQu,500238400,513,61,303,193,502,279,84,313,592,355,658
ϱ,NanBinZhen,500240100,84402,9787,58854,35878,85042,53774,24408,52986,106760,59743,118597
,XiDuoZhen,500240101,17610,2886,13121,9711,22202,11804,5089,11226,23030,12464,25585
·,XiaLuZhen,500240102,15703,3789,12806,9230,24525,12500,6808,12475,24975,13494,26300
,YueLaiZhen,500240103,7457,1562,6213,4719,11595,6066,3279,5890,11956,6085,12298
Ϫ,LinXiZhen,500240104,8921,2598,7943,6514,15066,7875,4350,7760,15635,7926,15869
ˮ,HuangShuiZhen,500240105,9800,1176,6169,4558,12325,5800,2587,6253,12053,7394,13563
,MaWuZhen,500240106,5118,1221,4187,3321,8135,4115,2307,4241,8356,4459,8646
ɳ,ShaZiZhen,500240107,9195,1431,5697,4013,11096,5480,2712,5775,11255,7641,13338
,WangChangZhen,500240108,5661,1855,5327,4783,10071,5227,2781,4819,10046,4970,10297
Ϫ,YanXiZhen,500240109,7821,2042,6660,5664,13068,6630,3296,6411,13041,6499,13159
ɳ,LongShaZhen,500240110,5240,1490,4910,3889,9302,4844,2918,4637,9481,4738,9648
,YuChiZhen,500240111,6369,1366,5279,3811,9945,5250,2872,5244,10494,5328,10607
Ъ,DaXieZhen,500240200,9086,2391,7690,5709,14821,7609,3989,7622,15231,7776,15466
,SanHeZhen,500240201,10459,2228,8499,6075,16489,8350,4648,8358,16708,8836,17335
,WanChaoZhen,500240202,7125,1639,5719,4727,10306,5629,2954,5507,11136,5999,11718
賡,LiChangXiang,500240203,4236,1401,4076,3508,7913,4069,2306,3769,7838,3867,7943
,SanXingXiang,500240204,4365,1446,3765,3407,7551,3699,1914,3837,7536,3960,7725
,LiuTangXiang,500240205,5236,1294,4218,3134,8506,4130,2258,4387,8517,4570,8788
ͷ,QiaoTouZhen,500240206,4262,1258,3828,2987,7547,3616,2224,3582,7198,3916,7744
,SanYiXiang,500240207,1588,527,1445,1359,2804,1412,859,1466,2878,1529,2974
,WangJiaXiang,500240208,3114,954,2780,2433,5447,2780,1435,2723,5503,2723,5503
,HeZuiXiang,500240209,3712,1224,3392,2765,6630,3378,1851,3357,6735,3395,6787
ʯ,ShiJiaXiang,500240210,3967,839,3119,2547,6164,3116,1506,3181,6297,3193,6312
ˮ,LengShuiZhen,500240211,4191,660,2851,1799,5655,2808,1383,3104,5912,3383,6234
ľ,FengMuXiang,500240212,6336,1001,4633,2939,8952,4548,2277,4678,9226,4981,9614
,ZhongYiXiang,500240213,3182,851,2614,2329,5272,2585,1401,2764,5349,2820,5434
ϴ,XiXinXiang,500240214,2069,528,1666,1303,3407,1656,944,1831,3487,1875,3541
ƺ,HuangHeXiang,500240215,2217,445,1833,1387,3255,1793,1078,1841,3634,1907,3740
̶,LongTanXiang,500240216,2160,527,1686,1217,3277,1665,823,1734,3399,1824,3510
,XinLeXiang,500240217,2101,401,1544,1108,3024,1527,754,1595,3122,1712,3256
,JinLingXiang,500240218,1448,336,1131,875,2216,1116,590,1196,2312,1243,2374
,JinZhuXiang,500240219,736,151,529,411,1077,522,258,567,1089,616,1145
к,ZhongHeZhen,500241100,77543,7824,52578,28318,85090,49434,19636,49166,98600,52425,105003
ƽ,PingKaiZhen,500241101,21271,2850,15178,8702,27609,15078,6837,15554,30632,15780,30958
Ϫ,QingXiChangZhen,500241102,28493,5280,22589,13772,43911,22392,11565,22244,44636,22749,45338
,AiKouZhen,500241103,8646,1911,7308,4571,14495,7299,4399,7603,14902,7648,14956
Ϫ,RongXiZhen,500241104,13363,2003,9877,6063,19441,9835,5082,10444,20279,10571,20448
ׯ,GuanZhuangZhen,500241105,19512,3159,13979,7999,27884,13824,6134,14559,28383,14826,28805
,LongChiZhen,500241106,13623,2642,10614,6473,20469,10544,5270,10771,21315,10921,21535
ʯ,ShiDiZhen,500241107,4423,829,3577,2218,6388,3568,1906,3494,7062,3581,7158
,ERongZhen,500241108,11493,1844,8745,4900,17388,8730,4923,9489,18219,9515,18260
鰲,HongAnZhen,500241109,7952,1405,6068,3320,11629,5935,3023,6108,12043,6312,12380
Ž,YaJiangZhen,500241110,7657,1473,5668,3665,11498,5645,2806,6176,11821,6268,11936
ʯҮ,ShiYeZhen,500241111,6066,923,4463,2587,8699,4443,2080,4545,8988,4606,9069
÷,MeiJiangZhen,500241112,15924,3133,12527,7755,24911,12437,6594,12884,25321,13124,25651
,LanQiaoZhen,500241113,7245,1411,5950,3786,11955,5949,3479,6179,12128,6185,12135
,GuanZhouXiang,500241200,4603,826,3341,2284,6729,3334,1549,3624,6958,3637,6978
ТϪ,XiaoXiXiang,500241201,5879,1156,4387,3036,8979,4371,2379,4837,9208,5027,9414
,TangAoXiang,500241202,4991,1000,3965,2711,8036,3963,2223,4226,8189,4249,8214
,GaoTianXiang,500241203,8987,1334,6294,3671,12566,6173,3287,6771,12944,7314,13608
Ϫ,XiKouXiang,500241204,8266,1507,6349,4155,12601,6274,3286,6567,12841,6710,13059
Ȫ,MiaoQuanXiang,500241205,4217,913,3437,2212,6601,3407,1744,3346,6753,3437,6874
ũ,SongNongXiang,500241206,3274,798,2561,1944,5040,2558,1255,2709,5267,2766,5327
,HaiYangXiang,500241207,3297,637,2618,1697,5236,2617,1418,2733,5350,2734,5352
Ϫ,DaXiXiang,500241208,3602,752,2977,2151,5814,2957,1602,2895,5852,2979,5956
,BaoAnXiang,500241209,4066,964,3542,2405,6837,3537,1964,3448,6985,3452,6994
,LiRenXiang,500241210,4441,968,3591,2324,6980,3558,1836,3579,7137,3654,7245
ӿ,YongDongXiang,500241211,4778,1044,3631,2326,7502,3588,1821,3901,7489,4012,7643
ɴ,GanChuanXiang,500241212,2064,526,1544,1237,3193,1544,689,1734,3278,1735,3279
ƽ,PingMaXiang,500241213,3471,794,2870,1854,5652,2826,1590,2931,5757,2985,5855
ƽ,ZhongPingXiang,500241214,3566,846,2931,1991,5838,2910,1591,3012,5922,3072,6003
Ϫ,CenXiXiang,500241215,3479,782,2685,1965,5459,2684,1350,2926,5610,2926,5611
,ZhongLingXiang,500241216,10161,2021,7832,5374,15855,7818,4348,8604,16422,8698,16530
ͼ,BaJiaXiang,500241217,2434,433,2010,1198,3860,1995,1149,1969,3964,2006,4016
Ӷ,ZhongDuoZhen,500242100,64833,6752,46242,28129,75037,43123,22343,44502,87625,47686,93928
̶,LongTanZhen,500242101,30751,4565,23266,15217,43346,22197,12090,22768,44965,24140,47406
,MaWangZhen,500242102,20235,3844,16216,11136,32546,16135,9377,17098,33233,17240,33456
ϳ,YouChouZhen,500242103,11000,2053,8667,6050,16957,8457,4710,8824,17281,9096,17763
Ϫ,DaXiZhen,500242104,8139,1317,6613,4622,12816,6611,3867,6709,13320,6710,13323
¡,XingLongZhen,500242105,6802,1645,5621,4233,11203,5621,3096,5920,11541,5922,11543
ˮ,HeiShuiZhen,500242106,10144,2289,8302,6183,16073,8222,4747,8737,16959,8878,17180
,DingShiZhen,500242107,11505,2336,9501,6356,18733,9152,5702,9834,18986,10042,19543
̲,GongTanZhen,500242108,10677,1932,8482,5605,16479,8303,4639,8440,16743,8766,17248
Ϫ,LiXiZhen,500242109,14171,2892,11903,8513,23349,11860,7366,12420,24280,12526,24429
Ϫ,GanXiZhen,500242110,6912,1589,5640,4010,11313,5598,3142,5865,11463,6003,11643
Ϫ,HouXiZhen,500242111,6879,1303,5468,3742,10902,5468,2915,5629,11097,5629,11097
,CangLingZhen,500242112,7444,1592,6207,4587,12208,6191,3687,6508,12699,6516,12723
С,XiaoHeZhen,500242113,5968,1644,5395,3848,10646,5330,3457,5524,10854,5674,11069
Ϳ,TuShiXiang,500242200,8894,2099,6882,5219,14470,6819,3824,7741,14560,7935,14817
Ϫ,BanXiXiang,500242201,7169,1273,5226,3543,10136,4980,2722,5590,10570,5938,11164
ͭ,TongGuXiang,500242202,10944,2829,9183,7334,18854,9135,5402,9882,19017,9992,19175
,JiangFengXiang,500242203,6185,1277,5062,3490,9879,4981,2901,5163,10144,5301,10363
ɴ,KeDaXiang,500242204,5814,1136,5075,3492,10032,5073,3256,5123,10196,5131,10206
ƫ,PianBaiXiang,500242205,6445,1140,5113,3463,10301,5056,2875,5219,10275,5347,10460
帣,WuFuXiang,500242206,5086,782,4170,2802,8279,4170,2542,4240,8410,4240,8410
ľҶ,MuYeXiang,500242207,3074,885,2458,2061,5106,2456,1316,2797,5253,2817,5275
ë,MaoBaXiang,500242208,4651,1312,3698,3136,7481,3687,1799,4034,7721,4064,7762
,HuaTianXiang,500242209,3710,1129,2993,2387,6201,2900,1539,3217,6117,3385,6378
ƺ,HouPingXiang,500242210,5298,1424,4437,3422,8940,4364,2480,4713,9077,4765,9202
,TianGuanXiang,500242211,5443,1113,4133,3196,8404,4130,2179,4595,8725,4602,8735
˾,YiJuXiang,500242212,7663,1828,6583,4783,13378,6407,4066,6799,13206,6974,13557
ľ,WanMuXiang,500242213,7972,1789,7482,5302,14700,7462,5459,7665,15127,7738,15220
,LiangZengXiang,500242214,5288,1060,4305,3015,8479,4261,2325,4293,8554,4368,8673
,BanQiaoXiang,500242215,4199,1034,3455,2862,6980,3455,2016,3789,7244,3794,7249
,GuanQingXiang,500242216,4732,1225,4107,3186,8273,4091,2458,4265,8356,4308,8415
,NanYaoJieXiang,500242217,6544,1653,5931,4354,11890,5898,3959,6165,12063,6225,12156
,CheTianXiang,500242218,2898,594,2394,1639,4680,2382,1454,2506,4888,2552,4946
,YuDiXiang,500242219,3341,1093,2978,2375,6054,2931,1869,3241,6172,3325,6303
Ȫ,QingQuanXiang,500242220,3427,692,2659,1913,5255,2633,1340,2744,5377,2800,5459
Ϫ,MiaoXiXiang,500242221,6418,1306,5439,3398,10241,5439,3231,5515,10954,5516,10955
ƺ,LangPingXiang,500242222,4166,820,3607,2353,6999,3600,2318,3674,7274,3697,7304
˫Ȫ,ShuangQuanXiang,500242223,5244,1242,4314,3145,8603,4314,2389,4561,8875,4561,8875
ľ,NanMuXiang,500242224,2859,620,2157,1642,4555,2129,1169,2432,4561,2491,4648
,HanJiaZhen,500243100,72876,7572,53431,34494,67001,52645,27982,53647,106292,54999,108430
,BaoJiaZhen,500243101,25267,3880,19242,11702,35497,18092,10591,19067,37159,20496,39738
ɽ,YuShanZhen,500243102,20018,3168,14747,10160,29688,14665,7795,16145,30810,16234,30981
߹,GaoGuZhen,500243103,10002,1893,7505,4807,14834,7414,3627,7835,15249,8017,15522
ɣ,SangZheZhen,500243104,15647,2637,12364,7895,23198,12234,7937,13358,25592,13857,26221
¹,LuJiaoZhen,500243105,5773,1132,4669,3340,8352,4572,2614,4705,9277,4850,9519
Ƽ,HuangJiaZhen,500243106,6975,1806,5684,4085,11257,5639,3119,6104,11743,6216,11900
,PuZiZhen,500243107,10834,2650,8904,6667,17318,8796,4649,8945,17741,9229,18133
,LongSheZhen,500243108,10384,2342,8040,5568,15961,7976,4437,8881,16857,9123,17163
,LianHuZhen,500243109,8854,1598,7628,4771,14435,7578,5345,8089,15667,8169,15797
,WanZuZhen,500243110,3511,570,2394,1762,4739,2333,1119,2516,4849,2806,5200
ˮ,DianShuiXiang,500243200,10855,2442,8878,6164,17529,8860,4991,9349,18209,9410,18288
Ҷ,YanDongXiang,500243201,4491,961,3513,2403,6984,3473,1882,3755,7228,3821,7334
¹,LuMingXiang,500243202,7846,1723,6096,4052,12151,6025,3231,6593,12618,6704,12800
ƽ,PingAnXiang,500243203,5492,1176,4312,2853,8657,4267,2318,4596,8863,4674,8986
,DiTangXiang,500243204,4748,1084,3778,2720,7399,3775,2070,3937,7712,4124,7902
̫ԭ,TaiYuanXiang,500243205,4422,1133,3855,2770,7358,3844,2190,3840,7684,3890,7745
,SanYiXiang,500243206,3217,643,2430,1719,4769,2423,1293,2656,5079,2723,5153
,LianHeXiang,500243207,6981,1182,5172,3242,10670,5089,3091,5658,10747,6082,11254
ʯ,ShiLiuXiang,500243208,4576,755,3761,2370,7406,3748,2426,3977,7725,3996,7757
Ϫ,LongXiXiang,500243209,7830,1301,6021,3702,12307,5988,3561,6609,12597,6671,12692
,ZouMaXiang,500243210,7440,1318,6107,3936,12105,6088,3941,6512,12600,6592,12699
«,LuTangXiang,500243211,4296,765,3034,2126,6284,2995,1689,3420,6415,3716,6750
̲,ChangTanXiang,500243212,9067,1883,7093,5147,13428,6948,3446,6932,13880,7303,14396
,QiaoZiXiang,500243213,5236,952,4211,2839,8467,4167,2585,4471,8638,4562,8773
Ǩ,QianQiaoXiang,500243214,4717,919,3685,2495,7517,3685,2103,4051,7736,4054,7739
,XinTianXiang,500243215,10855,2314,8790,5603,16488,8607,5080,9095,17702,9459,18249
÷,MeiZiYaXiang,500243216,5617,1112,4629,3211,9170,4593,2914,4928,9521,5014,9643
,ZhuFoXiang,500243217,6334,1286,5108,3519,10151,5069,3051,5484,10553,5563,10671
С,XiaoChangXiang,500243218,3974,565,3357,1951,5636,3347,2363,3470,6817,3545,6902
ͩ¥,TongLouXiang,500243219,2150,414,1755,1175,3286,1748,1012,1814,3562,1821,3576
,AnZiXiang,500243221,7435,1377,5723,4217,11892,5716,3302,6357,12073,6391,12114
Ƹ,ShanGanXiang,500243222,3369,655,2628,1763,5177,2595,1386,2707,5302,2782,5410
˫,ShuangLongXiang,500243223,2255,480,1777,1250,3376,1750,885,1789,3539,1843,3620
ʯ,ShiPanXiang,500243224,1571,360,1194,847,2401,1186,606,1311,2497,1343,2537
,DaYaXiang,500243225,2149,486,1618,1145,3204,1605,772,1734,3339,1789,3407
Ϫ,RunXiXiang,500243226,5719,1289,4490,3127,9078,4464,2433,4856,9320,4951,9441
Ϫ,LangXiXiang,500243227,3218,712,2572,1764,5074,2565,1442,2787,5352,2800,5372
,LongTangXiang,500243228,3083,836,2502,1963,5077,2501,1361,2772,5273,2778,5280
Ժֵֽ´,DuYuanJieJieDaoBanShiChu,510104020,20247,2997,12862,9394,15048,11476,2443,10967,22443,12825,25687
пڽֵ´,YanShiKouJieDaoBanShiChu,510104021,9342,1194,5447,2785,4310,3734,675,3545,7279,5764,11211
·ֵ´,ChunXiLuJieDaoBanShiChu,510104022,17947,2835,11359,7625,12019,9932,1434,9289,19221,10857,22216
Ժֵֽ´,ShuYuanJieJieDaoBanShiChu,510104023,38111,6118,24471,16341,30700,21662,3849,20231,41893,23607,48078
Ͻֵͤ´,HeJiangTingJieDaoBanShiChu,510104024,36850,5209,22583,12831,22824,20360,3031,20160,40520,22507,45090
ˮֵ´,ShuiJingFangJieDaoBanShiChu,510104025,21718,3575,13509,9290,16800,11982,1972,11562,23544,13756,27265
ţпڽֵ´,NiuShiKouJieDaoBanShiChu,510104026,37410,5744,22681,15640,29107,20994,3587,20081,41075,24060,46741
·ֵ´,LongZhouLuJieDaoBanShiChu,510104027,36646,4762,22027,14880,24071,19980,3852,19039,39019,23233,45260
˫·ֵ´,ShuangGuiLuJieDaoBanShiChu,510104028,19999,2441,10545,7269,13952,9685,1944,9674,19359,13839,24384
½ֵ´,LianXinJieDaoBanShiChu,510104029,48285,5831,30369,22238,35985,28905,5754,27730,56635,29501,59870
ɳӽֵ´,ShaHeJieDaoBanShiChu,510104030,11136,1435,6379,4421,6761,5648,1139,5833,11481,7331,13710
ֵ´,DongGuangJieDaoBanShiChu,510104031,52085,6296,33155,24581,37070,32632,7235,31484,64116,32461,65616
ʨɽֵ´,ShiZiShanJieDaoBanShiChu,510104032,57983,3448,36662,11446,30151,14668,3395,14242,28910,28164,64826
·ֵ´,ChengLongLuJieDaoBanShiChu,510104035,92725,8087,57040,39091,46728,51533,12938,50557,102090,56710,113750
ֵ´,LiuJiangJieDaoBanShiChu,510104036,43698,3126,24536,19537,20160,23643,5423,25733,49376,27711,52247
ʥֵ´,SanShengJieDaoBanShiChu,510104037,19727,1535,12086,7209,14996,11052,3209,10697,21749,12385,24471
̫·ֵ´,TaiShengLuJieDaoBanShiChu,510105001,47506,7101,29974,21052,32209,26960,4227,25654,52614,28860,58834
нֵֽ´,CaoShiJieJieDaoBanShiChu,510105002,34321,4237,20999,13623,22105,16446,2663,15131,31577,20222,41221
ӽֵ´,XiYuHeJieDaoBanShiChu,510105003,25835,4243,17371,8788,19164,12169,2490,11070,23239,15197,32568
ҹսֵ´,WangJiaGuaiJieDaoBanShiChu,510105004,46449,8154,30626,18229,41189,24672,4308,22709,47381,28285,58911
ٳǽֵ´,ShaoChengJieDaoBanShiChu,510105005,45920,7598,30782,21038,39794,28281,5319,26089,54370,28055,58837
»·ֵ´,XinHuaXiLuJieDaoBanShiChu,510105006,47593,3297,27239,10665,38159,13356,2821,11638,24994,26472,53711
ýֵ´,CaoTangJieDaoBanShiChu,510105007,38928,7327,26142,16815,31142,23013,4040,21671,44684,24153,50295
Ͻֵ´,FuNanJieDaoBanShiChu,510105008,83864,10570,53954,38631,57578,50572,10571,47669,98241,51051,105005
⻪ֵ´,GuangHuaJieDaoBanShiChu,510105009,65606,6580,41845,24573,35101,32118,7579,30015,62133,37920,79765
½ֵ´,DongPoJieDaoBanShiChu,510105010,43743,3943,28675,19932,29157,26693,7735,24709,51402,26746,55421
ɳֵ´,JinShaJieDaoBanShiChu,510105011,25592,2009,14965,11164,12565,14041,3499,13425,27466,16135,31100
ӽֵ´,HuangTianBaJieDaoBanShiChu,510105012,48746,9994,32905,22030,46411,28729,6793,28703,57432,32628,65533
½ֵ´,SuPoJieDaoBanShiChu,510105013,61691,3917,34971,24420,22215,31145,8660,31839,62984,39297,74268
ļҽֵ´,WenJiaJieDaoBanShiChu,510105014,52626,4274,30037,17862,25377,22407,5771,23096,45503,32634,62671
·ֵ,XiAnLuJieDao,510106024,69771,10680,44792,29190,47319,38453,6570,36213,74666,42229,87021
�ֵ,XiHuaJieDao,510106025,98566,3678,48163,34585,22235,34941,9352,41156,76097,63433,111596
·ֵ,RenMinBeiLuJieDao,510106026,59470,11231,39274,27594,47915,36349,6396,34927,71276,37823,77097
ɻؽֵ,HeHuaChiJieDao,510106027,49632,7503,30794,21516,29287,29124,5607,28848,57972,31948,62742
Žֵ,SiMaQiaoJieDao,510106030,93238,12867,57060,41267,64371,55030,10134,55953,110983,59179,116239
ӽֵ,ChaDianZiJieDao,510106031,73824,8667,46763,31894,46808,42849,9690,40748,83597,45418,92181
ٽֵ,FuQinJieDao,510106032,86387,12170,54198,41824,60888,52023,8197,50327,102350,52556,106754
ֵ̽,JiuLiDiJieDao,510106035,56423,5111,32869,19524,39911,27350,6968,26365,53715,35633,68502
ʯֵ,WuKuaiShiJieDao,510106036,42693,2515,24921,17411,13682,23957,6200,24554,48511,26487,51408
ҽֵ,HuangZhongJieDao,510106037,31319,3562,20141,14388,16395,18999,4290,17529,36528,19030,39171
Ӫſڽֵ,YingMenKouJieDao,510106038,76095,4875,42732,31562,27342,38285,9891,39231,77516,48129,90861
Ȫֵ,JinQuanJieDao,510106040,68552,4495,40189,26477,26407,36301,10296,36812,73113,43154,83343
ɳԴֵ,ShaHeYuanJieDao,510106041,101563,5560,57698,42661,27979,53752,16604,58039,111791,66029,123727
ֵ,TianHuiZhenJieDao,510106042,70394,6094,40789,27650,38361,33983,8672,35846,69829,44371,85160
ɽֵ,FengHuangShanJieDao,510106043,3895,252,2426,1975,1020,2307,827,2255,4562,2548,4974
ϴֵֽ´,JiangXiJieJieDaoBanShiChu,510107001,51486,6796,30963,17244,39153,22996,4522,21751,44747,31841,62804
·ֵ´,WangJiangLuJieDaoBanShiChu,510107004,77238,8926,46693,24837,58512,32148,6483,30864,63012,45954,92647
ֵֽ´,YuLinJieDaoBanShiChu,510107005,63730,10465,41575,28685,41609,36437,6539,33841,70278,39159,80734
ɡֵ´,TiaoSanTaJieDaoBanShiChu,510107006,55412,7786,35471,22360,39534,28465,5955,27404,55869,33682,69153
վֵ´,HuoCheNanZhanJieDaoBanShiChu,510107007,60037,5178,36597,25521,35286,32842,7171,30271,63113,35789,72386
˫骽ֵ´,ShuangNanJieDaoBanShiChu,510107008,78732,9440,48169,37021,59575,45780,9528,42853,88633,49531,97700
ֵ´,JinYangJieDaoBanShiChu,510107009,59583,6634,37881,25208,27080,34787,9223,33468,68255,37559,75440
¥ֵ´,HongPaiLouJieDaoBanShiChu,510107010,87360,6326,52225,37783,42371,48286,12084,45233,93519,53545,105770
Žֵ´,CuQiaoJieDaoBanShiChu,510107011,72165,3725,40778,16701,16225,24087,8084,24083,48170,43196,83974
ͶŽֵ´,JiTouQiaoJieDaoBanShiChu,510107012,86109,3877,47950,40511,18674,46068,13311,51549,97617,55347,103297
Žֵ´,JinHuaQiaoJieDaoBanShiChu,510107013,101103,3452,52391,45723,20029,45608,10542,51492,97100,62706,115097
ؽֵ´,CuJinJieDaoBanShiChu,510107014,65484,3688,35654,29560,17619,33847,8475,36020,69867,41993,77647
˽ֵ´,HuaXingJieDaoBanShiChu,510107015,40845,1481,21300,18119,8885,19100,4828,21866,40966,25854,47154
ݽֵ´,FangCaoJieDaoBanShiChu,510107061,76807,10128,50126,34842,62083,45708,9842,42053,87761,46651,96777
ФҺӽֵ´,XiaoJiaHeJieDaoBanShiChu,510107062,38790,4013,22961,15716,21389,20947,4024,19290,40237,23866,46827
ʯֵ´,ShiYangJieDaoBanShiChu,510107063,71138,5007,39870,25031,40187,35122,9051,34500,69622,45326,85196
Ϫֵ´,GuiXiJieDaoBanShiChu,510107064,53588,3335,27464,15750,23807,21895,6173,21373,43268,35632,63096
׷ֵ,MengZhuiWanJieDao,510108002,55023,10097,35147,25362,42664,31582,4987,30953,62535,34960,70107
˫ӽֵ,ShuangQiaoZiJieDao,510108004,59033,12528,39469,25476,55358,36538,5980,35222,71760,38072,77541
·ֵ,JianSheLuJieDao,510108005,50610,8372,30784,22036,37444,26637,4974,26438,53075,33172,63956
·ֵ,FuQingLuJieDao,510108006,35438,4933,22330,16557,24353,21583,4463,21126,42709,22504,44834
Žֵ,ErXianQiaoJieDao,510108007,49479,4758,25794,13876,31541,17185,3635,17932,35117,32078,57872
źӽֵ,TiaoDengHeJieDao,510108008,29733,4379,18513,14524,20656,18380,3626,19070,37450,19225,37738
º·ֵ,XinHongLuJieDao,510108009,48901,7921,30838,21085,39096,28741,4846,28221,56962,30830,61668
˫ˮֵ,ShuangShuiNianJieDao,510108010,49348,3598,29460,20496,17093,28650,7406,29686,58336,30892,60352
곡ֵ,WanNianChangJieDao,510108011,62479,6020,36914,26915,38573,35430,7968,35850,71280,39553,76467
·ֵ,TaoQiLuJieDao,510108012,70253,8383,44046,31507,52562,42692,10471,42562,85254,45061,89107
ʥƽֵ,ShengDengJieDao,510108013,13257,1233,8185,6424,11078,8084,2110,8129,16213,8415,16600
ͽֵ,BaoHeJieDao,510108014,41453,2702,22883,17804,19703,21462,6131,22416,43878,27403,50286
ֵ,QingLongJieDao,510108015,134441,8966,77861,59497,52632,75444,21072,81905,157349,86618,164479
̶ֵ,LongTanJieDao,510108016,53296,5416,32812,21195,48105,31226,9066,31673,62899,34966,67778
Ȫֵ´,LongQuanJieDaoBanShiChu,510112001,198896,20175,124385,76054,137544,105115,29781,103056,208171,124467,248852
ֵ´,DaMianJieDaoBanShiChu,510112002,108867,7786,68303,33009,60262,46182,13016,46114,92296,61366,129669
ʮֵ´,ShiLingJieDaoBanShiChu,510112003,88743,8272,53894,30899,60605,44850,13232,45144,89994,56353,110247
ֵͬ´,TongAnJieDaoBanShiChu,510112004,41233,3671,25500,11883,24382,16245,4688,16074,32319,24092,49592
,LuoDaiZhen,510112102,21844,3242,14565,9729,21025,13880,4096,13780,27660,14617,29182
,XiHeZhen,510112104,44876,4930,28426,16758,44523,25993,7734,26326,52319,29114,57540
鰲,HongAnZhen,510112108,11166,1725,7521,5037,13831,7441,2230,7333,14774,7600,15121
غ,BaiHeZhen,510112109,52028,5429,31642,18677,42841,28119,8207,27823,55942,34022,65664
,ChaDianZhen,510112110,9717,1907,6731,4808,12928,6584,2144,6726,13310,7037,13768
,HuangTuZhen,510112111,19959,2863,13183,8258,24890,12962,3847,13133,26095,13486,26669
ɽȪ,ShanQuanZhen,510112115,9247,1390,6201,4275,11472,5939,1931,6050,11989,6367,12568
,WanXingXiang,510112200,5868,1109,4157,2973,8151,4157,1354,4174,8331,4174,8331
ֵ´,HongYangJieDaoBanShiChu,510113001,45993,5484,28289,20332,38415,26998,6736,26717,53715,29924,58213
ֵ´,DaWanJieDaoBanShiChu,510113002,57707,7233,36768,27454,50649,34489,8809,33662,68151,36981,73749
Ĳ,MiMouZhen,510113102,23987,3460,15433,11921,27670,14981,3146,14359,29340,15160,30593
ͬ,DaTongZhen,510113103,17466,2468,11058,8254,18190,10148,2594,9825,19973,11470,22528
,ChengXiangZhen,510113104,38449,6120,25470,18893,47428,25319,6402,24800,50119,25501,50971
鸣,XiangFuZhen,510113105,31781,4840,21021,17742,39829,20923,5811,21047,41970,21411,42432
Ҧ,YaoDuZhen,510113106,12644,1854,8137,6216,15534,8127,2034,8346,16473,8395,16532
Ȫ,QingQuanZhen,510113108,21883,3860,15255,12031,27595,14759,4760,14472,29231,15248,30503
,LongWangZhen,510113110,15266,2256,10125,7402,19481,9996,3213,10152,20148,10610,20735
,FuHongXiang,510113202,16998,2580,11382,8298,22511,11349,3690,11762,23111,11886,23268
˺,RenHeXiang,510113203,8400,1868,5890,4996,11768,5859,2000,6276,12135,6378,12268
ֵ´,DaFengJieDaoBanShiChu,510114001,60198,3924,35690,18550,26728,28495,9275,29421,57916,37707,73397
ӽֵ´,SanHeJieDaoBanShiChu,510114003,32930,3198,20069,13536,27190,18805,5169,18846,37651,21228,41297
¶,XinDouZhen,510114100,192030,23212,119269,85068,176456,108449,26299,108009,216458,122272,241541
ʯ̲,ShiBanTanZhen,510114102,37503,4485,24120,14711,46782,23758,6939,24207,47965,24807,48927
·,XinFanZhen,510114103,79671,11514,51652,33694,92926,48070,12473,47316,95386,52006,103658
,XinMinZhen,510114104,26982,4260,17752,12114,34580,17700,3904,17330,35030,17394,35146
̩,TaiXingZhen,510114106,23853,3161,15277,10454,28345,14918,3800,15073,29991,15537,30814
԰,BanZhuYuanZhen,510114108,45861,5273,28312,17061,43366,24888,6246,24854,49742,29068,57380
,QingLiuZhen,510114109,22634,3799,14914,11231,27790,14557,3330,14261,28818,14849,29763
,MaJiaZhen,510114111,19121,2734,12178,8696,21879,11941,2768,11946,23887,12445,24623
,LongQiaoZhen,510114112,25258,2777,15557,9290,23838,14713,3584,14927,29640,16062,31619
ľ,MuLanZhen,510114114,30146,3415,19256,11486,34411,18867,5545,19088,37955,19850,39106
,JunTunZhen,510114116,14262,2136,9225,5346,16897,9057,2034,8973,18030,9207,18432
ǽֵ´,LiuChengJieDaoBanShiChu,510115001,118351,11867,72462,41961,88760,54981,13821,51656,106637,71577,144039
ƽֵ´,GongPingJieDaoBanShiChu,510115002,38282,4378,23646,14008,26438,20211,5279,19733,39944,24293,47939
ӿȪֵ´,YongQuanJieDaoBanShiChu,510115003,19175,1902,11168,7183,13890,9828,2466,9921,19749,12375,23543
츮ֵ´,TianFuJieDaoBanShiChu,510115004,46549,2161,27744,7939,28398,11787,3223,11580,23367,24189,51933
ʢ,HeShengZhen,510115101,27039,3704,17314,11917,28769,15741,3676,15628,31369,17105,34419
ʢ,YongShengZhen,510115102,12323,1380,7093,4126,10397,5838,1488,5951,11789,8098,15191
,JinMaZhen,510115103,19300,2337,11479,6833,16861,9842,2370,9714,19556,12528,24007
,YongNingZhen,510115104,18305,2212,11063,6708,17307,9654,2585,9629,19283,12039,23102
,WanChunZhen,510115105,44148,6327,28140,20463,46201,27036,6584,26406,53442,28919,57059
ٰ,ShouAnZhen,510115106,27007,4802,17921,13121,33952,17782,4029,17626,35408,17917,35838
,ZhaoZhen,510121100,118192,15512,77431,54263,131282,71955,21243,70042,141997,77516,154947
,SanXingZhen,510121101,16006,2534,10743,8299,18911,10053,2918,10024,20077,10715,21458
彭,QingJiangZhen,510121102,17149,2645,11456,7977,21809,11371,3104,11230,22601,11442,22898
ٲ,GuanCangZhen,510121103,15648,2387,10429,7604,20428,10376,3212,10715,21091,10818,21247
,HuaiKouZhen,510121104,54090,6486,34305,23129,61652,32608,10085,33625,66233,36356,70661
׹,BaiGuoZhen,510121105,20458,3485,14478,11169,29092,14126,5667,14685,28811,15132,29610
,WuFengZhen,510121106,14240,2960,10007,8939,19928,9993,3273,10380,20373,10466,20473
߰,GaoBanZhen,510121108,22092,3414,15709,10772,29438,15202,6023,15414,30616,15820,31529
Ϫ,SanXiZhen,510121109,24968,3903,17538,12822,34943,17454,6782,17916,35370,18115,35653
,FuXingZhen,510121110,21457,4054,15374,11771,30063,14878,5979,15273,30151,16116,31490
,JinLongZhen,510121111,14899,2410,10002,6712,20400,9918,3554,10656,20574,10861,20863
Լ,ZhaoJiaZhen,510121112,20238,2985,13968,10193,27239,13605,5118,13836,27441,14373,28341
,ZhuGaoZhen,510121113,25047,4585,19029,13518,36245,17889,8917,18587,36476,19520,38549
,GuangXingZhen,510121114,15187,3215,11641,8340,22954,11623,5212,11894,23517,11973,23614
¡ʢ,LongShengZhen,510121115,15408,3503,11427,8712,22179,11255,4865,11635,22890,12349,23776
ת,ZhuanLongZhen,510121116,10915,2455,8265,6061,16103,8221,3452,8483,16704,8557,16822
,TuQiaoZhen,510121117,19053,3507,13430,9663,26529,13092,4994,13779,26871,14124,27554
ƺ,YunHeZhen,510121118,13426,3151,10790,7917,20887,10766,5222,10971,21737,11009,21799
,YouXinZhen,510121119,15760,3363,12231,10199,24062,12093,5663,12281,24374,12555,24786
,QiXianXiang,510121200,14219,2307,9361,7230,18924,9316,2835,9922,19238,10000,19361
ƽ,PingQiaoXiang,510121203,21374,4087,15790,12421,30981,15592,6335,15676,31268,16006,31796
ֵ,DongShengJieDaoBan,510122001,161087,16051,101057,70398,114682,95863,25746,94347,190210,101827,202884
�۽ֵ,XiHangGangJieDaoBan,510122002,142091,7885,75595,45432,48362,51715,12921,54987,106702,87302,162897
ֵ,HuaYangZhenJieDaoBan,510122003,162143,16765,99028,64781,114601,88806,22398,86624,175430,102278,201306
кͽֵ,ZhongHeJieDaoBan,510122004,69261,5900,41131,26824,30762,36884,9775,37522,74406,43805,84936
̫ƽ,TaiPingZhen,510122101,17238,2765,11313,7563,20479,10806,2807,10949,21755,11497,22810
,YongXingZhen,510122102,13806,2563,9499,7054,17614,9450,2755,9505,18955,9625,19124
,JiTianZhen,510122106,25008,3813,16524,10220,28037,14910,4324,14674,29584,16621,33145
,ZhengXingZhen,510122107,18983,2894,12532,8796,23709,12413,3530,12437,24850,12875,25407
,PengZhen,510122108,34643,4464,21691,14204,34564,20271,5008,20544,40815,22424,44115
,DaLinZhen,510122109,12503,2937,8995,6875,17144,8938,2757,8939,17877,9202,18197
,JianChaZhen,510122110,19083,3428,12910,8971,24597,12798,3701,12964,25762,13302,26212
Ϫ,HuangLongXiZhen,510122111,17054,3394,11555,7918,21158,11275,2962,11285,22560,11855,23410
,YongAnZhen,510122112,22209,3645,14398,9819,26331,13722,3630,14025,27747,15086,29484
Ž,JiuJiangZhen,510122114,85510,5157,46355,31708,34269,39678,11155,42225,81903,55467,101822
ˮ,HuangShuiZhen,510122115,25707,3630,16257,10879,27681,15712,3972,16158,31870,17052,33309
,JinQiaoZhen,510122116,28971,4166,18396,11295,33076,17764,4387,18005,35769,19128,37524
Ƽ,HuangJiaZhen,510122117,21522,1874,12669,8266,17999,11867,3181,12217,24084,13908,26577
,GongXingZhen,510122118,19765,2427,12391,7824,20449,12158,3456,12368,24526,13257,25648
ʤ,ShengLiZhen,510122119,13238,1820,8435,5602,15795,8325,2236,8508,16833,8859,17294
,XinXingZhen,510122120,25788,3118,16593,9979,28855,16074,4603,16223,32297,16916,33509
¡,XingLongZhen,510122121,19234,2886,12548,7915,22807,12419,3340,12597,25016,12912,25460
,WanAnZhen,510122122,19733,2450,12089,7553,19724,11229,3251,11113,22342,13345,25434
ɳ,BaiShaZhen,510122123,20842,2714,13462,9223,25374,13384,3673,13580,26964,13767,27229
,SanXingZhen,510122124,11728,2296,8033,5763,15752,7981,2301,8130,16111,8292,16325
Ͻ,HeJiangZhen,510122125,11292,2112,7728,5656,14814,7612,2468,7969,15581,8144,15872
ۯͲ,PiTongZhen,510124100,103616,12767,61574,39574,85895,53655,12805,51706,105361,67614,129188
Ž,TuanJieZhen,510124101,66667,3623,37575,15559,32267,19565,5060,20585,40150,37775,75350
Ϭ,XiPuZhen,510124102,108408,6107,59836,26259,50305,34855,8829,35259,70114,63508,123344
԰,HuaYuanZhen,510124103,15431,2585,10303,6554,19324,10236,2393,10032,20268,10106,20409
Ʋ,TangChangZhen,510124104,35450,5951,23551,16213,43451,23269,5390,22897,46166,23240,46791
,AnDeZhen,510124105,28209,4292,18194,12486,30424,16911,4159,16443,33354,18466,36660
,SanDaoYanZhen,510124106,14854,2393,9564,6953,16107,9385,2109,9323,18708,9792,19356
,AnJingZhen,510124107,94351,4161,50050,22385,23978,27564,8139,28626,56190,56601,106651
,HongGuangZhen,510124108,53243,4207,28607,19970,28926,22903,5337,23436,46339,34180,62787
,XinMinChangZhen,510124110,12065,1938,7913,5508,14192,7764,1896,7710,15474,7986,15899
Դ,DeYuanZhen,510124112,24788,3251,15210,9877,24349,14703,3589,14547,29250,16418,31628
Ѱ,YouAiZhen,510124115,30005,4906,19646,13769,36669,19345,4583,19653,38998,19848,39494
ų,GuChengZhen,510124117,22019,2028,15973,5471,15243,8575,2070,8493,17068,10144,26117
Ԫ,TangYuanZhen,510124118,17110,2648,10687,7436,20640,10544,2615,10575,21119,11686,22373
,HeZuoZhen,510124119,130011,4102,48750,17003,47333,23064,6002,23257,46321,91365,140115
ԭ,JinYuanZhen,510129100,121947,15353,74663,43051,117035,64356,15572,61726,126082,78209,152872
,WangSiZhen,510129101,40383,6250,25798,14905,49220,25664,5806,25831,51495,26641,52439
³,XinChangZhen,510129103,16791,3183,11368,7054,21314,11319,2788,11284,22603,11394,22762
,YueLaiZhen,510129104,17049,3479,11035,6760,21222,10389,2250,11053,21442,11743,22778
,AnRenZhen,510129105,38553,6088,25338,15751,47811,24415,5907,23949,48364,25210,50548
,ChuJiangZhen,510129106,9103,2028,6035,4080,11792,5839,1388,6175,12014,6484,12519
ˮ,HuaShuiWanZhen,510129107,5225,979,3573,2206,6262,3384,985,3413,6797,3616,7189
,XiLingZhen,510129108,3945,847,2517,1676,4413,2310,630,2509,4819,2905,5422
бԴ,XieYuanZhen,510129109,3443,1027,2459,1903,4696,2436,581,2492,4928,2592,5051
,DongChangZhen,510129110,19259,3242,12773,7883,23594,12748,3056,12712,25460,12784,25557
,HanChangZhen,510129111,12730,1877,8332,5427,14474,8135,2173,8182,16317,8448,16780
,SanChaZhen,510129112,24618,3754,15986,9478,30731,15630,3792,15682,31312,16178,32164
ϰ,ShangAnZhen,510129113,10438,1755,6947,4455,13141,6920,1700,6901,13821,6946,13893
ռ,SuJiaZhen,510129114,13904,2202,9065,5563,17567,9042,2066,9044,18086,9107,18172
ϼ,QingXiaZhen,510129115,5464,1132,3482,2366,6749,3430,706,3614,7044,3820,7302
ɳ,ShaQuZhen,510129116,12237,1840,7886,4926,14306,7700,1853,7668,15368,8044,15930
̳,CaiChangZhen,510129118,12533,2201,8454,5701,15066,8391,2369,8448,16839,8649,17103
ɽ,WuShanXiang,510129202,2617,585,1725,1163,3435,1709,397,1817,3526,1874,3599
,JinXingXiang,510129203,5789,1517,3732,2773,7555,3729,673,4228,7957,4247,7979
,HeMingXiang,510129205,9116,1839,5867,3614,11683,5734,1185,6050,11784,6273,12140
ɽ,HeShanZhen,510131100,65102,8924,42305,28172,74644,39787,9749,38513,78300,41470,83775
,DaTangZhen,510131101,9259,1580,6296,4590,11655,6275,1596,6037,12312,6139,12435
ٰ,ShouAnZhen,510131102,36471,5937,24326,19361,46477,23777,5450,22994,46771,23532,47858
,ZhaoYangHuZhen,510131103,6876,1140,4577,3229,8688,4549,1106,4452,9001,4545,9122
,XiLaiZhen,510131104,20557,3117,13266,10324,25933,13162,3093,13273,26435,13501,26767
,DaXingZhen,510131105,12450,1861,8191,5925,15335,8129,2039,8040,16169,8159,16350
Ϫ,GanXiZhen,510131106,6893,1144,4673,3193,8899,4625,1240,4537,9162,4604,9277
ɼ,ChengJiaZhen,510131107,7360,1181,4853,3411,9446,4784,1221,4806,9590,4909,9762
,FuXingXiang,510131200,8815,1446,5882,4328,11245,5838,1459,5782,11620,5838,11720
,GuangMingXiang,510131201,3087,699,2097,1522,3924,2082,467,2141,4223,2156,4253
,BaiYunXiang,510131202,3330,830,2306,1733,4499,2305,543,2392,4697,2397,4703
,ChangQiuXiang,510131203,2565,537,1691,1271,3388,1691,438,1849,3540,1849,3540
,WuJinZhen,510132100,60024,7652,38491,28165,51779,37126,8666,35067,72193,37851,76342
,HuaQiaoZhen,510132101,18546,3080,12242,9020,22459,12184,2932,12036,24220,12316,24558
Դ,HuaYuanZhen,510132102,29998,3188,18450,9787,24697,13661,3359,13612,27273,18095,36545
,JinHuaZhen,510132103,10561,1852,6972,5584,13052,6905,1655,6902,13807,7096,14068
,PuXingZhen,510132104,15518,2439,10041,7478,18821,9979,2355,10062,20041,10271,20312
,XingYiZhen,510132105,23526,4151,15647,12171,30176,15570,3528,15336,30906,15558,31205
ƽ,XinPingZhen,510132106,18055,2760,11986,8249,19300,11480,2674,11108,22588,11503,23489
,FangXingZhen,510132107,8856,1657,5988,4388,11146,5805,1377,5619,11424,5902,11890
,AnXiZhen,510132108,9783,1459,6354,4571,11581,6250,1559,6288,12538,6447,12801
,YongShangZhen,510132109,14258,2323,9242,6571,14690,9129,2181,9219,18348,9520,18762
˫,DengShuangZhen,510132110,18091,2741,11188,7973,18419,10719,2626,10597,21316,12270,23458
ľ,WenJingXiang,510132202,6462,1276,4309,3535,8055,4261,1031,4237,8498,4460,8769
,GuanKouZhen,510181100,51653,8369,33448,22899,41829,30229,6264,28870,59099,32838,66286
Ҹ,XingFuZhen,510181101,108059,15809,69702,45712,66057,62206,15752,58777,120983,69918,139620
,PuYangZhen,510181102,34290,4322,20953,13582,34373,20239,4927,19944,40183,22586,43539
Դ,JuYuanZhen,510181103,32372,3703,20251,11017,31142,16908,4446,16603,33511,20270,40521
,ChongYiZhen,510181104,30335,4685,19701,12662,36784,19338,4932,19412,38750,20251,39952
,TianMaZhen,510181105,23794,3421,15538,10559,28859,15521,3783,15345,30866,15460,30998
ʯ,ShiYangZhen,510181106,34523,5623,22478,13620,40329,21250,4636,21303,42553,22304,44782
,LiuJieZhen,510181107,26306,4722,17421,11819,33460,17342,4030,17390,34732,17637,35058
,YuTangZhen,510181108,18856,3075,12371,8205,18229,12030,2941,11731,23761,12501,24872
,ZhongXingZhen,510181109,21972,3046,14152,7951,23495,12606,2951,12372,24978,13817,27969
ɽ,QingChengShanZhen,510181110,26321,3342,15358,9121,23587,13226,3307,12932,26158,17612,32970
,LongChiZhen,510181111,1677,310,1133,903,2135,1125,319,1151,2276,1173,2306
,XuJiaZhen,510181112,37733,5418,24196,15891,36486,22840,5405,22296,45136,24360,48556
,AnLongZhen,510181113,16869,3185,11200,7558,21057,11139,2395,11084,22223,11249,22449
,DaGuanZhen,510181114,13056,2177,8513,5301,15065,7687,1801,7913,15600,8521,17034
ƺ,ZiPingPuZhen,510181115,6594,1084,4290,3048,7020,4259,1086,4277,8536,4474,8764
º,CuiYueHuZhen,510181116,11067,1665,7066,4325,13251,7017,1567,6989,14006,7233,14299
,XiangEXiang,510181202,9610,1541,5907,4455,11506,5906,1223,6455,12361,6467,12374
,HongKouXiang,510181211,4357,664,2681,1893,5041,2644,626,2855,5499,2966,5647
,TianPengZhen,510182100,137644,19488,88796,56902,147432,82637,20047,80229,162866,88383,177179
ɽ,LongMenShanZhen,510182101,8418,1159,5449,3808,9914,5410,1306,5337,10747,5434,10883
,XinXingZhen,510182102,14069,2680,8342,6301,18016,7870,1874,7940,15810,10281,18623
,LiChunZhen,510182103,50937,7353,32906,21888,63281,32736,7851,32743,65479,33235,66141
ų,JiuChiZhen,510182104,20797,3344,13728,9343,25833,13707,2829,13192,26899,13242,26970
,MengYangZhen,510182105,50599,8014,33227,21831,61495,31963,7158,31236,63199,32544,65771
ͨ,TongJiZhen,510182106,19253,3110,12514,8585,23451,12426,3275,12872,25298,13124,25638
ɽ,DanJingShanZhen,510182107,21724,3299,14226,9132,26960,14202,3290,14049,28251,14087,28313
¡,LongFengZhen,510182108,32086,4319,20176,12759,37856,19945,5119,19877,39822,21348,41524
ƽ,AoPingZhen,510182109,20620,3041,13334,8857,25887,13316,2972,13236,26552,13299,26633
ŷ,CiFengZhen,510182110,10859,1728,6974,4608,13471,6964,1729,7329,14293,7342,14316
,GuiHuaZhen,510182111,20664,3226,13151,8181,25287,13040,3038,13549,26589,13777,26928
,JunYueZhen,510182113,21921,2958,13774,9577,23414,12491,2859,12413,24904,13964,27738
,SanJieZhen,510182114,23447,3875,15244,10485,29339,15136,3073,15011,30147,15151,30395
С涴,XiaoYuDongZhen,510182116,9208,1342,5880,4060,11254,5876,1479,6140,12016,6149,12029
,HongYanZhen,510182118,11785,1766,7457,5457,14536,7453,1573,7632,15085,7667,15124
ƽ,ShengPingZhen,510182120,22041,3726,14785,9684,27751,14679,3368,14116,28795,14350,29135
¹,BaiLuZhen,510182121,6330,1120,4143,2903,8210,4143,1015,4312,8455,4322,8465
ɽ,GeXianShanZhen,510182123,23995,3759,15693,12047,30270,15671,3695,15641,31312,15756,31449
º,ZhiHeZhen,510182126,62111,8175,39762,24432,71322,37844,9347,37263,75107,39871,79633
,LinQiongZhen,510183100,146587,18657,93059,60646,161876,87508,20186,85436,172944,92371,185430
,YangAnZhen,510183101,30866,4493,19613,11849,36513,18730,4488,18536,37266,20234,39847
Ĳ,MouLiZhen,510183102,30665,6816,22026,15068,41435,21986,5057,20317,42303,20512,42538
ɣ԰,SangYuanZhen,510183103,18940,2889,12500,7761,23709,12469,2920,12185,24654,12249,24749
ƽ,PingLeZhen,510183104,22786,4453,15603,10065,28844,14810,3698,14524,29334,15334,30937
й,JiaGuanZhen,510183105,12721,2346,8445,5723,16856,7984,2307,8289,16273,8929,17374
,HuoJingZhen,510183106,11946,2880,8095,5604,16116,7921,1905,8208,16129,8636,16731
ˮ,ShuiKouZhen,510183107,14043,3448,9286,6605,18788,9270,2033,10146,19416,10238,19524
,GuYiZhen,510183108,22493,3894,14621,9431,28671,14464,3109,14406,28870,14875,29496
Ƚ,RanYiZhen,510183109,18685,3332,12818,8911,24727,12539,3076,11785,24324,12275,25093
,HuiLongZhen,510183110,15592,2724,10382,6717,20057,10359,2300,10209,20568,10234,20616
߹,GaoGengZhen,510183111,15655,2150,10249,6383,17738,9149,2188,8765,17914,9744,19993
ǰ,QianJinZhen,510183112,15195,1843,9476,5542,16412,8404,2067,8567,16971,9629,19105
ߺ,GaoHeZhen,510183113,6223,1673,4687,3147,9106,4610,1485,4553,9163,4694,9381
ټ,LinJiZhen,510183115,11219,1983,7661,5534,14477,7661,2001,7537,15198,7542,15203
,WoLongZhen,510183116,10886,1510,7111,4973,13674,7106,1811,7091,14197,7096,14207
̨ɽ,TianTaiShanZhen,510183118,8681,2009,5965,4093,11746,5871,1743,6204,12075,6468,12433
,BaoLinZhen,510183120,10292,1621,6562,4655,12667,6562,1387,6730,13292,6738,13300
԰,ChaYuanXiang,510183201,8794,1819,5891,4353,11677,5890,1246,5966,11856,5968,11859
,DaoZuoXiang,510183206,4977,1323,3335,2758,6402,3244,780,3407,6651,3745,7080
ե,YouZhaXiang,510183209,7426,1917,5393,3902,10395,5391,1479,5420,10811,5429,10822
ϱ,NanBaoXiang,510183211,2449,561,1688,1158,3428,1685,536,1852,3537,1858,3546
ͬ,DaTongXiang,510183212,9097,2674,6306,4667,12714,6256,1359,6717,12973,6824,13130
,KongMingXiang,510183214,7913,1264,5119,3484,10125,5083,1182,5200,10283,5240,10359
,ChongYangZhen,510184100,127364,18246,81627,49419,131569,77376,17367,73232,150608,81350,162977
,SanJiangZhen,510184101,39447,6407,25391,15899,49141,25164,5549,25608,50772,26012,51403
Դ,JiangYuanZhen,510184102,21439,3621,13949,8670,26980,13903,3015,14009,27912,14126,28075
,YangMaZhen,510184103,32408,4997,20789,14777,37857,20626,4378,20601,41227,20994,41783
μ,LiaoJiaZhen,510184104,14273,2620,9417,5830,17853,9410,1990,9443,18853,9466,18883
Ԫͨ,YuanTongZhen,510184105,14573,2464,9604,6137,18119,9526,1925,9170,18696,9358,18962
ʤ,GuanShengZhen,510184106,13390,2602,8963,6170,16796,8928,1960,8927,17855,8989,17952
Զ,HuaiYuanZhen,510184107,44780,7078,29148,16806,55258,27425,6360,27643,55068,29070,58218
,SanLangZhen,510184108,10093,2003,6379,4815,12858,6376,1286,6999,13375,7003,13382
,JieZiZhen,510184109,23480,3752,15276,9425,29352,15224,3505,15318,30542,15461,30737
ľ,WenJingJiangZhen,510184110,4736,828,2951,1874,5683,2888,534,3083,5971,3147,6098
,WangChangZhen,510184111,16117,2800,10560,6965,19971,10477,2086,10325,20802,10443,21003
ͷ,BaiTouZhen,510184112,10771,1779,7054,4093,13453,7051,1547,7037,14088,7043,14097
,DaoMingZhen,510184113,15280,2760,9912,6114,19103,9912,1908,10031,19943,10036,19948
¡,LongXingZhen,510184114,12043,1923,7942,4810,15132,7916,1856,7772,15688,7880,15822
,DaHuaZhen,510184116,14899,2813,10047,6249,19133,10011,2191,9761,19772,9856,19903
ƽ,ChongPingZhen,510184117,13321,2258,8632,6006,15288,8618,1823,8741,17359,8770,17402
,ZiTongZhen,510184118,9455,2015,6371,3892,11951,6306,1283,6124,12430,6382,12753
Ȫ,QiQuanZhen,510184119,10969,1936,7053,4611,13684,6892,1528,6907,13799,7380,14433
,JinJiangXiang,510184201,11022,1813,7280,4286,13774,7274,1552,7101,14375,7107,14387
,GongYiXiang,510184202,9985,1866,6505,3966,12637,6482,1246,6529,13011,6592,13097
ɽ,JiGuanShanXiang,510184206,2207,418,1420,960,2889,1410,370,1554,2964,1575,2995
Э,JiXieXiang,510184208,9860,1513,6395,3723,11795,6386,1356,6317,12703,6334,12729
ԭ,LiaoYuanXiang,510184209,16638,2836,11111,7040,20990,11095,2429,10706,21801,10792,21903
,JiXianXiang,510184211,9267,1685,6158,3971,11716,6131,1226,5933,12064,6020,12178
ǽֵֽ,WuXingJieJieDao,510302001,40100,6269,26355,15993,33598,23039,4766,21410,44449,24780,51135
½ֵ,DongXingSiJieDao,510302002,39295,8526,27534,18448,41341,26916,5812,25298,52214,26099,53633
½ֵֽ,XinJieJieDao,510302003,12879,2273,8742,5778,11345,8245,1800,7894,16139,8210,16952
ֵֽ,GuoJiaAoJieJieDao,510302004,28301,4989,18768,13562,27487,18581,3356,17738,36319,17878,36646
ֵ,DanGuiJieDao,510302005,46264,6518,31517,20740,44668,31284,8250,29202,60486,29515,61032
ѧԷֵ,XueYuanJieDao,510302006,43306,3072,23868,12114,24011,18036,4770,16828,34864,27280,51148
Ȩ,ZhongQuanZhen,510302101,12259,2475,9201,5952,17555,9184,3426,8940,18124,8959,18160
ƺ,ShuPingZhen,510302102,11996,2064,8420,5318,15728,8402,2768,8374,16776,8408,16828
ٱ,RongBianZhen,510302103,8119,1868,5821,3993,11493,5821,1726,5891,11712,5892,11713
,HongQiXiang,510302201,6799,663,4301,3087,3375,4282,1124,3922,8204,4285,8586
߷,GaoFengXiang,510302202,8586,1416,6059,3342,11229,6029,2032,5860,11889,5975,12034
ũ,NongTuanXiang,510302203,2688,507,1891,1304,3651,1880,563,1824,3704,1867,3758
,QiShuXiang,510302204,3165,622,2455,1587,4547,2455,991,2323,4778,2323,4778
Ϫֵ,XiaoXiJieDao,510303001,33431,5018,22019,14691,33070,21833,4863,20614,42447,21293,43312
ֵ,GongJingJieDao,510303002,14498,2467,9699,5636,14411,8747,1788,8127,16874,9054,18753
Ҷ,AiYeZhen,510303100,12835,2403,8729,5153,15539,8668,2003,8425,17093,8512,17241
,JianSheZhen,510303101,10022,1783,6872,3569,12745,6840,1841,6694,13534,6774,13646
,ChangTuZhen,510303102,16020,2965,10808,7138,17731,10679,2377,10294,20973,10554,21362
̶,LongTanZhen,510303104,19427,3581,13242,7996,25718,13231,3773,13450,26681,13539,26781
ͷ,QiaoTouZhen,510303105,9015,1801,6183,3668,12123,6171,1813,6379,12550,6446,12629
屦,WuBaoZhen,510303106,17108,3287,11587,7423,22905,11575,3438,12157,23732,12246,23833
,LianHuaZhen,510303107,7295,1365,4824,2898,9914,4821,1549,5334,10155,5385,10209
ɼ,ChengJiaZhen,510303108,32391,6262,22272,12794,43851,21712,6951,22688,44400,23332,45604
,BaiMiaoZhen,510303109,8196,1694,5566,3435,11304,5549,1719,5962,11511,6043,11609
¼,ZhangJiaXiang,510303200,6064,1235,4065,2457,8229,4060,1275,4466,8526,4509,8574
ţβ,NiuWeiXiang,510303201,5087,1064,3301,2223,6737,3301,903,3723,7024,3753,7054
󰲽ֵ,DaAnJieDao,510304001,18221,3532,12005,8558,21248,11742,1897,11427,23169,11645,23650
ֵ,LongJingJieDao,510304002,29307,4303,19093,13007,24716,18682,3789,17820,36502,18306,37399
ڽֵ,MaChongKouJieDao,510304003,17062,3729,11453,8795,19950,11245,1905,10980,22225,11243,22696
ɽֵ,LiangGaoShanJieDao,510304004,8715,1458,5577,3748,9847,5359,1053,5235,10594,5649,11226
ɽ,DaShanPuZhen,510304100,22950,3953,15955,9658,29032,15343,4453,14507,29850,15401,31356
Ž,TuanJieZhen,510304102,8649,1692,6058,3817,11612,6017,1902,6097,12114,6185,12243
կ,SanDuoZhaiZhen,510304103,15076,3092,11488,7652,22960,11485,4991,11668,23153,11671,23159
,HeShiZhen,510304104,17996,3716,13762,9937,27772,13762,6260,14210,27972,14210,27972
µ,XinDianZhen,510304105,7879,1740,6255,4100,12386,6252,3067,6409,12661,6431,12686
,XinMinZhen,510304106,18786,3539,13058,8003,23049,12948,3611,12673,25621,12878,25936
ţ,NiuFoZhen,510304107,30373,6139,24163,17089,46969,24091,11207,23444,47535,23556,47719
,MiaoBaZhen,510304108,9739,2392,7803,6127,15272,7803,3554,7882,15685,7882,15685
,HuiLongZhen,510304109,17364,3365,12930,8656,25834,12925,5613,13362,26287,13412,26342
,YongJiaXiang,510304204,5386,1300,4482,2906,8510,4482,2303,4503,8985,4507,8989
ƽ,HePingXiang,510304205,12665,1708,8734,7506,15874,8734,2205,7843,16577,7844,16578
,FengHuangXiang,510304207,29631,3979,19858,12789,19879,19545,4999,18287,37832,18751,38609
̲,YanTanZhen,510311100,21238,3703,15638,9380,27303,15232,5482,14427,29659,14785,30423
ƺ,WeiPingZhen,510311101,26696,4369,18721,10382,35482,18502,6329,18191,36693,18673,37394
¡,XingLongZhen,510311102,10947,1875,7578,4592,15061,7575,2571,7797,15372,7815,15393
ȫ,FuQuanZhen,510311105,11036,2359,8560,5255,16654,8543,3679,8427,16970,8514,17074
,YongAnZhen,510311106,14013,2695,10225,5997,19536,9442,3632,9220,18662,10115,20340
,LianLuoZhen,510311107,8098,2095,6735,4542,13118,6735,3256,6711,13446,6714,13449
˹,DengGuanZhen,510311108,10995,2111,7944,5439,13328,7491,2536,6839,14330,7698,15642
,WangJingZhen,510311109,9214,1979,7301,4830,13360,7298,2922,6763,14061,6814,14115
,HuangShiZhen,510311110,13063,3039,9983,6855,19304,9958,3819,9741,19699,9938,19921
,WaShiZhen,510311111,19839,4520,15832,11269,30060,15805,7097,15563,31368,15624,31456
,XianShiZhen,510311112,16477,3965,13100,8931,25024,12997,5453,12563,25560,12795,25895
ɽ,LiuShanXiang,510311203,7479,1476,5653,3465,11071,5650,2407,5673,11323,5709,11362
ź,JiuHongXiang,510311204,12677,2942,10244,6483,19686,10227,4726,10045,20272,10101,20345
,XuYangZhen,510321100,119320,18131,83774,52899,130288,79097,25187,73388,152485,78864,162638
˫ʯ,ShuangShiZhen,510321102,22919,4478,16035,9765,29069,15002,5003,15435,30437,16365,32400
,WangJiaZhen,510321103,11247,2655,7991,4609,15457,6013,2265,5974,11987,8176,16167
,DingXinZhen,510321107,11245,2576,8034,5540,15496,8026,2492,8273,16299,8279,16313
ֵ,LeDeZhen,510321110,19717,4036,13688,8638,26707,12441,3976,12675,25116,14041,27729
ˮ,GuoShuiZhen,510321111,12215,2808,8472,5761,16612,8469,2384,8908,17377,8935,17407
,GuWenZhen,510321112,9146,1925,6192,4500,12131,6105,1631,6379,12484,6510,12702
ӿ,HeKouZhen,510321113,11438,2398,7775,4807,15440,7771,2270,8298,16069,8331,16106
,XinQiaoZhen,510321114,10682,2120,7616,4942,14230,7529,2518,7429,14958,7704,15320
,ZhengZiZhen,510321115,8790,1305,5627,3730,10471,5382,1527,5732,11114,5995,11622
ȼ,DuJiaZhen,510321116,15820,3274,11012,7272,20866,10787,3309,11136,21923,11391,22403
,DongJiaZhen,510321117,10903,2287,7709,5119,14725,7679,2333,7744,15423,7814,15523
ɽ,ChangShanZhen,510321118,22431,3862,15812,10278,26992,15289,4933,14731,30020,15414,31226
,BaoHuaZhen,510321119,15529,2795,10415,6402,20324,10120,3158,10445,20565,11067,21482
,LiuJiaZhen,510321120,22355,4295,15639,9904,30754,15572,4940,15819,31391,15951,31590
Ĳ,LaiMouZhen,510321121,14200,3272,10498,5931,19576,7810,3166,7182,14992,10140,20638
˫,ShuangGuZhen,510321122,15922,3017,10822,6404,21316,10412,3234,10721,21133,11351,22173
ɽ,GuanShanZhen,510321123,10555,2322,7515,4845,14342,6909,2118,6797,13706,7480,14995
ɽ,GaoShanZhen,510321124,17933,3467,12028,7539,24174,11278,3469,11902,23180,12841,24869
,DongXingZhen,510321125,4897,998,3298,2189,6571,3243,977,3381,6624,3574,6872
,TieChangZhen,510321126,8316,1663,5697,3646,10923,5650,1475,5685,11335,5757,11454
,JinHuaXiang,510321202,3068,756,2288,1685,4248,2288,712,2248,4536,2248,4536
,LeiYinXiang,510321203,4648,909,3129,2110,6277,3114,924,3306,6420,3352,6481
ż,GuJiaXiang,510321204,5852,1286,4006,2585,7915,3972,1137,4154,8126,4269,8275
ڼ,YuJiaXiang,510321205,4609,962,3199,2051,6127,3136,932,3172,6308,3304,6503
,FuXingXiang,510321206,4401,1030,3060,1810,5992,3039,849,3148,6187,3220,6280
ī,MoLinXiang,510321207,4840,1005,3347,2343,6675,3341,1091,3530,6871,3589,6936
,FuShiZhen,510322100,101281,14979,72977,43477,114193,69519,23369,63845,133364,66652,139629
,DongHuZhen,510322101,35749,5621,26339,14663,47722,25955,11110,25559,51514,26141,52480
,PiPaZhen,510322102,19552,3322,14085,7654,28190,14085,6029,14814,28899,14818,28903
ʨ,ShiShiZhen,510322103,12808,2867,9888,6455,19167,9874,4467,10182,20056,10254,20142
,QiLongZhen,510322104,29994,5078,21370,11825,43045,21364,8938,22585,43949,22640,44010
,HuZhuZhen,510322107,18119,3288,12970,7479,26018,12964,5153,13551,26515,13590,26560
,DaiSiZhen,510322111,34106,6101,25725,13003,49200,23330,11077,23647,46977,25559,51284
ʯ,ZhongShiZhen,510322112,12144,2278,8760,4968,17547,8754,3641,9264,18018,9303,18063
ͯ,TongSiZhen,510322113,18331,3484,14053,8084,27268,13231,6704,13683,26914,14466,28519
ŷ,GuFoZhen,510322114,12697,2311,9428,5248,18569,9203,4324,9444,18647,9904,19332
,YongNianZhen,510322115,26987,4564,19552,11702,38121,19073,7814,19256,38329,19813,39365
,PengMiaoZhen,510322116,12624,2211,9475,5337,18711,9472,4392,9709,19181,9752,19227
ɽ,DouShanZhen,510322117,21977,3765,15605,9266,31708,15245,6584,16184,31429,16721,32326
,BanQiaoZhen,510322118,21841,3551,16067,11036,32216,16067,7015,16334,32401,16340,32407
,FuShanZhen,510322119,18342,2962,13142,7009,26893,12880,5833,13591,26471,13995,27137
,LiQiaoZhen,510322120,16685,2714,11942,6899,24076,11875,5327,12696,24571,12784,24726
Ի,ZhaoHuaZhen,510322121,21387,3819,15810,9019,30284,14788,6618,15300,30088,16014,31824
Ϫ,AnXiZhen,510322122,21722,4039,15259,9279,30010,15056,5967,16100,31156,16469,31728
,WanShouZhen,510322123,12997,2761,9645,5923,19454,9640,4012,10104,19744,10125,19770
,FeiLongZhen,510322124,18918,3541,13454,8435,26978,13325,5477,14247,27572,14482,27936
,HuaiDeZhen,510322125,17370,3264,13191,8155,25285,13184,5330,12725,25909,12773,25964
̲,ChangTanZhen,510322126,10348,1719,7552,3756,14483,7550,3033,7545,15095,7548,15100
,LongWanXiang,510322200,16921,3218,12524,8183,25288,12517,5648,13241,25758,13263,25787
,BaoQingXiang,510322201,11304,2009,8180,4417,16148,8157,3374,8442,16599,8507,16687
,FuHeXiang,510322202,8098,1531,5950,3480,11801,5915,2451,6078,11993,6130,12080
ʯ,ShiDaoXiang,510322203,10465,1709,7397,4108,14861,7387,3035,7772,15159,7812,15209
ɿڽֵ´,DaDuKouJieDaoBanShiChu,510402001,30825,4113,19633,14262,25813,19136,5765,19282,38418,21070,40703
ݸڽֵ´,BingCaoGangJieDaoBanShiChu,510402002,103381,10166,63576,39874,82826,54935,17082,53887,108822,67053,130629
ɽֵ´,NanShanJieDaoBanShiChu,510402003,4552,701,3128,2333,4808,3113,925,3022,6135,3050,6178
ֵ´,XiangYangCunJieDaoBanShiChu,510402004,8912,1480,5632,4381,7840,5400,1476,5467,10867,6236,11868
ŪŪƺֵ´,NongNongPingJieDaoBanShiChu,510402005,20763,3251,13658,10584,19088,13489,3963,13984,27473,14319,27977
ƺֵ´,ZaoZiPingJieDaoBanShiChu,510402006,17501,2174,11205,8450,17056,10838,3145,11243,22081,11615,22820
·ֵ´,ChangShouLuJieDaoBanShiChu,510402007,7833,1083,4965,3761,7272,4780,1393,4851,9631,5344,10309
ܵؽֵ´,MiDiJieDaoBanShiChu,510402008,15950,2142,10329,7977,13580,10283,3125,10706,20989,10888,21217
ƺֵ´,GuaZiPingJieDaoBanShiChu,510402009,28195,4487,18954,13652,30987,18360,5496,18351,36711,19224,38178
,YinJiangZhen,510402100,42456,3804,25287,20894,22450,24848,8187,27023,51871,29160,54447
ƺֵ´,QingXiangPingJieDaoBanShiChu,510403001,36639,3429,23785,15525,33139,22233,7949,22138,44371,24232,48017
Ȫֵ´,YuQuanJieDaoBanShiChu,510403002,19340,2794,12037,8634,14464,11215,3402,11410,22625,13499,25536
ſڽֵ´,HeMenKouJieDaoBanShiChu,510403003,5641,963,3701,3168,5043,3679,1023,3829,7508,3926,7627
ռҶɽֵ´,TaoJiaDuJieDaoBanShiChu,510403004,15982,2735,10947,8500,17149,10900,3331,10883,21783,11101,22048
Ħӽֵ´,MoSuoHeJieDaoBanShiChu,510403005,10001,1586,6559,5397,8694,6521,2441,7090,13611,7469,14028
󱦶ֵ´,DaBaoDingJieDaoBanShiChu,510403006,10991,1769,6854,5500,10858,6801,2231,7363,14164,8137,14991
ƺ,GeLiPingZhen,510403100,23165,2494,14103,9891,16671,13424,4651,13936,27360,16207,30310
·ֵ´,DaHeZhongLuJieDaoBanShiChu,510411001,25167,3495,17044,11031,19133,15448,5365,15695,31143,16983,34027
ʺ,RenHeZhen,510411100,40780,4167,25983,17050,34365,24989,8533,24901,49890,27497,53480
ƽ,PingDiZhen,510411101,9876,1382,6670,3679,13027,6626,2384,6890,13516,6972,13642
,DaTianZhen,510411102,5871,892,3913,2368,7216,3882,1236,4002,7884,4086,7999
,FuTianZhen,510411103,3020,367,1996,1202,3444,1904,785,1985,3889,2176,4172
ͬ,TongDeZhen,510411104,9621,1334,6473,3916,11883,6448,2322,6758,13206,6804,13277
,JinJiangZhen,510411105,20781,1745,11239,7544,14297,10323,3653,10886,21209,14940,26179
,BuDeZhen,510411106,11715,1546,7763,4337,13669,7569,2699,7817,15386,8197,15960
ǰ,QianJinZhen,510411107,20842,1472,12974,8543,16598,12681,4599,13164,25845,13939,26913
̶,DaLongTanYiZuXiang,510411200,10398,1424,6879,3860,13297,6823,2490,7118,13941,7433,14312
,ALaYiZuXiang,510411201,5771,952,3822,2255,7697,3801,1324,4187,7988,4225,8047
ܷ,ZongFaXiang,510411202,6400,806,4102,2447,7324,4043,1225,4192,8235,4329,8431
̫ƽ,TaiPingXiang,510411203,13504,758,6405,3906,8199,6066,2788,6538,12604,10645,17050
,WuBenXiang,510411204,5041,787,3417,2130,6429,3395,1383,3498,6893,3794,7211
а,ZhongBaXiang,510411205,7114,888,4644,2694,8999,4586,1592,4827,9413,4950,9594
,PanLianZhen,510421100,45183,5437,29948,18007,42860,28096,9582,28123,56219,30254,60202
,BingGuZhen,510421101,17704,2801,11805,7306,20728,11708,3913,12350,24058,12613,24418
ʯ,DeShiZhen,510421102,4373,590,3089,1693,4939,2985,1424,2977,5962,3298,6387
,SaLianZhen,510421103,11863,1716,8270,4615,14147,8246,3416,8654,16900,8725,16995
,YaKouZhen,510421104,8467,1085,5377,3143,9191,5295,1717,5541,10836,5892,11269
,BaiMaZhen,510421105,19835,2880,13481,7837,25352,13290,5061,13743,27033,14295,27776
,PuWeiZhen,510421106,8682,1218,6581,3555,11568,6522,3554,6690,13212,6873,13454
ݳ,CaoChangXiang,510421200,13428,2073,9330,4964,17656,9211,3466,9370,18581,9637,18967
,WanQiuYiZuXiang,510421201,11604,1486,8125,4478,13365,8113,3459,8393,16506,8424,16549
,BaiPoYiZuXiang,510421202,5628,841,4116,2346,7902,4115,2094,4434,8549,4447,8563
¤,MaLongYiZuXiang,510421203,4985,540,3831,1891,6135,3812,2190,3853,7665,3884,7715
ɽ,XinShanLiSuZuXiang,510421204,4996,677,3333,1779,6521,3312,1259,3561,6873,3599,6932
ͩ,TongZiLinZhen,510422100,19546,2200,12791,7984,19074,11817,4433,11605,23422,13388,26179
,HongGeZhen,510422101,10624,1294,7017,3899,12144,6714,2611,6849,13563,7512,14529
,YuMenZhen,510422102,14335,1553,10253,5696,16211,9745,4895,9902,19647,10530,20783
,YongXingZhen,510422103,14322,2061,10148,5910,19436,10090,4313,10461,20551,10548,20696
,YiMinXiang,510422200,8620,1088,5892,3742,10807,5863,2521,6143,12006,6337,12229
¾,XinJiuXiang,510422201,9234,1086,5803,3495,10242,5696,2380,6105,11801,6897,12700
Ͱ,HeAiYiZuXiang,510422202,3686,454,2557,1255,4758,2518,1065,2593,5111,2648,5205
,HongGuoYiZuXiang,510422203,10824,964,6835,3810,10935,6709,3571,7080,13789,8524,15359
,GanYuYiZuXiang,510422204,5504,741,4018,2087,7410,3990,1914,4096,8086,4141,8159
,GongHeXiang,510422205,5936,906,4339,2318,8513,4294,2150,4493,8787,4653,8992
ʤ,GuoShengXiang,510422206,12566,2023,8748,4879,17248,8581,3467,9026,17607,9308,18056
챦,HongBaoMiaoZuXiang,510422207,3315,449,2427,1236,4758,2415,1180,2453,4868,2517,4944
,HuiMinXiang,510422208,10153,1714,7256,4618,14325,7237,3090,7660,14897,7701,14957
,QingHeLiSuZuXiang,510422209,4238,566,3067,1675,5326,3057,1558,3240,6297,3295,6362
Ȫ,WenQuanYiZuXiang,510422210,4307,470,3324,1944,5861,3323,2021,3466,6789,3474,6798
,GeSaLaYiZuXiang,510422211,7510,751,5784,2857,10177,5755,3508,5892,11647,5985,11769
ϳǽֵ,NanChengJieDao,510502001,37151,5658,25237,16107,34691,22834,5105,20904,43738,22677,47914
ǽֵ,BeiChengJieDao,510502002,36273,4443,24197,14233,27535,19244,4194,17452,36696,20713,44910
ɽƺֵ,DaShanPingJieDao,510502003,71790,8374,46612,28492,58659,42356,11393,39469,81825,44945,91557
ֵ´,LinYuJieDaoBanShiChu,510502004,14064,2186,9816,6491,15592,9428,2788,8662,18090,9222,19038
ֵ´,LanTianJieDaoBanShiChu,510502005,32494,4827,22286,14078,36039,21920,6759,21361,43281,21794,44080
ݽֵ´,QianCaoJieDaoBanShiChu,510502006,25823,4193,17035,11440,28019,16030,4179,15752,31782,17160,34195
ֵ´,HuaYangJieDaoBanShiChu,510502007,36360,2852,22252,10832,27392,16536,6137,16150,32686,23097,45349
ŰӾ´,ZhangBaJingQuBanShiChu,510502008,4198,488,2871,1743,3530,2868,915,2689,5557,2730,5601
̩,TaiAnZhen,510502102,11242,2058,8119,4996,14252,8092,3065,8100,16192,8246,16365
,HuangYiZhen,510502103,22388,4231,17105,10593,30933,17059,7050,16420,33479,16564,33669
,MiTuoZhen,510502104,15564,3328,12429,7514,23533,12390,5803,12150,24540,12266,24695
,KuangChangZhen,510502105,22133,4217,17013,10121,31883,16947,7733,16779,33726,17070,34083
̲ͨ,TongTanZhen,510502106,21065,4766,17542,11845,32260,17512,8700,16907,34419,16989,34531
,JiangBeiZhen,510502107,14135,2421,10524,6931,20225,10517,4896,10888,21405,10928,21452
ɽ,FangShanZhen,510502108,13502,2425,9592,6251,19187,9556,4032,10221,19777,10367,19959
,DanLinXiang,510502200,8044,2120,6592,4893,12573,6581,3223,6731,13312,6795,13387
ˮ,FenShuiLingXiang,510502202,18509,3896,13985,8809,27471,13849,6391,14524,28373,14811,28796
ʯկ,ShiZhaiXiang,510502203,10368,1762,7644,4712,14811,7611,3520,7817,15428,8006,15650
ֵ,AnFuJieDao,510503001,25294,3506,16393,11788,18306,16167,4396,16457,32624,16803,33196
ֵ,YongNingJieDao,510503002,38322,4824,25584,16835,28499,22196,6874,20911,43107,24436,50020
ɿ,DaDuKouZhen,510503100,22186,3291,15965,10120,30561,15727,6394,15470,31197,15906,31871
,HuGuoZhen,510503101,37925,5791,26619,15134,52973,25556,11079,26956,52512,28176,54795
,DaGuZhen,510503102,21072,3528,14756,8605,30174,14692,6438,16095,30787,16282,31038
,ShangMaZhen,510503103,18232,2845,12754,7810,25993,12734,5466,13696,26430,13789,26543
,HeMianZhen,510503104,23106,3757,16172,9933,33116,15914,7007,17268,33182,17698,33870
޻,MianHuaPoZhen,510503105,23818,3663,16692,10662,32561,16480,6257,16757,33237,17046,33738
,FengLeZhen,510503106,23547,4065,16001,10370,32828,15905,6016,17464,33369,17627,33628
׽,BaiJieZhen,510503107,24684,4446,17190,10890,35533,17189,6866,18798,35987,18806,35996
,TianXianZhen,510503108,10430,1488,7333,4299,14733,7327,3034,7587,14914,7619,14952
,XinLeZhen,510503109,20273,2680,13675,9394,26537,13314,5137,13392,26706,14415,28090
,QuBaZhen,510503110,12260,1852,8520,5646,16327,8493,3414,8944,17437,9006,17526
,LongCheZhen,510503111,17731,3077,12336,7427,24936,12330,5330,13745,26075,13802,26138
Снֵ´,XiaoShiJieDaoBanShiChu,510504001,31188,3865,21111,15035,24095,19800,4861,18658,38458,18803,39914
߰ӳ´,GaoBaChangQuBanShiChu,510504002,18783,3538,12367,8573,20430,11139,2154,10756,21895,12108,24475
ǽֵ´,HongXingJieDaoBanShiChu,510504003,57607,4846,37002,24385,35560,33041,9248,31638,64679,34699,71701
ؽֵ´,LianHuaChiJieDaoBanShiChu,510504004,21301,1797,13759,10033,13221,13721,4129,13346,27067,13468,27227
޺,LuoHanZhen,510504100,12121,1682,7875,5093,12384,7202,1865,6864,14066,7793,15668
,YuTangZhen,510504101,16374,1891,10675,6916,16757,10308,2871,10000,20308,10461,21136
ʯ,ShiDongZhen,510504102,24684,4381,17584,11747,32964,17431,6063,17232,34663,17544,35128
,HuShiZhen,510504103,14852,3034,11158,7442,20172,10758,4083,10357,21115,10811,21969
,TeXingZhen,510504104,12711,2823,9442,6687,18174,9434,3199,9272,18706,9291,18733
,AnNingZhen,510504105,18114,3032,12595,8264,23854,12573,4084,12454,25027,12635,25230
˫,ShuangJiaZhen,510504106,11974,2848,9567,6624,18257,9564,4025,9249,18813,9280,18847
,JinLongXiang,510504200,8664,2467,7309,5761,13834,7299,3032,6812,14111,6854,14163
,ChangAnXiang,510504201,6638,1554,5341,3744,9859,5332,2218,5055,10387,5069,10410
,FuJiZhen,510521100,93419,13873,65866,37704,112025,61606,24635,60885,122491,66061,131927
,JiaMingZhen,510521101,18957,4006,14794,9517,25821,13860,6436,13156,27016,14605,29399
,YuSiZhen,510521102,25439,4894,19213,11992,34423,18136,7927,17635,35771,19047,38260
ʤ,DeShengZhen,510521103,32569,5958,23043,12798,46345,22946,8807,23890,46836,24291,47334
ţ̲,NiuTanZhen,510521105,24387,4670,18077,11006,31685,16337,6928,15984,32321,17908,35985
,ZhaoYaZhen,510521106,23954,4487,18052,11183,31462,16543,6900,15894,32437,17289,35341
̲,XuanTanZhen,510521107,46061,8778,34689,20990,64834,33051,14411,32949,66000,34561,69250
̫,TaiFuZhen,510521108,36487,7983,29350,19934,56745,29324,14193,29184,58508,29313,58663
,YunLongZhen,510521109,28532,5238,20881,12249,34732,17764,7850,17465,35229,20739,41620
ʯ,ShiQiaoZhen,510521110,22981,4195,16716,10922,31976,16698,6605,16899,33597,17065,33781
¬,PiLuZhen,510521111,22574,3982,16228,9364,31800,16201,6411,16601,32802,16739,32967
,QiFengZhen,510521112,23107,5072,17837,10980,34567,17831,7555,17867,35698,17897,35734
,ChaoHeZhen,510521113,29388,5898,21874,12836,44137,21633,9540,22492,44125,22952,44826
ƽ,YunJinZhen,510521114,34787,6956,27345,17472,51877,27017,12642,26838,53855,27040,54385
ʯ,LiShiZhen,510521115,21854,3997,16616,10994,31676,16532,7445,16589,33121,16680,33296
ٺ,BaiHeZhen,510521116,20149,4857,17062,11231,31984,16992,8682,16453,33445,16626,33688
,TianXingZhen,510521117,13513,2893,10774,6172,20648,10764,4930,10490,21254,10562,21336
,FangDongZhen,510521118,25151,4937,18263,10627,35825,18183,7243,18704,36887,19068,37331
,HaiChaoZhen,510521123,16971,3379,12559,8347,24780,12491,4863,12510,25001,12654,25213
Ͻ,HeJiangZhen,510522100,101438,12431,68051,40927,83957,60358,23568,56466,116824,69386,137437
,WangLongZhen,510522101,15818,3410,12675,8509,23551,12665,6376,12893,25558,12929,25604
ɳ,BaiShaZhen,510522102,12690,2453,9766,6468,17588,9452,4675,9554,19006,10052,19818
,FoYinZhen,510522103,15578,4146,12836,8479,24086,12795,6243,13009,25804,13131,25967
,XianShiZhen,510522104,19064,4235,14753,9236,28218,14667,6709,15093,29760,15255,30008
Ң,YaoBaZhen,510522105,13787,3065,10228,6889,20623,10176,4715,11209,21385,11339,21567
֧,JiuZhiZhen,510522106,25767,4049,18402,11879,29372,18218,7846,19056,37274,19260,37662
ͨ,WuTongZhen,510522107,15109,2807,10973,6073,21859,10934,5007,11831,22765,11950,22923
,FengMingZhen,510522108,17036,4126,13173,8930,26370,13168,6134,14122,27290,14123,27296
ɽ,RongShanZhen,510522109,27468,5063,19962,14336,36916,19651,8282,20433,40084,20851,40813
¹,BaiLuZhen,510522110,19389,3866,14474,9274,28524,14463,6885,15613,30076,15666,30140
,GanYuZhen,510522111,10049,2794,8499,6325,16380,8492,4548,8857,17349,8892,17391
,FuBaoZhen,510522112,18005,3872,13255,9851,26678,13255,5581,14201,27456,14203,27458
̲,XianTanZhen,510522113,10220,2256,8236,5915,16489,8229,4516,8746,16975,8756,16992
Ի,ZiHuaiZhen,510522114,4256,1312,3721,3076,7359,3721,2091,3936,7657,3938,7659
,DaQiaoZhen,510522115,18903,4502,15569,9742,29373,15550,7314,15095,30645,15150,30719
,CheWangZhen,510522116,8987,2508,7113,5457,14333,7109,3361,7716,14825,7743,14856
Ϫ,MiXiXiang,510522200,10259,2306,7843,4830,15657,7843,3482,8194,16037,8204,16047
,BaiMiXiang,510522201,18531,4346,14528,10781,28067,14494,6631,14647,29141,14980,29508
̲,JiaoTanXiang,510522202,10549,2100,8214,5479,16060,8209,4110,8508,16717,8545,16759
α,CanBaoXiang,510522203,11711,2699,9625,6355,18175,9563,5098,9821,19384,9883,19508
,ErLiXiang,510522206,14155,3428,11084,7507,22229,11051,5429,11821,22872,11928,23012
ʵ¼,ShiLuXiang,510522208,11559,2803,8577,5729,17389,8563,3655,9390,17953,9440,18017
ͷ,HuTouXiang,510522209,13528,3040,10669,6945,20245,10626,4962,10798,21424,10861,21530
,RongYouXiang,510522210,6540,1859,5381,4096,10499,5346,2714,5647,10993,5732,11113
̲,NanTanXiang,510522212,7173,1525,5460,3873,10951,5460,2658,5881,11341,5896,11356
ʯ,ShiLongXiang,510522213,4771,1483,3959,3243,7968,3953,2062,4276,8229,4357,8316
,XuYongZhen,510524100,78972,9973,53944,32099,84267,49932,19407,49722,99654,54408,108352
,JiangMenZhen,510524101,19647,3229,14565,8380,28637,14425,7170,15127,29552,15481,30046
,MaLingZhen,510524102,19234,3100,14243,8819,28169,14085,7140,14958,29043,15231,29474
,TianChiZhen,510524103,9457,1830,7257,4796,14359,7226,3958,7816,15042,7988,15245
ˮβ,ShuiWeiZhen,510524104,13645,2219,10381,6484,20664,10315,5798,11175,21490,11281,21662
,LiangHeZhen,510524105,17372,3174,12744,8136,25262,12741,6057,13830,26571,13859,26603
䲷,LuoBuZhen,510524106,18556,2957,13614,8004,26717,13571,7025,14801,28372,14924,28538
ɽ,HouShanZhen,510524107,14101,2212,10301,6327,21118,10264,5643,11593,21857,11655,21956
ˮ,FenShuiZhen,510524108,13587,2478,10801,6376,21025,10657,6600,11629,22286,11864,22665
Ħ,MoNiZhen,510524109,17234,2707,13026,7267,25905,12960,7564,14202,27162,14479,27505
ˮ,ChiShuiZhen,510524110,14104,2927,11267,6970,21815,11216,6795,12227,23443,12559,23826
,XiangLinXiang,510524200,11024,1991,8492,5287,17094,8435,4632,9080,17515,9155,17647
ʯ,DaShiXiang,510524201,11870,1909,8963,5117,18261,8937,5168,9929,18866,9984,18947
¡,XingLongXiang,510524202,12274,2027,9283,5788,18514,9248,5128,10074,19322,10146,19429
,LongFengXiang,510524203,16970,2772,12249,7711,25152,12244,6099,13585,25829,13592,25841
,ZhenDongXiang,510524204,17303,2339,12246,6570,23868,12017,6546,13166,25183,13942,26188
,HuangNiXiang,510524206,11090,2141,8357,5153,17034,8320,4860,9628,17948,9734,18091
Ӫɽ,YingShanXiang,510524207,7363,1146,5520,3324,10877,5497,3036,5966,11463,6025,11545
,MaChengXiang,510524208,8420,1476,6551,4043,12730,6504,3852,7078,13582,7197,13748
,GuanXingXiang,510524209,10782,1949,8503,5061,16503,8462,5034,9170,17632,9262,17765
,HeLeMiaoZuXiang,510524210,5635,960,4215,2476,8485,4166,2451,4728,8894,4831,9046
,BaiLaMiaoZuXiang,510524211,9676,1820,7518,4378,14872,7474,4462,8377,15851,8440,15958
Ų,JianCaoMiaoZuXiang,510524212,5331,934,4319,2618,8450,4251,2754,4590,8841,4700,9019
ˮ,ShuiLiaoYiZuXiang,510524213,11023,1621,8853,4393,16440,8821,5725,9396,18217,9516,18369
ʯ,ShiBaYiZuXiang,510524214,4053,679,3291,1923,6292,3266,2102,3431,6697,3543,6834
,GuLinZhen,510525100,84646,9067,57319,27572,103912,53658,22814,55433,109091,59208,116527
ɽ,LongShanZhen,510525101,15623,1900,11732,6923,21767,11729,6329,12085,23814,12120,23852
,YongLeZhen,510525102,19661,3046,15347,8292,29871,15339,8992,16276,31615,16352,31699
̫ƽ,TaiPingZhen,510525103,20566,2450,15345,7746,29462,15318,8242,15839,31157,15913,31258
,ErLangZhen,510525104,27096,2960,19727,10241,37348,19049,9895,18861,37910,20224,39951
,DaCunZhen,510525105,14902,1856,11216,5978,22227,11196,6210,11687,22883,11752,22968
ʯ,ShiBaoZhen,510525106,26722,3363,21679,9426,38893,21679,13518,21923,43602,21924,43603
,DanGuiZhen,510525107,22108,2515,16840,7638,31950,16789,9878,17412,34201,17661,34501
ˮ,ShuiKouZhen,510525108,24491,2561,18201,7733,33702,18199,10662,19504,37703,19513,37714
,GuanWenZhen,510525109,17579,2245,13080,7392,24889,13042,7704,14083,27125,14448,27528
˫ɳ,ShuangShaZhen,510525110,25184,3693,18515,10539,36310,18500,9795,20062,38562,20157,38672
Ծ,DeYueZhen,510525111,10536,1648,7476,4624,14764,7447,3570,8194,15641,8278,15754
,HuJiaXiang,510525201,12062,1713,8573,5149,17153,8568,4437,9473,18041,9639,18212
㻯,YuHuaXiang,510525202,15030,1907,12058,5781,21405,12025,7272,11991,24016,12151,24209
ʯ,ShiPingXiang,510525203,20273,2296,14877,7436,27932,14810,8132,15419,30229,15824,30701
,DongXinXiang,510525204,11406,1620,9252,4759,18347,9240,5643,9396,18636,9417,18669
,TuChengXiang,510525205,14149,1738,11807,5719,21630,11798,7457,11494,23292,11537,23344
,JinXingXiang,510525206,24452,3134,18123,8439,35021,18115,9857,19283,37398,19320,37443
,BaiNiXiang,510525207,7733,1278,6195,2893,11854,6157,3808,6561,12718,6624,12819
԰,JiaoYuanXiang,510525208,12354,1842,9752,4101,18663,9725,6365,10655,20380,10809,20561
˻,MaSiMiaoZuXiang,510525209,6194,1004,4736,2584,9602,4695,2792,5164,9859,5254,9990
,MaTiXiang,510525211,13390,2166,10373,5370,20378,10373,6303,11486,21859,11486,21859
,JianZhuMiaoZuXiang,510525212,8555,1279,6079,3392,11477,6052,3122,6782,12834,6877,12956
կ,DaZhaiMiaoZuXiang,510525214,3538,620,2627,1477,5019,2606,1242,2731,5337,2773,5400
,GuiHuaXiang,510525215,5860,1033,4303,2672,8751,4273,2208,4712,8985,4798,9101
ƾ,HuangJingXiang,510525216,2607,431,1741,1128,3591,1713,754,1964,3677,2051,3792
ֵ,JingYangJieDao,510603001,41883,6404,27897,20529,33404,26587,6199,25288,51875,26589,54486
Ͻֵ,ChengNanJieDao,510603002,78948,11225,50479,37620,66794,48381,12186,47980,96361,51880,102359
Ǳֵ,ChengBeiJieDao,510603003,42584,6584,28027,21147,38474,26793,6738,25928,52721,27879,55906
캶ֵ,JingDongJieDao,510603004,65329,6712,41312,27294,36249,37567,9886,36065,73632,40615,81927
ũֵ,GongNongJieDao,510603005,48646,3958,24519,14703,28812,18213,4450,18464,36677,32535,57054
,HuangXuZhen,510603100,42095,6378,25432,20443,49998,25311,5524,24930,50241,28565,53997
ТȪ,XiaoQuanZhen,510603101,27006,4415,18061,12655,31605,17260,3791,16697,33957,17151,35212
˽Ǿ,BaJiaoJingZhen,510603102,22238,2911,14166,9869,25207,13799,3359,13490,27289,14342,28508
¡,BaiLongZhen,510603103,16532,2948,11200,8524,20665,11169,2660,10801,21970,10940,22140
Т,XiaoGanZhen,510603104,16641,2279,10772,7364,18686,10729,2566,10606,21335,10714,21486
Ԫ,TianYuanZhen,510603105,34112,4240,21183,14840,35532,20590,5164,20705,41295,22333,43516
,YangJiaZhen,510603107,14931,2358,9726,7125,17904,9716,2050,9576,19292,9613,19339
,DeXinZhen,510603108,22302,3545,14426,10125,26505,14276,3222,14107,28383,14643,29069
˫,ShuangDongZhen,510603110,15617,2817,10128,8492,19981,10100,2408,10657,20757,10714,20842
,XinZhongZhen,510603111,7396,1378,4813,3955,9108,4696,1325,5021,9717,5286,10099
,HeXinZhen,510603117,11108,1758,6823,5462,13883,6812,1644,7631,14443,7687,14510
,DongHuXiang,510603201,68510,5296,42991,26617,42256,37475,10814,36873,74348,41629,84620
,KaiJiangZhen,510623100,74105,8186,47996,29550,68864,42899,11792,40680,83579,46087,94083
ϻ,NanHuaZhen,510623101,50177,6149,33409,24202,59280,32057,10330,32179,64236,33247,66656
,HuiLongZhen,510623102,29519,5048,19955,14227,40535,19952,6620,21181,41133,21232,41187
ͨ,TongJiZhen,510623103,17331,3147,12478,9371,25221,12478,4977,12977,25455,12977,25455
̫,YongTaiZhen,510623104,26375,4563,18451,14153,37609,18448,6947,19413,37861,19434,37885
¹,HuangLuZhen,510623105,12937,2622,9235,7562,18827,9220,3529,9840,19060,9853,19088
,JiFengZhen,510623106,18323,3311,12133,9329,25110,12011,3851,13203,25214,13352,25485
,FuXingZhen,510623107,21810,3840,14283,10803,29792,14209,4539,15778,29987,15906,30189
,JiQingZhen,510623108,23894,4185,17076,12820,33399,16959,6401,17166,34125,17404,34480
¡,XingLongZhen,510623109,26185,4002,17614,13729,36317,17591,6288,18811,36402,18861,36475
̨,LongTaiZhen,510623110,37459,6187,25241,17513,49295,23901,8160,25382,49283,26565,51806
,YongAnZhen,510623111,18182,3687,13017,10308,26505,13000,4838,13637,26637,13690,26707
˫,ShuangLongZhen,510623112,13066,2529,9042,6287,18719,8946,3178,9528,18474,9731,18773
,YuXingZhen,510623113,18708,3141,12981,9534,26180,12873,4731,13317,26190,13599,26580
,YongXingZhen,510623114,18382,3092,12284,8531,25025,12271,4343,13492,25763,13533,25817
,YueLaiZhen,510623115,14548,2568,9617,6684,19715,9606,2998,10454,20060,10497,20114
̹,JiGuangZhen,510623116,15012,2815,10324,7297,21486,10222,3825,11164,21386,11328,21652
ɽ,CangShanZhen,510623117,47876,8313,34234,22490,66517,33499,12012,33155,66654,33967,68201
㸣,GuangFuZhen,510623118,23291,4664,16843,12637,33896,16435,6132,16698,33133,17244,34087
,HuiLongZhen,510623119,12883,2914,9728,7707,19582,9725,4022,10087,19812,10091,19819
,WanFuZhen,510623120,15430,2895,10754,8615,22426,10754,4149,11720,22474,11720,22474
,PuXingZhen,510623121,15581,2814,11445,7963,23063,11443,4887,11837,23280,11837,23282
,LianHeZhen,510623122,13159,2607,9700,7492,19571,9668,3971,9981,19649,10037,19737
,FengDianZhen,510623123,26799,5021,18950,13702,39412,18672,7868,20111,38783,20738,39688
,JiJinZhen,510623124,10968,2375,8100,5970,15930,8097,2918,8148,16245,8161,16261
̫,TaiAnZhen,510623125,16226,2773,11005,7983,22819,10994,4045,12020,23014,12039,23044
,JieXingZhen,510623127,13730,2023,8883,6125,17974,8880,2487,9354,18234,9357,18240
ɽ,NanShanZhen,510623130,13398,1964,8755,5336,17844,8755,2610,9217,17972,9217,17972
,DongBeiZhen,510623132,28796,3974,18815,12871,36609,18321,5777,18968,37289,19732,38547
ŵ,GuDianXiang,510623200,8791,1517,5604,4377,11907,5595,1658,6319,11914,6362,11966
,QingShiXiang,510623201,7183,1420,4900,3965,10104,4891,1620,5298,10189,5323,10223
ߵ,WaDianXiang,510623203,5709,1217,3794,3100,7886,3778,1116,4233,8011,4248,8042
ʯȪ,ShiQuanXiang,510623204,7990,1380,5288,4029,10827,5245,1593,5599,10844,5675,10963
,BaiShuXiang,510623206,16244,3528,11359,8199,23797,11236,4113,12117,23353,12526,23885
׹,BaiGuoXiang,510623207,18853,3435,12656,8393,26687,12655,4454,14083,26738,14086,26742
,QingHeXiang,510623208,14984,2199,9831,6877,20445,9694,3416,10521,20215,10768,20599
ߵ,GaoDianXiang,510623209,5137,1256,3815,2866,7530,3803,1319,3872,7675,3897,7712
ʯ,ShiSunXiang,510623210,8755,1321,5848,3786,12030,5813,2077,6213,12026,6305,12153
̫ƽ,TaiPingXiang,510623211,15536,2317,10131,7274,21096,10042,3454,11039,21081,11176,21307
,MinZhuXiang,510623212,9005,1748,6005,4262,12532,6005,1893,6641,12646,6641,12646
,YongFengXiang,510623214,14932,2648,10599,7573,21296,10599,3769,10750,21349,10750,21349
Ԫ,YuanXingXiang,510623216,7844,2022,6153,4898,12212,6153,2423,6136,12289,6136,12289
ͨɽ,TongShanXiang,510623218,7901,2017,6343,5484,12402,6343,2568,6143,12486,6143,12486
ʯ,ShiLongXiang,510623219,9458,1966,6854,5071,13949,6854,2737,7307,14161,7307,14161
,HeXingXiang,510623221,12076,1858,7736,5207,16386,7735,2521,8703,16438,8719,16455
,WanAnZhen,510626100,44705,4115,28076,17151,36691,22774,6179,22127,44901,26923,54999
۳,YanJiaZhen,510626101,18632,3559,12394,9517,24449,12351,3093,12806,25157,12890,25284
ɽ,JinShanZhen,510626102,25290,4181,16535,13107,31625,16388,4121,16578,32966,17057,33592
ƺ,LvePingZhen,510626103,17176,3051,11361,9506,22099,11339,2670,11468,22807,11536,22897
Ӫ,YuYingZhen,510626104,7772,1238,5042,3589,9625,5033,1223,5181,10214,5191,10233
۾,HuiJiaoZhen,510626105,6426,1169,4310,3215,7800,4284,1081,4300,8584,4366,8676
Ԫ,DiaoYuanZhen,510626106,7736,1552,5261,4241,10152,5261,1306,5333,10594,5333,10594
ʢ,XinShengZhen,510626107,18540,3764,12756,9811,25347,12744,3605,13138,25882,13153,25909
,PanLongZhen,510626108,6468,1318,4167,3580,8361,4160,932,4545,8705,4551,8718
,BaiMaGuanZhen,510626113,8542,1429,5494,4512,10800,5406,1312,5656,11062,5789,11283
ó,LuoChengZhen,510681100,104264,13817,64391,45361,88172,59546,13202,56222,115768,66892,131283
ˮ,SanShuiZhen,510681101,24311,4033,16325,10633,30770,16316,3924,15900,32216,15943,32268
ɽ,LianShanZhen,510681102,27974,4535,18532,12554,34616,18494,4345,18175,36669,18322,36854
ƺ,GaoPingZhen,510681103,17270,2776,11376,7957,20780,11134,2610,11046,22180,11280,22656
,NanXingZhen,510681104,32607,4991,20928,15500,39885,20657,4409,19977,40634,21079,42007
,XiangYangZhen,510681105,25689,3828,16437,11278,28629,15859,3807,15308,31167,16887,33324
С,XiaoHanZhen,510681106,32776,4814,21276,15529,40772,21151,4900,20827,41978,21214,42490
,JinLunZhen,510681107,13795,2241,9151,6802,17305,9137,2050,8871,18008,8935,18086
·,XinFengZhen,510681108,47674,6806,30622,20535,53145,29992,7023,29261,59253,30881,61503
¡,XingLongZhen,510681109,18065,2995,11766,9925,22680,11736,2502,11675,23411,11796,23562
,HeXingZhen,510681112,14460,2352,9655,6011,17893,9552,2140,9088,18640,9297,18952
,SongLinZhen,510681113,14395,2192,9184,5475,18400,9098,2218,9463,18561,9621,18805
,JinYuZhen,510681114,20681,3012,13545,9337,26384,13520,3166,13242,26762,13314,26859
ƽ,XinPingZhen,510681115,10697,1563,7031,5769,13370,7018,1649,6847,13865,6878,13909
Ϸ,NanFengZhen,510681116,15286,2184,9933,6713,19028,9927,2160,9682,19609,9697,19630
,XiGaoZhen,510681119,11448,1947,7446,6171,14697,7417,1563,7370,14787,7512,14958
,BeiWaiXiang,510681200,15686,1967,9998,6084,17978,9850,2469,9346,19196,10124,20122
,XiWaiXiang,510681202,10739,1548,7018,4613,12963,6918,1560,6647,13565,6829,13847
ֵͤ´,FangTingJieDaoBanShiChu,510682001,67408,8711,43803,31707,60073,41589,9570,38818,80407,41886,85689
ǽֵ´,ZaoJiaoJieDaoBanShiChu,510682002,13007,1770,8541,5549,12958,7639,1704,7204,14843,7940,16481
Ԫʯ,YuanShiZhen,510682101,13452,2112,8770,6296,13612,8557,1934,8397,16954,8728,17498
,HuiLanZhen,510682103,16929,2792,11074,7446,21364,11044,2231,10748,21792,10878,21952
ˮ,LuoShuiZhen,510682105,26301,4398,17134,12210,31631,17005,3525,16613,33618,17090,34224
̷,HeFengZhen,510682106,17250,2945,11276,8326,21793,11257,2268,11092,22349,11187,22463
˫ʢ,ShuangShengZhen,510682107,16780,2771,10959,8228,20710,10957,2236,10812,21769,10828,21787
,MaZuZhen,510682108,17727,3051,11523,8842,20560,11459,2314,11313,22772,11569,23092
,YinFengZhen,510682109,17131,2900,11157,7418,21604,11146,2190,11023,22169,11064,22221
�,MaJingZhen,510682110,19324,3275,12586,8785,24222,12521,2411,12324,24845,12424,25010
,YingHuaZhen,510682111,8398,1258,5352,3947,10520,5303,1373,5472,10775,5677,11029
Ȫ,NanQuanZhen,510682113,20673,3619,13430,9243,25461,13389,2611,13347,26736,13473,26903
ص,JianDiZhen,510682116,23526,3758,14881,10743,29520,14821,2931,15167,29988,15334,30215
,HongBaiZhen,510682118,4129,592,2644,1882,4976,2640,635,2646,5286,2712,5356
,BingChuanZhen,510682119,6490,1119,4180,2736,8116,4143,1009,4283,8426,4438,8618
ʦ,ShiGuZhen,510682120,31107,4949,20129,14088,38618,20082,4164,19964,40046,20091,40220
,JianNanZhen,510683100,55852,8076,36885,27339,46127,35411,8294,33579,68990,35337,72222
,DongBeiZhen,510683101,21513,3217,13904,10546,20655,13466,3096,13169,26635,13922,27826
,XiNanZhen,510683102,16367,2380,10683,8755,15899,10648,2423,10401,21049,10487,21170
¡,XingLongZhen,510683103,13333,2322,8745,6964,16470,8735,1893,8776,17511,8803,17548
,JiuLongZhen,510683104,7806,1383,5030,4343,9470,5020,990,5120,10140,5149,10179
,ZunDaoZhen,510683105,14607,2701,9506,8098,17920,9505,1923,9714,19219,9725,19231
,HanWangZhen,510683106,24562,4025,16103,12927,27882,16030,3786,16094,32124,16270,32373
,GongXingZhen,510683108,13448,2369,8947,7221,16683,8932,2181,8957,17889,9051,17998
,TuMenZhen,510683109,18707,3157,12128,10275,23329,12114,2411,12126,24240,12147,24275
,GuangJiZhen,510683110,15198,2872,10108,8730,19224,10088,2109,10002,20090,10071,20179
,JinHuaZhen,510683111,3545,646,2353,1889,4327,2346,470,2305,4651,2308,4661
Ȫ,YuQuanZhen,510683112,13622,2388,8981,7357,16943,8976,2085,9014,17990,9114,18095
,BanQiaoZhen,510683113,11993,1875,7783,6468,14304,7757,1739,7717,15474,7824,15607
,XinShiZhen,510683115,26887,4105,17470,12982,31174,16260,3611,16162,32422,17133,34603
Т,XiaoDeZhen,510683116,42571,7252,28084,23247,51947,27860,5958,27336,55196,27697,55781
,FuXinZhen,510683119,24487,4297,16322,13626,30363,16236,3716,15980,32216,16178,32500
,QiTianZhen,510683121,10424,1819,6919,5477,13002,6853,1546,6686,13539,6870,13789
ʲ,ShenDiZhen,510683122,16900,2943,11284,8806,21216,11267,2561,11011,22278,11120,22404
Զ,MianYuanZhen,510683123,9165,1661,6261,4938,11682,6258,1535,6099,12357,6100,12361
ƽ,QingPingXiang,510683200,3830,522,2450,1755,4857,2428,710,2565,4993,2612,5062
,TianChiXiang,510683201,1,0,1,4,3,1,3,3,4,3,4
ֵ,ChengXiangJieDao,510703001,56917,7936,37414,25832,47979,33799,8492,31139,64938,35931,73345
Ǳֵ,ChengBeiJieDao,510703002,55390,7148,36397,22517,39222,28246,6393,27013,55259,32534,68931
ֵ,GongQuJieDao,510703003,108437,10966,65754,52210,72367,62899,16189,64437,127336,69838,135592
ɽֵ,NanShanJieDao,510703004,57890,5136,36179,26487,38568,31769,8043,31279,63048,34890,71069
ֵ,ZhaoYangJieDao,510703005,67433,5940,40223,24023,44180,31168,8737,30725,61893,41887,82110
½ֵ,GaoXinJieDao,510703006,68351,4880,42682,32015,39448,40126,11353,39665,79791,41902,84584
Ͻֵ,ChengNanJieDao,510703007,29377,2215,17902,10468,21063,13230,3642,13542,26772,17332,35234
ҵ԰ֵ,ChuangYeYuanJieDao,510703009,22924,1457,13806,9888,16380,12224,3763,12889,25113,14338,28144
,FengGuZhen,510703100,9877,1447,6271,4987,9844,5698,1417,5810,11508,6470,12741
ص,GuanDiZhen,510703101,5656,1076,3763,2935,7286,3742,985,3917,7659,3954,7717
Ѵ,TangXunZhen,510703102,22102,2297,14270,10590,25996,14250,3761,13847,28097,13890,28160
,QingYiZhen,510703103,45598,1992,21915,8237,25193,11615,3303,11711,23326,28978,50893
,LongMenZhen,510703104,10280,1212,6301,3885,11351,6095,1642,6135,12230,6833,13134
ʯ,ShiTangZhen,510703105,17528,1274,9997,8001,12050,9502,2671,10425,19927,11476,21473
,WuJiaZhen,510703106,12528,1851,8161,7112,15671,8094,2333,8374,16468,8551,16712
,YangJiaZhen,510703107,8663,1598,5769,5026,11179,5730,1530,5914,11644,6022,11791
,JinFengZhen,510703108,6225,1174,4120,3293,7920,4098,1042,4290,8388,4321,8441
,YuHuangZhen,510703109,5923,1175,3973,3364,7962,3963,1121,4196,8159,4246,8219
,XinZaoZhen,510703110,13478,1603,7967,5382,13112,7000,1879,7369,14369,8993,16960
ӱ,HeBianZhen,510703111,7277,1274,4880,3937,9084,4856,1324,4922,9778,4995,9875
ĥ,MoJiaZhen,510703112,11686,990,7589,3803,8573,4735,1352,4834,9569,6439,14028
,YongXingZhen,510703113,27820,2576,16777,14470,22844,15873,4447,16273,32146,18066,34843
ǽ,ChengJiaoXiang,510703200,21473,1852,12627,10077,14874,12299,3333,13308,25607,14031,26658
ʯ,ShiDongXiang,510703201,4226,1052,2944,2622,5623,2938,795,3088,6026,3129,6073
ֵ,FuJiangJieDao,510704001,38092,3909,24098,17130,28533,21720,5795,21208,42928,23698,47796
ѧǴٽֵ´,KeXueChengChunLeiJieDaoBanShiChu,510704002,15396,3421,10619,8097,18750,10305,3118,10179,20484,11316,21935
ֵֽ´,FuLeJieDaoBanShiChu,510704003,30400,3637,19859,15424,23068,19522,5427,19186,38708,19605,39464
ѧǻֵ´,KeXueChengHuaFengJieDaoBanShiChu,510704004,5772,1504,4012,3095,7516,3838,963,3861,7699,4227,8239
ѧֵֽ´,KeXueChengSongLinJieDaoBanShiChu,510704005,9151,2860,6614,4529,9136,5535,1338,5495,11030,6735,13349
,YouXianZhen,510704100,63980,4715,37040,24161,36060,29730,7957,30963,60693,39612,76652
ʯ,ShiMaZhen,510704101,13363,1645,8727,6277,16395,8725,2375,8648,17373,8656,17383
,XinQiaoZhen,510704102,11202,1632,7136,5257,13565,7121,1745,7397,14518,7443,14579
СŹ,XiaoJianGouZhen,510704103,20027,1854,11563,8155,19868,10010,2863,10155,20165,13181,24744
κ,WeiChengZhen,510704104,23332,4159,15616,12374,30299,15556,4141,15817,31373,16016,31632
,ChenKangZhen,510704105,10865,2090,7376,6071,14286,7364,1879,7444,14808,7458,14834
,ZhongXingZhen,510704106,10148,2113,7002,5668,13492,6999,1807,7038,14037,7066,14068
,BoLinZhen,510704107,6700,1547,4661,3985,9118,4545,1202,4635,9180,4788,9449
,XuJiaZhen,510704108,8426,1684,5720,4522,11464,5686,1562,5861,11547,5952,11672
ʯ,ShiBanZhen,510704109,8858,1934,6180,5048,12187,6171,1656,6252,12423,6268,12448
,LiuJiaZhen,510704110,6890,1545,4917,3891,9600,4869,1508,4934,9803,5026,9943
,YuHeZhen,510704111,9374,1740,6498,5133,12874,6478,1975,6560,13038,6591,13089
,SongYaZhen,510704112,15486,1815,9832,6585,17023,9001,2364,8593,17594,9833,19665
ײ,BaiChanXiang,510704200,3772,981,2806,2470,5369,2797,839,2776,5573,2786,5592
̫,GuanTaiXiang,510704201,6822,1379,4583,3716,9271,4581,1229,4844,9425,4847,9430
,JianHuaXiang,510704202,5582,875,3509,2711,7135,3507,805,3745,7252,3753,7262
Ʒ,YunFengXiang,510704203,5806,1080,3906,3069,7669,3906,1001,3981,7887,3981,7887
,DongLinXiang,510704204,5139,933,3367,2657,6693,3366,854,3553,6919,3559,6926
̫ƽ,TaiPingXiang,510704205,7887,1684,5330,4347,10705,5330,1233,5474,10804,5474,10804
,ZiMianXiang,510704206,4923,1226,3501,2959,6952,3498,925,3572,7070,3573,7074
,ChaoZhenXiang,510704207,5566,1133,3632,2860,7252,3629,827,3889,7518,3894,7526
,DongXuanXiang,510704208,5052,1108,3523,2661,6921,3495,888,3477,6972,3525,7048
,JieZiXiang,510704209,6861,1227,4541,3470,9016,4538,1160,4671,9209,4707,9248
,FengHuangXiang,510704210,4615,1055,3163,2577,6240,3163,748,3244,6407,3255,6418
Ĵʡ,SiChuanShengXuNiDiQu,510704400,2445,2,2,2,4,0,1,3,3,2446,2448
,BeiBaZhen,510722100,41702,4878,27460,18957,28375,26572,7471,25481,52053,26591,54051
,TongChuanZhen,510722101,87633,11907,56563,39689,88755,51972,13663,51662,103634,56640,113203
,DongTaZhen,510722102,10332,1543,6356,4500,12747,6316,1562,6894,13210,7081,13437
,BaiQingZhen,510722103,6509,1451,4656,3759,8880,4619,1365,4505,9124,4669,9325
ɽ,TaShanZhen,510722104,14329,3101,10166,7867,18875,9391,3145,9646,19037,10409,20575
,LiuChiZhen,510722105,3601,935,2727,2240,5132,2692,862,2621,5313,2671,5398
,LongShuZhen,510722106,12506,1968,7973,5639,16302,7947,2317,8770,16717,8818,16791
ʯ,ShiAnZhen,510722107,12274,2191,8059,5622,16413,8049,2242,8571,16620,8648,16707
˳,FuShunZhen,510722108,9459,2178,6513,5407,13123,6491,1794,6836,13327,6918,13431
Ԫ,SanYuanZhen,510722109,8832,2273,6382,5175,12457,6377,1765,6485,12862,6488,12870
,QiuLinZhen,510722110,10645,2053,6692,4686,14001,6657,1595,7545,14202,7601,14293
,YongXinZhen,510722111,6001,1003,3875,2703,7835,3867,1078,4181,8048,4207,8082
µ,XinDeZhen,510722112,11208,1881,7300,5108,14744,7227,1834,7451,14678,7623,14923
,XinShengZhen,510722113,16219,3326,11370,8328,22080,11133,3620,11325,22458,11795,23165
³,LuBanZhen,510722114,16351,3399,11665,8447,22707,11558,3940,11758,23316,12025,23690
,JingFuZhen,510722115,21774,4096,14852,9890,30065,14841,4848,15840,30681,15866,30718
Ϻ,ZiHeZhen,510722116,9604,1638,6545,4174,13299,6545,2434,7131,13676,7131,13676
,AnJuZhen,510722117,5557,1070,3924,2897,7564,3864,1374,4001,7865,4077,8001
,GuanQiaoZhen,510722118,20050,4095,14749,11181,28512,14430,5216,14278,28708,14612,29361
V,QiJiangZhen,510722119,4227,1127,3301,2770,6258,3294,1156,3182,6476,3209,6510
,ZhongXinZhen,510722120,10878,1862,7329,5250,14825,7323,2305,7703,15026,7716,15045
ž,GuJingZhen,510722121,19583,3738,13260,10185,26838,13193,4056,13942,27135,14117,27377
,WanAnZhen,510722122,4217,926,3076,2381,5919,3074,1017,3083,6157,3084,6160
ƽ,XiPingZhen,510722123,28116,5272,19320,14248,37758,18654,6323,19580,38234,20391,39711
˶,BaDongZhen,510722124,11311,2371,8790,6462,16827,8709,3877,8638,17347,8769,17559
,KaiHeZhen,510722125,9753,2139,7228,5385,14164,7207,2659,7246,14453,7323,14551
ְ,LeAnZhen,510722126,18089,3780,12917,9520,25512,12723,4892,13257,25980,13844,26761
ƽ,JianPingZhen,510722127,14588,3138,10789,8373,21569,10779,4199,11110,21889,11136,21925
ǰ,QianFengZhen,510722128,5154,1203,3784,3020,7450,3779,1365,3930,7709,3938,7722
,JianSheZhen,510722129,6148,1187,4329,3236,8431,4321,1471,4442,8763,4477,8806
,GuangHuiZhen,510722130,7112,1461,5008,3426,10039,4932,1707,5132,10064,5272,10280
̫,ZhongTaiZhen,510722131,13480,2658,9545,7045,18729,9512,2993,9504,19016,9586,19131
ʯ,JinShiZhen,510722132,13018,3111,10145,8287,20297,9985,4637,10306,20291,10621,20766
³,XinLuZhen,510722133,14502,2867,10415,8660,21195,10415,4131,11084,21499,11085,21500
,LiShuZhen,510722134,4619,1067,3443,3195,6882,3443,1372,3615,7058,3615,7058
Ӫ,LiuYingZhen,510722135,21402,3963,14795,10469,28173,14214,5055,14729,28943,15625,30420
,LingXingZhen,510722136,8951,1593,6170,4724,12098,6156,1883,6241,12397,6257,12427
«Ϫ,LuXiZhen,510722137,32512,4990,22314,14566,39093,20255,7308,20165,40420,22496,44810
,LiXinZhen,510722138,15175,2978,10616,8321,21034,10590,3631,11076,21666,11168,21784
԰,HuaYuanZhen,510722139,17717,2691,12191,9158,23415,12190,3828,12043,24233,12045,24236
,YongMingZhen,510722140,13791,2707,9633,7230,18259,9587,2854,9536,19123,9719,19352
,GaoYanXiang,510722200,4635,1004,3231,2492,6436,3221,1053,3436,6657,3461,6692
Т,ZhongXiaoXiang,510722201,3825,1017,2888,2411,5656,2868,987,2889,5757,2941,5829
˫ʤ,ShuangShengXiang,510722202,4274,950,2998,2659,6007,2996,992,3193,6189,3218,6216
,JinGuXiang,510722203,4599,1104,3336,2829,6782,3336,1149,3515,6851,3516,6852
ʯ,DuanShiXiang,510722204,5290,1222,3866,3091,7469,3865,1219,3863,7728,3865,7731
,YuLinXiang,510722205,6133,1202,4260,2877,8454,4254,1332,4396,8650,4407,8667
ּ,LeJiaXiang,510722206,6755,1520,4871,3388,9414,4846,1724,5064,9910,5128,9999
,ShuGuangXiang,510722207,5396,1180,3870,2996,7503,3870,1167,3868,7738,3873,7743
,JianZhongXiang,510722208,10142,2359,7640,5586,15153,7602,2992,7784,15386,7853,15493
Ȫ,BaoQuanXiang,510722209,4808,998,3237,2379,6765,3237,1020,3589,6826,3589,6826
,GuangLiXiang,510722210,4232,1078,3194,2461,6230,3194,1123,3239,6433,3239,6433
Э,XieHeXiang,510722211,4900,1116,3731,2629,7265,3727,1511,3791,7518,3796,7527
˫,ShuangLeXiang,510722212,5773,1213,4273,3283,8481,4263,1742,4421,8684,4455,8728
պ,JuHeXiang,510722213,4815,1152,3573,3031,7150,3570,1388,3778,7348,3782,7355
Ҹ,XingFuXiang,510722214,6484,1637,5022,3859,9408,5022,1718,4810,9832,4817,9839
,XiaXinXiang,510722215,4824,1023,3429,2876,6830,3429,1164,3582,7011,3582,7011
,JinDouXiang,510722216,3356,685,2263,1749,4526,2261,624,2390,4651,2402,4665
,ShangXinXiang,510722217,6635,1436,4921,3679,9762,4916,1996,5141,10057,5146,10067
,LaoMaXiang,510722218,7793,1321,5484,3769,10465,5421,1835,5297,10718,5465,10949
,LiChengXiang,510722219,5075,1009,3587,2653,6963,3571,1136,3592,7163,3633,7220
ʤ,ZhengShengXiang,510722220,4293,967,3062,2474,5800,3030,937,3032,6062,3135,6197
ͬ,YunTongXiang,510722221,5913,1098,4005,2795,8368,4005,1426,4432,8437,4432,8437
Ϫ,YunXiZhen,510723100,56351,6996,35847,26199,62170,33444,9575,34500,67944,37075,72922
,YuLongZhen,510723101,13764,3229,10010,7479,19345,9379,2856,9222,18601,9839,19849
,FuYiZhen,510723102,28874,4633,19317,12084,37036,18635,5508,19016,37651,19698,39015
,JinKongZhen,510723103,16763,3448,11358,9276,22007,10848,2966,11325,22173,11819,23177
,LiangHeZhen,510723104,10752,2405,7874,6427,15341,7863,2611,7809,15672,7894,15768
Ƶ,HuangDianZhen,510723105,13042,3667,9814,8562,19283,9583,3135,9567,19150,10030,19844
,BaiZiZhen,510723106,11494,2122,7850,5719,15575,7619,2328,7706,15325,8094,15944
˽,BaJiaoZhen,510723107,11065,2798,8009,6729,15831,7987,2379,8160,16147,8233,16242
ƺ,HeiPingZhen,510723108,5423,1063,3752,2972,7429,3712,1166,3822,7534,3900,7652
ߵ,GaoDengZhen,510723109,7180,2527,5704,5071,10816,5703,1620,5593,11296,5623,11327
,JinJiZhen,510723110,7635,2050,5933,4649,11778,5919,2224,5963,11882,5976,11909
,AnJiaZhen,510723111,6285,1164,4391,3478,8739,4383,1525,4558,8941,4583,8974
ũ,LinNongZhen,510723112,8619,2118,6577,4939,12655,6568,2041,6137,12705,6201,12778
,JuLongZhen,510723113,6946,1190,4561,3395,9276,4561,1247,4822,9383,4822,9383
Ȫ,LongQuanXiang,510723200,3268,1115,2509,2210,4976,2489,708,2482,4971,2582,5091
۹,ZheGongXiang,510723201,4768,1175,3729,3040,7036,3729,1379,3592,7321,3593,7322
,MaYangXiang,510723202,4424,1040,3218,2826,6166,3200,1017,3195,6395,3263,6481
Ԫ,SanYuanXiang,510723203,4989,1254,3634,2948,7168,3634,1028,3620,7254,3637,7271
,WuLongXiang,510723204,3393,1187,2724,2406,5309,2718,802,2625,5343,2658,5382
ͤ,ChaTingXiang,510723205,3334,870,2456,1995,4781,2417,707,2388,4805,2455,4911
,JinAnXiang,510723206,7266,1234,5083,3166,9885,5068,1522,4895,9963,4939,10022
ϴ,XiZeXiang,510723207,10230,2439,7160,5341,14392,7157,1856,7328,14485,7365,14525
ë,MaoGongXiang,510723208,5814,1322,4140,3092,8367,4098,1393,4247,8345,4389,8529
,PingHeXiang,510723209,5392,1292,3944,3190,7803,3944,1190,3930,7874,3930,7874
ʯţ,ShiNiuMiaoXiang,510723210,6277,1532,4574,3730,8878,4574,1337,4571,9145,4572,9146
˻,DaXingHuiZuXiang,510723211,3609,652,2407,1507,4867,2404,693,2537,4941,2547,4954
ں,ZongHaiXiang,510723212,2816,871,2268,1981,4314,2268,717,2130,4398,2136,4404
,LiangChaHeXiang,510723213,2938,663,2207,1764,4126,2204,742,2111,4315,2136,4343
,JianHeXiang,510723214,2269,530,1612,1271,3264,1605,518,1681,3286,1705,3317
,LaiLongXiang,510723215,2537,543,1774,1432,3544,1772,530,1818,3590,1836,3610
̩,YongTaiXiang,510723216,2525,861,2128,1705,3994,2112,772,1968,4080,2030,4158
Ϫ,HuangXiXiang,510723217,2538,949,2107,1878,4091,2092,727,2050,4142,2107,4214
Ϫ,JuXiXiang,510723218,5179,1054,3495,2434,7031,3483,897,3607,7090,3635,7130
˫,ShuangBeiXiang,510723219,2037,510,1470,1293,2899,1464,470,1527,2991,1547,3017
ɽ,LinShanXiang,510723220,2261,444,1538,1046,3093,1536,425,1584,3120,1592,3130
ũ,XinNongXiang,510723221,2557,597,1788,1453,3481,1788,452,1818,3606,1818,3606
ɣ,SangZaoZhen,510724101,21211,3599,14910,11916,26302,14521,5206,14588,29109,15106,30016
D,HuaGaiZhen,510724102,47562,5383,30675,22668,44575,28490,8862,28744,57234,31132,61807
,HuangTuZhen,510724103,27659,4281,18253,13483,27969,18123,5466,18842,36965,19153,37406
ˮ,TaShuiZhen,510724104,25425,4861,18411,15507,33874,18385,6332,18133,36518,18207,36618
ˮ,XiuShuiZhen,510724105,36931,6237,26717,19976,46954,25831,9615,25242,51073,26066,52783
,HeQingZhen,510724106,11316,2112,7860,6132,14064,7776,2356,7697,15473,7924,15784
,JiePaiZhen,510724108,15402,2028,9915,7928,17755,9790,2726,9930,19720,10241,20156
,YongHeZhen,510724109,9199,1938,6711,5329,12701,6686,2198,6533,13219,6624,13335
ˮ,JuShuiZhen,510724110,12833,1978,8391,7058,14909,8292,2443,8681,16973,8863,17254
Ȫ,QingQuanZhen,510724111,7492,1572,5451,4641,10279,5437,1990,5567,11004,5603,11054
,BaoLinZhen,510724112,7156,1395,4956,4106,9450,4873,1498,4949,9822,5093,10049
ˮ,FeiShuiZhen,510724113,6753,1527,5150,4287,9480,5131,1914,5011,10142,5044,10194
,XiaoBaZhen,510724114,5079,985,3600,2652,6696,3581,1228,3648,7229,3692,7292
,LeXingZhen,510724115,9275,1841,7196,6418,13941,7196,3520,7440,14636,7440,14636
ƺ,ChaPingXiang,510724200,3740,710,2752,2388,5740,2750,1423,3111,5861,3121,5873
,XingRenXiang,510724201,5544,1047,3901,3356,7421,3886,1408,4068,7954,4098,7999
ߴ,GaoChuanXiang,510724202,3065,571,2036,1572,4019,2033,591,2172,4205,2191,4227
ӭ,YingXinXiang,510724203,7292,1551,5163,4409,9681,5143,1476,5093,10236,5156,10319
Ĳ,WenChangZhen,510725100,46522,5815,30737,22085,48533,28547,8484,28108,56655,30084,60821
,ZhangQingZhen,510725101,9302,1322,6237,4468,11936,6225,1718,6081,12306,6105,12342
,XuZhouZhen,510725102,16194,2332,10605,7656,20942,10576,2810,10641,21217,10731,21336
,LiYaZhen,510725103,9706,1615,6276,4236,12392,6259,1539,6461,12720,6584,12860
,BaiYunZhen,510725104,6029,960,3822,2546,7718,3802,933,4073,7875,4100,7922
,WoLongZhen,510725105,8116,1223,5233,3500,10304,5233,1347,5453,10686,5453,10686
,GuanYiZhen,510725106,7257,1070,4530,3463,9370,4525,1165,4952,9477,4962,9492
,MaNaoZhen,510725107,5232,950,3514,2771,7048,3514,995,3663,7177,3663,7177
ʯţ,ShiNiuZhen,510725108,11236,1909,7389,5300,14697,7383,2036,7763,15146,7792,15181
ǿ,ZiQiangZhen,510725109,3253,554,2176,1808,4386,2176,646,2277,4453,2277,4453
ʺ,RenHeZhen,510725110,6388,1145,4148,2971,8288,4148,995,4380,8528,4380,8528
ʯ,DongShiXiang,510725200,4433,828,3019,2191,5739,2995,844,3035,6030,3086,6105
Ȫ,SanQuanXiang,510725201,3339,609,2217,1663,4399,2208,626,2347,4555,2357,4574
,HongRenXiang,510725202,4884,795,3181,2225,6332,3173,831,3319,6492,3329,6510
С,XiaoYaXiang,510725203,3255,589,2173,1742,4291,2165,502,2159,4324,2173,4346
,YanWuXiang,510725204,2971,576,2006,1688,3988,1968,544,2022,3990,2085,4091
ɷ,XianFengXiang,510725205,4209,856,2863,2371,5499,2858,706,2893,5751,2908,5771
˫,ShuangBanXiang,510725206,7506,1244,4797,3243,9682,4795,1046,4995,9790,4999,9796
,HuanLongXiang,510725207,3293,610,2253,1792,4479,2253,694,2344,4597,2344,4597
˫,ShuangFengXiang,510725208,4031,796,2665,1926,5302,2651,646,2782,5433,2808,5473
̩,JiaoTaiXiang,510725209,3124,627,2076,1695,4217,2076,537,2212,4288,2212,4288
,JinLongChangXiang,510725210,6950,1241,4494,3275,9194,4458,1130,4739,9197,4827,9321
ʯ̨,ShiTaiXiang,510725211,6116,890,3857,2496,7786,3850,929,4073,7923,4078,7935
ɶ,XianEXiang,510725212,5510,902,3590,2442,7183,3590,954,3776,7366,3776,7366
,MaMingXiang,510725213,6304,1054,4135,2907,8389,4123,1251,4446,8569,4474,8609
ӭ,MaYingXiang,510725214,3761,614,2451,1869,5023,2446,699,2619,5065,2623,5074
,ErDongXiang,510725215,2750,394,1766,1154,3473,1762,455,1822,3584,1833,3599
,JianXingXiang,510725216,2924,525,2019,1550,3953,2015,635,2055,4070,2065,4084
ʯ,BaoShiXiang,510725217,4925,994,3342,2773,6756,3342,943,3520,6862,3520,6862
Զ,DingYuanXiang,510725218,4188,898,2868,2542,5755,2857,800,3009,5866,3018,5886
,DaXinXiang,510725219,6335,1129,4203,3002,8428,4184,1135,4376,8560,4396,8599
,WenXingXiang,510725220,6532,1009,4200,3292,8486,4199,1021,4362,8561,4362,8562
ɽ,QuShanZhen,510726100,6438,912,4214,2953,8544,4213,1395,4527,8740,4531,8745
޹,LeiGuZhen,510726101,11867,1501,7726,5300,14685,7652,2431,7973,15625,8073,15799
ͨ,TongKouZhen,510726102,3522,743,2400,1763,4635,2385,617,2452,4837,2482,4882
,YongChangZhen,510726103,13708,1185,8391,4827,11964,6134,1992,6117,12251,8494,16885
,AnChangZhen,510726104,35585,6212,23514,19291,41687,23214,6067,23945,47159,24350,47864
,YongAnZhen,510726105,14110,2311,9406,6641,18253,9322,2855,9726,19048,9870,19276
Ȫ,XiangQuanXiang,510726200,3937,776,2729,1955,5374,2729,906,2890,5619,2890,5619
¼Ұ,ChenJiaBaXiang,510726201,7228,1208,4792,3326,9910,4791,1631,5262,10053,5275,10067
Ϫ,GuiXiXiang,510726202,6855,1102,4471,2875,8500,4272,1358,4584,8856,4844,9315
,GuanLingXiang,510726203,2237,326,1433,913,2886,1429,433,1549,2978,1563,2996
,YuLiXiang,510726204,6935,1180,4581,3519,9406,4579,1518,5050,9629,5052,9633
ƺ,XuanPingXiang,510726205,3656,744,2476,1766,4955,2450,773,2571,5021,2697,5173
,BaiNiXiang,510726206,2507,460,1701,1203,3366,1689,557,1775,3464,1823,3524
С,XiaoBaXiang,510726207,6663,1008,4347,2808,8871,4313,1555,4733,9046,4879,9226
Ƭ,PianKouXiang,510726208,3929,644,2723,1698,5487,2700,1113,2935,5635,2963,5686
ƺ,KaiPingXiang,510726209,1795,368,1188,898,2489,1188,389,1361,2549,1364,2552
ӵ,BaDiXiang,510726210,4003,600,2752,1754,5405,2718,1026,2831,5549,2877,5629
ʲ,BaiShenXiang,510726211,1909,337,1299,821,2585,1279,448,1361,2640,1395,2694
Ƭ,QingPianXiang,510726212,2479,305,1382,682,3119,1056,450,1121,2177,1852,3234
,DouBaXiang,510726213,1592,270,1082,698,2126,1082,362,1142,2224,1142,2224
,TaoLongZangZuXiang,510726214,1797,299,1265,800,2492,1258,479,1298,2556,1310,2575
,DunShangXiang,510726215,1215,157,812,450,1616,811,272,832,1643,832,1644
,MaCaoXiang,510726216,1341,199,934,573,1795,933,326,931,1864,932,1866
,LongAnZhen,510727100,29174,3471,18547,12453,33225,17756,5077,18302,36058,19175,37722
ų,GuChengZhen,510727101,8991,1275,5821,4031,11310,5816,1628,5992,11808,6073,11894
ϰ,NanBaZhen,510727102,14684,1976,9199,6423,18478,9068,2582,9771,18839,10043,19242
,XiangYanZhen,510727103,7630,965,4733,3160,9586,4694,1222,4964,9658,5084,9817
ƽͨ,PingTongZhen,510727104,7372,964,4694,3367,9611,4665,1484,5079,9744,5126,9820
ߵ,DouKouZhen,510727105,5591,839,3590,2390,7329,3584,1120,3943,7527,3960,7550
ӡ,DaYinZhen,510727106,5106,715,3131,2020,6683,3128,885,3574,6702,3575,6706
,DaQiaoZhen,510727107,4858,877,3197,2211,6558,3181,1081,3565,6746,3619,6816
ˮ,ShuiJingZhen,510727108,8211,1099,5300,3281,10803,5249,1856,5778,11027,5866,11166
ߴ,GaoCunXiang,510727200,4006,565,2519,1717,5132,2519,763,2815,5334,2815,5334
ˮǼ,ShuiTianQiangZuXiang,510727201,2149,446,1438,1082,2992,1426,450,1554,2980,1607,3045
,BaZiXiang,510727202,5181,829,3346,2272,6745,3339,1030,3595,6934,3694,7040
ˮ,ShuiGuanXiang,510727203,2716,412,1793,1270,3674,1791,585,1919,3710,1920,3713
ƽǼ,PingNanQiangZuXiang,510727204,1443,244,989,623,1926,985,312,996,1981,1010,1999
Ǽ,XuTangQiangZuXiang,510727205,1612,302,1073,672,2206,1062,343,1168,2230,1184,2257
Ǽ,SuoJiangQiangZuXiang,510727206,3864,701,2544,1803,5264,2543,783,2804,5347,2804,5348
ǲ,TuChengZangZuXiang,510727207,4099,663,2629,1659,5568,2616,888,2971,5587,3021,5650
ɱǼ,JiuBaoQiangZuXiang,510727208,2474,419,1602,1112,3326,1601,511,1798,3399,1802,3404
,KuoDaZangZuXiang,510727209,3059,489,2078,1333,4068,2065,694,2144,4209,2164,4242
ز,HuangYangGuanZangZuXiang,510727210,1171,165,710,406,1482,700,217,803,1503,843,1553
,HuYaZangZuXiang,510727211,1496,239,950,561,1931,941,269,1028,1969,1054,2004
,SiErZangZuXiang,510727212,624,74,319,210,627,301,118,347,648,497,816
,BaiMaZangZuXiang,510727213,1076,92,610,347,1250,582,201,652,1234,759,1369
ľ,MuZuoZangZuXiang,510727214,1051,165,738,453,1475,731,305,751,1482,783,1521
ľƤ,MuPiZangZuXiang,510727215,671,103,438,292,858,428,157,465,893,493,931
ֵֽ,ChangGangJieDao,510781001,13989,2818,9149,7038,17284,9107,1898,9418,18525,9556,18705
䶼ֵֽ,WuDouChangGangJieDao,510781002,15282,1810,8898,6327,16082,7806,1617,8268,16074,9811,18709
�ֵֽ´,HanZengZhangGangJieDaoBanShiChu,510781003,4168,1093,2683,2456,5290,2589,491,2802,5391,3069,5752
ƺ´,HuaPingBanShiChu,510781004,587,415,528,571,924,528,11,485,1013,485,1013
а,ZhongBaZhen,510781100,85838,10759,57176,40363,85597,55700,15114,52970,108670,54535,111711
̫ƽ,TaiPingZhen,510781101,61527,7593,39542,27212,63649,37904,9764,37263,75167,39342,78884
,SanHeZhen,510781102,74765,9810,49178,33885,74598,44303,11337,44008,88311,46734,95912
,HanZengZhen,510781103,6141,1015,3900,2781,7658,3899,965,4211,8110,4221,8121
,QingLianZhen,510781104,11044,1807,7331,5386,13379,7280,1825,7162,14442,7345,14676
,ZhangMingZhen,510781105,11074,1804,7207,4991,13501,7109,1762,7138,14247,7433,14640
,LongFengZhen,510781106,10001,1492,6377,4757,12617,6368,1420,6519,12887,6536,12913
䶼,WuDouZhen,510781107,28272,3948,17851,12446,34220,17728,4130,17973,35701,18499,36350
,DaKangZhen,510781108,13842,2105,8955,6159,17087,8939,2303,9272,18211,9295,18250
°,XinAnZhen,510781109,9913,2005,6781,5263,13435,6771,1651,6756,13527,6788,13569
ս,ZhanQiZhen,510781110,7485,1758,5230,4436,10294,5224,1311,5299,10523,5324,10554
˫,ShuangHeZhen,510781111,8241,1650,5839,4547,10993,5835,1741,5792,11627,5793,11632
ʤ,YongShengZhen,510781112,18343,2937,12192,8494,24106,12188,3150,12198,24386,12238,24430
СϪ,XiaoXiBaZhen,510781113,9913,1683,6903,5519,12648,6903,1893,6586,13489,6586,13489
ӿ,HeKouZhen,510781114,6127,1295,4250,3353,8337,4240,1127,4291,8531,4299,8549
ػ,ZhongHuaZhen,510781115,8093,1720,5958,4791,10842,5958,1875,5730,11688,5730,11688
,HouBaZhen,510781116,14534,2572,10400,8289,17508,10370,3029,9651,20021,9735,20135
,ErLangMiaoZhen,510781117,17699,2686,11823,8791,21776,11650,3468,11751,23401,12030,23853
,MaJiaoZhen,510781118,8796,1452,5869,4666,10907,5792,1570,5755,11547,5949,11818
,YanMenZhen,510781119,6110,885,4079,3031,8008,4077,1274,4185,8262,4190,8269
,JiuLingZhen,510781120,11936,1765,7778,5364,15046,7759,1954,7863,15622,7877,15655
һ,BaYiXiang,510781200,8407,1730,5739,4428,11349,5723,1535,5896,11619,5933,11672
ˮ,FangShuiXiang,510781201,7926,1432,5390,4121,10394,5390,1470,5438,10828,5438,10828
,XiPingXiang,510781202,10775,1809,7273,5191,13619,7206,1893,7154,14360,7204,14477
ˮ,XiangShuiXiang,510781203,5282,932,3518,2545,6986,3517,940,3626,7143,3636,7154
,DaYanXiang,510781204,9415,1785,6226,4692,12150,6217,1478,6395,12612,6452,12678
,DongXingXiang,510781205,5376,1087,3676,3088,6839,3676,966,3753,7429,3753,7429
,YiXinXiang,510781207,7685,1654,5151,3869,10355,5150,1067,5254,10404,5255,10406
ɽ,GuanShanXiang,510781208,8314,1541,5462,4179,10902,5462,1322,5715,11177,5715,11177
,XinXingXiang,510781209,5762,1395,4271,3585,8131,4271,1190,4076,8347,4076,8347
´,XinChunXiang,510781210,6743,1449,4977,3966,9477,4977,1542,4757,9734,4757,9734
,DongAnXiang,510781211,6943,1271,4669,3635,9087,4658,1278,4804,9462,4823,9492
ͭ,TongXingXiang,510781212,4806,1190,3660,2974,6950,3658,1208,3516,7174,3544,7204
ʤ,WenShengXiang,510781213,3905,941,2935,2510,5440,2935,810,2721,5656,2721,5656
,ZhongXingXiang,510781214,4834,980,3307,2654,6493,3307,978,3480,6787,3485,6792
Ƽ,YunJiXiang,510781215,4410,962,3131,2371,6238,3121,1051,3269,6390,3292,6423
ʯԪ,ShiYuanXiang,510781216,2045,402,1378,1188,2657,1363,399,1409,2772,1468,2846
Ԫ,JingYuanXiang,510781217,3380,683,2476,1965,4765,2470,924,2497,4967,2511,4987
,LiuHeXiang,510781218,2493,422,1616,1459,3263,1598,473,1737,3335,1772,3388
˳,FengShunXiang,510781219,1623,259,990,842,2097,990,291,1183,2173,1183,2173
ӽֵ´,DongBaJieDaoBanShiChu,510802001,87812,7833,54820,38251,74345,49768,15807,48716,98484,56632,111452
ֵ´,JiaLingJieDaoBanShiChu,510802002,47474,6067,31068,20939,45900,28894,7433,27699,56593,29906,60974
ֵ´,HeXiJieDaoBanShiChu,510802003,8765,836,5368,3321,9236,5319,1611,5514,10833,5844,11212
ɽ,RongShanZhen,510802100,20366,2928,11921,8037,26317,11921,3878,12414,24335,15251,27172
ʯ,DaShiZhen,510802101,15697,1753,10095,6332,19745,10084,2990,10305,20389,10345,20440
,PanLongZhen,510802102,14056,1525,9015,5464,16590,9006,2612,9165,18171,9178,18193
,BaoLunZhen,510802103,44827,6037,28559,18752,47214,26543,8215,25659,52202,30520,59079
໯,ChiHuaZhen,510802104,6730,853,4554,3007,8752,4485,1585,4486,8971,4614,9168
,SanDuiZhen,510802105,16350,1873,10835,7038,20097,10792,3417,10638,21430,10805,21640
ũ,GongNongZhen,510802106,6814,772,4463,2619,8564,4431,1656,4618,9049,4779,9242
׳,BaiChaoXiang,510802200,3738,518,2447,1482,4919,2414,837,2562,4976,2646,5093
,JinDongXiang,510802201,4593,753,3170,2006,6203,3130,1057,3151,6281,3233,6403
̶,LongTanXiang,510802202,11199,1432,6858,4072,13673,6761,1926,7057,13818,7699,14557
ѩ´,XueFengBanShiChu,510802400,14791,1094,8649,4257,9702,6093,1964,6232,12325,9200,17849
ϺӰ´,NanHeBanShiChu,510802401,43031,2918,26941,19453,22495,26074,8240,26077,52151,27248,54189
Ӱ´,HuiLongHeBanShiChu,510802402,6176,555,3858,2154,6695,3832,1077,3837,7669,3950,7808
´,ShangXiBanShiChu,510802404,19060,1527,12389,7908,12997,11004,3466,10729,21733,11664,24053
ԬҰӰ´,YuanJiaBaBanShiChu,510802405,6520,523,4083,2015,7554,3983,1292,3964,7947,4252,8335
Ұ´,YangJiaYanBanShiChu,510802406,3621,875,2525,2041,4491,2519,574,2495,5014,2545,5070
ֵ´,XiaXiJieDaoBanShiChu,510802407,18778,2549,12267,8908,16877,11524,3168,11406,22930,12228,24495
Ԫ,YuanBaZhen,510811100,20721,1633,12779,6410,19870,9661,3886,9784,19445,13461,26240
,WeiZiZhen,510811101,5602,882,3550,2472,6179,3163,1157,3171,6334,4091,7641
,WangJiaZhen,510811102,4970,1064,3592,2650,6886,3495,1130,3346,6841,3572,7164
ĥ̲,MoTanZhen,510811103,4449,987,3255,2350,6210,3160,1182,3038,6198,3363,6618
ֹ,BoLinGouZhen,510811104,3445,731,2298,1706,4415,2222,618,2220,4442,2496,4794
̫,TaiGongZhen,510811105,5070,844,3335,2154,6135,3026,1150,3067,6093,3729,7064
,HuTiaoZhen,510811106,4369,656,2983,2195,5796,2977,999,2972,5949,3041,6024
,HongYanZhen,510811107,2238,468,1556,1147,2961,1539,447,1530,3069,1597,3153
ѻ,ZhaoHuaZhen,510811108,11146,1345,7105,4562,13287,6941,2283,6956,13897,7669,14774
,JinXianXiang,510811200,3189,670,2364,1600,4537,2333,827,2228,4561,2322,4686
Ĵ,WenCunXiang,510811201,2474,592,1833,1369,3478,1806,574,1715,3521,1807,3640
ˮ,QingShuiXiang,510811202,4843,920,3342,2176,6606,3276,1128,3339,6615,3549,6891
ż,ZhangJiaXiang,510811203,4083,867,2819,1907,5481,2753,978,2761,5514,3109,5928
Ϫ,XiangXiXiang,510811204,1539,407,1147,873,2185,1136,408,1150,2286,1207,2354
ţ,QingNiuXiang,510811205,3127,538,2257,1538,4443,2172,839,2096,4268,2247,4504
½,ChenJiangXiang,510811206,2497,437,1687,1079,3337,1643,593,1676,3319,1840,3527
,DingJiaXiang,510811207,2144,388,1495,1052,3007,1467,571,1526,2993,1608,3103
,HuangLongXiang,510811208,3059,512,2035,1451,3994,1995,621,2022,4017,2157,4192
ʯ,ShiJingPuXiang,510811209,6384,1048,4105,2821,7872,4013,1154,4124,8137,4481,8586
׹,BaiGuoXiang,510811210,3254,594,2174,1554,4133,2096,683,2049,4145,2357,4531
÷,MeiShuXiang,510811211,3116,602,2158,1521,4175,2092,621,2011,4103,2181,4339
,MingJiaoXiang,510811212,3951,681,2654,1874,4817,2634,783,2469,5103,2761,5415
,SheJianXiang,510811213,3347,579,2225,1537,4336,2190,627,2218,4408,2328,4553
,ZhaoYangXiang,510811214,2806,504,1834,1316,3457,1790,574,1776,3566,2050,3884
,DaChaoXiang,510811215,1629,270,1116,799,2132,1103,384,1134,2237,1167,2283
ɳ,ShaBaXiang,510811216,2015,374,1410,1019,2589,1389,457,1399,2788,1436,2846
,LiuQiaoXiang,510811217,2988,515,2033,1336,3769,2018,584,2005,4023,2054,4087
,ZiYunXiang,510811218,2800,477,1796,1124,3383,1739,495,1765,3504,1976,3772
ֵ´,JianYinYanSheQuJieDaoBanShiChu,510811400,1203,460,962,813,1848,962,233,931,1893,934,1896
,ChaoTianZhen,510812100,21988,2232,14322,7882,24319,12427,5204,12218,24645,15102,29424
̲,DaTanZhen,510812101,7264,1134,5107,3356,9963,5107,1808,5098,10205,5099,10206
ľ,YangMuZhen,510812102,9479,1389,6738,4621,12707,6706,2480,6379,13085,6610,13348
,CengJiaZhen,510812103,6410,790,4369,2757,8408,4350,1796,4579,8929,4627,8996
,ZhongZiZhen,510812104,6469,959,4604,2835,9037,4573,1724,4535,9108,4548,9152
ɳ,ShaHeZhen,510812105,4874,723,3340,1828,6490,3217,1320,3205,6422,3577,6917
¼,ChenJiaXiang,510812200,3552,563,2623,1562,4943,2585,994,2418,5003,2486,5109
С,XiaoAnXiang,510812201,2291,418,1682,990,3329,1682,646,1673,3355,1673,3355
㶴,YuDongXiang,510812202,2977,527,2126,1299,4242,2112,800,2136,4248,2178,4304
Ϫ,DongXiHeXiang,510812203,5345,953,3662,2281,7240,3629,1245,3686,7315,3881,7543
ʯ,HuaShiXiang,510812204,2347,470,1629,1056,3310,1628,571,1756,3384,1759,3388
Ѽ,PuJiaXiang,510812205,2610,469,1775,1089,3498,1761,666,1784,3545,1970,3745
,XiBeiXiang,510812206,2913,383,1982,1178,3881,1959,791,2026,3985,2105,4087
,XuanHeXiang,510812207,5290,911,3945,2406,7565,3914,1657,3794,7708,3913,7858
ת,ZhuanDouXiang,510812208,3401,519,2465,1616,4616,2417,1004,2320,4737,2459,4924
,QingLinXiang,510812209,1939,383,1346,897,2671,1333,439,1374,2707,1415,2761
ƽϪ,PingXiXiang,510812210,3112,486,2285,1351,4416,2276,986,2282,4558,2299,4584
ӿ,LiangHeKouXiang,510812211,5114,1043,3870,2536,7540,3870,1622,3885,7755,3909,7779
,LiJiaXiang,510812212,5591,850,3907,2227,7850,3887,1519,4004,7891,4053,7960
,WangJiaXiang,510812213,4018,670,2937,1696,5790,2908,1210,2917,5825,2961,5898
,MaLiuXiang,510812214,4204,688,3149,2103,6108,3149,1386,3120,6269,3129,6278
Ϫ,LinXiXiang,510812215,3862,555,2831,1639,5549,2825,1192,2761,5586,2778,5609
İ,WenAnXiang,510812216,2950,523,2062,1341,4088,2062,658,2068,4130,2069,4131
Ұ,MaJiaBaXiang,510812217,2334,493,1654,1125,3301,1644,515,1664,3308,1688,3342
,BaiYangXiang,510812218,2568,445,1761,1033,3535,1749,622,1835,3584,1874,3635
,DongHeZhen,510821100,63518,6181,41056,24393,66356,33384,12254,32939,66323,40897,81953
δ,JiaChuanZhen,510821101,29072,3696,17536,12057,31215,17413,5653,17356,34769,20885,38421
ľ,MuMenZhen,510821102,11197,1834,8383,5662,16316,8361,3916,8497,16858,8564,16947
ˮ,BaiShuiZhen,510821103,8033,1198,5535,3635,9964,5422,1813,5228,10650,5509,11044
,ShangWuZhen,510821104,7115,979,4867,2985,8475,4737,1748,4480,9217,4975,9842
Ż,ZhangHuaZhen,510821105,6657,1376,5085,3470,9738,5085,1987,4924,10009,4935,10020
,HuangYangZhen,510821106,12708,1953,8803,6149,16707,8688,2897,8486,17174,8755,17558
ռ,PuJiZhen,510821107,15322,2650,11042,7945,20843,10428,4060,10258,20686,10990,22032
,SanJiangZhen,510821108,12103,1710,8866,5884,16620,8857,3994,8805,17662,8941,17807
Ϫ,JinXiZhen,510821109,3787,672,3000,2252,5557,2989,1437,2851,5840,2896,5896
Ȩ,WuQuanZhen,510821110,9097,1408,6799,4029,13651,6765,3362,6993,13758,7068,13867
,GaoYangZhen,510821111,5065,857,3525,2055,6962,3513,1215,3581,7094,3612,7137
˫,ShuangHuiZhen,510821112,5657,921,3937,2351,7797,3905,1379,3924,7829,4020,7957
Ӣ,YingCuiZhen,510821113,5567,819,4027,2698,7882,3991,1806,4115,8106,4165,8192
,GuoHuaZhen,510821114,4395,769,3571,2623,6319,3553,1783,3362,6915,3376,6947
,LongFengXiang,510821200,6041,1355,4624,3066,9195,4624,1899,4648,9272,4671,9295
,DaHeXiang,510821201,2641,441,2006,1452,3825,2004,967,2038,4042,2043,4049
,JiuLongXiang,510821202,7201,1359,5594,3913,11124,5577,2664,5579,11156,5630,11224
,WanJiaXiang,510821203,2672,510,2035,1256,4077,1998,961,2030,4028,2108,4143
,YanZiXiang,510821204,3877,652,2773,1632,5528,2771,1149,2866,5637,2905,5678
ˮĥ,ShuiMoXiang,510821205,3083,641,2720,1595,5121,2697,1636,2583,5280,2640,5360
ĳ,GuChengXiang,510821206,2884,435,2025,1183,4099,2017,861,2150,4167,2155,4180
,MengZiXiang,510821207,2131,344,1494,889,3062,1489,642,1609,3098,1623,3117
,FuQingXiang,510821208,5152,880,3778,2449,7548,3776,1596,3834,7610,3850,7628
,ZaoLinXiang,510821209,2436,569,1842,1307,3547,1834,709,1828,3662,1872,3714
Ӣ,MaYingXiang,510821210,2676,501,1974,1183,3904,1974,771,1974,3948,1974,3948
Ϫ,LiuXiXiang,510821211,2754,580,2011,1227,3976,1991,753,1929,3920,2076,4087
ũ,NongJianXiang,510821212,2711,655,2354,1692,4549,2354,1190,2193,4547,2202,4556
,HuaLongXiang,510821213,4070,799,3199,2050,6206,3197,1487,3153,6350,3157,6356
,DaLiangXiang,510821214,3156,708,2697,1560,5194,2694,1556,2722,5416,2723,5420
ɽ,WanShanXiang,510821215,1734,375,1487,924,2962,1486,917,1535,3021,1539,3026
Դ,ZhengYuanXiang,510821216,3952,612,2958,1809,5794,2935,1315,2850,5785,2921,5879
,TianXingXiang,510821217,3846,653,2706,1739,5531,2684,1145,2866,5550,2938,5644
κ,YanHeXiang,510821218,1935,461,1515,1125,3014,1502,732,1581,3083,1613,3128
,DaDeXiang,510821219,2347,433,1981,1438,3683,1981,957,1754,3735,1756,3737
½ֵ´,JingLeSiJieDaoBanShiChu,510821400,1997,621,1476,1280,2520,1473,354,1487,2960,1496,2972
¼ֵ´,ChenJiaLingSheQuJieDaoBanShiChu,510821401,1720,676,1369,1226,2587,1367,342,1369,2736,1369,2738
ĥֵ´,MoYanSheQuJieDaoBanShiChu,510821402,224,23,135,131,223,135,41,153,288,153,288
ׯ,QiaoZhuangZhen,510822100,21988,1881,13330,10617,23863,12782,3688,13493,26275,14227,27557
Ϫ,QingXiZhen,510822101,10455,1407,6853,5561,13402,6815,2122,7022,13837,7131,13984
ʯ,FangShiZhen,510822102,4639,759,2922,2302,6082,2905,795,3233,6138,3271,6193
ׯ,GuanZhuangZhen,510822103,3782,436,2413,1840,4440,2394,865,2586,4980,2670,5083
ˮ,LiangShuiZhen,510822104,5181,681,3353,2522,6880,3353,1176,3685,7038,3685,7038
԰,ZhuYuanZhen,510822105,10700,1181,7128,5286,13644,7005,2514,7149,14154,7267,14395
ľ,MuYuZhen,510822106,4719,484,3009,1828,5533,2952,990,3001,5953,3184,6193
ɳ,ShaZhouZhen,510822107,7188,888,4685,3003,8984,4678,1532,4879,9557,4923,9608
Ҧ,YaoDuZhen,510822108,4778,562,2831,1827,5590,2792,958,2991,5783,3467,6298
ƺ,HuangPingXiang,510822200,3854,453,2405,1616,4882,2404,734,2630,5034,2636,5041
,WaLiXiang,510822201,2342,292,1501,1000,2959,1485,452,1546,3031,1585,3086
Ϫ,KongXiXiang,510822202,5116,612,3231,2106,6576,3221,979,3449,6670,3476,6707
,ChaBaXiang,510822203,4069,559,2562,1768,5266,2536,768,2724,5260,2834,5396
,DaBaXiang,510822204,1841,302,1212,810,2443,1208,370,1295,2503,1301,2513
¥,QiaoLouXiang,510822205,4169,570,2740,1914,5304,2723,842,2811,5534,2841,5581
,SanGuoXiang,510822206,5763,725,3710,2671,6830,3702,1140,3885,7587,3918,7628
Ϫ,HaoXiHuiZuXiang,510822207,2840,354,1851,1231,3592,1824,587,1875,3699,1930,3781
ְ,LeAnSiXiang,510822208,3491,451,2199,1516,4196,2171,609,2239,4410,2352,4551
ǰ,QianJinXiang,510822209,2739,428,1748,1231,3521,1739,517,1913,3652,1936,3684
,QuHeXiang,510822210,2747,470,1847,1337,3572,1823,569,1887,3710,1939,3786
�,MaGongXiang,510822211,805,184,525,426,1098,525,149,613,1138,613,1138
ʯ,ShiBaXiang,510822212,2708,450,1753,1246,3422,1753,513,1918,3671,1918,3671
,HongGuangXiang,510822213,2251,276,1386,1099,2882,1377,437,1544,2921,1578,2964
պ,SuHeXiang,510822214,2340,330,1494,1019,3036,1482,495,1626,3108,1671,3165
é,MaoBaXiang,510822215,3124,467,2005,1409,4177,1998,667,2225,4223,2253,4258
Ժ,DaYuanHuiZuXiang,510822216,3695,501,2478,1759,4940,2440,901,2572,5012,2619,5097
¥,LouZiXiang,510822217,1642,200,1017,729,2178,1017,345,1170,2187,1170,2187
ɽ,JinZiShanXiang,510822218,1828,216,1211,1022,2384,1194,469,1271,2465,1302,2513
¹,MaLuXiang,510822219,7433,869,4850,3232,9664,4849,1640,5083,9932,5092,9942
߷,QiFoXiang,510822220,2148,319,1424,884,2861,1407,491,1510,2917,1534,2958
,JianFengXiang,510822221,4497,610,2923,2138,5886,2918,980,3138,6056,3164,6087
׼,BaiJiaXiang,510822222,4687,717,3194,1944,6317,3182,1094,3266,6448,3304,6498
,BanQiaoXiang,510822223,4830,522,3094,2139,6214,3091,1073,3316,6407,3331,6425
,QiMaXiang,510822224,5281,720,3366,2141,6598,3319,1173,3557,6876,3808,7174
,GuanYinDianXiang,510822225,3414,503,2142,1250,4417,2129,622,2343,4472,2397,4539
Ӫ,YingPanXiang,510822227,4132,652,2740,1624,5326,2730,729,2722,5452,2773,5513
ƼҺӹҼȻ,TangJiaHeGuoJiaJiZiRanBaoHuQu,510822400,21,0,4,0,4,0,0,0,0,17,21
հ,PuAnZhen,510823100,32098,3640,21558,14422,28441,19385,6839,18947,38332,21019,42577
Դ,LongYuanZhen,510823101,6886,1464,5156,3915,9856,5072,1973,5044,10116,5167,10323
Ǳ,ChengBeiZhen,510823102,8076,1429,5769,4090,10463,5694,1985,5591,11285,5721,11490
ε,YanDianZhen,510823103,3805,757,2717,2179,5414,2676,969,2740,5416,2814,5531
,LiuGouZhen,510823104,4266,718,2950,2454,5750,2949,1114,3145,6094,3148,6098
,WuLianZhen,510823105,6920,1118,4827,3843,8727,4667,1627,4612,9279,4838,9665
,DongBaoZhen,510823106,5932,1152,4269,3111,8295,4187,1573,4271,8458,4388,8657
,KaiFengZhen,510823107,8766,1211,5925,4105,10418,5484,1870,5541,11025,5922,11847
Ԫɽ,YuanShanZhen,510823108,14278,2400,9856,7782,19574,9810,3402,10158,19968,10224,20080
ʥ,YanShengZhen,510823109,4858,1021,3469,2592,6730,3447,1076,3403,6850,3486,6955
,WangHeZhen,510823110,5152,867,3595,2866,7145,3590,1314,3717,7307,3738,7333
,GongXingZhen,510823111,5892,1026,4275,3341,7212,4161,1676,4141,8302,4319,8594
,JinXianZhen,510823112,3625,835,2668,2115,5146,2626,880,2601,5227,2672,5340
,XiangChenZhen,510823113,4358,1296,3563,3249,6697,3563,1284,3374,6937,3375,6938
,BaiLongZhen,510823114,10140,1533,7064,4436,13262,6233,2412,6069,12302,7021,14085
,HeLingZhen,510823115,11814,2127,8333,5661,16130,7566,2927,7502,15068,8535,16868
,YangCunZhen,510823116,6069,1011,4418,2880,8276,4369,1658,4241,8610,4320,8738
,YangLingZhen,510823117,7157,1593,5408,3762,10323,5392,1747,5065,10457,5089,10497
,JiangKouZhen,510823118,6583,1240,4882,3719,9610,4881,1971,4912,9793,4912,9794
ľ,MuMaZhen,510823119,4666,993,3393,2793,6530,3393,1223,3488,6881,3489,6882
Ź,JianMenGuanZhen,510823120,10159,1519,7062,4345,13288,6420,2558,6433,12853,7174,14236
,HanYangZhen,510823121,7765,1423,5453,3549,10628,5397,1739,5398,10795,5474,10927
,XiaSiZhen,510823122,25213,2011,15887,8667,24866,12870,5176,13226,26096,16513,32400
ʯ,JiangShiXiang,510823200,3056,604,2101,1720,4295,2100,707,2263,4363,2266,4367
,TianJiaXiang,510823201,3505,611,2491,1721,4874,2449,923,2477,4926,2548,5039
Ϫ,WenXiXiang,510823202,3544,678,2604,1907,5030,2591,904,2498,5089,2522,5126
Ҧ,YaoJiaXiang,510823203,4055,730,2801,1933,5565,2791,970,2928,5719,2954,5755
,BeiMiaoXiang,510823204,3882,820,2799,2321,5532,2776,1010,2881,5657,2913,5712
,XiMiaoXiang,510823205,3450,641,2413,1796,4811,2380,824,2449,4829,2502,4915
,YiXingXiang,510823206,3630,761,2569,1886,5206,2535,883,2660,5195,2705,5274
ë,MaoBaXiang,510823207,2614,513,1794,1348,3702,1794,589,1922,3716,1922,3716
ɽ,LiangShanXiang,510823208,3670,729,2615,1888,5160,2580,957,2683,5263,2741,5356
Ȫ,ChuiQuanXiang,510823209,2041,401,1400,1089,2774,1386,494,1508,2894,1536,2936
,XiuZhongXiang,510823210,3828,831,2693,2168,5338,2681,849,2801,5482,2815,5508
,ZhengXingXiang,510823211,2721,587,1909,1480,3808,1883,604,1959,3842,2003,3912
,MaDengXiang,510823212,2564,555,1831,1488,3608,1802,575,1812,3614,1863,3694
߳,GaoChiXiang,510823213,3498,634,2459,1767,4874,2459,836,2509,4968,2509,4968
Ȫ,WanQuanXiang,510823214,2987,706,2146,1714,4318,2139,736,2235,4374,2283,4429
ӭˮ,YingShuiXiang,510823215,3653,696,2575,1856,5029,2549,841,2559,5108,2615,5190
,GuoGuangXiang,510823216,3610,692,2445,1888,4916,2445,751,2608,5053,2608,5053
ϰ,ZheBaXiang,510823217,3099,732,2261,1803,4471,2236,772,2291,4527,2342,4603
,GongDianXiang,510823218,2980,624,2208,1723,4289,2197,819,2185,4382,2215,4423
ʨ,HouShiXiang,510823219,4050,796,2959,2235,5725,2949,1012,2869,5818,2899,5858
,ChangLingXiang,510823220,3624,886,2723,2030,5282,2710,925,2666,5376,2712,5435
Ϳɽ,TuShanXiang,510823221,3581,1025,2957,2609,5654,2937,1155,2740,5677,2804,5761
Ȧ,QuanLongXiang,510823222,3338,841,2625,2251,5076,2614,1045,2558,5172,2599,5224
,BeiYaXiang,510823223,3665,918,2871,2163,5459,2862,1052,2747,5609,2764,5635
ƺ,GuangPingXiang,510823224,3325,731,2481,2056,4887,2481,882,2457,4938,2457,4938
̷,HeFengXiang,510823225,3310,894,2600,2099,5006,2581,1012,2574,5155,2616,5216
,DianZiXiang,510823226,5163,994,3604,2961,7295,3604,1216,3769,7373,3769,7373
ҡ,YaoLingXiang,510823227,3500,796,2579,1940,4953,2549,883,2552,5101,2600,5179
Ե,QiaoDianXiang,510823228,4096,820,3187,2258,6000,3176,1280,2976,6152,3009,6196
,JinPingXiang,510823229,3214,705,2497,1822,4661,2491,961,2377,4868,2383,4880
,BaiYaXiang,510823230,2959,621,2217,1669,4141,2203,761,2087,4290,2124,4341
߹,GaoGuanXiang,510823231,4523,803,3218,2337,6364,3202,1160,3239,6441,3268,6486
,ZhangWangXiang,510823232,3929,752,2827,1978,5529,2807,1027,2842,5649,2881,5708
,ShangSiXiang,510823233,2605,358,1761,1092,3116,1731,632,1755,3486,1834,3595
꽭,LingJiangZhen,510824100,93902,11849,62672,37030,102974,54147,17060,51128,105275,60139,122811
Ʒ,YunFengZhen,510824102,13689,3554,9813,7541,18861,9631,2140,9143,18774,9570,19383
,DongQingZhen,510824104,6879,1956,5480,4067,10290,5436,1715,5002,10438,5070,10550
,BaiQiaoZhen,510824105,6420,1601,5194,3760,9663,5189,1986,4803,9992,4813,10007
,BaMiaoZhen,510824106,4275,1313,3351,2381,6519,3172,997,3009,6181,3234,6585
,WuLongZhen,510824107,8800,1534,6859,4286,11612,6017,2907,5302,11319,6382,13241
,YongNingZhen,510824108,5080,1046,3612,2579,6680,3568,1124,3425,6993,3638,7250
ԧϪ,YuanXiZhen,510824109,5357,1327,4060,3012,7840,4051,1276,3889,7940,3900,7960
,SanChuanZhen,510824110,7052,1859,5981,4333,10915,5962,2218,5088,11050,5148,11129
,LongWangZhen,510824111,8671,1696,6342,4436,11498,6200,1774,5630,11830,5799,12141
Ԫ,YuanBaZhen,510824112,17860,4027,13331,10079,23995,12915,3665,11569,24484,12221,25552
,HuanMaZhen,510824113,5150,1145,4175,3021,7744,4161,1564,3658,7819,3684,7859
ƺ,QiPingZhen,510824114,17189,3318,12635,8096,22660,11475,3796,10210,21685,11668,24303
,BaiYiZhen,510824115,10249,2538,7954,5832,14973,7887,2408,7069,14956,7241,15195
콭,LiJiangZhen,510824116,9166,2065,6903,5103,13456,6898,2315,6636,13534,6643,13546
Ĳ,WenChangZhen,510824117,11952,2156,8792,5634,15891,7933,3247,7638,15571,8563,17355
,YueDongZhen,510824118,10923,2276,8379,5410,15924,8306,2884,7608,15914,7704,16083
ʯ,ShiMaZhen,510824119,9040,1911,7036,4510,13677,7036,3139,7053,14089,7054,14090
ɽ,YunShanZhen,510824120,5639,1154,4308,2970,7836,4280,1467,3864,8144,3952,8260
Ϫ,DongXiZhen,510824121,18379,3184,13315,8665,25412,12522,5044,12343,24865,13292,26607
,GaoPoZhen,510824122,10460,2088,8141,5208,15736,8102,3643,8007,16109,8050,16191
ɽ,LongShanZhen,510824123,18525,3840,14376,9879,27454,14315,5669,13547,27862,13658,28034
,ChanLinXiang,510824202,3558,920,3016,2219,5727,3016,1311,2772,5788,2773,5789
ͤ,TingZiXiang,510824204,4450,1014,3336,2484,6544,3316,1204,3275,6591,3332,6668
׺,BaiHeXiang,510824208,6626,1712,4967,3959,9475,4914,1459,4677,9591,4830,9797
ˮ,ZheShuiXiang,510824209,4735,1065,3572,2403,6708,3526,1101,3251,6777,3329,6901
Ӻ,YongHeXiang,510824210,3292,753,2590,1997,4909,2582,1033,2469,5051,2488,5078
¹,XinGuanXiang,510824212,3580,923,2793,2005,5247,2757,909,2572,5329,2619,5412
,ZhongTuXiang,510824214,3748,1123,2940,2310,5493,2890,808,2639,5529,2739,5679
ʯ,ShiMenXiang,510824216,5561,1314,4489,2758,8300,3896,1689,3393,7289,4075,8564
ɽ,YueShanXiang,510824223,11536,2109,8178,5328,15892,8172,2362,7806,15978,7829,16007
ɽ,BaiShanXiang,510824226,5517,1071,4203,2477,8300,4111,1899,4174,8285,4284,8487
,PengDianXiang,510824228,4001,981,3235,2119,6006,3207,1382,3032,6239,3129,6364
Ϫ,QiaoXiXiang,510824229,4910,995,3511,2405,6914,3474,1137,3442,6916,3531,7042
,LongDongXiang,510824232,3497,691,2592,1833,5237,2592,1070,2666,5258,2666,5258
è,HuangMaoXiang,510824233,4683,855,3346,2101,6967,3346,1460,3652,6998,3652,6998
ʯ,ShiZaoXiang,510824234,4057,781,2935,2303,5756,2919,1005,2872,5791,2908,5843
ӵ,HeDiXiang,510824238,4530,1235,3724,2439,6796,3658,1309,3223,6881,3350,7074
˫,ShuangHeXiang,510824240,2889,852,2577,1786,4596,2539,1050,2151,4690,2214,4791
ϪɽȻ�,CangXiJiuLongShanZiRanBaoHuQuGuanLiChu,510824400,25,1,10,18,19,10,0,16,26,16,26
ϪϪɭ־Ӫ,CangXiXianSanXiKouSenLinJingYingSuo,510824401,13,0,0,1,1,0,0,1,1,13,13
Ϫֳ,CangXiXianLiangZhongChang,510824402,3254,3,308,0,0,0,0,0,0,2949,3257
Ͻ·ֵ,NanJinLuJieDao,510903001,20662,1775,13160,9070,15769,13158,3988,13260,26418,13265,26425
·ֵ,KaiXuanLuJieDao,510903002,35775,5030,23396,14715,39772,20996,5851,20009,41005,23260,46656
ֵֽ,GaoShengJieJieDao,510903003,18451,2547,11656,7192,19205,10668,2904,10018,20686,12246,23902
½ֵ,ZhenJiangSiJieDao,510903004,29331,3783,19015,13247,33808,19014,4402,18493,37507,18501,37516
·ֵ,YuCaiLuJieDao,510903005,30589,3389,19564,13204,33164,18815,4878,18571,37386,19292,38856
鸣·ֵ,JieFuLuJieDao,510903006,32228,3623,20977,14313,27406,20733,5603,20027,40760,20477,41454
κֵ̽,JiaHeJieDao,510903007,52482,4256,33282,21425,37532,32309,9985,32183,64492,33441,66723
½ֵ,GuangDeJieDao,510903008,10854,1491,7248,4940,11513,7241,2032,7111,14352,7129,14377
Դ·ֵ,FuYuanLuJieDao,510903009,33218,3114,21322,13891,25382,19748,5882,19671,39419,20892,42214
ƺֵ,LongPingJieDao,510903010,11096,1420,7571,4973,14423,7563,2244,7145,14708,7189,14760
Ȫֵ,LingQuanJieDao,510903011,13535,1212,8328,4365,10601,6717,2520,6731,13448,8939,17267
ֵ,CiYinJieDao,510903012,15334,922,8043,3428,8618,4812,1460,4703,9515,9673,17716
ֵ,JiuLianJieDao,510903013,19454,1699,12690,7350,15206,11505,3708,11005,22510,12171,24861
ǿ,NanQiangZhen,510903100,10663,1404,7279,5430,13878,7205,2390,6988,14193,7178,14457
,RenLiZhen,510903101,8986,1725,6344,4187,12339,6342,2095,6442,12784,6462,12806
,FuQiaoZhen,510903102,10109,1458,6820,4899,13663,6820,2422,7169,13989,7169,13989
,YongXingZhen,510903103,32794,5266,22259,14442,42457,21385,6846,21838,43223,22647,44906
ɳ,HeShaZhen,510903104,11936,2525,8311,5730,17093,8308,2981,9126,17434,9131,17442
,XinQiaoZhen,510903105,31066,4254,21102,11318,41270,21087,7113,21319,42406,21331,42433
,GuiHuaZhen,510903106,15537,2832,11310,7421,21607,11149,3958,10835,21984,11017,22327
,XiNingXiang,510903200,9625,1555,6553,3917,12905,6522,2082,6635,13157,6709,13262
ϳ,LaoChiXiang,510903201,18581,3188,13221,8292,26024,13215,5219,13724,26939,13767,26988
,BaoShengXiang,510903202,7797,1445,5514,3832,10907,5359,1948,5364,10723,5676,11190
Ƽ,TangJiaXiang,510903203,10648,1921,7553,4786,14763,7506,2429,7358,14864,7445,14998
,BeiGuXiang,510903204,7213,649,4900,2529,6785,3782,1373,3741,7523,4335,9235
,AnJuZhen,510904100,37784,5398,25675,15325,48917,24584,8646,24794,49378,26153,51828
,DongChanZhen,510904101,32195,4945,21575,13948,44201,21574,7229,22784,44358,22794,44369
ˮ,FenShuiZhen,510904102,23928,3796,16028,10446,33002,16003,5408,17009,33012,17104,33132
ʯ,ShiDongZhen,510904103,19679,3210,13027,7119,26842,13014,4188,14013,27027,14050,27077
,LanJiangZhen,510904104,24418,4401,18356,13038,35304,18338,7067,17471,35809,17530,35886
ʯ,BaoShiZhen,510904105,24736,3583,16517,9323,33465,16446,5549,17203,33649,17351,33868
,BaiMaZhen,510904106,24278,4037,16485,11000,33786,16193,5593,17192,33385,17423,33908
,ZhongXingZhen,510904107,15549,2310,10414,5202,21317,10406,3665,11088,21494,11110,21524
ɽ,HengShanZhen,510904108,32639,4736,21365,11987,43155,21336,6359,22282,43618,22369,43734
,HuiLongZhen,510904109,17468,2403,11063,6920,23003,11060,3195,12002,23062,12003,23066
,SanJiaZhen,510904110,41410,5888,26786,14758,54929,26020,8334,27787,53807,28846,55632
,YuFengZhen,510904111,14805,2790,10636,7567,21172,10579,3875,10657,21236,10834,21470
ü,XiMeiZhen,510904112,37290,5538,24541,14447,50617,24032,8348,26113,50145,26635,51176
ĥϪ,MoXiZhen,510904113,18958,2730,12142,6776,25166,11965,3922,13035,25000,13468,25610
,JuXianXiang,510904200,17318,2678,11236,6736,23018,11036,3221,11538,22574,11981,23217
,LianHuaXiang,510904201,14097,2157,9618,5425,19352,9614,3324,9956,19570,9960,19578
,GuanYinXiang,510904202,12449,1904,8017,4687,16576,7867,2341,8477,16344,8677,16694
,BuYunXiang,510904203,8460,1454,6021,3520,12112,6007,2401,6214,12221,6294,12315
,ChangLiXiang,510904204,18422,2839,11841,7129,24585,11536,3461,12276,23812,12881,24722
,DaAnXiang,510904205,18762,2822,12294,7145,25281,12153,3864,12922,25075,13154,25448
,MaJiaXiang,510904206,11065,1601,7083,4105,14796,7036,2205,7696,14732,7788,14871
,ChiChengZhen,510921100,65398,10445,45302,29913,66759,42752,13262,41574,84326,43803,89105
»,XinHuiZhen,510921101,8253,1765,5540,3497,11165,5539,1433,5911,11450,5911,11451
ľ,WenJingZhen,510921102,19364,3708,13047,8634,26509,12450,3866,13009,25459,13891,26938
,MingYueZhen,510921103,14264,2786,9760,7198,19650,9685,2959,10143,19828,10249,20009
,ChangLeZhen,510921104,14393,2879,9661,6075,19563,9644,2656,10240,19884,10267,19928
츣,TianFuZhen,510921105,19527,3364,13087,7635,26125,13085,3571,13366,26451,13375,26462
콭,HongJiangZhen,510921106,12375,1961,8703,4981,16541,8416,2801,8176,16592,8434,17137
,BaoFanZhen,510921107,9134,2039,6522,4806,12857,6480,2146,6677,13157,6797,13319
ʯ,DaShiZhen,510921108,14614,2731,10534,7531,19758,10500,3786,10530,21030,10597,21131
,JiXiangZhen,510921109,9297,1781,6262,4226,12663,6221,1770,6500,12721,6586,12848
,MingFengZhen,510921110,17587,3413,11505,7918,23899,11497,3418,12866,24363,12913,24418
¡,RenLongZhen,510921111,16288,3176,11504,6826,21637,10995,4018,11474,22469,11978,23482
,SanFengZhen,510921112,18278,3178,12521,8151,24749,12443,4316,13121,25564,13251,25772
ƺ,GaoPingZhen,510921113,7177,1339,4707,3122,9593,4704,1458,5259,9963,5267,9974
,PengNanZhen,510921114,45032,5813,30405,15343,58470,28108,11093,28967,57075,31533,61938
Ⱥ,QunLiZhen,510921115,14563,2358,9971,7471,20399,9971,3632,10582,20553,10582,20553
¶,XiaDongXiang,510921200,6733,1543,4636,3138,9556,4629,1437,5064,9693,5077,9713
,XinXingXiang,510921201,5168,1033,3560,2143,7177,3426,1173,3695,7121,3814,7374
޸,LuoGeXiang,510921202,3368,688,2201,1725,4563,2188,657,2493,4681,2512,4713
,BanQiaoXiang,510921203,4962,1305,3637,2575,7108,3637,1198,3810,7447,3828,7465
,HuaiHuaXiang,510921204,4284,1139,3097,2218,6118,3091,887,3184,6275,3213,6310
,JiXingXiang,510921205,8878,1797,6172,4151,12626,6172,2075,6568,12740,6578,12750
,HuangNiXiang,510921206,8491,1649,5654,3574,11667,5641,1803,6235,11876,6289,11943
Ҷ,HeYeXiang,510921207,7380,1341,5267,3912,10530,5135,2032,5401,10536,5486,10753
,JinLongXiang,510921208,5533,915,3621,2169,7437,3621,1180,4004,7625,4007,7628
ũ,NongXingXiang,510921209,8023,1351,5395,3750,11086,5395,1974,5953,11348,5953,11348
ʤ,XinShengXiang,510921210,3268,737,2199,1363,4439,2195,608,2407,4602,2414,4613
ˮ,HuiShuiXiang,510921211,6048,1213,4080,2599,8351,4037,1327,4473,8510,4508,8588
Ⱥ,QunLiXiang,510921212,5170,956,3413,2218,6860,3388,986,3646,7034,3699,7112
,GaoShengXiang,510921213,7500,1587,5084,3131,10374,5069,1531,5507,10576,5534,10618
,JinQiaoXiang,510921214,5466,1130,3883,2467,7628,3867,1250,3901,7768,3963,7846
̫,TaiHeZhen,510922100,188411,22936,125551,75241,200004,113655,33245,107555,221210,119041,244592
,DaYuZhen,510922101,33176,4804,22248,13544,40925,20566,5948,20198,40764,21680,43928
,GuangXingZhen,510922102,22692,3631,15139,10356,29647,15022,4112,15041,30063,15296,30435
,JinHuaZhen,510922103,42349,7321,28872,20773,53552,27532,7846,27354,54886,28644,57516
,DuoPaiZhen,510922104,40856,6260,28784,17880,51470,27424,8811,25620,53044,27143,55927
̫,TaiYiZhen,510922105,21073,3836,15586,10297,29604,15516,5762,14981,30497,15085,30671
,JinJiaZhen,510922106,17419,2719,11764,7997,23535,11693,3805,12021,23714,12179,23943
,FuXingZhen,510922107,15438,2758,10107,7251,20103,9952,2775,10668,20620,10864,20971
,TianXianZhen,510922108,15423,3074,10344,8582,20698,10289,2399,10508,20797,10552,20896
ʺ,RenHeZhen,510922109,26012,4733,17429,11647,34616,17280,4347,17374,34654,17663,35092
,QingGangZhen,510922110,25678,4971,17169,13117,33650,16840,4259,17170,34010,17739,34908
Ϫ,YangXiZhen,510922111,28159,5338,19186,14046,38237,19125,5238,19375,38500,19549,38735
ɽ,XiangShanZhen,510922112,11414,2016,7756,5202,15595,7734,2332,7955,15689,8006,15762
,MingXingZhen,510922113,17253,3251,12370,7649,24081,12343,4314,12383,24726,12448,24818
,FuXiZhen,510922114,13480,2427,8993,4991,18313,8765,2873,9333,18098,9787,18780
¹,ChenGuZhen,510922115,10588,2195,7633,5440,15318,7546,2692,7596,15142,7842,15475
,FengLaiZhen,510922116,10543,1972,7474,5170,14756,7324,2580,7320,14644,7621,15095
,TongSheZhen,510922117,9527,2300,7133,5196,13770,7048,2217,6750,13798,6911,14044
ܱ,CaoBeiZhen,510922118,13852,2842,9770,6984,19413,9770,2838,9761,19531,9762,19532
,GuanShengZhen,510922119,10927,2297,7814,5520,15447,7813,2325,7731,15544,7735,15549
ĺ,QuHeXiang,510922200,15928,2589,10968,6586,21472,10935,3377,10863,21798,10926,21894
,FuHeXiang,510922201,4465,903,2953,2172,5904,2910,813,3154,6064,3228,6181
,QingDiXiang,510922202,5066,1272,3806,2903,7244,3806,1025,3557,7363,3557,7363
˫Ϫ,ShuangXiXiang,510922203,9559,1982,6556,4646,13037,6532,1868,6784,13316,6853,13409
,WenShengXiang,510922204,10202,2207,7110,5232,14128,7097,1988,7257,14354,7287,14397
,WanLinXiang,510922205,17503,2904,11912,7746,23657,11810,3768,11956,23766,12263,24175
̫,TaiXingXiang,510922206,10392,1952,6822,5037,13779,6761,1680,7084,13845,7202,14024
,DongYueXiang,510922207,15718,3173,10583,7584,21142,10522,2724,10831,21353,11032,21615
,JinHeXiang,510922208,7957,2061,5766,4069,11113,5732,1622,5730,11462,5874,11640
̫,YuTaiXiang,510922209,9628,1897,6402,4559,12981,6401,1639,6762,13163,6762,13164
,PengLaiZhen,510923100,104421,13471,70954,46007,114658,67582,23056,66628,134210,69994,140948
¡ʢ,LongShengZhen,510923101,44864,7739,31799,19439,61317,31454,10143,30471,61925,30947,62746
,HuiMaZhen,510923102,27996,4035,17876,11457,36267,17777,4868,18804,36581,19023,36899
챣,TianBaoZhen,510923103,19632,3007,12935,7666,26615,12932,4286,13954,26886,13990,26925
ӱ,HeBianZhen,510923104,44163,7150,29754,18575,59626,29741,9270,30754,60495,30829,60583
׿Ͳ,ZhuoTongJingZhen,510923105,21160,3408,14295,9951,28906,14234,4703,14854,29088,14976,29271
,YuFengZhen,510923106,29259,4458,19773,13041,39292,19768,6075,19981,39749,20019,39792
ɽ,XiangShanZhen,510923107,21739,3638,14865,8636,29416,14852,4366,14856,29708,14878,29743
ͨ,TongXianXiang,510923200,9577,1427,6136,4154,12768,6136,1870,6736,12872,6738,12874
Ԫ,JinYuanXiang,510923201,21220,3339,13974,7992,28633,13969,4258,14824,28793,14843,28817
ˮ,ZhiShuiXiang,510923202,7476,1371,5075,3115,10305,5075,1519,5291,10366,5291,10366
Ƕֵ,ChengDongJieDao,511002001,18995,3972,12894,9950,21268,12846,2411,12246,25092,12484,25378
Ͻֵ,ChengNanJieDao,511002002,19382,3101,13343,8731,21672,13192,3324,12232,25424,12464,25807
ֵ,ChengXiJieDao,511002003,28867,5259,19662,14191,31577,19506,3871,18134,37640,18335,37997
Ϫֵ,YuXiJieDao,511002004,25319,4054,17193,11928,26475,16952,4337,16241,33193,16517,33710
¥ֵ,PaiLouJieDao,511002005,31194,4682,20366,14516,31548,20234,5538,19669,39903,21048,41414
ӿڽֵ,HaoZiKouJieDao,511002006,24902,3733,15251,10062,25227,13659,2991,13108,26767,16375,31626
,BaiMaZhen,511002100,33507,5663,23012,15554,44281,22959,6772,22268,45227,22930,45942
ʷ,ShiJiaZhen,511002101,11126,1839,7603,5102,14037,7551,2282,7479,15030,7644,15247
,LingJiaZhen,511002102,22576,4164,16153,10470,32090,16007,6217,16641,32648,16804,32957
,ZhaoYangZhen,511002103,17573,3153,12207,7070,24751,12195,4559,13025,25220,13078,25285
,YongAnZhen,511002104,27042,4576,19122,11791,38056,19116,7326,19764,38880,19822,38944
ȫ,QuanAnZhen,511002105,16489,2764,11264,6749,22120,11261,4062,12015,23276,12051,23315
,JingMinZhen,511002106,14215,2256,9915,5991,19401,9915,3320,9876,19791,9876,19791
,LeXianZhen,511002107,10569,1409,6309,4483,11312,5758,1887,5371,11129,7556,13865
,DuoJiangXiang,511002200,12066,2285,8231,5565,16965,8227,2907,8963,17190,9027,17258
ͨ,JiaoTongXiang,511002201,15168,2076,10698,7618,19547,10697,3179,9725,20422,9725,20423
ĺ,SiHeXiang,511002202,7339,1030,5120,3432,9771,5113,1713,4948,10061,4962,10082
,FengMingXiang,511002203,14376,2343,10232,5965,20491,10230,3924,10403,20633,10411,20643
,FuLongXiang,511002204,7418,1527,5564,3628,11086,5557,2438,5780,11337,5819,11383
,GongJiaXiang,511002205,7093,1470,4973,3432,9904,4970,1655,5205,10175,5245,10218
˽ֵ,DongXingJieDao,511011001,37027,4040,25741,14620,33018,21529,6872,20733,42262,22198,47939
ֵֽ,XiLinJieDao,511011002,66065,5510,41293,22630,42111,33134,8846,31271,64405,39128,80421
½ֵ,XinJiangJieDao,511011003,17071,2442,11942,7738,19882,11600,3552,10817,22417,11123,23065
,TianJiaZhen,511011100,18761,2728,12872,8307,23991,12815,4566,13082,25897,13183,26055
,GuoBeiZhen,511011101,20394,4184,15760,11517,29554,15573,6912,15561,31134,15730,31490
,GaoLiangZhen,511011102,15537,2887,11525,7284,22008,11486,5101,11962,23448,12000,23525
׺,BaiHeZhen,511011103,21304,3561,15626,9410,30028,15619,6782,15999,31618,16021,31647
˳,ShunHeZhen,511011104,18675,4378,14065,10829,28166,14056,5963,14928,28984,14951,29016
ʤ,ShengLiZhen,511011105,34583,4011,23885,14264,38344,22876,8194,21956,44832,22903,46788
,GaoQiaoZhen,511011106,17463,2881,12544,8246,23538,12544,4696,12496,25040,12496,25040
˫,ShuangCaiZhen,511011107,25753,4567,17785,10672,36714,17776,6794,19313,37089,19329,37114
Сӿ,XiaoHeKouZhen,511011108,18863,3073,12804,8035,25593,12802,4357,13488,26290,13489,26293
,YangJiaZhen,511011109,11053,2472,8344,5757,16771,8342,3627,8794,17136,8808,17152
ľ,BeiMuZhen,511011110,17091,2895,12125,9123,20822,12041,3724,11353,23394,11585,23710
ʯ,ShiZiZhen,511011111,13335,2486,9455,7003,18960,9453,3512,9874,19327,9878,19333
̫,TaiAnXiang,511011200,8395,1544,6051,3714,11906,6051,2555,6434,12485,6443,12494
ռ,SuJiaXiang,511011201,12609,2319,8818,4999,17895,8811,3281,9373,18184,9391,18209
Ϫ,FuXiXiang,511011202,15199,2902,10421,6505,21265,10297,3617,11069,21366,11297,21718
ͬ,TongFuXiang,511011203,10780,1723,7552,4568,14410,7065,2710,7597,14662,7661,15213
,BeiNanXiang,511011204,20022,3531,14394,9469,28920,14394,5681,14840,29234,14840,29234
,YongDongXiang,511011205,21144,4070,14612,10830,30080,14610,5507,16090,30700,16109,30721
,YongFuXiang,511011206,12497,2389,8917,5166,18072,8915,3393,9353,18268,9362,18279
µ,XinDianXiang,511011207,12219,2236,9132,6127,18416,9132,4379,9702,18834,9702,18834
˫,ShuangQiaoXiang,511011208,14845,2385,10759,6992,21706,10696,5071,11430,22126,11542,22301
ƽ̹,PingTanXiang,511011209,12723,2595,8916,5416,18273,8915,3520,9907,18822,9922,18838
ɽ,ZhongShanXiang,511011210,10729,2231,7823,5514,15596,7823,2811,7948,15771,7948,15771
,DaZhiXiang,511011211,7112,1384,5079,3488,10422,5073,2156,5552,10625,5573,10652
,LiuQiaoXiang,511011212,12875,2272,9082,5379,18035,9018,3496,9476,18494,9561,18643
,SanLieXiang,511011213,6746,1696,4830,3444,10039,4830,1873,5485,10315,5485,10315
,YanLingZhen,511024100,104983,15569,72887,50721,111862,71136,21455,67534,138670,69120,142007
,PuZiWanZhen,511024101,11665,2038,7796,5287,14717,7783,2274,8150,15933,8181,15977
µ,XinDianZhen,511024102,30854,5389,20704,11780,40636,20456,5931,21199,41655,21470,42174
,XiangYiZhen,511024103,22507,4194,15190,9178,28978,15117,4034,15470,30587,15545,30735
,JiePaiZhen,511024104,15709,3490,10897,6599,21218,10877,3454,11704,22581,11756,22653
,LongHuiZhen,511024105,18796,4379,14047,9623,25622,13428,4818,13349,26777,13946,27993
ʯ,GaoShiZhen,511024106,21599,4405,14659,9398,28648,14548,4407,15570,30118,15752,30411
,DongLianZhen,511024107,13328,2452,9230,5646,18615,9218,3353,9897,19115,9903,19133
,JingHeZhen,511024108,14094,2813,9631,6430,19377,9631,3113,10389,20020,10389,20020
,ZhenXiZhen,511024109,38644,8239,27352,18190,52822,27278,8164,27612,54890,27695,55047
,QingWeiZhen,511024110,6953,1605,5044,3884,9305,4986,1794,4997,9983,5308,10352
ɽ,ShanWangZhen,511024111,7428,1674,5121,3575,9902,5114,1529,5485,10599,5510,10631
ƾ,HuangJingGouZhen,511024112,14983,3512,10301,7316,20062,10275,2569,10508,20783,10763,21064
Ӣ̲,GuanYingTanZhen,511024113,14190,2884,9773,6682,19235,9763,3405,10663,20426,10706,20479
³,XinChangZhen,511024114,24108,4313,16312,10959,31780,16194,5563,17239,33433,17672,33984
,LianJieZhen,511024115,45843,5678,29596,19473,50183,28926,9811,30190,59116,31736,61332
ԽϪ,YueXiZhen,511024116,11619,2379,8373,5922,15576,8322,3197,8725,17047,8822,17195
,LiangHeZhen,511024117,9840,1394,6472,4205,10752,6351,2164,6731,13082,6926,13398
볧,WanChangZhen,511024118,7716,1210,5073,3355,9476,5070,1774,5170,10240,5627,10700
С,XiaoHeZhen,511024119,15064,2438,10163,6377,19171,10137,3695,10929,21066,11034,21197
,ZhongLongZhen,511025100,61344,9621,43147,31182,75500,41570,12212,39385,80955,40030,83177
¶,GanLuZhen,511025101,13255,2522,8969,6279,18552,8969,3049,9853,18822,9857,18826
,GuiDeZhen,511025102,20808,3448,13843,9099,28558,13808,4709,14889,28697,15122,28965
Ϫ,YuXiZhen,511025103,30113,4376,20237,13414,40431,20226,6561,20754,40980,20813,41050
,JinLiJingZhen,511025104,16634,2653,11326,7344,23056,11323,4109,12037,23360,12070,23396
,TieFoZhen,511025105,22134,3112,14579,9121,29628,14578,4798,15465,30043,15465,30044
Ϫ,QiuXiZhen,511025106,35396,5462,23467,15403,46995,22665,7808,24378,47043,25199,48666
˳ӳ,ShunHeChangZhen,511025107,12274,2343,8077,5737,16919,8077,2744,9274,17351,9284,17361
,LongJieZhen,511025108,25745,4761,17940,11316,34986,16744,6704,18093,34837,19270,37210
Ȫ,LuoQuanZhen,511025109,22226,3984,14723,9707,30616,14563,4784,15886,30449,16271,30994
,FaLunZhen,511025110,24425,4018,16520,9453,33494,16518,5914,17777,34295,17837,34357
¡,XingLongJieZhen,511025111,15170,2002,10174,6403,20258,10172,3576,10566,20738,10574,20748
ɽ,YinShanZhen,511025112,41944,7040,28026,20224,56353,28023,9110,30026,58049,30068,58094
μ,SongJiaZhen,511025113,17668,2431,11940,8036,23942,11909,4354,12393,24302,12513,24453
̫ƽ,TaiPingZhen,511025114,27945,4296,19643,11281,38555,19598,7984,20499,40097,20582,40225
,LiuMaZhen,511025115,18714,3398,12900,7515,26295,12888,4575,13679,26567,13787,26687
ˮ,ShuiNanZhen,511025116,76124,8706,51260,31620,74840,49221,16450,47826,97047,50020,101280
ռ,SuJiaWanZhen,511025117,22712,4064,15546,9572,31956,15546,5854,17084,32630,17084,32630
,XinQiaoZhen,511025118,17920,2883,11907,7634,24789,11777,4252,13023,24800,13148,25055
,MingXinSiZhen,511025119,20438,3237,13942,9314,27420,13941,4831,14561,28502,14564,28506
˫,ShuangHeZhen,511025120,22448,3225,15163,9202,30196,15163,5407,15911,31074,15917,31080
,GongMinZhen,511025121,34231,5158,22932,14924,44802,22903,8287,24396,47299,24744,47676
,LongJiangZhen,511025122,31402,5185,22281,14673,44586,22280,9172,23473,45753,23478,45759
˫,ShuangLongZhen,511025123,35219,5440,23371,15370,48677,23357,8314,25464,48821,25602,48973
¥,GaoLouZhen,511025124,25605,3971,17316,9988,34891,17308,6382,18503,35811,18642,35958
¼,ChenJiaZhen,511025125,21604,4010,14775,10247,30668,14753,5542,16299,31052,16381,31156
,PeiLongZhen,511025126,17719,2989,11693,7252,24044,11691,3886,12896,24587,12901,24594
,ZouMaZhen,511025127,19141,3226,13072,7397,26643,13067,4837,14082,27149,14132,27204
,MengTangZhen,511025128,32606,4998,21620,12701,44624,21605,7924,23830,45435,23908,45528
�,MaAnZhen,511025129,19530,3117,13011,7409,26868,12882,4755,14128,27010,14391,27402
ʨ,ShiZiZhen,511025130,24713,4156,16911,9474,34671,16908,6511,18455,35363,18469,35380
,BanLiYaXiang,511025200,17161,2859,11521,7127,23758,11520,4030,12521,24041,12529,24050
ɽ,LongShanXiang,511025201,10531,2095,7509,5012,15384,7509,2950,8067,15576,8067,15576
źֵ´,GuHuJieDaoBanShiChu,511028001,67031,8595,44888,28876,74904,40086,11234,36888,76974,41972,86860
,JinEZhen,511028100,56382,6948,38927,26447,60519,36761,11688,34412,71173,36091,75018
ɽ,ShanChuanZhen,511028101,15310,2597,10749,7218,20852,10714,3378,10509,21223,10536,21285
ʯ,XiangShiZhen,511028102,25770,5156,19177,14035,37946,19170,7684,19314,38484,19433,38610
ʥ,ShengDengZhen,511028103,13020,2488,9417,7101,17923,9368,3346,9099,18467,9437,18854
Ƽ,HuangJiaZhen,511028104,32104,6705,24077,18014,46416,23240,9965,23908,47148,24697,48774
˫,ShuangFengZhen,511028105,24749,4716,17434,12755,35036,17427,6775,18749,36176,18806,36240
,LongShiZhen,511028106,34072,5533,22722,15540,46232,22718,7299,24131,46849,24182,46904
ӭ,YingXiangZhen,511028107,25125,3946,16660,11738,34499,16657,5923,18319,34976,18334,34994
,JieShiZhen,511028108,25636,4735,17432,12296,35793,17426,6317,19180,36606,19256,36688
ʯ,ShiNianZhen,511028109,15651,3386,11792,9532,22617,11777,4547,11696,23473,11792,23584
,ZhouXingZhen,511028110,11059,2024,7882,5797,15194,7872,2921,8071,15943,8122,16004
,YuJianZhen,511028111,8034,1604,5939,4052,11409,5936,2239,5907,11843,5938,11877
ʯ,ShiYanQiaoZhen,511028112,22080,4088,15689,11763,30489,15661,5260,15405,31066,15739,31428
,LiShiZhen,511028113,8338,1560,6377,4866,12531,6377,2683,6203,12580,6204,12581
,HuJiaZhen,511028114,22604,5258,17458,13406,33798,17452,6728,17094,34546,17132,34590
ƶ,YunDingZhen,511028115,25068,4328,17224,11884,34405,17204,5799,17912,35116,17971,35195
𻨾,GuiHuaJingXiang,511028200,7125,1363,5015,3841,10352,4973,2051,5362,10335,5524,10539
,PuRunXiang,511028201,8402,2020,6557,5573,12794,6547,2763,6575,13122,6628,13185
ŹŽֵ´,ZhangGongQiaoJieDaoBanShiChu,511102001,48393,6975,32253,22316,46143,30591,7187,28229,58820,30302,62555
ˮֵ´,BoShuiJieDaoBanShiChu,511102002,48003,5130,34083,11836,28794,17691,3089,16380,34071,22139,56222
Ϻӽֵ´,ShangHeJieDaoBanShiChu,511102003,26790,5458,18576,13353,26538,17717,3201,16183,33900,16873,35449
ֵ´,DaFoJieDaoBanShiChu,511102004,9523,1479,5977,3359,7254,4820,1083,4747,9567,6108,12085
Фӽֵ´,XiaoBaJieDaoBanShiChu,511102005,32324,2000,16415,7800,17505,10478,2526,10014,20492,20435,36850
ֵͨ´,TongJiangJieDaoBanShiChu,511102006,38917,3718,24531,17269,26077,22569,6016,21904,44473,24120,48651
ֵ´,BaiYangJieDaoBanShiChu,511102007,78518,7938,50559,33947,50963,47235,11939,44308,91543,47836,98395
Ĳ,MouZiZhen,511102101,18124,2168,11433,7257,16023,10315,2655,10493,20808,11514,22947
,TuZhuZhen,511102102,12648,1695,7972,4727,14160,7563,1843,7872,15435,8214,16186
,BaiMaZhen,511102103,5378,1421,3828,2971,7249,3828,903,3874,7702,3874,7702
é,MaoQiaoZhen,511102104,9267,1781,6032,4982,11996,6030,1340,6351,12381,6356,12388
ƽ,QingPingZhen,511102105,6588,1537,4450,3228,8948,4450,965,4636,9086,4640,9090
ջ,SuJiZhen,511102106,29640,4269,19371,10357,30183,16328,3868,15879,32207,18406,37777
ˮ,ShuiKouZhen,511102107,13270,2434,9012,5548,16824,8969,2023,8606,17575,8715,17727
,AnGuZhen,511102108,20209,3668,13483,8408,26218,13468,2914,13173,26641,13308,26791
,MianZhuZhen,511102109,9728,1538,6240,4119,11267,6151,1543,6321,12472,6569,12809
ȫ,QuanFuZhen,511102110,8149,1287,5266,3425,9786,5261,1138,5296,10557,5308,10574
ͯ,TongJiaZhen,511102111,7680,1790,5220,3582,10410,5126,1205,5252,10378,5455,10675
ŷ,JiuFengZhen,511102112,11308,1952,7477,5243,12882,7467,1682,7377,14844,7465,14942
޺,LuoHanZhen,511102113,8234,1489,5457,3519,10315,5421,1244,5397,10818,5510,10967
ٽ,LinJiangZhen,511102114,5188,1031,3422,2352,6702,3422,749,3546,6968,3546,6968
,CheZiZhen,511102115,10315,1537,6654,4206,11814,6646,1432,6618,13264,6630,13284
,YueLaiXiang,511102200,6264,1394,4160,2834,8201,4119,914,4332,8451,4412,8572
,GuanMiaoXiang,511102201,6881,1330,4551,3005,8758,4542,999,4644,9186,4659,9210
ʯ,ShiLongXiang,511102202,4940,1028,3261,2259,6304,3212,589,3259,6471,3296,6557
,JianFengXiang,511102203,8366,1712,5376,3760,10957,5376,1103,5805,11181,5805,11181
,LingYunXiang,511102204,8066,1299,5162,3364,9968,5097,1127,5281,10378,5330,10492
ӭ,YingYangXiang,511102205,4016,725,2541,1631,5139,2541,534,2734,5275,2734,5275
,JiuLongXiang,511102206,2516,558,1666,1228,3322,1664,411,1819,3483,1819,3485
,PuRenXiang,511102207,2256,598,1605,1247,3064,1602,390,1638,3240,1639,3244
ƽ,PingXingXiang,511102208,6475,1116,4114,2522,7858,4096,899,4203,8299,4376,8490
,YangWanXiang,511102209,11507,1975,7554,4578,14322,7525,1792,7542,15067,7720,15274
ɳ,ShaWanZhen,511111100,40782,5640,23835,15304,41937,20195,5098,19811,40006,27685,51520
ũ,JiaNongZhen,511111101,19752,3017,12654,7240,23733,11984,3047,11950,23934,13162,25816
̫ƽ,TaiPingZhen,511111102,14025,2574,9200,6277,17774,9118,1990,9154,18272,9389,18589
»,FuLuZhen,511111103,13974,2461,9423,6407,18726,9408,2923,9831,19239,9935,19358
ţʯ,NiuShiZhen,511111104,5514,1066,3812,2524,7181,3764,1180,3888,7652,3948,7760
,GongZuiZhen,511111105,3460,636,2308,1390,4619,2269,712,2409,4678,2500,4808
«,HuLuZhen,511111106,7754,1512,5169,3022,10447,4919,1445,5310,10229,5542,10711
̤ˮ,TaShuiZhen,511111107,7123,1205,4520,2826,9221,4480,1111,4799,9279,4919,9439
̷,TanBaXiang,511111200,5507,1089,3621,2341,7389,3621,958,3933,7554,3933,7554
Ϫ,ZhenXiXiang,511111201,3155,749,2228,1477,4433,2216,704,2362,4578,2380,4608
,FanDianXiang,511111202,2214,643,1531,1105,3078,1454,356,1605,3059,1682,3213
ͭ,TongCiXiang,511111203,4108,836,2862,1749,5636,2841,870,2917,5758,2952,5814
ɽ,BiShanXiang,511111204,8695,1630,5579,3580,11114,5559,1133,5800,11359,5879,11458
ĭ´,MoJiangBanShiChu,511111400,5079,1005,2798,2407,5540,2661,448,2742,5403,3734,6532
,ZhuGenZhen,511112100,58013,9753,38686,26363,66997,37969,7665,35784,73753,36745,75431
ţ,NiuHuaZhen,511112101,32534,5794,21242,15016,39519,21032,4042,20593,41625,21128,42370
,YangLiuZhen,511112102,14171,2533,9174,6168,17384,8912,1667,8932,17844,9197,18371
Ź,QiaoGouZhen,511112103,12140,2375,7695,5612,15233,7546,1576,7764,15310,8396,16091
,JinSuZhen,511112104,14853,2370,9530,6630,17857,9508,1829,9405,18913,9522,19052
ɽ,JinShanZhen,511112105,17125,3166,11258,7147,21775,11230,2560,11488,22718,11593,22851
ɽ,HuiShanZhen,511112106,8590,1527,5464,3851,10823,5459,1121,5766,11225,5774,11238
,XiBaZhen,511112107,17644,2732,11301,7275,22226,11288,2669,11635,22923,11744,23045
Ӣ,GuanYingZhen,511112108,27483,4434,18134,13444,35781,18127,4096,17874,36001,17879,36013
̽,CaiJinZhen,511112109,9905,1742,6296,4522,12569,6294,1388,6736,13030,6739,13035
ʯ,ShiLinZhen,511112110,18343,2871,11490,7397,22985,11230,2634,11893,23123,12358,23848
,XinYunXiang,511112200,8107,1598,5176,3141,10526,5126,1036,5460,10586,5565,10741
,YongHeZhen,511113100,14585,1843,9184,6538,14995,8914,2777,8918,17832,10021,19205
,JinHeZhen,511113101,4918,1210,3416,2360,6696,3386,969,3573,6959,3681,7097
ƽ,HePingYiZuXiang,511113200,7427,887,5070,2707,8463,4606,1980,4742,9348,5224,10294
,GongAnYiZuXiang,511113201,3488,543,2445,1447,4798,2428,1156,2603,5031,2742,5187
,JiXingXiang,511113202,2292,501,1637,1107,3121,1624,541,1666,3290,1697,3334
ʤ,YongShengXiang,511113203,2913,601,1853,1241,3560,1827,526,1940,3767,2187,4040
,YuJinZhen,511123100,71634,9258,47957,35849,74810,46994,13085,44626,91620,46020,93977
Т,XiaoGuZhen,511123101,11941,2446,8622,6469,15621,8057,2646,7863,15920,8411,17033
ʯϪ,ShiXiZhen,511123102,13797,2456,9078,7605,17012,8969,2291,9233,18202,9466,18544
Ϫ,QingXiZhen,511123103,28970,4772,20383,14739,36669,19639,6868,19451,39090,20227,40610
,XinMinZhen,511123104,12816,2901,9359,8378,18497,9348,3646,9909,19257,10004,19363
޳,LuoChengZhen,511123105,26312,5191,18394,14219,31764,17557,4787,17223,34780,17896,36290
Ź,BaGouZhen,511123106,8832,1690,5324,4618,10171,5291,1168,5632,10923,6366,11690
,LongKongZhen,511123107,11125,2843,8428,7060,15972,8413,2995,8484,16897,8535,16963
,DingWenZhen,511123108,8705,2077,6285,4936,12046,6279,1860,6307,12586,6357,12642
,AoJiaZhen,511123109,7644,2254,5685,4667,10897,5685,1596,5777,11462,5809,11494
ʯ,JinShiJingZhen,511123110,7153,1854,5106,4285,9999,5085,1380,5204,10289,5281,10387
Ȫˮ,QuanShuiZhen,511123111,6826,1212,4458,3203,8645,4451,1251,4795,9246,4831,9289
˫Ϫ,ShuangXiXiang,511123200,5474,1092,3820,2992,7684,3808,1456,4179,7987,4202,8022
ž,JiuJingXiang,511123201,3623,744,2690,2085,5036,2686,1125,2783,5469,2802,5492
ͬ,TongXingXiang,511123202,4759,852,3161,2406,6163,3142,1122,3457,6599,3572,6733
ե,ZhaGuXiang,511123203,5824,1201,4056,3071,8093,4055,1435,4395,8450,4404,8460
¯,TieLuXiang,511123204,3786,915,2834,2339,5489,2834,1084,2950,5784,2951,5785
,DaXingXiang,511123205,5020,1281,3737,2863,7244,3722,1438,3971,7693,4002,7739
,NanYangXiang,511123206,3563,854,2567,2070,4849,2509,784,2523,5032,2634,5201
ͼ,JiJiaXiang,511123207,2484,688,1890,1552,3568,1889,587,1868,3757,1869,3759
ʢ,XinShengXiang,511123208,2630,667,1859,1399,3668,1847,566,1968,3815,2004,3863
ٱ,ShouBaoXiang,511123209,6959,1696,4886,3953,9627,4886,1321,5062,9948,5090,9976
,WuYuXiang,511123210,8508,1745,5874,4127,11499,5874,1492,5870,11744,5871,11745
¶,XiaDuXiang,511123211,7265,1528,5052,3638,9694,5008,1501,5197,10205,5242,10294
,YuPingXiang,511123212,5308,1191,3620,2761,7293,3600,1035,3870,7470,3914,7534
Ặ,MinDongXiang,511123213,6647,888,4253,2697,8392,4249,1053,4308,8557,4335,8588
,TangBaXiang,511123214,8734,1506,5734,4961,11176,5731,1664,6157,11888,6170,11904
,MaMiaoXiang,511123215,6352,1029,3849,3062,8099,3841,1110,4591,8432,4642,8491
ƽ,GongPingXiang,511123216,3927,1059,2951,2517,5677,2943,940,2956,5899,2975,5926
,FuLongXiang,511123217,4413,1149,3255,2542,6379,3246,1053,3344,6590,3360,6615
г,YanChengZhen,511124100,47690,6464,33244,22532,44812,31821,9897,29706,61527,30807,64051
̤,MaTaZhen,511124101,14324,2741,10562,6815,17222,9866,3413,9392,19258,9916,20478
԰,ZhuYuanZhen,511124102,7823,2213,6422,4846,11371,6244,2335,5749,11993,5949,12371
о,YanJingZhen,511124103,8441,3050,7007,5607,13285,6990,2485,6879,13869,6969,13976
,ZhouPoZhen,511124104,8824,2075,6478,5177,12138,6406,2075,6433,12839,6496,12974
ǧ,QianFoZhen,511124105,8902,2392,6821,5329,12658,6803,2111,6555,13358,6584,13405
,WangCunZhen,511124106,11017,2589,7917,5905,15012,7908,2332,8008,15916,8021,15938
,SanJiangZhen,511124107,6802,1693,5380,3996,9827,5370,2007,5098,10468,5122,10502
,DongLinZhen,511124108,4891,1702,3965,3320,7538,3958,1379,4004,7962,4007,7972
ĥ,MoChiZhen,511124109,4833,1090,3522,2435,6568,3522,1106,3507,7029,3507,7029
,JiYiXiang,511124200,7084,1610,5350,3711,10290,5349,1881,5225,10574,5225,10575
,ChunFuXiang,511124201,3668,1140,2804,2275,5226,2793,813,2777,5570,2817,5621
,SanJiaoXiang,511124202,3900,832,2698,1918,5136,2693,819,2822,5515,2853,5551
̲,GaoTanXiang,511124203,3546,1187,2850,2337,5434,2844,943,2819,5663,2826,5676
,BaoWuXiang,511124204,4418,1280,3251,2663,6296,3250,878,3321,6571,3325,6576
ĺ,SiHeXiang,511124205,2937,964,2353,1787,4315,2257,711,2194,4451,2259,4612
Ʋ,HuangBoXiang,511124206,4343,1217,3225,2548,6236,3215,1003,3315,6530,3338,6563
ʤȪ,ShengQuanXiang,511124207,3887,1075,3077,2326,5924,3031,1095,2941,5972,2980,6057
ſ,MenKanXiang,511124208,3283,1233,2873,2369,5225,2868,1101,2709,5577,2744,5617
ʯţ,ShiNiuXiang,511124209,3555,963,2737,2020,5238,2735,901,2632,5367,2682,5419
߷,GaoFengXiang,511124210,5825,1954,4767,3889,9144,4767,1747,4752,9519,4759,9526
,JinFengXiang,511124211,3901,1122,3028,2292,5824,3024,993,2984,6008,2988,6016
ȫ,FenQuanXiang,511124212,2961,881,2253,1722,4139,2188,573,2094,4282,2162,4415
,ZhenYangXiang,511124213,4036,1131,2917,2194,5790,2865,793,2980,5845,3043,5960
,TianYunXiang,511124214,3100,799,2126,1649,4293,2116,506,2251,4367,2279,4405
,WuPaoXiang,511124215,2742,939,2177,1784,4172,2172,739,2229,4401,2243,4420
,DaFoXiang,511124216,4259,1215,3265,2370,6194,3250,1043,3163,6413,3252,6517
ɳ,YanChengZhen,511126100,59243,9143,39988,28588,67720,39459,10031,37607,77066,38429,78417
,HuangTuZhen,511126101,17153,2666,11258,7424,20713,11076,2546,10894,21970,11107,22365
ʽ,GanJiangZhen,511126102,27284,4905,17798,11329,34300,17649,3567,17751,35400,17958,35756
,JiePaiZhen,511126103,13094,2175,8470,5398,16009,8451,1896,8596,17047,8695,17165
,ZhongXingZhen,511126104,8090,1661,5473,3683,10761,5473,1362,5639,11112,5640,11113
,SanDongZhen,511126105,10121,1546,6565,3699,12612,6535,1240,6277,12812,6342,12907
ⳡ,WuChangZhen,511126106,10201,1776,6569,3786,12878,6561,1267,6650,13211,6675,13244
ľ,MuChengZhen,511126107,10906,2222,7370,5428,14441,7359,1688,7414,14773,7446,14816
ͷ,HuaTouZhen,511126108,7249,1381,4865,3234,9859,4843,1583,5293,10136,5348,10213
,GanLinZhen,511126109,12265,1899,7908,4595,14893,7813,1646,7687,15500,7902,15810
³,XinChangZhen,511126110,9143,1336,5769,3438,10600,5467,1178,5454,10921,5888,11657
˳,ShunHeXiang,511126200,8504,1343,5477,3365,10686,5477,1117,5477,10954,5487,10964
,MaCunXiang,511126201,8216,1752,5406,3478,10792,5363,1156,5621,10984,5718,11124
,TuMenXiang,511126202,8019,1239,5152,2953,9610,5123,1105,5120,10243,5211,10363
,QingZhouXiang,511126203,6726,1059,4285,2523,8312,4263,851,4333,8596,4351,8636
,WuFengXiang,511126204,4865,830,3258,2029,6151,3256,744,3178,6434,3181,6439
,YongQingXiang,511126205,3937,612,2473,1469,4880,2473,441,2516,4989,2517,4990
ӭ,YingJiangXiang,511126206,7711,1567,5100,3260,10075,5076,1095,5205,10281,5273,10373
,LongDuoXiang,511126207,4301,870,2814,1857,5719,2813,677,3034,5847,3034,5848
ϰ,NanAnXiang,511126208,7310,1414,4642,3397,8863,4629,960,4977,9606,5042,9684
Ъ,XieMaXiang,511126209,8032,1441,5397,3343,10732,5395,1502,5571,10966,5578,10975
,MaLiuXiang,511126210,3750,878,2776,1895,5386,2776,859,2711,5487,2711,5487
Ϫ,MuXiZhen,511129100,30746,3933,20865,12810,34723,18960,7441,19382,38342,21255,42120
,YongFuZhen,511129101,9406,1687,6828,4237,13530,6806,3027,7238,14044,7292,14120
,DaNanZhen,511129102,7310,1623,5266,3788,10768,5266,2254,5901,11167,5921,11187
,JianBanZhen,511129103,5183,1069,3695,2654,7288,3689,1553,4098,7787,4110,7805
۰,ZhouBaZhen,511129104,10123,1546,6881,4264,13403,6788,2652,7282,14070,7440,14321
Ƶ,HuangDanZhen,511129105,9046,1303,6148,4180,11477,6068,2276,6338,12406,6477,12625
,LiDianZhen,511129106,8414,1250,5962,3766,10680,5914,2518,6156,12070,6220,12182
,JianHeXiang,511129200,5484,1061,3806,2507,7807,3803,1640,4358,8161,4379,8185
Ҹ,XingFuXiang,511129201,8817,1595,6049,3900,12624,6048,2443,6806,12854,6806,12855
·,XinFanXiang,511129202,6695,1063,4595,2960,9261,4592,1785,4923,9515,4948,9543
,FuHeXiang,511129203,2987,666,2225,1569,4474,2225,919,2347,4572,2347,4572
̿,TanKuXiang,511129204,4498,820,3110,2102,6342,3104,1208,3371,6475,3416,6526
ױ,DiBaoXiang,511129205,8618,1727,6351,4291,12980,6351,3133,7099,13450,7127,13478
,YangCunXiang,511129206,4660,1032,3250,2020,6554,3218,1214,3594,6812,3656,6906
,GaoSunXiang,511129207,5733,786,3809,2394,7773,3809,1601,4289,8098,4311,8120
,CiZhuXiang,511129208,4817,1108,3422,2448,6882,3415,1332,3773,7188,3835,7257
,HaiYunXiang,511129209,4448,723,2985,1886,6015,2985,965,3149,6134,3151,6136
ʥ,WuShengXiang,511129210,6391,1090,4353,2798,8896,4353,1817,4945,9298,4945,9298
,FengCunXiang,511129211,4813,849,3439,2393,6639,3437,1447,3601,7038,3670,7109
,XuNiDiQu,511129400,2215,122,331,263,684,286,55,333,619,2061,2392
ɳƺ,ShaPingZhen,511132100,29293,3422,19390,12171,30075,18137,7368,18878,37015,20693,40083
,DaBaoZhen,511132101,7046,900,5152,2654,9516,4998,2614,5099,10097,5408,10560
ëƺ,MaoPingZhen,511132102,7201,1146,4849,2783,9504,4716,1921,5158,9874,5419,10268
,WuDuZhen,511132103,5934,1094,3977,2632,7743,3957,1357,4291,8248,4408,8385
,XinLinZhen,511132104,8792,1043,6350,3203,12491,6348,3114,6597,12945,6599,12949
,HeiZhuGouZhen,511132105,2562,193,1716,1153,3075,1649,1031,1897,3546,2070,3786
컨,HongHuaXiang,511132200,2514,485,1710,1024,3360,1710,570,1859,3569,1859,3569
ƺ,YiPingXiang,511132201,4066,748,2733,1681,5419,2732,903,2983,5715,2984,5717
,YangCunXiang,511132202,3820,506,2658,1488,5099,2637,1120,2754,5391,2788,5446
,BaiYangXiang,511132203,1634,141,1295,667,2555,1295,861,1341,2636,1341,2636
Ī,JiaoMoXiang,511132204,1322,133,981,572,1880,909,570,1000,1909,1044,2025
ƺ,WanPingXiang,511132205,1470,126,1074,649,2104,1062,668,1162,2224,1190,2264
,YangHeXiang,511132206,2206,218,1702,854,3232,1699,1064,1763,3462,1786,3488
,GongHeXiang,511132207,2937,449,1857,1144,3837,1848,628,2142,3990,2157,4014
³,XinChangXiang,511132208,4020,688,2585,1587,5239,2585,848,2970,5555,2971,5556
ƽ,PingDengXiang,511132209,3107,498,2165,1247,4391,2165,1027,2460,4625,2467,4632
,HaQuXiang,511132210,1528,105,1105,613,2178,1079,696,1140,2219,1224,2329
,JinYanXiang,511132211,4215,328,3196,1698,6223,3195,2027,3370,6565,3374,6570
,LeWuXiang,511132212,3213,258,2252,1247,4551,2132,1462,2281,4413,2681,4933
,MinJianZhen,511133100,27173,2743,18882,10780,29560,18200,8077,18396,36596,19111,37993
ٶ,RongDingZhen,511133101,7208,1185,5312,3409,9710,5252,2529,5486,10738,5610,10922
Ͷ,LaoDongXiang,511133200,7494,1034,5447,3029,9823,5418,2526,5525,10943,5607,11054
,JianSheXiang,511133201,7099,793,5461,2784,10185,5456,3341,5770,11226,5772,11233
ʯ,ShiLiangXiang,511133203,2110,398,1631,1093,2868,1622,755,1610,3232,1632,3263
,QiaoBaXiang,511133204,4928,1032,3686,2685,7319,3682,1668,3893,7575,3942,7628
,MinZhuXiang,511133206,5700,899,4397,2766,8513,4387,2786,4972,9359,4988,9385
ϺӰ,LaoHeBaXiang,511133207,2430,585,1942,1289,3860,1942,959,2032,3974,2032,3974
Ϫ,XiaXiXiang,511133208,6048,1051,4639,2830,8709,4639,2247,4707,9346,4707,9346
ѩɽ,XueKouShanXiang,511133209,6341,675,5313,2522,9330,5311,3692,5379,10690,5395,10708
,ZhenJiangMiaoXiang,511133210,1852,284,1358,837,2339,1358,705,1483,2841,1483,2841
,DaZhuBaoXiang,511133211,2124,220,1705,933,3081,1705,1189,1825,3530,1828,3533
հ,SuBaXiang,511133213,7474,718,5856,3066,11133,5846,3860,6057,11903,6196,12052
̷,YanFengXiang,511133214,5445,403,4491,1944,8411,4457,3251,4403,8860,4608,9099
ԬϪ,YuanJiaXiXiang,511133215,2331,176,1904,867,3478,1890,1423,1987,3877,2026,3930
ɳǻ,ShaQiangXiang,511133216,3502,279,3170,1393,5668,3166,2587,3189,6355,3198,6368
ӿ,SanHeKouXiang,511133217,4867,386,4001,1848,7731,3973,3036,4051,8024,4288,8289
÷Ӱ,MeiZiBaXiang,511133221,2054,152,1765,840,3438,1741,1425,1764,3505,1866,3631
׿Ӫ,GaoZhuoYingXiang,511133223,4044,359,3446,1513,6728,3430,2600,3482,6912,3557,7003
,YongHongXiang,511133226,2463,192,2101,925,3944,2084,1623,2129,4213,2177,4278
ɽ,SuiShanZhen,511181100,100763,13218,65141,41621,97092,58465,16053,55696,114161,64893,130034
,GaoQiaoZhen,511181101,10217,1942,6766,4587,12874,6749,1709,7025,13774,7102,13868
Ŀ,LuoMuZhen,511181102,17819,3034,11495,7830,21396,11397,2478,11479,22876,11836,23331
,JiuLiZhen,511181103,19241,3272,12039,8381,22760,11598,2690,11973,23571,13164,25203
,LongChiZhen,511181104,17856,3127,11792,7568,22968,11444,3484,11841,23285,12675,24467
ֶ,LeDouZhen,511181105,8940,1535,5903,4584,11048,5896,1476,6024,11920,6048,11951
Ϫ,FuXiZhen,511181106,24127,3339,15323,9046,25946,13898,2895,14059,27957,15038,30361
ɽ,EShanZhen,511181107,10289,1260,6808,3919,9740,5447,1308,5324,10771,6049,12857
˫,ShuangFuZhen,511181108,18694,2736,12034,7412,22861,11979,2856,12037,24016,12252,24286
,GuiHuaQiaoZhen,511181109,33139,6332,22119,14879,38458,21492,4737,21508,43000,22089,44208
Ϊ,DaWeiZhen,511181110,8240,1981,5659,3615,11490,5562,1740,6040,11602,6302,11961
ʤ,ShengLiZhen,511181111,16939,2657,11100,7682,15817,10926,2686,10582,21508,11182,22282
,LongMenXiang,511181200,5175,1279,3674,2578,7137,3648,1140,3888,7536,3920,7594
,ChuanZhuXiang,511181201,4512,917,2780,1919,5860,2693,594,2969,5662,3243,6023
ɳϪ,ShaXiXiang,511181202,2809,849,1850,1414,3898,1844,356,2142,3986,2164,4014
ƽ,XinPingXiang,511181203,7553,1168,4861,3125,9411,4842,1033,4858,9700,4893,9754
,PuXingXiang,511181204,7412,1694,5089,3491,10274,5085,1498,5510,10595,5515,10604
,HuangWanXiang,511181205,20486,1816,10156,5396,15930,7806,1968,7874,15680,14114,24270
гǽֵ,ZhongChengJieDao,511302001,58752,7190,38072,22434,56486,33090,8063,31247,64337,35933,74005
ǽֵ,BeiChengJieDao,511302002,53465,7919,35226,24081,54747,34495,8404,33463,67958,34562,69788
ǽֵ,XiChengJieDao,511302003,55190,7096,37472,24758,48447,35423,9342,33544,68967,34156,71628
Ͻֵ,DongNanJieDao,511302004,24037,2998,15624,10759,18849,15388,3865,14694,30082,15276,30900
ֵ,WuFengJieDao,511302005,41613,4573,25421,17151,34149,24073,6820,23681,47754,27585,53006
½ֵ,XinJianJieDao,511302006,44461,4656,29141,18129,31768,26218,7263,25047,51265,27239,56380
ֵ,HuaFengJieDao,511302007,33249,1557,21470,6691,17063,8352,2152,8497,16849,15488,36958
ƽ·ֵ,HePingLuJieDao,511302008,59411,5801,38449,20876,53174,30957,8610,30016,60973,35373,73822
Ϫ,YingXiZhen,511302103,55835,5254,35198,20357,38683,29494,10317,32064,61558,36208,71406
,GongXingZhen,511302104,3926,1229,3018,2848,5891,3007,1052,3182,6189,3189,6207
̨,JinTaiZhen,511302105,6660,1542,4983,3736,9794,4983,1986,5201,10184,5205,10188
«Ϫ,LuXiZhen,511302106,9794,1644,6987,4845,13207,6934,2870,7243,14177,7321,14308
,LiJiaZhen,511302107,10077,1659,7348,4821,13788,7347,2874,7253,14600,7262,14610
˫,ShuangQiaoZhen,511302108,3977,956,3055,2191,6143,2990,1315,3099,6089,3193,6248
Ϫ,JingXiZhen,511302109,8284,1431,5924,4063,11601,5914,2062,5831,11745,5853,11777
,BanZengZhen,511302110,13837,2295,9339,6798,18457,9271,3215,9740,19011,10008,19347
¸,XinFuXiang,511302200,3655,878,2494,1874,5135,2490,704,2706,5196,2743,5237
ͬ,TongRenXiang,511302201,2970,667,1978,1697,4070,1975,600,2252,4227,2259,4237
,DaLinXiang,511302204,4391,1013,3158,2342,6203,3116,1284,3277,6393,3530,6688
,FanDianXiang,511302205,4148,835,2882,1966,5929,2877,1141,3222,6099,3242,6124
˳,ShunHeXiang,511302206,4486,1011,3261,2402,6602,3261,1237,3472,6733,3473,6734
̨,DengTaiXiang,511302207,4102,916,2994,2061,5978,2984,1195,3203,6187,3219,6213
Ծ,HuiJingXiang,511302208,5233,1159,3923,2697,7779,3920,1607,4063,7983,4076,7999
,LongGuiXiang,511302209,5541,1080,3986,2637,7960,3973,1645,4182,8155,4280,8266
,YongFengXiang,511302210,7134,1292,5149,3403,10302,5149,2140,5417,10566,5417,10566
,GuiHuaXiang,511302211,3891,992,2920,2199,5980,2920,1187,3150,6070,3150,6070
ɽ,FengShanXiang,511302212,4352,827,2939,1932,5932,2889,952,3049,5938,3192,6131
Ϫ,YuXiXiang,511302213,4698,977,3554,2396,6929,3554,1409,3530,7084,3530,7084
ֵ´,BaiTaJieDaoBanShiChu,511303001,62932,4713,37748,20554,49105,30051,9568,31314,61365,39465,77213
Ϫֵ´,QingXiJieDaoBanShiChu,511303002,28419,3189,17627,12073,33648,17482,4572,17723,35205,18553,36180
С,XiaoLongZhen,511303101,25431,1899,15143,6137,20016,10006,3358,9932,19938,15545,30688
,LongMenZhen,511303102,35471,4480,24167,16572,40198,21789,7528,21232,43021,23312,47479
,JiangLingZhen,511303103,16898,2522,11083,7242,23378,11083,4011,12347,23430,12348,23431
,CaErZhen,511303104,8674,1513,5818,4001,12362,5818,2220,6586,12404,6589,12407
Ͼ,LaoJunZhen,511303105,9437,1549,6437,3791,12882,6419,2379,6709,13128,6928,13365
,DongGuanZhen,511303106,25653,4129,17816,11954,35051,17422,6736,18263,35685,18702,36518
,ChangLeZhen,511303107,13291,1978,8989,5637,18601,8839,3567,9641,18480,9847,18836
ʤ,ShengGuanZhen,511303108,8202,1337,5716,3578,11561,5678,2301,6048,11726,6124,11840
,YongAnZhen,511303109,7216,1139,4793,3328,9700,4793,1377,4939,9732,4939,9732
ڼ,QueJiaZhen,511303110,6796,1018,4649,3045,9341,4649,1696,4861,9510,4861,9510
ʯ,ShiGuiZhen,511303111,6897,1176,4768,2840,9692,4768,1664,4968,9736,4969,9737
,QingJuZhen,511303112,10223,1607,7141,4319,14413,6715,2664,6876,13591,7353,14494
,QingLianZhen,511303113,6534,904,4532,3172,8527,4532,1691,4597,9129,4597,9129
,DouJingZhen,511303114,9414,1459,6503,4408,11217,6323,1524,5844,12167,5894,12397
,HuiLongZhen,511303115,10490,1603,7054,4546,14871,7054,2910,7949,15003,7949,15003
Ϫ,LuoXiZhen,511303116,10693,1641,7380,4513,14661,7375,2579,7523,14898,7533,14913
,ZouMaXiang,511303201,12305,1933,8190,5536,16954,8157,2894,8890,17047,8942,17132
,YuJiaXiang,511303202,4828,809,3201,2020,6656,3201,1147,3581,6782,3583,6784
,MaJiaXiang,511303203,7248,1307,4852,3316,10364,4852,1885,5579,10431,5588,10440
Ϫ,HuangXiXiang,511303204,6501,1119,4527,2837,9396,4527,2023,5112,9639,5116,9643
,WanJiaXiang,511303205,2545,479,1678,1021,3610,1678,643,1987,3665,1989,3667
ʷ,YuShiXiang,511303207,7410,1218,5034,2946,10570,4981,2046,5517,10498,5640,10674
¡,LongXingXiang,511303208,8841,1548,6242,3868,12742,6242,2576,6722,12964,6723,12965
,BanZhuXiang,511303209,7472,1251,5199,3166,10725,5199,2224,5748,10947,5748,10947
۳,YanJiaXiang,511303210,4116,772,2929,1882,6061,2927,1239,3171,6098,3198,6127
ˮ,JinShuiXiang,511303211,11089,2177,7459,4949,15581,7456,2695,8490,15946,8502,15961
Ϫͷ,XiTouXiang,511303212,9660,1368,6358,3940,13060,6358,2084,6752,13110,6754,13112
,QingSongXiang,511303213,7117,977,4670,2917,8961,4461,1454,4487,8948,4878,9548
,FengHuangXiang,511303215,6234,1043,4128,2930,8782,4104,1582,4661,8765,4731,8859
Ͻ,NanJiangXiang,511303218,7073,1217,5118,3111,10328,5029,2292,5350,10379,5464,10582
𻨽ֵ,HuoHuaJieDao,511304001,73163,5442,43037,25759,46354,38634,13244,38539,77173,48812,91849
ˮ,QuShuiZhen,511304101,9519,1690,6245,4501,13034,6227,2219,7059,13286,7183,13428
,LiDuZhen,511304102,15622,2481,11490,6903,16467,9957,5012,9963,19920,11625,23115
,JiAnZhen,511304103,11053,1847,7642,4860,15563,7634,3234,8462,16096,8492,16134
,LongLingZhen,511304104,12517,1702,8201,4599,17068,8200,3171,9168,17368,9189,17390
,JinFengZhen,511304105,16723,2252,10874,7594,22408,10874,3943,12031,22905,12044,22918
,AnFuZhen,511304106,12028,1693,7956,5057,16309,7949,2920,8672,16621,8685,16641
ƽ,AnPingZhen,511304107,16933,3108,11763,8376,23090,11446,4588,12527,23973,12866,24629
,ShiYangZhen,511304108,13600,2398,8606,5786,18465,8461,2667,9742,18203,10059,18665
ͨ,DaTongZhen,511304109,12480,2510,9190,5814,17345,8378,3804,8707,17085,9604,18794
һ,YiLiZhen,511304110,9873,1624,6327,4765,13055,6282,2186,7236,13518,7356,13683
,LongPanZhen,511304111,11235,1900,7358,5128,15119,7357,2137,7902,15259,7914,15272
,LiBaZhen,511304112,7093,1184,4612,3341,9689,4612,1568,5219,9831,5233,9845
,JiFengZhen,511304113,7045,1275,4695,3225,9671,4653,1611,5150,9803,5236,9931
,JinBaoZhen,511304114,8599,1330,5593,3949,11553,5578,1727,6032,11610,6063,11656
,SanHuiZhen,511304115,6348,1021,4048,2574,8425,4043,1260,4574,8617,4581,8629
,XiXingZhen,511304116,7109,1253,4662,3311,9126,4610,1509,4882,9492,5209,9871
˫,ShuangGuiZhen,511304117,7915,1647,5152,3763,10943,5152,1552,5961,11113,5962,11114
ķ,WenFengZhen,511304118,11518,2083,8157,5371,15837,8071,2435,7563,15634,7879,16036
߱,QiBaoSiZhen,511304119,5634,882,3617,2446,7415,3585,1118,3951,7536,4017,7634
Ȫ,LongQuanZhen,511304120,6523,1178,4160,3125,8671,4159,1210,4751,8910,4751,8911
,HeXiXiang,511304201,9310,1289,6349,4008,12816,6324,2366,6550,12874,6616,12965
ɽ,YiShanXiang,511304202,6532,1235,4366,3150,9082,4366,1661,5062,9428,5062,9428
ľ,MuLaoXiang,511304203,9477,1416,6081,4202,12379,5852,1945,6364,12216,6757,12838
³,XinChangXiang,511304205,7518,1471,5509,3403,11185,5459,2381,5776,11235,5861,11370
,TuMenXiang,511304207,7953,1454,5630,3427,11455,5619,2297,6017,11636,6074,11704
ٽ,LinJiangXiang,511304208,9571,1743,6770,4123,13958,6770,2864,7407,14177,7408,14178
˫,ShuangDianXiang,511304209,9420,1621,6419,4045,13452,6412,2784,7388,13800,7406,13825
׼,BaiJiaXiang,511304211,8088,1232,5354,3354,11138,5333,1995,5905,11238,5961,11315
,HuaXingXiang,511304212,10328,1601,6468,3633,13850,6375,2094,7381,13756,7555,14023
ͬ,DaTongXiang,511304213,7025,960,4469,2571,9462,4469,1545,5054,9523,5061,9530
Ϫ,YanXiXiang,511304215,6772,1096,4390,2989,9243,4388,1599,5070,9458,5077,9467
,QiaoLongXiang,511304216,4287,798,2795,1715,5979,2689,1057,3166,5855,3347,6142
,TianXingXiang,511304218,4745,858,3064,2079,6401,3030,983,3450,6480,3522,6586
,DaGuanXiang,511304219,5816,978,3821,2698,7959,3806,1307,4257,8063,4280,8101
,DaXingXiang,511304220,9050,1697,6137,3996,12555,6119,2116,6697,12816,6726,12863
,XinMiaoXiang,511304221,5481,815,3407,2427,7173,3391,1101,3947,7338,3990,7397
԰,TaoYuanXiang,511304222,6154,1090,3910,2651,8292,3910,1138,4464,8374,4472,8382
̫,TaiHeXiang,511304223,4574,906,2928,2124,6207,2923,840,3375,6298,3392,6320
,JiShanXiang,511304226,7155,1176,4691,3352,9782,4687,1588,5219,9906,5228,9919
ʯ¥,ShiLouXiang,511304228,4985,1098,3155,2462,6839,3155,847,3775,6930,3775,6930
,LiLeXiang,511304229,6664,1301,4450,3075,9148,4415,1353,4807,9222,4868,9318
԰,HuaYuanXiang,511304230,6255,1252,4432,3079,8441,4412,1382,4413,8825,4457,8889
¡,NanLongZhen,511321100,143449,16123,96827,58072,150295,87962,33497,86222,174184,96242,193069
Ӷ,HeDongZhen,511321101,6882,1265,5155,3193,9769,5118,1998,4860,9978,4990,10145
ѻ,LaoYaZhen,511321102,10173,2193,7995,5182,15528,7981,3416,7746,15727,7787,15782
,YongDingZhen,511321103,7713,2017,6580,4310,12225,6580,2819,5969,12549,5969,12549
Ժ,BeiYuanZhen,511321104,9008,2063,7286,4468,13839,7263,2893,6625,13888,6678,13964
л,XieHeZhen,511321105,5356,1216,4418,3129,8304,4382,1897,3998,8380,4051,8469
,PanLongZhen,511321106,17720,4358,13804,9780,26442,13547,5060,13068,26615,13334,27138
,TieFoTangZhen,511321107,6484,1391,4973,3556,9715,4970,2154,5052,10022,5056,10029
ʯ,ShiHeZhen,511321108,8489,1802,6843,4727,12669,6757,2797,6167,12924,6245,13088
,WangJiaZhen,511321109,10368,2177,7868,5659,15081,7781,3106,7648,15429,7783,15651
,FuLiZhen,511321110,9846,2343,7946,5082,14960,7936,3154,7354,15290,7397,15343
ľ,NanMuZhen,511321111,9867,2740,8512,6206,15918,7626,3882,7295,14921,7977,16489
ƺ,ChangPingZhen,511321112,5525,1355,4389,2747,8517,4288,1836,4142,8430,4327,8716
,DongBaZhen,511321113,9080,2174,7293,5078,12151,6518,3419,6423,12941,7380,14673
Ӱ,HeBaZhen,511321114,7174,1904,6134,4784,11775,6134,2920,5863,11997,5864,11998
ˮ,DingShuiZhen,511321115,14922,3077,11191,8099,21020,10851,4162,10595,21446,10970,22161
,DaiWangZhen,511321116,6019,1278,4429,2969,8504,4396,1589,4374,8770,4457,8886
ƽ,HuangJinZhen,511321117,9114,2137,6810,4940,13698,6705,2690,6883,13588,7131,13941
,LiuMaZhen,511321118,5616,1446,4240,3478,8416,4206,1579,4326,8532,4401,8641
,JianXingZhen,511321119,20735,4499,16253,12664,28017,15754,6560,14946,30700,15541,31794
,SanGuanZhen,511321120,7119,1756,5590,4176,10382,5590,2131,5416,11006,5416,11006
,FuHuZhen,511321121,14897,2191,10646,6974,19542,10254,3908,9963,20217,10350,20996
˫,ShuangFoZhen,511321122,7010,1382,5529,3745,10123,5527,2147,5008,10535,5010,10539
,HuaGuanZhen,511321123,6106,1164,4549,2962,8773,4548,1642,4362,8910,4363,8912
,DaQiaoZhen,511321124,8955,1638,6676,4902,13075,6576,2685,6504,13080,6602,13278
,DaHeZhen,511321125,7978,1688,5949,3692,11428,5923,2127,5814,11737,5844,11793
,WanNianZhen,511321126,5474,1129,4257,2869,8180,4244,1741,4057,8301,4087,8344
,ShengZhongZhen,511321127,8449,1642,6483,5071,11937,6438,2609,6136,12574,6217,12700
ˮ,ShengShuiZhen,511321128,3601,829,2847,2227,5207,2833,1065,2630,5463,2648,5495
ƺ,DaPingZhen,511321129,6722,1243,4691,3121,9042,4220,1537,4016,8236,4811,9502
,ShenBaZhen,511321130,5799,1155,4281,2704,8288,4281,1475,4148,8429,4148,8429
,NianPanXiang,511321200,4534,1308,3801,2527,7316,3801,1607,3648,7449,3648,7449
,HuoFengXiang,511321201,6064,1340,4718,3148,8819,4718,1913,4599,9317,4599,9317
Ⱥ,QunLongXiang,511321202,6602,1621,5171,3805,10049,5113,1976,4949,10062,5028,10199
,DaFuXiang,511321204,8047,1935,6377,4511,12489,6375,2689,6285,12660,6294,12671
⻪,GuangHuaXiang,511321205,4222,940,3357,2379,6258,3339,1340,3087,6426,3145,6502
,BiLongXiang,511321206,6593,1715,5442,3731,10358,5423,2240,5085,10508,5106,10548
,SanQingXiang,511321208,6898,1392,5355,3293,10401,5330,2368,5251,10581,5303,10658
,ZhongXinXiang,511321209,5318,1504,4251,2861,8221,4223,1692,4188,8411,4263,8514
,WuLingXiang,511321210,9073,1826,6777,4040,13412,6617,2860,6699,13316,6982,13759
ƽ,PingQiaoXiang,511321211,5749,1533,4764,3427,9282,4764,2102,4616,9380,4620,9384
÷,MeiJiaXiang,511321212,4750,1467,4093,3258,7940,4093,1877,4001,8094,4001,8094
,LongMiaoXiang,511321213,2587,929,2270,1871,4506,2270,1068,2314,4584,2314,4584
,MaWangXiang,511321214,2897,1341,2756,2548,5259,2754,1472,2938,5692,2954,5710
,DaYanXiang,511321215,3979,1083,3202,2226,6182,3181,1424,3244,6425,3284,6486
Ҥ,YaoChangXiang,511321216,6079,1440,4568,2871,9223,4469,1982,4741,9210,4933,9501
̫,TaiHuaXiang,511321217,4900,1078,3597,2361,6992,3570,1214,3518,7088,3595,7192
ʢ,XingShengXiang,511321218,5999,1449,4607,3424,8920,4593,1741,4560,9153,4582,9189
,HanPoXiang,511321220,6839,1719,5304,3896,10359,5271,2068,5208,10479,5322,10626
Ф,XiaoJiaXiang,511321222,5438,1087,4172,3149,8217,4165,1778,4122,8287,4131,8303
,SiLongXiang,511321225,5897,1297,4287,2576,8593,4287,1576,4483,8770,4483,8770
,NianYaXiang,511321226,5211,1307,4177,3237,8064,4112,1649,3905,8017,3990,8167
ǧ,QianQiuXiang,511321227,4117,1025,2944,2174,5948,2911,954,3101,6012,3152,6096
,YuZhenXiang,511321228,2670,875,2336,1811,4220,2296,904,2044,4340,2113,4449
СԪ,XiaoYuanXiang,511321229,7476,1610,5796,3964,11060,5787,2287,5558,11345,5577,11373
,LiuYiXiang,511321230,5762,1437,4933,3543,9216,4929,2262,4520,9449,4528,9461
ʯȪ,ShiQuanXiang,511321231,6326,1661,5210,3757,10099,5178,2327,5007,10185,5104,10314
ʨ,XiongShiXiang,511321232,3965,969,3379,2560,6357,3363,1695,3203,6566,3250,6629
,HongGuanXiang,511321233,9086,1773,6874,4307,13412,6868,2837,6803,13671,6822,13696
,YongQingXiang,511321234,3942,927,3205,2230,5962,3194,1247,2873,6067,2911,6116
,YongHongXiang,511321235,7420,1749,6031,4272,11313,6011,2507,5581,11592,5645,11676
,LiuShuXiang,511321236,5814,1317,4533,3034,8521,4496,1611,4129,8625,4209,8742
,BaoChengXiang,511321237,4727,1182,3716,2935,7218,3696,1410,3525,7221,3603,7319
˫,ShuangFengXiang,511321238,5325,1090,4140,3010,7972,4138,1678,3952,8090,3953,8093
,ZaoJiaoXiang,511321239,3109,867,2585,2119,4926,2585,1051,2441,5026,2442,5027
,QiuYaXiang,511321240,5123,1158,3775,2686,7362,3775,1242,3748,7523,3748,7523
,GuangZhongXiang,511321241,5095,1137,3778,2739,7168,3778,1341,3794,7572,3795,7573
,TieBianXiang,511321242,3850,753,2796,2053,5228,2790,899,2678,5468,2706,5502
̫ϼ,TaiXiaXiang,511321243,2791,658,2145,1699,4093,2133,757,2005,4138,2061,4206
,DianYaXiang,511321244,4254,850,3068,2290,5868,3018,1021,2996,6014,3057,6125
ͩƺ,TongPingXiang,511321245,5091,1135,3767,2764,7131,3767,1222,3677,7444,3681,7448
,XiHeXiang,511321246,2368,424,1699,1202,3142,1691,620,1675,3366,1713,3412
ʳ,LangChiZhen,511322100,54307,8088,38526,23547,69809,38072,13682,37142,75214,37551,76077
˾,LuJingZhen,511322101,5160,1242,3934,2692,7735,3933,1485,3931,7864,3953,7887
,DongShengZhen,511322102,13706,2695,9516,5960,19849,9514,3521,10398,19912,10406,19922
,LuoShiZhen,511322103,17019,4134,13727,12107,26783,13727,6201,13623,27350,13627,27354
ƶ,HuangDuZhen,511322104,7284,1383,5206,3255,10319,5200,1959,5410,10610,5420,10626
С,XiaoQiaoZhen,511322105,20500,3384,15075,10612,28475,14497,5839,13934,28431,14648,29723
,LingJiuZhen,511322106,16713,3581,11925,7466,24115,11925,4262,12631,24556,12631,24556
,LaoLinZhen,511322107,8426,1651,6189,4613,12432,6141,2518,6360,12501,6406,12595
ľ,MuYaZhen,511322108,8553,1414,5882,3696,11871,5882,2082,6166,12048,6167,12049
ˮ,XiaoShuiZhen,511322109,9912,1946,6960,4726,13723,6959,2545,7436,14395,7443,14403
˫,ShuangLiuZhen,511322110,17995,3144,12495,7041,25062,12478,4447,13057,25535,13091,25586
ˮ,LvShuiZhen,511322111,9586,1907,6797,4161,13249,6795,2589,7279,14074,7285,14082
,SanXingZhen,511322112,6421,1109,4345,2699,8916,4345,1659,4844,9189,4844,9189
ޤҶ,LiaoYeZhen,511322113,4795,1167,3542,2404,7017,3542,1302,3722,7264,3722,7264
µ,XinDianZhen,511322114,12447,2462,8782,6009,17916,8771,3299,9399,18170,9426,18208
,HuiLongZhen,511322115,19986,3559,14681,11621,28923,14678,5957,14813,29491,14821,29502
ǻ,XingHuoZhen,511322116,12344,2497,9193,6264,18492,9157,3876,9482,18639,9524,18717
,XiQiaoZhen,511322117,7618,1343,5420,3239,10981,5408,2185,5704,11112,5726,11146
,ChengNanZhen,511322118,57554,5909,38873,22243,53902,36460,14871,36641,73101,39461,78334
ô,JiChuanXiang,511322201,11979,2178,8261,5134,16982,8261,2900,8787,17048,8796,17057
,ChaPanXiang,511322202,5810,1308,4129,2545,8448,4129,1436,4425,8554,4425,8554
˫Ϫ,ShuangXiXiang,511322204,8247,1558,5685,3528,11698,5683,2255,6366,12049,6375,12060
,DaiHeXiang,511322206,7000,1619,4984,3213,10068,4942,1600,5184,10126,5235,10219
ϲ,SiXiXiang,511322207,6346,1125,4463,2350,9018,4437,1723,4669,9106,4731,9194
,LingLongXiang,511322210,4016,885,2992,1984,5956,2989,1225,3122,6111,3134,6126
ӿȪ,YongQuanXiang,511322211,5833,1280,4020,2645,8325,4016,1347,4417,8433,4440,8460
ľ,MuDingXiang,511322212,6644,1219,4646,2789,9221,4627,1599,4753,9380,4816,9462
Դ,QingYuanXiang,511322213,5267,1063,3565,2314,7400,3565,1159,3924,7489,3924,7489
,LongFuXiang,511322214,5649,1117,4005,2489,8055,4005,1441,4201,8206,4202,8207
˫,ShuangLinXiang,511322215,5188,1122,3721,2344,7591,3710,1393,3964,7674,3982,7703
,MingDeXiang,511322216,7061,1556,5060,3295,10125,5053,1725,5220,10273,5282,10342
,PuLingXiang,511322217,10045,1479,6494,3258,11929,5756,2065,6201,11957,7095,13589
Ԫ,SanYuanXiang,511322218,6217,1189,4425,2569,8817,4425,1652,4632,9057,4633,9058
̫,TaiPengXiang,511322219,5098,1093,3654,2348,7330,3654,1293,3829,7483,3830,7484
,BoLinXiang,511322221,7586,1531,5561,3580,10927,5561,1916,5472,11033,5472,11033
ȸ,KongQueXiang,511322222,5820,1141,4092,2220,8171,4092,1404,4272,8364,4273,8365
,HeXingXiang,511322223,7253,1644,5333,3542,10613,5332,1844,5399,10731,5408,10741
,LiuHeXiang,511322224,3033,659,2139,1356,4351,2139,743,2296,4435,2296,4435
,YueZhongXiang,511322225,5462,1082,3866,2714,7808,3863,1452,4124,7987,4130,7996
,GaoMaXiang,511322227,2398,935,2093,1665,3903,2092,835,2065,4157,2075,4168
,AnGuXiang,511322228,4768,1174,3824,2432,6723,3824,1599,3717,7541,3717,7541
,DaMiaoXiang,511322230,7374,1682,5429,3617,11080,5429,2121,5742,11171,5748,11177
ͨ,TongTianXiang,511322231,7863,1594,5578,3565,11404,5578,2029,5907,11485,5908,11486
,AnHuaXiang,511322232,5512,1186,3849,2436,7839,3843,1316,4145,7988,4165,8014
,FaTangXiang,511322233,5532,1134,3742,2166,7881,3722,1320,4193,7915,4244,7986
,ZengChanXiang,511322234,7417,1507,5283,3312,10767,5283,1971,5612,10895,5612,10895
,FengChanXiang,511322236,8714,1638,6177,4142,12387,6177,2050,6225,12402,6225,12402
ˮ,QingShuiXiang,511322237,5802,1141,4053,2659,7816,3823,1328,3876,7699,4218,8271
ɽ,QingShanXiang,511322238,5184,1112,3800,2520,7494,3800,1370,3866,7666,3866,7666
Դ,FuYuanXiang,511322239,5121,1151,3727,2356,7295,3727,1183,3726,7453,3728,7455
ƺ,BaiPingXiang,511322240,3627,750,2445,1601,5145,2443,845,2777,5220,2777,5222
߽,QiJianXiang,511322241,3971,798,2881,2024,6005,2881,1288,3176,6057,3176,6057
,LiangFengXiang,511322243,4511,918,3049,1884,6483,3025,1171,3501,6526,3551,6600
,JinPingZhen,511323101,17348,2277,11108,6562,18282,9550,2842,9679,19229,11359,22467
,JuLongZhen,511323102,10021,1713,7034,5152,13947,7020,2530,7204,14224,7230,14264
Դ,ZhengYuanZhen,511323103,8941,1602,6208,4579,12463,6208,2178,6509,12717,6513,12721
,LongYunZhen,511323104,5660,1329,4020,3137,8048,4016,1280,4245,8261,4249,8269
Ϫ,JinXiZhen,511323105,19388,3785,13260,9005,26675,13259,4143,14047,27306,14056,27316
,XuJiaZhen,511323106,17190,3203,12192,8571,24641,12187,4551,12747,24934,12752,24944
,HeShuZhen,511323107,13692,2095,9620,7008,18972,9579,3415,9498,19077,9582,19202
Ϫ,LiXiZhen,511323108,12519,2074,8153,5563,16868,8145,2537,8956,17101,8977,17130
,LongCanZhen,511323109,9998,1720,6791,4774,13972,6789,2500,7426,14215,7427,14218
,YangJiaZhen,511323110,9879,1648,6649,4133,13835,6574,2370,7129,13703,7248,13897
޼,LuoJiaZhen,511323111,11658,2184,8380,5884,16542,8363,3311,8739,17102,8773,17153
,FuDeZhen,511323112,9974,1692,7112,4237,14457,7079,3068,7546,14625,7622,14734
,YinHanZhen,511323113,8886,1367,6032,3569,12457,6023,2520,6696,12719,6741,12773
,XingWangZhen,511323114,8859,1892,6473,4783,13145,6470,2582,6854,13324,6860,13333
,XiangRuZhen,511323115,73490,9365,50286,40083,88065,48753,17489,48612,97365,50058,100344
,GaoMiaoXiang,511323201,7296,1194,4755,2980,9873,4631,1463,5112,9743,5198,9953
Ⱥ,QunLeXiang,511323202,6669,1215,4570,2933,9365,4567,1626,4929,9496,4940,9510
,ChangLiangXiang,511323203,12124,1967,8249,5713,16632,8199,2575,8297,16496,8417,16666
·,LiangLuXiang,511323204,4846,828,3206,2238,6557,3206,936,3404,6610,3404,6610
,MuBaXiang,511323205,11474,2052,7929,5450,16164,7848,2718,8113,15961,8315,16244
ʯ,ShiLiangXiang,511323207,7343,1377,5203,3758,10471,5203,1877,5386,10589,5394,10597
ƽͷ,PingTouXiang,511323208,6321,1298,4366,3201,9004,4359,1509,4757,9116,4762,9128
ʵ,XianDianXiang,511323209,5956,1311,4082,2915,8556,4082,1464,4648,8730,4649,8731
ͤ,ChaTingXiang,511323211,5864,1418,4512,3320,8857,4512,1719,4489,9001,4489,9001
,ZhuJiaXiang,511323212,8207,1557,5826,3694,11722,5663,2240,5923,11586,6178,12004
,QiLongXiang,511323214,4772,1004,3260,1928,6650,3249,1026,3528,6777,3542,6802
,JinJiaXiang,511323215,8637,1737,5913,3737,12089,5884,1977,6340,12224,6438,12351
԰,XinYuanXiang,511323217,6397,1167,4496,2802,9019,4496,1666,4734,9230,4734,9230
,SanBaXiang,511323218,7254,1194,5122,3494,10213,5070,1885,5089,10159,5211,10333
Ϫ,BiXiXiang,511323220,7323,1419,5172,3440,10445,5170,1833,5398,10568,5403,10575
̲,LiuTanXiang,511323221,7631,1382,5203,3096,10838,5198,2008,5800,10998,5818,11021
ʯ,ShiKongXiang,511323222,6011,1214,4239,2887,8631,4239,1654,4640,8879,4640,8879
Ԫ,KaiYuanXiang,511323223,2128,711,1835,1505,3495,1827,813,1784,3611,1817,3652
º,XinHeXiang,511323225,6782,1303,4659,2815,9737,4658,1854,5273,9931,5280,9939
,NanYanXiang,511323226,7747,1359,5334,3824,11113,5326,2184,5937,11263,5956,11290
,TianChengXiang,511323227,7777,1448,5319,3405,10975,5319,1843,5749,11068,5749,11068
,HaiTianXiang,511323228,2852,1092,2474,2136,4903,2474,994,2463,4937,2464,4938
ö,JiDuXiang,511323229,5454,1031,4079,2529,7734,4040,1582,3937,7977,3988,8067
ʯ,FengShiXiang,511323230,5691,1078,3862,2210,7911,3862,1250,4157,8019,4157,8019
,JinChengZhen,511324100,79654,7595,51935,35360,88327,45931,20757,48760,94691,56071,108006
,XinZhengZhen,511324101,44980,7961,32750,23803,58700,32268,12847,32293,64561,33038,65788
�,MaAnZhen,511324102,26337,3588,17615,9500,34575,14275,7024,14722,28997,19334,36949
,YongLeZhen,511324103,20507,3743,14205,10630,29448,14202,5396,15439,29641,15441,29646
,RiXingZhen,511324104,20930,3369,14662,9710,29171,14661,5656,15291,29952,15293,29955
,TuMenZhen,511324105,25024,3558,16797,9440,34490,16653,6136,17735,34388,17921,34718
,FuXingZhen,511324106,16327,3065,12790,8039,22602,11290,6005,10813,22103,12607,25397
,GuanZiZhen,511324107,6936,1728,5434,4778,10895,5434,2416,5646,11080,5646,11080
ȷ,XianFengZhen,511324108,6732,1164,4739,2833,9628,4734,1803,4951,9685,4960,9699
,SanJiaoZhen,511324109,9451,1521,6428,4006,13368,6427,2601,7145,13572,7145,13573
ش,HuiChunZhen,511324110,14057,2487,9783,6019,19871,9776,3695,10438,20214,10456,20239
,LiuYaZhen,511324111,14793,2173,9714,6424,20460,9711,3776,11022,20733,11028,20742
·,YiLuZhen,511324112,6866,1261,4921,3118,10017,4921,2082,5287,10208,5288,10209
ɽ,LiShanZhen,511324113,22024,3626,15181,9279,30735,15077,5859,16082,31159,16328,31509
,SanHeZhen,511324114,10817,1851,7933,4428,15401,7051,3291,7403,14454,8026,15959
,WaZiZhen,511324115,6771,1144,4821,2970,9897,4821,2018,5112,9933,5112,9933
,DaYinZhen,511324116,10911,1752,7349,5008,14623,7156,2806,7873,15029,8120,15469
,ErDaoZhen,511324117,12538,2343,8667,5722,17796,8654,3245,9430,18084,9459,18126
,SaiJinZhen,511324118,11284,1811,7832,4819,15913,7622,3242,8269,15891,8505,16337
,DingZiQiaoZhen,511324119,5916,774,3818,2150,7809,3750,1659,4221,7971,4531,8349
,DaYiZhen,511324120,9862,1914,6984,4071,14112,6967,2509,7262,14229,7301,14285
Ź,ZhangGongZhen,511324121,10553,1799,7487,4364,15219,7483,3162,8022,15505,8027,15514
帣,WuFuZhen,511324122,9691,1492,6413,3790,13519,6358,2595,7273,13631,7365,13778
ܺ,ZhouHeZhen,511324123,4205,1025,3348,2375,6383,3309,1542,3351,6660,3424,6772
,YangQiaoZhen,511324124,9053,1568,6380,4177,13315,6367,2753,6994,13361,6994,13374
ƽ,BaoPingZhen,511324125,12970,2039,9117,5847,18223,9117,3690,9582,18699,9582,18699
,WenXingZhen,511324126,10100,1685,7055,4823,14107,7055,2646,7376,14431,7376,14431
˫ʤ,ShuangShengZhen,511324127,14003,2054,9348,5628,19314,9270,3556,10123,19393,10265,19613
,DuMenZhen,511324128,13179,2308,9158,5661,18110,9114,2928,9211,18325,9257,18415
ľ,LaoMuXiang,511324200,7141,1319,4891,2868,10166,4874,1812,5358,10232,5381,10272
,MengYaXiang,511324201,6693,1077,4595,2677,9431,4584,1769,4930,9514,4944,9539
ͭ,TongGuXiang,511324202,12038,2010,8587,4987,17237,8587,3432,8893,17480,8893,17480
а,ZhongBaXiang,511324205,7605,1432,5155,3503,10706,5155,1924,5806,10961,5806,10961
˫,ShuangPanXiang,511324206,5958,1170,4353,2826,8623,4340,1744,4452,8792,4519,8872
,FengYiXiang,511324207,7971,1449,5503,3593,11355,5408,2209,5974,11382,6126,11629
˫,ShuangQingXiang,511324208,6800,1342,4861,3076,10015,4861,2009,5290,10151,5290,10151
,DaFengXiang,511324209,7790,1368,5638,3339,11121,5638,2258,5778,11416,5778,11416
,FuLinXiang,511324210,5641,1111,4212,2598,8244,4212,1816,4356,8568,4356,8568
,LaiYiXiang,511324212,6562,1262,4563,2839,9253,4556,1644,4894,9450,4905,9468
Ȫ,BiQuanXiang,511324213,6685,1030,4622,2652,9267,4612,1702,4752,9364,4795,9417
,LeXingXiang,511324214,5880,998,4055,2523,8232,4054,1615,4432,8486,4438,8493
ʯ,ShiFoXiang,511324216,7709,1331,5323,3524,11077,5323,2115,5832,11155,5832,11155
˼,SiDeXiang,511324217,5141,927,3488,2486,7330,3488,1373,3953,7441,3953,7441
,QiuYaXiang,511324218,4587,800,3072,1664,6450,3047,1210,3472,6519,3525,6597
,DaLuoXiang,511324219,4983,844,3337,1847,7038,3320,1312,3755,7075,3802,7139
,YiMenXiang,511324220,6547,1060,4384,2525,9142,4384,1742,4965,9349,4965,9349
,HeZuoXiang,511324221,4175,699,2843,1533,5963,2801,1198,3151,5952,3229,6072
,LongQiaoXiang,511324225,7008,1082,4657,2846,9494,4653,1676,5079,9732,5109,9766
,BanQiaoXiang,511324226,6206,1257,4377,2799,8851,4344,1666,4699,9043,4752,9129
,YongGuangXiang,511324227,6483,1169,4316,3022,8794,4316,1564,4900,9216,4900,9216
,JuGuangXiang,511324228,4316,821,2946,2153,5975,2946,1084,3273,6219,3275,6221
,JiuLongXiang,511324229,5817,1243,4106,2421,8305,4063,1475,4326,8389,4429,8535
Ž,BaJiaoXiang,511324230,5460,1253,3890,2335,7814,3872,1419,4204,8076,4242,8132
,DengTaXiang,511324231,6144,1384,4539,2720,9127,4443,1789,4604,9047,4778,9317
,WuPengXiang,511324232,6961,1156,4769,2806,10033,4759,2031,5343,10102,5379,10148
,ChaiJingXiang,511324241,13112,2252,9190,5205,18724,9188,3617,9769,18957,9791,18981
,JinChengZhen,511325100,80383,8183,49908,33929,79293,46464,13759,48794,95258,52417,102325
̫ƽ,TaiPingZhen,511325101,8813,1820,5980,4751,12010,5666,1629,5932,11598,6282,12262
ȫ,DaQuanZhen,511325102,7303,1576,5407,3524,10580,5405,1870,5336,10741,5342,10749
,XianLinZhen,511325103,7118,1575,4962,3475,10057,4962,1564,5285,10247,5295,10257
¥,GuLouZhen,511325104,9680,1887,6310,4609,13266,5913,1985,6341,12254,7242,13552
,YiXingZhen,511325105,12714,2539,8780,5933,17550,8105,2726,8368,16473,9199,17979
,GuanWenZhen,511325106,5427,1674,4203,3500,8234,4203,1220,4118,8321,4118,8321
,FengMingZhen,511325107,6957,1515,4718,3899,9562,4717,1249,5000,9717,5003,9721
ʨ,QingShiZhen,511325108,9033,2030,6353,4898,12421,6218,1676,6217,12435,6386,12739
,HuaiShuZhen,511325109,7756,1877,5398,3383,10416,5394,1407,5627,11021,5642,11040
,MingLongZhen,511325110,9044,1979,6173,3831,12203,6134,1403,6132,12266,6253,12426
˫,ShuangFengZhen,511325111,11354,2357,8469,6627,15531,8369,2951,8092,16461,8193,16662
Ժ,GaoYuanZhen,511325112,8720,2149,6423,4069,12688,6228,1977,6209,12437,6423,12846
ʺ,RenHeZhen,511325113,8674,1963,6160,4595,12251,5829,1722,5896,11725,6199,12359
,DuoFuZhen,511325114,12294,2146,7591,5930,15387,6601,1748,7125,13726,8597,16188
,ChangLinXiang,511325202,15593,2699,10551,8450,19333,10367,2922,10404,20771,10663,21214
ռɽ,ZhanShanXiang,511325203,7825,1773,5381,4584,10872,5367,1389,5562,10929,5606,10987
,LianChiXiang,511325204,4757,1262,3328,3051,6872,3328,878,3569,6897,3569,6897
,HongQiaoXiang,511325205,4580,1099,3112,2445,6325,3112,734,3300,6412,3301,6413
Ȫ,JinQuanXiang,511325207,5419,1225,3782,2983,7470,3765,990,3767,7532,3852,7634
,HuaGuangXiang,511325208,5790,1218,3850,2877,8136,3841,1315,4422,8263,4473,8323
Դ,JinYuanXiang,511325209,6666,1295,4547,3064,9261,4484,1496,4792,9276,4910,9457
,DaiLinXiang,511325210,4802,1013,3114,1855,6635,2970,887,3324,6294,3588,6702
,LiQiaoXiang,511325211,4874,1253,3459,2830,7087,3418,1096,3685,7103,3764,7223
,ZhongLingXiang,511325212,5453,1349,4038,3316,7924,3882,1182,3714,7596,3946,7984
,XiNianXiang,511325213,5019,999,3515,2756,7024,3489,1310,3738,7227,3813,7328
,ZiYanXiang,511325214,6190,1204,4265,2887,8500,4071,1231,4131,8202,4360,8625
,FuAnXiang,511325215,3553,962,2627,1889,5252,2492,899,2565,5057,2787,5414
۷,GuanFengXiang,511325216,5363,1335,3803,3242,7553,3803,953,3848,7651,3848,7651
,QingLongXiang,511325217,5092,1159,3633,2234,7182,3626,999,3521,7147,3617,7250
˫,ShuangLuoXiang,511325218,4062,1051,2959,2350,5703,2959,882,3036,5995,3036,5995
,YiHeXiang,511325219,3955,903,2855,1850,5622,2853,838,2835,5688,2841,5696
,GuanYaXiang,511325220,6849,1381,4676,2951,9370,4673,1226,4771,9444,4780,9456
,ZhongNanXiang,511325221,3104,672,2269,1470,4357,2265,698,2200,4465,2205,4474
˫,ShuangJiangXiang,511325222,4315,1082,3046,2124,5937,2939,701,2913,5852,3052,6098
,FengHeXiang,511325223,4936,1207,3594,2448,7107,3420,1031,3426,6846,3580,7174
,DongDaiXiang,511325224,5632,1100,3804,2806,7750,3804,1126,4054,7858,4054,7858
ͬ,TongDeXiang,511325225,5330,1112,3846,2304,7479,3802,1190,3718,7520,3786,7632
,XiangLongXiang,511325226,5206,1441,3750,2492,7966,3749,1363,4259,8008,4260,8010
,CheLongXiang,511325227,9739,1738,6642,4038,13397,6642,2097,6932,13574,6932,13574
,FuJunXiang,511325228,4005,1067,2835,2052,5754,2826,806,3001,5827,3043,5878
̫,DongTaiXiang,511325229,7467,1811,5226,4025,10339,5162,1447,5424,10586,5499,10725
,YongQingXiang,511325230,5275,1154,3419,2709,7242,3419,865,3873,7292,3875,7294
ɽ,JinShanXiang,511325231,3881,914,2527,1920,5240,2527,559,2827,5354,2827,5354
ֵ,BaoNingJieDao,511381001,104459,12215,69561,46309,110407,65989,19599,62056,128045,66712,136273
ɳϪֵ,ShaXiJieDao,511381003,22525,2612,14422,10149,22675,14088,3966,13947,28035,14681,29103
ֵ,QiLiJieDao,511381004,21768,2582,14458,10304,26288,13768,3887,12837,26605,13779,28237
,JiangNanZhen,511381005,23210,4241,15525,13656,29807,15494,4123,15831,31325,16049,31574
,PengChengZhen,511381103,10284,1720,7265,4393,13943,7217,2336,6982,14199,7075,14340
˫,ShuangLongZhen,511381104,8079,1379,5329,3847,10320,5247,1350,5307,10554,5479,10808
,BaiYaZhen,511381105,22613,4336,15084,10332,29839,14141,4286,14794,28935,16151,31235
ɷ,FeiFengZhen,511381106,6838,1293,4809,3501,9182,4790,1261,4487,9277,4583,9392
˼,SiYiZhen,511381107,12772,1711,8706,5131,16913,8407,3153,8500,16907,8930,17636
ĳ,WenChengZhen,511381108,8294,1768,5699,5369,10925,5693,1214,5562,11255,5577,11276
,ErLongZhen,511381109,13501,3071,9133,6105,18002,7743,1921,7984,15727,9360,18493
ʯ̲,ShiTanZhen,511381110,7150,1563,5065,3589,9528,5028,1168,4744,9772,4816,9881
Ϲ,LaoGuanZhen,511381111,15663,2778,10370,7107,20142,9824,2439,9752,19576,10510,20880
Ȫ,LongQuanZhen,511381112,9067,1690,6092,3866,11781,6068,1429,6018,12086,6094,12186
ǧ,QianFoZhen,511381113,12507,2359,8689,5991,16530,8038,2269,7815,15853,8446,17135
,WangYaZhen,511381114,8933,2015,6575,5263,13056,6507,2380,6704,13211,6753,13328
Ϫ,HeXiZhen,511381115,13940,2600,9755,6160,17173,9072,3049,8934,18006,9834,19589
,MiaoGaoZhen,511381116,9553,2289,6704,4638,13175,6658,1717,6729,13387,6855,13559
ɽ,HongShanZhen,511381117,12821,2515,9072,5437,17579,8463,3078,8458,16921,9342,18414
ʯ,ShiLongZhen,511381118,8603,1863,6234,4056,12104,6136,1958,5998,12134,6190,12424
,BaoMaZhen,511381119,7658,1705,5561,3822,10900,5538,1926,5660,11198,5728,11289
ˮ,ShuiGuanZhen,511381120,15568,3261,11152,7191,21866,10636,3673,10630,21266,11350,22502
,JinYaZhen,511381121,12854,2544,8875,5318,16353,7853,2575,8026,15879,9098,17973
̨,YuTaiZhen,511381122,3189,885,2437,1823,4776,2390,930,2507,4897,2567,5004
,YaKouXiang,511381201,5006,1124,3490,2603,6855,3484,839,3441,6925,3479,6969
ƽ,ZhiPingXiang,511381202,4408,918,3103,2249,5907,3084,844,3005,6089,3067,6170
칬,TianGongXiang,511381208,3755,1025,2890,2139,5310,2833,988,2759,5592,2878,5768
,TianLinXiang,511381209,6121,1218,4500,2818,8591,4469,1532,4309,8778,4371,8871
,ZaoBiXiang,511381210,4652,980,3277,2131,6494,3234,1112,3381,6615,3467,6744
,BeiMenXiang,511381211,3911,852,2801,1881,5641,2783,971,2881,5664,2933,5734
¥,QiaoLouXiang,511381212,4679,796,3307,2217,6534,3278,1222,3319,6597,3390,6697
¥,HeLouXiang,511381213,5036,768,3467,2174,6865,3454,1244,3528,6982,3581,7048
ľ,MuLanXiang,511381215,4161,771,2977,1729,5838,2961,1111,3029,5990,3066,6043
,DongXingXiang,511381216,8449,1971,5995,4372,11598,5836,1344,5596,11432,5769,11764
Ȫ,QingQuanXiang,511381217,4274,821,2841,2024,5657,2831,705,2922,5753,2959,5800
,BoShuHuiZuXiang,511381219,3922,984,2826,2035,5129,2785,679,2667,5452,2759,5585
ˮ,LiangShuiXiang,511381221,8991,1967,6412,5212,12310,6364,1900,6341,12705,6446,12858
Ԫ,JieYuanXiang,511381224,4567,1048,3121,2314,6200,3121,682,3176,6297,3176,6297
ɽ,XiShanXiang,511381225,6321,1116,4321,2814,8284,4306,1033,4119,8425,4149,8470
ɽ,FangShanXiang,511381226,5268,1091,3703,2426,7169,3654,881,3448,7102,3537,7240
,JinZiXiang,511381232,7024,1591,5089,3729,9617,5044,1724,5166,10210,5250,10339
,SanMiaoXiang,511381233,3360,709,2388,1486,4682,2365,793,2436,4801,2474,4862
ռ,FengZhanXiang,511381234,6277,1164,4415,3094,8476,4405,1244,4264,8669,4270,8685
׷,HeFengXiang,511381235,4582,1014,3290,2307,6148,3249,965,3213,6462,3271,6561
,JinChengXiang,511381239,3837,1018,2792,2046,5399,2734,706,2673,5407,2769,5561
,WuMaXiang,511381241,10135,2302,7132,4916,13830,6984,1739,6921,13905,7044,14176
,ZhuZhenXiang,511381243,7091,1358,5146,3198,9788,4994,1820,4948,9942,5123,10269
̨,BaoTaiXiang,511381245,5883,1348,4299,2778,8575,4251,1458,4323,8574,4390,8689
,FuXingXiang,511381247,6199,1456,4651,3039,9107,4518,1549,4318,8836,4553,9204
ͨݽֵ´,TongHuiJieDaoBanShiChu,511402001,54940,4992,34146,23994,33656,32251,9074,30813,63064,34860,69006
ʯŽֵ´,DaShiQiaoJieDaoBanShiChu,511402002,56599,4861,36330,24379,39460,34451,9881,32982,67433,35011,71341
ֵ´,SuCiJieDaoBanShiChu,511402003,78838,9435,51831,29052,46900,48173,12059,44865,93038,48501,100332
,BaiMaZhen,511402100,11953,1884,7809,4848,15014,7693,1673,7548,15241,7701,15510
,XiangErZhen,511402101,8768,1578,5731,4414,10600,5700,1278,5774,11474,5893,11624
̫,TaiHeZhen,511402102,23924,4133,16060,11302,29716,15424,3678,15008,30432,15675,31735
,YueXingZhen,511402103,18177,3125,12094,8274,22629,12052,2845,11977,24029,12053,24147
,ShangYiZhen,511402104,29295,4919,19606,13873,38031,19580,4587,19170,38750,19195,38801
,DuoYueZhen,511402105,24786,4166,16341,10066,29980,15321,3659,15376,30697,16270,32611
ؼ,QinJiaZhen,511402106,23102,3969,15005,9780,29486,14890,3053,14923,29813,15119,30124
ʤ,WanShengZhen,511402107,18694,3465,12281,7637,22714,11477,2340,11359,22836,12218,24499
,ChongRenZhen,511402108,21163,3885,13712,9923,25833,13238,2549,13224,26462,13885,27597
˼,SiMengZhen,511402109,31128,4821,20140,13322,37755,18965,4075,18830,37795,19884,40024
,XiuWenZhen,511402110,30224,4989,19502,12992,37665,19087,3939,18838,37925,19650,39152
ɽ,SongJiangZhen,511402112,26078,4262,17083,10788,32014,16770,3742,16361,33131,16999,34082
,ChongLiZhen,511402113,26845,4658,17874,11837,34406,17827,4226,17719,35546,17855,35729
ţ,FuNiuZhen,511402114,19612,2849,12944,7710,22285,11111,3196,11338,22449,12713,25657
,YongShouZhen,511402115,30929,6745,22104,14251,40670,21058,5261,19703,40761,20831,42935
,SanSuXiang,511402204,20799,4073,14060,9324,27133,13935,2912,13569,27504,13724,27784
,GuangJiXiang,511402205,14092,2364,9073,5912,17934,9068,1906,9281,18349,9289,18362
,PanAoXiang,511402206,10291,2588,7032,5123,13735,6992,1383,7142,14134,7230,14262
,TuDiXiang,511402210,8763,1735,5999,4305,11569,5996,1353,5838,11834,5852,11851
ʢ,FuShengXiang,511402211,8521,1535,5824,4038,10994,5799,1618,5770,11569,5850,11674
,FuXingXiang,511402212,12708,2734,9198,6283,17503,9192,2644,8877,18069,8888,18086
,JinHuaXiang,511402213,9936,2005,6887,4586,13581,6887,2041,7092,13979,7095,13982
ʥ,LiuShengXiang,511402214,7698,1551,5466,3928,10728,5464,1697,5478,10942,5480,10946
Ĺ,WenGongZhen,511421102,22833,4113,15848,11807,30142,14437,4754,14379,28816,15852,31700
̼,HeJiaZhen,511421112,13950,2288,9860,8222,19015,9859,3682,10049,19908,10060,19920
,LongMaZhen,511421116,13785,2838,9817,7797,19857,9805,3404,10201,20006,10210,20027
,FangJiaZhen,511421117,13347,2791,9704,7053,18933,9702,3219,9633,19335,9653,19357
,WenLinZhen,511421123,135933,14864,91565,54098,128490,84265,28806,79960,164225,88038,179603
,DaHuaZhen,511421124,16440,3430,11889,8687,23231,11547,3867,11361,22908,11848,23737
߼,GaoJiaZhen,511421125,11194,2577,8386,6862,16366,8383,2902,8286,16669,8287,16673
ũ,ZhongNongZhen,511421126,8411,2129,6779,5036,12959,6766,2786,6518,13284,6547,13326
»,LuJiaZhen,511421127,16519,3910,12504,8371,23786,11692,4696,11839,23531,12621,25125
,BaoFeiZhen,511421128,15149,3496,11411,7756,21786,11310,4415,11497,22807,11649,23060
ü,ZhangJiaZhen,511421129,16030,4325,12491,9842,24412,12485,4419,12274,24759,12283,24774
Ⱥ,CiHangZhen,511421130,14834,4080,11619,8587,22478,11611,4248,11416,23027,11543,23162
,WangYangZhen,511421131,40599,5759,27208,21381,49322,26416,9492,27022,53438,28642,55850
,ZhongXiangZhen,511421132,22325,4102,15593,10698,28959,15026,5058,15392,30418,15892,31485
ʼ,ShiJianZhen,511421133,20270,4464,14582,10026,29266,14557,4944,15049,29606,15096,29678
,ManJingZhen,511421134,16230,3713,12407,9222,22858,12361,4865,12090,24451,12401,24808
,FuJiaZhen,511421135,26365,6079,20705,15108,37202,20026,7712,18887,38913,19451,40156
,LongZhengZhen,511421136,18058,3356,12711,9437,23198,12250,3811,12071,24321,12514,25225
̲,HeiLongTanZhen,511421137,24904,5031,16725,11940,33753,16612,4515,17356,33968,17725,34450
ˮ,QingShuiZhen,511421138,14478,2950,10163,7811,18175,9687,2641,9569,19256,9906,20069
Ӹ,ShiGaoZhen,511421139,19764,3185,12923,9953,25520,12835,3410,13367,26202,13436,26359
,BeiDouZhen,511421140,19963,4277,14750,10443,29564,14745,5668,15146,29891,15158,29908
ة,YuChengXiang,511421200,3609,1099,2695,1981,5505,2544,832,2608,5152,2845,5540
,QingGangXiang,511421203,7750,1729,5757,4206,11419,5757,2038,5759,11516,5760,11517
ŷ,GuFoXiang,511421209,6360,1700,4902,4111,9556,4886,1624,4752,9638,4782,9684
,BanYanXiang,511421210,6030,1754,4646,4072,8974,4646,1421,4555,9201,4559,9205
ʯ,ShiJuXiang,511421218,7861,1744,5783,3749,11302,5695,1851,5516,11211,5673,11456
ź,OuTangXiang,511421219,5509,1568,4453,3368,8487,4438,1652,4240,8678,4276,8729
,YuLongXiang,511421222,10112,2198,7543,4653,14618,7523,2626,7388,14911,7393,14936
,HeXingXiang,511421232,4601,1309,3672,2732,6856,3672,1294,3532,7204,3532,7204
ٽ,CuJinXiang,511421239,4264,1349,3338,2432,6609,3315,1119,3346,6661,3394,6732
Ѽ,YaChiXiang,511421251,6244,1080,4605,3036,9002,4602,1713,4416,9018,4432,9037
˫,ShuangBaoXiang,511421254,9472,2105,7083,5304,13804,7006,2639,7036,14042,7133,14216
ӿ,HeKouXiang,511421258,8389,1759,6157,3885,12321,6154,2254,6220,12374,6245,12402
,BanQiaoXiang,511421259,6083,1506,4600,3412,8999,4599,1681,4654,9253,4670,9270
Ԫͨ,YuanTongXiang,511421268,11049,2291,7911,5761,15735,7904,2536,7957,15861,7965,15876
,XiangJiaXiang,511421269,10227,1904,7429,5560,14550,7417,2661,7353,14770,7363,14792
,LiRenXiang,511421276,10953,1696,7277,4521,14284,7263,1826,7138,14401,7198,14475
ʢ,XingShengXiang,511421277,10440,1922,6726,4563,13622,6721,1626,7252,13973,7262,13988
׼,ZhaoJiaXiang,511421281,5042,1196,3724,2643,7228,3722,1249,3742,7464,3763,7487
,BaoMaXiang,511421287,13410,2977,9983,7490,19370,9914,3756,9935,19849,10160,20143
,ZhuJiaXiang,511421288,14188,3173,10354,7805,20706,10328,3694,10624,20952,10701,21055
,AoLingXiang,511421289,8806,1846,5732,4705,11864,5693,1555,6227,11920,6475,12207
,GuanSiXiang,511421290,16706,2896,11204,8285,22465,11204,3161,11559,22763,11559,22763
и,ZhongGangXiang,511421291,10005,2589,7670,7405,15343,7670,2931,7854,15524,7855,15525
,LongQiaoXiang,511421292,11546,2750,8854,6023,17563,8787,3594,8934,17721,9036,17890
,QuJiangXiang,511421293,10207,2671,7805,5803,15615,7568,2838,7664,15232,7911,15716
,ChengYanXiang,511421294,5716,1252,4434,3482,8735,4433,1857,4390,8823,4391,8825
л,XieAnXiang,511421295,6990,1928,5723,4276,11113,5721,2444,5614,11335,5639,11362
µ,XinDianXiang,511421296,8063,2415,6908,5592,13104,6761,2960,6225,12986,6530,13438
,TianEXiang,511421297,13804,2190,8926,6276,17911,8865,2963,9449,18314,10031,18957
ʶ,ShiJingXiang,511421298,8158,1751,6017,4443,11871,6016,2197,6079,12095,6089,12106
,FengLingXiang,511421299,8702,2658,6919,4696,13398,6802,2596,6911,13713,7037,13956
Ϳ,TuJiaXiang,511421300,7794,1747,5970,4315,11394,5840,2149,5505,11345,5720,11690
Ĺ,SiGongXiang,511421301,7881,2052,5789,4622,11348,5786,1904,6020,11806,6048,11837
ɷ,SongFengXiang,511421302,9761,1663,6549,4945,13116,6510,1852,6659,13169,6727,13276
ܼ,CaoJiaXiang,511421303,11263,2979,8760,6891,16891,8760,2898,8380,17140,8380,17140
,JingXianXiang,511421304,4981,1460,3687,2653,7256,3635,1088,3730,7365,3842,7529
ũ,NongWangXiang,511421305,13554,3697,10487,7221,20598,10474,3628,10343,20817,10392,20879
,HongFengXiang,511421306,8098,2025,5879,4444,11445,5879,1659,5900,11779,5903,11782
,QingLongZhen,511422101,23089,3764,14698,8745,26924,14112,3271,13767,27879,15426,30124
,GongYiZhen,511422103,14294,3066,9787,6606,19041,9763,2464,10005,19768,10037,19824
,GuanYinZhen,511422105,16059,3353,11047,7302,20552,10942,2652,10690,21632,11017,22064
Ϫ,PengXiZhen,511422107,26443,3068,16593,8643,20829,13387,3413,12607,25994,16331,32924
Ʒ,HuangFengZhen,511422108,9600,2038,6567,4720,12852,6560,1667,6725,13285,6738,13305
л,XieJiaZhen,511422110,15882,3318,10781,7421,20663,10722,2496,10704,21426,10915,21696
,MuMaZhen,511422111,10125,1822,6854,4506,13349,6839,1724,6789,13628,6817,13671
,FengMingZhen,511422112,53117,8615,35331,23883,51814,34478,8989,31857,66335,35390,70721
,JiangKouZhen,511422113,10672,2545,7132,4966,14293,7113,1486,7442,14555,7571,14703
ʤ,BaoShengXiang,511422205,7671,1828,5130,3705,10241,5118,1231,5505,10623,5600,10730
,YiHeXiang,511422211,8566,1793,5827,4019,11247,5827,1316,5848,11675,5848,11675
,WuYangXiang,511422212,10690,2354,7527,5165,14467,7513,1849,7358,14871,7366,14893
,JinJiangXiang,511422213,6594,1838,4708,3450,9149,4690,1127,4818,9508,4851,9559
ֹ,ZhiGeZhen,511423101,13490,2328,9086,5489,17089,9060,2127,8683,17743,8859,17945
,SanBaoZhen,511423102,9306,1974,6667,4407,12794,6636,1853,6379,13015,6466,13133
Ϫ,HuaXiZhen,511423108,11034,2119,7549,5578,14480,7534,1902,7494,15028,7506,15055
鴨,HongChuanZhen,511423112,57453,8683,38309,24832,61879,36010,9664,34735,70745,37491,75800
ƺ,YuPingZhen,511423113,22141,5330,16003,10981,30602,15866,3911,15031,30897,15379,31382
̲,CaoYuTanZhen,511423114,12153,2485,8412,5382,16312,8141,2257,8071,16212,8483,16895
б,ZhongBaoZhen,511423115,12555,2705,9311,5927,16116,8754,2440,7788,16542,8389,17700
,DongYueZhen,511423116,15828,3320,11003,7580,21328,10980,2699,10727,21707,10844,21847
,LiuJiangZhen,511423117,11994,2450,8342,5662,15732,8237,2279,8135,16372,8381,16723
,GaoMiaoZhen,511423118,11408,1960,7575,4808,14751,7481,2314,7801,15282,8107,15682
ɽ,WaWuShanZhen,511423119,10066,1838,7116,3998,13969,6865,2957,7128,13993,7745,14861
ɽ,ZhongShanXiang,511423200,9093,1742,6416,3885,12204,6399,1683,6048,12447,6102,12518
,JiangJunXiang,511423201,13036,2397,8754,5192,16611,8426,2364,8437,16863,9043,17797
,HanWangXiang,511423205,6489,1450,4494,2982,8935,4451,1174,4500,8951,4619,9113
Դ,TaoYuanXiang,511423212,2555,608,1844,1234,3569,1773,603,1835,3608,1922,3766
,RenMeiZhen,511424102,10066,2127,7186,4648,13701,7183,1897,6897,14080,6904,14090
,DanLengZhen,511424105,33197,4525,21817,13785,37600,20838,5056,19943,40781,20961,42778
,YangChangZhen,511424106,19867,3512,13297,8402,25670,13259,3217,13213,26472,13299,26596
˫,ShuangQiaoZhen,511424107,19279,3910,13619,8363,25785,13586,3461,12900,26486,13031,26650
ų,ZhangChangZhen,511424108,14998,3156,10313,6696,20180,10129,2521,10105,20234,10362,20675
ʯ,ShiQiaoXiang,511424200,2800,539,1852,1173,3629,1831,422,1886,3717,1909,3761
˳,ShunLongXiang,511424204,5197,1224,3728,2449,7174,3715,982,3654,7369,3675,7403
,HanYangZhen,511425102,5145,1449,3596,3125,7120,3585,738,3693,7278,3736,7332
Ӱ,HeBaZiZhen,511425105,4719,1263,3569,3012,6681,3531,1057,3411,6942,3470,7039
ϳ,NanChengZhen,511425106,13658,2630,9415,6202,14683,9157,2238,8801,17958,9111,18526
,QingChengZhen,511425107,27911,4261,19313,13692,26098,18277,4867,16764,35041,17726,37039
,RuiFengZhen,511425108,8079,2080,5559,4152,10884,5499,1157,5660,11159,5757,11316
,HeiLongZhen,511425109,17213,3692,11973,7961,22179,11892,2690,11429,23321,11622,23595
,XiLongZhen,511425110,16802,3461,11109,8000,21565,11075,2280,11105,22180,11434,22543
̨,GaoTaiXiang,511425205,6516,1600,4761,3473,9002,4758,1246,4598,9356,4601,9362
׹,BaiGuoXiang,511425217,12077,2961,8502,6581,16506,8480,2012,8486,16966,8548,17050
޲,LuoBoXiang,511425218,10423,2035,6763,4438,13263,6709,1299,6724,13433,6994,13757
ǽֵ´,BeiChengJieDaoBanShiChu,511502001,22390,3434,15336,10533,22862,15240,4046,14372,29612,14534,29870
ǽֵ´,DongChengJieDaoBanShiChu,511502002,16288,3009,11526,8088,15617,11390,2811,10443,21833,10582,22108
ϳǽֵ´,NanChengJieDaoBanShiChu,511502003,17442,2512,10535,7050,12798,10145,2483,9394,19539,11902,22437
ǽֵ´,XiChengJieDaoBanShiChu,511502004,42005,4263,27521,14497,24557,21098,5670,19876,40974,24417,51938
ϰֵ´,NanAnJieDaoBanShiChu,511502005,99105,9186,63897,41186,56601,58439,16901,56392,114831,61295,125192
�ֵ´,XiJiaoJieDaoBanShiChu,511502006,45563,5511,27538,19662,30891,26371,7760,26484,52855,31296,58834
ֵ´,AnFuJieDaoBanShiChu,511502007,71002,7410,44575,31146,51185,41383,12101,41604,82987,45938,90513
ɳֵ´,BaiShaWanJieDaoBanShiChu,511502008,26408,4055,17394,12960,24576,16745,4301,16417,33162,17370,34764
Գֵ´,ZhaoChangJieDaoBanShiChu,511502009,39305,3954,26203,16457,35688,26001,9104,25825,51826,26160,52363
ǽֵ´,XiangBiJieDaoBanShiChu,511502010,34971,3559,22473,15709,32675,22289,7796,23043,45332,23853,46326
Ϲ,NanGuangZhen,511502100,23490,2714,15188,9011,27901,14861,5409,15916,30777,16425,31613
ׯ,LiZhuangZhen,511502101,24072,3534,17242,10883,32094,16927,7213,17258,34185,17577,34819
˰,CaiBaZhen,511502102,22161,2541,14880,8724,27302,14620,5031,14511,29131,14853,29733
ƺ,JinPingZhen,511502104,13474,2356,9895,7037,18572,9883,4515,10415,20298,10450,20345
ߵ,GaoDianZhen,511502106,9496,1786,7212,4848,13876,7205,3618,7638,14843,7688,14900
ɳƺ,ShaPingZhen,511502107,21790,3082,15267,10216,28879,15187,6280,15540,30727,15885,31152
Ĳƺ,MouPingZhen,511502108,11784,2158,8402,5439,16739,8373,3553,9021,17394,9093,17495
,LiDuanZhen,511502109,13907,2374,9704,6408,19185,9696,4030,10561,20257,10607,20311
μ,SongJiaXiang,511502200,12355,2178,9376,6349,17873,9372,4726,9842,19214,9883,19259
,MingWeiXiang,511502201,8156,1362,5781,3990,11308,5776,2500,6210,11986,6237,12018
,LiangJiangXiang,511502202,9567,1399,6526,4276,12757,6503,2740,7022,13525,7180,13706
,QiuChangXiang,511502203,12226,2199,8937,6408,17364,8897,4152,9518,18415,9640,18577
˼,SiPoXiang,511502204,14476,2263,9743,6641,19293,9715,3582,10523,20238,10578,20321
ڳ,ZongChangXiang,511502205,12805,1824,8650,5805,16957,8641,3117,8995,17636,9096,17746
Ϫ,BaiXiZhen,511521100,66651,6696,44122,29047,61972,42103,14904,41535,83638,44129,88251
ϲ,XiJieZhen,511521101,20504,3203,14170,9630,28876,14112,6194,15633,29745,15731,29901
,GuanYinZhen,511521102,44296,7390,31746,19822,59109,29997,11920,30242,60239,31860,63606
Ὥ,HengJiangZhen,511521103,17444,2743,12072,7966,24637,11837,5460,13242,25079,13575,25647
,YongXingZhen,511521104,19812,3782,15222,10053,30261,15031,7369,15494,30525,15741,30963
׻,BaiHuaZhen,511521105,27916,5230,20844,14260,38994,20237,8428,20057,40294,20730,41574
,LiuJiaZhen,511521106,27673,4849,19363,13145,37396,18491,7361,19602,38093,20520,39883
Ϫ,NiXiZhen,511521107,20291,3543,14426,10441,28889,14419,5773,15113,29532,15181,29607
ާϪ,JueXiZhen,511521108,30163,4385,21393,14041,40910,20566,8979,21573,42139,22134,43527
,ShangZhouZhen,511521109,13684,2559,10964,6877,21294,10964,6016,11288,22252,11295,22259
߳,GaoChangZhen,511521110,20309,3118,14661,10326,28168,14594,6877,15581,30175,15643,30304
,AnBianZhen,511521111,17524,1914,10491,7944,17567,10145,3867,10711,20856,12814,23305
˫,ShuangLongZhen,511521112,29020,4229,21247,13243,42582,21179,10806,22671,43850,22808,44055
,LiChangZhen,511521113,21047,3508,15266,10143,30955,15189,6971,16180,31369,16260,31526
ʲ,HeShenZhen,511521114,14017,3256,10459,8186,20815,10459,4091,10905,21364,10905,21364
,GuLuoZhen,511521115,14007,3358,10845,8033,21121,10843,4439,10923,21766,10959,21804
̲,KongTanZhen,511521116,31132,5404,23300,15593,45833,23196,10589,23355,46551,23825,47125
,FuLongZhen,511521117,17425,2536,11996,6932,24726,11986,5308,13240,25226,13273,25269
Ű,GuBaiXiang,511521200,13381,2097,9578,6313,18991,9540,4031,9851,19391,9931,19509
,WangChangXiang,511521201,12084,2141,9002,6428,18034,9002,4160,9383,18385,9383,18385
˫,ShuangYiXiang,511521202,16820,2961,12170,7633,24558,12137,5401,12936,25073,13012,25182
¡,LongXingXiang,511521203,12550,2425,9145,6551,18416,9140,4056,9882,19022,9886,19031
,NiNanXiang,511521204,10004,1619,7359,5135,14390,7328,3266,7486,14814,7530,14889
,LongChiXiang,511521205,5952,1065,4144,2806,8546,4128,1955,4766,8894,4828,8972
հ,PuAnXiang,511521207,21022,3327,14557,9842,29335,14557,5692,15484,30041,15484,30041
,FengYiXiang,511521209,10656,1705,8192,5136,16171,8147,4713,8744,16891,8882,17074
Ϫ,NanXiZhen,511522100,71373,9072,48101,32041,72627,44736,15616,44544,89280,47960,96061
,LuoLongZhen,511522101,28638,4448,19699,13097,38674,19643,7526,20603,40246,20913,40612
,LiuJiaZhen,511522102,15092,2481,10803,7142,21095,10801,4613,11329,22130,11383,22186
,JiangNanZhen,511522103,12470,1824,8255,5724,17109,8255,3001,9040,17295,9040,17295
,DaGuanZhen,511522104,18096,3302,13871,9209,25686,13786,6682,14080,27866,14209,28080
,WangJiaZhen,511522105,10303,1535,7051,4142,14578,7039,2923,7646,14685,7710,14761
ɳ,HuangShaZhen,511522106,7801,1431,5691,3904,11249,5687,2452,5956,11643,5993,11684
,XianLinZhen,511522107,15838,3120,11766,7841,23408,11757,5523,12649,24406,12715,24481
,ChangXingZhen,511522108,13074,2230,9174,6072,18718,9167,4004,10069,19236,10134,19308
ʯ,PeiShiXiang,511522200,10989,1871,7825,5434,15740,7810,3495,8479,16289,8530,16355
,MaJiaXiang,511522201,6386,942,4249,2857,8679,4248,1766,4833,9081,4845,9094
ƺ,DaPingXiang,511522203,2846,546,2238,1572,4273,2233,1095,2200,4433,2249,4487
ʯ,ShiGuXiang,511522204,7117,1098,5009,3548,9612,4956,2066,5186,10142,5272,10281
ַ,LinFengXiang,511522205,4188,695,3035,1878,5974,3028,1386,3201,6229,3234,6269
,LiuBinXiang,511522206,10031,1744,7090,4818,14527,7090,3082,7767,14857,7767,14857
,JiangAnZhen,511523100,50237,6456,33904,21909,48627,31540,11083,31303,62843,33872,67776
,HongQiaoZhen,511523101,15783,2422,11254,7117,21039,11112,4793,11605,22717,11744,22998
ͩ,TongZiZhen,511523102,19529,3386,13980,9476,27666,13877,5882,14718,28595,14817,28797
,JingKouZhen,511523103,9093,2023,6354,5056,12858,6332,2463,7019,13351,7225,13579
,YiLeZhen,511523104,13269,2801,9649,7265,19245,9636,4178,10556,20192,10599,20248
,LiuGengZhen,511523105,11887,2395,9030,6138,17615,9025,4282,9501,18526,9534,18564
,DiPengZhen,511523106,13925,2694,10630,6909,19351,10461,4991,10782,21243,10980,21610
,WuKuangZhen,511523108,9845,1406,7140,3955,13440,6452,3558,6762,13214,7669,14809
ӭ,YingAnZhen,511523109,12834,2807,9939,7422,19362,9856,4757,10285,20141,10459,20398
Ϧɽ,XiJiaShanZhen,511523110,10848,1829,7577,4877,15240,7562,3107,8164,15726,8207,15784
ˮ,ShuiQingZhen,511523111,8637,1421,6054,4314,11783,6049,2611,6562,12611,6615,12669
,TieQingZhen,511523112,16304,3291,11733,8104,23656,11633,4857,12574,24207,12719,24452
ɽ,SiMianShanZhen,511523113,19805,3976,14437,10319,27960,14036,6199,15041,29077,15543,29980
,DaJingZhen,511523114,18245,2605,12896,7764,25521,12889,5752,13690,26579,13706,26602
,DaMiaoXiang,511523200,6794,1428,5162,3595,10174,5114,2572,5546,10660,5632,10794
,PanLongXiang,511523203,10498,2073,7915,5666,15655,7887,3912,8543,16430,8568,16483
,YangChunXiang,511523204,15506,2684,10749,7506,21534,10584,4316,11252,21836,11757,22506
ʺ,RenHeXiang,511523205,7712,1503,5440,4013,11710,5431,2565,6337,11768,6340,11780
,ChangNingZhen,511524100,58448,7696,40059,25989,63288,38211,15104,39023,77234,41189,81248
÷,MeiDongZhen,511524101,10441,2299,7922,6370,15786,7921,4198,9015,16936,9016,16938
˫,ShuangHeZhen,511524102,13466,2482,9381,6719,18812,9381,3858,10424,19805,10425,19806
ϵ,DongDiZhen,511524103,11574,1796,7915,5541,15178,7885,3099,8516,16401,8554,16469
̲,HuaTanZhen,511524104,10263,1906,7732,5494,14976,7727,3888,8305,16032,8325,16057
,ZhuHaiZhen,511524105,17847,2805,12597,8824,24574,12549,5238,13209,25758,13293,25890
,LaoWengZhen,511524106,12891,2542,9312,7990,19241,9307,4411,10526,19833,10532,19844
ź,GuHeZhen,511524107,9496,1740,6644,4961,13437,6644,2725,7317,13961,7317,13961
³,XiaChangZhen,511524108,13944,2640,10051,7293,19504,9932,4540,10964,20896,11073,21124
ͷ,LongTouZhen,511524110,12530,2162,8717,6823,17515,8683,3768,9631,18314,9743,18460
ͭ,TongLuoXiang,511524200,5754,1237,4244,3285,8367,4244,1945,4692,8936,4692,8936
ƺ,TaoPingXiang,511524201,6191,1006,4337,3080,8966,4325,2018,4851,9176,4878,9215
ͭ,TongGuXiang,511524203,8315,1242,5807,3831,11482,5802,2579,6302,12104,6329,12136
,JingJiangXiang,511524204,7839,1501,5664,4188,11402,5659,2693,6343,12002,6369,12033
Ԫ,SanYuanXiang,511524205,6804,1510,5369,4258,10498,5366,2738,5649,11015,5683,11052
,KaiFoXiang,511524206,7942,1408,5614,4068,11206,5609,2574,6254,11863,6310,11924
,FuXingXiang,511524207,6409,1411,4521,3385,9695,4491,2317,5514,10005,5616,10137
÷,MeiBaiXiang,511524208,9455,1957,7066,5121,13624,7063,3330,7672,14735,7676,14742
Ľ,WenJiangZhen,511525100,47832,7305,33818,21588,63778,33742,13296,34449,68191,34615,68433
,QingFuZhen,511525101,41016,4903,26648,15467,46806,24921,10731,25559,50480,30002,56650
ɳ,ShaHeZhen,511525102,26776,3990,18873,12331,37418,18865,8280,20086,38951,20173,39046
,JiaLeZhen,511525103,8766,1576,6726,4311,12999,6709,3386,6928,13637,7002,13728
,DaWoZhen,511525104,13613,2577,9860,6599,20216,9853,4543,10799,20652,10873,20733
޳,LuoChangZhen,511525105,17432,2407,12765,8527,25244,12759,6330,13376,26135,13404,26169
,JiaoCunZhen,511525106,14917,2799,11557,7090,22734,11527,6113,12212,23739,12272,23829
ɾ,KeJiuZhen,511525107,9303,1598,7129,4448,14242,7124,3589,7302,14426,7361,14490
,LaiFuZhen,511525108,12767,2169,9198,6732,14086,9044,3816,9402,18446,9554,18752
½,YueJiangZhen,511525109,17574,2711,12182,7878,24175,12137,5163,12774,24911,13266,25448
ʤ,ShengTianZhen,511525110,12775,2184,9131,6012,18739,9128,4234,10045,19173,10062,19193
,FuXingZhen,511525111,9013,1460,6552,4086,13233,6542,3109,6971,13513,7030,13582
̲,ZanTanXiang,511525203,2041,381,1576,1099,2972,1575,752,1592,3167,1598,3174
,YangTianXiang,511525204,6817,1133,5346,3060,10180,5318,2914,5456,10774,5518,10864
,LuoRunXiang,511525205,11661,1760,8270,5180,16586,8268,3494,8603,16871,8645,16915
Ϫ,YingXiXiang,511525206,4855,1081,3643,2557,7291,3617,1642,3884,7501,3935,7578
,QingLingXiang,511525207,5919,1334,4681,3368,9383,4680,2341,4895,9575,4913,9594
˫,ShuangHeXiang,511525208,6651,1088,4874,3334,9574,4872,2198,5055,9927,5063,9937
,SiLieXiang,511525210,8550,1491,6214,4056,12424,6214,2967,6791,13005,6794,13008
Ȫ,GongQuanZhen,511526100,26881,3845,18452,13398,31144,18245,7131,18967,37212,19405,37857
Ѳ,XunChangZhen,511526101,86877,11120,56534,37958,96596,54639,20667,55023,109662,62130,118664
Т,XiaoErZhen,511526102,19326,2979,13088,7950,24683,12883,5457,13629,26512,14674,27762
׶,DiDongZhen,511526103,17954,2736,12290,7246,22769,12256,5374,13629,25885,13774,26064
,ShangLuoZhen,511526104,17130,3163,12403,7430,23208,12369,5580,13378,25747,13470,25873
,LuoBiaoZhen,511526105,15934,2639,12288,7115,22604,12258,6742,12911,25169,13027,25315
庥,LuoHaiZhen,511526106,12231,1547,8462,4703,16121,8433,4275,9522,17955,9591,18053
,WangJiaZhen,511526107,10840,1744,8784,4827,15028,8771,5294,9040,17811,9094,17878
,HengFengXiang,511526200,6355,1150,4529,2797,8730,4502,1921,4826,9328,4897,9426
̲,MuTanXiang,511526202,6898,1425,5173,3159,9816,5112,2482,5496,10608,5632,10805
,RenYiXiang,511526203,5711,1175,4252,2757,8300,4225,2021,4599,8824,4655,8907
,YuHeMiaoZuXiang,511526205,3195,525,2270,1301,4311,2247,1126,2541,4788,2576,4846
,XiaLuoXiang,511526207,10232,1951,7060,4407,13790,7060,2820,7943,15003,7943,15003
޶,LuoDuMiaoZuXiang,511526209,7775,1334,5654,3247,11133,5579,2841,6181,11760,6296,11950
Ӫ,CaoYingXiang,511526210,6154,1075,4285,2507,8326,4251,1995,4872,9123,4939,9224
ʯ,ShiBeiXiang,511526211,5101,939,3793,2336,7062,3777,1778,3998,7775,4025,7818
۶,GuanDouMiaoZuXiang,511526212,2818,446,2063,1241,3728,2052,1089,2266,4318,2290,4353
,JunLianZhen,511527100,54041,7642,40289,24296,70578,39482,19025,39607,79089,40419,80708
ڴ,TengDaZhen,511527101,12688,2255,9727,5907,18628,9725,5407,10597,20322,10623,20350
Ѳ˾,XunSiZhen,511527102,27420,3644,19695,11730,34662,19522,10056,20684,40206,21425,41120
˫,ShuangTengZhen,511527103,9638,1634,7722,4455,14919,7717,4755,8288,16005,8305,16027
尮,MuAiZhen,511527104,18830,2823,13973,8029,26288,13738,7439,14875,28613,15119,29092
ά,WeiXinZhen,511527105,12483,2136,9189,5464,17950,9163,5157,10518,19681,10587,19776
,ZhenZhouZhen,511527107,9183,1526,6970,4210,13605,6957,3642,7351,14308,7381,14351
,HaoBaZhen,511527108,9331,1373,6817,3956,12670,6806,4002,7862,14668,7889,14706
ѩɽ,DaXueShanZhen,511527109,10472,1807,8339,5238,15411,8326,4940,8852,17178,8880,17219
,WuDeXiang,511527200,14568,2194,10885,5806,21403,10881,6127,11949,22830,12004,22889
,TangBaXiang,511527202,3741,691,3209,1870,6022,3201,1984,3187,6388,3207,6416
,LongZhenXiang,511527203,4142,816,3265,1990,6334,3261,2086,3762,7023,3779,7044
ȸ,KongQueXiang,511527204,3430,744,2904,1719,5221,2892,1954,3195,6087,3224,6128
,LeYiXiang,511527205,7144,1258,5261,3030,10393,5258,2868,5974,11232,6009,11270
߿,GaoKanXiang,511527206,2831,562,2219,1470,4523,2215,1421,2575,4790,2595,4814
,TuanLinMiaoZuXiang,511527208,2865,521,2154,1419,4184,2136,1357,2541,4677,2589,4743
,LianHeMiaoZuXiang,511527209,4426,608,3415,1942,5989,3408,2317,3910,7318,3936,7351
ƺ,GaoPingMiaoZuXiang,511527210,3187,505,2377,1504,4400,2357,1357,2623,4980,2672,5049
,GuSongZhen,511528100,59581,8121,42939,25903,73484,41598,20180,43204,84802,44943,87882
kɽ,BoWangShanZhen,511528101,27009,4591,20638,12546,40324,20411,11535,22169,42580,22497,43135
,GongLeZhen,511528103,18443,3331,14923,10129,29682,14885,9183,15902,30787,16034,30957
,LianHuaZhen,511528105,11194,2285,8990,6195,18143,8896,5564,9869,18765,10053,19043
˿,JiuSiChengZhen,511528107,15291,2861,11179,6686,22240,11166,4946,11830,22996,11919,23098
ʯ,ShiHaiZhen,511528108,9225,1557,6880,4232,13336,6822,3716,7534,14356,7618,14498
̫ƽ,TaiPingZhen,511528109,12332,2020,9656,6350,18655,9650,5950,10627,20277,10646,20302
ܼ,ZhouJiaZhen,511528110,6240,990,4432,2572,8397,4386,2274,4848,9234,5072,9504
,DaBaMiaoZuXiang,511528200,15384,2721,11645,7087,23304,11631,6462,12884,24515,12922,24567
ع,YuXiuMiaoZuXiang,511528201,3502,748,2520,1592,5129,2513,1305,3020,5533,3035,5555
,YuPingXiang,511528202,5244,952,3985,2552,7503,3958,2038,4236,8194,4249,8234
,DaHeMiaoZuXiang,511528205,20261,3512,14905,10191,30445,14903,8211,17073,31976,17079,31984
,QiLinMiaoZuXiang,511528206,15104,2617,11569,7039,23117,11557,6411,12525,24082,12563,24132
ɷ,XianFengMiaoZuXiang,511528207,7601,1238,5273,3321,10308,5237,2899,6104,11341,6465,11738
,WuXingXiang,511528208,13231,2565,10756,7325,21036,10732,6741,11743,22475,11781,22537
,JinPingZhen,511529100,27307,3528,18813,10493,34207,18263,6801,18286,36549,18823,37636
,XinShiZhen,511529101,16901,2363,11914,7133,22585,11819,5190,12443,24262,12540,24454
ж,ZhongDouZhen,511529102,13619,2595,10398,6672,20403,10397,4979,10794,21191,10795,21193
,LongHuaZhen,511529103,11399,1966,8274,5131,15568,8271,4025,9069,17340,9116,17390
,DaChengZhen,511529104,12256,1885,8553,5544,16028,8543,3760,9259,17802,9348,17901
,FuYanZhen,511529105,7809,1121,5523,3395,10676,5515,2538,5901,11416,5945,11468
,FuRongZhen,511529106,7205,1138,5224,3151,9666,5141,2390,5330,10471,5509,10733
°,XinAnZhen,511529107,12887,1944,9548,5626,18123,9547,4616,9897,19444,9899,19447
¥,LouDongXiang,511529202,7419,876,5227,3082,10364,5225,2430,5491,10716,5498,10725
Ѽ,YaChiXiang,511529203,7998,1352,5705,3635,11094,5648,2673,6210,11858,6318,12023
Ϫ,LongXiXiang,511529204,3883,761,2928,1857,5478,2926,1560,3254,6180,3276,6204
̫ƽ,TaiPingXiang,511529205,7430,1333,5809,3403,11367,5676,2910,5665,11341,5864,11673
Ϫ,XiaXiXiang,511529208,5311,761,3972,2300,7036,3944,2024,4095,8039,4124,8096
,PingBianYiZuXiang,511529210,4652,511,3609,2043,6160,3600,2290,3810,7410,3844,7453
ƽ,QingPingYiZuXiang,511529211,4748,597,3683,1872,6804,3655,2188,3811,7466,3850,7533
·,XinFaXiang,511529212,17653,2163,12675,7206,23686,12310,6006,12514,24824,13147,25822
Ũ䧽ֵ´,NongHuiJieDaoBanShiChu,511602001,27524,2932,18099,9183,19385,13487,4707,12474,25961,17064,35163
ֵ´,BeiChenJieDaoBanShiChu,511602002,37362,3952,26659,17551,41281,26650,10929,25505,52155,25584,52243
ֵ´,KuiGeJieDaoBanShiChu,511602003,4798,722,3525,2346,6151,3428,1352,3203,6631,3347,6872
㸣ֵ´,GuangFuJieDaoBanShiChu,511602004,52787,4380,35757,21548,53104,34569,13332,33230,67799,34742,70499
ʢֵ´,WanShengJieDaoBanShiChu,511602005,31772,2205,20963,13490,33068,19332,7627,19071,38403,20641,41604
Žֵ´,ZhongQiaoJieDaoBanShiChu,511602006,15049,1180,10597,5010,13016,7585,3146,7335,14920,8778,19375
ɽ,ZaoShanZhen,511602100,14453,2602,10538,7392,18390,9828,4148,9693,19521,10665,21203
ʢ,GuanShengZhen,511602101,3287,924,2659,2129,5106,2658,1192,2710,5368,2744,5403
Э,XieXingZhen,511602102,17862,3159,13579,9736,25105,13313,5988,13045,26358,13430,27009
ŨϪ,NongXiZhen,511602103,7407,1964,5915,4461,11554,5915,2554,5999,11914,6010,11925
,YueLaiZhen,511602104,11746,2737,9457,6894,18290,9451,4453,9444,18895,9479,18936
ƽ,XingPingZhen,511602105,7524,1888,5995,4401,11866,5979,2661,6033,12012,6078,12073
,JingHeZhen,511602106,9480,2653,7989,5876,15226,7970,3819,7908,15878,7963,15952
,HuaQiaoZhen,511602107,15011,3191,11743,8019,20109,11659,5130,11484,23143,11589,23332
̨,LongTaiZhen,511602108,17945,4332,14086,10285,27916,14078,6459,14611,28689,14650,28736
ФϪ,XiaoXiZhen,511602109,15209,3878,11939,9380,24076,11920,5501,12536,24456,12649,24588
,HengShengZhen,511602110,14836,3219,11391,8417,21828,11139,4937,11389,22528,11601,22992
ʯ,ShiSunZhen,511602111,11845,3941,10825,9261,20270,10679,5559,10337,21016,10520,21345
,BaiShiZhen,511602112,7805,2505,7345,6252,13556,7323,4108,7024,14347,7073,14418
,DaAnZhen,511602113,6898,1766,5685,4507,10721,5685,2766,5745,11430,5745,11430
۸,GuanGeZhen,511602114,11950,2794,9856,6792,18714,9849,5419,10233,20082,10307,20163
,GuangXingZhen,511602115,3539,1093,3238,2903,6128,3234,1919,3307,6541,3313,6551
ǰ,QianFengZhen,511602116,21244,3226,15729,10644,25701,15488,7347,15148,30636,16088,31817
,GuiXingZhen,511602117,9800,1811,7129,5400,13838,7106,3579,7882,14988,8061,15190
,DaiShiZhen,511602118,31831,6786,26299,18535,44085,24931,12497,23463,48394,24815,51114
,GuanTangZhen,511602119,14914,3914,12687,9286,23308,12668,5978,12069,24737,12119,24806
,HuAnZhen,511602120,8017,2150,6624,4974,12657,6609,3104,6592,13201,6647,13271
ʯ,ChuanShiXiang,511602200,4063,1039,3140,2382,6106,3132,1341,3294,6426,3303,6443
,GuangMenXiang,511602201,5875,1595,4661,3652,9036,4660,1796,4604,9264,4605,9266
,GuangLuoXiang,511602202,5761,1340,4548,3139,8799,4542,1929,4469,9011,4482,9030
ƺ,FangPingXiang,511602203,9336,2235,7457,5500,14462,7452,3435,7526,14978,7549,15006
,HuaLongXiang,511602204,5219,1543,4600,3494,8496,4594,2196,4272,8866,4358,8958
,DaLongXiang,511602205,5363,1634,4761,4028,9214,4761,2434,4670,9431,4670,9431
,ChongWangXiang,511602206,3764,1105,3257,2566,6302,3253,1636,3238,6491,3248,6505
,LongAnXiang,511602207,6331,1345,4388,3031,9063,4388,1540,4828,9216,4828,9216
,PengJiaXiang,511602208,5828,1310,4481,3086,8730,4475,1960,4582,9057,4617,9098
ƺ,YangPingXiang,511602209,5321,1337,4381,3143,8612,4370,2145,4405,8775,4422,8803
֣ɽ,ZhengShanXiang,511602210,4238,1029,3487,2709,6671,3485,1722,3500,6985,3502,6989
,PuLianXiang,511602211,4168,1057,3474,2396,6570,3474,1645,3395,6869,3396,6870
,DaYouXiang,511602212,4087,1244,3672,2715,6672,3672,1866,3519,7191,3525,7197
,XiaoHeXiang,511602213,5738,1537,4770,3573,9360,4768,2279,4765,9533,4784,9554
,DongYueXiang,511602214,7166,1924,5866,4701,11725,5862,2952,6162,12024,6176,12042
Ϫ,SuXiXiang,511602215,2826,1055,2515,2220,4857,2483,1210,2542,5025,2576,5091
,BaiMaXiang,511602216,6379,1508,5157,3858,9974,5157,2512,5242,10399,5242,10399
,GuangHuiXiang,511602217,4862,1227,3859,2914,7646,3832,2257,4215,8047,4487,8346
̲,LongTanXiang,511602218,5278,1440,4621,3311,9103,4594,2775,4775,9369,4872,9493
С,XiaoJingXiang,511602219,9651,2098,7269,5623,14121,7237,4023,8179,15416,8503,15772
,XinQiaoXiang,511602220,9861,1769,7762,5663,14937,7748,3860,7676,15424,7728,15490
,HuChengXiang,511602222,6016,2241,5744,4396,10621,5743,2893,5393,11136,5406,11150
,JiuLongZhen,511621100,115981,14598,81170,53331,130285,77418,28784,74731,152149,78193,159363
԰,HuaYuanZhen,511621101,21986,3178,15134,11199,30219,15118,5559,15566,30684,15589,30723
ƺ̲,PingTanZhen,511621102,16377,3398,12919,8405,25007,12875,5856,12666,25541,12712,25631
,LongKongZhen,511621103,10341,2422,7972,6048,15808,7972,3477,8267,16239,8268,16240
ԣ,ZhenYuZhen,511621104,6991,1381,5328,3678,10443,5268,2281,5250,10518,5325,10653
,BaiMiaoZhen,511621105,17079,3864,13411,9205,25898,13336,5726,13191,26527,13258,26669
Ϫ,YouXiZhen,511621106,11771,2593,9046,6493,16529,9027,3893,9085,18112,9211,18257
ͬ,TongXingZhen,511621107,5272,1254,4117,3149,8042,4047,1739,4009,8056,4148,8265
¡,XingLongZhen,511621108,9579,2413,7483,5720,14879,7331,3428,7579,14910,7937,15420
Ϫ,QinXiZhen,511621109,7746,1729,5908,3991,11876,5908,2786,6290,12198,6353,12261
,GuXianZhen,511621110,18986,3824,15082,10597,25656,14591,6719,13930,28521,14447,29529
,GouJiaoZhen,511621111,21096,4809,17003,12751,32684,16910,8118,16805,33715,17020,34023
ƽ,TianPingZhen,511621112,11721,3081,9783,7099,18867,9774,4675,9647,19421,9694,19477
ʯ,ShiYaZhen,511621113,17055,3871,13840,9261,25278,13266,6164,12576,25842,13250,27090
Ǽ,QiaoJiaZhen,511621114,12644,2976,10240,6828,19747,10165,4408,9622,19787,9788,20028
޶,LuoDuZhen,511621115,14930,2309,11530,7901,19481,10554,5105,9916,20470,10814,22344
ԣ,YuMinZhen,511621116,14052,3314,11629,8214,22272,11601,5759,11439,23040,11496,23125
к,ZhongHeZhen,511621117,12747,2824,10569,7162,19831,10560,5167,10044,20604,10169,20738
³,XinChangZhen,511621118,12336,2977,9593,7170,19126,9590,4025,9710,19300,9745,19338
հ,PuAnZhen,511621119,10046,2811,8648,6282,16350,8553,4254,8259,16812,8463,17111
,SaiLongZhen,511621120,5704,1757,5022,3752,9452,4979,2496,4815,9794,4935,9957
Ϫ,LinXiZhen,511621121,8182,1819,6845,4485,12892,6841,3449,6590,13431,6605,13450
,ZhaoYangXiang,511621200,7259,1317,5492,3517,10740,5489,2357,5387,10876,5441,10933
,BeiChengXiang,511621201,4129,1104,3555,2434,6455,3549,1599,3267,6816,3277,6832
,ZhenLongXiang,511621202,5015,1148,3873,2903,7621,3860,1569,3824,7684,3859,7732
,ZongBaXiang,511621203,10218,2096,7702,4968,15334,7670,3286,7813,15483,7898,15600
¥,PaiLouXiang,511621205,5701,1610,4695,3457,9216,4695,2094,4710,9405,4710,9405
,XiBanXiang,511621206,8696,2149,6680,4951,13538,6680,2822,6987,13667,6987,13667
,JiaLingXiang,511621207,4469,1095,3568,2547,7024,3564,1669,3630,7194,3665,7233
ʯ,ShiGuXiang,511621208,4851,1093,3812,2883,7540,3811,1679,3811,7622,3811,7623
ƽ,PingAnXiang,511621209,3323,892,2643,2019,5073,2643,1122,2694,5337,2694,5337
,KongLongXiang,511621210,3975,1107,3241,2630,6439,3241,1510,3351,6592,3351,6592
Ž,TuanJieXiang,511621211,2057,699,1690,1319,3319,1677,800,1766,3443,1866,3556
,HuangLongXiang,511621212,2526,810,2141,1659,4160,2139,972,2149,4288,2167,4308
˫۳,ShuangYanXiang,511621213,3504,1052,3119,2226,5669,3119,1430,2860,5979,2867,5986
,DongBanXiang,511621214,2534,851,2361,1849,4447,2357,1184,2168,4525,2208,4569
,ChangTianXiang,511621215,4306,962,3348,2130,6606,3285,1367,3196,6481,3287,6635
,YuFengXiang,511621216,4316,1189,3660,2555,7098,3594,1756,3483,7077,3601,7261
ʯ,DaShiXiang,511621218,6320,1374,4763,3138,9408,4763,1873,4801,9564,4804,9567
,HuaBanXiang,511621219,5954,1415,4631,3240,9482,4631,2164,4901,9532,4902,9533
,DaFoXiang,511621220,6074,1796,5423,4040,10308,5323,3021,5310,10633,5468,10891
븣,QiFuXiang,511621222,10113,2271,8038,5425,15359,8012,3519,7795,15807,7865,15903
,FuLongXiang,511621223,19101,3710,14770,9709,29396,14770,6973,15014,29784,15014,29784
ؿ,YanKouZhen,511622100,78450,10933,54789,36893,90591,53640,19199,52472,106112,53793,108582
,ZhongXinZhen,511622101,18213,4274,13754,9796,25440,12938,4809,12853,25791,13542,27296
,LieMianZhen,511622102,21274,4304,16713,10640,26199,15696,6796,14854,30550,15661,32374
,FeiLongZhen,511622103,13197,2378,9710,6717,18367,9595,3677,9419,19014,9542,19252
,LeShanZhen,511622104,12067,2687,9557,6870,17888,9186,4231,9029,18215,9428,18985
,WanShanZhen,511622105,10695,2065,8350,5615,15600,7838,3433,7360,15198,7843,16193
Ů,LongNvZhen,511622106,16261,3975,12686,8847,24772,12683,4854,12388,25071,12404,25090
Ϫ,SanXiZhen,511622107,10069,2282,7847,5641,15527,7847,3266,7770,15617,7770,15617
,SaiMaZhen,511622108,16800,3444,12497,8526,24436,12441,4738,12349,24790,12485,24982
ʤ,ShengLiZhen,511622109,21139,3438,14207,7434,28995,14148,5067,15300,29448,15437,29644
ţ,JinNiuZhen,511622110,9535,2353,7629,5721,14695,7618,3137,7323,14941,7396,15025
ƽ,QingPingZhen,511622111,8370,2246,6808,4875,13077,6794,2692,6442,13236,6500,13308
,JieZiZhen,511622112,10248,2120,7563,7308,15184,7563,3061,7864,15427,7866,15429
¡,WanLongZhen,511622113,9595,2099,7562,6545,14590,7561,3289,7408,14969,7421,14983
,LiAnZhen,511622114,6603,1424,5090,3357,9988,5090,2028,4965,10055,4965,10055
,HuaFengZhen,511622115,12886,2631,9617,7418,18965,9526,3864,9593,19119,9764,19381
,MingZhongXiang,511622200,8953,2265,7145,5075,14164,7145,3132,7205,14350,7205,14350
澲,ZhenJingXiang,511622201,5198,1354,4269,3808,8388,4269,1915,4198,8467,4198,8467
ɽ,MengShanXiang,511622202,6984,1639,5448,3770,10711,5447,2277,5430,10877,5452,10900
˫,ShuangXingXiang,511622203,10151,1961,7089,5146,14690,7070,2646,7648,14718,7669,14758
ͥ,LongTingXiang,511622204,6003,1491,4743,3568,9410,4743,2073,4824,9567,4824,9567
ʯ,ShiPanXiang,511622205,12612,2577,9187,5954,18333,9187,3273,9275,18462,9275,18462
,JiuXianXiang,511622207,6133,1425,4642,3806,9212,4638,1818,4692,9330,4734,9376
Ľ,GuJiangXiang,511622208,8964,1927,6481,4565,13259,6474,2526,6920,13394,6936,13417
ƺ,BaiPingXiang,511622209,9202,2024,7100,5049,13668,7024,2938,6932,13956,7064,14164
ʤ,YongShengXiang,511622210,5676,1309,4396,3217,8608,4396,1766,4352,8748,4355,8751
ѧ,XinXueXiang,511622211,5723,1666,4546,4121,8926,4546,1642,4473,9019,4485,9031
,BaoZhenSaiXiang,511622212,9789,2228,7576,5174,14711,7575,2876,7317,14892,7317,14893
,JinGuangXiang,511622213,7842,1731,6236,4258,12130,6217,2676,5970,12187,6013,12249
һ,BaYiXiang,511622214,7058,1440,5310,3378,10219,5307,1890,5066,10373,5078,10388
ʯ,GaoShiXiang,511622215,7441,1379,5193,2666,10458,5167,1835,5413,10580,5462,10655
,DingPingZhen,511623100,84846,8053,57461,34522,84429,54597,20800,54164,108761,56238,113699
Ǳ,ChengBeiZhen,511623101,24043,3740,16905,10784,34560,16775,6888,17550,34325,17766,34671
,ChengNanZhen,511623102,20296,3732,15453,11341,29661,15144,7051,15218,30362,15626,31079
,GanZiZhen,511623103,8876,1560,6406,4978,13100,6358,2832,6762,13120,6862,13268
,LongAnZhen,511623104,6830,1462,5336,4191,10658,5325,2651,5573,10898,5607,10943
,GuanYinQiaoZhen,511623105,11545,2147,8334,7064,17049,8324,3659,8988,17312,9017,17351
Ĳ,MouJiaZhen,511623106,9482,1763,7225,5403,14376,7225,3606,7626,14851,7626,14851
,HeLiuZhen,511623107,8717,1707,6787,4877,13140,6562,3534,6794,13356,7171,13958
̳ͬ,TanTongZhen,511623108,18597,3196,14118,10897,26972,13862,6766,14216,28078,14441,28559
̲,GaoTanZhen,511623109,13181,2752,10292,7657,19913,10155,4758,10192,20347,10399,20691
,JiuLongZhen,511623110,30394,5139,22189,14940,38808,20084,9049,20535,40619,22393,44582
,YuLinZhen,511623111,11837,2708,9407,7259,18615,9378,4341,9379,18757,9479,18886
Ԭ,YuanShiZhen,511623112,11688,2236,9503,7395,18793,9499,5116,9526,19025,9537,19040
,FengHeZhen,511623113,23743,3754,18510,15338,30537,17920,10135,18530,36450,19122,37632
˶,BaErZhen,511623114,6894,1285,5075,4173,10384,5075,2460,5564,10639,5564,10639
ʯ,ShiYongZhen,511623115,12668,2594,10217,7908,19654,9778,5517,10178,19956,10562,20779
,XingRenZhen,511623116,11138,1943,8713,6686,17069,8700,4655,8979,17679,9023,17736
,WangJiaZhen,511623117,10568,1941,8091,5699,16295,7893,4251,8337,16230,8669,16760
̫,TaiHeXiang,511623200,7794,1618,5909,4751,12198,5902,3045,6525,12427,6548,12457
,XinZhenXiang,511623201,3242,606,2656,1955,5262,2642,1505,2661,5303,2697,5353
,LengJiaXiang,511623202,4562,940,3374,2662,6862,3319,1499,3517,6836,3627,7001
,ChangAnXiang,511623203,7757,1391,5671,4265,11523,5663,2598,6051,11714,6075,11746
,XiTianXiang,511623204,4582,1081,3420,2569,6880,3418,1501,3684,7102,3744,7164
,LiangBanXiang,511623205,6204,1303,4661,3592,9524,4603,2088,4853,9456,4934,9595
ʰ,GanBaXiang,511623206,4166,804,3286,2365,6480,3284,1698,3370,6654,3382,6668
ĺ,SiHaiXiang,511623207,5786,868,4184,2731,8436,4133,1957,4324,8457,4427,8611
ŷ,JiuFengXiang,511623208,2236,641,2017,1483,3822,1985,1156,1934,3919,2016,4033
ľ,ChunMuXiang,511623209,4072,862,3351,2415,6384,3348,1816,3382,6730,3399,6750
,HuaYingXiang,511623210,1618,339,1186,1029,2245,1174,544,1221,2395,1315,2501
,ZiZhongXiang,511623211,5885,1172,4405,3667,8848,4394,1994,4592,8986,4646,9051
,FengYaXiang,511623212,3415,844,2633,1864,5361,2604,1220,2794,5398,2846,5479
,LiJiaXiang,511623213,5007,1412,4193,3476,8099,4188,1895,4106,8294,4121,8314
,LongQiaoXiang,511623214,6133,1747,5453,4231,10782,5392,3135,5425,10817,5562,11015
غ,GuanHeXiang,511623215,4429,1186,3873,2992,7558,3870,2085,3812,7682,3827,7700
,LiangHeXiang,511623216,4203,1014,3456,2922,6859,3454,1840,3586,7040,3601,7057
̲,ChangTanXiang,511623217,5939,1279,4833,3716,9559,4811,2472,4822,9633,4857,9690
ɽ,LiangShanXiang,511623218,4027,1067,3567,2820,6820,3524,1856,3276,6800,3383,6950
ʢ,FuShengXiang,511623219,8354,1634,6493,4981,12979,6398,3472,6750,13148,6967,13460
·,GuLuXiang,511623220,3507,827,2754,1972,5353,2736,1252,2798,5534,2832,5586
ƺ,JingPingXiang,511623221,5101,1126,4082,3054,8179,4082,2089,4233,8315,4234,8316
,LiuTangXiang,511623222,5265,1202,4428,3376,8522,4417,2454,4463,8880,4493,8921
ʯ,ShiZiXiang,511623223,7789,1290,5947,4673,11312,5932,3116,6160,12092,6248,12195
,HuLinXiang,511623224,5356,802,4271,3025,8338,4261,2595,4455,8716,4482,8753
ͬʯ,TongShiXiang,511623225,2001,590,1807,1415,3512,1807,1035,1818,3625,1819,3626
,SanGuXiang,511623226,6806,1370,5731,3956,10864,5731,3403,5848,11579,5848,11579
˫ӽֵ´,ShuangHeJieDaoBanShiChu,511681001,55910,6802,38436,23980,64997,35097,13593,34294,69391,37869,76305
Žֵ´,GuQiaoJieDaoBanShiChu,511681002,9481,1483,6829,4967,12435,6700,2773,6601,13301,6908,13737
ֵ´,HuaLongJieDaoBanShiChu,511681003,12172,2099,8871,5979,16999,8869,3533,8931,17800,8933,17804
,TianChiZhen,511681101,10587,1624,7203,5839,13547,7196,2586,7560,14756,7594,14797
»,LuShiZhen,511681102,10147,2199,7932,5408,15020,7803,3381,7568,15371,7795,15727
,YongXingZhen,511681103,12451,2666,9772,6954,18214,9767,3878,9166,18933,9223,18995
,MingYueZhen,511681104,10308,2387,8621,6453,15947,8616,3973,8020,16636,8047,16668
,YangHeZhen,511681105,10337,2403,8898,6173,16578,8761,4673,8281,17042,8515,17413
,GaoXingZhen,511681106,12371,1916,9119,5909,18176,8996,4380,9359,18355,9548,18667
Ϫ,GuanYinXiZhen,511681107,13712,2131,9534,6595,17898,9163,3982,9656,18819,10291,19825
Ϫ,XiKouZhen,511681108,15906,2185,11211,6388,21125,9160,4797,9247,18407,11677,22888
컪,QingHuaZhen,511681109,14078,3158,11680,8449,21083,11652,5570,10948,22600,11126,22806
,HongYanXiang,511681200,2025,381,1244,1076,1984,1142,321,1271,2413,1483,2727
ǽֵ´,DongChengJieDaoBanShiChu,511702001,84548,9733,55341,34318,64355,49336,14853,47387,96723,53793,109134
ǽֵ´,XiChengJieDaoBanShiChu,511702002,68486,8075,45430,26456,55297,38585,13424,37302,75887,44555,89985
ֵ´,ZhaoYangJieDaoBanShiChu,511702003,77861,5335,50029,29511,47292,42861,15847,43248,86109,49014,99043
,XiWaiZhen,511702100,14180,1454,9475,6123,15709,9188,3331,8877,18065,9490,18965
,BeiWaiZhen,511702101,24703,2112,16602,8960,23946,12449,4771,12138,24587,14984,31586
޽,LuoJiangZhen,511702102,16936,2192,11734,7574,20526,11584,4467,11680,23264,11861,23595
Ѽ,PuJiaZhen,511702103,14141,2355,10555,6939,19255,10385,4971,10476,20861,10912,21467
,FuXingZhen,511702104,17230,1876,10946,7120,21780,10265,3940,9970,20235,12100,23046
˫,ShuangLongZhen,511702105,7698,1177,5489,3719,10431,5346,2337,5467,10813,5723,11212
κ,WeiXingZhen,511702106,8380,1173,6100,4052,11766,5980,2604,5880,11860,6057,12157
ʯ,PanShiXiang,511702200,14895,2472,10660,7320,20783,10474,4059,10449,20923,10766,21426
,DongYueXiang,511702201,8081,1122,5788,3460,10892,5788,2248,5660,11448,5663,11451
´,XinCunXiang,511702202,3472,651,2629,1766,5055,2583,1086,2473,5056,2580,5209
,NanWaiZhen,511721100,140251,10518,90905,58276,89053,84026,31321,83297,167323,91185,182090
ͤ,TingZiZhen,511721101,20117,3612,14668,8176,29111,14179,6617,14853,29032,15678,30346
,FuShanZhen,511721102,7437,1549,5802,3667,11230,5752,2844,5939,11691,6028,11830
,MaLiuZhen,511721103,22203,3791,16584,9745,30075,15832,7608,15940,31772,17018,33602
̴ľ,TanMuZhen,511721104,12551,2055,8854,6277,18163,8827,3770,9459,18286,9522,18376
,DaShuZhen,511721105,19312,3349,14437,10329,28399,14430,7213,15298,29728,15437,29874
,NanYueZhen,511721106,12133,2236,9236,5858,18573,9187,4603,9642,18829,9736,18972
,WanJiaZhen,511721107,18437,3389,13701,7934,27436,13578,6403,14375,27953,14528,28229
,JingShiZhen,511721108,15365,3388,11762,7370,23679,11643,5895,12592,24235,12886,24648
ٽ,BaiJieZhen,511721109,6948,1352,5286,3306,10058,5197,2449,5348,10545,5463,10749
Լ,ZhaoJiaZhen,511721110,13644,2289,9963,5494,19036,8945,4289,9103,18048,10259,20222
,HeShiZhen,511721111,31489,4125,21698,13013,37981,19963,7821,19376,39339,21737,43435
ʯ,ShiBanZhen,511721112,14792,1888,9624,6161,16839,8470,3059,8571,17041,10115,19739
,JinYaZhen,511721113,8490,1867,5946,3335,11920,5810,1914,6064,11874,6325,12271
,DuShiZhen,511721114,17855,2880,12440,6749,25495,11755,4942,12167,23922,13237,25677
ܴ,GuanCunZhen,511721115,12424,2102,9224,6301,17356,8981,4247,9216,18197,9549,18773
ʯ,ShiTiZhen,511721116,17209,3089,12468,7251,23676,10925,4908,11293,22218,12738,25206
ʯ,ShiQiaoZhen,511721117,25855,3984,18754,11112,32996,17422,8277,17717,35139,19362,38116
,BuZiZhen,511721118,12775,2079,8830,4561,17850,8199,3460,8876,17075,9484,18314
,JiangLingZhen,511721119,11599,2472,8329,4632,16723,8149,3162,8654,16803,8904,17233
,BeiMiaoZhen,511721120,16163,2129,11225,6322,22208,10860,5015,11452,22312,12082,23307
,DaFengXiang,511721200,5864,978,4258,2786,8551,4225,1892,4411,8636,4476,8734
,JiangYangXiang,511721201,6560,1207,4705,3096,9402,4650,1965,4956,9606,5027,9732
,DongXingXiang,511721202,9166,1865,7029,4311,13914,6989,3387,7349,14338,7389,14418
,AnRenXiang,511721203,5907,1262,4609,3117,8835,4585,2147,4671,9256,4707,9316
«,HuLuXiang,511721204,2388,580,1843,1221,3571,1826,753,1839,3665,1878,3721
̲,DaTanXiang,511721205,4872,980,3641,2242,7374,3562,1679,3748,7310,3890,7531
,HuaHongXiang,511721206,6489,1340,4713,3152,9736,4677,2022,5026,9703,5138,9851
ͥ,HuangTingXiang,511721207,4630,796,3594,2031,6698,3570,1864,3633,7203,3696,7290
ƶ,HuangDouXiang,511721208,8120,1708,6331,4071,12740,6295,3277,6673,12968,6774,13105
ƽ̲,PingTanXiang,511721209,11021,1557,7343,4111,15847,7222,3419,8352,15574,8654,15997
,BeiGaoXiang,511721210,7365,1488,5416,3430,10852,5370,2293,5609,10979,5730,11146
,MaJiaXiang,511721211,9461,1694,6763,4027,13017,6697,2860,6883,13580,7252,14015
ľ,MuZiXiang,511721212,7595,1793,5577,3510,11220,5553,2215,5979,11532,6026,11603
˫,ShuangMiaoXiang,511721213,17331,3363,12247,7320,24665,12019,4469,12601,24620,12916,25163
,BinLangXiang,511721214,10858,1607,7774,4900,13975,7506,3141,7537,15043,7832,15606
,YaoTangXiang,511721215,5709,858,3892,2178,7337,3842,1412,3949,7791,4087,7979
¼,ChenJiaXiang,511721216,6261,1366,4818,3049,9633,4809,2188,4972,9781,4997,9815
,LongHuiXiang,511721217,5314,1528,4294,3051,8386,4140,2016,4330,8470,4564,8858
,GuanZiXiang,511721218,9827,1953,7402,4694,14649,7321,3386,7643,14964,7764,15166
,ShenJiaXiang,511721219,6728,1299,4910,3153,9749,4817,2112,4998,9815,5229,10139
,CaoXingXiang,511721220,5811,1168,4019,2114,8473,3941,1603,4442,8383,4563,8582
ľͷ,MuTouXiang,511721221,7927,968,5089,3449,9079,5067,1656,5320,10387,5462,10551
̴,JinTanXiang,511721222,7717,1457,5726,3518,11300,5665,2529,5862,11527,5977,11703
,DaYanXiang,511721223,8139,1254,5752,3599,10830,5701,2580,6096,11797,6221,11973
Թ,ZhaoGuXiang,511721224,8776,1930,6821,4151,13070,6799,3216,7063,13862,7101,13922
,JiuLingXiang,511721225,8126,1744,5967,3263,11807,5941,2430,6269,12210,6333,12300
,QiaoWanXiang,511721226,11846,2502,8489,5893,17244,8277,3403,8790,17067,9262,17751
,WuSiXiang,511721227,7380,1445,5295,3538,10729,5278,2173,5650,10928,5703,10998
,YinTieXiang,511721228,3997,989,3059,2099,6031,3034,1290,3162,6196,3217,6276
غ,YanHeXiang,511721229,4969,1153,3555,2232,7148,3532,1251,3762,7294,3818,7373
¡,XiangLongXiang,511721230,3291,752,2316,1331,4721,2312,862,2557,4869,2589,4905
,YongJinXiang,511721231,8661,1456,6074,3652,12126,6029,2352,6280,12309,6395,12469
峵,LuoCheXiang,511721232,3898,912,2802,1686,5724,2798,1000,3000,5798,3008,5810
,DaoRangXiang,511721233,3710,765,2635,1630,5340,2593,1020,2757,5350,2860,5495
,HuRangXiang,511721234,7100,1324,4993,2524,10017,4975,2030,5417,10392,5461,10454
׳,MiChengXiang,511721235,5215,879,3813,2103,7814,3749,1916,4086,7835,4197,8010
̲,LongTanXiang,511721236,4813,928,3492,2368,6935,3485,1368,3596,7081,3617,7109
ͩ,ZiTongXiang,511721237,5513,1071,4139,2322,8348,4107,1953,4296,8403,4398,8537
ɽ,BeiShanXiang,511721238,11254,1920,7949,4464,15573,7893,3465,8232,16125,8690,16639
ʯ,JinShiXiang,511721239,8544,1610,5923,3370,11515,5733,2683,6053,11786,6914,12837
,AnYunXiang,511721240,7572,1344,5257,3501,10360,5199,2014,5363,10562,5673,10930
,QingNingXiang,511721241,6927,1154,4801,3098,9804,4438,2187,4677,9115,5467,10268
˫,MengShuangXiang,511721242,4088,750,2915,1663,6025,2894,1235,3102,5996,3158,6073
,DongXiangZhen,511722100,99217,11104,68988,37141,110420,59057,28113,57446,116503,69446,138434
,JunTangZhen,511722101,6486,1497,4758,3090,9287,4749,1667,4873,9622,4892,9650
Ϫ,QingXiZhen,511722102,21586,3736,15721,9108,31814,15675,7170,16514,32189,16771,32492
չ,PuGuangZhen,511722103,15344,1948,10483,6970,20188,10156,5429,10632,20788,12238,22721
,TianShengZhen,511722104,13544,2239,9272,5459,18230,8447,3722,8918,17365,10233,19505
,BaiShuZhen,511722105,10227,2344,7873,5039,15180,7840,3358,7921,15761,8056,15929
Ž,BaJiaoZhen,511722106,17025,2550,11974,7062,23520,11909,5484,12924,24833,13085,25059
ϰ,NanBaZhen,511722107,62406,8189,44185,25989,81243,43017,20896,45540,88557,47306,91491
屦,WuBaoZhen,511722108,13077,2396,9692,6691,19868,9647,5046,10701,20348,10827,20519
,FengChengZhen,511722109,12061,2013,8954,5752,18208,8948,4689,9797,18745,9809,18763
,TuHuangZhen,511722110,17559,2453,13019,8375,25747,13019,6972,13965,26984,13965,26984
,HuaJingZhen,511722111,14065,2777,10975,6876,21212,10824,5599,11194,22018,11466,22441
,FanKuaiZhen,511722112,14460,1911,10728,6449,20678,10703,5564,11174,21877,11207,21935
»,XinHuaZhen,511722113,13635,1963,9500,5699,19201,9469,4461,10325,19794,10559,20059
ƽ,HuangJinZhen,511722114,16160,2206,11899,6717,23873,11853,5957,12209,24062,12424,24323
,HuJiaZhen,511722115,18915,2923,14381,9336,26701,13724,7254,13663,27387,14711,29092
ë,MaoBaZhen,511722116,14559,2099,10167,6243,19688,9894,4412,10562,20456,10903,21070
˫,ShuangHeZhen,511722117,18861,3279,13874,9256,27031,13717,6125,14102,27819,14391,28265
,DaChengZhen,511722118,18109,3015,13053,7476,26078,12989,5793,13683,26672,13864,26917
,MingYueXiang,511722200,4488,1156,3335,2125,6697,3288,1193,3358,6646,3502,6837
,HongLingXiang,511722201,5280,1384,4196,3219,8371,4181,2015,4430,8611,4483,8679
,LiuChiXiang,511722202,14586,2644,10429,6413,20815,10228,4460,10564,20792,11261,21690
,SanHeXiang,511722203,8410,1308,5830,3404,11932,5568,2589,6160,11728,6477,12307
Ͼ,LaoJunXiang,511722204,7005,1515,5531,3626,11231,5493,2999,5906,11399,5988,11519
ʯ,HuangShiXiang,511722205,6116,1342,4776,3349,9659,4776,2483,5165,9941,5165,9941
,QiLiXiang,511722206,9630,1562,6508,3518,13030,6452,2497,6799,13251,7181,13689
�,MiaoAnXiang,511722207,3815,777,2654,1593,5396,2585,994,2820,5405,2932,5586
챦,TianBaoXiang,511722208,4782,866,3177,1921,6476,3177,954,3425,6602,3425,6602
,DongLinXiang,511722209,4314,1101,3225,2431,6634,3222,1312,3499,6721,3502,6727
°,XiaBaXiang,511722210,14795,2757,11220,7483,22542,11217,5637,11960,23177,11969,23189
,LiangFengXiang,511722211,5585,951,3854,2451,7903,3845,1880,4500,8345,4562,8416
Ͽ,ShangXiaXiang,511722212,8405,1329,5833,3679,11479,5741,2645,6324,12065,6546,12379
,TaHeXiang,511722213,11600,2014,7946,4801,16363,7912,3510,9076,16988,9178,17124
,ChaHeXiang,511722214,13035,2965,10038,6880,20137,9978,4948,10754,20732,10910,20948
̨,TianTaiXiang,511722215,4574,971,3407,2090,6744,3380,1416,3496,6876,3554,6961
ɽ,GuanShanXiang,511722216,3653,561,2601,1468,5323,2586,1307,2865,5451,2920,5521
ƺ,NanPingXiang,511722217,3232,451,2211,1153,4662,2196,1083,2521,4717,2555,4766
,FengLinXiang,511722218,3823,571,2669,1457,5389,2669,1273,2996,5665,2998,5667
һ,TaoHuaXiang,511722219,10046,1762,7612,4294,15395,7402,4051,7992,15394,8247,15859
,BaiMaXiang,511722220,7162,1494,5888,3697,11545,5849,3434,6145,11994,6202,12090
ᱮ,QiBeiXiang,511722221,4382,820,3430,2126,6650,3430,1875,3643,7073,3647,7077
,SanDunTuJiaZuXiang,511722222,8198,1081,6207,3561,12028,6207,3384,6451,12658,6456,12663
,QiShuTuJiaZuXiang,511722223,3611,541,2711,1570,5319,2711,1499,2940,5651,2940,5651
Ȫ,LongQuanTuJiaZuXiang,511722224,5690,845,4315,2530,8487,4304,2587,4786,9090,4807,9122
ɿ,DuKouTuJiaZuXiang,511722225,3472,642,2680,1691,5280,2677,1447,2864,5541,2881,5561
ʯ,ShiTieXiang,511722226,4246,862,3324,2043,6701,3296,1752,3499,6795,3536,6860
Ϫ,ChangXiXiang,511722227,14181,2431,10904,6503,21941,10886,5861,11417,22303,11569,22473
,HongFengXiang,511722228,12212,1615,8665,4919,17240,8617,4366,9450,18067,9528,18193
,FengMingXiang,511722229,5994,1258,5318,3523,9231,5306,3254,5166,10472,5188,10506
,HuaChiXiang,511722230,6166,1093,4706,2715,9476,4658,2356,4818,9476,4909,9615
,TuZhuXiang,511722231,6308,1100,4799,3214,9298,4716,2290,4734,9450,4899,9698
,QingYunXiang,511722232,10132,1547,7580,3910,14909,7504,3855,7802,15306,7954,15534
,MaDuXiang,511722233,7627,1159,6024,3840,11796,5990,3523,6190,12180,6285,12309
,AiKouXiang,511722234,5968,1079,4730,2844,9075,4696,2371,4598,9294,4688,9418
,XinNingZhen,511723100,59298,7225,40199,29164,69692,39176,15059,40057,79233,41383,81582
հ,PuAnZhen,511723101,31361,5126,23226,15716,44021,21936,10135,22055,43991,23396,46622
,HuiLongZhen,511723102,9044,1577,6659,4105,13028,6555,3055,6851,13406,7017,13676
ʦ,TianShiZhen,511723103,7042,1336,5122,3311,10150,5050,2169,5264,10314,5425,10547
,YongXingZhen,511723104,22539,2679,14825,9761,30921,14706,6387,16110,30816,16780,31605
,JiangZhiZhen,511723105,14361,2791,10617,7140,20894,10371,4579,10823,21194,11114,21731
,GanTangZhen,511723106,21500,4583,16664,11757,32469,16648,8296,17565,34213,17715,34379
,RenShiZhen,511723107,25741,3816,18824,11683,35057,17977,8840,18681,36658,19573,38397
㸣,GuangFuZhen,511723108,9493,1781,7215,4286,14010,7138,3580,7536,14674,7639,14854
,ChangLingZhen,511723109,15582,3231,12455,8032,23708,12449,6489,12809,25258,12847,25302
,ChangTianXiang,511723200,5738,1186,4306,2740,8412,4251,1851,4319,8570,4469,8775
,QiLongXiang,511723201,5404,973,3860,2559,7754,3860,1682,4189,8049,4199,8059
̫,XinTaiXiang,511723202,7287,1376,5375,3516,10743,5324,2519,5667,10991,5807,11182
,LingYanXiang,511723203,7941,1691,5570,3964,11299,5564,2500,6236,11800,6562,12132
ɳӳ,ShaBaChangXiang,511723204,6929,1375,4692,3480,9717,4690,1679,5284,9974,5291,9983
÷,MeiJiaXiang,511723205,7089,1464,4955,3204,10244,4939,2154,5670,10609,5752,10707
ʯ,BaoShiXiang,511723206,8895,1803,6486,4228,13060,6483,2955,7145,13628,7167,13653
,JingAnXiang,511723207,10275,1981,7978,5257,15750,7976,4107,8374,16350,8385,16363
½,XinJieXiang,511723208,5075,1414,4461,3647,8512,4461,2552,4580,9041,4580,9041
,BaMiaoXiang,511723209,7418,1708,6017,4331,11485,6012,3161,6258,12270,6270,12287
,ZhuYangZhen,511724100,104352,12291,71848,38826,103113,59927,26329,56785,116712,71124,142972
ľ,WuMuZhen,511724101,9662,2201,7050,5394,14090,7036,2672,7403,14439,7485,14535
Ű,TuanBaZhen,511724102,8406,1984,6017,4846,12508,5920,2695,6341,12261,7068,13085
,YangJiaZhen,511724103,12865,2974,9357,7927,18652,9320,3665,10018,19338,10147,19504
,QingHeZhen,511724104,12028,2394,9043,5915,17664,8271,3980,8452,16723,9359,18402
,BoLinZhen,511724105,10471,2047,7776,5939,14382,7753,3166,7841,15594,7908,15684
ʯ,ShiHeZhen,511724106,22129,3852,15442,9497,28712,12917,5758,13634,26551,16297,31739
˫,ShuangGongZhen,511724107,4977,1193,3843,2972,7176,3802,1712,3926,7728,4039,7882
ʯ,ShiQiaoPuZhen,511724108,14430,2431,10381,6150,20094,10306,4507,10892,21198,10987,21368
,GuanYinZhen,511724109,13805,2685,10280,8493,19875,10004,4756,10673,20677,10966,21246
ܼ,ZhouJiaZhen,511724110,23078,3893,17154,11633,34802,16940,9167,18656,35596,18984,36138
ʯ,ShiZiZhen,511724111,16211,1968,10872,6789,21869,10815,4647,11892,22707,11954,22826
,WenXingZhen,511724112,15692,2125,10794,7555,21919,10590,4975,11540,22130,11998,22792
,MaMaZhen,511724113,8845,1784,6236,4663,12984,6236,2536,6929,13165,6929,13165
Ѩ,GaoXueZhen,511724114,17038,2912,11432,7197,23825,11207,4396,12577,23784,12914,24346
ŷ,OuJiaZhen,511724115,8848,1364,6085,3741,12243,6084,2467,6588,12672,6594,12679
,MiaoBaZhen,511724116,20937,2967,13962,10177,25206,12947,5319,14047,26994,15261,29223
ˮ,QingShuiZhen,511724117,23820,3444,15613,10016,32086,15613,5252,16902,32515,16903,32516
,ChengXiXiang,511724200,11473,1990,7587,4811,15017,7178,2411,7746,14924,8287,15874
,ZhuBeiXiang,511724201,18755,2589,12677,7455,21250,11974,4458,12537,24511,13125,25802
,DongLiuXiang,511724202,14360,2261,10214,6347,18467,9849,4306,10246,20095,10713,20927
,ZhaoYangXiang,511724203,8242,1551,5991,4709,11908,5981,2545,6300,12281,6347,12338
˺,RenHeXiang,511724204,6542,1511,4691,3412,9399,4686,1700,5052,9738,5062,9753
л,ZhongHuaXiang,511724205,4839,1093,3495,2586,6983,3487,1293,3698,7185,3730,7225
Ƽ,HuangJiaXiang,511724206,4396,886,2988,2069,6018,2976,933,3211,6187,3227,6215
ؼ,BaiJiaXiang,511724207,4407,1320,3484,2620,6916,3479,1526,3764,7243,3769,7253
,LiJiaXiang,511724208,7200,2186,5523,4107,11289,5523,2112,5974,11497,5975,11498
»,YueHuaXiang,511724209,17764,3389,12621,9665,25440,12618,4807,13327,25945,13339,25960
,ErLangXiang,511724210,4473,1382,3613,2855,7169,3591,1646,3854,7445,3888,7501
Ѱ,PuBaoXiang,511724211,1682,338,1258,847,2360,1197,476,1106,2303,1238,2496
ʤ,YongShengXiang,511724212,12589,2258,8772,5430,18068,8623,3592,9466,18089,9667,18439
,XinShengXiang,511724213,9290,1584,6249,3956,12895,6243,2479,7090,13333,7104,13353
,AnJiXiang,511724214,7023,1431,5266,3453,10569,5251,2501,5667,10918,5689,10955
װ,BaiBaXiang,511724215,7869,1752,6123,5465,12277,6120,3148,6645,12765,6646,12769
˫Ϫ,ShuangXiXiang,511724216,6634,1569,4928,3746,10076,4919,2310,5550,10469,5585,10513
,GaoMingXiang,511724217,14308,2494,10747,5782,21782,10562,5405,11143,21705,11460,22207
˶,BaDuXiang,511724218,5429,1231,4374,3278,8705,4363,2352,4622,8985,4638,9012
к,ZhongHeXiang,511724219,3741,1049,3064,2253,6136,3007,1647,3223,6230,3373,6437
ͨ,YangTongXiang,511724220,8461,1287,5932,3997,12166,5858,2619,6284,12142,6435,12367
,TianChengXiang,511724221,6630,1363,5397,4242,10445,5394,2912,5497,10891,5508,10905
ĺ,SiHeXiang,511724222,7642,1078,5520,3725,11035,5519,2665,5860,11379,5865,11385
ż,ZhangJiaXiang,511724223,4479,657,3156,2268,6320,3128,1536,3468,6596,3516,6672
ͯ,TongJiaXiang,511724224,14536,2299,10496,6601,21390,10494,4892,11229,21723,11231,21727
,ShenHeXiang,511724225,4053,929,3350,2616,6609,3339,1852,3461,6800,3484,6834
,JinJiXiang,511724226,4682,1020,3440,2255,6993,3431,1430,3681,7112,3692,7132
̲,HuangTanXiang,511724227,4454,911,3165,2411,6403,3165,1351,3551,6716,3551,6716
Ʒ,PaiFangXiang,511724228,7461,1255,5075,3434,10076,5056,1773,5387,10443,5414,10489
Ҧ,YaoShiXiang,511724229,4219,1117,3317,2492,6643,3310,1543,3488,6798,3562,6879
ӡ,LianYinXiang,511724230,8271,1467,5788,3607,11385,5349,2037,5471,10820,5987,11775
,ChuanZhuXiang,511724231,4789,1224,3437,2877,7210,3437,1361,3935,7372,3937,7374
,QuJiangZhen,511725100,121065,12379,78180,40654,119977,68605,24975,69274,137879,80239,158419
,TianXingZhen,511725101,19132,2254,13486,8713,24754,13393,5153,12949,26342,13053,26539
ٰ,LinBaZhen,511725102,23105,3778,16257,10605,32375,16257,6533,17156,33413,17159,33416
Ϫ,TuXiZhen,511725103,28028,4015,19384,10683,37869,19328,7837,20354,39682,20496,39880
,SanHuiZhen,511725104,30608,5513,22086,16242,42915,21971,7820,21604,43575,21855,43941
ĳ,WenChongZhen,511725105,10912,2267,7786,6212,15891,7681,2872,8119,15800,8265,16051
ӿ,YongXingZhen,511725106,25716,3790,17851,10313,34518,17554,7003,18092,35646,18658,36509
,GuiFuZhen,511725107,18321,2751,13026,7843,25733,13013,5178,13134,26147,13224,26250
ҷ,YanFengZhen,511725108,16499,2493,11387,6514,22335,11384,4355,11960,23344,11960,23347
,JingBianZhen,511725109,14747,2709,10686,6078,21263,10685,4385,11152,21837,11155,21841
Ϫ,QingXiChangZhen,511725110,20644,3281,14524,7935,29334,14515,5947,15295,29810,15348,29872
,BaoChengZhen,511725111,16330,2493,11382,7102,22996,11377,4687,12087,23464,12128,23510
,YouQingZhen,511725112,17801,2873,12712,9481,25964,12712,5422,13383,26095,13384,26096
ʶ,XianDuZhen,511725113,14845,2541,9857,6117,20464,9857,3283,10812,20669,10812,20669
,LangYaZhen,511725114,15862,2846,11321,6131,21874,11229,4626,11771,23000,12013,23334
,QuNanXiang,511725200,12881,2131,8771,5229,17804,8737,2973,9174,17911,9214,17985
,QuBeiXiang,511725201,11051,1855,7689,4638,15620,7670,2813,8012,15682,8030,15719
,QingLongXiang,511725202,13527,2649,9974,5928,20205,9974,4212,10409,20383,10414,20388
,BanQiaoXiang,511725203,8476,1717,6045,3899,12478,6014,2377,6463,12477,6525,12570
Ϫ,XiXiXiang,511725204,9303,1537,6528,4238,13459,6525,2759,7063,13588,7071,13599
̶,LongTanXiang,511725205,9563,1784,6758,4268,13833,6758,2624,7210,13968,7213,13971
Ӷ,HeDongXiang,511725206,7456,1379,5352,3490,10855,5352,2329,5812,11164,5812,11164
,LiFuXiang,511725207,17358,3794,12738,8506,25822,12738,4953,13367,26105,13367,26105
,QingShenXiang,511725208,9012,1411,6385,3689,12745,6385,2522,6558,12943,6560,12945
Ϫ,LiuXiXiang,511725209,10558,1805,7233,4437,14729,7231,2861,7946,15177,7991,15224
,DongAnXiang,511725210,8703,1812,6420,4647,13007,6420,2763,6858,13278,6858,13278
㶫,HuiDongXiang,511725211,9308,1716,6499,4110,12848,6489,2058,6548,13037,6583,13082
,HuiNanXiang,511725212,5742,968,4021,2154,8010,4021,1439,4126,8147,4128,8149
㱱,HuiBeiXiang,511725213,7660,1423,5179,2654,10618,5179,1663,5567,10746,5567,10746
,FengLeXiang,511725214,14308,2445,10419,6469,20278,10419,4005,10338,20757,10339,20758
,BaoEnXiang,511725215,12978,2206,9186,5076,18506,9155,3571,9524,18679,9569,18755
,AnBeiXiang,511725216,8762,1498,6082,3043,12381,6082,2313,6491,12573,6491,12573
ƽ,PingAnXiang,511725217,7248,1234,5207,2970,10473,5207,2198,5473,10680,5473,10680
ǧ,QianFoXiang,511725218,7455,1283,5195,2733,10461,5174,1882,5377,10551,5425,10620
ˮ,BaiShuiXiang,511725219,4047,964,2903,1839,5950,2903,950,3057,5960,3058,5961
,DaYiXiang,511725220,3571,769,2539,1623,5175,2539,862,2663,5202,2663,5202
,YiHeXiang,511725221,4350,1005,3040,1818,6233,3040,966,3281,6321,3281,6321
ˮ,ShuiKouXiang,511725222,14676,2431,10928,6675,21099,10928,4517,10687,21615,10696,21624
,SanBanXiang,511725223,11861,1828,8350,4498,16760,8337,3218,8529,16866,8557,16907
޹,JuGuangXiang,511725224,9244,1577,6450,3697,13168,6450,2483,6854,13304,6854,13304
̺,CaiHeXiang,511725225,3835,855,2715,1913,5691,2714,1044,3019,5733,3019,5734
,HeLinXiang,511725226,7723,1416,5452,3256,11255,5452,2266,5953,11405,5953,11405
,BaiTuXiang,511725227,6378,1168,4445,2498,9197,4445,1654,4755,9200,4755,9200
˿,QingSiXiang,511725228,5315,1157,3823,2721,7839,3823,1442,4091,7914,4091,7914
,WanShouXiang,511725229,4716,878,3311,1866,6855,3311,1330,3613,6924,3613,6924
,SheHongXiang,511725230,10026,1664,7122,4083,14505,7116,2986,7529,14645,7554,14676
,WangJiangXiang,511725231,6908,1232,4963,2921,9924,4963,1968,5145,10108,5145,10108
,HeLeXiang,511725232,3771,713,2630,1524,5425,2627,1025,2875,5502,2879,5509
,LongFengXiang,511725233,9860,1701,7438,4351,14671,7438,3377,7500,14938,7500,14938
,XinShiXiang,511725234,9513,1430,6501,3711,13613,6500,2722,7160,13660,7164,13665
μ,SongJiaXiang,511725235,7972,1442,5697,3773,11744,5697,2432,6149,11846,6149,11846
,GongShiXiang,511725236,8068,1344,5601,3220,11628,5598,2272,6048,11646,6083,11684
̲,ZhongTanXiang,511725237,9865,1452,6899,4194,14004,6899,2690,7108,14007,7108,14007
,PingXiXiang,511725238,9133,1441,6259,3914,12642,6255,2236,6504,12759,6551,12810
Զ,DingYuanXiang,511725239,12513,1750,8911,5162,17736,8858,3664,8938,17796,9016,17927
κ,JiaHeXiang,511725240,8772,1325,5780,3470,11863,5769,1796,6103,11872,6113,11893
,LiDuXiang,511725241,21797,3750,15418,9079,30797,14968,5839,15484,30452,15968,31386
Ϫ,WangXiXiang,511725242,16187,2604,11228,6489,23198,11187,4874,12170,23357,12437,23665
˫,ShuangTuXiang,511725243,9653,1573,6781,4362,13959,6757,2923,7323,14080,7368,14149
,JuanDongXiang,511725244,6923,961,4640,2598,9045,4569,1853,4834,9403,5097,9737
̫ƽ,TaiPingZhen,511781100,66589,6440,44268,26357,61767,40682,15939,40471,81153,44700,88968
໨,QingHuaZhen,511781101,6103,1111,4543,3434,7976,4535,1874,4536,9071,4545,9088
Ժ,JiuYuanZhen,511781102,7476,1414,6188,4024,11733,6184,3411,6103,12287,6113,12301
,LuoWenZhen,511781103,6851,1620,5444,4203,10079,5366,2377,5316,10682,5404,10848
ӿ,HeKouZhen,511781104,3628,897,3128,2250,5437,3128,1557,2954,6082,2954,6082
ݰ,CaoBaZhen,511781105,5112,1037,4459,3009,7608,4459,2522,4212,8671,4212,8671
,ZhuYuZhen,511781106,4881,1038,4251,3106,7197,4247,2288,3910,8157,3956,8207
,DaZhuZhen,511781107,7938,1724,6581,4382,11921,6578,3464,6541,13119,6545,13126
,HuangZhongZhen,511781108,3955,889,3174,2432,5846,3155,1460,3077,6232,3130,6304
ٶ,GuanDuZhen,511781109,8128,1044,5507,3418,9299,5454,2553,5886,11340,6218,11725
ɳ,BaiShaZhen,511781110,14872,1975,10815,6797,17853,10732,5328,10795,21527,11360,22175
ɳ̲,ShaTanZhen,511781111,8684,1459,6263,4665,12019,6258,2648,6476,12734,6528,12791
,ChaYaXiang,511781200,5249,704,3616,1994,6742,3590,1378,3628,7218,3715,7331
ʯ,ChangShiXiang,511781201,3118,676,2297,1663,4459,2291,1015,2487,4778,2512,4809
,BaiYangXiang,511781202,3664,837,3203,2120,5941,3200,1657,2950,6150,2955,6158
,TieKuangXiang,511781203,3129,665,2430,1709,4766,2430,1206,2570,5000,2570,5000
̾,GuJunXiang,511781204,4049,805,3009,2022,5999,3009,1367,3212,6221,3212,6221
Ϫ,JingXiXiang,511781205,4267,1069,3712,2576,7141,3711,2081,3698,7409,3705,7417
,YanTangXiang,511781206,1443,349,1064,743,2184,1058,557,1193,2251,1285,2349
Ͱ,FengTongXiang,511781207,1799,383,1555,849,2940,1552,998,1618,3170,1625,3180
¥,HuaLouXiang,511781208,5715,1270,4373,3427,8331,4373,1853,4465,8838,4465,8838
,ChangBaXiang,511781209,5009,1107,3989,3126,7370,3989,1723,3849,7838,3850,7839
,CengJiaXiang,511781210,4260,965,3284,2449,6324,3284,1419,3360,6644,3360,6644
ɳ,DaShaXiang,511781211,4175,1075,3502,2702,6584,3501,1809,3556,7057,3557,7059
غ,QinHeXiang,511781212,2367,638,2079,1477,3952,2079,1168,2094,4173,2094,4173
,MiaoYaXiang,511781213,2841,687,2576,1848,4808,2575,1576,2528,5103,2528,5104
ӥ,YingBeiXiang,511781214,3833,718,3250,2080,6192,3250,2034,3335,6585,3335,6585
ʯ,ShiWoXiang,511781215,5545,1234,4405,2978,8614,4399,2195,4554,8953,4569,8974
,YuDaiXiang,511781216,4195,871,3540,2461,6579,3540,2007,3533,7073,3533,7073
µ,XinDianXiang,511781217,1933,483,1637,1133,3084,1637,865,1644,3281,1644,3281
κ,WeiJiaXiang,511781218,4698,924,4029,2610,7381,4029,2200,3793,7822,3793,7822
,LiuHuangXiang,511781219,2130,555,1991,1293,3554,1991,1111,1801,3792,1805,3796
Ϫ,XiKouXiang,511781220,1905,547,1715,1302,3179,1715,892,1629,3344,1629,3344
,YongNingXiang,511781221,2162,550,1872,1424,3403,1869,908,1737,3606,1748,3620
,HongQiaoXiang,511781222,1660,452,1500,1158,2627,1493,715,1320,2813,1327,2827
,KangLeXiang,511781223,1133,230,921,673,1708,921,461,903,1824,903,1824
׹,BaiGuoXiang,511781224,3324,651,2619,1602,4886,2619,1412,2768,5387,2768,5387
ͤ,ZhongTingXiang,511781225,2949,515,2429,1459,4316,2429,1413,2448,4877,2448,4877
,MiaoZiXiang,511781226,3169,677,2489,1743,4750,2489,1424,2779,5268,2781,5270
Ϫ,ZiXiXiang,511781228,1077,235,817,508,1600,817,429,924,1741,924,1741
,MiaoPoXiang,511781229,3326,553,2596,1536,5031,2558,1545,2792,5350,2828,5424
,LiShuXiang,511781230,3305,470,2223,1567,4125,2223,1012,2564,4787,2564,4787
Ƥ,PiWoXiang,511781231,1944,354,1528,943,2804,1525,850,1611,3136,1620,3148
˿,SiLuoXiang,511781232,2010,513,1654,1311,3003,1654,729,1598,3252,1598,3252
ް,GuanBaXiang,511781233,1205,350,890,743,1722,890,299,964,1854,964,1854
ʯ,ShiRenXiang,511781234,1550,426,1299,1020,2351,1299,618,1289,2588,1295,2594
,ZhaoTangXiang,511781235,1659,375,1304,997,2494,1304,584,1306,2610,1314,2618
ƺ,ZhongPingXiang,511781236,2474,710,2100,1565,3988,2063,1091,2118,4181,2175,4275
̨,BaTaiXiang,511781237,5467,688,4027,3143,6817,4019,1918,4009,8028,4046,8073
,HuaEXiang,511781238,862,178,628,438,1231,628,299,711,1339,711,1339
ܼ,CaoJiaXiang,511781239,1597,442,1239,857,2536,1239,610,1410,2649,1410,2649
ʯ,ShiTangXiang,511781240,5672,1009,4302,2836,8323,4252,2071,4228,8480,4450,8752
ǽֵ,DongChengJieDao,511802001,64041,7579,38950,19336,52587,25913,5976,24974,50887,38646,77596
ǽֵ,XiChengJieDao,511802002,16166,3508,11217,8632,17221,10792,2425,10450,21242,10882,22099
ӱֵ,HeBeiJieDao,511802003,30202,6056,20498,15222,32347,19683,4739,19505,39188,20499,40997
཭ֵ,QingJiangJieDao,511802004,16304,1701,10576,7489,15779,10500,3064,10112,20612,10493,21069
,BeiJiaoZhen,511802100,17934,2528,11930,7397,21978,11908,3509,11980,23888,12041,23971
ݰ,CaoBaZhen,511802101,16300,2470,11187,7883,21840,10831,3631,10533,21364,11214,22401
Ͻ,HeJiangZhen,511802102,5625,1003,3847,2352,7739,3846,1301,4075,7921,4082,7929
,DaXingZhen,511802103,14035,1880,9553,8111,18715,9553,3291,9649,19202,9653,19206
,DuiYanZhen,511802104,10253,1612,7118,4228,12494,7110,2290,7014,14124,7037,14155
ɳƺ,ShaPingZhen,511802105,2534,615,1837,1371,3539,1807,685,1849,3656,1997,3834
,ZhongLiZhen,511802106,7458,1364,5678,3978,11089,5675,2725,5869,11544,5869,11547
,ShangLiZhen,511802107,6431,1186,5175,3570,9708,5055,2590,4837,9892,5032,10207
,YanQiaoZhen,511802108,6349,1168,4750,2545,9229,4577,1957,4479,9056,4724,9474
̳,YanChangZhen,511802109,4701,1154,3632,2243,7024,3582,1439,3591,7173,3662,7294
Ӫ,DuoYingZhen,511802110,5782,731,3893,2815,7288,3889,1348,3948,7837,3968,7861
̷Ͽ,BiFengXiaZhen,511802111,5430,1155,4226,2746,7768,4175,1953,4187,8362,4312,8538
Ͻ,NanJiaoXiang,511802200,10513,1433,7105,4743,12931,7097,2174,6973,14070,7015,14120
˲,BaBuXiang,511802201,5639,996,3955,2414,7583,3944,1414,4067,8011,4094,8049
ۻ,GuanHuaXiang,511802202,2854,672,2018,1392,4014,1997,688,2123,4120,2196,4214
ƺ,KongPingXiang,511802203,5907,1197,4266,2639,8066,4163,1499,4161,8324,4337,8603
,FengMingXiang,511802204,4809,911,3304,2144,6508,3304,1136,3549,6853,3552,6856
,WangYuXiang,511802205,3789,845,2660,1693,5250,2650,918,2767,5417,2892,5552
,MengYangZhen,511821100,27872,3586,17168,11138,27871,16401,4668,16087,32488,18958,36126
,BaiZhangZhen,511821101,13871,1820,9261,5123,16803,8755,2616,8613,17368,9046,18307
,CheLingZhen,511821102,13305,2530,9163,5493,18152,9129,3138,9754,18883,9810,18973
,YongXingZhen,511821103,13196,2109,8892,5369,17379,8868,2700,9091,17959,9113,18005
,MaLingZhen,511821104,7811,1553,5252,3409,10322,5252,1341,5452,10704,5453,10705
µ,XinDianZhen,511821105,14046,2016,9597,5424,18786,9595,3129,9591,19186,9594,19191
ɶɽ,MengDingShanZhen,511821106,9505,1301,6114,3479,11425,5858,1783,5839,11697,6475,12589
,HeiZhuZhen,511821107,7634,1110,5216,3202,9904,5216,1558,5086,10302,5086,10302
,HongXingZhen,511821108,9176,1271,6158,3702,11857,6154,1875,6155,12309,6164,12322
Ƕ,ChengDongXiang,511821200,6254,941,4172,2761,7024,4162,1195,4183,8345,4218,8390
ǰ,QianJinXiang,511821201,9537,1778,6514,4033,13320,6387,2248,6828,13215,7049,13563
з,ZhongFengXiang,511821202,9320,1433,6098,3593,12109,6083,1797,6420,12503,6452,12550
,LianJiangXiang,511821203,7597,1117,5092,3033,9810,5085,1439,5050,10135,5061,10153
γ,LiaoChangXiang,511821204,6955,1020,4621,2903,8823,4610,1328,4653,9263,4682,9303
,WanGuXiang,511821205,6396,994,4437,2583,8469,4437,1494,4447,8884,4447,8884
,HongYanXiang,511821206,3896,721,2797,1654,5353,2740,996,2730,5470,2816,5613
˫,ShuangHeXiang,511821207,6986,1253,4819,2914,9289,4773,1741,5093,9866,5161,9980
ɽ,JianShanXiang,511821208,3972,825,2820,1885,5578,2795,1009,2947,5742,2986,5806
,JieFangXiang,511821209,6292,930,4217,2399,8208,4198,1243,4198,8396,4248,8465
é,MaoHeXiang,511821210,5477,776,3673,2169,7050,3638,1004,3521,7159,3584,7257
ϵ,YanDaoZhen,511822100,29593,3744,20648,13940,31046,20553,7124,19715,40268,19813,40461
̲,HuaTanZhen,511822101,7264,1215,5197,3420,9074,5192,2140,5419,10611,5422,10619
,LiuHeXiang,511822200,7018,986,4810,3013,8110,4807,1779,4966,9773,4973,9783
̫,LieTaiXiang,511822201,4823,710,3347,2036,5781,3347,1166,3352,6699,3352,6699
,AnJingXiang,511822202,3052,648,2107,1491,4052,2094,712,2235,4329,2305,4412
,MinJianYiZuXiang,511822203,2749,400,2031,1204,3591,2031,963,2080,4111,2081,4112
ʿ,LieShiXiang,511822204,3262,462,2072,1288,3939,2054,658,2137,4191,2310,4382
,YingHeXiang,511822205,4036,630,2827,1834,5005,2827,986,2825,5652,2825,5652
½,XinJianXiang,511822206,1594,334,1137,684,2130,1137,395,1186,2323,1186,2323
ƺ,SiPingXiang,511822207,2994,466,2071,1183,3829,1992,785,2013,4005,2174,4245
,XinMiaoXiang,511822208,1938,321,1362,798,2624,1359,514,1392,2751,1411,2773
,SanHeXiang,511822209,1722,333,1206,616,2305,1205,447,1289,2494,1296,2502
,DaTianBaXiang,511822210,4034,612,2787,1859,4574,2778,932,2765,5543,2791,5578
,TianFengXiang,511822211,2008,435,1284,1057,2766,1284,372,1531,2815,1531,2815
,BaoFengYiZuXiang,511822212,1154,273,819,639,1655,819,306,914,1733,914,1733
,XinTianXiang,511822213,6694,1228,4594,3252,9127,4594,1614,4940,9534,4942,9536
,FuChengXiang,511822214,4276,656,2970,2041,4703,2964,1003,2915,5879,2965,5935
,WuXianXiang,511822215,4226,605,2821,1657,5293,2821,880,2890,5711,2890,5711
,YanZhuXiang,511822216,2133,377,1468,1055,2640,1466,497,1534,3000,1539,3007
,QingLongXiang,511822217,5028,667,3310,1900,6126,3306,1010,3373,6679,3395,6705
Թ,LongCangGouXiang,511822218,7007,836,3331,1966,5661,3040,1129,3220,6260,5641,8972
,FuLinZhen,511823100,22466,2702,13721,9530,24724,12085,3659,12562,24647,15106,28827
,JiuXiangZhen,511823101,41108,5305,27242,15194,41915,26099,6967,25117,51216,26138,53380
˹,WuSiHeZhen,511823102,6204,893,4047,2328,7693,3862,1550,3889,7751,4600,8647
˶,YiDongZhen,511823103,11683,1505,7851,4571,15467,7787,2781,8001,15788,8118,15969
ׯ,FuZhuangZhen,511823104,6996,990,4629,2622,8790,4610,1724,5058,9668,5081,9710
Ϫ,QingXiZhen,511823105,3659,485,2439,1429,4624,2434,741,2443,4877,2446,4885
,DaShuZhen,511823106,3792,576,2681,1823,4817,2681,995,2682,5363,2682,5363
ľ,HuangMuZhen,511823107,4981,648,3356,2001,6502,3331,1218,3426,6757,3491,6847
,DaTianXiang,511823200,9839,1333,6560,3733,10958,6560,1970,6582,13142,6582,13142
Ƽ,TangJiaXiang,511823201,11858,1565,7566,4269,13103,7397,2002,7493,14890,7859,15425
,FuChunXiang,511823202,6391,849,4157,2575,8116,4142,994,4047,8189,4077,8234
,HeXiXiang,511823203,7475,871,4793,2592,9219,4732,1410,4831,9563,4963,9756
,DaLingXiang,511823204,3691,468,2297,1402,4575,2297,620,2482,4779,2482,4779
ǰ,QianYuXiang,511823205,7852,943,5183,2854,9650,5182,1591,5197,10379,5203,10386
,HouYuXiang,511823206,2719,454,1769,1020,3586,1761,507,1888,3649,1911,3680
,DaYanXiang,511823207,5934,716,3841,2086,7675,3836,1148,3926,7762,3957,7798
,LiangHeXiang,511823208,2373,390,1556,973,3148,1542,520,1704,3246,1727,3283
,FuXiangXiang,511823209,2149,373,1362,876,2876,1361,406,1559,2920,1566,2928
԰,LiYuanXiang,511823210,3230,374,2045,1219,4216,2045,678,2236,4281,2237,4282
,SanJiaoXiang,511823211,3479,422,2220,1235,4456,2209,688,2354,4563,2369,4589
˫Ϫ,ShuangXiXiang,511823212,5274,754,3416,2033,6492,3410,936,3505,6915,3548,6964
Ϫ,XiXiXiang,511823213,2676,486,1731,1115,3580,1708,627,2026,3734,2058,3789
,JianLiXiang,511823214,3081,409,2065,1357,4082,2052,710,2113,4165,2135,4200
,ShiRongXiang,511823215,10827,984,6112,3396,11323,5775,1897,5844,11619,7596,13708
Ȫ,FuQuanXiang,511823216,4780,669,3108,1799,5797,3086,877,3159,6245,3218,6326
,WanGongXiang,511823217,2615,303,1653,1164,3390,1651,536,1796,3447,1801,3454
,AnLeXiang,511823218,5933,867,3816,2528,7801,3816,1159,4141,7957,4143,7959
,WanLiXiang,511823219,2952,646,1911,1203,3786,1858,549,2098,3956,2236,4147
,MaLieXiang,511823220,4372,693,2880,1850,5976,2859,1009,3163,6022,3194,6074
,BaiYanXiang,511823221,5380,724,3354,2097,6708,3337,1041,3758,7095,3791,7145
฻,QingFuXiang,511823222,1178,136,795,519,1466,795,326,845,1640,845,1640
,GuiXianXiang,511823223,6662,729,4448,2701,8419,4448,1761,4692,9140,4704,9152
,HeNanXiang,511823224,3899,536,2636,1544,4988,2636,1001,2800,5436,2800,5436
ɹ,ShaiJingXiang,511823225,2887,371,1962,1124,3728,1941,799,2053,3994,2095,4057
,LiaoLinXiang,511823226,4032,552,2597,1529,5398,2582,997,2942,5524,2984,5581
С,XiaoBaoZangZuYiZuXiang,511823227,1626,168,1062,601,1722,1041,432,1105,2146,1164,2226
Ƭ,PianMaYiZuXiang,511823228,2964,444,2066,1268,3826,2057,956,2276,4333,2298,4364
,NiMeiYiZuXiang,511823229,1193,109,842,480,1247,842,503,963,1805,963,1805
,YongLiYiZuXiang,511823230,2163,401,1405,967,2859,1387,470,1592,2979,1629,3034
˳,ShunHeYiZuXiang,511823231,1033,149,696,491,1403,695,255,741,1436,741,1437
޳ǽֵ´,MianChengJieDaoBanShiChu,511824001,24835,3274,15955,12761,24034,15749,4518,15927,31676,16672,32627
,XinMianZhen,511824100,7138,833,5020,3059,9243,4991,1988,4874,9865,4939,9959
˳,AnShunYiZuXiang,511824200,6067,721,4329,2563,7767,4215,1974,4239,8454,4433,8762
ȷ,XianFengZangZuXiang,511824201,4670,569,3211,1890,5961,3136,1292,3205,6341,3320,6531
зݲ,XieLuoZangZuXiang,511824202,2450,376,1749,1058,3151,1736,740,1778,3514,1817,3566
,YongHeXiang,511824203,3386,449,2279,1477,4386,2275,904,2441,4716,2460,4739
¡,HuiLongYiZuXiang,511824204,6092,891,4081,2644,7696,3958,1794,4110,8068,4696,8777
,CaLuoYiZuXiang,511824205,2814,311,2060,1082,3670,1999,1082,1971,3970,2147,4207
ƺ,LiZiPingYiZuXiang,511824206,3274,212,2528,1118,4824,2483,1721,2406,4889,2679,5207
,MeiLuoXiang,511824207,6191,842,4227,2565,7892,4167,1451,4170,8337,4257,8484
ӭ,YingZhengXiang,511824208,4539,522,3036,1904,5477,3036,1167,3192,6228,3192,6228
,ZaiYangXiang,511824209,3587,424,2375,1495,4570,2375,875,2511,4886,2511,4886
,FengLeXiang,511824210,1923,320,1249,917,2487,1249,443,1437,2686,1437,2686
,XinMinZangZuYiZuXiang,511824211,5165,728,3530,2295,6829,3530,1421,3783,7313,3784,7314
ڽ,WaJiaoYiZuZangZuXiang,511824212,3238,246,1705,894,2693,1446,646,1470,2916,2425,4130
,TianWanYiZuXiang,511824213,2051,345,1499,890,2846,1483,658,1514,2997,1555,3054
ݿƲ,CaoKeZangZuXiang,511824214,1679,338,1135,766,2157,1134,426,1303,2437,1308,2443
,ChengXiangZhen,511825100,28761,3520,20022,11793,31121,18807,7080,18295,37102,19339,39361
ʼ,ShiYangZhen,511825101,13373,1932,9692,5463,17074,9593,3946,9385,18978,9559,19251
С,XiaoHeXiang,511825200,6914,958,4826,2493,8610,4425,1882,4484,8909,4928,9754
˼,SiJingXiang,511825201,5751,1155,4084,2566,7875,4076,1589,4327,8403,4411,8495
Ȫ,YuQuanXiang,511825202,1304,328,1004,605,1834,994,477,1044,2038,1105,2109
ʯ,ZiShiXiang,511825203,2389,257,1246,647,1987,1108,389,1041,2149,1789,3035
·,LiangLuXiang,511825204,1263,181,828,505,1538,787,329,851,1638,945,1773
ƺ,DaPingXiang,511825205,2798,586,2031,1250,3789,2024,815,2139,4163,2168,4199
Ӣ,LeYingXiang,511825206,5088,920,3763,2293,6894,3689,1542,3647,7336,3787,7550
๦,DuoGongXiang,511825207,2702,442,1934,1118,3703,1910,821,1995,3905,2031,3965
,RenYiXiang,511825208,4982,973,3819,2461,7048,3803,1582,3686,7489,3718,7537
ϳ,LaoChangXiang,511825209,4031,694,3120,1900,5677,2979,1324,2828,5807,2929,6049
»,XinHuaXiang,511825210,3509,694,2602,1738,4837,2536,1069,2616,5152,2670,5272
³,XinChangXiang,511825211,6044,1359,4608,3030,8732,4546,1839,4519,9065,4634,9242
ҵ,XingYeXiang,511825212,4343,1034,3093,2161,5449,3060,1183,3187,6247,3467,6560
«,LuYangZhen,511826100,20365,2626,13826,9419,24736,13711,5227,14013,27724,14392,28218
ɹ,FeiXianGuanZhen,511826101,6637,1059,4934,3399,9241,4918,1933,4666,9584,4695,9629
˫ʯ,ShuangShiZhen,511826102,4862,988,3509,2276,7034,3477,1403,3689,7166,3744,7253
̫ƽ,TaiPingZhen,511826103,7434,1511,5343,3160,10413,5322,2061,5519,10841,5663,11006
,DaChuanZhen,511826104,4161,804,2900,1830,5984,2900,1064,3129,6029,3129,6029
˼,SiYanXiang,511826200,6377,953,4830,2968,8756,4813,2125,4593,9406,4625,9455
,QingRenXiang,511826201,8391,1375,6071,3772,10985,6065,2432,6067,12132,6127,12198
,LongMenXiang,511826202,13222,2290,9767,6252,17716,9733,4201,9815,19548,9946,19713
ʢ,BaoShengXiang,511826203,3624,750,2708,1802,5364,2701,1152,2790,5491,2818,5526
ƺ,MuPingZhen,511827100,9532,1144,6086,3559,10642,5533,2014,5703,11236,6604,12690
,LingGuanZhen,511827101,11716,1730,7841,4630,15736,7580,3198,7818,15398,8803,16644
¤,LongDongZhen,511827102,3760,813,2566,1537,5017,2466,847,2612,5078,2854,5420
Ӽկ,FengYongZhaiXiang,511827201,3245,600,2260,1243,4379,2181,858,2259,4440,2443,4703
,QiaoQiXiang,511827202,3287,463,2158,1173,4493,2083,813,2189,4272,2405,4563
,YongFuXiang,511827203,1090,259,749,487,1483,713,293,800,1513,893,1642
,MingLiXiang,511827204,901,237,651,438,1264,638,241,696,1334,728,1379
,WuLongXiang,511827205,3936,759,2750,1500,5544,2696,1040,2917,5613,2985,5735
Ϫ,DaXiXiang,511827206,2277,407,1542,945,3157,1531,600,1710,3241,1742,3284
ǽֵ´,DongChengJieDaoBanShiChu,511902001,51219,4431,33316,20694,53687,32814,11794,33792,66606,34128,67444
ǽֵ´,XiChengJieDaoBanShiChu,511902002,39335,3672,26647,16877,43399,26620,10854,27168,53788,27214,53861
طֵ´,HuiFengJieDaoBanShiChu,511902003,53230,4314,37134,21117,34007,35694,16214,34643,70337,36624,73758
ֵ´,JiangBeiJieDaoBanShiChu,511902004,63216,5000,41745,24743,37858,40082,17202,39032,79114,43673,85418
,BaZhouZhen,511902100,34357,5489,23552,13647,46727,23468,8367,24562,48030,24661,48213
彭,QingJiangZhen,511902101,29259,4490,20702,11032,39488,20208,8515,20692,40900,21562,42264
,XingWenZhen,511902102,9019,2086,6885,4532,13611,6863,2691,6880,13743,6911,13796
ˮ,ShuiNingSiZhen,511902103,12741,2247,9616,5547,18870,9559,4189,9463,19022,9561,19177
,HuaChengZhen,511902104,16226,2880,11916,5999,22634,10575,5255,10888,21463,12445,24361
,CengKouZhen,511902105,21685,5314,16603,12282,33762,16410,6931,16865,33275,17327,33930
,LiangYongZhen,511902106,14491,3064,11059,6544,21797,11001,4824,11132,22133,11320,22379
,SanJiangZhen,511902107,9113,2015,6595,3612,13386,6592,2463,6977,13569,6996,13591
ɽ,DingShanZhen,511902108,17805,3497,12653,8906,25788,12377,5322,13596,25973,13971,26624
,DaLuoZhen,511902109,9335,1814,6914,3975,13906,6832,2922,7035,13867,7157,14071
ɽ,YuShanZhen,511902110,23689,5147,18465,11492,35746,17653,8447,17904,35557,18818,37283
,EnYangZhen,511902111,46412,7432,32650,19219,60699,31601,12716,32473,64074,33910,66560
Ϫ,YuXiZhen,511902112,17251,4019,13845,9559,26375,13843,5672,13097,26940,13097,26942
ӳ,SanHeChangZhen,511902113,8921,1807,6586,4291,13112,6585,2456,6598,13183,6598,13184
ľ,QingMuZhen,511902114,9285,2252,7539,4991,14652,7410,3378,7220,14630,7376,14915
,HuaCongZhen,511902115,17859,3865,13472,8750,26033,13245,5093,13095,26340,13345,26817
,LiuLinZhen,511902116,20187,3452,13854,7381,27512,13800,5276,14814,28614,15061,28915
°,XiaBaMiaoZhen,511902117,12136,2411,8707,5534,17388,8706,3339,9143,17849,9179,17886
,ChaBaZhen,511902118,8304,1939,6380,4195,11936,5929,2564,5832,11761,6427,12807
,GuanYinJingZhen,511902119,9527,2481,7757,5108,15138,7678,3621,7508,15186,7872,15629
,SanHuiZhen,511902120,7890,1564,6116,3851,11800,6111,2631,5962,12073,5969,12085
ϰ,ShangBaMiaoZhen,511902121,10098,1958,7272,4245,14489,7270,2647,7429,14699,7431,14703
,ZaoLinZhen,511902122,6491,1446,4985,3394,9645,4960,2085,4962,9922,5037,10022
ƽ,PingLiangXiang,511902200,26346,4614,18934,10957,37736,18600,7573,18955,37555,19599,38533
,GuangHuiXiang,511902201,9151,1610,6235,3298,12892,6207,2228,6678,12885,6754,12989
Ϫ,HuaXiXiang,511902202,7232,1206,5276,2813,10414,5276,2299,5461,10737,5461,10737
,DaHeXiang,511902203,4982,1217,4142,2692,7853,4115,1827,3781,7896,3884,8026
,BaiMiaoXiang,511902204,5351,980,3707,2341,7678,3707,1396,4020,7727,4020,7727
ض,GuanDuXiang,511902205,4262,954,3255,2066,6301,3203,1220,3073,6276,3181,6436
,LingYunXiang,511902206,6033,1083,4238,2301,8148,4205,1631,4415,8620,4509,8747
,SiLingXiang,511902207,5660,1257,4395,2677,8715,4393,1912,4428,8821,4434,8829
ͩ,ZiTongMiaoXiang,511902208,8340,1620,5941,3072,12106,5692,2254,5877,11569,6273,12214
,JinBeiXiang,511902209,4080,1209,3617,2491,6847,3611,1830,3490,7101,3502,7119
,YangFengXiang,511902210,5846,1335,4439,2653,9119,4439,1959,4699,9138,4701,9140
Ϫ,FengXiXiang,511902211,8139,1859,6354,4481,12893,6354,3036,6680,13034,6680,13034
,LongBeiXiang,511902212,4824,1005,3566,1974,7167,3566,1591,3854,7420,3854,7420
,SanXingXiang,511902213,6860,1277,4758,2654,9939,4745,1928,5283,10028,5307,10065
ع,GuanGongXiang,511902214,10203,2615,8134,5510,16076,8134,3614,8298,16432,8298,16432
,WuFengXiang,511902215,4424,925,3409,2116,6856,3409,1559,3499,6908,3499,6908
¡,XingLongChangXiang,511902216,9195,1755,6640,3836,13297,6603,2626,6846,13449,6936,13576
ʯ,ShiChengXiang,511902217,9486,1784,6683,3515,13416,6680,2492,7075,13755,7079,13762
,JiuZhenXiang,511902218,5798,1293,4571,2636,8921,4528,1959,4409,8937,4479,9050
,YinJiaXiang,511902219,4579,1358,3897,2742,6999,3869,1581,3559,7428,3621,7518
˫ʤ,ShuangShengXiang,511902220,12231,2105,8491,3941,17452,8127,3487,8845,16972,9332,17823
Ⱥ,QunLeXiang,511902221,8402,1749,6230,3742,12749,6228,2715,6618,12846,6636,12866
,WanAnXiang,511902222,7440,1479,5575,2967,11214,5569,2479,5817,11386,5823,11398
,YuJingXiang,511902223,5462,1068,4011,2322,8075,4011,1639,4158,8169,4158,8169
,YiXingXiang,511902224,7318,1401,5609,3125,10788,5609,2295,5404,11013,5405,11014
ŵ,NuoJiangZhen,511921100,88956,8167,58276,33330,100245,51961,21396,52531,104492,60243,118519
ʤ,MinShengZhen,511921101,13492,2266,9495,5437,18901,9382,3307,9477,18859,9570,19065
,HuoJuZhen,511921102,11804,2310,8673,4705,17256,8520,3351,8613,17133,8792,17465
,GuangNaZhen,511921103,17896,3318,13186,8357,25999,13088,5148,13006,26094,13176,26362
,TieFoZhen,511921104,20303,3498,16297,10368,31222,16193,8452,15811,32004,15956,32253
ʯ,MaShiZhen,511921105,6330,1355,4918,3290,9475,4891,2227,4887,9778,4994,9912
,ZhiChengZhen,511921106,13106,1639,9250,4960,18740,8776,4063,8943,17719,9558,18808
,HongKouZhen,511921107,9258,1406,6568,4025,13043,6554,2951,7020,13574,7047,13615
ɳϪ,ShaXiZhen,511921108,14458,1960,10302,6165,20957,10200,4855,10782,20982,10971,21273
,WaShiZhen,511921109,10560,1949,8068,4547,15576,7536,3579,7387,14923,8020,16088
,YongAnZhen,511921110,13890,1854,9319,5243,17709,8820,3430,9252,18072,9855,19174
Ϫ,TieXiZhen,511921111,7643,1118,5046,2685,10467,4928,2106,5521,10449,5821,10867
,FuYangZhen,511921112,11090,1276,7390,4055,14953,7339,2845,7780,15119,7821,15211
ŵˮ,NuoShuiHeZhen,511921113,14160,1987,9972,5145,19878,9544,4562,10148,19692,10737,20709
,YangBaiXiang,511921200,10574,2059,7666,4430,15189,7604,2842,7700,15304,7809,15475
,DaXingXiang,511921201,4220,815,3170,1744,6139,3165,1278,3135,6300,3143,6313
ɽ,DongShanXiang,511921202,4323,702,2938,1612,5908,2917,980,3015,5932,3067,6005
Ϫ,SanXiXiang,511921203,5265,1114,4103,2491,8117,4076,1887,4105,8181,4163,8266
˫Ȫ,ShuangQuanXiang,511921204,5316,800,3867,1952,7701,3867,1677,3926,7793,3926,7793
ķ,WenFengXiang,511921205,7717,1009,5590,2760,11364,5568,2788,5856,11424,5924,11514
,ChunZaiXiang,511921206,9537,1483,6422,3352,12552,6384,2106,6596,12980,6704,13126
,SanHeXiang,511921207,8052,1332,5467,2514,10784,5427,1746,5588,11015,5663,11130
,YunTanXiang,511921208,4342,632,2985,1590,6107,2979,1182,3152,6131,3171,6156
,ChangGeXiang,511921209,3141,473,2114,993,4424,2096,833,2287,4383,2333,4447
֥,ZhiBaoXiang,511921210,8613,1260,5808,2832,11981,5789,2194,6197,11986,6259,12067
ﳡ,LongFengChangXiang,511921211,8777,1708,7186,4210,13866,7144,3887,7098,14242,7186,14372
Ϫ,DongXiXiang,511921212,3125,502,2171,1105,4505,2152,1039,2447,4599,2495,4666
,SiBoXiang,511921213,3782,679,2819,1582,5685,2791,1371,2972,5763,3013,5832
Ϫ,SongXiXiang,511921214,5895,981,4378,2285,8676,4339,2106,4503,8842,4604,8982
Ų,JiuCengXiang,511921215,3903,727,2975,1888,5813,2969,1394,3023,5992,3049,6024
ʤ,ShengLiXiang,511921216,4147,677,2891,1516,6088,2876,1335,3203,6079,3268,6159
,BanDengXiang,511921217,4882,628,3311,1674,6937,3302,1539,3701,7003,3738,7049
ʤ,WenShengXiang,511921218,5955,989,4245,2008,8789,4241,1916,4603,8844,4615,8860
¡,XingLongXiang,511921219,9020,1497,6460,3483,12802,6429,2644,6603,13032,6701,13161
ëԡ,MaoYuXiang,511921220,8865,1721,6456,3772,12782,6343,2549,6477,12820,6679,13135
Ϫ,NiXiXiang,511921221,8196,1250,5710,2962,11553,5691,2243,5927,11618,5979,11689
Ϫ,YanXiXiang,511921222,7091,1038,4897,2354,9741,4855,1994,5149,10004,5226,10123
ɳƺ,ShaPingXiang,511921223,3565,609,2376,1156,4880,2368,911,2605,4973,2709,5085
Ԫ,ZhuYuanXiang,511921224,2870,448,2110,921,4139,2086,924,2064,4150,2132,4242
ƺ,ChangPingXiang,511921225,7837,1063,5325,2670,10970,5289,2227,5698,10987,5802,11127
ӿ,LiangHeKouXiang,511921226,7308,1053,5087,2464,10256,5042,2107,5274,10316,5381,10468
ɽ,KongShanXiang,511921227,4696,702,3422,1619,6751,3361,1568,3402,6763,3544,6966
ԡ,QingYuXiang,511921228,9300,1325,6495,3014,13212,6460,2763,6802,13262,6893,13388
ſ,BanQiaoKouXiang,511921229,12467,1839,8727,4406,17917,8683,3938,9373,18056,9517,18244
,TieChangXiang,511921230,2745,457,1878,1016,3824,1852,776,1992,3844,2100,3978
³,XinChangXiang,511921231,11581,1676,8279,4231,16590,8275,3544,8521,16796,8522,16801
º,ChenHeXiang,511921232,9029,1365,6224,3191,12743,6211,2520,6625,12836,6690,12914
ݳ,CaoChiXiang,511921233,5478,726,3672,1961,7474,3672,1333,3861,7533,3865,7537
,HuiLinXiang,511921234,3462,600,2315,1121,4746,2307,892,2547,4854,2639,4954
Ͻ,NanJiangZhen,511922100,68729,6413,47184,25481,71236,43340,19822,42989,86329,47780,94964
ɳ,ShaHeZhen,511922101,13653,1926,9273,6529,19026,9272,4084,10388,19660,10390,19663
ְ,LeBaZhen,511922102,3484,353,2378,1352,3951,2107,1037,2110,4217,2496,4874
,ChangChiZhen,511922103,23320,3066,17137,10946,31546,16832,8556,17509,34341,17805,34942
ֱ,ZhengZhiZhen,511922104,22323,2482,14955,9754,30572,14810,6473,16197,31007,16323,31278
,DaHeZhen,511922105,15982,2505,11721,6434,22735,10979,5226,10950,21929,11992,23713
ɽ,GuangWuShanZhen,511922106,1736,280,1203,820,2283,1047,487,1103,2150,1300,2503
,DongYuZhen,511922107,13187,2037,10091,6124,19065,9801,5104,9777,19578,10237,20328
,XiaLiangZhen,511922108,13394,2048,10242,5731,18547,10203,5317,10416,20619,10517,20759
ϳ,GanChangZhen,511922109,9639,1582,7274,4605,14264,7270,3368,7310,14580,7315,14589
,YangBaZhen,511922110,5684,833,3888,2354,7951,3885,1688,4289,8174,4317,8205
Ϫ,ChiXiXiang,511922200,9856,1348,6969,4228,14160,6964,3034,7230,14194,7269,14238
ɽ,YanShanXiang,511922201,4525,784,3354,1891,6744,3305,1622,3513,6818,3577,6931
,BaMiaoXiang,511922202,6698,883,4885,2675,9249,4829,2230,4849,9678,4926,9811
,GaoTaXiang,511922203,8260,1307,6327,4069,12628,6316,3154,6147,12463,6394,12721
Ž,TuanJieXiang,511922204,4559,817,3474,2274,6900,3456,1596,3467,6923,3498,6972
,HongGuangXiang,511922205,11848,1563,8386,5222,16935,8379,3737,8728,17107,8762,17148
,FuJiaXiang,511922206,5521,904,4298,2687,8266,4298,2018,4143,8441,4145,8443
,HongSiXiang,511922207,4940,631,3391,1978,6906,3386,1435,3594,6980,3615,7006
,TianChiXiang,511922208,9255,1335,6384,3717,13189,6373,2795,6944,13317,7001,13385
,HouJiaXiang,511922209,7485,1248,5656,3353,10909,5640,2508,5475,11115,5585,11241
˫,ShuangGuiXiang,511922210,3751,603,2726,1553,5545,2716,1273,2871,5587,2901,5627
,FengYiXiang,511922211,9179,1240,6186,3253,12788,6158,2577,6740,12898,6810,12996
칫,ZhuGongXiang,511922212,6615,1111,4674,2620,9413,4646,2003,5016,9662,5055,9729
̶,HeiTanXiang,511922213,8410,1087,5495,3079,11514,5417,2301,6011,11428,6303,11798
ƽ,HePingXiang,511922214,7672,1404,5998,3593,11364,5985,3153,6188,12173,6231,12229
˫,ShuangLiuXiang,511922215,10524,1724,7918,4890,16021,7918,4001,8331,16249,8331,16249
Ԫ̶,YuanTanXiang,511922216,9647,1634,7297,4375,14092,7234,3490,7387,14621,7474,14771
,GaoQiaoXiang,511922217,5229,870,4048,2241,7900,4015,2115,4133,8148,4166,8214
ƽ,PingGangXiang,511922218,3687,664,2991,1787,5882,2971,1628,2952,5923,2988,5979
ʺ,RenHeXiang,511922219,9414,1691,7109,3863,14267,6969,3401,7233,14202,7397,14506
ʯ̲,ShiTanXiang,511922220,8548,1297,6302,3835,12981,6299,3193,6729,13028,6736,13038
,GuanMenXiang,511922221,6458,1226,4933,3096,9682,4903,2448,5133,10036,5199,10132
,XingMaXiang,511922222,10110,1519,7386,4266,14846,7384,3438,7677,15061,7681,15067
,BeiJiXiang,511922223,3094,509,2193,1028,4479,2169,924,2271,4440,2334,4527
·,GuanLuXiang,511922224,6248,871,4471,2365,8785,4464,1941,4579,9043,4589,9060
,GuanTianXiang,511922225,2443,387,1759,932,3447,1755,766,1829,3584,1837,3596
,HongYanXiang,511922226,1786,317,1235,633,2551,1235,492,1352,2587,1360,2595
ͤ,QiaoTingXiang,511922227,4742,714,3343,2006,6671,3343,1351,3464,6807,3464,6807
,GuiMinXiang,511922228,1598,318,1122,716,2146,1044,488,1058,2102,1282,2404
ɳ,ShaBaXiang,511922229,4287,541,2957,1765,5847,2910,1204,2953,5863,3075,6032
,LiuWanXiang,511922230,4128,588,2724,1840,5381,2686,1156,2989,5675,3148,5872
̲,HuiTanXiang,511922231,2334,380,1664,842,3316,1653,730,1737,3390,1780,3444
,ShangLiangXiang,511922232,3376,548,2577,1604,4457,2543,1319,2567,5110,2666,5243
ذ,GuanBaXiang,511922233,3763,574,2742,1647,5460,2696,1237,2741,5437,2832,5574
կ,ZhaiPoXiang,511922234,1412,195,1069,595,2007,1061,492,1001,2062,1030,2099
ƺ,PingHeXiang,511922235,5558,834,4407,2440,8324,4366,2301,4197,8563,4286,8693
,LiuBaXiang,511922236,4879,733,3360,1949,6862,3358,1385,3632,6990,3637,6997
,JiangKouZhen,511923100,126625,12835,87233,62352,152177,85450,38936,87001,172451,91163,178396
̲,XiangTanZhen,511923101,18856,2688,13348,7380,26425,13028,5912,13531,26559,14108,27456
,XiXingZhen,511923102,10754,1927,8025,4964,15638,7883,3269,7748,15631,7925,15950
¥,FoLouZhen,511923103,9307,1798,6494,4002,13533,6481,2569,7141,13622,7180,13674
,BaiYiZhen,511923104,16854,2967,12389,8275,23977,12388,5016,12448,24836,12448,24837
ˮ,HanShuiZhen,511923105,9848,1601,7163,3925,14324,7128,3044,7265,14393,7330,14493
,YueJiaZhen,511923106,6357,1761,5217,3939,9886,5176,2381,5165,10341,5282,10499
,LanCaoZhen,511923107,12855,2122,9488,5959,19125,9485,4465,9931,19416,9954,19442
,SiMaZhen,511923108,27604,4123,19532,12105,39801,19467,8709,20638,40105,20904,40436
̹Ϫ,TanXiZhen,511923109,9181,2002,7238,4848,14512,7235,3582,7509,14744,7527,14765
Ԫɽ,YuanShanZhen,511923110,20160,3172,14711,9494,29210,14422,6484,14779,29201,15105,29816
̨,YunTaiZhen,511923111,15669,2418,11432,6250,23029,11423,5129,11770,23193,11784,23216
,QiuJiaZhen,511923112,10573,1507,8606,4781,16647,8594,4795,8227,16821,8269,16875
ɽ,BiShanZhen,511923113,21315,2934,16568,10893,32301,16487,9381,16881,33368,17062,33630
,ZhenLongZhen,511923114,14132,2365,11762,6500,21713,11683,6691,11313,22996,11426,23188
ʤ,DeShengZhen,511923115,11896,1945,8635,5729,17479,8486,3960,8969,17455,9166,17801
¹,LuMingZhen,511923116,7843,1109,5921,3226,11740,5887,2995,5955,11842,6026,11947
,QingYunXiang,511923200,10664,1871,7955,4330,15543,7914,3618,8110,16024,8198,16153
Ԫʯ,YuanShiXiang,511923201,10601,1993,7966,4977,15474,7925,3450,7946,15871,8078,16044
,LiuMenXiang,511923202,7641,1507,5835,3458,11635,5835,2561,5868,11703,5874,11709
կ,DaZhaiXiang,511923203,10296,1818,7714,4046,15361,7691,3354,7651,15342,7754,15468
,LongGangXiang,511923204,13159,2278,9568,5959,19119,9566,3808,9662,19228,9677,19245
,TuXingXiang,511923205,20686,3057,14736,9410,30242,14713,6632,15591,30304,15639,30375
,BanMiaoXiang,511923206,7839,1342,6077,3389,11774,6017,2953,5911,11928,6057,12134
,NiLongXiang,511923207,11739,1662,8903,5525,17977,8852,4686,9017,17869,9184,18087
ҿ,YanKouXiang,511923208,7959,988,5970,3154,11094,5947,3296,6172,12119,6273,12243
,WangJingXiang,511923209,8111,1251,6362,3825,12615,6315,3462,6342,12657,6462,12824
ϲ,XiShenXiang,511923210,5676,1160,4701,2921,9109,4693,2408,4514,9207,4543,9244
,TuYaXiang,511923211,9368,1691,6752,4188,13205,6732,2590,6863,13595,6897,13649
ʯ,ShiYaXiang,511923212,9011,1332,6383,3490,12536,6382,2482,6427,12809,6442,12825
,QingFengXiang,511923213,8052,1330,5843,3000,11445,5836,2357,5855,11691,5896,11739
,SiAnXiang,511923214,10036,1760,7695,4777,15482,7693,3698,7793,15486,7799,15494
�,MaAnXiang,511923215,6127,794,4534,2703,9073,4523,2585,4914,9437,4972,9506
ľ,WuMuXiang,511923216,8354,1377,6183,4040,12532,6173,2936,6447,12620,6484,12667
ɽ,LingShanXiang,511923217,7840,1172,5811,3129,11725,5773,2930,6015,11788,6131,11942
,JiePaiXiang,511923218,4562,739,3673,2325,6981,3660,1893,3435,7095,3521,7194
۱,FenBiXiang,511923219,8028,1393,5794,3320,11908,5781,2584,6159,11940,6211,12005
̲,SiTanXiang,511923220,7437,1069,5479,3211,10880,5459,2517,5455,10914,5544,11023
߷,GaoFengXiang,511923221,9103,1389,6647,3418,13275,6639,2903,6721,13360,6748,13395
Ϸ,NanFengXiang,511923222,9657,1720,7169,4477,14402,7167,3119,7317,14484,7327,14496
,FuShenXiang,511923223,7019,1241,5066,3098,10073,5063,2062,5231,10294,5256,10322
˫¹,ShuangLuXiang,511923224,6847,1162,5282,2877,10429,5233,2590,5215,10448,5317,10599
ˮ,HeiShuiXiang,511923225,3865,697,2810,1657,5737,2803,1255,2974,5777,3007,5817
ֵ´,LianHuaBanJieDaoShiChu,512002001,60286,7213,39000,29673,51395,38045,10875,37699,75744,39374,78374
ֵ´,SanXianCiJieDaoBanShiChu,512002002,40345,3156,25903,17541,22337,25014,8238,24537,49551,25836,51739
Ϫֵ´,ZiXiJieDaoBanShiChu,512002003,64488,7502,42883,33161,52928,40876,11366,38540,79416,40473,83356
ʨɽֵ´,ShiZiShanJieDaoBanShiChu,512002004,30110,4017,19657,13918,28159,18317,5569,18045,36362,20039,39696
㽭,YanJiangZhen,512002100,18978,1899,12270,6918,20259,9827,3707,9811,19638,12314,24584
,SongTaoZhen,512002101,24637,3223,16667,11487,30865,16556,5585,16532,33088,16778,33445
̨,BaoTaiZhen,512002102,24728,3391,16977,12936,32367,16932,5886,16872,33804,17028,34005
ٽ,LinJiangZhen,512002103,24750,4223,17417,13162,33928,17396,5965,17426,34822,17521,34938
,BaoHeZhen,512002104,28136,5924,20261,15436,40293,20061,6918,20467,40528,20717,40978
Ͼ,LaoJunZhen,512002105,23718,4897,17166,12916,34182,17163,6346,17783,34946,17795,34961
к,ZhongHeZhen,512002106,30002,5826,21085,14999,42754,20458,7615,21713,42171,22358,43443
ɽ,DanShanZhen,512002107,26485,6194,19762,16080,37977,19716,7114,19941,39657,20031,39793
СԺ,XiaoYuanZhen,512002108,21640,4610,16039,12426,32398,16034,6305,16513,32547,16516,32555
,KanJiaZhen,512002109,15694,3735,11823,8984,23732,11817,4594,12148,23965,12200,24023
,WuHuangZhen,512002110,27326,5796,19872,14396,39452,19783,6882,19996,39779,20132,40004
ʯ,ShiLingZhen,512002111,19462,4358,14583,11043,28876,14577,5570,14766,29343,14807,29390
,DongFengZhen,512002112,14223,3833,11772,9406,22503,11764,5340,11601,23365,11624,23396
Ͻ,NanJinZhen,512002113,22621,4863,16544,13542,32769,16511,5998,16789,33300,16938,33482
,ZhongYiZhen,512002114,16024,3652,11525,8409,23045,11460,3928,11954,23414,12079,23604
,BeiJiZhen,512002115,16567,3161,12176,8608,23534,12163,4531,12042,24205,12083,24259
ԣ,FengYuZhen,512002116,18925,4074,14260,11058,26968,14205,5234,13820,28025,13973,28233
ӭ,YingJieZhen,512002117,19818,3673,14068,10023,27837,14049,4933,14323,28372,14356,28424
,XiangFuZhen,512002118,13468,3169,10411,7574,19989,10410,3992,10203,20613,10218,20629
³,XinChangXiang,512002200,15462,2937,10504,7257,21463,10496,3323,11157,21653,11218,21722
,HuiLongXiang,512002201,9691,2676,7643,6488,14986,7629,2800,7474,15103,7524,15167
ˮ,QingShuiXiang,512002202,12502,2845,9589,7574,18597,9563,3998,9650,19213,9756,19345
Ĵ,SiChuanXuNiDiQu,512002400,2166,11,13,18,37,13,7,18,31,2171,2184
,YueYangZhen,512021100,88873,10935,60997,41377,94312,59198,21185,57927,117125,59996,120993
ԧ,YuanDaZhen,512021101,11948,2293,8293,5579,16864,8290,2925,8838,17128,8873,17166
ʯ,ShiQiaoPuZhen,512021102,15689,2266,10771,7394,20897,10667,4024,10890,21557,11208,21979
ͨ,TongXianZhen,512021103,19313,4038,13837,9927,26868,13826,4702,14159,27985,14216,28053
̨,LongTaiZhen,512021104,21844,3606,16405,12292,29058,16372,7098,16075,32447,16143,32548
Ҧ,YaoShiZhen,512021105,16948,3150,11912,6983,23793,11696,4443,12330,24026,12629,24541
ַ,LinFengZhen,512021106,13973,2938,10958,7214,21750,10938,5053,10827,21765,11006,21964
ë,MaoJiaZhen,512021107,8108,1569,6080,4278,11806,6055,2713,6264,12319,6310,12390
,YongQingZhen,512021108,18267,3271,13484,9057,26003,13335,6116,13865,27200,14170,27654
˳,YongShunZhen,512021109,16240,2997,11695,7795,23972,11488,4929,12069,23557,12471,24166
ʯ,ShiYangZhen,512021110,26352,4297,20504,12800,34850,19754,10147,19425,39179,20292,40796
,LiangBanQiaoZhen,512021111,11546,2476,8932,5559,18082,8838,4503,9415,18253,9593,18525
,HuLongZhen,512021112,14461,2779,10659,6606,21534,10550,4725,11101,21651,11306,21965
,LiJiaZhen,512021113,14587,2647,10428,6970,19906,10411,4075,10829,21240,10881,21309
Ԫ,YuanBaZhen,512021114,9084,1670,6367,4022,12623,6354,2251,6618,12972,6638,13005
¡,XingLongZhen,512021115,17529,3335,12920,9260,24796,12726,5297,13102,25828,13241,26161
,TianLinZhen,512021116,9343,1919,6757,5036,13639,6751,2672,7117,13868,7177,13934
,ZhenZiZhen,512021117,16158,3002,11571,7611,23092,11533,4487,11908,23441,12076,23647
Ļ,WenHuaZhen,512021118,13497,2665,9577,5880,18905,9049,3329,9571,18620,9914,19491
,ZhouLiZhen,512021119,16565,3007,12638,9482,25238,12527,6195,12871,25398,13129,25767
ѱ,XunLongZhen,512021120,15646,3234,10774,8461,21648,10324,3433,10879,21203,11539,22313
,HuaYanZhen,512021121,13223,2326,8995,5532,18296,8937,2927,9425,18362,9481,18476
Ǳ,ChengBeiXiang,512021200,9449,1800,6746,4503,13584,6724,2863,7249,13973,7366,14112
,ChengXiXiang,512021201,6365,1308,4468,3026,9085,4468,1524,4729,9197,4729,9197
˼,SiXianXiang,512021202,8870,1765,6239,4425,12815,6239,2300,6696,12935,6696,12935
ʯ,ShiGuXiang,512021203,5855,1462,4132,2932,8518,4130,1361,4539,8669,4546,8678
,BaMiaoXiang,512021204,11017,2675,8199,5246,16261,8025,2996,8114,16139,8489,16688
,LaiFengXiang,512021205,9488,1965,6722,4704,13405,6669,2468,7066,13735,7199,13921
,TianMaXiang,512021206,8552,1674,5873,3861,11916,5794,1955,5935,11729,6308,12181
˺,RenHeXiang,512021207,7182,1455,4671,3108,9379,4604,1478,4895,9499,5444,10115
Դ,ChangHeYuanXiang,512021208,12489,2870,8913,6287,17627,8738,3130,9102,17840,9576,18489
Ž,TuanJieXiang,512021209,5639,1415,4075,2913,8308,4002,1418,4182,8184,4397,8472
,YueLaiXiang,512021210,3596,852,2497,1630,5121,2459,842,2652,5111,2793,5290
ˮ,BaiShuiXiang,512021211,7867,1257,5689,3513,11526,5687,2560,5988,11675,5995,11684
Ʒ,YunFengXiang,512021212,5908,1510,4813,3558,9214,4808,2095,4686,9494,4700,9513
,YueXinXiang,512021213,6186,1493,4813,3668,9375,4810,1982,4846,9656,4848,9661
ƫ,PianYanXiang,512021214,7502,1521,5469,3511,11021,5465,2182,5711,11176,5736,11205
ʤ,DongShengXiang,512021215,6484,1192,4920,3059,9893,4897,2251,4973,9870,5007,9927
ƺ,PingHeXiang,512021216,4095,969,3105,2258,6241,3088,1287,3176,6264,3246,6351
Ǭ,QianLongXiang,512021217,6735,1302,5170,3304,10269,5163,2410,5269,10432,5277,10447
,GaoShengXiang,512021218,10745,2166,7904,4488,16331,7867,3629,8483,16350,8636,16540
,HengMiaoXiang,512021219,8257,1646,6268,4142,12638,6265,3102,6717,12982,6737,13005
,RuiYunXiang,512021220,7388,1499,5638,3537,11388,5518,2660,5705,11223,5909,11547
,BaiTaSiXiang,512021221,12222,2436,9931,6088,19276,9918,5308,10002,19920,10035,19966
˫,ShuangLongJieXiang,512021222,8159,1853,6443,3923,12790,6438,3148,6704,13142,6717,13160
,DingXinXiang,512021223,6930,1485,5095,3056,10590,5055,2392,5584,10639,5712,10807
ƽ,HePingXiang,512021224,5767,1249,4187,2897,8614,4187,1647,4472,8659,4476,8663
,GaoWuXiang,512021225,6734,1508,5007,2802,10085,5007,2164,5397,10404,5399,10406
,ZhongYiXiang,512021226,11658,2469,8169,5030,17109,8085,3231,8857,16942,9189,17358
,HeYiXiang,512021227,8206,1738,5735,3813,12086,5706,2300,6379,12085,6509,12244
Ŭ,NuLiXiang,512021228,6609,1630,4856,3549,9862,4855,1759,5128,9983,5142,9998
,HuJianXiang,512021229,10525,2640,8237,6163,16856,8237,3781,8707,16944,8709,16946
,QingLiuXiang,512021230,7678,1647,5630,3666,11392,5630,2268,5963,11593,5963,11593
,GongHeXiang,512021231,8037,1634,5739,3681,11583,5736,2042,5959,11695,5974,11713
챦,TianBaoXiang,512021232,6874,1491,5053,3710,10335,5052,2118,5428,10480,5430,10483
Э,XieHeXiang,512021233,8253,1941,6401,3978,12774,6388,2807,6525,12913,6600,13001
,YuLongXiang,512021234,4470,934,3244,2055,6500,3244,1224,3384,6628,3384,6628
,JianHuaXiang,512021235,6514,1249,4501,3139,9221,4498,1535,4770,9268,4797,9298
ƽ,DaPingXiang,512021236,12848,2731,9493,6665,19246,9493,3793,9879,19372,9879,19372
,JiuLongXiang,512021237,5685,1222,4062,2723,8278,4055,1548,4312,8367,4393,8455
Դ,YueYuanXiang,512021238,5101,1060,3677,2156,7206,3673,1232,3674,7347,3716,7393
,LongQiaoXiang,512021239,6607,1238,5180,3215,10237,5179,2593,5247,10426,5258,10438
ǧ,QianFoXiang,512021240,9605,2006,7102,4653,14388,7002,3029,7363,14365,7538,14640
,GongQiaoXiang,512021241,8110,1366,5609,3517,11596,5591,2295,6139,11730,6162,11771
,BaoHuaXiang,512021242,5203,1051,3773,2604,7620,3709,1655,3893,7602,4136,7909
޹,NanXunXiang,512021243,11588,2620,8970,6025,17551,8964,4067,9238,18202,9305,18275
,ZiZhiXiang,512021244,5867,1171,4028,2857,8252,4028,1343,4350,8378,4353,8381
,DaNianXiang,512021245,5704,1315,4171,2637,8276,4156,1486,4273,8429,4334,8505
,ZhaoYangXiang,512021246,5024,1010,3522,2656,6942,3502,1109,3566,7068,3621,7143
,TianChiZhen,512022100,89571,12778,60038,40545,88936,55692,17299,54584,110276,59610,119648
ʯ,ShiFoZhen,512022101,16561,4710,12358,9257,24527,12285,3851,12605,24890,12764,25122
,HuiLanZhen,512022102,14272,4306,11053,9239,21065,10949,3554,10923,21872,11079,22132
ʯ,ShiTuanZhen,512022103,14519,3820,10701,8099,21101,10671,3552,11147,21818,11190,21891
ͯ,TongJiaZhen,512022104,17241,4753,13108,10432,25523,13057,4494,13250,26307,13380,26488
,BaoLinZhen,512022105,16160,4350,12413,9420,24317,12385,4457,12463,24848,12554,24967
,DaFoZhen,512022106,15721,4412,12216,10028,24018,12014,4480,12134,24148,12397,24613
,LiangAnZhen,512022107,17802,5340,14463,12413,27722,14354,5635,14198,28552,14314,28777
˳,JinShunZhen,512022108,13229,3629,10506,7746,20401,10505,4371,10719,21224,10723,21229
кͳ,ZhongHeChangZhen,512022109,9046,2516,6934,5529,13727,6928,2489,7106,14034,7117,14051
Ͷ,LaoDongZhen,512022110,14666,3959,10748,8613,21603,10742,3411,11265,22007,11288,22036
,ZhongTianZhen,512022111,11867,3020,8771,7348,17020,8742,2813,8833,17575,8929,17700
,FoXingZhen,512022112,12259,3356,8867,7331,17961,8858,2735,9458,18316,9483,18350
,PanLongZhen,512022113,7498,1886,5541,4255,10930,5538,1814,5651,11189,5657,11198
ɽ,DongShanZhen,512022114,11347,2871,8096,5823,16406,8090,2503,8578,16668,8625,16721
ͨ,TongLvZhen,512022115,10105,2390,7411,5778,14771,7411,2613,7697,15108,7697,15108
,GaoSiZhen,512022116,14176,3895,10495,8329,21280,10482,3625,11180,21662,11201,21696
Ϫ,LongXiXiang,512022200,5590,1584,4295,3291,8593,4291,1551,4413,8704,4430,8725
ȫʤ,QuanShengXiang,512022201,5511,1487,4398,3236,8553,4359,1754,4299,8658,4354,8752
ȸ,KongQueXiang,512022202,7235,2159,5409,4739,10820,5366,1631,5497,10863,5616,11025
,LongMenXiang,512022203,8372,2692,6612,5289,12790,6530,2205,6609,13139,6657,13269
˫ӳ,ShuangHeChangXiang,512022204,9272,2310,6493,4714,13437,6478,2057,7078,13556,7146,13639
,FangShengXiang,512022205,7036,2187,5603,5091,10734,5589,1848,5437,11026,5468,11071
ʢ,ShengChiXiang,512022206,10511,2997,8282,6074,16225,8281,2999,8225,16506,8225,16507
ˮ,LiangShuiXiang,512022207,7914,2203,6068,5180,11806,6055,1935,5942,11997,5984,12052
,JianChengZhen,512081100,123687,16760,84156,59318,125332,79304,23471,75857,155161,79762,163918
ʯ,ShiQiaoZhen,512081101,42898,8406,31193,22672,56795,30171,10397,29335,59506,30508,61701
,XinShiZhen,512081102,22300,5041,17179,12411,31769,17065,6708,16670,33735,16870,34049
ʯ,ShiPanZhen,512081103,18158,3359,12974,9464,24617,12912,4475,12919,25831,13018,25992
Ϫ,DongXiZhen,512081104,24493,4311,17158,11677,29179,15866,5835,16129,31995,17481,34639
ƽȪ,PingQuanZhen,512081105,12493,2816,9590,7481,17027,9338,3540,8896,18234,9259,18849
̷,HeFengZhen,512081106,17106,4856,14498,10992,27368,14073,6478,13700,27773,13942,28440
,YunLongZhen,512081107,17040,4109,13145,9738,25987,13145,5485,13489,26634,13489,26634
,SanXingZhen,512081108,12540,2771,9505,7759,17182,9039,3717,9044,18083,9523,19028
,YangMaZhen,512081109,21620,4110,15966,11762,28436,15712,6028,15324,31036,15792,31758
ּ,JiaJiaZhen,512081110,34942,5551,24754,14759,45690,22892,8984,22777,45669,24723,49477
ʯ,ShiBanDengZhen,512081111,15774,3182,12165,8581,22311,11985,5048,11643,23628,11839,24004
,SanChaZhen,512081112,20454,3720,14782,11821,27806,14240,5192,14075,28315,14584,29366
,ZhenJinZhen,512081113,11465,2732,8786,6385,16894,8780,3196,8604,17384,8607,17393
ʯ,ShiZhongZhen,512081114,13806,3111,10097,7161,20309,10091,3759,10568,20659,10579,20676
ʩ,ShiJiaZhen,512081115,9063,2340,7287,5939,14235,7276,3216,7324,14600,7332,14619
,SanHeZhen,512081116,9194,2514,7401,5869,14536,7398,3191,7458,14856,7498,14899
ƽ,PingWuZhen,512081117,10247,2541,8193,6368,15960,8193,3612,8207,16400,8207,16400
,JinMaZhen,512081118,5259,1661,4736,3498,9005,4736,2265,4449,9185,4449,9185
̤ˮ,TaShuiZhen,512081119,8596,2464,6935,5873,13662,6935,2924,7046,13981,7049,13984
Դ,JiangYuanZhen,512081120,10239,2522,8120,6000,15696,8120,3339,7980,16100,7980,16100
ӿȪ,YongQuanZhen,512081121,6362,1946,5553,4348,10726,5551,2537,5289,10840,5292,10845
«,LuJiaZhen,512081122,15478,3197,11645,7931,23268,11645,4795,11824,23469,11825,23470
ݳ,CaoChiZhen,512081123,23918,4868,17620,12211,34928,17493,6706,17693,35186,17872,35492
̫ƽ,TaiPingQiaoZhen,512081124,5700,1306,4593,3068,8766,4548,2069,4421,8969,4482,9075
,QingLongZhen,512081125,10437,2601,8213,6243,15891,8212,3352,8176,16388,8177,16390
Ͼ,LaoJunJingXiang,512081200,3950,894,2777,1865,5609,2777,965,3031,5808,3032,5809
,FuTianXiang,512081201,9310,2106,7182,5320,14136,7180,2790,7007,14187,7024,14206
Ե,HongYuanXiang,512081202,9785,2562,8044,6511,15399,8044,3649,7949,15993,7952,15996
ܼ,ZhouJiaXiang,512081203,11881,2752,9361,6977,17982,9361,3588,8860,18221,8860,18221
ƽ,PingWoXiang,512081204,6285,1659,4748,3652,9418,4743,1721,4908,9651,4917,9665
,WuMiaoXiang,512081205,6600,1533,4903,3570,9672,4903,1930,5160,10063,5160,10063
,GaoMingXiang,512081206,6295,1666,5290,3835,10251,5288,2604,5261,10549,5275,10565
,YuChengXiang,512081207,20226,3673,14283,9985,28975,14280,5334,14941,29221,14950,29233
,DanJingXiang,512081208,4002,1045,2994,2409,5958,2990,1068,3076,6066,3121,6115
ˮ,WangShuiXiang,512081209,8456,1455,5926,3804,11864,5917,2267,6249,12166,6252,12178
,QingFengXiang,512081210,10654,2539,8377,6286,16338,8367,3530,8318,16685,8346,16723
ҹ,DongJiaGengXiang,512081211,8951,2450,7221,5136,13886,7059,2685,6576,13635,6865,14086
,WuXingXiang,512081212,6511,1653,5184,4149,10229,5184,2151,5131,10315,5131,10315
,FeiLongXiang,512081213,2995,796,2341,1863,4552,2341,889,2339,4680,2339,4680
,LingXianXiang,512081214,5934,1399,4796,3597,9250,4792,2007,4532,9324,4544,9340
ָ,WuZhiXiang,512081215,4438,1015,3215,2262,6508,3214,1167,3401,6615,3405,6620
,XinMinXiang,512081216,4586,1061,3532,2450,6876,3443,1397,3353,6796,3512,7044
,XinXingXiang,512081217,4164,1216,3451,2985,6515,3447,1572,3487,6934,3501,6952
ͬ,TongHeXiang,512081218,5348,1382,4382,3542,8611,4381,2064,4404,8785,4412,8794
,LaoLongXiang,512081219,4187,1047,3334,2606,6428,3333,1423,3323,6656,3323,6657
׳Ϫ,ZhuangXiXiang,512081220,5717,1502,4512,3294,8808,4505,1756,4459,8964,4463,8975
,HaiLuoXiang,512081221,4894,966,3706,2486,7185,3706,1559,3713,7419,3713,7419
̳,TanGuanXiang,512081222,7542,1594,5827,3895,11378,5827,2355,5664,11491,5664,11491
׼,LeiJiaXiang,512081223,5670,1553,4705,3598,8934,4705,2088,4605,9310,4606,9311
,AnLeXiang,512081224,3373,1024,2990,2413,5543,2990,1437,2844,5834,2844,5834
հ,PuAnXiang,512081225,5305,1187,3975,2764,7986,3975,1559,4054,8029,4076,8051
ƽϢ,PingXiXiang,512081226,8568,2020,7040,4979,13232,7030,3210,6744,13774,6758,13798
,WuHeXiang,512081227,4951,1665,4149,3244,8358,4147,1846,4310,8457,4313,8462
,YongNingXiang,512081228,5177,1285,4218,2940,7958,4218,1766,4010,8228,4010,8228
,WeiZhouZhen,513221100,28114,1987,17152,9382,27883,14155,4359,14413,28568,17308,34460
̌,MianTiZhen,513221101,5736,805,3759,2173,7606,3553,1304,3641,7194,4086,7845
ӳ,YingXiuZhen,513221102,2071,144,881,531,1494,759,253,824,1583,1587,2468
,WoLongZhen,513221103,1832,171,1073,606,2149,910,418,1003,1913,1348,2421
ˮĥ,ShuiMoZhen,513221105,9783,1090,5634,3057,9648,4704,1701,5160,9864,6940,12574
,XuanKouZhen,513221106,10739,1198,5881,2962,12540,4026,1660,4503,8529,7716,13597
Ϫ,LongXiXiang,513221200,2790,342,1816,973,3685,1735,592,1816,3551,1908,3724
˿,KeKuXiang,513221201,2314,253,1471,769,2965,1400,511,1516,2916,1607,3078
,YanMenXiang,513221202,5714,444,3707,1577,6094,2889,1346,3066,5955,3797,7504
,CaoPoXiang,513221203,2778,352,1820,921,3557,1689,696,1725,3414,2006,3826
,YinXingXiang,513221204,1675,226,1147,774,2221,1146,401,1154,2300,1155,2302
,GengDaXiang,513221205,2049,270,1294,739,2364,1255,538,1266,2521,1563,2857
,SanJiangXiang,513221207,3058,394,1953,1131,3708,1890,663,2029,3919,2162,4115
ӹ,ZaGuNaoZhen,513222100,11507,888,6302,3533,9635,5569,1792,5588,11157,7885,14187
,MiYaLuoZhen,513222101,1309,194,784,734,1606,758,227,892,1650,946,1730
Ŷ,GuErGouZhen,513222102,1524,214,983,547,1787,934,325,905,1839,1080,2063
Ѧ,XueChengZhen,513222103,4882,423,2562,1345,4711,2442,873,2517,4959,3616,6178
б,JiaBiXiang,513222200,799,127,508,263,980,487,129,477,964,547,1055
ͷ,PuTouXiang,513222201,3170,287,1991,1227,3385,1940,675,1969,3909,2141,4132
ʱ,GanBaoXiang,513222202,2175,255,1422,680,2780,1414,516,1434,2848,1524,2946
Ϫ,PuXiXiang,513222203,1083,120,717,345,1348,714,303,711,1425,789,1506
,ShangMengXiang,513222204,2005,240,1343,649,2683,1330,522,1395,2725,1424,2767
,XiaMengXiang,513222205,1853,176,1129,563,2245,1039,476,1184,2223,1376,2505
ľ,MuKaXiang,513222206,1231,145,786,461,1412,765,303,822,1587,893,1679
ͨ,TongHuaXiang,513222207,2182,253,1412,794,2670,1402,423,1418,2820,1446,2858
ƺ,TaoPingXiang,513222208,2200,295,1342,764,2461,1328,455,1351,2679,1608,2950
,FengYiZhen,513223100,31565,2654,20509,12218,32637,18548,7478,18702,37250,21188,41697
,NanXinZhen,513223101,5629,547,3654,2043,7147,3534,1414,3616,7150,3936,7590
Ϫ,DieXiZhen,513223102,1654,161,1177,643,2206,1146,582,1120,2266,1220,2397
μ,WeiMenXiang,513223201,2664,249,1885,1045,3688,1863,824,1832,3695,1852,3737
,YongHeXiang,513223202,2269,251,1596,836,3311,1580,802,1702,3282,1726,3322
,GouKouXiang,513223203,2201,250,1607,849,3144,1604,793,1597,3201,1637,3244
,GuangMingXiang,513223204,4020,486,2845,1364,5597,2832,1212,2851,5683,2873,5718
˳,FuShunXiang,513223205,4028,451,2733,1315,5605,2733,1188,2934,5667,2934,5667
,TuMenXiang,513223206,2859,331,1973,939,3867,1933,883,1996,3929,2100,4073
,DongXingXiang,513223207,2927,345,1947,1001,3754,1871,833,1940,3811,2158,4105
ڻ,HeiHuXiang,513223208,1510,196,1091,572,2174,1080,516,1114,2194,1131,2222
ɺ,FeiHongXiang,513223209,1446,178,986,518,1988,934,382,952,1886,1020,2006
,HuiLongXiang,513223210,1393,148,928,532,1891,907,378,960,1867,991,1919
,SanLongXiang,513223211,2015,238,1302,928,2700,1302,492,1440,2742,1443,2745
Ϫ,BaiXiXiang,513223212,1341,155,882,491,1804,872,349,941,1813,963,1845
ݵ,WaDiXiang,513223213,1040,122,771,347,1517,761,401,779,1540,792,1563
ʯ,ShiDaGuanXiang,513223214,1452,153,955,494,1945,934,406,1027,1961,1056,2011
̫ƽ,TaiPingXiang,513223215,1617,173,1102,635,2247,1089,553,1221,2310,1241,2343
ƺ,SongPingGouXiang,513223216,767,67,538,325,1047,530,262,541,1071,558,1096
,QuGuXiang,513223217,1419,150,963,490,1949,947,415,995,1942,1021,1984
Ŷ,YaDouXiang,513223218,2452,329,1742,932,3436,1705,764,1751,3456,1803,3545
,JinAnZhen,513224100,6919,520,4397,2928,7149,4276,1588,4403,8679,4630,9027
,ChuanZhuSiZhen,513224101,5337,389,3296,1436,5124,2809,1158,2889,5698,3588,6884
,JinAnHuiZuXiang,513224200,5266,484,3500,1844,3484,3462,1277,3492,6954,3527,7027
ʮ,ShiLiHuiZuXiang,513224201,2213,215,1491,763,2990,1491,712,1649,3140,1649,3140
,QingYunXiang,513224202,2610,257,1762,832,3460,1756,793,1853,3609,1898,3660
,AnHongXiang,513224203,2832,276,1949,942,3819,1924,925,2038,3962,2084,4033
կ,DaZhaiXiang,513224204,1258,152,880,315,1751,876,422,909,1785,952,1832
Ĳ,MouNiXiang,513224205,1167,114,747,351,1321,712,295,713,1425,829,1576
򽭹,ZhenJiangGuanXiang,513224206,2287,202,1633,723,2968,1579,826,1580,3159,1682,3315
ƺ,ZhenPingXiang,513224207,2408,212,1681,803,3246,1661,773,1677,3338,1712,3393
ẽ,MinJiangXiang,513224208,2124,183,1484,659,2812,1453,714,1508,2961,1537,3021
,DaXingXiang,513224209,797,81,560,244,1108,548,291,590,1138,609,1169
,BaiYangXiang,513224210,1427,221,927,641,1863,916,370,1016,1932,1091,2018
,HongTuXiang,513224211,1632,206,1123,554,2228,1102,468,1135,2237,1183,2306
,HongZhaXiang,513224212,725,76,506,219,1016,502,250,538,1040,545,1051
С,XiaoXingXiang,513224213,1098,127,780,406,1503,752,356,773,1525,801,1581
,YanYunXiang,513224214,719,90,528,244,1052,521,286,561,1082,567,1095
ɽ,ShanBaXiang,513224215,1385,181,1024,387,2004,1009,515,1029,2038,1057,2081
ˮ,ShuiJingXiang,513224216,1300,199,899,306,1645,833,333,875,1708,933,1832
С,XiaoHeXiang,513224217,2483,247,1263,652,2318,1142,479,1277,2419,1946,3209
ʩұ,ShiJiaBaoXiang,513224218,1494,252,929,546,1917,906,327,1050,1956,1144,2073
,HuangLongXiang,513224219,1191,59,655,337,778,473,174,507,980,769,1424
ϰկ,ShangBaZhaiXiang,513224220,1548,216,996,531,1942,978,456,1147,2125,1224,2220
°կ,XiaBaZhaiXiang,513224221,851,105,527,195,1001,504,221,495,999,650,1177
ԭ,CaoYuanXiang,513224222,1025,100,843,330,1551,835,498,729,1564,780,1623
عӪ,SongPanXianGuoYingMuChang,513224400,150,21,124,60,239,124,74,121,245,121,245
ҵ,SongPanLinYeJu,513224401,251,3,119,167,251,109,43,163,272,178,297
,YongLeZhen,513225100,18214,927,10777,5895,13058,9319,3939,9194,18513,12303,23080
,ZhangZhaZhen,513225101,12921,483,7474,2136,6251,3731,1542,3617,7348,7472,14946
,YongFengXiang,513225200,3592,320,2496,1161,4606,2449,1085,2464,4913,2501,4997
,YongHeXiang,513225201,2343,237,1706,840,3428,1706,899,1773,3479,1773,3479
,AnLeXiang,513225202,2324,245,1617,785,2988,1615,725,1675,3290,1677,3294
׺,BaiHeXiang,513225203,1774,194,1215,545,2364,1188,518,1238,2426,1271,2486
˫,ShuangHeXiang,513225204,3227,288,1960,894,3765,1884,740,2025,3909,2295,4255
,BaoHuaXiang,513225205,2432,203,1262,617,2479,1235,588,1277,2512,1961,3223
,LuoYiXiang,513225206,1594,205,1062,540,2184,1053,462,1182,2235,1199,2261
,WuJiaoXiang,513225207,1610,145,985,548,1852,938,485,1008,1946,1255,2240
,MaJiaXiang,513225208,834,92,524,270,1070,511,244,575,1086,646,1170
Ԫ,GuoYuanXiang,513225209,2835,358,1910,974,3789,1884,799,1992,3876,2082,3992
ݵ,CaoDiXiang,513225210,842,94,520,263,1042,494,252,573,1067,668,1188
꽭,LingJiangXiang,513225211,1066,139,662,407,1273,625,247,684,1309,790,1452
ں,HeiHeXiang,513225212,2031,226,1349,783,2580,1345,598,1387,2732,1506,2855
,YuWaXiang,513225213,1499,187,889,473,1660,804,363,851,1655,1160,2049
¼,DaLuXiang,513225214,2759,270,1335,552,2392,1217,546,1214,2431,2240,3575
կӪ,JiuZhaiGouGuoYingMuChang,513225400,23,2,13,0,0,0,3,0,0,15,28
կ羰ʤ,JiuZhaiGouFengJingMingShengGuanLiJu,513225401,750,8,366,338,316,258,66,310,568,458,824
,JinChuanZhen,513226100,12068,1005,7580,4441,12983,7152,2757,7352,14504,8250,15830
,GuanYinQiaoZhen,513226101,1620,222,1132,544,2129,1090,440,1088,2178,1150,2282
ɳ,ShaErXiang,513226200,4056,570,2795,1466,5275,2784,1005,2810,5594,2836,5631
,QingNingXiang,513226201,1365,274,992,595,1780,989,301,906,1895,948,1940
,GeErXiang,513226202,3431,470,2422,1331,4670,2421,810,2283,4704,2289,4711
,LeWuXiang,513226203,1896,279,1342,773,2493,1342,523,1356,2698,1356,2698
,WanLinXiang,513226204,1090,205,810,444,1530,807,324,804,1611,809,1619
Ӷ,HeDongXiang,513226205,723,132,560,283,1018,560,191,486,1046,486,1046
,HeXiXiang,513226206,1952,330,1415,812,2637,1414,497,1363,2777,1364,2779
,JiMuXiang,513226207,1211,213,801,413,1514,783,235,729,1512,858,1659
߽,SaWaJiaoXiang,513226208,663,110,479,270,919,479,152,446,925,446,925
,KaLaZuXiang,513226209,713,112,481,218,947,476,160,497,973,504,985
,EReXiang,513226210,2023,243,1445,646,2894,1445,642,1463,2908,1463,2908
̫,TaiYangHeXiang,513226211,444,70,309,144,581,290,129,302,592,334,643
,ErGaLiXiang,513226212,1749,244,1254,522,2517,1253,606,1326,2579,1345,2599
,AKeLiXiang,513226213,961,86,783,354,1557,771,555,801,1572,819,1602
,AnNingXiang,513226214,2640,410,1782,892,3432,1709,583,1768,3477,1851,3633
,KaSaXiang,513226215,2881,407,1952,985,4069,1943,794,2119,4062,2130,4082
,CengDaXiang,513226216,1891,250,1297,701,2500,1268,430,1257,2525,1274,2571
,DuSongXiang,513226217,1038,163,683,439,1365,666,241,708,1374,759,1442
,MaErBangXiang,513226218,900,126,617,356,1260,617,236,645,1262,645,1262
,MaNaiXiang,513226219,634,88,444,261,873,443,173,451,894,451,895
ë,MaoRiXiang,513226220,1454,146,1106,518,2224,1105,634,1127,2232,1128,2234
,MeiXingZhen,513227100,10771,898,6718,4219,10040,6116,2000,6195,12311,6951,13669
¡,RiLongZhen,513227101,2612,187,1678,1086,3120,1641,704,1680,3321,1825,3503
Ӫ,LaoYingXiang,513227200,2172,195,1446,752,2893,1435,594,1487,2922,1515,2961
,ChongDeXiang,513227201,1775,177,1198,604,2382,1195,508,1260,2455,1262,2460
,XinQiaoXiang,513227202,3103,396,1987,1209,4200,1984,772,2281,4265,2284,4271
,MeiWoXiang,513227203,2824,276,1817,965,3750,1806,768,2038,3844,2051,3868
ɳ,ShaLongXiang,513227204,1704,159,1081,635,2281,1081,462,1244,2325,1244,2325
լ¢,ZhaiLongXiang,513227205,1984,232,1303,707,2733,1279,530,1412,2691,1443,2746
¸,XinGeXiang,513227206,1695,200,1203,654,2404,1203,594,1286,2489,1286,2489
ά,DaWeiXiang,513227207,3337,320,2104,1229,4200,2092,813,2330,4422,2366,4470
ն,RiErXiang,513227208,2397,294,1540,894,3035,1518,583,1638,3156,1734,3274
˹,JieSiXiang,513227209,1778,227,1182,707,2378,1182,453,1276,2458,1276,2458
,WoRiXiang,513227210,2607,248,1725,905,3269,1710,615,1730,3440,1745,3470
ľ,MuPoXiang,513227211,2751,324,1791,1003,3631,1779,607,1860,3639,1891,3682
,LiangHeXiang,513227212,3769,380,2471,1481,5069,2468,949,2617,5085,2627,5098
,FuBianXiang,513227213,3426,334,2236,1291,4604,2236,956,2480,4716,2480,4716
˽,BaJiaoXiang,513227214,2372,296,1568,848,3121,1568,560,1660,3228,1660,3228
˫,ShuangBaiXiang,513227215,1729,185,1123,665,2233,1123,448,1239,2362,1239,2362
ѵ,WoDiXiang,513227216,1928,246,1225,684,2503,1219,467,1383,2602,1416,2641
ţ,HanNiuXiang,513227217,1496,207,979,453,1985,979,369,1093,2072,1093,2072
˰,PanAnXiang,513227218,1463,177,819,432,1650,778,328,887,1665,1149,1968
«,LuHuaZhen,513228100,10910,791,6638,4200,10764,6193,2241,6101,12294,7304,13942
,KaLongZhen,513228101,795,72,535,256,977,523,241,513,1036,573,1108
ɳʯ,ShaShiDuoXiang,513228200,1337,140,857,372,1607,824,360,775,1599,980,1837
,HongYanXiang,513228201,2517,266,1856,858,3431,1802,915,1695,3497,1842,3698
,MaWoXiang,513228202,2196,235,1488,811,2841,1465,656,1380,2845,1599,3087
˫,ShuangLiuSuoXiang,513228203,1631,128,912,440,1744,848,410,908,1756,1257,2169
߲,WaBoLiangZiXiang,513228204,1930,172,1380,660,2686,1377,718,1399,2776,1440,2820
ɫ,SeErGuXiang,513228205,1981,190,1327,618,2366,1243,642,1227,2470,1486,2813
ʯ¥,ShiDiaoLouXiang,513228206,2662,278,1977,961,3804,1977,1049,2006,3983,2012,3989
,LongBaXiang,513228207,1804,144,1234,564,2310,1203,655,1187,2390,1369,2603
,LuoDuoXiang,513228208,1449,148,1114,574,2115,1102,591,1064,2166,1074,2188
ľ,MuSuXiang,513228209,3086,348,2310,1145,4277,2310,1042,2155,4465,2166,4476
ά,WeiGuXiang,513228210,2706,183,1676,831,3205,1603,781,1607,3210,1994,3670
֪ľ,ZhiMuLinXiang,513228211,2735,316,1896,1125,3704,1854,861,1892,3746,2016,3912
,ZhaWoXiang,513228212,2905,302,2139,1101,4180,2124,1074,2106,4230,2142,4281
,QingLangXiang,513228213,2175,221,1522,781,2914,1489,727,1451,2940,1601,3123
Ȱ,CiBaXiang,513228214,669,84,485,269,929,484,235,483,967,503,988
,MaErKangZhen,513229100,24147,1489,14072,9351,19586,11847,3899,12092,23939,15463,29535
׿˻,ZhuoKeJiZhen,513229101,710,142,521,325,991,521,160,491,1012,491,1012
ɸ,SongGangZhen,513229102,1533,248,1052,564,1980,1034,323,989,2023,1052,2104
ĥ,SuoMoXiang,513229200,2154,239,1199,663,2277,1164,402,1212,2376,1596,2795
,BaiWanXiang,513229201,2278,299,1281,629,2350,1209,413,1312,2521,1709,2990
,DangBaXiang,513229202,1960,361,1229,659,2386,1197,377,1223,2420,1469,2698
ľ,MuErZongXiang,513229203,959,130,671,299,1314,671,270,680,1351,688,1359
ľ,JiaoMuZuXiang,513229204,2293,384,1648,786,3274,1634,625,1643,3277,1654,3302
ɳ,ShaErZongXiang,513229205,1517,238,1033,613,2050,1026,371,1081,2107,1093,2126
,LongErJiaXiang,513229206,1078,179,763,445,1477,763,270,758,1521,764,1527
,DaZangXiang,513229207,762,125,499,351,976,499,180,568,1067,568,1067
ɽ,KangShanXiang,513229208,1121,168,789,407,1529,787,310,800,1587,810,1599
ݵ,CaoDengXiang,513229209,2052,329,1335,675,2842,1330,572,1576,2906,1618,2953
ղ,RiBuXiang,513229210,2226,324,1667,738,3269,1667,820,1690,3357,1703,3370
,RangKeZhen,513230100,3138,121,1768,1549,2952,1719,573,1879,3598,2064,3832
,PuXiXiang,513230200,1867,236,1300,732,2498,1297,552,1331,2628,1355,2655
ڿ,ZongKeXiang,513230201,1999,240,1463,595,2857,1460,626,1397,2857,1402,2865
ʯ,ShiLiXiang,513230202,1254,144,988,403,1887,985,530,933,1918,940,1928
,WuYiXiang,513230203,1872,234,1361,605,2660,1361,639,1384,2745,1384,2745
ľ,GangMuDaXiang,513230204,2586,395,2048,754,4022,2011,1187,2072,4083,2120,4168
϶ſ,ShangDuKeXiang,513230205,2403,315,1755,813,3466,1753,843,1784,3537,1806,3561
ľ,RongMuDaXiang,513230206,1270,173,999,451,1865,981,527,946,1927,971,1970
ľ,NanMuDaXiang,513230207,2652,282,2143,796,4320,2086,1501,2238,4324,2292,4435
ض,GaDuoXiang,513230208,2904,324,2296,796,4604,2296,1383,2315,4611,2315,4611
,ZhongRangTangXiang,513230209,2508,268,1850,861,3624,1809,1094,1828,3637,2020,3870
,ShangRangTangXiang,513230210,1626,141,1263,643,2522,1263,766,1270,2533,1270,2533
,ABaZhen,513231100,11352,647,5968,4110,9513,5745,2283,6305,12050,8314,14282
۶,WaErMaXiang,513231200,2542,366,1908,610,3813,1886,1009,1994,3880,2009,3917
,MaiKunXiang,513231201,2216,281,1694,567,3386,1675,995,1743,3418,1798,3492
֧,HeZhiXiang,513231202,1931,186,1459,505,2966,1450,903,1492,2942,1561,3020
,LongCangXiang,513231203,1764,228,1319,453,2586,1288,681,1334,2622,1354,2673
,QiuJiMaXiang,513231204,1713,135,1291,540,2587,1279,791,1329,2608,1348,2639
׶,JiaErDuoXiang,513231205,1912,245,1465,437,2985,1447,878,1548,2995,1570,3035
Ī,GeMoXiang,513231206,1901,255,1567,502,3039,1567,909,1497,3064,1498,3065
¸,DeGeXiang,513231207,1135,207,920,280,1875,919,537,956,1875,959,1879
,SiWaXiang,513231208,1701,197,1288,405,2517,1258,689,1274,2532,1299,2587
,AnDouXiang,513231209,1178,161,926,301,1773,912,484,879,1791,897,1823
º,KeHeXiang,513231210,975,137,736,210,1477,736,368,744,1480,744,1480
ɳ,KuaShaXiang,513231211,828,100,702,253,1306,687,425,611,1298,651,1353
Ǽ,AnQiangXiang,513231212,1435,171,1055,454,2082,1055,493,1044,2099,1044,2099
,ChaLiXiang,513231213,2317,282,1759,725,3503,1759,970,1810,3569,1810,3569
װ,RongAnXiang,513231214,1764,228,1458,597,2841,1458,862,1396,2854,1396,2854
,LuoErDaXiang,513231215,3137,435,2478,871,4824,2461,1363,2436,4897,2457,4935
,MaiErMaXiang,513231216,3027,367,2344,992,4666,2344,1341,2391,4735,2391,4735
,JiaLuoXiang,513231217,3591,353,2854,1148,5782,2851,1896,2983,5834,2986,5840
ºũ,RuoKeHeNongChang,513231400,723,68,567,240,1119,567,364,588,1155,588,1155
ֿº,JiaKeHeMuChang,513231401,1165,107,971,382,1952,971,687,988,1959,988,1959
,DaZhaSiZhen,513232100,7909,377,4702,3246,7210,4273,1721,4734,9007,5305,10007
,BanYouXiang,513232200,3694,430,2840,1115,5653,2832,1617,2872,5704,2901,5741
,AXiXiang,513232201,3812,360,2918,1052,5697,2882,1683,2823,5705,2937,5855
ƿ,TangKeXiang,513232202,3757,326,2750,1260,5229,2718,1482,2673,5391,2815,5565
Ͻ,XiaManXiang,513232203,3920,383,3000,1116,5818,2951,1647,2827,5778,2950,5950
,HongXingXiang,513232204,4379,421,3061,1339,5888,3032,1792,2898,5930,3531,6592
Ϫ,MaiXiXiang,513232205,3485,363,2639,987,5243,2565,1475,2542,5107,2684,5323
,NenWaXiang,513232206,1967,190,1491,615,2977,1466,904,1494,2960,1570,3061
,DongLieXiang,513232207,1703,227,1374,402,2452,1224,646,1054,2278,1202,2576
,ChongErXiang,513232208,1445,241,1408,446,2440,1408,777,1055,2463,1055,2463
ȶ,ReErXiang,513232209,1402,191,1223,379,2168,1199,625,961,2160,995,2218
ռ,ZhanWaXiang,513232210,1601,206,1286,341,2631,1275,852,1349,2624,1373,2659
,JiangZhaXiang,513232211,1830,195,1407,373,2567,1373,824,1312,2685,1442,2849
,BaXiXiang,513232212,1032,173,793,346,1356,749,317,684,1433,729,1522
,AXiRongXiang,513232213,2066,250,1467,540,2928,1442,715,1426,2868,1564,3031
,QiuJiXiang,513232214,2212,304,1627,590,3218,1521,735,1454,2975,1624,3251
,BaoZuoXiang,513232215,1990,343,1544,671,3119,1539,799,1528,3067,1588,3132
׺,BaiHeMuChang,513232400,823,92,651,314,1231,651,352,616,1267,616,1267
Ͻ,XiaManMuChang,513232401,1017,108,763,310,1557,763,432,794,1557,794,1557
Ϫ,QiongXiZhen,513233100,10685,617,6131,5134,10699,5784,2191,6240,12024,7362,13493
ˢ,ShuaJingSiZhen,513233101,1055,75,615,618,1163,615,138,653,1268,653,1268
,AnQuXiang,513233200,2414,287,1962,833,3687,1962,1129,1868,3830,1868,3830
,LongRiXiang,513233201,1358,155,1011,583,1936,1000,547,1011,2011,1049,2060
,JiangRongXiang,513233202,786,96,588,312,1177,588,330,624,1212,624,1212
,ChaErMaXiang,513233203,1339,157,986,374,1889,970,539,938,1908,1049,2035
,WaQieXiang,513233204,3987,342,3065,1553,5807,2957,1773,2927,5884,3037,6102
ľ,AMuXiang,513233205,2232,231,1419,736,2717,1419,841,1388,2807,1885,3304
,RangKouXiang,513233206,653,113,453,259,809,453,210,473,926,523,976
,MaiWaXiang,513233207,2520,240,1806,835,3490,1796,947,1794,3590,1901,3707
ɫ,SeDiXiang,513233208,3940,384,2961,1469,5700,2961,1507,2870,5831,2870,5831
¯,LuChengZhen,513321100,34224,2143,18921,12668,29845,16912,5032,17222,34134,22478,41399
,GuZanZhen,513321101,16166,561,10334,3353,5500,4674,1922,4793,9467,8315,18649
¶,XinDouQiaoZhen,513321102,6074,309,3139,1485,5258,2835,1298,2935,5770,4542,7681
,YaLaXiang,513321201,3050,194,1797,818,2772,1467,649,1603,3070,2096,3893
ʱ,ShiJiXiang,513321202,1790,147,986,546,1770,949,393,970,1919,1344,2330
ǰϪ,QianXiXiang,513321203,1372,117,880,394,1680,851,355,881,1732,964,1844
,SheLianXiang,513321204,2847,86,1108,407,1819,948,463,894,1842,2288,3396
,MaiBengXiang,513321205,1999,165,1012,513,1926,962,429,1039,2001,1581,2593
,SanHeXiang,513321206,2206,216,1333,671,2656,1294,472,1400,2694,1561,2894
,JinTangXiang,513321207,2117,283,1465,827,2795,1423,689,1568,2991,1624,3089
,PengTaXiang,513321208,2937,236,1259,627,2362,1133,525,1294,2427,2439,3698
ɳ,ShaDeXiang,513321209,2556,224,1716,686,3144,1687,758,1673,3360,1822,3538
ɽ,GongGaShanXiang,513321210,2131,169,1419,545,2898,1392,681,1421,2813,1562,2981
ɳ,PuShaRongXiang,513321211,1559,167,1163,499,2264,1154,644,1155,2309,1207,2370
,JiJuXiang,513321212,1410,210,1019,412,1981,1016,507,1076,2092,1108,2127
,WaZeXiang,513321213,2968,224,1906,855,3760,1880,851,1996,3876,2137,4043
Ȱ,GaBaXiang,513321214,2566,238,1814,796,3588,1802,951,1906,3708,1941,3755
׸,JiaGenBaXiang,513321215,1786,152,1242,497,2387,1222,599,1263,2485,1295,2537
,PengBuXiXiang,513321216,2168,188,1371,489,2653,1286,586,1418,2704,1571,2942
,TaGongXiang,513321217,6040,598,4203,2061,8127,4092,2346,4275,8367,4781,8984
,KongYuXiang,513321218,4526,280,1779,940,3003,1473,593,1848,3321,3620,5399
,LuQiaoZhen,513322100,18592,2223,12303,7660,18082,11591,4485,11298,22889,12997,25300
,LengQiZhen,513322101,5806,810,3968,2800,6679,3938,1505,4077,8015,4153,8121
¡,XingLongZhen,513322102,6550,891,4527,2675,8407,4371,1740,4483,8854,4654,9181
ĥ,MoXiZhen,513322103,5275,605,3370,2085,6003,3182,1510,3470,6652,4020,7390
ᰰ,LanAnXiang,513322200,1535,230,1100,721,2174,1100,500,1165,2265,1165,2265
,PengBaXiang,513322201,2855,318,1936,1026,3686,1913,880,1968,3881,2117,4053
,TianBaXiang,513322202,3144,460,2076,1250,3876,2025,894,2222,4247,2422,4498
,ChuNiXiang,513322203,1949,272,1358,866,2506,1354,580,1437,2791,1443,2801
ӿ,JiaJunXiang,513322204,2654,335,1838,1135,3437,1834,869,1990,3824,2020,3858
,DeWeiXiang,513322205,2813,417,1958,1227,3774,1954,842,2107,4061,2114,4072
,XinXingXiang,513322206,3191,424,2363,1305,4426,2320,1223,2371,4691,2475,4838
,DeTuoXiang,513322207,4568,562,3453,2083,6698,3413,1879,3490,6903,3556,7009
¹,ZhangGuZhen,513323100,8187,703,5032,3289,7113,4712,1731,5057,9769,5589,10621
͵,BaDiXiang,513323200,3187,551,2284,1150,4378,2212,871,2144,4356,2325,4609
,BaWangXiang,513323201,1833,284,1310,764,2533,1310,492,1296,2606,1299,2609
,NieGaXiang,513323202,2268,347,1704,880,3281,1669,695,1550,3219,1606,3310
ʲ,GeShenZhaXiang,513323203,3650,494,2523,1102,4649,2370,1019,2188,4558,2640,5163
߶,BianErXiang,513323204,1495,164,941,407,1670,857,419,879,1736,1137,2078
,DanDongXiang,513323205,820,92,648,341,1222,629,399,612,1241,663,1311
,DongGuXiang,513323206,2602,271,1667,877,3136,1621,765,1698,3319,1971,3638
ˮ,ShuiZiXiang,513323207,2423,252,1676,797,3116,1609,820,1684,3293,1819,3495
,GeZongXiang,513323208,2833,343,1995,932,3815,1873,867,1851,3724,2048,4043
,SuoPoXiang,513323209,2258,285,1664,714,3208,1641,723,1568,3209,1602,3266
·,ZhongLuXiang,513323210,1925,251,1373,604,2607,1347,518,1281,2628,1321,2694
,YueZhaXiang,513323211,2802,356,1999,1004,3911,1930,913,1951,3881,2072,4071
,BanShanMenXiang,513323212,3202,416,2230,1005,4505,2109,1055,2296,4405,2443,4673
̫ƽ,TaiPingQiaoXiang,513323213,2856,323,2028,981,4057,1990,936,2035,4025,2087,4115
ȶ,GaErZhen,513324100,10746,746,6961,4091,9852,6573,3494,6913,13486,8025,14986
,TangGuXiang,513324200,1307,111,953,441,1795,913,491,896,1809,956,1909
б,XieKaXiang,513324201,1377,43,568,246,923,475,297,479,954,1149,1717
,SanYanLongXiang,513324202,1566,196,1149,646,2286,1140,587,1177,2317,1200,2349
,ShangTuanXiang,513324203,516,56,285,139,548,272,142,288,560,429,714
,BaWoLongXiang,513324204,752,113,527,285,1087,524,263,573,1097,601,1128
,NaiQuXiang,513324205,2020,206,1379,927,2639,1362,765,1428,2790,1612,2991
Ϫ,WuLaXiXiang,513324206,2829,219,1487,808,2617,1317,846,1486,2803,2407,3894
̴,YanDaiXiang,513324207,2967,335,2218,1408,4280,2212,1436,2508,4720,2520,4738
,KuiDuoXiang,513324208,3479,319,2486,1269,3974,2287,1562,2424,4711,2874,5360
Ӷ,ZiErYiZuXiang,513324209,2168,249,1685,915,3279,1665,1111,1807,3472,1843,3528
,SanYaYiZuXiang,513324210,1396,153,1170,757,2343,1170,894,1271,2441,1273,2443
,EErYiZuXiang,513324211,1169,124,986,603,2109,973,843,1123,2096,1150,2136
С,XiaoJinYiZuXiang,513324212,1400,137,1104,554,2131,1089,787,1156,2245,1220,2324
,DuoLuoYiZuXiang,513324213,718,75,545,332,1072,530,438,575,1105,686,1231
̤,TaKaYiZuXiang,513324214,2269,256,1769,1047,3616,1766,1247,1967,3733,2003,3772
,WanBaYiZuXiang,513324215,3377,327,2770,1469,5364,2715,2184,2832,5547,3118,5888
,HongBaXiang,513324216,759,45,445,248,712,402,221,379,781,580,1025
ӿ,HeKouZhen,513325100,7611,500,4618,2455,7696,3775,1757,3801,7576,5250,9868
,GaLaXiang,513325200,4391,280,1956,768,3267,1683,833,1706,3389,3548,5504
˽¥,BaJiaoLouXiang,513325201,2515,234,1803,755,3499,1798,901,1843,3641,1847,3650
հ,PuBaRongXiang,513325202,1204,116,935,542,1861,935,547,932,1867,932,1867
ףɣ,ZhuSangXiang,513325203,2362,215,1615,630,3347,1597,806,1746,3343,1768,3383
,MiLongXiang,513325204,1373,155,965,306,1988,963,520,1083,2046,1083,2048
,BaYiRongXiang,513325205,1741,193,1277,442,2538,1271,702,1331,2602,1359,2636
˹,BoSiHeXiang,513325206,795,108,557,180,1108,537,259,578,1115,605,1162
,EGuXiang,513325207,1478,161,1067,384,1994,1053,529,1062,2115,1101,2168
º,YaYiHeXiang,513325208,644,95,495,173,894,483,259,467,950,503,998
,XiELuoXiang,513325209,2067,161,1480,582,2683,1450,815,1527,2977,1563,3043
ɴ,MaLangCuoXiang,513325210,1260,106,849,302,1686,825,472,895,1720,989,1838
²,DeChaXiang,513325211,1035,75,751,254,1332,735,424,733,1468,783,1534
,HongLongXiang,513325212,2019,139,1559,608,3171,1550,1098,1675,3225,1697,3256
,KeLaXiang,513325213,1817,124,1523,669,2966,1511,1200,1587,3098,1618,3141
߶,WaDuoXiang,513325214,1389,142,1058,604,2095,1032,582,1035,2067,1055,2113
ľ,MuRongXiang,513325215,1322,151,985,407,1898,977,543,1005,1982,1031,2016
ˮ,XianShuiZhen,513326100,8120,765,5022,4082,7859,4897,1833,5183,10080,5696,10718
,BaMeiZhen,513326101,3843,320,2597,1381,5119,2564,1353,2756,5320,2919,5516
,GeXiXiang,513326200,2329,183,1632,650,2985,1499,689,1524,3023,1569,3201
,MaZiXiang,513326201,2729,203,1988,667,3640,1869,873,1801,3670,1817,3805
ɫ,KongSeXiang,513326202,1821,161,1288,421,2551,1257,636,1291,2548,1330,2618
,GeKaXiang,513326203,1551,123,1097,412,2126,1079,540,1091,2170,1117,2214
׿,YaZhuoXiang,513326204,1289,162,955,422,1845,955,467,923,1878,963,1918
,ZhongNiXiang,513326205,775,89,560,235,1112,549,290,556,1105,594,1154
춥,HongDingXiang,513326206,616,71,460,193,946,460,272,469,929,499,959
,ZhaTuoXiang,513326207,862,99,641,230,1276,637,326,617,1254,646,1287
,XiaTuoXiang,513326208,778,77,512,209,1060,507,248,549,1056,591,1103
,WaRiXiang,513326209,1170,119,800,375,1529,791,363,836,1627,852,1652
ľ,MuRuXiang,513326210,767,74,548,224,1071,543,262,528,1071,555,1103
˹,JiaSiKongXiang,513326211,1376,158,1069,361,2130,1055,633,1034,2089,1098,2167
,JiaZongXiang,513326212,815,107,490,401,1013,490,245,537,1027,677,1167
,QiMeiXiang,513326213,1221,112,978,409,1964,977,652,993,1970,1007,1985
,YinEnXiang,513326214,1463,156,1238,497,2359,1237,793,1171,2408,1174,2412
ά,WeiTaXiang,513326215,858,89,714,308,1360,708,493,704,1412,726,1440
,LongDengXiang,513326216,1343,135,1080,468,2175,1078,708,1067,2145,1106,2186
Э,XieDeXiang,513326217,1603,141,1145,541,2295,1137,657,1234,2371,1256,2401
ɫ,SeKaXiang,513326218,2169,223,1560,733,3226,1541,986,1633,3174,1818,3378
ɳ,ShaChongXiang,513326219,666,96,500,186,953,479,250,465,944,512,1012
¶,XinDouZhen,513327100,8887,900,5045,3020,8274,4270,1766,4436,8706,6508,11553
,NiBaXiang,513327200,1549,162,1095,431,2164,1058,570,1123,2181,1186,2281
ŵ,YaDeXiang,513327201,1846,128,1278,537,2479,1270,593,1286,2556,1289,2567
,LuoQiuXiang,513327202,1315,153,991,369,2023,991,613,1090,2081,1090,2081
˹ľ,SiMuXiang,513327203,1995,145,1468,495,2300,1143,578,1136,2279,1250,2718
ľ,YiMuXiang,513327204,2161,165,1472,577,2857,1419,641,1355,2774,1495,2967
ʴ,RenDaXiang,513327205,1778,165,1179,429,2256,1125,586,1099,2224,1350,2529
,ZhuWoXiang,513327206,1755,130,1183,469,2200,1159,537,1154,2313,1239,2422
,DanDouXiang,513327207,1615,116,1119,419,2192,1084,555,1088,2172,1167,2286
,ChongGuXiang,513327208,1325,92,923,313,1560,840,385,850,1690,879,1802
֪,GengZhiXiang,513327209,1020,119,752,349,1468,747,416,783,1530,803,1555
,KaNiangXiang,513327210,977,83,601,265,1139,578,289,575,1153,748,1349
,ZongTaXiang,513327211,1408,161,1103,505,2085,1086,627,1060,2146,1093,2196
,ZongMaiXiang,513327212,1787,241,1505,661,2912,1490,957,1457,2947,1480,2985
޿,ShangLuoKeMaXiang,513327213,1456,150,1189,537,2261,1161,737,1126,2287,1154,2343
޿,XiaLuoKeMaXiang,513327214,1721,182,1483,630,2833,1466,1021,1412,2878,1441,2924
,GanZiZhen,513328100,13485,791,8157,4694,11527,7185,2644,7311,14496,8763,16920
,GaLaXiang,513328200,1546,123,1117,400,2035,1099,517,1014,2113,1069,2186
ɫ,SeXiDiXiang,513328201,1572,132,1200,366,1908,1023,464,954,1977,968,2168
϶,NanDuoXiang,513328202,1009,95,777,252,1184,698,319,636,1334,646,1423
,ShengKangXiang,513328203,1630,127,1006,416,2003,987,442,986,1973,1193,2199
¡,GongLongXiang,513328204,1061,59,741,265,1316,726,391,733,1459,770,1511
,ZhaKeXiang,513328205,2199,195,1518,612,2721,1505,763,1473,2978,1639,3157
,LaiMaXiang,513328206,2418,227,1705,572,2986,1689,767,1606,3295,1707,3412
ɫ,XiSeXiang,513328207,1803,158,1321,418,2094,1197,538,1115,2312,1178,2499
,KaGongXiang,513328208,1036,104,640,266,1213,633,269,572,1205,769,1409
ʹ,RenGuoXiang,513328209,1242,86,862,367,1421,862,381,847,1709,847,1709
ϰ,TuoBaXiang,513328210,2203,171,1608,530,2844,1483,692,1399,2882,1458,3066
˹,SiEXiang,513328211,2382,180,1628,601,2802,1585,715,1530,3115,1649,3277
ͥ,TingKaXiang,513328212,1618,144,1234,344,2247,1123,520,1046,2169,1048,2282
,XiaXiongXiang,513328213,1749,187,1453,524,2492,1416,943,1370,2786,1426,2879
ͨ,SiTongDaXiang,513328214,1898,198,1270,515,2503,1247,554,1277,2524,1380,2650
,DuoDuoXiang,513328215,960,106,638,267,1236,624,263,647,1271,691,1329
,NiKeXiang,513328216,1231,140,866,323,1800,856,455,782,1638,960,1826
,ChaZhaXiang,513328217,2244,258,1712,687,2763,1691,1120,1733,3424,1910,3622
,DaDeXiang,513328218,2179,263,1711,755,2262,1703,1004,1712,3415,1735,3446
,KaLongXiang,513328219,1785,187,1411,663,2154,1411,855,1416,2827,1416,2827
,ChaLongXiang,513328220,1712,167,1393,627,2411,1376,847,1292,2668,1333,2726
,RuLongZhen,513329100,4675,378,3044,1775,5660,3038,1276,3203,6241,3285,6329
ɳ,ShaDuiXiang,513329200,1434,128,1105,320,2134,1084,636,1063,2147,1093,2198
ְ,LeAnXiang,513329201,1477,197,1089,302,1963,1089,570,1155,2244,1155,2244
,DaGaiXiang,513329202,2322,289,1700,548,3334,1700,906,1817,3517,1817,3517
³,RaoLuXiang,513329203,1361,200,1063,361,2028,1063,618,1116,2179,1116,2179
ɫ,SeWeiXiang,513329204,2005,215,1470,405,3002,1466,804,1550,3016,1554,3024
,JiaLaXiXiang,513329205,2091,203,1604,674,3193,1603,909,1599,3202,1599,3203
,LaRiMaXiang,513329206,3167,340,2614,1092,4713,2614,1818,2711,5325,2711,5325
,BoMeiXiang,513329207,1893,225,1390,364,2773,1390,680,1408,2798,1408,2798
,YouLaXiXiang,513329208,1466,163,1118,405,2178,1117,614,1123,2240,1125,2243
,ZiTuoXiXiang,513329209,1280,134,1042,309,1756,1028,615,972,2000,987,2029
ƽ,HePingXiang,513329210,1407,149,1064,327,2044,1064,524,1016,2080,1016,2080
,LuoGuXiang,513329211,926,127,743,210,1532,743,484,794,1537,794,1537
,XiongLongXiXiang,513329212,2320,314,1708,601,3491,1708,886,1812,3520,1812,3520
,MaRiXiang,513329213,982,77,746,244,1495,745,438,746,1491,751,1497
ͨ,TongXiaoXiang,513329214,1368,164,1114,442,2159,1114,654,1072,2186,1072,2186
,YouYiXiang,513329215,984,108,741,300,1466,741,382,733,1474,733,1474
Ƥ,PiCaXiang,513329216,835,83,633,194,1117,630,325,608,1238,610,1243
,YinDuoXiang,513329217,1122,160,891,267,1765,891,485,876,1767,876,1767
,GengQingZhen,513330100,7921,595,4533,3409,9170,4506,1705,4937,9443,5688,10221
,DaMaXiang,513330200,1438,134,958,525,1890,912,398,956,1868,1012,1970
,PuMaXiang,513330201,1397,169,1042,569,2029,1042,478,1002,2044,1002,2044
,YueBaXiang,513330202,1233,122,882,366,1713,863,459,914,1777,932,1814
˰,BaBangXiang,513330203,1997,184,1267,708,2560,1267,457,1371,2638,1371,2638
,GongYaXiang,513330204,2508,270,1780,871,3446,1778,739,1737,3515,1737,3517
,BaiYaXiang,513330205,1298,128,855,404,1691,842,318,884,1726,889,1744
�,WangBuDingXiang,513330206,1896,205,1406,793,2795,1397,730,1411,2808,1425,2831
嶴,KeLuoDongXiang,513330207,2846,322,2225,1291,4479,2225,1376,2319,4544,2319,4544
ɶ,KaSongDuXiang,513330208,881,135,679,290,1322,666,336,662,1328,673,1352
,ENanXiang,513330209,981,90,762,326,1432,752,385,681,1433,694,1456
,ZhuQingXiang,513330210,3584,368,2978,1468,5788,2951,2130,3044,5995,3104,6082
֧,EZhiXiang,513330211,2868,287,2067,893,3860,2067,1158,2246,4313,2246,4313
ɸ,MaNiGanGeXiang,513330212,1913,155,1494,799,2724,1472,920,1465,2937,1494,2988
¡,YuLongXiang,513330213,1450,140,1038,454,2017,1023,538,1081,2104,1090,2128
�,CuoAXiang,513330214,1384,155,1174,463,2358,1174,819,1184,2358,1184,2358
,ZhongZhaKeXiang,513330215,2962,214,2188,906,4079,2169,1283,2159,4328,2271,4459
Ȼ,RanGuXiang,513330216,1334,105,1077,441,1911,1067,779,1124,2191,1141,2218
ѹ,WoGongXiang,513330217,1348,100,1072,485,1985,1061,731,1091,2152,1107,2179
,WenTuoXiang,513330218,2328,165,1811,748,3258,1805,1149,1731,3536,1831,3642
,NianGuXiang,513330219,1928,203,1573,573,3049,1560,988,1532,3092,1546,3119
˶,LangDuoXiang,513330220,2150,212,1670,730,3163,1669,914,1600,3269,1606,3276
,AXuXiang,513330221,1822,192,1238,731,2421,1228,588,1349,2577,1364,2602
,DaGunXiang,513330222,1439,171,1137,541,2162,1137,610,1083,2220,1083,2220
Ƕ,YaDingXiang,513330223,2583,314,1888,887,3851,1877,1018,2016,3893,2027,3915
,SuoBaXiang,513330224,1176,119,927,422,1818,918,578,932,1850,946,1873
,JianSheZhen,513331100,4966,293,2968,1979,4297,2827,1249,2998,5825,3540,6508
ɳ,JinShaXiang,513331200,1602,129,1236,574,2339,1236,652,1147,2383,1147,2383
޸,RongGaiXiang,513331201,1371,132,1028,409,2005,1017,538,999,2016,1013,2041
¶,ZhangDouXiang,513331202,1690,209,1234,548,2408,1232,563,1224,2456,1228,2462
,MaRongXiang,513331203,1150,173,871,369,1746,855,458,893,1748,910,1781
,HePoXiang,513331204,2784,318,1946,677,3816,1917,795,1883,3800,1951,3897
ȼ,ReJiaXiang,513331205,3085,517,2371,747,4638,2371,1041,2272,4643,2272,4643
,DengLongXiang,513331206,1342,159,1020,404,1936,1005,465,924,1929,946,1966
,ZengKeXiang,513331207,3262,288,2205,822,4036,2180,854,2144,4324,2199,4404
,AChaXiang,513331208,8451,806,6799,883,2757,1708,916,1848,3556,3374,10173
,MaQiongXiang,513331209,2093,172,1448,667,2750,1423,973,1509,2932,1790,3238
,LiaoXiXiang,513331210,803,134,563,255,1089,563,172,546,1109,546,1109
,NaTaXiang,513331211,2251,237,1855,585,3599,1845,1148,1759,3604,1781,3636
,AnZiXiang,513331212,1617,183,1280,468,2471,1265,744,1219,2484,1264,2544
,GaiYuXiang,513331213,2341,183,1725,713,3367,1725,897,1696,3421,1696,3421
ɳ,ShaMaXiang,513331214,742,78,563,280,1056,563,285,542,1105,542,1105
ɽ,ShanYanXiang,513331215,652,68,490,216,949,490,259,489,979,489,979
,NiGaZhen,513332100,5075,221,3185,2359,4869,3116,1675,3542,6658,3786,6971
,LuoXuZhen,513332101,2781,218,1959,1281,3405,1956,1057,2088,4044,2097,4056
,ZhenDaXiang,513332200,1501,190,1173,569,2332,1173,699,1213,2386,1217,2390
,BenDaXiang,513332201,914,84,722,320,1439,718,478,743,1461,754,1476
,ZhengKeXiang,513332202,1742,177,1372,636,2606,1372,881,1428,2800,1428,2800
,MaGaXiang,513332203,1139,92,850,449,1638,842,557,919,1761,938,1788
,DeRongMaXiang,513332204,2327,230,1840,1035,3715,1840,1212,1929,3769,1929,3769
,EDuoMaXiang,513332205,4509,442,3589,2077,6943,3589,2250,3612,7201,3612,7201
ɳ,ChangShaGongMaXiang,513332206,2470,172,1734,972,3614,1725,1090,1932,3657,1998,3732
,GaYiXiang,513332207,3435,336,2570,1598,5140,2570,1398,2599,5169,2599,5169
,GeMengXiang,513332208,2286,212,1765,960,3595,1760,1130,1848,3608,1863,3628
,MengYiXiang,513332209,2530,270,1782,1031,3757,1781,962,1980,3761,1980,3762
,XinRongXiang,513332210,2007,208,1600,860,3181,1600,1037,1652,3252,1652,3252
ţ,YiNiuXiang,513332211,1336,133,1096,609,2195,1083,756,1114,2197,1129,2225
Ϻ,XiaZhaXiang,513332212,2168,197,1885,1041,3662,1884,1388,1867,3751,1868,3753
,QiWuXiang,513332213,2327,222,1895,910,3748,1895,1296,1950,3845,1950,3845
,ARiZhaXiang,513332214,3286,321,2541,1217,4839,2526,1323,2376,4902,2389,4930
빱,ChangXuGongMaXiang,513332215,1985,216,1532,736,3106,1525,911,1575,3100,1580,3112
ɳ,ChangShaGanMaXiang,513332216,1973,194,1555,694,3078,1555,917,1529,3084,1529,3084
,ChangXuGanMaXiang,513332217,1750,214,1423,603,2808,1419,1004,1539,2958,1545,2968
²,WenBoXiang,513332218,2355,278,1771,992,3536,1771,923,1785,3556,1785,3556
,WaXuXiang,513332219,2376,253,1696,875,3295,1696,738,1671,3367,1671,3367
ɫ,SeKeZhen,513333100,6853,400,4248,2796,7574,4169,2105,4643,8812,5110,9358
̴,WengDaZhen,513333101,1337,153,913,441,1782,890,435,993,1883,1012,1925
,NiDuoXiang,513333200,2404,222,1954,993,3903,1954,1283,1955,3909,1955,3909
˸,KeGeXiang,513333201,1413,119,1123,564,2279,1113,846,1167,2280,1255,2378
Ȼ,RanChongXiang,513333202,1918,200,1488,709,2867,1488,829,1459,2947,1459,2947
,KangLeXiang,513333203,1483,128,1214,569,2406,1214,820,1217,2431,1217,2431
,DaZhangXiang,513333204,1897,150,1454,799,2868,1454,842,1435,2889,1435,2889
,DaZeXiang,513333205,1977,175,1609,776,3081,1601,997,1528,3129,1540,3149
,YaLongXiang,513333206,2148,227,1656,879,3254,1648,985,1700,3348,1704,3360
,TaZiXiang,513333207,1808,175,1381,757,2723,1374,812,1399,2773,1414,2795
,NianLongXiang,513333208,1615,155,1124,668,2342,1124,583,1229,2353,1229,2353
,LuoRuoXiang,513333209,7832,857,5596,659,3318,1344,666,1395,2739,3759,9355
,HuoXiXiang,513333210,3170,360,2346,1094,4787,2346,1272,2456,4802,2456,4802
,XuRiXiang,513333211,1521,164,1063,430,2034,1059,559,1134,2193,1181,2244
,YangGeXiang,513333212,1595,201,1197,500,2421,1197,673,1272,2469,1272,2469
ѧ,JiaXueXiang,513333213,899,129,670,329,1348,670,349,707,1377,707,1377
,GeLeDuoXiang,513333214,592,65,427,177,841,427,208,438,865,438,865
߳,GaoChengZhen,513334100,20245,1250,12154,7682,13372,11990,4983,13771,25761,14324,26478
,JunBaXiang,513334200,1415,148,1099,451,2024,1099,692,1156,2255,1156,2255
,HaYiXiang,513334201,498,40,361,131,691,341,231,364,705,408,769
,JiaoWuXiang,513334202,1163,119,864,265,1654,850,443,829,1679,861,1725
Ī,MoBaXiang,513334203,512,54,398,137,755,388,212,367,755,380,778
ǻ,YaHuoXiang,513334204,926,74,698,215,1313,690,377,665,1355,679,1377
ް,RongBaXiang,513334205,678,41,552,160,1046,540,383,533,1073,550,1102
ȿ,GaKeXiang,513334206,1342,100,984,395,1962,965,571,999,1964,1029,2013
,BenGeXiang,513334207,1874,174,1383,475,2704,1372,701,1343,2715,1366,2749
,CunGeXiang,513334208,1737,139,1299,560,2386,1261,787,1298,2559,1364,2663
,HeNiXiang,513334209,1920,167,1495,561,2969,1495,961,1553,3048,1553,3048
,QuDengXiang,513334210,2274,184,1636,636,3332,1626,969,1774,3400,1791,3427
,LaMaYaXiang,513334211,1112,107,855,308,1596,831,501,836,1667,865,1720
,ZhangNaXiang,513334212,783,61,590,212,1110,590,345,599,1189,599,1189
ľ,ShangMuLaXiang,513334213,1026,72,714,259,1363,692,425,785,1477,809,1523
ľ,XiaMuLaXiang,513334214,1438,115,1039,357,2021,1019,555,1055,2074,1069,2108
ľ,ZhongMuLaXiang,513334215,1494,124,1021,338,2009,1003,487,1051,2054,1084,2105
۰,XiongBaXiang,513334216,1590,125,1132,414,2182,1091,643,1192,2283,1226,2358
,JiaWaXiang,513334217,1128,100,778,334,1531,760,427,845,1605,877,1655
ذ,CangBaXiang,513334218,784,63,571,242,1097,558,327,575,1133,603,1174
ľ,GeMuXiang,513334219,1454,99,986,477,1963,977,496,1043,2020,1063,2049
,LaBoXiang,513334220,1322,136,988,411,1827,952,484,909,1861,954,1942
,MaiWaXiang,513334221,741,75,550,224,1043,539,281,522,1061,547,1097
,DeWuXiang,513334222,1147,72,862,347,1651,852,523,860,1712,880,1742
,XiaQiongZhen,513335100,9964,738,6599,3694,9603,6084,2474,6163,12247,6577,13176
,LaWaXiang,513335200,978,100,707,319,1443,707,393,764,1471,764,1471
,DangBaXiang,513335201,1772,138,1252,483,2514,1249,665,1317,2566,1323,2575
,ZhuBaLongXiang,513335202,1113,122,805,337,1499,797,398,819,1616,828,1633
,ZhongXinRongXiang,513335203,1415,123,1014,427,1867,1014,446,970,1984,970,1984
,SuWaLongXiang,513335204,2007,240,1488,568,2736,1480,642,1398,2878,1401,2889
,ChangBoXiang,513335205,1167,130,826,320,1677,826,438,909,1735,909,1735
,DiWuXiang,513335206,1252,116,925,397,1731,925,431,874,1799,874,1799
,ZhongZanXiang,513335207,3353,242,2276,918,4355,2276,1118,2429,4705,2437,4713
չ,YaRiGongXiang,513335208,2180,127,1606,667,3157,1593,968,1641,3234,1669,3275
,BoMiXiang,513335209,1170,72,835,362,1794,833,568,970,1803,975,1810
Ī,MoDuoXiang,513335210,1042,85,788,284,1476,779,443,759,1538,782,1570
ɶ,SongDuoXiang,513335211,1486,112,979,334,1984,959,447,998,1957,1066,2045
Ϫ,BoGeXiXiang,513335212,1272,120,1024,413,1990,1005,669,1010,2015,1037,2061
Ӣ,JiaYingXiang,513335213,389,46,319,139,642,319,229,345,664,345,664
,CuoLaXiang,513335214,972,81,707,393,1307,707,392,738,1445,738,1445
,ChaLuoXiang,513335215,918,61,684,294,1273,684,340,635,1319,635,1319
,LieYiXiang,513335216,554,58,399,209,785,399,222,435,834,435,834
´,DeDaXiang,513335217,1059,80,844,371,1615,844,512,807,1651,807,1651
,XiangBaLaZhen,513336100,7171,346,4037,2089,6632,3887,1457,4143,8030,4937,8974
˹,NiSiXiang,513336200,1842,140,1098,360,2036,1053,497,1116,2169,1381,2479
ɳ,ShaGongXiang,513336201,1333,88,600,140,1094,529,281,573,1102,1102,1702
ˮ,ShuiWaXiang,513336202,2020,163,1213,384,2371,1176,641,1290,2466,1611,2824
,QingDeXiang,513336203,1912,182,1299,383,2448,1272,641,1258,2530,1436,2735
,QingMaiXiang,513336204,1711,173,1239,318,2306,1200,617,1133,2333,1262,2501
Ȼ,RanWuXiang,513336205,1363,113,990,320,1920,964,460,915,1879,946,1936
,DongSongXiang,513336206,961,118,727,235,1344,721,381,684,1405,733,1460
ȴ,ReDaXiang,513336207,2412,169,1717,517,3482,1701,940,1789,3490,1804,3521
,DingBoXiang,513336208,1067,66,716,236,1469,710,420,767,1477,837,1553
,ZhengDouXiang,513336209,1451,125,1110,372,2039,1093,551,997,2090,1017,2127
,BaiYiXiang,513336210,914,84,661,206,1312,646,360,675,1321,697,1358
,JinZhuZhen,513337100,5785,312,3545,2158,5629,3349,1456,3518,6867,4008,7553
,XiangGeLiLaZhen,513337101,2181,186,1523,519,2667,1442,664,1323,2765,1508,3031
ɣ,SangDuiXiang,513337200,1813,144,1272,477,2492,1239,623,1255,2494,1308,2580
ʡĸ,ShengMuXiang,513337201,1205,119,868,337,1585,849,388,828,1677,844,1712
,BangHeXiang,513337202,1112,105,756,244,1495,732,335,748,1480,796,1552
ɫ,SeLaXiang,513337203,1251,107,895,331,1715,879,427,876,1755,890,1785
,JuLongXiang,513337204,1358,107,976,347,1877,958,492,934,1892,981,1957
˲,DengBoXiang,513337205,629,44,475,163,977,464,307,474,938,505,980
ľ,MuLaXiang,513337206,1192,122,865,307,1686,865,461,910,1775,910,1775
,ChiTuXiang,513337207,1824,183,1314,449,2532,1292,658,1312,2604,1351,2665
,MengZiXiang,513337209,1358,170,1020,441,1899,995,433,899,1894,941,1961
,GeKaXiang,513337210,566,66,410,153,762,401,174,387,788,396,806
,JiGaXiang,513337211,1011,102,737,270,1367,715,329,668,1383,705,1442
ͬ,EYaTongXiang,513337212,911,98,677,246,1271,676,305,619,1295,637,1314
,SongMaiZhen,513338100,3634,217,2213,1325,3782,2148,875,2242,4390,2513,4726
˹բ,SiZhaXiang,513338200,815,109,624,232,1214,624,295,595,1219,595,1219
,XuLongXiang,513338201,1040,154,712,230,1491,707,343,816,1523,825,1537
,RiLongXiang,513338202,915,118,634,196,1248,619,279,644,1263,678,1312
Ź,QuYaGongXiang,513338203,1063,151,767,220,1475,742,324,738,1480,771,1538
,BenDouXiang,513338204,1461,200,1097,318,2065,1077,459,997,2074,1023,2120
,BaRiXiang,513338205,920,148,668,229,1320,644,322,692,1336,722,1390
ѧ,GuXueXiang,513338206,1801,287,1281,362,2504,1248,584,1280,2528,1391,2672
Ӹ,ZiGengXiang,513338207,1311,154,928,316,1699,863,426,859,1722,963,1891
,GongBoXiang,513338208,909,109,650,207,1257,636,259,602,1238,627,1277
,BaiSongXiang,513338209,2614,283,1856,559,3646,1819,797,1814,3633,1838,3694
,CiWuXiang,513338210,1980,159,1376,462,2661,1341,694,1343,2684,1457,2833
ǽֵ´,BeiChengJieDaoBanShiChu,513401001,24839,4026,17236,11408,15703,14773,4577,14028,28801,16206,33442
ǽֵ´,XiChengJieDaoBanShiChu,513401002,48078,7254,33183,25517,26557,32206,9747,30776,62982,31896,65079
ǽֵ´,DongChengJieDaoBanShiChu,513401003,30798,5057,21597,14473,16837,18294,5122,17752,36046,19380,40977
ֵ´,ChangAnJieDaoBanShiChu,513401004,20813,2025,9321,7326,8408,8785,2675,8502,17287,16192,25513
´ֵ´,XinCunJieDaoBanShiChu,513401005,13359,954,7851,3429,2494,5150,1914,5280,10430,8376,16227
ֵ´,ChangNingJieDaoBanShiChu,513401006,4366,747,2752,2419,4124,2720,717,2871,5591,3078,5830
,MaDaoZhen,513401100,14343,2231,9359,6886,14233,8870,2853,9300,18170,10068,19427
,LiZhouZhen,513401101,17141,2187,11756,6643,18526,11019,4223,11178,22197,11795,23551
,AnNingZhen,513401102,28201,2055,16198,7109,20190,11610,4723,11960,23570,18781,34979
,ChuanXingZhen,513401103,21145,2285,14582,6882,22142,12674,5737,12671,25345,14585,29167
,HuangLianGuanZhen,513401104,9406,890,6730,3190,10298,6590,3325,6759,13349,6891,13621
Ӿ,YouJunZhen,513401105,10277,1315,6976,3994,11968,6924,2909,7275,14199,7525,14501
̫,TaiHeZhen,513401106,12142,1624,8212,5007,13534,8178,3146,8595,16773,8700,16912
,AnHaZhen,513401107,3366,241,2834,1476,3951,2831,2155,2909,5740,2928,5762
,XiJiaoXiang,513401200,42512,5115,27704,20047,15075,26325,9275,26816,53141,29198,56902
,GaoJianXiang,513401201,12903,1634,8786,5207,12611,8542,3441,8575,17117,9192,17978
С,XiaoMiaoXiang,513401202,17237,1841,11242,6443,17040,10947,4281,11333,22280,12117,23359
ĺ,SiHeXiang,513401203,7317,388,5680,2905,8245,5679,4218,6242,11921,6243,11923
»,YueHuaXiang,513401204,11010,1423,7824,4367,13064,7796,3402,7978,15774,8011,15835
ʤ,XingShengXiang,513401205,13053,1760,9127,4934,15840,9080,3821,9449,18529,9507,18634
Ż,LangHuanXiang,513401206,4916,790,3446,1938,6068,3446,1361,3621,7067,3621,7067
ʤ,MinShengXiang,513401207,5833,508,4761,2349,7182,4753,3564,5135,9888,5144,9905
,XiXiangXiang,513401208,14679,1752,9991,5250,16742,9900,3952,10214,20114,10392,20383
ľ,ZhangMuQingXiang,513401209,9262,1341,6290,3788,10641,6249,2682,6941,13190,6995,13285
ˮ,XiangShuiXiang,513401210,5684,418,4640,2204,6581,4633,3306,4751,9384,4768,9408
Ԫ,KaiYuanXiang,513401211,5874,391,4674,2070,6277,4659,3239,4803,9462,4830,9504
,DaXingXiang,513401212,4405,577,3142,1727,5277,3138,1443,3281,6419,3283,6425
,HaiNanXiang,513401213,5137,706,3500,2123,6120,3443,1336,3594,7037,3679,7179
,DaQingXiang,513401214,3682,284,3037,1368,5109,3037,2146,3075,6112,3075,6112
,JingJiuXiang,513401215,11204,1080,6746,3384,10443,6112,2742,6342,12454,8280,15026
Ϫ,XiXiXiang,513401216,11341,1403,8117,4450,9111,8076,3860,8371,16447,8487,16604
ˮ,HuangShuiXiang,513401217,4791,569,3494,1807,5211,3476,1716,3542,7018,3582,7076
Ų,LuoGuBoXiang,513401218,6810,387,5541,2349,7456,5489,4086,5667,11156,5742,11283
ԣ¡,YuLongHuiZuXiang,513401219,11646,1599,7819,4033,14409,7647,2880,7952,15599,8306,16125
߲ݻ,GaoCaoHuiZuXiang,513401220,9923,1281,6679,3404,12183,6531,2454,6781,13312,6979,13658
а,ZhongBaXiang,513401221,6659,868,4664,2518,7444,4629,2022,4858,9487,4885,9549
,AQiXiang,513401222,4609,654,3301,1808,4926,3271,1534,3463,6734,3496,6797
,QiaoDiXiang,513401223,4070,271,3385,1393,3764,3350,2662,3565,6915,3618,7003
ĥ,MoPanXiang,513401224,7284,552,5954,2780,7515,5953,4350,6232,12185,6232,12186
,BaRuXiang,513401225,2493,206,1877,850,3088,1843,1211,1931,3774,2033,3910
,YinChangXiang,513401226,1945,225,1507,678,2920,1490,1063,1699,3189,1726,3233
,BaiMaXiang,513401227,3399,191,1987,801,3318,1875,1370,2056,3931,2973,4960
�ɽ,MaAnShanXiang,513401228,3730,291,2986,1184,4186,2965,2116,3081,6046,3151,6137
,QiaoWaZhen,513422100,15304,987,9932,5828,15494,9539,3965,9533,19072,10324,20256
߳,WaChangZhen,513422101,3993,357,2510,1314,5119,2488,1074,2765,5253,2914,5424
貼,ChaBuLangZhen,513422102,2270,207,1574,793,2940,1548,671,1523,3071,1574,3148
,BoKeXiang,513422201,3165,312,2131,1049,4309,2115,1040,2293,4408,2386,4517
,NingLangXiang,513422202,1368,154,1009,434,1982,1001,575,1066,2067,1088,2097
,YiJiXiang,513422203,2091,210,1583,554,3182,1583,999,1713,3296,1717,3300
,EYaXiang,513422204,3797,402,2740,951,5541,2732,1542,2959,5691,3001,5741
ˮ,ShuiLuoXiang,513422205,4895,413,2838,942,5363,2756,1285,2737,5493,3755,6593
ţƺ,MaoNiuPingXiang,513422206,2024,170,1536,851,3003,1536,973,1631,3167,1631,3167
ݽ,WuJiaoXiang,513422207,1383,167,1091,459,2136,1081,651,1080,2161,1110,2201
,XiangJiaoXiang,513422208,2143,171,1506,707,3060,1503,810,1616,3119,1618,3124
ƺ,LiZiPingXiang,513422209,2603,167,1889,965,3707,1889,1041,1922,3811,1922,3811
,LieWaXiang,513422210,2447,222,1788,893,3555,1781,1025,1902,3683,1906,3694
ѿ,YaZuXiang,513422211,2024,156,1492,709,2744,1475,905,1565,3040,1593,3085
,XiaMaiDiXiang,513422212,1940,198,1567,794,3021,1563,1025,1584,3147,1596,3163
,XiQiuXiang,513422213,1766,217,1250,664,2458,1212,569,1265,2477,1302,2552
˶,KeErXiang,513422214,2477,229,1755,839,3463,1721,950,1830,3551,1901,3656
׵,BaiDiaoXiang,513422215,3757,368,2709,1190,4985,2709,1596,3012,5721,3012,5721
,SanJueYaXiang,513422216,2901,312,2054,898,4177,2053,1171,2318,4371,2330,4384
,LuoBoXiang,513422217,5032,361,3012,1634,5310,2808,1648,3175,5983,4029,7041
,KaLaXiang,513422218,3394,281,2034,919,3969,1980,917,2104,4084,2558,4592
,HouSuoXiang,513422219,3529,355,2606,1271,5124,2582,1548,2784,5366,2826,5432
ɳ,ShaWanXiang,513422220,4192,283,2449,1061,4725,2388,1172,2436,4824,3198,5647
,GuZengXiang,513422222,2396,221,1610,737,3173,1590,735,1662,3252,1742,3352
,MaiRiXiang,513422223,1937,186,1388,499,2664,1378,655,1348,2726,1390,2778
,DongLangXiang,513422224,1750,188,1312,463,2453,1303,653,1259,2562,1279,2591
,TangYangXiang,513422225,5119,264,2350,896,4372,2155,1309,2285,4440,4342,6692
,BoWoXiang,513422226,1184,145,814,351,1638,801,374,837,1638,889,1703
,MaiDiLongXiang,513422227,1605,174,1095,564,2228,1076,485,1114,2190,1169,2264
ξ,YanJingZhen,513423100,34275,2355,23009,12750,30498,20876,10750,22130,43006,24371,47380
,WeiChengZhen,513423101,15000,1480,10897,5399,20831,10833,5733,11187,22020,11316,22213
÷,MeiYuZhen,513423102,16661,1465,11415,6213,21695,11404,5849,12534,23938,12560,23975
,BaiWuZhen,513423103,10129,955,8102,4300,15400,8088,5608,8529,16617,8590,16692
,ShuHeZhen,513423104,5910,658,4066,2325,7860,3948,2267,4487,8435,4769,8835
Ʋ,HuangCaoZhen,513423105,6151,663,4903,2440,9000,4903,3261,5169,10072,5172,10075
ƽ,PingChuanZhen,513423106,10499,831,7507,4419,13400,7222,4940,7756,14978,8763,16270
,LuGuHuZhen,513423107,7059,816,5453,2703,9906,5452,2856,5274,10726,5278,10731
˫,ShuangHeXiang,513423200,14545,1543,10063,5120,18414,10041,4736,10690,20731,10761,20824
ɺ,GanHaiXiang,513423201,11973,1315,8279,4149,15336,8226,3853,8769,16995,8862,17141
º,XiaHaiXiang,513423202,8833,983,6464,3421,11784,6464,3562,6911,13375,6914,13378
,MianYaXiang,513423203,10139,906,7910,3685,15281,7908,5223,8350,16258,8358,16268
,GanTangXiang,513423204,4223,517,2865,1617,5928,2862,1526,3389,6251,3401,6266
¹,MaLuXiang,513423205,2011,333,1328,746,2901,1321,656,1656,2977,1672,3000
,TengQiaoXiang,513423206,1977,357,1363,783,2855,1357,718,1669,3026,1689,3052
,TianWanXiang,513423207,1966,277,1375,720,2667,1365,800,1625,2990,1668,3043
ʯ,DeShiXiang,513423208,2274,192,1715,812,3490,1712,1166,1892,3604,1917,3632
,DaHeXiang,513423209,6648,617,5470,2809,9643,5466,3884,5678,11144,5679,11149
,YanTangXiang,513423210,4561,361,3461,1812,5998,3388,2413,3545,6933,3874,7335
ľ,WuMuXiang,513423211,3338,335,2689,1225,5227,2689,1941,2925,5614,2925,5614
,DaCaoXiang,513423212,2233,176,1663,783,3152,1633,1121,1726,3359,1867,3530
,BoDaXiang,513423213,4511,390,3420,1940,6205,3394,2383,3759,7153,3864,7284
,JinHeXiang,513423214,5980,586,4567,2278,8328,4539,2905,4781,9320,4904,9471
,YouSuoXiang,513423215,4423,411,3180,1639,6603,3177,1973,3608,6785,3627,6807
,BaZheXiang,513423216,3727,251,2680,1198,5175,2622,1928,2918,5540,3226,5906
,ASaXiang,513423217,1536,151,1159,619,2334,1159,731,1247,2406,1259,2418
,ChangBaiXiang,513423218,5641,670,4087,1985,8464,4075,2410,4598,8673,4634,8721
,TaoZiXiang,513423219,3128,284,2377,1197,4525,2349,1629,2488,4837,2664,5041
,GaiZuXiang,513423220,2789,307,2205,1053,4235,2182,1409,2266,4448,2300,4505
ǰ,QianSuoXiang,513423221,3998,415,3051,1268,6014,3047,1719,3058,6105,3081,6132
ֵ,WoDiXiang,513423222,3072,252,2288,1068,4468,2264,1539,2509,4773,2575,4863
ɹ,DaPoMengGuZuXiang,513423223,2352,242,1630,701,3364,1623,864,1807,3430,1828,3458
,WaLiXiang,513423224,11227,279,2833,1547,3386,2107,953,2762,4869,9626,12459
÷ƺ,MeiZiPingXiang,513423225,1701,128,1277,654,2448,1274,879,1418,2692,1431,2708
,DeZhouZhen,513424100,46237,5154,31347,19069,46615,29900,11561,29856,59756,31605,62952
,YongLangZhen,513424101,6468,792,4418,2525,7118,4178,1960,4388,8566,4802,9220
Ծ,LeYueZhen,513424102,7222,856,5159,2682,9913,5100,2405,5225,10325,5324,10483
,MaLiXiang,513424200,6241,719,4281,2235,7244,4198,1785,4325,8523,4464,8745
,AYueXiang,513424201,6318,782,4279,2122,7897,4270,1651,4457,8727,4472,8751
,WangSuoXiang,513424202,9058,1075,6118,3167,11609,6060,2177,6110,12170,6192,12310
,LiuSuoXiang,513424203,8377,1056,5423,2739,10681,5338,1761,5644,10982,5771,11194
Ͷ,BaDongXiang,513424204,6708,835,4443,2432,8313,4415,1740,4749,9164,4840,9283
ԣ,KuanYuXiang,513424205,7340,873,5033,2459,9450,4935,1977,5020,9955,5157,10190
Ĵ,CiDaXiang,513424206,8664,952,6085,3341,11367,6052,2750,6194,12246,6281,12366
С,XiaoGaoXiang,513424207,8097,956,5691,2804,10390,5650,2604,5882,11532,5966,11657
,JinChuanXiang,513424208,5373,693,3612,2130,5844,3547,1540,3757,7304,3994,7606
,LaoNianXiang,513424209,4726,658,3209,1841,6449,3199,1362,3527,6726,3537,6746
,DaWanXiang,513424210,1620,135,1170,594,2236,1170,704,1289,2459,1289,2459
�,MaAnXiang,513424211,1923,124,1533,784,2939,1533,1057,1571,3104,1571,3104
¯,TieLuXiang,513424212,3571,260,2705,1372,4582,2698,1767,2864,5562,2893,5598
ǰɽ,QianShanXiang,513424213,2179,189,1688,774,3057,1657,1081,1706,3363,1761,3449
ɽ,DaShanXiang,513424214,1436,127,1107,541,2070,1100,710,1151,2251,1166,2273
,DaLiuCaoXiang,513424215,1542,114,1124,590,2109,1124,701,1233,2357,1233,2357
Ⱥ,ReHeXiang,513424216,3346,332,2345,1187,4441,2317,1217,2500,4817,2550,4895
ɽ,NanShanLiLiZuXiang,513424217,1290,113,892,424,1811,892,436,947,1839,947,1839
ɳ,JinShaLiLiZuXiang,513424218,2119,149,1443,668,2977,1433,749,1547,2980,1574,3017
¹,YinLuXiang,513424219,2471,215,1936,963,3513,1901,1225,1924,3825,1975,3911
ǹ,ChengGuanZhen,513425100,22438,3573,15526,10783,18261,13986,4169,13083,27069,14654,30180
¹,LuChangZhen,513425101,11315,1650,8044,4533,14907,8024,3261,8154,16178,8182,16226
Ϫ,LiXiZhen,513425102,10947,1577,7453,4171,13615,7144,3079,7491,14635,8150,15603
ͨ,TongAnZhen,513425103,8526,1179,5887,3205,11237,5749,2397,6012,11761,6215,12102
̫ƽ,TaiPingZhen,513425104,8849,1440,6064,3452,12384,6042,2690,6881,12923,6915,12979
,YiMenZhen,513425105,8316,1222,5626,3912,9979,5609,2161,6019,11628,6073,11699
Ԫ,GuoYuanXiang,513425200,29037,3048,18968,9577,26843,16177,6300,16249,32426,19417,38385
ϸ,NanGeXiang,513425201,9964,1233,6771,3710,13204,6687,2730,7029,13716,7156,13927
ڶ,NeiDongXiang,513425202,7057,930,4729,2389,9377,4728,1835,5090,9818,5093,9822
Ͻ,LaoJieXiang,513425203,11700,1511,8246,4343,14545,8154,3279,8108,16262,8244,16490
ⱱ,WaiBeiXiang,513425204,8110,1097,5684,2870,11163,5682,2416,5937,11619,5939,11623
ù,ZhangGuanXiang,513425205,10550,1451,7103,3883,14260,7040,2755,7561,14601,7653,14756
,AiMinXiang,513425206,7240,1010,4899,2617,9955,4899,2023,5374,10273,5374,10273
,AiGuoXiang,513425207,2513,418,1742,969,3493,1741,740,1925,3666,1929,3671
Ӫ,FengYingXiang,513425208,3886,619,2660,1415,5373,2643,998,2795,5438,2843,5503
׼,BaiJiXiang,513425209,2894,448,1953,1008,3998,1953,730,2118,4071,2119,4072
,AiLangXiang,513425210,2442,355,1594,944,3207,1592,632,1832,3424,1835,3429
С,XiaoHeiQingXiang,513425211,4306,310,3136,1419,5237,3077,1798,2951,6028,3278,6414
ӿ,HeKouXiang,513425212,5540,1040,4211,2543,8434,4191,2073,4403,8594,4442,8653
г,ZhongChangXiang,513425213,4158,634,2889,1788,5909,2884,1269,3147,6031,3172,6061
غ,GuanHeXiang,513425214,7141,1254,4945,3102,9608,4915,1843,5171,10086,5293,10238
,YuZhaXiang,513425215,2751,385,1740,923,3508,1722,629,1888,3610,2025,3765
ˮ,LvShuiXiang,513425216,8555,939,5145,3110,9408,4817,1961,5061,9878,6310,11455
,LiHongXiang,513425217,2431,358,1625,919,3374,1623,650,1791,3414,1814,3439
,JinYuXiang,513425218,1907,355,1284,786,2656,1284,485,1462,2746,1463,2747
,ShuBaoXiang,513425219,4031,578,2840,1792,5675,2840,1261,3030,5870,3030,5870
,JiangZhuXiang,513425220,2686,390,1866,1142,3788,1866,794,2004,3870,2004,3870
°,XinAnDaiZuXiang,513425221,2597,377,1823,1284,3667,1823,761,1910,3733,1912,3735
¡,PuLongXiang,513425222,2648,449,1985,1187,3756,1963,887,1958,3921,1999,3984
,ZhuQingXiang,513425223,4904,735,3417,1790,6811,3391,1533,3701,7092,3755,7172
·,XinFaXiang,513425224,10869,1846,7747,4089,15491,7647,3281,8076,15723,8249,15996
Ұ,YangJiaBaXiang,513425225,5812,1168,4313,2347,8494,4282,1826,4430,8712,4493,8806
,JiangPuXiang,513425226,2368,504,1761,937,3480,1754,745,1822,3576,1856,3617
ľ,MuGuXiang,513425227,6321,990,4256,2226,8609,4239,1780,4792,9031,4835,9091
,FuLeXiang,513425228,7662,1196,5340,2739,10709,5306,2326,5784,11090,5844,11184
,HaiChaoXiang,513425229,4314,689,3031,1687,6000,3030,1305,3271,6301,3277,6308
Ž,BaJiaoXiang,513425230,2339,424,1614,938,3302,1608,753,1866,3474,1902,3516
ɽ,HengShanXiang,513425231,5446,955,3804,2083,7786,3794,1693,4265,8059,4290,8094
,MaZongXiang,513425232,1399,314,1021,647,2124,1010,496,1171,2181,1188,2209
ƺ,FaPingXiang,513425233,1203,234,844,479,1807,842,416,1002,1844,1009,1853
Ԫ,CaoYuanXiang,513425234,2264,351,1674,932,3394,1666,942,1859,3525,1883,3557
ư,HuangBoXiang,513425235,760,64,632,291,1171,632,488,676,1308,680,1312
Ƶ,YunDianXiang,513425236,11210,1448,7743,4584,13576,7663,3200,7938,15601,8115,15858
,CangTianXiang,513425237,4730,410,3506,1733,6335,3463,2153,3664,7127,3787,7293
׹,BaiGuoWanXiang,513425238,5598,708,3690,2197,7281,3651,1530,4067,7718,4146,7836
´,XiaCunXiang,513425239,3996,612,2793,1653,5587,2781,1302,3091,5872,3117,5910
Ȫ,LongQuanXiang,513425240,2282,158,1774,771,3344,1774,1072,1738,3512,1738,3512
,LiuHuaXiang,513425241,2171,176,1579,735,3202,1575,962,1700,3275,1730,3309
,SanDiXiang,513425242,596,70,418,247,855,418,238,486,904,486,904
,LiuMinXiang,513425243,1100,129,832,461,1720,826,529,910,1736,926,1758
ᶫ,HuiDongZhen,513426100,31461,3005,21981,13575,25805,21027,10482,21792,42819,22967,44948
Ǧп,QianXinZhen,513426101,9976,1554,6996,4935,13231,6960,3484,7967,14927,8018,15014
С,XiaoChaHeXiang,513426200,7353,1026,5352,2660,10995,5334,2829,5804,11138,5856,11208
,SaZheYiXiang,513426201,2397,446,1617,895,3670,1612,836,2048,3660,2062,3679
,XinYunXiang,513426202,7001,883,4858,2490,9932,4857,2505,5527,10384,5531,10389
,ChangXinXiang,513426203,2629,437,1755,974,3872,1749,862,2139,3888,2173,3928
ɽ,HuoShanXiang,513426204,2440,400,1787,918,3675,1782,1032,2073,3855,2085,3872
¸,DuGeXiang,513426205,6037,1101,4177,2160,9091,4148,2174,5081,9229,5135,9312
ƺ,PingTangXiang,513426206,2411,508,1920,989,3973,1918,1240,2223,4141,2239,4159
,JiangZhouXiang,513426207,7311,1090,5293,3166,10592,5256,2485,5505,10761,5593,10886
,ZhongXinXiang,513426208,5092,701,3512,1980,7299,3507,1551,3820,7327,3832,7344
С,XiaoBaXiang,513426209,6488,982,4583,2641,9436,4562,2105,4970,9532,4992,9575
ʯ,HuoShiXiang,513426210,2532,420,1764,1062,3629,1745,819,1958,3703,2007,3771
,TieLiuXiang,513426211,5688,756,4006,2057,8124,3958,1998,4321,8279,4436,8442
,LongShuXiang,513426212,2771,355,2072,1202,4029,2063,1147,2176,4239,2201,4273
ɺ,KeHeXiang,513426213,3015,503,2264,1356,4476,2247,1131,2342,4589,2385,4649
¼,GaJiXiang,513426214,6605,962,4732,2547,9350,4662,2435,5147,9809,5270,10002
,BaiYanXiang,513426215,6288,973,4467,2394,9321,4446,2215,4970,9416,5009,9476
,HaiBaXiang,513426216,1730,364,1355,812,2615,1340,796,1487,2827,1535,2890
,LuoZuoXiang,513426217,4316,778,3205,1741,6591,3190,1722,3586,6776,3611,6816
,XinMaXiang,513426218,5700,833,3961,2269,8337,3950,2007,4519,8469,4579,8540
,TangTangXiang,513426219,4507,816,2960,1821,6677,2893,1551,3696,6589,3914,6874
,PuMieXiang,513426220,2918,494,2062,1168,4500,2060,1090,2439,4499,2440,4502
Ұ,YanBaXiang,513426221,2537,435,1734,988,4009,1729,1069,2281,4010,2307,4041
¹״,LuHeCunXiang,513426222,2973,502,2022,1091,4321,2005,987,2340,4345,2440,4462
,XinTianXiang,513426223,2935,407,1692,937,3362,1445,812,1932,3377,2462,4154
,JiangXiJieXiang,513426224,4173,705,3032,1641,6487,3014,1718,3519,6533,3564,6596
,ChaHeXiang,513426225,4582,839,3391,1964,7335,3388,1983,3990,7378,4013,7404
˫,ShuangYanXiang,513426226,6591,1093,4843,2638,10636,4816,3141,5846,10662,5982,10825
,FaQingXiang,513426227,4436,694,3315,1718,7039,3259,2209,3836,7095,4024,7339
�,TieChangGouXiang,513426228,1791,301,1251,686,2711,1225,906,1569,2794,1747,2998
½,XinJieXiang,513426229,4471,688,3080,1934,6592,3080,1622,3701,6781,3701,6781
,MaLongXiang,513426230,3059,717,2428,1587,5006,2428,1391,2739,5167,2739,5167
,XinLongXiang,513426231,2139,277,1505,832,3142,1505,812,1721,3226,1723,3228
,HongYanXiang,513426232,2774,520,2005,1286,4346,1997,1126,2373,4370,2415,4420
,HongGuoXiang,513426233,3138,686,2598,1584,5218,2591,1523,2710,5301,2749,5347
³,LuJiXiang,513426234,6293,934,4555,2558,9246,4552,2425,5093,9645,5097,9652
,LiuGuXiang,513426235,4580,690,3336,1744,6675,3333,1771,3685,7018,3705,7041
,DaChongXiang,513426236,9431,1208,6947,4399,13702,6947,3419,7111,14058,7111,14058
ڸ,HeiGaXiang,513426237,3306,460,2287,1258,4805,2287,1360,2839,5126,2839,5126
,WenQingXiang,513426238,4880,679,3529,1920,7388,3529,2198,4228,7757,4228,7757
Ұţƺ,YeNiuPingXiang,513426239,3310,522,2471,1455,4847,2471,1410,2771,5242,2771,5242
ƺ,SongPingXiang,513426240,2200,347,1548,943,2930,1505,824,1717,3222,1823,3371
ɽ,XinShanXiang,513426241,2064,359,1505,856,3158,1495,923,1799,3294,1841,3346
С,XiaoJieXiang,513426242,4091,572,2520,1423,5181,2475,1497,2878,5353,3640,6160
Ͽ,LaoKouXiang,513426243,3500,728,2741,1492,5850,2734,1927,3394,6128,3414,6155
ɺ,GanHaiZiXiang,513426244,1706,352,1238,785,2686,1232,764,1559,2791,1584,2822
ƺ,HuangPingXiang,513426245,2989,527,2207,1314,4651,2198,1374,2577,4775,2683,4890
Ұ,YeZuXiang,513426246,1855,161,1360,651,2764,1314,818,1363,2677,1474,2834
,LaMaXiang,513426247,938,99,751,384,1535,751,517,803,1554,803,1554
³,LuNanXiang,513426248,680,84,614,303,1198,614,441,591,1205,591,1205
ѩɽ,XueShanXiang,513426249,2199,199,1718,836,3538,1708,1191,1847,3555,1871,3589
ɼ,BaiShanXiang,513426250,479,61,418,224,813,412,291,401,813,413,831
ɰ,PiShaZhen,513427100,22354,3041,15408,10056,24724,15358,5523,15328,30686,15510,30918
,SongXinZhen,513427101,6692,856,4624,2497,8221,4415,1887,4521,8936,4811,9435
,ZhuShouZhen,513427102,4237,606,2899,1591,5553,2783,1211,2949,5732,3155,6054
,HuaDanZhen,513427103,7479,1201,5511,3699,10786,5495,2375,5507,11002,5544,11055
׺̲,BaiHeTanZhen,513427104,4897,652,3467,1821,6753,3371,1531,3443,6814,3613,7080
«,HuLuKouZhen,513427105,3982,433,2771,1519,5377,2765,1270,2907,5672,2914,5685
,JingXingXiang,513427200,7590,1136,5399,3093,10172,5393,2008,5325,10718,5335,10734
,JuLeXiang,513427201,2333,413,1705,1060,3058,1687,821,1822,3509,1862,3567
´,XinCunXiang,513427202,3390,494,2410,1372,4436,2410,1117,2591,5001,2591,5001
Ҹ,XingFuXiang,513427203,3486,670,2564,1544,4698,2539,1260,2788,5327,2852,5416
,HaiZiXiang,513427204,2830,229,2210,925,3908,2202,1495,2305,4507,2344,4554
,LiuTieXiang,513427205,3794,349,2876,1288,5389,2876,1811,3075,5951,3078,5954
½,XinJianXiang,513427206,2361,204,1769,772,3188,1768,1125,1902,3670,1921,3690
,DaoGuXiang,513427207,2088,205,1607,686,3114,1607,1015,1700,3307,1701,3308
»,XinHuaXiang,513427208,4109,633,2800,1596,5775,2784,1267,3150,5934,3209,6009
ʯ,ShiLiXiang,513427209,4559,768,3197,1838,6598,3183,1493,3574,6757,3623,6820
,SongLinXiang,513427210,3691,605,2536,1496,5134,2526,1032,2738,5264,2792,5328
ɼ,ShanShuXiang,513427211,2014,183,1578,626,2930,1569,978,1569,3138,1597,3175
,LiangZiXiang,513427212,2493,233,1880,813,3611,1858,1188,2000,3858,2034,3914
ͬ,DaTongXiang,513427213,3401,517,2346,1352,4854,2333,1116,2625,4958,2688,5034
,XiYaoXiang,513427214,3019,427,2048,1131,4175,2047,943,2285,4332,2341,4389
,HongXingXiang,513427215,2202,340,1569,845,3084,1560,816,1743,3303,1789,3358
⹵,QiLuoGouXiang,513427216,4629,525,3338,1579,6526,3319,1772,3535,6854,3588,6926
,LuoGeXiang,513427217,3333,331,2527,1190,4930,2500,1629,2693,5193,2766,5293
,PaoMaXiang,513427218,4819,413,3844,1571,6806,3819,2744,4023,7842,4132,7976
ջ,PuJiZhen,513428100,16141,1515,10832,6745,16339,10506,5289,11315,21821,12113,22945
,QiaoWoZhen,513428101,6715,712,5021,2839,7057,5002,3126,5495,10497,5532,10553
ɽ,LuoJiShanZhen,513428102,6571,640,5056,3090,9565,5020,3255,5353,10373,5410,10466
,YongAnXiang,513428200,3803,369,2890,1411,5115,2870,1914,3176,6046,3196,6086
,XiangYangXiang,513428201,2468,173,2059,1028,3184,2053,1653,2227,4280,2235,4294
ƺ,WenPingXiang,513428202,1847,163,1541,795,3001,1534,1155,1610,3144,1624,3165
谲,LiAnXiang,513428203,2217,166,1685,874,3216,1685,1249,1947,3632,1947,3632
ɽ,HuaShanXiang,513428204,4390,564,3053,1831,4277,2915,1572,3204,6119,3473,6526
ɽ,DongShanXiang,513428205,3142,227,2496,1154,4639,2495,1869,2725,5220,2742,5238
ƺ,DaPingXiang,513428206,3622,296,2823,1369,4811,2808,2069,3121,5929,3164,5987
¡,HuiLongXiang,513428207,941,84,766,350,1248,763,635,875,1638,894,1660
ڹ,LuoWuGouXiang,513428208,1006,67,768,344,1290,768,577,873,1641,882,1650
ˮ,YuShuiXiang,513428209,4139,321,3225,1638,5789,3219,2417,3633,6852,3652,6877
,GanTianDiXiang,513428210,742,68,613,343,836,613,488,685,1298,685,1298
,LuoWuXiang,513428211,2814,199,2307,1191,3553,2307,1764,2470,4777,2470,4777
ϸ,MengGanXiang,513428212,3290,254,2749,1265,4442,2729,2225,2969,5698,3020,5769
,TeZiXiang,513428213,2274,161,1745,857,3230,1742,1304,1980,3722,1994,3739
,JiLeXiang,513428214,2196,144,1734,863,2974,1719,1265,1839,3558,1871,3605
ؿ,TeKouXiang,513428215,644,39,542,243,877,537,416,543,1080,557,1099
Ү,YeDiXiang,513428216,810,81,614,292,1275,614,461,731,1345,738,1352
,JiaTieXiang,513428217,3875,363,3191,1720,6244,3191,2350,3396,6587,3397,6588
,WaLuoXiang,513428218,2616,253,2191,1058,4034,2181,1673,2329,4510,2351,4542
,HaLiLuoXiang,513428219,1220,138,1004,494,1821,1000,779,1115,2115,1133,2137
,CaiZiXiang,513428220,1790,181,1484,733,2750,1484,1144,1631,3115,1631,3115
ף,ZhuLianXiang,513428221,1586,162,1278,604,2630,1271,1027,1481,2752,1497,2775
ƺ,LiuJiaPingXiang,513428222,2819,163,2310,972,3475,2297,1786,2421,4718,2458,4768
,YueWuXiang,513428223,1345,212,1012,528,2118,1012,583,1118,2130,1128,2140
ز,TeBuXiang,513428224,2994,281,2450,1280,4703,2442,1736,2552,4994,2561,5011
,WuDaoQingXiang,513428225,1851,173,1594,850,2968,1559,1208,1594,3153,1638,3232
ض,TeErGuoXiang,513428226,1759,175,1457,752,2608,1442,1067,1529,2971,1544,3001
,DaCaoXiang,513428227,1946,131,1620,806,2969,1609,1261,1688,3297,1718,3338
,MaHongXiang,513428228,722,76,663,354,1125,663,545,675,1338,680,1343
,LuoGanXiang,513428229,832,80,703,340,1306,701,547,738,1439,756,1459
Ī,HongMoYiDaXiang,513428230,884,77,749,427,1409,748,612,806,1554,824,1573
ľ,TeMuLiZhen,513429100,15916,1122,12378,7118,19170,12290,8527,12959,25249,13187,25565
̶,LongTanZhen,513429101,3922,363,3116,1680,5752,3096,2344,3436,6532,3513,6629
Ͼ,TuoJiaoZhen,513429102,7194,643,5993,3131,11101,5993,4222,6063,12056,6066,12059
ľ,MuErXiang,513429200,3185,302,2731,1544,5196,2731,2039,2795,5526,2795,5526
Ŷ,JiuDouXiang,513429201,3429,348,3116,1498,5980,3116,2288,2949,6065,2949,6065
,LaDaXiang,513429202,2117,188,1802,930,3099,1802,1355,1858,3660,1858,3660
ڿ,WuKeXiang,513429203,1112,114,912,486,1588,912,637,951,1863,951,1863
ɳ,ShaLuoXiang,513429204,2606,246,2277,950,3737,2277,1807,2382,4659,2382,4659
,LuoGuXiang,513429205,1330,147,1190,634,2241,1190,981,1268,2458,1268,2458
,BuErXiang,513429206,3728,468,3241,1492,5388,3241,2292,3247,6488,3247,6488
,JiaoSaXiang,513429207,1455,166,1305,616,1978,1301,979,1293,2594,1295,2600
,MeiSaXiang,513429208,2034,202,1724,856,2946,1724,1252,1764,3488,1764,3488
,LaGuoXiang,513429209,1982,253,1631,840,3192,1631,1182,1786,3417,1786,3417
,WuYiXiang,513429210,1443,162,1326,676,2399,1320,1098,1367,2687,1377,2703
,LangZhuXiang,513429211,1043,98,924,382,1576,924,763,980,1904,980,1904
ƺ,BaoGuPingXiang,513429212,2326,223,1924,959,3454,1923,1488,2106,4029,2113,4037
Ͼ,HeJingXiang,513429213,3642,327,2980,1357,6190,2980,2390,3379,6359,3379,6359
޼ƺ,LuoJiaPingXiang,513429214,2071,180,1652,771,3512,1649,1327,1912,3561,1926,3578
ţ,NiuJiaoWanXiang,513429215,3737,348,3140,1443,5837,3140,2569,3514,6654,3514,6654
,BuLuoXiang,513429216,2591,258,2301,1259,4302,2301,1742,2290,4591,2290,4591
,HuoLieXiang,513429217,3957,380,3246,1608,6102,3246,2247,3338,6584,3338,6584
ְ,LeAnXiang,513429218,5063,521,4173,1993,7612,4173,2865,4276,8449,4276,8449
Ŀ,SiKeXiang,513429219,1025,110,878,444,1679,878,652,909,1787,909,1787
,DiLuoXiang,513429220,5958,511,5066,2477,8476,5059,4190,5578,10637,5593,10659
ƺ,ELiPingXiang,513429221,2366,244,1930,1180,3515,1930,1481,2161,4091,2161,4091
߶,WaDouXiang,513429222,1357,147,1223,653,2126,1223,951,1232,2455,1232,2455
ɹ,CaiHaXiang,513429223,1325,128,1115,568,2110,1115,828,1166,2281,1166,2281
ίֻ,WeiZhiLuoXiang,513429224,1417,162,1284,706,2297,1284,1027,1322,2606,1322,2606
,LianBuXiang,513429225,1673,217,1555,786,2818,1555,1225,1560,3115,1560,3115
ֻ,JiZhiXiang,513429226,2276,237,1913,890,3350,1913,1308,1908,3821,1908,3821
ذ,TianDiBaZhen,513430100,11353,688,8133,4595,12818,8011,4990,8655,16666,8898,17031
,PaiLaiZhen,513430101,5288,389,4130,2204,8163,4130,3059,4603,8733,4606,8736
«,LuGaoZhen,513430102,2988,269,2106,1310,4014,2063,1228,2318,4381,2379,4485
ƺ,DuiPingZhen,513430103,6450,593,5111,2617,8761,5026,3503,5296,10322,5435,10546
ƺ,TaoPingXiang,513430200,3405,265,2933,1258,5186,2918,2276,2959,5877,3013,5946
ˮ,ReShuiHeXiang,513430201,2523,178,2033,913,4020,2024,1474,2109,4133,2142,4175
,MaYiZuXiang,513430202,3827,296,3516,1444,5765,3510,2965,3538,7048,3572,7088
,HongFengXiang,513430203,1129,83,1008,399,1797,993,773,956,1949,977,1985
,ErJiaoXiXiang,513430204,1970,200,1757,869,2961,1749,1388,1788,3537,1801,3558
ȿ¾,ReKeJiaoXiang,513430205,2108,177,1690,826,3120,1675,1131,1691,3366,1726,3416
,JiaYiXiang,513430206,2182,181,1809,792,3018,1806,1473,2001,3807,2027,3836
ľ,MuFuXiang,513430207,2457,158,2042,913,3396,2037,1481,2035,4072,2054,4096
կ,ZhaiZiXiang,513430208,1497,128,1271,577,1944,1267,1034,1368,2635,1388,2659
,ZeZuXiang,513430209,1232,108,1100,463,1795,1097,869,1089,2186,1109,2209
,JiJiaoXiang,513430210,3345,265,2958,1297,5090,2958,2340,2992,5950,2992,5950
Сľ,XiaoYinMuXiang,513430211,3113,202,2740,1148,4798,2734,2377,2928,5662,2952,5692
,ChunJiangXiang,513430212,2630,220,1902,1002,3697,1873,1186,2086,3959,2134,4036
,HongLianXiang,513430213,2983,283,2544,1092,4220,2475,2116,2680,5155,2838,5382
,QingSongXiang,513430214,2574,164,2247,822,3435,2233,1769,2233,4466,2260,4507
ƺ,FangMaPingXiang,513430215,3078,232,2558,1073,4788,2514,2052,2643,5157,2804,5362
,GengBaoXiang,513430216,2088,144,1795,722,2876,1795,1494,1918,3713,1931,3726
ɽ,ShanJiangXiang,513430217,1360,161,1191,660,2049,1111,964,1237,2348,1294,2485
,LuoJiaoXiang,513430218,3856,300,3090,1260,5312,2836,2257,2889,5725,3323,6413
,XiangLingXiang,513430219,2248,172,1876,797,3482,1809,1483,1870,3679,2027,3903
ȵ,GuDeXiang,513430220,1452,102,1224,531,2030,1139,892,1100,2239,1222,2446
߷,GaoFengXiang,513430221,1661,138,1196,569,2486,1098,846,1181,2279,1449,2645
կ,LaoZhaiZiXiang,513430222,2359,234,2097,917,3679,1936,1609,1929,3865,2105,4202
Ϫ,DeXiXiang,513430223,3925,286,3124,1389,5722,2888,2123,2848,5736,3210,6334
,NanWaXiang,513430224,4058,282,3023,1212,5714,2801,1882,2842,5643,3199,6222
Ī,YiMoHeXiang,513430225,1074,125,933,455,1530,930,809,1054,1984,1075,2008
,TuGouXiang,513430226,2089,204,1844,813,2853,1843,1476,1924,3767,1925,3769
,BingDiXiang,513430227,2533,224,2014,1029,3270,1985,1365,2070,4055,2108,4122
,YiDaXiang,513430228,2166,190,1621,886,2808,1607,947,1664,3271,1682,3303
˿,SiWoXiang,513430229,1727,186,1386,594,2490,1295,935,1351,2646,1462,2848
³,XinChengZhen,513431100,20018,781,13373,8483,21674,13016,7622,14611,27627,15048,28421
Ǳ,ChengBeiXiang,513431200,4723,359,3839,2071,7139,3837,2549,3788,7625,3792,7631
ƺ,ShuPingXiang,513431201,1153,91,946,542,1799,946,672,969,1915,970,1916
,GuQuXiang,513431202,3852,305,3398,1779,6303,3396,2602,3350,6746,3361,6759
,DaLuoXiang,513431203,1131,116,1000,612,1857,982,774,1007,1989,1021,2021
,LongEnXiang,513431204,2180,179,1882,1043,3110,1873,1550,2005,3878,2027,3909
,MeiGanXiang,513431205,1735,203,1637,779,2616,1637,1200,1499,3136,1501,3138
Ŀ,SiKaiXiang,513431206,8375,651,6790,3467,13053,6787,4559,6774,13561,6795,13585
,DaBaXiang,513431207,3836,304,3228,1664,5638,3228,2385,3297,6525,3297,6525
Ī,DiMoXiang,513431208,6592,606,5631,2568,10735,5622,4034,5567,11189,5601,11232
,LiuQieXiang,513431209,3720,268,3174,1557,5878,3164,2408,3201,6365,3222,6396
,BoLuoXiang,513431210,3112,245,2634,1325,4779,2634,2135,2858,5492,2858,5492
Ī,KuMoXiang,513431211,1725,102,1398,675,2748,1398,1104,1524,2922,1533,2931
,JieFangXiang,513431212,3458,336,2935,1510,5573,2928,1977,2802,5730,2836,5771
,SanGangXiang,513431213,2345,184,1869,1076,3816,1869,1331,1986,3855,1991,3860
,SaLaDiPoXiang,513431214,4564,400,3800,2112,7390,3793,2711,3867,7660,3875,7675
,SanChaHeXiang,513431215,2563,194,2165,1089,3725,2165,1720,2312,4477,2312,4477
,NiDiXiang,513431216,1148,95,938,491,1727,938,655,960,1898,960,1898
볧,WanChangXiang,513431217,1519,134,1350,785,2423,1343,1095,1379,2722,1398,2748
ʫ,PuShiXiang,513431218,3756,255,3114,1463,5446,3079,2125,2964,6043,3022,6136
,MaZengYiWuXiang,513431219,3393,181,2793,1350,5316,2793,2086,2867,5660,2867,5660
,TangQieXiang,513431220,1651,170,1419,767,2669,1393,1029,1377,2770,1431,2850
,JiuTeLuoGuXiang,513431221,1503,164,1276,766,2477,1271,934,1302,2573,1325,2601
ݿɲ,ChiKeBoXiXiang,513431222,4712,417,4009,2171,7568,3996,3068,4154,8150,4188,8197
ؿڼ׹,TeKouJiaGuXiang,513431223,1753,195,1442,838,2579,1432,1017,1514,2946,1523,2965
,ZhuHeXiang,513431224,6865,563,5659,2683,10788,5534,3770,5364,10898,5539,11198
,ABingLuoGuXiang,513431225,4273,323,3516,1775,6525,3494,2416,3474,6968,3496,7012
,GeWuXiang,513431226,1161,105,919,543,1766,919,678,1025,1944,1025,1944
ز,TeBuLuoXiang,513431227,3695,274,2835,1532,5725,2824,1926,3038,5862,3060,5895
,QingHengXiang,513431228,4203,318,3240,1703,5830,3239,2197,3476,6715,3478,6718
һľ,LaYiMuXiang,513431229,3156,273,2537,1193,4786,2537,1777,2669,5206,2669,5206
ɫ,SeDiXiang,513431230,1114,99,874,453,1606,874,675,1013,1887,1014,1888
Լ,BuYueXiang,513431231,1467,125,1181,580,2203,1175,958,1341,2516,1369,2550
ȶ,BiErXiang,513431232,4710,308,3995,1967,7705,3981,2963,3971,7952,3986,7981
,KuYiXiang,513431233,4402,357,3870,1815,6442,3870,3030,3918,7788,3919,7789
,JinQuXiang,513431234,1732,131,1559,716,2664,1559,1263,1567,3126,1567,3126
,YiMuDiXiang,513431235,1666,102,1339,666,2450,1339,995,1424,2763,1424,2763
,BoLuoXiang,513431236,1444,104,1178,552,2103,1177,808,1174,2351,1178,2356
Ħ,YangMoZuXiang,513431237,1566,126,1343,642,2342,1335,1025,1351,2686,1374,2717
,ZePuXiang,513431238,3172,250,2503,1121,4547,2503,1749,2668,5171,2668,5171
,YongLeXiang,513431239,1514,111,1236,569,2102,1228,903,1272,2500,1292,2528
Ī,QieMoXiang,513431240,2015,247,1578,955,2826,1578,977,1661,3239,1661,3239
ʶ,GanDuoLuoGuXiang,513431241,1237,110,828,487,1687,828,522,1041,1869,1041,1869
֧Ī,ZhiErMoXiang,513431242,1528,142,1179,674,2345,1179,816,1303,2482,1307,2486
,LongGouXiang,513431243,1133,98,855,573,1700,855,602,973,1828,978,1833
չ,RiHaXiang,513431244,2890,256,2179,1331,4114,2179,1395,2362,4541,2362,4541
,HaGanXiang,513431245,3755,331,3015,1610,5841,3015,2146,3217,6232,3217,6232
,GuangMingZhen,513432100,16794,1334,12071,7224,19289,11834,6991,12662,24496,13048,25119
ɽ,MianShanZhen,513432101,8882,844,7147,3879,12604,7089,4870,7244,14333,7449,14596
Ī,HongMoZhen,513432102,6947,536,5197,2747,9639,5193,3468,5750,10943,5754,10951
ӿ,LiangHeKouZhen,513432103,6465,617,5437,2872,10611,5416,3926,5526,10942,5571,11008
,MiShiZhen,513432104,3709,351,3130,1622,5918,3015,2278,3060,6075,3208,6338
,LuoHaZhen,513432105,2730,232,2254,1337,4392,2240,1684,2359,4599,2392,4646
Შ,NiBoZhen,513432106,3996,325,3394,1791,6400,3393,2810,3732,7125,3737,7131
,LaKeXiang,513432200,5365,558,4351,2147,7198,4314,2744,4243,8557,4316,8667
Լ,ZeYueXiang,513432201,1846,189,1544,791,2812,1537,1156,1617,3154,1647,3191
ز,HeBoLuoXiang,513432202,5505,465,4587,2405,8750,4587,3405,4787,9374,4788,9375
³,LuJiXiang,513432203,6147,356,4835,2497,8907,4835,3403,5071,9906,5071,9906
,LiZiXiang,513432204,5748,356,4711,2395,7978,4705,3522,4904,9609,4915,9626
ɽ,BeiShanXiang,513432205,2870,230,2194,1227,4299,2188,1645,2527,4715,2551,4745
,XiHeXiang,513432206,1304,92,967,532,1957,960,724,1125,2085,1153,2120
,DongHeXiang,513432207,4456,298,3602,1782,5597,3562,2643,3729,7291,3795,7397
,QieTuoXiang,513432208,2379,234,1937,1032,3745,1937,1390,2056,3993,2066,4003
,BoLuoLaDaXiang,513432209,1299,103,1050,576,1914,1050,810,1161,2211,1162,2212
ɳ,ShaMaLaDaXiang,513432210,2784,207,2310,1126,4326,2289,1678,2264,4553,2359,4669
;,BaJiuXiang,513432211,2316,179,2039,998,3946,2032,1660,2087,4119,2116,4155
Ī,LuoMoXiang,513432212,1608,110,1358,746,2704,1358,1037,1396,2754,1397,2755
,YiLuoXiang,513432213,1923,139,1563,808,3010,1555,1226,1698,3253,1725,3288
ȿ,ReKeYiDaXiang,513432214,1152,119,965,545,1899,953,749,1044,1997,1055,2020
,ENiXiang,513432215,1388,109,1116,638,2160,1112,830,1185,2297,1211,2327
,LeWuXiang,513432216,3298,237,2733,1355,5210,2733,2126,2928,5661,2928,5661
,ChengXiangZhen,513433100,30352,3125,22159,12521,32712,21551,11073,21739,43290,22391,44550
ˮ,ManShuiWanZhen,513433101,8599,911,6086,3133,9450,5981,2988,6169,12150,6412,12498
,DaQiaoZhen,513433102,7295,669,6245,3124,12104,6224,4725,6359,12583,6444,12689
,FuXingZhen,513433103,12528,1616,9007,4833,16931,8996,4105,9203,18199,9242,18249
,LuGuZhen,513433104,19449,2042,13659,7991,21446,13527,6471,13841,27368,14303,27962
ɳ,ShaBaZhen,513433105,17220,1718,12787,6108,22027,12666,7477,13371,26037,13628,26415
ƺ,HuiPingXiang,513433200,8497,1155,6031,3144,11264,6028,2873,6481,12509,6494,12525
,HuiLongXiang,513433201,7292,1015,5315,2704,10202,5289,2750,5686,10975,5742,11057
,HaHaXiang,513433202,4516,481,3814,1830,7041,3811,2892,4063,7874,4075,7889
ɭ,SenRongXiang,513433203,7427,791,6470,3030,11934,6459,4964,6706,13165,6712,13182
,LinLiXiang,513433204,3546,455,2528,1432,4622,2521,1262,2672,5193,2735,5263
ʯ,ShiLongXiang,513433205,9519,1230,6696,3508,12512,6696,2985,7037,13733,7038,13734
,TieChangXiang,513433206,5597,529,4749,2198,7808,4733,3474,4751,9484,4851,9600
ӱ,HeBianXiang,513433207,8538,1242,6055,3090,11869,6034,2753,6441,12475,6478,12533
,HeLiXiang,513433208,3148,344,2774,1297,4900,2774,2100,2818,5592,2818,5592
ұ,YeLeXiang,513433209,633,41,523,285,977,523,382,533,1056,533,1056
,TuoWuXiang,513433210,2212,201,1764,870,3309,1746,1302,1834,3580,1951,3715
ͺ,YiHaiXiang,513433211,3320,280,2804,1323,5115,2766,2172,2859,5625,2968,5772
ܹ,CaoGuXiang,513433212,3761,340,3256,1514,5784,3254,2565,3405,6659,3410,6666
ݰ,HuiAnXiang,513433213,5216,774,4020,2103,7723,4016,2425,4386,8402,4395,8415
ɽ,HouShanXiang,513433214,8288,921,6517,3218,11968,6498,4202,6851,13349,6894,13411
ģ,HongMoXiang,513433215,9321,1479,7224,4115,13142,7224,3836,7406,14630,7412,14636
ȷ,XianFengXiang,513433216,10447,1320,7784,3842,13904,7676,4123,7997,15673,8106,15890
Զ,ZeYuanXiang,513433217,7574,794,6115,3220,11939,6087,3975,6172,12259,6228,12343
ׯ,LiZhuangXiang,513433218,1500,183,1086,691,2004,1085,644,1236,2321,1241,2327
,JinLinXiang,513433219,753,84,601,309,1180,590,432,646,1236,668,1269
,LaWoXiang,513433220,1060,107,842,453,1580,837,597,911,1748,922,1764
,LianHeXiang,513433221,2213,249,1575,865,2924,1531,1025,1683,3214,1912,3487
ع,MaiDiGouXiang,513433222,1527,175,1330,653,2455,1324,1085,1418,2742,1457,2787
,JinPingXiang,513433223,2637,500,1838,1186,3867,1838,922,2220,4058,2221,4059
Ϻ,NanHeXiang,513433224,1545,329,944,616,1977,932,471,1182,2114,1401,2345
,QingNaXiang,513433225,2080,371,1469,851,3136,1457,770,1728,3185,1752,3221
Ͱ,HeAiZangZuXiang,513433226,1360,264,1098,629,2213,1094,763,1262,2356,1289,2387
ɳ,MianShaWanXiang,513433227,1383,171,1248,658,2166,1248,958,1231,2479,1264,2512
ͷ,MaTouXiang,513433228,938,92,820,425,1624,820,703,913,1733,913,1733
ѱ,WoBaoXiang,513433229,2148,236,1866,911,3743,1866,1482,1998,3864,2000,3866
,XinXingXiang,513433230,1239,276,864,549,1859,863,433,1066,1929,1084,1948
,JianMeiXiang,513433231,1260,219,833,515,1780,833,419,1065,1898,1065,1898
Խ,YueChengZhen,513434100,23576,2469,17287,10551,31461,17236,8941,17536,34772,17699,34986
,ZhongSuoZhen,513434101,5797,808,4474,2703,8055,4473,2327,4458,8931,4458,8932
,XinMinZhen,513434102,6374,635,4931,2659,9052,4931,3194,5272,10203,5272,10203
,NaiTuoZhen,513434103,4143,310,3547,1828,6140,3469,2825,3526,6995,3731,7278
,PuXiongZhen,513434104,11828,748,9180,5082,15513,9133,6909,9856,18989,10305,19485
,XinXiangXiang,513434200,1410,106,1285,657,2370,1285,1070,1301,2586,1301,2586
,MaTuoXiang,513434201,6049,504,5605,2681,10311,5605,4458,5406,11011,5406,11011
,DaRuiXiang,513434202,6196,824,5153,2972,9820,5151,3274,5137,10288,5141,10294
,NanQingXiang,513434203,5159,480,4623,2254,8471,4622,3625,4641,9263,4641,9264
ɽ,DingShanXiang,513434204,3675,476,2817,1677,5140,2815,1574,2901,5716,2908,5725
,DaHuaXiang,513434205,3744,327,3339,1576,6161,3339,2562,3292,6631,3294,6633
Ӷ,HeDongXiang,513434206,4788,452,3956,2014,7260,3956,2704,3988,7944,3988,7944
ɽ,XiShanXiang,513434207,3350,253,3025,1442,4807,3025,2462,3040,6065,3040,6065
,BanQiaoXiang,513434208,4163,374,3556,1637,6660,3525,2638,3576,7101,3619,7175
,WaYanXiang,513434209,4253,276,3607,1582,6475,3602,2865,3753,7355,3787,7394
,DaTunXiang,513434210,5455,565,4336,2366,8180,4307,2713,4353,8660,4397,8733
,BaoAnZangZuXiang,513434211,1828,198,1632,793,3130,1627,1329,1721,3348,1723,3355
׹,BaiGuoXiang,513434212,2573,261,2390,1168,4316,2387,1995,2437,4824,2439,4829
÷,MeiHuaXiang,513434213,1966,170,1637,734,2980,1598,1264,1646,3244,1763,3400
,LaPuXiang,513434214,3412,254,3119,1458,5834,3105,2613,3113,6218,3160,6279
,TieXiXiang,513434215,2570,208,2240,1075,4323,2240,1818,2340,4580,2356,4596
,ErJiaoXiang,513434216,3202,195,2690,1270,4832,2655,2123,2758,5413,2830,5520
ĸ,SiGanPuXiang,513434217,2589,202,2274,1148,4366,2273,1839,2345,4618,2356,4630
Ī,GongMoXiang,513434218,3530,312,2978,1426,5763,2961,2235,3050,6011,3099,6077
,LaBaiXiang,513434219,1408,108,1267,643,2445,1267,1089,1338,2605,1338,2605
,LeQingDiXiang,513434220,3434,356,3071,1474,5671,3071,2448,3167,6238,3167,6238
¼,DeJiXiang,513434221,1139,80,1013,536,1688,1011,869,1066,2077,1075,2088
ذ,YiLuoDiBaXiang,513434222,4230,354,3865,2219,7407,3865,3293,4012,7877,4012,7877
,ErSaiXiang,513434223,2806,228,2313,1188,4189,2304,1894,2590,4894,2615,4928
Ŷ,GuErXiang,513434224,1910,214,1757,897,3440,1751,1485,1837,3588,1852,3609
񰢾,ZhuAJiaoXiang,513434225,1790,118,1575,829,3139,1571,1437,1755,3326,1770,3345
ʯ,BaoShiXiang,513434226,1743,130,1518,740,2846,1518,1262,1617,3135,1617,3135
,WuLiQingXiang,513434227,3452,286,3211,1530,5959,3211,2633,3160,6371,3160,6371
,ShuGuXiang,513434228,3683,296,3388,1621,6519,3388,2857,3445,6833,3448,6836
Ī,WaPuMoXiang,513434229,1950,132,1723,814,3481,1716,1432,1761,3477,1791,3514
,ShenGuoXiang,513434230,1674,125,1510,830,2983,1510,1317,1606,3116,1606,3116
,WaQuJiaoXiang,513434231,1498,127,1436,751,2579,1436,1230,1419,2855,1419,2855
,ShenPuXiang,513434232,2215,201,2088,1016,3891,2083,1753,2072,4155,2081,4169
,WaQuNaiWuXiang,513434233,224,19,197,103,357,197,150,196,393,196,393
,WaLiJiaoXiang,513434234,2006,126,1720,901,3262,1712,1346,1736,3448,1758,3478
,LaJiXiang,513434235,1623,114,1463,704,2717,1463,1208,1482,2945,1482,2945
а,XinShiBaZhen,513435100,35604,2481,25435,14170,36144,25207,14586,26650,51857,27236,52671
,TianBaZhen,513435101,10793,1394,7490,4310,15049,7481,3456,8135,15616,8153,15643
,HaiTangZhen,513435102,2466,243,1967,1089,3692,1964,1327,2053,4017,2069,4036
,JiMiZhen,513435103,2844,186,2283,1416,4783,2282,1965,2680,4962,2712,4995
˹,SiJiaoZhen,513435104,3215,206,2842,1266,4910,2842,2491,3070,5912,3070,5912
ղ,PuChangZhen,513435105,8063,568,6597,3157,10505,6597,5232,7266,13863,7266,13863
,YuTianZhen,513435106,3941,322,3104,1512,5922,3104,2141,3300,6404,3300,6404
ǰ,QianJinXiang,513435200,3875,411,2954,1559,5800,2954,1816,3148,6102,3148,6102
ʤ,ShengLiXiang,513435201,3210,385,2499,1349,4713,2486,1592,2664,5150,2688,5187
²,XinChaXiang,513435202,1600,251,1221,645,2355,1207,750,1359,2566,1380,2601
,LiangHeXiang,513435203,996,152,773,456,1591,771,521,889,1660,896,1669
,LiKeXiang,513435204,2943,184,2531,1029,4419,2516,2177,2748,5264,2773,5304
,NiErJiaoXiang,513435205,2583,182,2276,920,3861,2276,1852,2339,4615,2341,4617
Ī,LaMoXiang,513435206,1009,87,839,464,1445,836,689,925,1761,946,1785
,BoBoXiang,513435207,895,96,749,427,1484,749,584,826,1575,826,1575
,AGaXiang,513435208,2043,183,1681,925,3403,1666,1395,1855,3521,1940,3621
,AErXiang,513435209,5716,367,4702,2155,8741,4691,3724,5101,9792,5105,9807
ʯ,ShiHaiXiang,513435210,4708,290,3887,1810,7135,3887,3038,4149,8036,4149,8036
Ž,TuanJieXiang,513435211,3656,347,2595,1269,4898,2543,1496,2803,5346,2904,5499
,GaRiXiang,513435212,4617,324,3606,1355,6823,3586,2756,3995,7581,4091,7697
,ZeLaXiang,513435213,1814,154,1436,624,2642,1435,1036,1567,3002,1568,3004
ƺ,PingBaXiang,513435214,1941,221,1584,883,2877,1584,1150,1728,3312,1728,3312
ޤƺ,LiaoPingXiang,513435215,2191,229,1778,918,3123,1778,1267,1893,3671,1909,3687
Ⱦ,AZiJiaoXiang,513435216,2235,190,1641,822,3215,1641,1040,1819,3460,1824,3465
ʷ,WuShiDaQiaoXiang,513435217,2388,215,1688,802,3433,1673,1038,1932,3605,1953,3641
,HeiMaXiang,513435218,2893,251,1996,1213,4021,1990,1323,2418,4408,2471,4467
ɳ,ShaDaiXiang,513435219,1683,133,1212,733,2350,1212,869,1473,2685,1473,2685
,SuXiongXiang,513435220,2511,211,1697,846,3205,1671,1093,1780,3451,2118,3815
,BaPuZhen,513436100,12788,669,9593,5541,15552,9462,6006,9502,18964,9870,19463
,JiaoLuoXiang,513436200,3381,255,2898,1342,5271,2898,1937,2675,5573,2675,5573
Ҷ,JingYeTeXiXiang,513436201,4502,331,3529,1629,6710,3529,2295,3592,7121,3599,7128
Ϲ,HeGuLuoXiang,513436202,2752,244,2359,1132,4442,2359,1739,2376,4735,2376,4735
͹,BaGuXiang,513436203,3948,292,3329,1572,6428,3329,2499,3410,6739,3410,6739
ũ,NongZuoXiang,513436204,3046,289,2703,1266,4961,2699,1998,2614,5313,2630,5333
,ZuoGeYiDaXiang,513436205,5147,359,4352,2144,8246,4346,3398,4513,8859,4552,8904
,ZiWeiXiang,513436206,2599,177,1968,921,3384,1967,1212,2003,3970,2020,3988
,YiLuoLaDaXiang,513436207,2211,174,1739,896,3256,1738,1159,1795,3533,1805,3544
䲹,DianBuXiang,513436208,3960,349,3445,1601,5783,3431,2566,3410,6841,3430,6875
,HaLuoXiang,513436209,1519,132,1321,603,2532,1321,1007,1337,2658,1337,2658
ţţ,NiuNiuBaXiang,513436210,8053,589,6554,3297,12447,6554,4678,6766,13320,6766,13320
,ErHeXiang,513436211,2649,204,2224,1057,4445,2223,1675,2298,4521,2304,4528
,ZhuKuXiang,513436212,2877,227,2251,1140,4504,2251,1668,2521,4772,2521,4772
Ī,HouGuMoXiang,513436213,5276,388,4403,1971,8597,4403,3092,4353,8756,4353,8756
,HouBoNaiTuoXiang,513436214,4584,361,3908,1755,7505,3908,2996,3977,7885,4033,7941
ɺ,CaiHongXiang,513436215,2147,167,1839,828,3473,1834,1349,1807,3641,1824,3663
,SuLuoXiang,513436216,2218,185,1860,904,3606,1859,1441,1974,3833,1984,3844
ſ,JiuKouXiang,513436217,6156,439,5131,2448,9503,5131,3743,5196,10327,5207,10338
,LuoEYiGanXiang,513436218,4518,394,3764,1928,6800,3764,2567,3713,7477,3715,7479
ľ,LaMuAJiaoXiang,513436219,5012,307,3991,1882,7202,3915,2737,3919,7834,4065,8056
Ī,LuoMoYiDaXiang,513436220,2723,257,2205,1143,4219,2196,1499,2260,4456,2274,4479
,LiuHongXiang,513436221,3246,318,2783,1465,5265,2774,1977,2735,5509,2758,5541
Լ,LeYueXiang,513436222,2116,199,1772,882,3393,1761,1431,1850,3611,1974,3746
,ErQiXiang,513436223,2077,189,1745,887,3458,1741,1297,1815,3556,1818,3563
߹,WaGuXiang,513436224,1892,179,1492,838,2875,1492,1005,1584,3076,1584,3076
,EQuGuXiang,513436225,3101,238,2712,1220,5054,2711,1960,2583,5294,2587,5299
;,BingTuXiang,513436226,2638,202,2249,1112,4199,2249,1632,2223,4472,2223,4472
ľ,TuoMuXiang,513436227,2731,193,2180,1023,4413,2180,1551,2295,4475,2295,4475
,NiHaXiang,513436228,1278,116,1205,604,2136,1205,925,1114,2319,1114,2319
,LongMenXiang,513436229,5626,452,4662,2199,8938,4656,3124,4517,9173,4540,9202
,YiGuoJiaoXiang,513436230,4904,372,3947,2228,7925,3946,2833,4161,8107,4162,8109
,SaKuXiang,513436231,4974,386,4172,1932,7960,4148,2913,4045,8193,4101,8273
,WaXiXiang,513436232,2287,218,1957,944,3737,1951,1449,1977,3928,1997,3954
,ShuWoXiang,513436233,1438,119,1353,604,2185,1344,1186,1343,2687,1390,2743
,LongWoXiang,513436234,2622,221,2294,1043,4024,2294,1774,2323,4617,2323,4617
,JinChengZhen,513437100,9605,922,6454,4800,10380,6413,2569,6556,12969,6642,13096
,XiNingZhen,513437101,4389,489,3443,1974,5651,3421,2167,3436,6857,3602,7045
ˮ,WenShuiZhen,513437102,7751,707,5457,3172,10884,5439,2959,5906,11345,5960,11417
,HuangLangZhen,513437103,4832,520,3651,1948,6797,3646,2051,3748,7394,3752,7403
,NanTianXiang,513437200,6888,456,4135,2297,7726,4041,1754,3988,8029,4963,9098
,HaiWanXiang,513437201,4957,412,3412,1743,5819,3109,1456,3211,6320,3413,6825
ɼ,ShanShuBaoXiang,513437202,2413,272,1822,1074,3406,1814,1040,1886,3700,1903,3725
,QingKouXiang,513437203,4985,489,3596,1897,7044,3591,1995,3860,7451,3873,7469
,PaHaXiang,513437204,2982,265,2285,1178,4451,2285,1482,2444,4729,2444,4729
ʢ,YongShengXiang,513437205,5523,546,3919,2408,7980,3887,2215,4293,8180,4365,8284
Ϫ,XiLuoMiXiang,513437206,3198,348,2361,1491,4619,2359,1406,2588,4947,2591,4952
,BaiTieBaXiang,513437207,3214,140,1457,961,2261,1328,538,1450,2778,2435,3892
˳,ShunHeXiang,513437208,1383,153,1019,692,1956,1019,591,1106,2125,1108,2127
ɿ,DuKouXiang,513437209,4275,547,3344,1921,6322,3313,2041,3474,6787,3519,6863
,HuiLongChangXiang,513437210,3321,402,2418,1552,4765,2416,1386,2689,5105,2691,5109
,MaHuXiang,513437211,4763,560,3638,1953,6824,3638,2251,3934,7572,3936,7574
,ZhongTianXiang,513437212,3481,384,2683,1506,5008,2675,1648,2809,5484,2830,5513
,GuMiXiang,513437213,3927,474,3111,1482,5918,3111,1906,3196,6307,3196,6307
,GanZiXiang,513437214,1425,182,1093,674,2082,1093,618,1131,2224,1132,2225
˫ӿ,ShuangHeKouXiang,513437215,1093,102,919,431,1610,914,686,949,1863,962,1881
ɽϪ,LuoShanXiXiang,513437216,1776,121,1467,717,2862,1461,1076,1490,2951,1506,2973
,GuiHuaXiang,513437217,2179,182,1723,953,3397,1718,1215,1810,3528,1853,3576
ð,LanBaZiXiang,513437218,1501,95,1170,605,2248,1156,796,1180,2336,1222,2392
ɳ,ShaDuoXiang,513437219,1586,219,1207,725,2230,1205,713,1269,2474,1311,2518
ɽ,ShanLengGangXiang,513437220,3273,206,2570,1300,4828,2526,1815,2644,5170,2724,5294
,ChangHeXiang,513437221,1423,138,1177,584,2182,1173,869,1239,2412,1253,2430
ȶ,GuDuiXiang,513437222,1640,116,1261,607,2427,1257,852,1333,2590,1347,2608
կ,BaZhaiXiang,513437223,3307,226,2628,1410,4386,2614,1817,2665,5279,2722,5350
,LaMiXiang,513437224,1004,72,692,457,1207,682,459,773,1455,843,1535
,SongShuXiang,513437225,2164,175,1732,838,3260,1725,1278,1809,3534,1885,3617
,QuYiXiang,513437226,2256,178,1797,913,3469,1797,1318,1955,3752,1955,3752
ǧ,QianWanGuanXiang,513437227,2275,216,1811,990,3476,1810,1266,1939,3749,1946,3757
,WuGuanXiang,513437228,3250,293,2446,1231,4614,2443,1470,2537,4980,2567,5013
,ShangTianBaXiang,513437229,2546,174,2088,1066,3962,2087,1463,2086,4173,2095,4183
ƺ,DaPingZiXiang,513437230,855,89,660,359,1394,659,476,756,1415,760,1420
,BoJiLiangZiXiang,513437231,1317,107,1032,519,1892,1024,710,1068,2092,1102,2134
С,XiaoGouXiang,513437232,640,42,432,318,830,432,333,583,1015,583,1015
Ī,MoHongXiang,513437233,1960,146,1592,854,2780,1580,1197,1622,3202,1711,3303
˾,KeJiaoXiang,513437234,348,22,196,119,404,184,122,229,413,296,492
ƺͷ,PingTouXiang,513437235,1538,139,1221,773,2350,1217,900,1335,2552,1356,2577
׳,LeiChiXiang,513437236,2406,222,1839,1045,3776,1839,1281,2070,3909,2070,3909
͹,BaGuXiang,513437237,2236,161,1791,859,3380,1783,1152,1720,3503,1758,3549
,MiGuXiang,513437238,3144,295,2528,1259,5074,2521,1674,2567,5088,2585,5113
һ,YiCheXiang,513437239,2094,210,1673,894,3454,1665,1225,1839,3504,1856,3529
˹Ϫ,SiGuXiXiang,513437240,1169,86,948,483,1844,948,723,1030,1978,1030,1978
,KaHaLuoXiang,513437241,3761,305,2826,1572,5621,2814,1859,3063,5877,3099,5925
Ԫɽ,YuanBaoShanXiang,513437242,5518,392,4303,2007,8339,4302,2956,4557,8859,4563,8866
Ҷ,DaYanDongXiang,513437243,1099,108,866,467,1636,866,611,952,1818,952,1818
ҽ,YanJiaoXiang,513437244,2327,207,1785,923,3560,1780,1191,1911,3691,1940,3725
»·ֵ´,XinHuaLuJieDaoBanShiChu,520102001,18519,3071,12429,8775,16159,11940,2932,11448,23388,12093,24522
·ֵ´,XiHuLuJieDaoBanShiChu,520102002,56935,8095,37670,23269,47617,33180,9253,31687,64867,36613,74283
Žֵ´,DaNanMenJieDaoBanShiChu,520102003,10713,1477,7063,5092,7030,6605,1579,6222,12827,6706,13769
л·ֵ´,ZhongHuaNanLuJieDaoBanShiChu,520102004,3926,524,2513,1727,2830,2306,515,2162,4468,2452,4965
и·ֵ´,ShiFuLuJieDaoBanShiChu,520102005,10458,1807,7038,4854,7911,6721,1512,6345,13066,6739,13777
ӱֵ´,HeBinJieDaoBanShiChu,520102006,21001,3501,14118,9220,15260,12704,2671,11931,24635,13055,27173
·ֵ´,ZunYiLuJieDaoBanShiChu,520102007,45754,6290,28607,19377,35237,26897,6757,26099,52996,30194,58801
˹·ֵ´,XingGuanLuJieDaoBanShiChu,520102008,44832,6542,29199,21306,36130,28855,7456,28504,57359,29631,58830
ɳ·ֵ´,ShaChongLuJieDaoBanShiChu,520102009,53124,6032,34194,24323,31161,33464,9642,33365,66829,34604,68798
̫Žֵ´,TaiCiQiaoJieDaoBanShiChu,520102010,36439,4860,23575,16763,26156,22681,6251,22405,45086,23975,47550
԰ֵ´,HuaGuoYuanJieDaoBanShiChu,520102011,34235,4526,22408,15046,28024,21237,5536,20838,42075,21889,44297
եֵֽ´,YouZhaJieJieDaoBanShiChu,520102012,53598,7382,35041,24152,42566,33951,9441,33758,67709,35380,70421
в˾ֵ´,ZhongCaoSiJieDaoBanShiChu,520102013,24578,3194,15515,11452,17248,15294,4667,15462,30756,16924,32439
կֵ´,ErGeZhaiJieDaoBanShiChu,520102014,34078,4777,21795,13992,26122,18796,5569,19197,37993,22629,44424
�ֵ´,LongDongBaoJieDaoBanShiChu,520102015,23683,1229,11434,3236,12908,4501,1639,4638,9139,15117,26551
,HouChaoXiang,520102200,92268,2701,58543,43325,16183,57558,29955,63988,121546,66381,124924
ƹ,YunGuanXiang,520102201,45483,1943,30241,19690,17721,29594,14902,30801,60395,32087,62328
С̲,XiaoBiBuYiZuMiaoZuXiang,520102202,13124,1155,8549,4856,12939,8288,3757,8793,17081,9487,18036
,YongLeXiang,520102203,9835,995,6314,3699,10868,6202,2608,6761,12963,7124,13438
л·ֵ´,ZhongHuaZhongLuJieDaoBanShiChu,520103001,12131,1677,8331,5474,11229,8002,2244,7358,15360,7721,16052
ɽ·ֵ´,ZhongShanDongLuJieDaoBanShiChu,520103002,39992,5581,26473,18984,29066,25840,6278,24604,50444,25378,51851
ɽ·ֵ´,ZhongShanXiLuJieDaoBanShiChu,520103003,12905,1668,8384,6038,9686,7935,1942,7693,15628,8131,16515
л·ֵ´,ZhongHuaBeiLuJieDaoBanShiChu,520103004,7029,1007,4622,3327,5831,4405,1010,4140,8545,4424,9046
·ֵ´,BeiJingLuJieDaoBanShiChu,520103005,30816,6437,21338,14777,30536,20817,4626,19663,40480,20541,41879
Ӱ·ֵ´,YanAnZhongLuJieDaoBanShiChu,520103006,16751,2206,10978,7694,12369,10186,2258,9546,19732,10237,21215
·ֵ´,ShiXiLuJieDaoBanShiChu,520103007,26126,3138,16875,12199,15246,16468,4185,16180,32648,16574,33449
·ֵ´,PuTuoLuJieDaoBanShiChu,520103008,23413,3159,15358,11374,18477,15247,3229,14270,29517,14443,29801
Ǳ·ֵ´,HuanChengBeiLuJieDaoBanShiChu,520103009,15270,2271,9646,7165,11407,9450,1999,9112,18562,9894,19540
·ֵ´,GuiWuLuJieDaoBanShiChu,520103010,75379,9784,49965,31515,53699,44423,11754,42509,86932,46952,96917
ǭ鶫·ֵ´,QianLingDongLuJieDaoBanShiChu,520103011,39205,4174,25092,13690,26634,18512,4174,17849,36361,22461,47553
·ֵ´,WeiQingLuJieDaoBanShiChu,520103012,17949,2939,11912,8591,14017,11622,2551,11176,22798,11527,23439
ͷŽֵ´,TouQiaoJieDaoBanShiChu,520103013,60954,7060,39095,27520,39796,37858,10341,37473,75331,39260,78355
Žֵ´,SanQiaoJieDaoBanShiChu,520103014,33328,3724,21064,13847,21871,18859,5655,19210,38069,21643,42707
լ·ֵ´,ZhaiJiLuJieDaoBanShiChu,520103015,57047,4379,35157,16691,39173,23019,6962,22439,45458,33231,68388
ؽֵ´,JinGuanJieDaoBanShiChu,520103016,43266,2265,22033,15194,20026,18778,7749,20814,39592,31247,53280
Ѽֵ´,JinYaJieDaoBanShiChu,520103017,64845,5661,38025,24918,39225,34279,12735,37022,71301,45216,83241
ݽֵ´,JinHuiJieDaoBanShiChu,520103018,6887,487,4514,2654,4540,4449,2044,4680,9129,4904,9418
ǭ,QianLingZhen,520103100,167852,6395,101960,76143,47327,94898,40013,103115,198013,112300,214260
ֵ´,GuiZhuJieDaoBanShiChu,520111001,53831,4955,32888,18057,43053,26992,10080,26793,53785,35978,68866
Ϫֵ´,QingXiJieDaoBanShiChu,520111002,24133,2773,16402,10124,21286,15368,5472,14973,30341,15976,32378
Ϫֵ´,XiBeiJieDaoBanShiChu,520111003,59908,3288,34409,12192,38530,18675,7240,18695,37370,36027,70436
,QingYanZhen,520111101,22310,2339,15178,8057,27166,14953,6058,15271,30224,15529,30707
ʯ,ShiBanZhen,520111102,15461,1976,10460,5682,19278,10188,4101,10692,20880,11078,21538
Ϲ岼,MengGuanMiaoZuBuYiZuXiang,520111201,15812,1479,10737,5927,18465,10576,4594,10841,21417,11148,21885
,DangWuXiang,520111203,13241,1483,8866,4877,16676,8688,3528,9183,17871,9386,18252
岼,HuChaoMiaoZuBuYiZuXiang,520111204,19386,2283,13143,5799,20126,9431,3707,9489,18920,12233,25376
ð,JiuAnXiang,520111205,8728,1041,5922,3447,11020,5870,2604,6372,12242,6451,12373
ƺ,MaiPingXiang,520111206,11304,1370,7711,4472,13950,7630,3286,8080,15710,8249,15960
,GaoPoMiaoZuXiang,520111207,8636,1445,6932,4022,13074,6891,4116,7143,14034,7265,14197
ǭղ,QianTaoBuYiZuMiaoZuXiang,520111208,5618,850,3961,2455,7299,3919,1665,4086,8005,4172,8133
岼,MaLingBuYiZuMiaoZuXiang,520111209,4611,798,3152,2038,6065,3137,1274,3493,6630,3531,6683
¥,YanLouXiang,520111210,8871,998,5778,3341,10970,5731,2328,6249,11980,6419,12197
ֵ´,XinTianJieDaoBanShiChu,520112001,33321,3252,20432,13819,22184,19550,6853,19407,38957,22994,43426
·ֵ´,GaoXinLuJieDaoBanShiChu,520112002,58194,5359,38105,23603,44371,32867,11492,33146,66013,36940,75045
ֵ´,JinYangJieDaoBanShiChu,520112003,77461,4152,47700,26659,42651,40646,19363,42048,82694,53276,100976
,ZhuChangZhen,520112100,17165,1946,11646,6884,19824,11581,5170,11890,23471,12635,24281
,DongFengZhen,520112101,22856,2065,14659,8620,20587,14139,5939,14796,28935,16201,30860
ˮ,ShuiTianZhen,520112102,9080,1210,6267,3857,11021,6239,2696,6592,12831,6719,12986
,YangChangZhen,520112103,6828,1139,4676,3376,8521,4653,1781,5036,9689,5072,9748
,JinHuaZhen,520112104,30280,4144,19513,12680,32798,19216,7575,19776,38992,22486,41999
°,XiaBaXiang,520112202,7942,1310,5498,3868,10491,5476,2308,6031,11507,6062,11560
±,XinBaoBuYiZuXiang,520112203,2769,478,1936,1381,3536,1927,805,2091,4018,2116,4052
³,XinChangXiang,520112204,7470,1260,5241,3860,9601,5200,2280,5723,10923,5769,11010
,BaiYiXiang,520112205,5819,1081,3968,3014,7498,3931,1584,4411,8342,4516,8484
ƫ²,PianPoBuYiZuXiang,520112206,1163,182,771,506,1424,767,298,869,1636,872,1643
ũ,GuiYangShiSanJiangNongChang,520112400,659,122,438,306,432,433,120,449,882,463,901
ɽֵ´,DaShanDongJieDaoBanShiChu,520113001,31090,2705,16608,11868,23839,16224,6125,16363,32587,23312,39920
կֵ´,GongJiaZhaiJieDaoBanShiChu,520113002,29191,4595,19473,15055,29058,19244,5446,19291,38535,19759,39232
ɽֵ´,YanShanHongJieDaoBanShiChu,520113003,22961,3975,15972,11429,19201,15685,4839,15242,30927,15803,31775
Ӫֵ´,DouLaYingJieDaoBanShiChu,520113004,5546,676,3438,2881,5082,3209,823,3456,6665,3607,7045
ɽ,YanShanHongZhen,520113100,47008,2383,30710,19220,18114,29929,15541,32569,62498,34222,64932
,MaiJiaZhen,520113101,26170,1221,15864,5658,23487,10608,5079,10969,21577,16606,32470
ɳ,ShaWenZhen,520113102,18585,1617,12479,7317,18493,12315,5639,12867,25182,13362,25841
,DouLaBuYiZuXiang,520113200,9700,686,6298,3508,7280,6108,3022,6401,12509,7110,13408
ţ,NiuChangBuYiZuXiang,520113201,6750,975,4835,2811,8200,4737,2148,4915,9652,5038,9873
ƺӽֵ´,HuangHeJieDaoBanShiChu,520114001,60454,7108,36408,26217,37000,35545,11903,35529,71074,43057,79465
ֵ´,ChangJiangJieDaoBanShiChu,520114002,44918,5652,30125,21589,35111,29532,10001,29457,58989,30446,60571
ƽŽֵ´,PingQiaoJieDaoBanShiChu,520114003,47410,4024,31045,21866,29977,30345,12999,31932,62277,33388,64433
ֵ´,SanJiangJieDaoBanShiChu,520114004,18438,2152,11781,8587,15412,11577,4260,12436,24013,13069,24850
´,JinZhuSheQuBanShiChu,520114005,13799,1307,9154,5423,11730,8683,3645,8929,17612,9597,18751
ǹ,ChengGuanZhen,520121100,68007,5842,46049,29509,64405,44627,19107,45392,90019,46907,92956
˫,ShuangLiuZhen,520121101,20598,2573,13690,8766,26109,13069,5485,13838,26907,14966,28656
,JinZhongZhen,520121102,18120,1742,11379,7963,18378,11222,4301,11883,23105,12784,24163
,FengSanZhen,520121103,19324,2462,12967,8986,25983,12967,4980,13799,26766,13799,26766
ľ,NanMuDuZhen,520121104,22851,3212,15690,10020,30989,15107,6093,15780,30887,16466,32156
,LongGangZhen,520121105,20582,2803,14258,9181,26746,14045,5974,14846,28891,15101,29359
,NanLongXiang,520121200,9267,1387,6368,4510,12866,6352,2605,6856,13208,6891,13259
,YongWenXiang,520121201,10435,1334,6854,4483,13699,6791,2625,7368,14159,7540,14394
լ,ZhaiJiXiang,520121202,8814,1348,6266,4100,12596,6258,2888,6752,13010,6784,13050
,HuaLiXiang,520121203,12543,1944,9035,6323,17616,9001,3957,9340,18341,9409,18444
ˮ,LongShuiXiang,520121204,5773,972,4180,2991,8168,4123,1772,4211,8334,4337,8517
ƺ,MiPingXiang,520121205,3609,610,2631,1773,5124,2630,1135,2714,5344,2723,5354
̷,HeFengXiang,520121206,7602,1307,5319,3816,10356,5218,2176,5580,10798,5766,11085
Ͻ,NanJiangXiang,520121207,9876,1554,6859,4496,13352,6791,2835,7249,14040,7406,14265
կ,GaoZhaiXiang,520121208,11894,1867,8409,5831,16373,8331,3918,8898,17229,9270,17679
ë,MaoYunXiang,520121209,5427,952,3824,2761,7546,3770,1766,4192,7962,4321,8145
,YongJingZhen,520122100,44053,4469,29993,20662,45362,29469,12035,29620,59089,30564,60557
Ȫ,WenQuanZhen,520122101,12717,1817,8546,6568,15497,8486,3400,9205,17691,9388,17934
ׯ,JiuZhuangZhen,520122102,15187,2263,10685,7573,20666,10552,4788,11387,21939,11553,22238
Сկ,XiaoZhaiBaZhen,520122103,23123,2592,15336,11241,25130,15149,6305,16148,31297,16684,32020
ɽ,QingShanMiaoZuXiang,520122200,3574,519,2436,1964,4724,2435,1041,2693,5128,2698,5134
ɽ,XiShanXiang,520122201,9035,1304,6231,4592,12087,6187,2641,6617,12804,6749,12980
˾,YangLongSiXiang,520122202,12382,1852,8751,6028,16822,8745,3905,9236,17981,9388,18139
ʯ,ShiDongXiang,520122203,11864,1612,8198,6203,16019,8171,3854,8740,16911,9132,17330
¹,LuWoXiang,520122204,7442,1305,5204,3900,10372,5170,2386,5856,11026,5929,11133
,LiuChangXiang,520122205,10128,1741,7398,5279,14412,7387,3563,8008,15395,8034,15432
,LongChangZhen,520123100,61039,5805,41022,26497,63498,40080,16371,40605,80685,42193,83215
,ZhaZuoZhen,520123101,30463,3014,19628,11253,29822,17888,7242,18349,36237,21091,40719
ó,JiuChangZhen,520123102,17716,2046,12376,8017,22803,12327,5514,12759,25086,12900,25276
,LiuGuangZhen,520123103,13948,1807,9106,6786,17417,8963,3785,9631,18594,10434,19540
ȱ,GuBaoXiang,520123200,11893,1756,8045,5683,15852,7944,3523,8487,16431,9127,17172
,LiuTunXiang,520123201,6732,1232,4909,3477,9515,4860,2135,5095,9955,5190,10099
С,XiaoQingXiang,520123202,10970,1472,7471,5312,14783,7462,3256,8198,15660,8227,15698
ƺ,SaPingXiang,520123203,7567,1168,5160,4123,10326,5127,2197,5682,10809,5772,10932
ʯ,DaShiBuYiZuXiang,520123204,5557,843,3932,3157,7851,3911,1939,4335,8246,4407,8339
Ͱ,LiuTongXiang,520123205,12277,2007,8372,6358,16448,8322,3652,9395,17717,9564,17936
ֵ´,QingLongJieDaoBanShiChu,520181001,100564,8443,64642,39894,84344,59762,24046,59946,119708,68411,133053
,HongFengHuZhen,520181100,30694,4074,21369,13045,35175,20866,8995,21670,42536,22394,43763
վ,ZhanJieZhen,520181101,52071,4965,34783,20871,60872,33117,14292,34029,67146,36545,71328
,WeiChengZhen,520181102,32838,4232,22692,14613,41645,22069,9755,23172,45241,24133,46825
µ,XinDianZhen,520181103,27625,3618,19135,12564,35693,19102,7953,19878,38980,20061,39196
ٻ,BaiHuaHuXiang,520181200,11478,1550,8057,4852,14574,7779,3420,8155,15934,8391,16448
岼,MaiGeMiaoZuBuYiZuXiang,520181201,11632,1605,7792,5032,15054,7724,3185,8532,16256,8630,16422
,AnLiuXiang,520181202,10731,1756,7164,5383,14003,7089,3007,7904,14993,8330,15494
ׯ,WangZhuangBuYiZuMiaoZuXiang,520181203,12380,1636,8311,5054,15713,8151,3496,8736,16887,9201,17512
,LiuChangMiaoZuXiang,520181204,25670,3288,17785,11761,34536,17568,8426,19033,36601,19599,37384
,LiWoXiang,520181205,21374,2440,14761,9003,28327,14726,6551,15515,30241,15604,30365
½ֵ,HuangTuPoJieDao,520201001,134619,10869,92065,64128,109724,88474,42917,91546,180020,96340,188405
ɳǽֵ,HeChengJieDao,520201002,91462,7358,61628,40103,82018,59662,29830,63277,122939,67022,128650
˽ֵ,FengHuangJieDao,520201003,57037,3295,37137,21365,40574,32709,16248,34010,66719,39443,76580
ֵ,DeWuJieDao,520201004,16111,943,11358,5936,13412,9635,5780,10163,19798,11476,22834
ӥɽ,LaoYingShanZhen,520201100,28894,3534,19623,13094,32051,18513,9721,20026,38539,22526,42149
,DaHeZhen,520201101,22114,2368,15768,9791,28381,15652,9353,17377,33029,18067,33835
կ,WangJiaZhaiZhen,520201102,35242,3496,24052,14804,42917,23433,13131,25649,49082,27817,51869
,DaWanZhen,520201103,36550,2799,26222,13628,44928,25359,16396,27513,52872,29523,55745
,YueZhaoYiZuHuiZuMiaoZuXiang,520201200,10629,1056,7689,4534,12566,7395,4458,7969,15364,8454,16143
ƽկ,PingZhaiZhen,520203100,93171,13246,68169,43839,108680,66045,32409,66398,132443,70657,138826
,LangDaiZhen,520203101,17320,2860,13543,8695,25710,13458,7941,14125,27583,14578,28121
ҽ,YanJiaoZhen,520203102,23450,4150,19581,12324,36107,19558,12130,20047,39605,20149,39730
ľ,MuGangZhen,520203103,10162,1912,7982,5532,15002,7977,4479,8562,16539,8571,16553
,DaYongZhen,520203104,11202,2046,8617,6347,16117,8614,4895,9426,18040,9526,18143
Ҥ,XinYaoXiang,520203200,19008,2877,15093,8825,28645,15033,9532,15880,30913,16324,31417
,LuoBieBuYiZuYiZuXiang,520203201,12422,2536,10421,6543,19626,10403,6702,10992,21395,11239,21660
Ϫ,ZheXiYiZuXiang,520203202,5053,1195,4601,3110,8798,4601,3200,4847,9448,4847,9448
ţ,NiuChangMiaoZuYiZuXiang,520203203,9406,1461,7477,4793,14411,7470,4865,8186,15656,8255,15732
³,XinChangXiang,520203204,15168,2384,12396,7613,24675,12394,7834,12981,25375,12990,25386
կ岼,ZhongZhaiMiaoZuYiZuBuYiZuXiang,520203205,19496,3013,15057,9685,28632,15002,9137,16229,31231,16589,31646
ȴ,DuoQueXiang,520203206,11388,1715,8825,5596,17267,8821,5411,9620,18441,9689,18514
岼,QingKouYiZuYiLaoZuBuYiZuXiang,520203207,6318,831,4711,2726,9137,4698,2885,5202,9900,5323,10034
־岼,SaZhiYiZuBuYiZuMiaoZuXiang,520203208,6785,1182,5711,3581,10272,5698,3983,6223,11921,6239,11950
ëڲ,MaoKouBuYiZuMiaoZuXiang,520203209,4689,698,3694,2282,6882,3674,2200,3814,7488,3893,7587
,LongChangXiang,520203210,16846,2425,14503,8573,27935,14485,10176,14887,29372,14944,29447
»,XinHuaXiang,520203211,11327,1587,9114,5390,16101,9088,6101,9689,18777,9901,19015
,SuoJiaMiaoZuYiZuHuiZuXiang,520203212,8412,1212,6941,4287,13636,6928,4855,7514,14442,7538,14479
¤Ų,LongJiaoBuYiZuXiang,520203213,4253,791,3586,2563,6980,3583,2430,3875,7458,3888,7474
İ,LanBaZhen,520221100,32848,2173,22284,11709,26991,20147,11927,21684,41831,24664,46948
,DongDiXiang,520221200,12578,1279,8936,5494,16628,8642,4901,9528,18170,9822,18758
,DouQingXiang,520221201,12922,1475,9318,5837,17960,9269,5166,10013,19282,10245,19563
ȵ,BiDeXiang,520221202,15967,1793,11855,7507,23250,11840,7033,12826,24666,12938,24793
,HuaLeXiang,520221203,15352,1826,11508,7343,21499,11483,7251,12508,23991,12921,24429
Ͽ,NanKaiXiang,520221204,25987,2657,18940,10691,37800,18892,10747,20351,39243,20451,39391
,QingLinXiang,520221205,9092,1070,7198,4603,13794,7198,4645,7609,14807,7609,14807
,BaoHuaXiang,520221206,14739,1495,10392,6288,20297,10209,5602,11012,21221,11444,21836
,JinPenXiang,520221207,15112,1483,12032,6653,21805,12011,8410,12906,24917,12973,25005
ľ,MuGuoXiang,520221208,21370,2265,15303,8609,28937,15189,8919,16731,31920,17251,32554
,FaQingXiang,520221209,6113,655,4061,2429,8026,4042,1916,4520,8562,4623,8684
˫,ShuangJiaXiang,520221210,6876,640,4779,2593,8485,4741,2646,5237,9978,5383,10162
,YuSheXiang,520221211,22812,2501,15749,9476,30110,15680,8474,17561,33241,18038,33787
,ShaoMiXiang,520221212,15405,1546,10170,5539,19507,10020,5737,11162,21182,12518,22688
ֽ,ZhiChangXiang,520221213,7503,814,5052,2853,10101,5025,2563,5646,10671,5828,10880
ƺկ,PingZhaiXiang,520221214,5348,751,3799,2460,7949,3794,2100,4374,8168,4400,8199
,FaErXiang,520221215,25772,2529,17401,10343,32374,17146,9428,19010,36156,20328,37729
,DouGeXiang,520221216,15756,1886,10765,7397,21953,10701,5672,12242,22943,12549,23314
,JiChangXiang,520221217,15452,1839,10614,7417,22046,10546,6020,11989,22535,12697,23311
,LongChangXiang,520221218,10903,1626,7875,5600,16028,7862,4189,8806,16668,8843,16718
Ӫ,YingPanXiang,520221219,11924,1482,7559,5198,16003,7248,3927,8639,15887,9774,17333
˳,ShunChangXiang,520221220,10849,1629,7831,5030,15909,7772,4291,8752,16524,8938,16769
,HuaGaXiang,520221221,8824,1095,6216,3991,13020,6148,3425,6988,13136,7128,13344
÷,YangMeiXiang,520221222,14872,1861,10954,6527,21327,10933,6294,11997,22930,12073,23027
½,XinJieXiang,520221223,6336,961,4784,3093,9985,4784,2888,5401,10185,5401,10185
Ұ,YeZhongXiang,520221224,10033,1427,7504,4482,14513,7500,4555,8472,15972,8511,16015
,GuoBuGaXiang,520221225,8068,1167,5859,3571,12177,5854,3165,6524,12378,6541,12400
,MiLuoXiang,520221226,15259,2230,10981,8011,22822,10968,5964,12446,23414,12472,23453
,AJiaXiang,520221227,19107,2134,13555,7810,26779,13389,7371,14333,27722,15057,28612
ξ,YanJingXiang,520221228,12742,1476,8659,5116,18463,8621,4778,10253,18874,10337,18996
,PanLongXiang,520221229,21733,2707,15428,10348,31425,15305,8523,17066,32371,17535,32963
ﳡ,HouChangXiang,520221230,10038,1449,7163,4727,14773,7041,4041,7971,15012,8365,15528
,HongYanXiang,520221231,8140,1120,5810,3680,11709,5800,3174,6546,12346,6624,12434
,HongGuoZhen,520222100,83628,5669,53530,36922,84246,50128,22964,54128,104256,58731,112261
ǹ,ChengGuanZhen,520222101,36133,3699,23340,15833,32345,20590,7880,20473,41063,24372,47712
,BanQiaoZhen,520222102,25367,3324,17460,12478,34477,17070,7590,18448,35518,18821,36281
ˮ,ShuiTangZhen,520222103,17711,2943,12694,10240,25908,12675,6012,13911,26586,13972,26666
,MinZhuZhen,520222104,16710,2511,12278,9182,25273,12269,6489,13416,25685,13432,25710
ɽ,DaShanZhen,520222105,23274,2697,16285,11444,32470,16245,8686,18169,34414,18372,34657
,BaoTianZhen,520222106,11514,1620,8324,6124,16447,8306,4151,8898,17204,8961,17285
ϳ,LaoChangZhen,520222107,13981,2338,10405,7598,20449,10397,5450,11299,21696,11364,21769
,MaYiZhen,520222108,10382,1463,7301,5070,15312,7301,3821,8336,15637,8365,15666
ʯ,ShiQiaoZhen,520222109,12389,1412,8296,6228,16590,8280,3905,9179,17459,9410,17706
ƽ,PingGuanZhen,520222110,17951,1402,11262,7694,23473,11237,4837,12704,23941,12928,24190
ˮ,XiangShuiZhen,520222111,16438,1813,11644,8338,22251,11621,6138,12644,24265,12745,24389
,HuoPuZhen,520222112,17652,1253,11002,8069,18567,10963,4826,12502,23465,12729,23731
,LeMinZhen,520222113,31241,2897,21048,13911,41999,20982,10483,22995,43977,23573,44621
,XiChongZhen,520222114,14490,1564,9517,6194,19438,9474,4008,10349,19823,10545,20062
Ͻ,DuanJiangZhen,520222115,27031,2212,17100,12854,30414,16952,6757,18447,35399,18900,36000
̽,PanJiangZhen,520222116,20851,1954,13558,8975,25286,13382,5889,14640,28022,15136,28694
ع,BaiGuoZhen,520222117,49900,4344,33192,22374,66759,33146,15111,36003,69149,36163,69355
,SaJiZhen,520222118,17808,1210,11339,8518,18529,11319,4987,12559,23878,12666,24005
,LiuGuanZhen,520222119,18574,2433,13089,9679,25399,13014,6295,13965,26979,14213,27302
,ZhongYiXiang,520222200,10844,1620,7582,5614,15870,7580,3583,8448,16028,8465,16047
,XinMinXiang,520222201,18892,2748,14195,9786,28840,14138,7974,15168,29306,15419,29614
,PuTianHuiZuXiang,520222202,7509,968,5281,3626,10954,5279,2505,5698,10977,5701,10982
鶫,ZhuDongXiang,520222203,13560,1948,9518,7113,19189,9483,4463,10394,19877,10453,19971
,LiangHeXiang,520222204,12278,1360,8123,5386,16231,8023,3745,8921,16944,9260,17383
ʯ,HuaShiXiang,520222205,14875,2009,10105,7489,20507,10022,4610,10986,21008,11389,21494
ƺ,JiChangPingYiZuXiang,520222206,25756,2494,17076,10495,34443,16798,7699,18195,34993,18873,35949
ɺ,SongHeYiZuXiang,520222207,20172,1510,12235,8404,23222,12009,5518,12971,24980,14965,27200
ƺ,PingDiYiZuXiang,520222208,21372,2253,14346,9945,29779,14330,6800,15936,30266,16079,30425
ĸ,SiGeYiZuXiang,520222209,13248,1689,9024,6609,18889,9020,4324,10211,19231,10237,19261
,YuNiYiZuXiang,520222210,19861,1903,12753,8215,24790,12394,5493,13297,25691,14504,27257
չ,PuGuYiZuMiaoZuXiang,520222211,13807,1956,9502,7155,19503,9494,4266,10506,20000,10527,20029
Ӫ,JiuYingBaiZuYiZuMiaoZuXiang,520222212,11433,2112,8486,6872,17258,8475,4063,9106,17581,9122,17608
򳡲,YangChangBuYiZuBaiZuMiaoZuXiang,520222213,19043,2674,13259,10117,26894,13227,6233,14437,27664,14691,27950
,BaoJiMiaoZuYiZuXiang,520222214,7694,1066,5364,3868,11111,5350,2596,5939,11289,5992,11356
Ӣ,YingWuXiang,520222215,9630,1388,6960,4970,13618,6933,3348,7331,14264,7406,14366
�,MaChangYiZuMiaoZuXiang,520222216,6547,1094,4988,3645,10032,4974,2750,5385,10359,5403,10391
ϳǽֵ´,LaoChengJieDaoBanShiChu,520302001,42188,5600,26987,19654,43444,25572,7188,24183,49755,27989,54976
·ֵ´,WanLiLuJieDaoBanShiChu,520302002,28020,3482,18982,11466,21542,16397,5415,15478,31875,17935,36917
л·ֵ´,ZhongHuaLuJieDaoBanShiChu,520302003,33917,3295,22644,16573,25371,22329,7108,21342,43671,21676,44320
Źؽֵ´,NanMenGuanJieDaoBanShiChu,520302004,29444,3377,19509,14551,21582,19215,6724,19088,38303,20036,39545
Ӱ·ֵ´,YanAnLuJieDaoBanShiChu,520302005,38562,4174,25314,17542,32317,23395,6944,22424,45819,24366,49680
ˮŽֵ´,ZhouShuiQiaoJieDaoBanShiChu,520302006,22878,3526,15254,12365,20771,14792,5267,15295,30087,16417,31671
ɽ·ֵ´,ZhongShanLuJieDaoBanShiChu,520302007,23480,2864,16066,10913,21132,15134,4801,14171,29305,15079,31145
·ֵ´,BeiJingLuJieDaoBanShiChu,520302008,16837,1774,11231,10014,14004,11166,3569,10785,21951,10949,22180
,ChangZhengZhen,520302100,93959,4502,62677,42760,37582,62101,30283,64588,126689,66067,128744
,XiangKouZhen,520302101,8143,1029,5533,3758,10128,5513,2196,5772,11285,5835,11368
Ϲ,NanGuanZhen,520302102,33763,2707,22378,14381,22932,22260,9332,22851,45111,23424,45802
ׯ,ZhongZhuangZhen,520302103,35605,3299,23516,14696,26829,20587,7968,20977,41564,23356,46872
,HaiLongZhen,520302104,9253,1207,6332,4098,11367,6218,2288,6242,12460,6416,12748
Ϫ,ShenXiZhen,520302105,20131,2469,13585,8191,25620,13178,5351,13808,26986,14366,27951
ɽ,JinDingShanZhen,520302106,18545,2706,13164,9145,24817,13024,5569,13458,26482,13656,26820
,XinPuZhen,520302107,33613,3322,21337,13534,37671,19755,8918,20593,40348,24516,45853
Ϻ·ֵ´,ShangHaiLuJieDaoBanShiChu,520303001,59686,5494,36773,24760,37647,34122,11803,32909,67031,40210,76983
ϴ·ֵ´,XiMaLuJieDaoBanShiChu,520303002,36098,4024,23979,14722,22955,18882,5458,17994,36876,21601,45580
·ֵ´,DaLianLuJieDaoBanShiChu,520303003,54786,4468,35950,24023,36246,31063,12107,31034,62097,35411,71361
,GaoQiaoZhen,520303100,59590,2782,39498,26847,23868,38827,18856,40498,79325,41730,81228
,DongGongSiZhen,520303101,19772,1979,13121,9081,19516,12926,5253,13257,26183,13883,27004
,TuanZeZhen,520303102,23131,4031,17268,12054,32624,16965,8365,17934,34899,18259,35527
ƺ,GaoPingZhen,520303103,38101,5148,27140,16052,49960,26734,11868,27417,54151,27977,55117
,BanQiaoZhen,520303104,12575,2228,9531,6570,17663,9505,4423,9584,19089,9695,19226
,SiDuZhen,520303105,17357,2878,12844,8505,24404,12815,6018,13291,26106,13409,26253
ϰ,NanBaiZhen,520321100,94083,8099,62506,38193,88666,57077,25008,58455,115532,64684,127190
,LongKengZhen,520321101,36515,3448,24196,14562,35583,22930,9971,23512,46442,25738,49934
,SanChaZhen,520321102,18899,2757,13240,8712,25114,13190,5491,13648,26838,13907,27147
,GouJiangZhen,520321103,10566,2024,8076,5197,15655,7949,3940,8233,16182,8454,16530
,SanHeZhen,520321104,33933,5148,24729,16157,48426,24699,11577,25805,50504,25929,50658
ڽ,WuJiangZhen,520321105,10806,1409,7647,5173,12795,7211,3420,7270,14481,7988,15635
Ϻ,XiaZiZhen,520321106,33128,5052,24431,16853,46285,24294,11820,25389,49683,25569,50000
,SanDuZhen,520321107,8917,1648,6812,4874,13085,6741,3339,6955,13696,7092,13904
,XinZhouZhen,520321108,36788,5626,27107,17021,49047,25816,11616,25680,51496,26923,54030
,YongLeZhen,520321109,19304,3292,14381,9803,28106,14368,6713,14857,29225,14928,29309
ƺ,LongPingZhen,520321110,19187,3175,13978,9036,26447,13643,5865,13805,27448,14249,28227
,LaBaZhen,520321111,9911,1880,7624,5333,14844,7560,3615,7624,15184,7782,15406
Ϫ,TuanXiZhen,520321112,28176,3941,20573,12839,37022,19625,9008,19661,39286,20552,41125
,TieChangZhen,520321113,7556,1171,5477,3756,10583,5430,2500,5645,11075,5750,11227
ƺ,XiPingZhen,520321114,17082,2761,12376,8520,24167,12213,5262,12304,24517,12729,25105
,ShangJiZhen,520321115,23440,2922,16231,9424,28738,15446,7225,15670,31116,17356,33587
é,MaoLiZhen,520321116,12733,2104,9618,6273,18375,9486,4806,9731,19217,10025,19643
,XinMinZhen,520321117,9448,1579,7102,4928,13655,7095,3537,7425,14520,7462,14564
ѼϪ,YaXiZhen,520321118,38021,4519,26776,16883,47243,25922,12307,26604,52526,28071,54847
ʯ,ShiBanZhen,520321119,16667,2891,12320,8189,23411,12301,5768,12945,25246,13006,25326
ɽ,LeShanZhen,520321120,11760,1871,8637,5753,16414,8516,4167,8856,17372,9161,17798
,FengXiangZhen,520321121,20820,2932,14461,9678,27305,14401,6518,15276,29677,15809,30270
ˮ,PanShuiZhen,520321122,20736,3509,15308,10387,28004,15246,7720,16257,31503,16657,31965
,MaTiZhen,520321123,17592,2940,12931,8559,25079,12834,6553,13713,26547,14154,27085
ɳ,ShaWanZhen,520321124,11531,2006,8324,5679,16374,8279,3852,8929,17208,9065,17389
,SongLinZhen,520321125,12726,2271,9214,6247,16982,9145,4340,9774,18919,10123,19337
ëʯ,MaoShiZhen,520321126,9619,1809,6832,4727,13526,6784,3110,7326,14110,7706,14538
ɽ,ShanPenZhen,520321127,27392,4421,21524,13243,40529,21315,12466,21812,43127,22755,44279
֥,ZhiMaZhen,520321128,8031,1407,6128,3803,11785,6044,3432,6575,12619,6742,12870
ƽ,PingZhengXiang,520321200,10550,1704,7503,5362,14492,7361,3802,8100,15461,8553,16056
,HongGuanXiang,520321201,4922,879,3832,2488,7377,3827,2122,4087,7914,4091,7923
¦ɽ,LouShanGuanZhen,520322100,96986,9778,68669,44847,99449,67479,30641,67166,134645,68736,137405
,ChuMiZhen,520322101,14716,2077,10486,6403,19520,10332,5014,10772,21104,11321,21807
վ,XinZhanZhen,520322102,12588,2502,9604,6593,18010,9526,4546,9820,19346,10032,19636
ɿ,SongKanZhen,520322103,10673,1820,7475,5301,14278,7424,3252,7975,15399,8270,15745
,GaoQiaoZhen,520322104,12382,2190,9817,6434,19135,9813,5329,10070,19883,10084,19901
ˮ,ShuiBaTangZhen,520322105,10224,1921,8109,4947,15179,8066,4349,8183,16249,8385,16494
ٲ,GuanCangZhen,520322106,16427,2791,12609,8376,24508,12571,6747,13205,25776,13356,25965
,HuaQiuZhen,520322107,21877,3563,17568,10707,34452,17498,10524,17867,35365,18396,35964
,YangDengZhen,520322108,9297,1783,7383,4701,14570,7337,4045,7603,14940,7742,15125
Ű,JiuBaZhen,520322109,15913,2244,11564,6789,22977,11551,5895,12407,23958,12488,24052
,DaHeZhen,520322110,5217,969,3747,2662,7471,3724,1829,4134,7858,4268,8015
ҹ,YeLangZhen,520322111,9572,2148,7378,5354,14415,7335,3614,7870,15205,7956,15334
ľ,MuGuaZhen,520322112,13323,2310,9885,5954,19517,9758,5048,10505,20263,10796,20681
¶,PoDuZhen,520322113,9773,1927,7860,4741,14857,7855,4187,7982,15837,8027,15887
ԭ,LiaoYuanZhen,520322114,12861,1502,9111,5136,17169,8999,4718,9502,18501,9970,19081
ʨϪ,ShiXiZhen,520322115,15336,3000,12283,7577,23840,12071,6815,12188,24259,12868,25151
éʯ,MaoShiXiang,520322200,7836,1246,5599,3593,11195,5570,2876,6169,11739,6359,11958
ˮ,FengShuiXiang,520322201,9134,1756,7472,4895,14915,7462,4445,7804,15266,7863,15335
ݹ,RongGuangXiang,520322202,8171,1582,6353,3922,12038,6285,3420,6417,12702,6820,13173
Сˮ,XiaoShuiXiang,520322203,5103,1244,4023,2835,7946,4003,2072,4324,8327,4396,8419
ƺ,TianPingXiang,520322204,10709,2160,8227,5516,16475,8205,4174,8751,16956,8816,17043
,HuangLianXiang,520322205,3502,562,2820,1671,5079,2813,1869,3057,5870,3113,5933
Ž,BaJiaoXiang,520322206,4881,895,3878,2690,7706,3878,2230,4128,8006,4128,8006
,MaZongMiaoZuXiang,520322207,3711,623,2609,1902,5384,2598,1396,3053,5651,3121,5730
,YangChuanZhen,520323100,57908,6365,41696,26311,64200,40985,19128,40927,81912,41705,83401
֣,ZhengChangZhen,520323101,19155,2880,14362,9596,27109,14328,6710,14355,28683,14383,28745
,WangCaoZhen,520323102,25872,4467,21233,14001,40391,20992,12509,21200,42192,21615,42848
ѳ,PuChangZhen,520323103,20067,3091,14752,9324,26815,14594,6789,14599,29193,15195,29947
绪,FengHuaZhen,520323104,22804,3439,16989,10361,30567,16684,7986,16709,33393,17240,34229
é,MaoYaZhen,520323105,11864,2455,10009,6544,19152,10000,5848,10130,20130,10158,20167
Ű,JianBaZhen,520323106,11613,2019,8493,5210,16526,8429,4530,9215,17644,9669,18162
,KuanKuoZhen,520323107,10863,1786,8121,5137,16072,8049,4360,8649,16698,8888,17009
,HuangYangZhen,520323108,11347,1854,9164,5789,17817,9156,5445,9387,18543,9482,18646
,QingGangTangZhen,520323109,9618,1946,8071,5201,15379,8005,4690,8062,16067,8183,16254
̫,TaiBaiZhen,520323110,9530,1625,7714,4646,13889,7641,4706,7929,15570,8147,15861
Ȫ,WenQuanZhen,520323111,11699,2176,9531,6171,18408,9453,5641,9829,19282,9985,19516
·,DaLuCaoXiang,520323200,6098,1196,4934,3252,9640,4927,2712,5040,9967,5072,10006
С,XiaoGuanXiang,520323201,8737,1302,6548,4021,12639,6501,3456,6837,13338,6947,13495
ƺ,PingLeXiang,520323202,7084,1324,5730,3810,11179,5720,3389,6036,11756,6067,11797
,FengYiZhen,520324100,37083,4033,26867,17368,40045,25927,12651,25554,51481,26900,53767
Ϫ,RuiXiZhen,520324101,13197,2444,10136,6837,20222,10103,5089,10452,20555,10594,20730
Ϫ,HeXiZhen,520324102,13708,2711,11425,7536,22466,11358,7114,11971,23329,12108,23533
,AnChangZhen,520324103,29462,5046,23539,14466,44690,22976,12867,22960,45936,23836,47375
ƺ,TuPingZhen,520324104,16802,3489,13256,9262,26233,12937,6915,13478,26415,13950,27206
,LiuDuZhen,520324105,12069,2539,9451,6896,18977,9381,4791,9796,19177,9948,19399
,GeLinZhen,520324106,11817,2570,9940,6624,19722,9888,5890,10165,20053,10337,20277
,XinZhouZhen,520324107,11921,2363,9938,6451,19383,9851,5457,9642,19493,9803,19741
,MiaoTangZhen,520324108,9666,1834,8016,5014,15154,7991,4421,7857,15848,7905,15921
С,XiaoYaZhen,520324109,13579,2732,11250,7164,22100,11190,6366,11277,22467,11427,22677
й,ZhongGuanZhen,520324110,11368,2110,8719,6040,17123,8701,4490,9085,17786,9249,17968
̷,BiFengXiang,520324200,9960,1692,7697,5006,15516,7674,4213,8112,15786,8168,15865
ּ,LeJianXiang,520324201,5118,1057,4064,2912,7989,4049,2238,4280,8329,4349,8413
л,XieBaXiang,520324202,5516,944,4220,2932,8303,4180,2262,4406,8586,4502,8722
ƺ,ShiPingXiang,520324203,7705,1335,6035,4067,11799,6018,3182,6155,12173,6187,12222
ƺ,JianPingXiang,520324204,8028,1776,6830,4460,13433,6823,4101,7060,13883,7075,13905
,YangXingXiang,520324205,6997,1333,5415,3701,10709,5353,2694,5449,10802,5609,11024
,FuYanXiang,520324206,7942,1414,6008,3909,11864,5990,3125,6369,12359,6473,12481
,BanZhuXiang,520324207,11921,1947,8875,5593,17535,8831,4540,9292,18123,9533,18408
Ϫ,YuXiZhen,520325100,54266,6715,42144,25736,60694,40387,21130,38203,78590,39967,82111
,SanJiangZhen,520325101,4654,902,3518,2502,6795,3460,1787,3613,7073,3825,7343
¡,LongXingZhen,520325102,12417,2331,9699,6606,18781,9583,5148,9798,19381,10197,19896
ɳ,JiuChengZhen,520325103,9916,1872,7931,5524,15020,7832,4349,7919,15751,8206,16137
,ZhongXinZhen,520325104,7783,1651,6709,4665,12164,6651,3411,5973,12624,6136,12845
,LuoLongZhen,520325105,9575,2000,7406,5117,14260,7358,3414,7403,14761,7583,14989
Ϫ,YangXiZhen,520325106,4971,1226,3828,2834,7789,3803,1913,4196,7999,4282,8110
,SanQiaoZhen,520325107,9962,2504,8762,6331,16340,8675,4444,7927,16602,8148,16910
,DaGanZhen,520325108,9724,2027,7969,5043,15165,7859,3925,7495,15354,7707,15676
ƽģ,PingMoZhen,520325109,5647,1201,4712,3079,8868,4601,2576,4423,9024,4712,9424
ϰ,ShangBaTuJiaZuXiang,520325200,7920,1292,6282,4021,11749,6215,3309,6092,12307,6239,12521
ƺ,ZongPingXiang,520325201,4887,994,3834,2702,7530,3789,2132,4074,7863,4179,8013
Դ,TaoYuanXiang,520325202,4147,803,3168,2221,6151,3149,1622,3306,6455,3404,6572
ӿ,HeKouXiang,520325203,8263,1741,6859,4515,13158,6773,3608,6581,13354,6753,13612
,DouRuZhen,520326100,50277,5521,37400,22009,55650,35697,20310,36191,71888,38708,76108
,FengLeZhen,520326101,15863,2404,12301,7164,23937,12213,6739,12390,24603,12705,25006
ƶ,HuangDouZhen,520326102,13591,2266,10783,6394,21148,10759,6073,11051,21810,11147,21930
,FuYangZhen,520326103,14324,2882,12282,8076,23736,12212,7329,12133,24345,12253,24535
,ZhenNanZhen,520326104,10688,2109,8786,6103,16904,8718,4872,8710,17428,8883,17669
ɽ,YanShanZhen,520326105,4947,1268,4139,3169,8288,4132,2280,4341,8473,4356,8495
ˮ,ZhuoShuiZhen,520326106,14720,3132,12351,7970,24241,12111,7547,12725,24836,13048,25399
é,MaoTianZhen,520326107,10439,2323,8751,5723,17342,8728,5600,9560,18288,9611,18362
ش,BaiCunZhen,520326108,6134,1166,4824,3375,9170,4752,2695,4715,9467,5171,9995
ƺ,DaPingZhen,520326109,11848,2246,9927,6677,18962,9923,5941,10069,19992,10108,20035
,NiGaoXiang,520326200,14458,2252,11701,6954,22741,11668,7073,11846,23514,12082,23783
ˮ,FenShuiXiang,520326201,7800,1751,6704,4155,13205,6646,4183,6899,13545,7030,13734
,JiaoBaXiang,520326202,10446,1706,8719,5553,17129,8705,5580,8951,17656,9013,17732
˿,HongSiXiang,520326203,5658,950,4755,3099,9390,4738,3052,4862,9600,4905,9660
ʯ,ShiChaoXiang,520326204,5734,1045,4426,2685,8911,4413,2435,4724,9137,4788,9214
Ȫ,LongQuanZhen,520327100,45161,3751,30971,19813,43116,28995,13468,29005,58000,31409,62380
,JinHuaZhen,520327101,17111,2433,12552,8085,24456,12479,6013,12866,25345,13005,25557
,YaChuanZhen,520327102,13768,2422,10624,6903,20483,10537,5355,10791,21328,10921,21545
,FengYanZhen,520327103,13983,2650,11022,7474,21634,11013,5846,11434,22447,11457,22479
,YongHeZhen,520327104,10059,1907,8186,5244,15660,8139,4394,8050,16189,8174,16360
ƺ,HuaPingZhen,520327105,9955,1771,7948,5306,15316,7868,4486,8136,16004,8264,16212
,SuiYangZhen,520327106,15218,2312,12172,8116,24150,12070,7356,12551,24621,12714,24886
Ϫ,TuXiZhen,520327107,15848,2567,13055,8289,25210,12977,7944,13021,25998,13304,26359
,YongAnZhen,520327108,12061,1629,9139,5823,17563,9050,4900,9288,18338,9451,18590
ΰ,HeBaXiang,520327200,12902,1755,9223,5964,18146,9210,4261,9640,18850,9695,18918
,TianQiaoXiang,520327201,10549,1742,8345,5570,16278,8327,4906,8799,17126,8852,17197
կ,WangZhaiXiang,520327202,9528,1959,7972,5136,15718,7941,4776,8202,16143,8291,16263
ʯ,ShiJingXiang,520327203,7500,1289,5908,4250,11538,5904,3152,6022,11926,6033,11941
½,XinJianXiang,520327204,8743,1476,7103,4974,13803,7092,4222,7309,14401,7338,14441
ؽ,MeiJiangZhen,520328100,66947,6529,46614,26642,64375,41350,18787,40488,81838,45649,92263
,YongXingZhen,520328101,26668,4290,20039,13451,37106,19886,8948,19627,39513,19867,39906
,FuXingZhen,520328102,14737,2406,11720,8081,22601,11691,6617,11916,23607,12040,23760
ɽ,MaShanZhen,520328103,12361,2060,9796,6668,18404,9786,5205,9800,19586,9830,19626
Ȫ,YuQuanZhen,520328104,7190,1402,5816,4134,11217,5811,3017,5770,11581,5793,11609
ƼҰ,HuangJiaBaZhen,520328105,22922,3825,17501,11276,32966,17271,8406,17248,34519,17652,35153
̨,GaoTaiZhen,520328106,12193,2506,9728,6432,19253,9664,5413,10223,19887,10384,20112
éƺ,MaoPingZhen,520328107,5514,841,4289,2902,7991,4229,2348,4323,8552,4414,8703
¡,XingLongZhen,520328108,16814,2849,12946,8168,24619,12869,6304,12923,25792,13021,25967
,XiHeXiang,520328200,11457,1968,9110,6127,17634,9060,5194,9416,18476,9509,18619
ϴ,XiMaXiang,520328201,10249,1908,8351,5730,16380,8343,4777,8568,16911,8583,16934
,XinNanXiang,520328202,11872,1738,9285,5704,17355,9207,5251,9468,18675,9576,18861
ʯ,ShiLianXiang,520328203,12803,1998,9647,6272,18903,9565,5029,10009,19574,10183,19830
,ChaoLeXiang,520328204,8330,1569,6479,4428,12304,6470,3181,6584,13054,6601,13080
,TianChengXiang,520328205,8303,1397,6447,4074,12314,6407,3235,6406,12813,6488,12935
,BaiNiZhen,520329100,38856,5013,27891,16373,44033,24785,12461,24903,49688,28439,56330
С,XiaoSaiZhen,520329101,6602,1281,5219,3723,10228,5203,2831,5459,10662,5495,10714
Ϫ,LongXiZhen,520329102,19409,2751,15137,9377,26748,14383,8334,14506,28889,15357,30494
Ƥ̲,GouPiTanZhen,520329103,18100,2988,13491,9139,25192,13161,6954,13460,26621,14551,28042
ڽ,DaWuJiangZhen,520329104,14852,2804,12012,8073,23017,11999,6509,12125,24124,12153,24165
Ϫ,AoXiZhen,520329105,12978,2101,9740,6135,17143,9327,4472,9387,18714,9811,19551
,LongJiaZhen,520329106,9351,1696,7365,4852,14133,7350,3666,7324,14674,7348,14713
,SongYanZhen,520329107,15713,2935,12336,8390,22996,12168,6188,12223,24391,12500,24836
,GuanXingZhen,520329108,9546,1811,7515,5547,14605,7418,3953,7553,14971,7795,15310
ɽ,HuaShanMiaoZuXiang,520329200,6684,1269,5190,3396,10074,5088,2631,5231,10319,5394,10584
,DongHuangZhen,520330100,75554,5894,52121,30830,73645,51022,24789,52522,103544,54116,106237
,TuChengZhen,520330101,19685,3723,14764,9695,27101,14209,6701,14877,29086,15345,30109
ͬ,TongMinZhen,520330102,7132,1509,5468,3873,10843,5454,2671,5815,11269,5844,11312
,XingMinZhen,520330103,7082,1308,5693,3513,10688,5682,3079,5753,11435,5776,11469
¡,LongXingZhen,520330104,22377,2959,16143,9706,30984,16112,8030,17056,33168,17223,33366
ϰ,XiJiuZhen,520330105,19591,2639,13422,8583,24818,13188,5815,14031,27219,14623,28045
,HuiLongZhen,520330106,15024,2369,11926,6996,22691,11836,6583,11776,23612,12050,23976
ɣľ,SangMuZhen,520330107,10162,1669,8065,4889,15145,8036,4485,8204,16240,8251,16316
,YongAnZhen,520330108,9811,1957,8560,5280,16928,8547,5602,8794,17341,8810,17370
,LiangCunZhen,520330109,17231,2617,13011,7794,25543,12997,6785,13553,26550,13622,26633
ˮ,WenShuiZhen,520330110,25352,3653,18406,11729,32216,18155,8377,18622,36777,18976,37382
Դ,XianYuanZhen,520330111,12138,2087,8668,5550,16656,8637,4057,9485,18122,9614,18282
ٵ,GuanDianZhen,520330112,12222,2147,9726,5853,18723,9697,5296,9833,19530,9939,19665
կ,ZhaiBaZhen,520330113,10721,2668,8395,5768,16006,8344,3718,8599,16943,8712,17107
,MinHuaXiang,520330200,10272,1464,7264,4312,14385,7216,3333,7591,14807,7805,15069
,ErLangXiang,520330201,9456,1898,7923,5030,15362,7843,4789,7988,15831,8220,16143
,ErLiXiang,520330202,9295,1625,7192,4358,13777,7136,4176,7334,14470,7904,15096
,SanChaHeXiang,520330203,7706,1698,5986,4321,11810,5895,3103,6346,12241,6521,12507
,DaPoXiang,520330204,12609,2283,9866,6339,17606,9803,5122,10026,19829,10148,20014
˫,ShuangLongXiang,520330205,5957,1202,4671,3063,9194,4651,2380,4774,9425,4868,9539
,TaoLinXiang,520330206,10271,1775,8030,4718,15736,8024,4330,8325,16349,8346,16376
,NiBaXiang,520330207,5399,1632,4515,3232,8627,4491,2224,4653,9144,4740,9255
կ,ChengZhaiXiang,520330208,7624,1514,5826,3962,11354,5800,2774,6012,11812,6086,11912
нֵ´,ShiZhongJieDaoBanShiChu,520381001,30993,4098,22205,15342,32649,21613,7658,19986,41599,20544,42749
Ļֵ´,WenHuaJieDaoBanShiChu,520381002,12149,1527,8614,5493,9789,8146,3366,7960,16106,8428,17042
𻪽ֵ´,JinHuaJieDaoBanShiChu,520381003,8933,1314,5987,4519,10432,5805,1848,5845,11650,6108,12095
̨,TianTaiZhen,520381100,9830,2019,7271,4980,14737,7171,3189,7675,14846,7767,15038
,FuXingZhen,520381101,10053,1921,7357,5325,14521,7322,3177,7749,15071,7794,15151
ͬ,DaTongZhen,520381102,9877,2001,7246,5174,14362,7242,3039,7662,14904,7671,14917
¡,WangLongZhen,520381103,9685,2089,7508,5485,14830,7493,3828,8027,15520,8094,15602
,HuShiZhen,520381104,7856,1577,5944,4195,11765,5938,2921,6345,12283,6410,12354
Ԫ,YuanHouZhen,520381105,7588,1373,5767,4074,11458,5728,3077,6171,11899,6271,12038
ٶ,GuanDuZhen,520381106,11684,2873,9631,7300,18190,9550,5092,9933,19483,10018,19649
,ChangQiZhen,520381107,9917,2704,8601,6448,16733,8598,4545,8543,17141,8565,17166
ɳ,ChangShaZhen,520381108,8423,1846,6836,4756,12750,6800,3446,6828,13628,6879,13715
ӿ,LiangHeKouXiang,520381200,3483,606,2427,1660,4957,2392,1141,2781,5173,2803,5230
,BingAnXiang,520381201,3490,740,2566,1923,5365,2548,1217,2839,5387,2881,5447
Դ,BaoYuanXiang,520381202,4439,883,3269,2177,6676,3195,1479,3467,6662,3532,6801
ʯ,ShiBaoXiang,520381203,2923,867,2536,1987,5004,2510,1377,2578,5088,2631,5167
,BaiYunXiang,520381204,3870,1103,3477,2447,6740,3452,1918,3379,6831,3414,6891
νֵ´,YanJinJieDaoBanShiChu,520382001,27593,1510,18537,10710,22322,17713,9130,18642,36355,19696,38233
ֵ´,ZhongShuJieDaoBanShiChu,520382002,55821,3506,38059,22187,52741,35250,18547,36772,72022,39815,77874
ֵ´,CangLongJieDaoBanShiChu,520382003,16832,1654,12155,6246,22390,11821,6389,12364,24185,12720,24875
ę́,MaoTaiZhen,520382100,33853,2898,22756,12848,41816,22718,9963,23737,46455,23958,46714
̳,TanChangZhen,520382101,15507,1957,10842,6538,21434,10829,4938,11528,22357,11560,22402
,ChangGangZhen,520382102,11996,2005,8289,5628,16112,8248,3583,9028,17276,9295,17584
³,LuBanZhen,520382103,24625,2855,16952,9201,30952,16122,7927,17082,33204,18455,35407
,WuMaZhen,520382104,17343,2352,12115,7137,23463,12026,5929,12958,24984,13509,25624
é,MaoBaZhen,520382105,19871,2909,14396,8670,28855,14178,7247,15283,29461,15631,30027
Ų,JiuCangZhen,520382106,11756,2281,9330,5703,18401,9307,5227,9883,19190,9934,19264
ϲͷ,XiTouZhen,520382107,13843,1824,10121,5381,19476,10086,5221,10648,20734,10767,20888
,DaBaZhen,520382108,19073,2967,14809,8338,28565,14756,8157,15238,29994,15388,30197
,SanHeZhen,520382109,16569,2685,12944,7791,25325,12841,7329,13408,26249,13639,26583
,HeMaZhen,520382110,9705,1618,7585,4513,14516,7567,4162,7845,15412,7900,15485
,ErHeZhen,520382111,14444,2135,10417,5683,19985,10320,4855,10792,21112,11017,21434
,LongJingXiang,520382200,8403,1521,6688,3920,12653,6640,3777,6878,13518,7013,13701
ɽ岼,HouShanMiaoZuBuYiZuXiang,520382201,5225,827,3536,2329,7196,3482,1759,4160,7642,4275,7811
ѧ,XueKongXiang,520382202,10521,1357,8187,4716,15565,8134,4991,8503,16637,8682,16869
ߴƺ,GaoDaPingXiang,520382203,18710,2605,14843,8002,27478,14822,8744,15088,29910,15216,30059
ʯ,HuoShiGangXiang,520382204,9700,1868,8154,4752,16280,8136,5246,8558,16694,8660,16814
ɳ̲,ShaTanXiang,520382205,5587,976,4226,2677,8074,4210,2069,4278,8488,4406,8632
Ͻֵֽ´,NanJieJieDaoBanShiChu,520402001,15702,2381,10768,7995,13083,10543,2863,9879,20422,10178,20946
ֵֽ´,DongJieJieDaoBanShiChu,520402002,13171,1995,9232,6676,12063,8255,2306,7790,16045,8240,17472
ֵֽ´,XiJieJieDaoBanShiChu,520402003,15431,2192,10533,7382,12119,9976,2943,9615,19591,10033,20566
ֵֽ´,BeiJieJieDaoBanShiChu,520402004,19959,2860,13563,9780,15808,12823,3955,12529,25352,13211,26774
ؽֵ´,DongGuanJieDaoBanShiChu,520402005,68147,8083,47236,27808,73267,44483,18008,44084,88567,47002,94238
ֵ´,HuaXiJieDaoBanShiChu,520402006,59817,5050,36222,22627,51404,35986,14982,35978,71964,43627,79849
�ֵ´,XiHangJieDaoBanShiChu,520402007,57765,4944,37313,22802,44934,33700,14482,34273,67973,39878,77191
,SongQiZhen,520402100,11608,1774,9133,5630,15866,9054,5219,9261,18315,9468,18601
,YaoPuZhen,520402101,29764,4774,21789,14268,40965,21509,10165,22244,43753,22914,44703
,NingGuZhen,520402102,21429,2714,16282,9299,30057,16209,9162,16831,33040,17023,33305
,LongGongZhen,520402103,11666,1683,9110,5492,17586,9025,5104,9225,18250,9343,18453
˫,ShuangBaoZhen,520402104,15594,2738,12593,7811,21547,12435,6930,12455,24890,12669,25262
,DaXiQiaoZhen,520402105,21073,3490,16300,9190,31117,16219,8138,16201,32420,16401,32701
,QiYanQiaoZhen,520402106,25918,4754,20907,11879,39488,20626,11398,20687,41313,21163,42070
̹,CaiGuanZhen,520402107,29295,4307,21148,11952,40180,20667,11978,21736,42403,24432,45580
ɽ,JiaoZiShanZhen,520402108,25556,3780,18842,10712,32471,18346,10215,18624,36970,20709,39551
,JiuZhouZhen,520402109,17280,2787,13845,8405,25833,13806,7657,13832,27638,13879,27724
³,XinChangBuYiZuMiaoZuXiang,520402200,6802,1220,5354,3355,10370,5295,3051,5615,10910,5719,11073
岼,YanLaMiaoZuBuYiZuXiang,520402201,7966,1228,6969,3753,12597,6944,5001,7150,14094,7226,14195
,JiChangBuYiZuMiaoZuXiang,520402202,8101,1213,6354,3750,11094,6292,3553,6375,12667,6513,12867
䲼,YangWuBuYiZuMiaoZuXiang,520402203,10265,2246,8492,5515,15887,8384,4604,8444,16828,8623,17115
,DongTunXiang,520402204,15894,2056,12009,5487,23137,11971,6171,12041,24012,12112,24121
,HuangLaBuYiZuMiaoZuXiang,520402205,6309,1400,5171,3251,9586,5106,2699,5149,10255,5237,10408
,LiuGuanXiang,520402206,6570,1239,5314,3156,9730,5201,2825,5133,10334,5320,10634
ǹ,ChengGuanZhen,520421100,44011,3998,29296,18161,41550,28319,13511,28465,56784,32224,61520
,BaiYunZhen,520421101,21409,3786,16020,11021,28176,15830,7278,16096,31926,16453,32473
߷,GaoFengZhen,520421102,14883,2631,11390,7875,19829,11335,5748,11756,23091,11872,23262
,TianLongZhen,520421103,13525,1813,10042,5928,17097,9950,5394,10305,20255,10690,20732
,XiaYunZhen,520421104,22134,3398,16381,10453,25403,15926,7786,16060,31986,16937,33318
�,MaChangZhen,520421105,25977,4380,18745,12527,32994,18491,8357,19616,38107,19969,38714
ƽ,LePingXiang,520421200,22959,3142,16631,10659,29449,16550,9399,17532,34082,18869,35500
벮,QiBoXiang,520421201,7783,1275,5973,4254,10901,5965,3437,6495,12460,6522,12495
ʮֻ,ShiZiHuiZuMiaoZuXiang,520421202,16428,2252,11924,7587,21415,11831,6463,12890,24721,13219,25143
,YangChangBuYiZuMiaoZuXiang,520421203,9450,1598,7173,4839,13212,7014,3785,7473,14487,7660,14833
ǹ,ChengGuanZhen,520422100,57811,6282,41805,26104,69295,40530,21102,41925,82455,43390,85195
,MaGuanZhen,520422101,29281,3731,20371,12043,38932,20245,11584,21810,42055,24225,44596
,HuaChuZhen,520422102,25706,3529,19209,10284,38797,18942,10724,20416,39358,20750,39959
�,MaChangZhen,520422103,24151,2695,18269,9854,36526,18207,11365,19846,38053,19942,38211
,BaiYanZhen,520422104,21265,2605,14709,7702,28427,14584,6553,15375,29959,15714,30423
,LongChangXiang,520422200,16219,2374,12268,7454,24015,12243,7212,13227,25470,13537,25805
,JiChangPoXiang,520422201,19317,2133,14659,8236,27528,14585,9276,15496,30081,16067,30726
ƺ岼,PingShangMiaoZuYiZuBuYiZuXiang,520422202,15756,2012,11822,6417,22777,11737,6912,12699,24436,12858,24680
,BuLangMiaoZuXiang,520422203,13605,1683,9898,5755,18982,9825,5733,10837,20662,11123,21021
ﳡ,HouChangMiaoZuYiLaoZuXiang,520422204,10512,1462,8031,5211,15511,7980,4953,8704,16684,8896,16927
è,MaoDongMiaoZuYiLaoZuXiang,520422205,13606,2190,9736,5996,18992,9691,5113,10811,20502,11173,20909
ǹ,ChengGuanZhen,520423100,55232,6338,39981,25976,66366,39295,19687,40608,79903,41276,81257
,DingQiZhen,520423101,18764,2659,14257,8245,26829,14168,7974,14958,29126,15140,29397
ƹ,HuangGuoShuZhen,520423102,9983,1453,7333,4348,13028,7250,3633,7409,14659,7736,15069
,JiangLongZhen,520423103,11889,1735,8518,5313,16812,8390,4464,9428,17818,9570,18088
ɽ,DaShanXiang,520423200,12172,1720,8817,5065,17056,8778,4438,9473,18251,9513,18330
ⵣɽ,BianDanShanXiang,520423201,6583,1235,4993,2551,9888,4961,2365,5110,10071,5190,10183
ļ,MuYiXiang,520423202,7667,1154,5809,3973,11217,5758,3279,6206,11964,6291,12100
�,MaChangXiang,520423203,11121,1717,8156,5271,16171,8142,4305,8946,17088,8987,17143
ɳ,ShaZiXiang,520423204,5641,819,4456,2870,8812,4382,2734,4658,9040,4738,9194
䲷¤,DuoBuLongXiang,520423205,5203,1037,4174,2744,8140,4141,2322,4319,8460,4388,8562
,GeLiXiang,520423206,6085,1142,4919,2978,9813,4897,3074,5342,10239,5382,10301
կ,BenZhaiXiang,520423207,7630,1388,6126,3930,12038,6104,4018,6804,12908,6910,13036
,LiuMaXiang,520423208,7375,1387,5990,3996,11884,5959,3670,6329,12288,6442,12432
,LiangTianXiang,520423209,8669,1312,7175,4090,13616,7137,4858,7462,14599,7664,14839
,JianGaXiang,520423210,4759,688,3957,2323,7514,3935,2541,3998,7933,4031,7988
,DaBangXiang,520423211,3852,597,2914,1854,5704,2908,1695,3211,6119,3230,6144
,GuanSuoZhen,520424100,36737,3395,25828,15597,43719,24989,13103,26358,51347,27407,53235
,HuaJiangZhen,520424101,28036,3264,20517,10909,40152,20471,11709,22219,42690,22492,43009
,YongNingZhen,520424102,16079,1877,11903,6479,23278,11888,6804,12813,24701,12857,24760
,GangWuZhen,520424103,11420,1430,8768,4273,17223,8762,5280,9353,18115,9362,18130
Ϲ,ShangGuanZhen,520424104,12959,1476,9524,4974,18629,9488,5380,10221,19709,10291,19815
¹,PoGongZhen,520424105,10107,1352,7241,3650,14398,7199,3827,7634,14833,8045,15286
,DuanQiaoZhen,520424106,7399,826,5154,3024,9785,5153,2514,5575,10728,5585,10739
ˮ,BaiShuiZhen,520424107,8602,1332,6310,3930,12071,6293,3099,6676,12969,6723,13033
˵,BaDeXiang,520424200,8034,984,5561,3035,11255,5542,2831,6250,11792,6288,11849
,DingYunXiang,520424201,15187,1751,11005,5559,21943,10948,6509,11831,22779,12442,23447
,PuLiXiang,520424202,10243,1228,7608,3722,15269,7594,4348,8104,15698,8211,15819
,BanGuiXiang,520424203,9966,1339,7972,4228,15575,7970,5343,8657,16627,8676,16648
,XinPuXiang,520424204,11858,1113,8214,3796,16456,8179,4419,9005,17184,9176,17390
ɳӪ,ShaYingXiang,520424205,11700,1458,8643,4359,16827,8635,5045,9410,18045,9560,18203
ɽ,SongShanZhen,520425100,37182,3878,27081,16425,42529,26135,14182,27070,53205,28161,55242
ˮ,ShuiTangZhen,520425101,10290,1663,8509,5198,16279,8487,5363,8781,17268,8807,17316
ﳡ,HouChangZhen,520425102,15955,2602,13484,7959,25466,13435,9156,14143,27578,14229,27713
èӪ,MaoYingZhen,520425103,19769,3411,15480,9705,28819,15433,8904,16494,31927,16604,32084
嵱,BanDangZhen,520425104,18770,2848,15524,9409,29455,15479,10348,16315,31794,16442,31966
ʯ,BaiShiYanXiang,520425200,6580,985,5331,3381,9940,5303,3343,5537,10840,5577,10908
ڵ,ZongDiXiang,520425201,18215,2022,12961,6124,26119,12944,7414,14656,27600,14690,27651
Ӫ,DaYingXiang,520425202,10260,1644,8743,5202,16329,8736,6249,9387,18123,9410,18153
Ĵկ,SiDaZhaiXiang,520425203,7412,1238,6311,3675,12466,6281,4428,6670,12951,6767,13078
,BaYangXiang,520425204,7797,1231,6221,3861,11600,6182,3737,6440,12622,6544,12765
,HuoHuaXiang,520425205,9306,1464,7439,4777,14580,7408,4573,7789,15197,7904,15343
,DaBangXiang,520425206,5173,581,3861,2046,7505,3855,2372,4255,8110,4265,8126
а´,ShiZhongBanShiChu,522201001,21707,2629,14636,10152,22231,13378,4260,12843,26221,13960,28596
´,HuanBeiBanShiChu,522201002,50619,4061,33702,23219,42358,32254,13226,32464,64718,34204,67906
´,HeXiBanShiChu,522201003,71021,6050,46311,29715,62799,43675,17707,43984,87659,48467,94778
лŰ´,XieQiaoBanShiChu,522201004,9998,1438,6908,4590,12891,6872,3105,7443,14315,7633,14541
´,DengTaBanShiChu,522201005,9561,1150,6612,3400,12355,5471,2585,5641,11112,6684,13296
,ChuanDongZhen,522201100,10123,1203,7029,3945,11974,6024,2893,6433,12457,7190,14219
ӻ,BaHuangZhen,522201101,15441,3084,11706,9055,23563,11693,6194,12998,24691,13013,24719
Ƴƺ,YunChangPingZhen,522201102,1895,518,1408,1261,2599,1405,529,1531,2936,1534,2942
ͷ,YangTouZhen,522201103,3195,609,2408,1591,4615,2402,1100,2462,4864,2496,4904
,ChaDianZhen,522201104,10038,1515,7021,4570,14166,6954,3551,7739,14693,8083,15104
ͩľƺ,TongMuPingXiang,522201200,4129,835,3024,2168,6169,2934,1500,3296,6230,3440,6464
ʯ,HuaShiXiang,522201201,8528,1439,6189,4037,12322,6042,2802,6285,12327,6580,12769
ƽ,HePingXiang,522201202,9072,1673,6412,4803,13417,6400,3117,7429,13829,7450,13862
,WaWuXiang,522201203,4860,1096,3719,2458,7494,3702,1765,3940,7642,4002,7721
ɽ,LiuLongShanXiang,522201204,1899,436,1347,1063,2825,1342,581,1562,2904,1569,2916
ƺ,DaPingXiang,522201205,9829,2113,7766,5605,15947,7702,4869,8942,16644,9045,16811
,YuTangXiang,522201206,12386,2253,9351,6706,19446,9301,5483,10652,19953,10771,20122
˫,ShuangJiangZhen,522222100,35966,3961,24985,15061,42823,24201,11025,24960,49161,25967,50952
Т,MinXiaoZhen,522222101,12651,2286,9330,6556,19124,9199,4689,10133,19332,10296,19626
̫ƽ,TaiPingTuJiaZuMiaoZuXiang,522222200,9012,1324,6343,4328,13037,6106,3056,6701,12807,7049,13392
嶱,BaPanTuJiaZuDongZuMiaoZuXiang,522222201,11228,2036,8465,5705,17643,8444,4769,9522,17966,9568,18033
,DeWangTuJiaZuMiaoZuXiang,522222202,8255,1351,5902,4053,11768,5841,2680,6235,12076,6384,12286
Ͷ,MinHeDongZuTuJiaZuMiaoZuXiang,522222203,11542,2160,8935,6071,18269,8850,5049,9630,18480,9816,18751
ٺͶ,GuanHeDongZuTuJiaZuMiaoZuXiang,522222204,4309,702,3080,2214,6248,3054,1509,3390,6444,3440,6520
ӳ,TaoYingTuJiaZuMiaoZuXiang,522222205,12210,2203,9259,6707,19163,9226,5384,10415,19641,10538,19797
ŭϪ,NuXiTuJiaZuMiaoZuXiang,522222206,7970,1589,6315,4569,13092,6292,3845,7036,13328,7089,13404
ƽϪ,PingXiZhen,522223100,29584,3547,20413,13855,33770,20004,8772,20920,40924,21490,41903
,DaLongZhen,522223101,16020,2730,11289,8487,21318,11207,5370,12563,23770,12831,24120
ҳ,ZhuJiaChangZhen,522223102,8955,1828,6807,5036,13673,6735,3780,7642,14377,7756,14563
ƺ,TianPingZhen,522223103,14027,2642,10621,7201,20973,10480,5583,11292,21772,11631,22252
µ,XinDianXiang,522223200,6262,1142,4093,2800,8289,4051,2029,4603,8654,5340,9433
,YaYuXiang,522223201,3873,757,3002,2017,5854,2979,1624,3194,6173,3252,6254
ɽ,TangShanZhen,522224100,40512,4334,27909,16973,45645,25422,12126,25980,51402,29063,56972
ׯ,BenZhuangZhen,522224101,21912,2942,16807,10871,33997,16767,9643,17639,34406,17690,34497
ɳ,BaiShaZhen,522224102,10951,2103,9461,6268,18590,9411,6300,9736,19147,9893,19354
,LongTangZhen,522224103,14419,2440,12319,8261,24238,12267,7593,12021,24288,12133,24452
,HuaQiaoZhen,522224104,8007,1417,6146,4330,12683,6127,3346,6587,12714,6624,12770
,WuDeZhen,522224105,8147,1424,6074,4225,12545,6058,3225,6693,12751,6722,12796
а,ZhongBaZhen,522224106,7459,1460,5852,3858,11596,5792,3091,5940,11732,6158,12010
Ӱӳ,HeBaChangXiang,522224200,8166,1429,6652,4671,13249,6638,4001,6841,13479,6944,13596
,GuoRongXiang,522224201,5853,1276,5057,3312,10094,5052,3056,5122,10174,5128,10185
۷嶱,JuFengYiLaoZuDongZuXiang,522224202,9867,1480,7602,4712,15531,7578,4431,8058,15636,8176,15778
嶱,LongJingYiLaoZuDongZuXiang,522224203,12216,2099,10082,6669,20254,10076,6177,10400,20476,10410,20492
ɳ嶱,DaShaBaYiLaoZuDongZuXiang,522224204,8100,1603,6787,4577,13697,6703,4181,6715,13418,7097,13884
嶱,FengXiangYiLaoZuDongZuXiang,522224205,4245,776,3240,2154,6569,3183,1767,3402,6585,3548,6788
嶱,QingYangMiaoZuYiLaoZuDongZuXiang,522224206,5493,1018,4225,3013,8808,4220,2405,4676,8896,4691,8916
ʯ嶱,ShiGuYiLaoZuDongZuXiang,522224207,6660,1127,4937,3157,10047,4922,2524,5347,10269,5374,10311
ƺس嶱,PingDiChangYiLaoZuDongZuXiang,522224208,9467,1713,7392,4758,15171,7385,4065,7820,15205,7853,15245
Ϫ嶱,GanXiYiLaoZuDongZuXiang,522224209,6149,1120,4802,3305,9563,4795,2518,4973,9768,4985,9787
ƺɽ嶱,PingShanYiLaoZuDongZuXiang,522224210,4450,603,2976,1849,5994,2924,1501,3176,6100,3578,6554
˼,SiTangZhen,522225100,58490,5132,39659,22571,58653,36636,16472,36846,73482,40435,80094
ͷ,TangTouZhen,522225101,22408,3869,18184,11531,34516,17834,9534,17320,35154,17627,35811
Ұ,XuJiaBaZhen,522225102,18562,2877,14910,8616,26843,13687,8409,13698,27385,14938,29848
ӳ,DaBaChangZhen,522225103,12020,2110,9481,6431,18823,9422,5088,9593,19015,9737,19218
ļҵ,WenJiaDianZhen,522225104,6910,1235,5728,3373,11222,5559,3376,5541,11100,5793,11521
Ϫ,YingWuXiZhen,522225105,16533,2212,12587,7293,25770,12199,7407,12837,25036,13565,26152
Ϫ,HePengXiZhen,522225106,8058,1338,6772,4040,13190,6703,4305,6852,13555,6929,13701
żկ,ZhangJiaZhaiZhen,522225107,9766,1776,8206,5169,16304,8162,4892,8175,16337,8228,16434
Ұ,SunJiaBaZhen,522225108,7893,1524,6598,4589,13126,6588,3991,6777,13365,6810,13408
,QingGangPoZhen,522225109,9880,1973,8572,5654,17269,8561,5587,8856,17417,8868,17440
Ϫ,WengXiZhen,522225110,12977,2326,11058,6512,21573,10966,6743,10886,21852,10988,22046
ˮ,LiangShuiJingZhen,522225111,10989,2497,9333,6548,18525,9296,5381,9478,18774,9534,18867
ۼ,ShaoJiaQiaoZhen,522225112,13746,2974,12201,7547,23653,12124,7283,11555,23679,11802,24003
Ӱ,DaHeBaXiang,522225200,11249,1867,8824,5645,17948,8750,5007,9214,17964,9299,18123
˼,SiLinXiang,522225201,5957,1049,4894,3128,9695,4894,2842,4953,9847,4954,9848
,DongHuaXiang,522225202,5366,881,4402,2897,8974,4332,2847,4560,8892,4692,9094
,HuJiaWanXiang,522225203,5941,1183,5178,3376,10116,5155,3258,5160,10315,5204,10382
ƺ,KuanPingXiang,522225204,6155,1086,5405,3407,10565,5393,3492,5314,10707,5328,10733
ͤӰ,TingZiBaXiang,522225205,5876,1003,5051,3131,9890,5031,3284,5066,10097,5112,10163
ܿ,FengYunXiang,522225206,7177,1277,6074,4004,11949,6053,3741,6047,12100,6121,12195
,XiangBaXiang,522225207,11514,1849,9805,6078,19319,9795,6149,9693,19488,9707,19512
,ChangBaXiang,522225208,5981,996,5018,3110,9915,5015,3164,5119,10134,5123,10141
,BanQiaoXiang,522225209,7069,1211,5794,3364,11648,5666,3465,5709,11375,5951,11745
ˮ,SanDaoShuiXiang,522225210,8583,1446,7361,4281,14298,7352,4342,6994,14346,7010,14371
,TianQiaoXiang,522225211,6280,1345,5227,3704,10179,5211,2821,5202,10413,5219,10446
¡,XingLongXiang,522225212,5831,1242,5132,3485,10088,5127,3239,5175,10302,5180,10312
,YangJiaAoXiang,522225213,7696,1546,6780,4395,13573,6734,4486,6883,13617,6948,13728
,ELingZhen,522226100,41325,4492,30766,18962,50025,29850,15366,29266,59116,30417,61183
Ϫ,BanXiZhen,522226101,10600,2551,9953,7557,19318,9865,6574,9600,19465,9772,19725
ɳ,ShaZiPoZhen,522226102,9298,2028,8128,5896,15952,8070,5363,8347,16417,8561,16689
,TianTangZhen,522226103,9738,2127,8298,6202,16176,8118,4835,8241,16359,8402,16700
ľ,MuHuangZhen,522226104,11511,2288,9653,6077,18218,9463,5629,9383,18846,9775,19428
ˮ,HeShuiZhen,522226105,9836,2181,8403,6205,16481,8281,4947,8349,16630,8561,16964
Ϫ,LangXiZhen,522226106,7974,1630,6544,4816,13023,6423,3719,6558,12981,6779,13323
Ϫ,ChanXiZhen,522226107,9788,1804,7555,5187,15063,7501,3815,7731,15232,7852,15407
Ϫ,YangXiZhen,522226108,6851,1257,5170,3605,10448,5166,2690,5602,10768,5628,10798
կ,XinZhaiXiang,522226200,11438,2680,9967,7318,19622,9939,5881,9946,19885,10032,19999
а,ZhongBaXiang,522226201,5146,1200,4561,3549,8847,4551,2660,4418,8969,4445,9006
ɼ,ShanShuXiang,522226202,6328,1551,5885,4499,11464,5866,3755,5712,11578,5749,11634
,DaoBaXiang,522226203,11378,2579,9825,7272,19594,9803,5957,10023,19826,10089,19914
ҵ,XinYeXiang,522226204,4352,978,3512,2606,7051,3436,2034,3588,7024,3852,7364
,YongYiXiang,522226205,5509,912,4040,2865,8361,3995,2126,4386,8381,4507,8547
޳,LuoChangXiang,522226206,5421,1080,4341,3277,8901,4333,2497,4606,8939,4657,8998
,YangLiuXiang,522226207,5278,984,4043,2846,8270,4025,2279,4431,8456,4498,8541
,QingLongZhen,522227100,51962,4231,38195,22227,63289,37777,20676,38144,75921,38674,76869
,JianChaZhen,522227101,19613,3012,15757,10032,30380,15607,9164,15800,31407,16032,31789
,ChaoDiZhen,522227102,7502,1601,6615,5220,12839,6598,3986,6395,12993,6474,13089
Ϫ,FengXiangXiZhen,522227103,11599,2114,10593,7298,20388,10522,7445,10308,20830,10565,21158
ƺ,WenPingZhen,522227104,7941,1450,7036,4868,13433,6979,4639,6899,13878,6994,14030
,GongHeXiang,522227200,8726,1595,7621,5526,14855,7605,4960,7600,15205,7660,15281
,YanTangXiang,522227201,7093,1249,5830,3906,11719,5813,3509,5962,11775,6021,11851
Ȫ,LongQuanXiang,522227202,6027,880,4745,3290,9587,4742,2767,4918,9660,4929,9674
Ǯ,QianJiaXiang,522227203,5144,1020,4220,3021,8441,4191,2361,4242,8433,4305,8525
ɳϪ,ShaXiXiang,522227204,5948,956,4475,2818,8934,4425,2438,4708,9133,4867,9342
骸,NanGanXiang,522227205,7324,1213,6108,3775,11942,5949,3755,6008,11957,6184,12292
ƽԭ,PingYuanXiang,522227206,6284,1145,5280,3565,10361,5274,3270,5417,10691,5419,10699
,FuXingXiang,522227207,14745,2235,12336,7731,23937,12327,7922,12531,24858,12566,24902
,HeXingXiang,522227208,11593,2004,9489,6493,18822,9474,5613,9704,19178,9721,19210
,ChangBaoXiang,522227209,10171,2116,9366,6170,18263,9321,6295,9101,18422,9216,18582
Ͱ,TongJingXiang,522227210,9624,1774,8572,5917,16832,8549,5680,8455,17004,8506,17078
,JingJiaoXiang,522227211,6517,1135,5452,4141,10894,5421,3460,5586,11007,5660,11112
,ChangFengXiang,522227212,7210,1145,6071,3969,12242,6049,4151,6385,12434,6435,12506
ɽ,GaoShanXiang,522227213,7456,1006,6037,3894,12196,6006,4051,6402,12408,6476,12513
Ȫ,QuanKouXiang,522227214,9334,1535,8293,5389,16789,8250,6549,9020,17270,9125,17418
ƽ,HePingZhen,522228100,38391,3254,27943,16129,44439,26609,14934,26970,53579,28636,56579
ɳ,ShaZiZhen,522228101,11755,2408,10446,6751,20430,10431,6697,10372,20803,10414,20860
ۼ,QiaoJiaZhen,522228102,20845,2995,18523,11579,37239,18450,13761,18883,37333,19078,37601
ʯ,JiaShiZhen,522228103,14829,3098,13873,8460,27295,13853,9858,13841,27694,13912,27785
̲,QiTanZhen,522228104,15917,2471,13782,8477,27018,13685,9406,13576,27261,14012,27794
,GuanZhouZhen,522228105,24985,3501,22461,13534,45059,22391,17170,22982,45373,23195,45656
,TuDiAoZhen,522228106,9783,1658,9390,5254,18272,9336,7607,9416,18752,9658,19048
˼,SiQuZhen,522228107,9076,1653,8323,5249,16602,8265,6148,8382,16647,8554,16877
,KeTianZhen,522228108,7293,1216,6460,3769,12770,6447,4675,6677,13124,6724,13184
,HongDuZhen,522228109,4727,702,3906,2251,7610,3848,2442,3871,7719,3965,7871
̡,HeiTaXiang,522228200,3508,673,2922,1879,5857,2859,1785,2849,5708,3044,5966
ˮ,HeiShuiXiang,522228201,9660,1581,8367,5727,16715,8301,5659,8406,16707,8533,16900
н,ZhongJieXiang,522228202,8408,1615,7393,5075,14555,7392,4777,7402,14794,7407,14800
,XiaoJingXiang,522228203,5812,1309,5161,3557,10206,5157,3148,5093,10250,5108,10269
Ϫ,GanXiXiang,522228204,11930,2198,11400,7218,22365,11257,8621,11043,22300,11349,22749
峡,BanChangXiang,522228205,12645,2289,12370,7313,24410,12368,9657,12209,24577,12221,24591
Ȫ,QuanBaXiang,522228206,9024,1398,8840,4706,17806,8792,7630,9120,17912,9212,18052
կ,ZhongZhaiXiang,522228207,7110,1234,6684,4120,13707,6666,5481,7092,13758,7141,13825
,HuangTuXiang,522228208,6667,1179,6159,3717,11905,6126,4477,6085,12211,6164,12323
¾,XinJingXiang,522228209,7492,1236,6203,3799,12385,6137,4020,6416,12553,6545,12748
,TangBaXiang,522228210,8049,1401,6931,4213,13882,6915,4732,7182,14097,7251,14182
ƺ,HouPingXiang,522228211,5678,1134,4937,2996,9755,4923,3347,5171,10094,5222,10159
ޤ,LiaoGaoZhen,522229100,42411,3973,29704,17872,48402,28709,14545,29476,58185,31225,60929
ʯ,PanShiZhen,522229101,9187,1440,7481,3756,15280,7454,5015,8082,15536,8161,15642
,PanXinZhen,522229102,14256,1833,11122,6167,21584,11104,6305,11206,22310,11272,22394
ƺ,DaPingChangZhen,522229103,9490,1757,7823,5036,15550,7809,4764,8141,15950,8188,16011
վ,PuJiaoZhen,522229104,12426,1910,10138,6331,20271,10134,6355,10543,20677,10553,20691
կӢ,ZhaiYingZhen,522229105,17238,2419,13535,7886,27280,13520,8546,14605,28125,14668,28203
Ϫ,MengXiZhen,522229106,15600,2184,12039,7567,23657,11936,7135,12476,24412,12880,24919
,WuLuoZhen,522229107,12051,2086,9281,6388,19138,9251,5384,10125,19376,10240,19521
,GanLongZhen,522229108,11159,2309,9266,6872,18890,9211,5743,9821,19032,9945,19211
˱,ChangXingBaoZhen,522229109,11363,1931,9087,5663,17519,8952,5154,9198,18150,9361,18448
¼,YaJiaZhen,522229110,9629,1659,7930,4548,15759,7928,4784,8142,16070,8142,16072
,DaXingZhen,522229111,10248,1140,7504,4054,14017,7147,4039,7331,14478,7923,15427
ţ,NiuLangZhen,522229112,6864,1165,5587,3783,11140,5572,3353,5754,11326,5795,11382
Ž,JiuJiangXiang,522229200,5895,1125,4906,3051,10048,4857,3166,5230,10087,5280,10186
,ShiChangXiang,522229201,11446,1747,9399,4822,18712,9257,5744,9237,18494,9538,18937
,ZhengDaXiang,522229202,8990,1479,7206,4096,14186,7206,4303,7566,14772,7566,14772
ƺ,ChangPingXiang,522229203,6262,1003,5006,2887,10180,4985,3057,5253,10238,5316,10322
̫ƽӪ,TaiPingYingXiang,522229204,9899,1667,8185,4926,16642,8133,5321,8588,16721,8702,16887
ƽͷ,PingTouXiang,522229205,8452,1325,7021,4387,13822,6964,4582,7142,14106,7338,14359
·,DaLuXiang,522229206,11002,2211,9526,5903,18472,9517,5756,9404,18921,9443,18969
,MiaoAiXiang,522229207,6905,1426,5727,3829,11581,5727,3475,6079,11806,6079,11806
ˮϪ,LengShuiXiXiang,522229208,9592,1926,7746,4909,15618,7735,4663,8358,16093,8435,16181
ʯ,ShiLiangXiang,522229209,4815,1096,4011,2907,8101,3994,2390,4186,8180,4290,8301
Ϫ,WaXiXiang,522229210,4099,913,3278,2294,6794,3265,1900,3610,6875,3634,6912
,YongAnXiang,522229211,4860,1104,4274,3120,8452,4165,2728,4249,8414,4418,8692
ľ,MuShuXiang,522229212,8250,1602,6756,3958,13806,6739,4102,7150,13889,7198,13954
ư,HuangBanXiang,522229213,12811,2029,10104,5601,20395,10096,5889,10596,20692,10625,20729
ɳӺ,ShaBaHeXiang,522229214,4154,668,3283,2377,6767,3283,2069,3608,6891,3608,6891
ɽ,WanShanZhen,522230100,9913,2010,7209,5612,11295,6883,2514,6760,13643,7228,14437
¥ƺ,GaoLouPingDongZuXiang,522230200,7577,1477,5523,3804,10966,5490,2903,6253,11743,6434,11957
Ƶ,HuangDaoDongZuXiang,522230201,5634,1252,4348,3207,8551,4288,2346,4795,9083,4884,9232
կ,AoZhaiDongZuXiang,522230202,3785,955,2861,2239,5731,2853,1334,3194,6047,3213,6074
Ϫ,XiaXiDongZuXiang,522230203,3897,813,2766,2040,5548,2709,1408,3118,5827,3352,6118
Ʋݽֵ´,HuangCaoJieDaoBanShiChu,522301001,68682,6157,44837,29877,57594,39729,14532,39154,78883,44534,89371
ֵ̩´,XingTaiJieDaoBanShiChu,522301002,17257,822,10603,5822,9890,8801,3989,9054,17855,11465,22068
ɽֵ´,JuShanJieDaoBanShiChu,522301003,57477,3510,35539,20755,46943,34046,15428,34624,68670,40876,76415
ᶼֵ´,FengDouJieDaoBanShiChu,522301004,21138,1875,15113,6806,27487,14911,7475,15082,29993,15375,30488
ƺֵ´,PingDongJieDaoBanShiChu,522301005,29870,1969,19207,10332,22272,17512,7959,18097,35609,20591,39798
ľֵֽ´,MuJiaJieDaoBanShiChu,522301006,14031,1436,9793,4794,17532,9316,4792,9756,19072,10466,20259
ͽֵ´,XiaWuTunJieDaoBanShiChu,522301007,19770,1724,13565,7092,22469,13485,6170,13914,27399,14099,27664
ֵֽ´,WanFengLinJieDaoBanShiChu,522301008,11371,1359,8289,4355,16030,8274,4097,8472,16746,8538,16827
,JingNanZhen,522301100,20376,3032,14971,8499,30068,14828,8147,16256,31084,16584,31555
,NiDangZhen,522301101,13312,2197,10056,6386,19905,10041,5493,10870,20911,10946,21002
ͽ,BaJieZhen,522301102,11554,1600,8769,4945,16983,8694,4743,8986,17680,9128,17897
է,PengZhaZhen,522301103,17080,2547,12548,7876,25118,12534,6400,13438,25972,13479,26027
³,LuBuGeZhen,522301104,6964,1070,4958,3370,9912,4955,2313,5380,10335,5389,10347
,SanJiangKouZhen,522301105,7192,831,5170,2783,10485,5129,2837,5566,10695,5690,10860
ɳ,WuShaZhen,522301106,17748,2416,12778,7163,25073,12578,6712,13409,25987,14098,26876
Ҥ,BaiWanYaoZhen,522301107,15792,2067,11850,6475,23659,11795,6643,12498,24293,12652,24502
,MaLingZhen,522301108,22134,2379,15864,8318,28654,15434,7933,15808,31242,16582,32446
,WeiSheZhen,522301109,10999,1229,7871,4891,14166,7646,4405,8306,15952,8762,16633
ˮ,QingShuiHeZhen,522301110,17143,2158,11230,6552,21699,10899,5669,12031,22930,13740,24970
Ч,DingXiaoZhen,522301111,31123,2325,20334,10376,30648,17982,9388,18921,36903,22502,42836
֣,ZhengTunZhen,522301112,14656,2067,10716,6672,20765,10607,5677,11162,21769,11684,22400
,WanTunZhen,522301113,25287,2918,18267,9863,36071,17891,10106,19302,37193,20044,38311
³,LuTunZhen,522301114,11656,1440,8469,5547,16415,8460,4408,8970,17430,9035,17504
ָ,CangGengZhen,522301115,6612,1010,4908,3153,9638,4885,2409,5077,9962,5123,10031
,QiSheZhen,522301116,11867,1689,8624,5279,17507,8618,4598,9492,18110,9530,18154
,ZeRongXiang,522301200,12389,2073,9343,5122,18217,9342,4724,9838,19180,9843,19186
׽,CangJiangXiang,522301201,4906,734,3703,2214,7582,3603,2210,3954,7557,4147,7850
,LuoWanXiang,522301202,6339,851,4809,2866,9726,4804,2804,5171,9975,5185,9994
�ƺ,ZhuChangPingXiang,522301203,10967,1818,7836,5087,16283,7769,3983,8810,16579,8932,16768
,XiongWuXiang,522301204,9449,1133,6622,4146,13405,6563,3499,7202,13765,7459,14081
ֵ´,DongHuJieDaoBanShiChu,522322001,19346,1341,13638,8334,18860,13361,7453,14085,27446,14502,28140
Ͻֵ´,ChengNanJieDaoBanShiChu,522322002,11206,1089,8172,4880,13420,8120,4369,8398,16518,8492,16664
ɽֵ´,ZhenWuShanJieDaoBanShiChu,522322003,13662,1350,9479,5469,16484,9421,5013,9869,19290,10546,20025
Ǳֵ´,ChengBeiJieDaoBanShiChu,522322004,18937,1770,12856,7735,18915,11519,6043,12024,23543,13894,26750
ͽ,TunJiaoZhen,522322101,15394,2019,12428,7382,23440,12376,8045,12833,25209,13030,25458
,BaLingZhen,522322102,21742,3308,19035,11531,35606,19008,13562,19513,38521,19577,38612
ٵ,BaiDeZhen,522322103,15531,2272,12766,7882,24167,12715,8201,13161,25876,13238,26004
,YuZhangZhen,522322104,15408,1766,12074,6897,23478,12045,7760,12714,24759,12860,24934
˼ׯ,PanJiaZhuangZhen,522322105,16147,1768,11527,6763,21925,11230,7799,12032,23262,14187,25714
,HuiLongZhen,522322106,17756,2791,14901,9316,28368,14855,10020,15445,30300,15666,30567
ɽ,XiaShanZhen,522322107,20154,2056,15283,8586,27909,15170,9935,15892,31062,16862,32145
,XinLongChangZhen,522322108,13358,1549,10324,6159,20459,10201,6828,10871,21072,11411,21735
ɽ,DaShanXiang,522322200,13962,2154,11726,7066,23252,11719,7994,12371,24090,12384,24110
�,XinMaChangXiang,522322201,12638,1784,10159,6147,19115,10156,6365,10623,20779,10628,20787
,LiGuanXiang,522322203,6971,862,5560,3531,10746,5558,3609,5877,11435,5882,11442
,TianWanXiang,522322204,11830,1640,9663,5963,18816,9663,6135,9935,19598,9942,19605
³Ӫ,LuChuYingHuiZuXiang,522322205,8078,1263,6319,4042,12643,6318,3943,6938,13256,6965,13284
,MinJianXiang,522322206,6988,973,5768,3626,11412,5759,3982,6112,11871,6175,11943
ˮ,PanShuiZhen,522323100,21630,1708,14619,9224,22882,13490,6918,14235,27725,15637,30256
,LongYinZhen,522323101,8762,1223,7460,4462,14231,7358,4795,7191,14549,7320,14780
Ҥ,GuanZiYaoZhen,522323102,6640,1009,5264,3450,10563,5237,3323,5643,10880,5708,10972
,JiangXiPoZhen,522323103,12876,1602,10361,6128,19781,10334,6634,10666,21000,10751,21112
,SanBanQiaoZhen,522323104,8557,1117,6826,4457,13496,6823,4211,7037,13860,7059,13885
ع,DiGuaZhen,522323105,11937,1575,9641,6094,19114,9629,6537,10273,19902,10408,20049
ɽ,QingShanZhen,522323106,14506,1707,11408,6609,21432,11185,7029,11574,22759,11834,23242
¥,LouXiaZhen,522323107,21071,2332,15082,8578,29215,14879,9222,15770,30649,17543,32625
ɳ,BaiShaXiang,522323200,4873,797,4113,2806,8141,4110,2745,4278,8388,4302,8415
,GaoMianXiang,522323201,6563,1033,5588,3612,11318,5578,3899,5898,11476,5907,11495
,WoYanXiang,522323202,8660,1311,7159,4644,14410,7156,4843,7647,14803,7655,14814
޺,LuoHanXiang,522323203,9504,1332,7727,4425,15624,7720,5232,8328,16048,8341,16068
µ,XinDianXiang,522323204,10165,1305,8353,4926,16573,8344,5704,8797,17141,8821,17174
ѩ,XuePuXiang,522323205,11411,1604,9404,5486,18878,9351,6345,9832,19183,9956,19360
,LianChengZhen,522324100,25257,2330,17963,10696,32951,17645,9166,18240,35885,18790,36753
ɳ,ShaZiZhen,522324101,11827,1357,9293,5756,17881,9258,5521,9332,18590,9412,18705
̺,BiHenZhen,522324102,9875,1027,7526,4510,14548,7442,4956,7787,15229,8332,15858
,DaChangZhen,522324103,11709,1433,8661,5751,16140,8609,4929,9047,17656,9410,18071
,JiChangZhen,522324104,14384,1734,10972,6037,21467,10876,6728,11155,22031,11874,22846
,HuaGongZhen,522324105,9726,1226,7709,4602,14164,7707,4822,8060,15767,8065,15774
Ӫ,ZhongYingZhen,522324106,9559,1546,7973,4761,15524,7907,5466,8131,16038,8598,16571
,GuangZhaoZhen,522324107,12474,1768,10163,6209,19397,10119,6342,10296,20415,10421,20584
,ChangLiuXiang,522324200,9752,1501,8605,5072,17390,8578,6641,9034,17612,9289,17894
,DaTianXiang,522324201,6766,895,5836,3202,11438,5833,4213,6019,11852,6038,11874
�,MaChangXiang,522324202,11901,1737,10213,5951,19679,10209,7151,10557,20766,10576,20789
,ZiMaXiang,522324204,7137,905,5784,3348,11229,5771,3792,5927,11698,6050,11834
,AnGuXiang,522324205,8691,1050,7514,4068,13959,7461,5159,7279,14740,7386,14900
,SanBaoYiZuXiang,522324206,2592,279,2122,1025,4298,2122,1485,2234,4356,2234,4356
,MinGuZhen,522325100,42301,5417,32424,19294,54424,31951,18074,32857,64808,33368,65792
,LongChangZhen,522325101,18242,2448,15400,8504,27485,15376,10631,15436,30812,15921,31321
,ZheXiangZhen,522325102,16738,2661,15543,8784,26670,15517,11247,15062,30579,15103,30646
̽,BeiPanJiangZhen,522325103,14564,2103,12759,6920,23701,12589,9106,12818,25407,13014,25773
ײ,BaiCengZhen,522325104,8941,1643,7567,4754,13763,7496,4880,7503,14999,7897,15464
³,LuGongZhen,522325105,9491,1663,8685,4699,14525,8663,5947,8327,16990,8416,17101
,LianHuanXiang,522325200,6964,1443,6098,3459,11468,6086,3978,6242,12328,6287,12385
,WanLanXiang,522325201,8480,1222,6583,3779,11808,6528,4509,6890,13418,7628,14211
С,XiaoTunXiang,522325202,16730,2209,13760,7811,25347,13683,9233,13984,27667,14412,28172
,ChangTianXiang,522325203,9304,1409,7928,5093,14739,7912,5403,8077,15989,8188,16116
ƽ,PingJieXiang,522325204,9965,1462,8696,4533,16351,8695,6235,8963,17658,8966,17662
³,LuRongXiang,522325205,7668,1211,6696,3745,12997,6682,4651,6735,13417,6834,13530
ɳƺ,ShaPingXiang,522325206,9510,1073,7438,3809,13606,7349,5127,7391,14740,8272,15710
,FuXingZhen,522326100,28977,3128,21447,12087,30916,21362,10992,21423,42785,21650,43097
Ԫ,LeYuanZhen,522326101,13683,1883,10978,6100,20814,10962,6085,10659,21621,10673,21651
,DaYiZhen,522326102,11199,1945,10098,5613,19616,10080,6874,9886,19966,9920,20018
,LeWangZhen,522326103,7803,1333,7195,3885,13677,7185,5389,7306,14491,7330,14525
ɣ,SangLangZhen,522326104,4706,693,3925,2321,7194,3902,2380,3801,7703,3854,7779
ҹ,NaYeZhen,522326105,4512,584,4086,2175,7606,4071,2876,3838,7909,3886,7972
,XinTunZhen,522326106,13247,2288,11419,6581,22624,11419,7351,11466,22885,11467,22886
ʯ,ShiTunZhen,522326107,11470,2012,9747,5477,18812,9726,5582,9267,18993,9317,19064
,KanBianXiang,522326200,5704,813,5159,2599,9664,5159,3653,5011,10170,5011,10170
,BaRaoXiang,522326201,5254,645,4703,2232,9334,4703,3526,4712,9415,4722,9425
,JiaoNaXiang,522326202,7458,1262,6777,3444,13268,6743,4969,6849,13592,6912,13689
,DaGuanXiang,522326203,7326,1054,6426,3269,12730,6388,4513,6379,12767,6467,12893
,ZheXiangXiang,522326204,8960,1087,7570,3587,14578,7570,4978,7455,15025,7455,15025
,AngWuXiang,522326205,5482,603,4547,2310,9049,4547,3072,4609,9156,4610,9157
,YouMaiXiang,522326206,5866,851,5116,2700,9895,5110,3295,4885,9995,4896,10012
ɽ,MaShanXiang,522326207,3799,569,3279,1789,6503,3277,2239,3323,6600,3328,6607
,DaJianXiang,522326208,4729,698,4094,2207,7488,4088,2569,3883,7971,3902,7996
¥,ZheLouZhen,522327100,23645,2193,16944,9918,25303,16342,8412,16588,32930,17306,34250
,PoMeiZhen,522327101,12026,2188,9849,6243,19102,9810,5937,10227,20037,10302,20151
߶,RongDuZhen,522327102,9605,1559,7562,5240,14516,7537,4131,7690,15227,7733,15295
Ѿ,YaTaZhen,522327103,10324,974,7547,4080,14467,7479,4135,7482,14961,7886,15433
,QiaoMaZhen,522327104,8686,918,5856,3267,10736,5716,3350,5934,11650,7098,12954
,YangBaZhen,522327105,8238,889,6223,3618,11823,6210,3142,6026,12236,6046,12269
˫,ShuangJiangZhen,522327106,7183,672,5526,3076,10523,5506,3081,5358,10864,5410,10936
Ҽ,YanJiaZhen,522327107,9415,1064,7521,3996,14705,7460,4631,7462,14922,7589,15110
˶,BaDuZhen,522327108,5101,544,3908,2177,7378,3863,2175,3756,7619,3912,7820
ƺ,QingPingXiang,522327200,7622,1375,6061,4160,11955,6010,3456,6312,12322,6392,12453
,DaYangXiang,522327201,6066,584,4660,2700,8783,4649,2626,4597,9246,4616,9276
,WeiPangXiang,522327202,4652,896,3873,2466,7565,3873,2270,3943,7816,3945,7818
,BiYouXiang,522327203,7151,917,5867,3615,11270,5864,3435,5618,11482,5636,11503
ٿ,BaiKouXiang,522327204,3346,296,2513,1287,4622,2492,1503,2564,5056,2632,5145
°,XinAnZhen,522328100,49801,5539,34939,22402,60414,34491,16080,35126,69617,36481,71420
,LongGuangZhen,522328101,25018,3618,18534,11566,34865,18444,8787,18760,37204,18889,37423
,DeWoZhen,522328102,20257,2639,15211,9822,28649,15168,7685,15282,30450,15370,30581
,WanFengHuZhen,522328103,7465,1364,5837,3975,11358,5834,3018,5979,11813,6010,11847
ľ,MuZanZhen,522328104,10282,1411,7664,4837,15071,7605,4182,7919,15524,8211,15875
,SaYuZhen,522328105,13612,2012,10863,6378,21171,10847,6559,11262,22109,11320,22183
ƺ,PuPingZhen,522328106,10734,1472,8341,4937,15820,8310,4513,8335,16645,8378,16719
ɽ,LongShanZhen,522328107,14397,2243,10683,6785,20948,10643,6796,11479,22122,12753,23436
,GeTangZhen,522328108,12891,1740,10153,5986,19885,10112,6635,10916,21028,11113,21266
¡,XingLongZhen,522328109,14096,2153,11274,7038,22038,11262,6545,11504,22766,11520,22794
,XinQiaoZhen,522328110,12416,1627,8883,5798,16749,8609,4563,8997,17606,9723,18606
,HaiZiXiang,522328200,11883,1419,8811,5077,16854,8754,5258,9408,18162,9749,18560
ɽ,DuShanXiang,522328201,7822,1359,6129,3893,12093,6076,3715,6502,12578,6767,12896
ƽ,PingLeXiang,522328202,6781,1449,5642,3623,11204,5604,3294,5780,11384,5882,11524
Ǯ,QianXiangXiang,522328203,9395,1608,7495,4731,14241,7491,3993,7442,14933,7501,14996
½,PoJiaoXiang,522328204,4129,574,2613,1801,5087,2558,1426,2918,5476,3516,6129
ֵ,ShiXiJieDao,522401001,83174,9132,57964,36939,82384,56212,24675,56599,112811,59017,116981
жֵ,ShiDongJieDao,522401002,63773,4764,40002,23000,45695,35591,16935,36566,72157,45470,85472
Žֵ,SanBanQiaoJieDao,522401003,7763,852,6199,3164,10704,6086,4032,6292,12378,6448,12647
Žֵ,LiuCangQiaoJieDao,522401004,18017,1442,12038,6759,19397,11596,6606,12059,23655,14027,26065
Žֵ,DaXinQiaoJieDao,522401005,8372,1029,6815,4029,11908,6794,4315,6872,13666,6901,13716
Žֵ,GuanYinQiaoJieDao,522401006,6243,589,4798,2400,7563,4686,2730,4661,9347,4764,9562
Ѽ,YaChiZhen,522401100,29277,3805,22433,12991,40948,22298,13140,23299,45597,23789,46222
,LiShuZhen,522401101,13810,1759,10560,6235,19436,10455,6436,10937,21392,11445,22005
,ChaHeZhen,522401102,16704,2884,14016,8869,26717,13939,9123,14518,28457,14695,28711
,ZhuChangZhen,522401103,19177,3122,16818,10054,31231,16800,11570,17008,33808,17051,33869
,TianBaZhen,522401104,8551,1541,7856,4795,15022,7759,5965,8016,15775,8201,16057
,ChangChunBaoZhen,522401105,21427,3125,19012,10834,35266,18938,14344,19618,38556,19884,38896
Ϫ,SaLaXiZhen,522401106,23648,3567,21498,12906,40065,21334,16648,21903,43237,22365,43863
,YangJiaWanZhen,522401107,18382,2718,18101,9548,32644,18070,15277,18123,36193,18276,36377
,FangZhuZhen,522401108,10903,1628,10591,5975,19259,10588,8528,10456,21044,10468,21059
ೡ,QingChangZhen,522401109,14277,2045,13199,7430,24151,13171,10187,13268,26439,13310,26509
ˮ,ShuiQingZhen,522401110,13845,1362,11159,5955,20726,11123,7816,11744,22867,11864,23023
ι,HeGuanTunZhen,522401111,18587,2497,15685,8970,29162,15659,10920,16229,31888,16319,32004
,DuiPoZhen,522401112,11583,1869,9788,5904,17928,9744,6622,10155,19899,10286,20074
,DaYinZhen,522401113,12076,1523,9866,5553,17676,9863,6973,10694,20557,10706,20572
ֿ,LinKouZhen,522401114,13448,2145,11756,7205,20971,11735,8357,12114,23849,12194,23950
,ShengJiZhen,522401115,13490,2426,12125,7138,22005,12066,8922,12564,24630,12713,24838
ˮ,QingShuiPuZhen,522401116,14035,2646,12443,8207,22933,12386,8426,12604,24990,12664,25107
,LiangYanZhen,522401117,9200,1688,8248,5257,15308,8158,6063,8482,16640,8703,16951
ӿ,YanZiKouZhen,522401118,18752,3116,15990,9806,29112,15622,10483,15776,31398,16361,32351
կ,BaZhaiZhen,522401119,13968,2025,11847,6795,21987,11847,7973,12117,23964,12119,23966
,TianBaQiaoZhen,522401120,8361,1212,7111,3770,12506,7092,4896,7280,14372,7358,14469
ӽ,HaiZiJieZhen,522401121,28827,4904,25084,15020,46470,24919,16690,25047,49966,25337,50421
С,XiaoBaZhen,522401122,15750,2930,14247,8432,25572,14137,10428,14536,28673,14861,29108
̨,CengTaiZhen,522401123,10187,1993,9985,5726,18042,9953,7805,9953,19906,10000,19985
С,XiaoJiChangZhen,522401124,19864,3682,19319,11801,34651,19085,15074,19017,38102,19301,38620
,PuYiZhen,522401125,11363,2038,9845,6028,17343,9828,6500,10029,19857,10056,19901
Ӫ,LongChangYingZhen,522401126,8775,1648,7987,4858,14921,7911,5817,8142,16053,8253,16240
ǧϪ,QianXiXiang,522401200,7100,1335,6553,4154,12512,6540,5066,6865,13405,6948,13501
,YinDiXiang,522401201,14032,2202,13364,7442,24764,13345,11018,13833,27178,13888,27252
Ұ,YeJiaoXiang,522401202,9613,1306,8047,5038,15868,7999,5868,8621,16620,8740,16787
,DaHeXiang,522401203,8198,1259,7356,4349,14433,7355,5762,7847,15202,7863,15219
Ž,TuanJieXiang,522401204,8706,1493,7827,4920,15033,7825,5762,8123,15948,8134,15961
,AShiXiang,522401205,9069,1682,8064,5125,15305,8049,5840,8464,16513,8527,16591
,DaTunXiang,522401206,6680,1455,6255,3980,11241,6248,4653,6470,12718,6533,12788
￲,TianKanXiang,522401207,4999,1150,4642,3027,8783,4626,3544,4985,9611,5051,9693
,DaFangZhen,522422100,69175,6312,47403,29104,72509,45072,23829,48607,93679,51913,99316
˫ɽ,ShuangShanZhen,522422101,19442,2707,15719,8827,28733,15628,9925,16200,31828,16355,32074
è,MaoChangZhen,522422102,16704,1771,13328,8088,26810,13315,8791,13855,27170,13938,27266
�,MaChangZhen,522422103,19773,2801,15899,9899,31857,15885,10649,17200,33085,17324,33223
,YangChangZhen,522422104,13500,1944,9718,7193,19376,9718,4994,10718,20436,10720,20438
,HuangNiTangZhen,522422105,14458,1986,10507,6937,20840,10505,5583,11512,22017,11520,22027
,LiuLongZhen,522422106,17142,1902,11527,7348,21987,11421,5755,12323,23744,13272,24799
Ϫ,DaXiZhen,522422107,10896,1964,9126,6079,18026,9113,5817,9527,18640,9551,18677
ư,PiaoJingZhen,522422108,14892,2113,12469,7482,23387,12459,8128,12611,25070,12664,25133
ʯ,ChangShiZhen,522422109,14298,2373,12679,7920,23231,12602,8950,12846,25448,12942,25621
,DongGuanXiang,522422200,14244,1484,10305,6472,18609,10163,6062,10744,20907,11485,21790
԰,ZhuYuanXiang,522422201,9409,1363,7648,4716,14876,7626,4831,7697,15323,7955,15603
ˮ,XiangShuiXiang,522422202,13343,2321,11096,7391,20766,11084,6891,11403,22487,11459,22555
ĸ,WenGeXiang,522422203,12627,1934,10480,6272,20956,10337,7107,10874,21211,11188,21668
,LvTangXiang,522422204,7308,1015,5493,3736,10515,5481,3649,5940,11421,6479,11972
,DingXinXiang,522422205,17414,2367,14480,9657,28594,14458,9582,14858,29316,14883,29363
ţ,NiuChangXiang,522422206,16043,2246,12790,8097,25790,12746,8348,13786,26532,13847,26637
ߵ,GaoDianXiang,522422207,10986,1757,8416,6067,16669,8386,4790,8952,17338,9117,17533
С,XiaoTunXiang,522422208,11124,1607,8033,6146,16226,8033,4062,8735,16768,8760,16793
�,LiHuaXiang,522422209,20016,2949,14602,10103,29266,14577,7381,15715,30292,15744,30346
,JiChangXiang,522422210,14063,1988,10760,6585,21469,10756,6165,11444,22200,11456,22216
ɽ,FengShanXiang,522422211,11594,1145,7564,5078,13969,7399,3635,8259,15658,8810,16374
,AnLeXiang,522422212,6855,850,4850,3391,9682,4828,2613,5261,10089,5468,10318
,HeTaoXiang,522422213,12530,2015,10130,6429,18926,10126,6096,10355,20481,10511,20641
˱,BaBaoXiang,522422214,11572,2149,10194,6998,19598,10187,7031,10547,20734,10558,20752
¡,XingLongXiang,522422215,8388,1567,7925,5272,15024,7900,6267,8245,16145,8297,16222
,GuoWaXiang,522422216,5836,995,4623,3108,9119,4610,2930,5090,9700,5138,9761
ɽ,DaShanXiang,522422217,6588,955,5550,3534,10972,5535,4073,6051,11586,6066,11616
,YuChongXiang,522422218,6235,736,4077,2639,8610,4040,2290,4771,8811,5184,9261
,HuangNiXiang,522422219,7418,976,5239,3414,10501,5194,2867,5805,10999,6022,11261
ˮ,DaShuiXiang,522422220,6580,822,4837,2941,9660,4828,2870,5417,10245,5435,10272
ɳ,ShaChangXiang,522422221,7387,965,5347,3292,10259,5306,3099,5929,11235,6104,11451
յ,PuDiXiang,522422222,21202,2374,14575,9197,29153,14477,7791,15857,30334,16792,31367
,BaiNaXiang,522422223,6847,568,4597,2672,8592,4496,2142,4797,9293,4960,9557
Ԫ,SanYuanXiang,522422224,8437,1054,5989,4141,12275,5989,3365,6867,12856,6867,12856
,XingXiuXiang,522422225,6029,706,4486,2878,8722,4466,2830,5006,9472,5079,9565
ǹ,ChengGuanZhen,522423100,116064,9236,80462,47074,108364,76286,39103,77925,154211,83941,164403
,JinBiZhen,522423101,19980,2750,15443,9823,28965,15352,9035,16188,31540,16322,31765
,YuDuoZhen,522423102,11855,1760,8992,6235,16827,8986,4918,9325,18311,9541,18533
,DaGuanZhen,522423103,16725,2372,12438,7712,22754,12376,6494,12794,25170,13153,25591
,GuLiZhen,522423104,14610,1906,10320,6794,19295,10161,5558,11142,21303,11754,22074
,SuPuZhen,522423105,15667,2512,12420,8070,23061,12404,7629,13335,25739,13388,25808
ƺ,ZhongPingZhen,522423106,12693,2087,9833,6582,19612,9830,5772,10712,20542,10719,20552
,ChongXinZhen,522423107,16746,2599,12950,8314,23859,12947,7557,13945,26892,13952,26902
Ȫ,LinQuanZhen,522423108,19777,2478,14608,9207,27465,14583,7939,15494,30077,15586,30194
,WuLiXiang,522423200,8866,1238,7268,4372,13958,7262,4697,7507,14769,7533,14801
ɳ,ShaJingXiang,522423201,15393,2280,12216,7884,22704,12213,7857,13301,25514,13314,25530
,YangChangXiang,522423202,8836,1212,6422,4564,12209,6376,4115,7135,13511,7741,14163
̻,LvHuaXiang,522423203,11115,1651,8433,5310,15765,8401,4614,8841,17242,8947,17380
,XinRenXiang,522423204,9331,1296,7183,4723,13821,7183,4574,8018,15201,8018,15201
ɽ,ZhongShanXiang,522423205,12775,1836,9513,6171,16695,9448,5294,9876,19324,10392,19905
ʯ,TieShiXiang,522423206,7848,1468,6151,4637,12114,6144,3534,6674,12818,6699,12850
Э,XieHeXiang,522423207,14348,1729,10436,6628,19610,10377,6010,11146,21523,11651,22087
̫,TaiLaiXiang,522423208,12250,1859,9052,6303,16781,8961,5448,10056,19017,10505,19557
,GanTangXiang,522423209,19657,2679,14446,9567,26816,14379,8203,15738,30117,16093,30539
,YongShenXiang,522423210,10048,1755,7429,5427,15067,7429,3909,8283,15712,8283,15712
н,ZhongJianXiang,522423211,4821,721,3615,2433,6699,3607,2145,4004,7611,4072,7687
Ϫ,HuaXiXiang,522423212,6821,949,4961,3552,9343,4958,3057,5637,10595,5866,10827
,DingXinXiang,522423213,8436,1491,6422,4437,12752,6422,3598,7103,13525,7103,13525
ˮ,HongShuiXiang,522423214,12255,1614,9056,5526,17052,9042,4787,9584,18626,9600,18656
,JinPoXiang,522423215,12895,1100,8322,4782,14503,8121,4521,8945,17066,10194,18516
ʺ,RenHeXiang,522423216,11397,1682,8475,5362,16070,8446,4844,9268,17714,9448,17923
,HongLinXiang,522423217,10594,1261,7514,4592,14252,7513,3979,8319,15832,8320,15834
,JinXingXiang,522423218,11678,1943,9467,5987,18026,9438,5811,9911,19349,9965,19432
ǹ,ChengGuanZhen,522424100,80446,7590,56785,36670,83190,55231,28089,56909,112140,59340,116125
,AnDiZhen,522424101,13936,2105,10612,7383,19147,10564,5747,11126,21690,11176,21788
ɳ,ShaTuZhen,522424102,25294,3020,18454,12071,32191,17928,10032,18834,36762,19892,38346
ҿ,YanKongZhen,522424103,19286,3426,15101,10902,28306,15052,8547,15985,31037,16158,31259
,YuMoZhen,522424104,16308,2447,11979,8521,23227,11962,6577,12925,24887,13353,25332
ͷ,LanTouZhen,522424105,8827,1147,6437,4401,11547,6387,3540,6814,13201,7077,13514
,QingChiZhen,522424106,10024,2146,8744,5977,15476,8725,6054,9403,18128,9480,18224
ƽ,PingBaXiang,522424200,12444,1870,9203,5911,18328,9166,5364,10151,19317,10475,19678
,XiLuoXiang,522424201,18745,2378,13538,8003,21844,13332,7770,13792,27124,15355,28893
ʯ,ShiChangMiaoZuYiZuXiang,522424202,13478,2321,10308,6974,19384,10265,5728,11149,21414,11219,21527
,GuiHuaXiang,522424203,6642,1057,5166,3308,9566,5118,3183,5649,10767,5716,10882
̫ƽ,TaiPingYiZuMiaoZuXiang,522424204,6410,1123,4982,3505,9096,4923,3269,5627,10550,5820,10802
,QingMenMiaoZuYiZuYiLaoZuXiang,522424205,2909,490,2106,1693,3999,2106,1308,2597,4703,2601,4707
,LongBaXiang,522424206,5690,1062,4401,3012,8103,4379,2410,4724,9103,4761,9162
ƺ,GaoPingXiang,522424207,8459,1021,6294,4186,11254,6213,3773,6521,12734,6959,13253
,HuaJiaoXiang,522424208,8822,1416,7166,4822,12803,7142,4632,7418,14560,7704,14870
԰,ChaYuanXiang,522424209,11049,1888,8599,6098,16119,8571,5197,9175,17746,9535,18134
ľ,MuKongXiang,522424210,9347,1232,6406,4200,10768,6297,3558,6770,13067,7731,14137
,ChangBaXiang,522424211,10832,1707,8236,5782,15346,8222,4693,8891,17113,8996,17232
Դ,YuanCunXiang,522424212,12316,2009,9636,6627,18378,9634,5588,10153,19787,10277,19913
,GuanTianXiang,522424213,7353,1495,6000,4694,11230,5989,3388,6219,12208,6236,12236
ɽ,HouShanXiang,522424214,6741,1410,5545,3796,11116,5529,3403,5950,11479,6009,11554
,AnLuoMiaoZuYiZuManZuXiang,522424215,13277,1410,8453,5211,15677,8409,4685,9324,17733,10919,19372
»,XinHuaMiaoZuYiZuManZuXiang,522424216,20668,1420,12422,8048,17391,12147,7409,13816,25963,17075,29497
岼,DaTianYiZuMiaoZuBuYiZuXiang,522424217,6095,608,4019,2632,7324,3968,2292,4605,8573,4976,8995
·,MaLuYiZuMiaoZuXiang,522424218,6026,1233,5306,3371,9434,5277,3884,5772,11049,5837,11143
ǹ,ChengGuanZhen,522425100,82956,6495,58831,36054,94957,55452,31431,58337,113789,62051,120882
,GuiGuoZhen,522425101,13949,1549,10112,6091,21196,10102,5938,11250,21352,11324,21436
ţ,NiuChangZhen,522425102,16924,2464,13388,9417,26448,13348,8263,13902,27250,14263,27651
è,MaoChangZhen,522425103,19193,2506,15243,9856,29779,15233,9780,16023,31256,16236,31479
,HuaQiZhen,522425104,18201,2354,13655,8284,28043,13644,8006,14820,28464,14906,28561
,LongChangZhen,522425105,11062,1691,8360,5859,17176,8353,4843,9202,17555,9236,17596
˲,BaBuZhen,522425106,21549,2560,16352,9655,32771,16296,9909,17419,33715,17666,34018
,YiNaZhen,522425107,15414,2336,12452,8572,24670,12424,7995,13161,25585,13293,25745
,SanTangZhen,522425108,19682,1944,14791,8570,30152,14624,9944,15882,30506,16779,31570
,AGongZhen,522425109,14041,1925,11932,7418,24420,11896,8992,12933,24829,13026,24958
,ZhuCangZhen,522425110,22506,2518,16848,10229,33759,16805,10392,17981,34786,18568,35416
,SanJiaXiang,522425200,13771,1529,10066,6787,20214,10048,5921,10852,20900,11155,21221
ǿ,ZiQiangXiang,522425201,7068,880,5094,3427,10653,5049,2906,5687,10736,5760,10854
ƽ,DaPingXiang,522425202,8711,1172,6866,4033,14107,6866,4365,7366,14232,7382,14248
կ,GuanZhaiXiang,522425203,12315,1589,9861,6535,20028,9844,6383,10336,20180,10426,20287
,ChaDianXiang,522425204,11930,1894,9948,6538,20020,9888,6809,10603,20491,10685,20633
,JinLongXiang,522425205,16666,2256,12914,7613,26429,12901,7868,13815,26716,13876,26790
կ,HouZhaiXiang,522425206,11215,1260,8789,5286,17826,8740,5924,9410,18150,9610,18399
,JiChangXiang,522425207,17968,2422,15413,8859,31029,15371,11373,16269,31640,16350,31763
կ,ZhongZhaiXiang,522425208,9728,1189,7755,4545,15390,7670,5462,8342,16012,8624,16379
İ,QiMoXiang,522425209,16077,1714,11723,7032,23494,11630,6765,12366,23996,12833,24556
,PuWengXiang,522425210,7675,907,5717,4046,11477,5701,3566,6374,12075,6431,12148
ʵ,ShiXingXiang,522425211,8221,1170,6587,4567,13480,6559,4413,7164,13723,7217,13804
�,MaChangXiang,522425212,10958,1307,8354,5679,16488,8342,5063,8846,17188,8974,17328
ƺկ,ShangPingZhaiXiang,522425213,6967,1098,5609,3998,11390,5584,3720,6022,11606,6176,11785
Ӫ,YingHeXiang,522425214,6644,921,4999,3547,10422,4994,3141,5680,10674,5707,10706
Ӻ,NaYongXiang,522425215,8405,1124,6346,4081,13021,6345,3840,7003,13348,7023,13369
,BanQiaoXiang,522425216,10178,1579,7907,5930,16161,7841,4634,8392,16233,8484,16391
,BaiNiXiang,522425217,11024,1588,9569,5826,19162,9398,7198,9973,19371,10241,19810
,ShaoPuXiang,522425218,17740,2181,14271,8122,28287,14221,9920,15254,29475,15570,29841
ܼҳ,XiongJiaChangXiang,522425219,11184,1684,8817,5807,18041,8774,5699,9532,18306,9750,18567
,HeiTuXiang,522425220,9847,1436,7553,5016,15552,7531,4645,8266,15797,8375,15928
Ӻ,YongXiZhen,522426100,54941,5424,41084,24711,65262,40451,24870,42890,83341,44151,85235
W,ZongLingZhen,522426101,19412,1825,14447,8179,23781,14316,10061,15249,29565,16851,31298
,YangChangZhen,522426102,29646,2794,22911,11886,43338,22720,14921,23493,46213,24450,47361
ά,WeiXinZhen,522426103,12803,1959,11113,6238,20962,11092,7902,11494,22586,11551,22664
,LongChangZhen,522426104,16993,1931,14756,8700,27018,14738,10972,14974,29712,15140,29896
,LeZhiZhen,522426105,12179,1796,10305,6548,19359,10273,6804,10381,20654,10474,20779
կ,WangJiaZhaiZhen,522426106,14061,2432,11693,8489,22432,11673,7437,12186,23859,12237,23930
,BaiXingZhen,522426107,17662,2715,15219,9508,27390,15189,10122,15135,30324,15280,30499
ż,ZhangJiaWanZhen,522426108,16361,2493,13753,8781,25976,13735,9581,14486,28221,14682,28435
,ShaoWoXiang,522426200,13663,1921,10843,6826,20412,10779,6940,11205,21984,11681,22524
·,XinFangXiang,522426201,17241,2014,14259,7863,27547,14136,10288,14693,28829,15284,29543
Ƕ,SheDongGuanXiang,522426202,7626,1115,6831,4206,13156,6820,5183,7052,13872,7093,13924
,DongDiXiang,522426203,10656,1345,9957,5634,18958,9938,8215,10211,20149,10259,20216
կ,ZhaiLeXiang,522426204,16076,2117,14036,8409,26838,14014,10270,14327,28341,14427,28463
,HuaZuoXiang,522426205,13588,1856,12533,7511,23051,12520,9942,12767,25287,12853,25386
ϰ,LaoAoBaXiang,522426206,16850,2359,13878,8352,27578,13852,9386,14616,28468,14717,28595
ɳ,ShaBaoXiang,522426207,12288,1999,10895,6754,20912,10878,7934,11230,22108,11326,22221
ˮ,ShuiDongXiang,522426208,10287,1703,8982,5922,17548,8960,6597,9540,18500,9605,18587
,ShuGuangXiang,522426209,17836,2682,14986,9951,27578,14944,10256,15632,30576,15788,30774
ÿ,GuKaiXiang,522426210,12711,1666,11183,6381,21442,11152,8596,11696,22848,11790,22973
,YangChangXiang,522426211,12351,1808,11053,6351,22007,11002,9082,12141,23143,12188,23241
Ȧ,GuoQuanYanXiang,522426212,10983,1420,9844,5104,19164,9842,8184,10733,20575,10743,20587
կ,KunZhaiXiang,522426213,10497,1248,8926,5119,16748,8897,6756,9362,18259,9575,18501
,ZuoJiuJiaXiang,522426214,5466,679,4318,2618,8364,4301,3004,4767,9068,4831,9149
�,ZhuChangXiang,522426215,8834,1108,7385,4311,13690,7349,5549,7840,15189,8106,15491
ݺ,CaoHaiZhen,522427100,95581,7329,71900,37176,132315,69846,45397,73470,143316,76407,148307
ôվ,MeZhanZhen,522427101,17088,1841,14206,7748,29259,14201,10853,15563,29764,15576,29782
,JinZhongZhen,522427102,26231,2482,21459,10678,44151,21392,16999,24061,45453,24253,45712
¯ɽ,LuShanZhen,522427103,31547,2337,27727,12162,56331,27609,24018,29884,57493,30175,57902
,LongChangZhen,522427104,31857,3118,25361,12083,53370,25138,19159,28203,53341,28773,54134
ʯ,HeiShiZhen,522427105,28345,2816,19841,9828,41365,19781,11261,22431,42212,22581,42422
ܾ,ZheJiaoZhen,522427106,26029,3034,19359,10502,40036,19351,11815,21471,40822,21519,40878
۷纣,GuanFengHaiZhen,522427107,20876,1634,16455,7999,33445,16433,11452,17414,33847,17507,33962
ţ,NiuPengZhen,522427108,23359,1920,18852,8681,38754,18781,13896,20213,38994,20323,39175
,YiNaZhen,522427109,20159,1481,16075,7878,33341,16026,12150,17517,33543,17715,33790
ˮ,ZhongShuiZhen,522427110,23522,2638,19827,9638,39337,19768,13951,20107,39875,20284,40111
,LongJieZhen,522427111,28269,2064,20728,11225,43064,20691,13144,22564,43255,22749,43477
ѩɽ,XueShanZhen,522427112,26542,2267,20993,10569,42313,20886,14531,22115,43001,22347,43340
,YangJieZhen,522427113,27162,2606,23422,10935,47391,23202,18597,24505,47707,24943,48365
С,XiaoHaiZhen,522427114,33619,2598,27173,11902,55363,27065,19988,28837,55902,29032,56205
β,YanCangZhen,522427115,16034,1475,13379,6443,27816,13318,10855,14838,28156,14985,28364
,DongFengZhen,522427116,24940,1788,20989,9349,41729,20968,16440,22152,43120,22179,43168
,ErTangZhen,522427117,13232,1212,10852,5209,21411,10728,7880,10946,21674,11472,22324
ﳡ,HouChangZhen,522427118,15470,1492,13188,5774,25833,13144,9883,13494,26638,13657,26845
,JinDouXiang,522427200,16666,1942,12634,6595,27487,12595,9135,14972,27567,15109,27743
·,XinFaBuYiZuXiang,522427201,23746,2683,18178,8802,38252,18112,12434,20500,38612,20685,38863
,ChaHeXiang,522427202,13476,1789,9726,5499,20808,9679,6192,11532,21211,11731,21457
է,MaZhaXiang,522427203,21790,2452,17590,8349,36157,17563,12099,18681,36244,18751,36341
,HaiLaXiang,522427204,17042,2335,12580,6369,27422,12526,8440,15145,27671,15237,27817
,HaLaHeXiang,522427205,11757,1227,8930,4592,18473,8777,5813,9502,18279,9867,18797
ˮ,XiuShuiXiang,522427206,14594,1502,11117,5358,23056,11082,7164,12057,23139,12143,23260
,DouGuXiang,522427207,10679,1141,8096,4175,17113,8015,5652,9202,17217,9376,17472
,YuLongXiang,522427208,16735,1811,13158,6937,27134,13111,9020,14340,27451,14408,27566
,HeiTuHeXiang,522427209,11379,801,9053,4557,18528,9000,6795,9798,18798,9922,18975
ʯ,ShiMenXiang,522427210,11610,968,8957,4669,18348,8877,6494,9882,18759,10115,19072
ƹ,YunGuiXiang,522427211,11521,802,8565,4623,17562,8537,5852,9535,18072,9610,18175
ý,TuJieXiang,522427212,18984,1671,14663,7454,30118,14554,9989,15705,30259,15981,30644
˫,ShuangLongXiang,522427213,15863,1250,13213,6111,27042,13199,10095,13975,27174,13995,27208
,BanDiXiang,522427214,8080,828,6937,3449,13984,6922,5327,7250,14172,7298,14235
,DaJieXiang,522427215,11201,1114,8298,4333,17511,8259,5318,9231,17490,9335,17633
ǹ,ChengGuanZhen,522428100,39829,3494,29142,17249,45248,28505,17104,29929,58434,31285,60427
׹,BaiGuoZhen,522428101,18563,2071,15784,7021,29026,15686,11227,15908,31594,16077,31861
,MaGuZhen,522428102,22213,2410,17875,9553,34459,17778,12262,18640,36418,19010,36885
,CaiShenZhen,522428103,17536,2323,15426,7910,30354,15060,11666,15595,30655,16099,31525
,LiuQuHeZhen,522428104,13581,1878,11794,6728,22905,11720,8647,12124,23844,12312,24106
Ұ�,YeMaChuanZhen,522428105,20954,3329,17784,10157,33581,17664,11583,17680,35344,18082,35866
,DaYiXiang,522428200,10462,1266,9084,4553,17524,9071,6745,9325,18396,9389,18473
ˮ,ShuiTangBaoXiang,522428201,9919,1002,8561,4041,15837,8460,6635,8726,17186,8995,17556
˷,XingFaXiang,522428202,13395,1336,11137,5509,21210,11089,8277,11782,22871,11871,23008
,SongLinPoXiang,522428203,12268,1569,10493,5774,19874,10443,7548,10600,21043,10892,21385
,ZhiJieXiang,522428204,8843,898,6840,3459,13111,6812,4742,7509,14321,7643,14483
,ZhuShiXiang,522428205,12244,1044,9693,4547,18632,9652,6891,10253,19905,10486,20179
,LuoZhouXiang,522428206,13228,1484,11761,5654,22755,11726,9234,12108,23834,12185,23946
˫ƺ,ShuangPingXiang,522428207,19524,2166,16475,7407,31831,16378,12688,17700,34078,17903,34378
,TieJiangXiang,522428208,9229,1006,7909,3474,14587,7845,5921,8086,15931,8247,16156
,FuChuXiang,522428209,7458,996,6407,3451,12127,6366,4733,6687,13053,6780,13187
,KeLeXiang,522428210,18777,2032,15429,8109,30817,15380,10547,15830,31210,15927,31356
,HeZhenXiang,522428211,15190,1772,12661,7190,24373,12616,9009,13181,25797,13310,25971
׿,DeZhuoXiang,522428212,12689,1491,10892,5404,20676,10837,8149,11280,22117,11437,22329
Ϫ,AnLeXiXiang,522428213,6356,861,5641,3046,10257,5584,4407,5837,11421,5983,11624
,ZhuMingXiang,522428214,14721,1889,12362,6269,24103,12228,8744,12679,24907,12992,25354
ṹ,JieGouXiang,522428215,9512,1063,8024,3834,16146,7967,6092,8415,16382,8643,16667
Ż,GuJiXiang,522428216,10142,1561,9572,4976,17938,9543,7532,9593,19136,9663,19235
ׯ,ZheZhuangXiang,522428217,12498,1917,11295,6413,21439,11220,8551,11406,22626,11671,22966
ƽɽ,PingShanXiang,522428218,11082,1985,10095,5931,19144,10034,7281,9945,19979,10253,20348
Ŵ,GuDaXiang,522428219,10501,1793,8777,5338,16954,8745,6172,9580,18325,9689,18466
,WeiSheXiang,522428220,6601,1027,5488,3136,10868,5431,3992,5894,11325,6132,11620
ֵ,ChengXiJieDao,522601001,25301,2444,16749,10426,16883,14614,5435,14829,29443,16431,33180
ʮֵֽ,DaShiZiJieDao,522601002,66493,5507,41190,28324,50590,38605,14718,38405,77010,45528,86718
Žֵ,XiMenJieDao,522601003,36333,3817,24954,16651,27534,24762,10228,25098,49860,25424,50378
ϴӽֵ,XiMaHeJieDao,522601004,43631,3663,26863,15928,28607,22967,10281,24246,47213,30712,57575
Ϫֵ,WanXiJieDao,522601005,17768,1834,12135,7905,14314,11867,5086,12170,24037,12553,24688
Ѽֵ,YaTangJieDao,522601006,18186,1551,11347,5375,14931,7862,3469,8755,16617,11859,23206
,SanKeShuZhen,522601100,30177,4694,21581,12524,44133,21384,11531,24377,45761,24821,46402
Ϫ,ZhouXiZhen,522601101,11191,2076,7722,5521,16210,7709,3592,9016,16725,9137,16859
Ժ,PangHaiZhen,522601103,13071,2559,10678,6472,21390,10675,6676,11615,22290,11628,22306
ˮ,WanShuiZhen,522601104,10487,2078,8259,5615,16093,8253,4576,8828,17081,8882,17141
¯ɽ,LuShanZhen,522601105,16916,2530,11810,7556,23168,11636,5628,12673,24309,13264,25074
,WanChaoZhen,522601106,7934,1568,5678,3885,11477,5660,2565,6353,12013,6389,12067
,LongChangZhen,522601107,12529,1819,8578,5546,17078,8541,4215,9814,18355,9985,18563
,KaiTangXiang,522601200,10775,1528,8605,4411,16446,8602,6091,9782,18384,9789,18394
綴,DaFengDongXiang,522601201,17781,2999,12501,8547,25520,12431,5680,13841,26272,13959,26460
,XinZhouZhen,522622100,34914,4936,25495,17276,42220,25192,12644,25768,50960,26999,52494
,JiuZhouZhen,522622101,23363,4155,18764,12572,35348,18184,10128,18257,36441,18882,37646
ذ,ZhongAnZhen,522622102,17771,3557,14099,9234,27616,13922,7463,14324,28246,14692,28791
¤,GuLongZhen,522622103,21183,3922,19200,10203,37602,18947,13052,18547,37494,18957,38157
ƽϪ,PingXiZhen,522622104,6448,1332,5160,3663,10104,5107,2748,5301,10408,5368,10528
Ұ,YeDongHeXiang,522622200,8251,1646,6628,4462,13121,6623,3595,6840,13463,6864,13492
Ʈ,HuangPiaoXiang,522622201,5566,1323,4879,2897,9572,4853,2863,4782,9635,4873,9752
,ShangTangXiang,522622202,6271,1326,4785,3561,9567,4760,2355,5090,9850,5167,9952
һˮ,YiWanShuiXiang,522622203,6247,1044,4677,3129,9180,4677,2311,4925,9602,4925,9602
ֽ,ZhiFangXiang,522622204,4796,918,3668,2701,7312,3650,1870,3886,7536,3916,7584
˶,LangDongXiang,522622205,7492,1473,5975,4310,11599,5891,3108,5929,11820,6098,12073
ƺ,WengPingXiang,522622206,5345,1274,4679,3138,9299,4675,2863,4794,9469,4803,9482
,ZhongXingXiang,522622207,6586,1391,5390,3464,10939,5380,3125,5698,11078,5712,11102
¤,MiaoLongXiang,522622208,6596,1387,6477,3611,12383,6452,4725,6156,12608,6231,12708
ǹ,ChengGuanZhen,522623100,34470,4070,25207,14836,41709,24083,12345,24553,48636,25678,50885
,YangLiuTangZhen,522623101,7975,1697,6853,4077,13465,6826,4254,6985,13811,7073,13926
˫,ShuangJingZhen,522623102,7484,1876,6643,4179,13029,6630,4291,6946,13576,7008,13651
ţ,NiuDaChangZhen,522623103,13033,1757,9384,5685,18417,9370,4577,9956,19326,9983,19367
׶,BaiDuoXiang,522623200,4780,726,3383,2149,6910,3367,1722,3814,7181,3845,7228
Ϫ,GanXiXiang,522623201,4518,762,3298,2290,6731,3291,1715,3689,6980,3697,6995
,MaHaoXiang,522623202,7496,1718,6474,4082,12483,6437,3937,6557,12994,6677,13151
Ϫ,MaXiXiang,522623203,3439,586,2469,1850,5062,2467,1236,2791,5258,2792,5261
˹,BaGongZhen,522624100,39317,4630,28997,19021,50340,28458,14971,28885,57343,29921,58918
̨,TaiLieZhen,522624101,9531,1787,8182,6093,16543,8137,5653,8660,16797,8789,16971
կ,WaZhaiZhen,522624102,7522,1446,6098,4656,11792,6051,3403,6220,12271,6273,12371
ͩ,TongLinZhen,522624103,7950,1593,6063,4454,12260,6057,3198,6665,12722,6678,12741
ѩ,XueDongZhen,522624104,5473,1393,4276,3442,8891,4250,2362,4868,9118,4952,9228
,GunMaXiang,522624200,5221,928,4177,3182,8409,4167,2458,4386,8553,4430,8607
,ChangJiXiang,522624201,9702,1765,7980,5774,15718,7950,4841,8268,16218,8328,16308
,KuanChangXiang,522624202,5358,1167,4187,3096,8416,4154,2157,4462,8616,4495,8682
,LiangShangXiang,522624203,6761,1297,5526,3851,11747,5500,3851,6318,11818,6383,11909
,WuYangZhen,522625100,40616,4999,29010,18169,46773,27426,13015,27668,55094,29620,58630
Ϫ,JiaoXiZhen,522625101,9534,1649,7420,5228,14631,7372,4299,7967,15339,8062,15482
Ϫ,QingXiZhen,522625102,15767,2486,11638,7414,21847,11347,6406,12180,23527,13021,24659
ƺ,YangPingZhen,522625103,11309,2011,8388,5546,13914,8320,4625,9286,17606,9557,17945
,YangChangZhen,522625104,10259,1678,7215,4713,14155,7088,3818,7918,15006,8540,15755
ƺ,DouPingZhen,522625105,8262,1739,6481,4680,12933,6457,3529,7002,13459,7049,13530
,JiangGuXiang,522625200,8594,1575,7133,4581,13977,7103,4391,7339,14442,7427,14560
ӿϪ,YongXiXiang,522625201,5524,979,4194,2669,8124,4162,2306,4471,8633,4615,8809
,JinBaoXiang,522625202,8610,1401,6644,4511,13348,6571,4102,7185,13756,7469,14113
,BaoJingXiang,522625203,4096,653,3076,2099,6433,3046,2035,3611,6657,3708,6784
,DaDiXiang,522625204,5136,803,3611,2320,7231,3538,2111,3971,7509,4439,8050
կ,ShangZhaiXiang,522625205,3220,739,2456,1791,4943,2442,1346,2781,5223,2849,5305
˼D,SiYangZhen,522626100,25875,3379,18626,12807,28546,17966,9007,18835,36801,19635,38261
ˮβ,ShuiWeiZhen,522626101,7381,1667,6173,4550,12476,6159,4114,6942,13101,6989,13162
,TianMaZhen,522626102,9569,1695,7396,4865,15252,7380,4406,8258,15638,8274,15670
,LongTianZhen,522626103,8373,1651,6798,4559,13485,6790,3804,7019,13809,7030,13828
,DaYouXiang,522626200,7425,1645,5673,4247,11954,5649,3337,6637,12286,6734,12407
עϪ,ZhuXiXiang,522626201,8324,1584,6527,4356,13059,6501,3650,7010,13511,7031,13558
,TianXingXiang,522626202,5136,1269,4237,3259,8744,4234,2669,4829,9063,4837,9074
,YangQiaoXiang,522626203,9024,2110,7864,5746,15627,7854,5522,8776,16630,8792,16656
,KaiBenXiang,522626204,7412,1127,5744,3626,11309,5728,3340,6056,11784,6135,11879
ƽׯ,PingZhuangXiang,522626205,6280,1079,5231,3372,10444,5227,3311,5430,10657,5439,10670
¥,KeLouXiang,522626206,4557,877,3447,2343,7038,3447,1845,3825,7272,3832,7279
,FengChengZhen,522627100,41751,4590,28276,18061,39481,26437,11568,27770,54207,29633,57909
,BangDongZhen,522627101,18006,3404,12893,9199,26111,12877,5686,14144,27021,14203,27096
ƺ,PingDiZhen,522627102,7907,2192,5979,4628,12464,5978,2795,6909,12887,6915,12894
,LanTianZhen,522627103,11729,2579,8888,7164,18370,8862,4578,9943,18805,9998,18886
Ͷ,WengDongZhen,522627104,7468,1699,5823,4869,12118,5802,3272,6573,12375,6616,12439
,GaoNiangZhen,522627105,11740,2314,8557,6489,17388,8529,3824,9203,17732,9321,17878
ʯ,ShiDongZhen,522627106,10240,2208,7483,6120,15747,7483,3590,8547,16030,8555,16038
Զ,YuanKouZhen,522627107,11216,2130,8531,5902,17061,8419,4179,8784,17203,8994,17525
д,BenChuZhen,522627108,6011,1312,4480,3287,9133,4437,2049,4794,9231,4892,9372
,BaiShiZhen,522627109,14210,2788,10573,7581,21604,10433,5782,11832,22265,12207,22780
ѧ,SheXueXiang,522627200,9730,1693,6802,4465,13735,6754,3029,7394,14148,7650,14452
,DuMaXiang,522627201,7468,1551,5623,4160,11708,5590,2900,6244,11834,6296,11919
עϪ,ZhuXiXiang,522627202,2057,458,1567,1216,3266,1567,892,1838,3405,1840,3407
غ,DiHuXiang,522627203,1507,326,1191,877,2359,1180,631,1263,2443,1273,2464
,ZhuLinXiang,522627204,4752,1129,3916,3011,7877,3895,2179,4096,7991,4144,8060
,JiangDongXiang,522627205,6316,1399,5068,4151,10327,5065,3016,5624,10689,5663,10731
,SanJiangZhen,522628100,27622,2787,18834,11561,24981,17048,8016,17393,34441,19591,38425
éƺ,MaoPingZhen,522628101,1927,456,1489,1110,2721,1484,632,1479,2963,1526,3015
կ,DunZhaiZhen,522628102,9755,1537,7111,5036,14051,7074,3567,7683,14757,7748,14859
,QiMengZhen,522628103,9826,1724,7692,5282,15221,7591,4179,7812,15403,8037,15729
ƽ,PingQiuZhen,522628104,5354,1226,4262,3241,8610,4244,2516,4700,8944,4834,9096
ͭ,TongGuZhen,522628105,5104,999,4133,3057,8091,4125,2274,4226,8351,4244,8377
ƽ,PingLveZhen,522628106,5702,856,4196,2800,8234,4146,2112,4249,8395,4474,8670
ͬ,DaTongXiang,522628200,5256,1053,4283,2827,8459,4250,2321,4277,8527,4347,8630
»,XinHuaXiang,522628201,3949,667,3002,2074,5995,2979,1659,3208,6187,3273,6275
¡,LongLiXiang,522628202,2279,422,1851,1394,3507,1846,1052,1890,3736,1902,3753
,ZhongLingXiang,522628203,4427,726,3534,2411,6928,3511,1925,3527,7038,3544,7078
ż,OuLiXiang,522628204,4185,804,3571,2359,6729,3568,2103,3511,7079,3521,7092
̱,GuBenXiang,522628205,5114,794,3945,2549,7730,3922,2302,4203,8125,4265,8210
ӿ,HeKouXiang,522628206,5673,1017,4517,3114,9034,4494,2691,4760,9254,4864,9381
嶴,YanDongXiang,522628207,3806,807,2933,2346,6093,2915,1666,3307,6222,3346,6279
,LiuChuanZhen,522629100,10891,1354,7892,4968,15332,7802,4705,8893,16695,9058,16950
,CenSongZhen,522629101,9033,1526,7167,4779,14355,7108,5271,8483,15591,8663,15830
ϼ,NanJiaZhen,522629102,9538,1601,6992,5071,14340,6989,3788,7931,14920,7935,14927
,NanMingZhen,522629103,9273,1893,6952,4911,13908,6936,3534,7700,14636,7748,14700
ﶫ,GeDongZhen,522629104,25915,3349,18969,11480,29755,17539,10016,18587,36126,20311,39280
,JiuYangXiang,522629200,10417,1155,7541,4338,15890,7540,4947,8968,16508,8978,16519
̫ӵ,TaiYongXiang,522629201,9154,1206,6508,4082,13346,6492,3627,7428,13920,7479,13987
,NanShaoXiang,522629202,6828,945,4999,3177,9855,4998,2732,5502,10500,5506,10505
կ,NanZhaiXiang,522629203,8045,1223,5808,4145,11887,5798,3227,6648,12446,6687,12495
Ϫ,PanXiXiang,522629204,6076,1286,4662,3514,9576,4649,2495,5170,9819,5195,9857
,MinDongXiang,522629205,5536,959,4080,3056,8288,4064,2346,4718,8782,4761,8841
ô,GuanMeXiang,522629206,3898,575,3119,2096,6420,3081,2260,3534,6615,3614,6733
̨,TaiGongZhen,522630100,26114,3097,19064,13049,33450,18654,10369,19869,38523,20516,39580
ʩ,ShiDongZhen,522630101,6105,1452,5187,3520,10001,5134,3113,5355,10489,5483,10670
Ϲ,NanGongXiang,522630200,7762,982,5655,3401,11760,5655,3233,6320,11975,6322,11977
,PaiYangXiang,522630201,3697,648,2719,1846,5561,2704,1472,3056,5760,3098,5817
̨,TaiPanXiang,522630202,7909,1183,6160,3457,12085,6116,3862,6679,12795,6794,12954
һ,GeYiXiang,522630203,6305,1052,5137,2964,10434,5126,3403,5574,10700,5623,10760
,LaoTunXiang,522630204,6216,1139,4922,3364,10117,4909,3041,5436,10345,5474,10396
,FangZhaoXiang,522630205,5949,990,4730,3165,9884,4715,3226,5390,10105,5435,10165
·,DeFengZhen,522631100,46234,3824,30337,18263,42038,27928,12264,29425,57353,31985,62322
,GaoTunZhen,522631101,13961,1881,9666,6301,19283,9623,4546,10565,20188,10722,20388
г,ZhongChaoZhen,522631102,14599,2098,10821,6624,21416,10711,5432,11115,21826,11308,22129
,MengYanZhen,522631103,6611,1373,5135,3640,10241,5124,2588,5411,10535,5437,10572
,AoShiZhen,522631104,7456,1033,5332,3195,10909,5219,2543,5438,10657,5700,11032
ų,JiuChaoZhen,522631105,11047,1884,8996,5534,17428,8982,5383,9264,18246,9318,18314
Ҷ,YanDongZhen,522631106,6333,1432,5069,3251,10287,5048,2741,5404,10452,5437,10506
ˮ,ShuiKouZhen,522631107,17242,2566,12861,7577,25939,12791,7019,13700,26491,13966,26827
,HongZhouZhen,522631108,13878,2046,10362,6111,20629,10355,5369,10900,21255,10931,21293
,ShangZhongZhen,522631109,14008,2201,10212,7086,20785,10197,5216,11194,21391,11213,21425
˳,ShunHuaXiang,522631200,2385,328,1697,1033,3569,1680,876,1870,3550,1892,3589
׶,LeiDongXiang,522631201,5820,1045,4326,2634,9063,4321,2323,4831,9152,4862,9188
,YongCongXiang,522631202,8873,1359,6323,3660,12435,6194,3438,6706,12900,7347,13670
,LuoLiXiang,522631203,7657,1286,5473,3527,11352,5427,2578,5917,11344,6048,11521
é,MaoGongXiang,522631204,7417,1374,5854,3443,11851,5849,3318,6217,12066,6255,12109
կ,BaZhaiXiang,522631205,5857,963,4657,2849,9246,4618,2779,4857,9475,4942,9599
ڽ,KouJiangXiang,522631206,4756,907,3539,2012,7400,3517,1814,3886,7403,3938,7477
˫,ShuangJiangXiang,522631207,11350,1881,7632,4340,16090,7577,3542,8687,16264,9141,16773
,ZhaoXingXiang,522631208,10459,1937,8066,4915,16204,8022,4341,8368,16390,8671,16737
,LongEXiang,522631209,10066,2006,8055,5019,15997,8031,4856,8500,16531,8873,16928
ƺ,DiPingXiang,522631210,7756,1816,6020,4167,12452,6015,3120,6607,12622,6672,12692
˳,DeShunXiang,522631211,7369,1219,5512,3318,10869,5468,2578,5581,11049,5654,11166
,DaJiaXiang,522631212,6452,1049,4646,3387,9396,4630,2290,5091,9721,5145,9791
ƽկ,PingZhaiXiang,522631213,5336,756,3858,2594,8019,3827,2073,4224,8051,4307,8165
»,DeHuaXiang,522631214,4560,706,3209,2206,6760,3201,1568,3592,6793,3625,6834
,GuZhouZhen,522632100,49493,4995,33720,17920,57009,31902,15610,33229,65131,36378,70098
ҳ,ZhongChengZhen,522632101,15073,2132,11195,6472,22826,11182,6273,12226,23408,12283,23478
կ,ZhaiHaoZhen,522632102,10873,1788,8233,5301,16780,8208,4601,8975,17183,9029,17262
ƽ,PingYongZhen,522632103,9402,1454,7106,4645,14468,7100,4072,7813,14913,7822,14928
,LeLiZhen,522632104,12438,1686,8894,6051,18620,8880,5077,10261,19141,10307,19201
ʶ,LangDongZhen,522632105,11771,1574,8215,5200,17378,8206,4382,9491,17697,9512,17727
,ZaiMaXiang,522632201,8742,1272,6781,3847,13752,6765,4088,7229,13994,7321,14102
,ChongYiXiang,522632202,4913,852,3823,2688,8075,3822,2417,4338,8160,4359,8182
ƽ,PingJiangXiang,522632203,8524,1028,5590,3231,10998,5385,3124,5963,11348,7086,12676
,SanJiangXiang,522632204,8395,880,5665,3193,11657,5545,3561,6315,11860,7171,12836
,RenLiXiang,522632205,5247,771,3946,2492,8193,3906,2384,4385,8291,4456,8402
ʯ,TaShiXiang,522632206,4827,788,3718,2439,7641,3709,2274,4159,7868,4171,7889
˿,BaKaiXiang,522632207,10906,1341,8371,4711,16825,8320,5179,8880,17200,9055,17426
,DingWeiXiang,522632208,3094,411,2350,1491,4823,2346,1510,2647,4993,2665,5015
˻,XingHuaXiang,522632209,5551,687,4208,2364,8565,4198,2746,4738,8936,4776,8984
ƻ,JiHuaXiang,522632210,7311,953,5423,2882,10994,5413,2946,5769,11182,5787,11210
ˮβ,ShuiWeiXiang,522632211,2107,243,1676,957,3348,1676,1213,1887,3563,1887,3563
ƽ,PingYangXiang,522632212,5015,743,3594,2404,7528,3584,1977,4115,7699,4141,7735
,LiangWangXiang,522632213,3717,454,2615,1691,5521,2611,1437,2985,5596,2993,5608
,BingMeiZhen,522633100,21778,2112,14688,9063,22369,13949,6577,14662,28611,15779,30467
ᶴ,GuanDongZhen,522633101,13155,2263,9332,5394,19249,9306,4430,10392,19698,10516,19848
,LuoXiangZhen,522633102,12382,1937,8377,4774,16349,8245,3842,8769,17014,9784,18161
½,XiaJiangZhen,522633103,18444,2590,13461,7699,27603,13457,7206,14766,28223,14779,28240
ױ,ZaiBianZhen,522633104,7628,1219,5419,3361,11018,5410,2720,6098,11508,6148,11567
ɽ,XiShanZhen,522633105,7979,1269,5990,3525,11898,5984,2965,6194,12178,6223,12213
ͣ,TingDongZhen,522633106,15305,1863,11267,6178,22709,11235,6153,11923,23158,12054,23321
,GaoZengXiang,522633200,8235,1630,5838,3596,12529,5817,2813,6783,12600,6840,12678
ƺ,GuPingXiang,522633201,8307,1002,5679,2893,11958,5611,3393,6488,12099,7023,12702
Ӻ,YongLiXiang,522633202,9275,1327,7020,3602,14424,6976,4025,7491,14467,7607,14627
,QingYunXiang,522633203,5533,1066,4011,2253,8707,4003,2159,4729,8732,4747,8758
ձ,GangBianXiang,522633204,6188,977,4536,2567,9037,4519,2382,4917,9436,5011,9547
Ӱ,JiaBangXiang,522633205,6619,1079,4521,2629,9795,4514,2201,5349,9863,5378,9899
,XiuTangXiang,522633206,4100,816,2980,1803,5982,2971,1382,3303,6274,3318,6298
,DouLiXiang,522633207,5800,1171,4622,2786,9367,4622,2527,4869,9491,4876,9498
,CuiLiXiang,522633208,6521,1153,5008,2676,10232,4996,2657,5292,10288,5323,10331
,WangDongXiang,522633209,11502,1428,7507,4350,15639,7434,3896,8390,15824,9319,16826
,DongLangXiang,522633210,11153,1417,8299,4469,16777,8298,4333,8582,16880,8604,16903
,JiaJiuXiang,522633211,6071,891,4359,2920,8829,4359,2201,4798,9157,4804,9163
,JiaMianXiang,522633212,4945,686,3293,2161,6978,3287,1491,3800,7087,3829,7122
,GuangHuiXiang,522633213,1938,264,1308,883,2683,1308,589,1483,2791,1483,2791
,DanJiangZhen,522634100,23079,2747,16064,10024,26677,15572,8343,17288,32860,18105,34169
,XiJiangZhen,522634101,12552,1890,8873,5401,18303,8826,4876,10370,19196,10445,19318
,YongLeZhen,522634102,11296,1957,8568,5842,17579,8550,5410,10037,18587,10095,18663
ɵ,LangDeZhen,522634103,4273,753,2980,2137,6226,2972,1530,3557,6529,3576,6556
,WangFengXiang,522634200,6481,1213,4531,3201,9791,4513,2469,5567,10080,5632,10163
,DaTangXiang,522634201,6206,1124,4414,3016,9514,4399,2597,5456,9855,5513,9927
ҽ,TaoJiangXiang,522634202,4239,811,3102,2186,6426,3088,1849,3746,6834,3797,6899
ˮ,DaDiShuiZuXiang,522634203,4515,646,3511,2365,6738,3480,2358,3929,7409,4008,7519
,FangXiangXiang,522634204,2570,411,1775,1309,3738,1775,995,2195,3970,2201,3976
ɽ,XingShanZhen,522635100,30216,3710,20991,12683,34319,19273,9221,20339,39612,22156,43147
,GuDongZhen,522635101,9130,1421,6485,4101,12461,6391,3018,6897,13288,7084,13569
˾,XiaSiZhen,522635102,17097,2731,12118,7629,23763,12077,5662,13208,25285,13372,25490
,XuanWeiZhen,522635103,15478,3089,12035,7732,23907,11970,6311,12687,24657,12843,24878
̲,BiBoXiang,522635200,12030,1947,8684,5385,17159,8559,4144,9166,17725,9437,18121
ɽ,LongShanXiang,522635201,7784,1747,5835,3947,12098,5800,2945,6584,12384,6641,12476
Ͳ,XianChangBuYiZuXiang,522635202,8034,1498,6002,3828,11984,5970,2862,6335,12305,6392,12394
â,BaMangBuYiZuXiang,522635203,6893,1407,5348,3756,10709,5320,2784,5679,10999,5736,11084
,JingYangBuYiZuXiang,522635204,4216,762,3119,2172,6190,3072,1504,3288,6360,3363,6482
Ȫ,LongQuanZhen,522636100,26437,3752,19181,12789,33818,18609,9905,19904,38513,20913,40094
,XingRenZhen,522636101,15411,2501,11423,6904,23601,11368,6257,12605,23973,12746,24169
ŵ,PaiDiaoZhen,522636102,11405,1829,8097,5587,17551,8078,4617,9712,17790,9754,17851
,ChangQingXiang,522636200,5320,1049,4072,2837,8593,4072,2330,4626,8698,4627,8699
,YangWuXiang,522636201,9952,1975,7967,5432,16696,7947,4999,8924,16871,8959,16926
Ż,YaHuiXiang,522636202,3706,538,2611,1907,5658,2611,1580,3212,5823,3213,5824
ϸ,NanGaoXiang,522636203,5579,1055,4108,2656,8613,4084,2233,4694,8778,4759,8867
ݰ´,GuangHuiBanShiChu,522701001,36814,3537,20695,12552,33212,17248,5362,16663,33911,25018,45713
ķ´,WenFengBanShiChu,522701002,32103,5139,22051,16516,32782,21162,5710,20069,41231,20901,42952
»´,XinHuaBanShiChu,522701003,24116,3591,16445,12561,23430,15737,4282,14889,30626,15544,31989
СΧկ´,XiaoWeiZhaiBanShiChu,522701004,36796,4912,24976,16413,39474,23211,8078,23838,47049,24810,49786
ɳ´,ShaBaoBaoBanShiChu,522701005,46553,5214,29926,18025,44086,25077,8298,24941,50018,30139,60065
,YangLiuJieZhen,522701100,7100,1063,4655,3139,9243,4642,1894,5279,9921,5402,10057
,GanTangZhen,522701101,15969,1897,10099,5439,17422,8727,3405,8972,17699,11172,21271
,LuoBangZhen,522701102,8755,1263,5841,3473,11813,5832,2230,6365,12197,6407,12248
ӹ,BaGuZhen,522701103,10407,1935,7683,5406,15735,7678,3683,8333,16011,8342,16025
ƺ,DaPingZhen,522701104,15317,2141,10207,6046,19972,9977,3879,10688,20665,11130,21337
˾,WangSiZhen,522701105,12467,1812,8381,5128,17139,8357,3898,9397,17754,9796,18177
ī,MoChongZhen,522701106,10776,1758,7677,4946,15088,7620,3210,7944,15564,8067,15744
ƽ,PingLangZhen,522701107,5555,1057,4239,2949,8299,4239,1993,4366,8605,4366,8605
,KaiKouZhen,522701108,6041,1124,4438,3063,8755,4438,1913,4639,9077,4640,9078
,JiangZhouZhen,522701109,5461,1029,4160,2996,8107,4160,2023,4353,8513,4353,8513
ˮ,FengHeShuiZuXiang,522701200,3903,555,2815,1725,5659,2790,1380,2988,5778,3023,5838
ˮ,YangHeShuiZuXiang,522701201,6163,950,4422,3084,9256,4422,2328,5019,9441,5019,9441
ˮ,JiChangShuiZuXiang,522701202,5633,911,4016,2950,8268,4013,2187,4637,8650,4715,8731
Ķ,LiangMuXiang,522701203,6770,1169,4887,3235,9823,4885,2114,5158,10043,5166,10053
,HeYangXiang,522701204,9024,1424,6328,3798,12834,6314,2704,6812,13126,6824,13152
ɳկ,ShaZhaiXiang,522701205,7806,1390,5767,3937,11777,5759,2817,6243,12002,6246,12013
ʯ,ShiLongXiang,522701206,4038,827,3142,2221,6294,3142,1608,3331,6473,3331,6473
æ,BaiMangXiang,522701207,4188,738,3092,1984,6325,3092,1534,3368,6460,3368,6460
ɽ´,JinShanBanShiChu,522702001,38892,2601,24403,15965,32241,23045,9177,22818,45863,26267,50670
�ƺ´,MaChangPingBanShiChu,522702002,21413,1608,13908,8937,20051,13410,5889,13922,27332,15002,28910
,ChengXiangZhen,522702100,10715,1263,7080,4433,13557,7030,2931,7599,14629,7829,14909
˿,HuangSiZhen,522702101,9545,1573,6621,4231,13236,6612,2766,7227,13839,7263,13884
ɽ,FengShanZhen,522702102,11780,1746,8318,5145,16221,8272,3656,8741,17013,8864,17182
½ƺ,LuPingZhen,522702103,9984,1457,6782,4322,13583,6749,2807,7406,14155,7466,14248
,DiSongZhen,522702104,7144,1143,4861,3537,9560,4809,2062,5334,10143,5488,10349
,LongChangZhen,522702105,15392,1690,9931,6012,19051,9696,3772,10387,20083,10923,20854
ţ,NiuChangZhen,522702106,24105,2320,16170,9693,28592,15771,6701,16543,32314,16956,33126
ƺ,DaoPingZhen,522702107,13289,1724,9339,6112,18471,9318,4768,10286,19604,10442,19781
ƺ,GaoPingZhen,522702108,8317,856,5668,3080,11274,5599,2532,5951,11550,6037,11705
¡,XingLongXiang,522702200,4464,761,3186,2086,6254,3173,1425,3430,6603,3464,6650
޼ɽ,LiShanXiang,522702201,6881,1147,4867,3318,9708,4856,2028,5151,10007,5189,10056
,ChaHeXiang,522702202,2341,282,1552,1060,3085,1551,609,1678,3229,1680,3232
,XianQiaoXiang,522702203,6058,825,4294,2646,8574,4288,2123,4683,8971,4712,9006
ʯ,GaoShiXiang,522702204,8064,1057,5635,3725,11116,5604,2578,5971,11575,6064,11699
,GuWangXiang,522702205,5269,750,3576,2513,7309,3533,1624,3964,7497,4067,7643
,YuPingZhen,522722100,23419,2066,15384,8795,20837,14042,5685,14245,28287,15786,31170
,ZhaoYangZhen,522722101,6054,1097,4612,2814,8972,4553,2182,4616,9169,4721,9333
ï,MaoLanZhen,522722102,5672,726,3780,2416,7339,3710,1854,4074,7784,4472,8252
,LiHuaZhen,522722103,3837,293,2000,1630,2925,1967,882,2468,4435,3012,5012
,JiaLiangZhen,522722104,9918,1828,7848,5351,15626,7767,4387,8174,15941,8285,16133
,JiaRongZhen,522722105,7536,1256,5556,3787,11348,5544,3021,6130,11674,6257,11813
,YongKangXiang,522722200,2777,514,2219,1431,4429,2214,1230,2299,4513,2302,4521
ˮҢ,ShuiYaoXiang,522722201,4045,515,3019,1648,5898,2993,1640,3015,6008,3181,6200
ˮ,ShuiLiXiang,522722202,3104,417,2422,1483,4742,2422,1352,2451,4873,2451,4873
ɽ,YaoShanXiang,522722203,3732,413,2634,1421,5071,2602,1188,2644,5246,2699,5333
̴,LaoCunXiang,522722204,1933,383,1412,963,2868,1403,649,1543,2946,1553,2965
̰,WengAngXiang,522722205,2383,464,1707,1210,3496,1705,761,1897,3602,1901,3608
ŷ,JiaOuXiang,522722206,4104,611,3033,1971,6097,3013,1616,3179,6192,3298,6331
´,YaoLuXiang,522722207,912,155,617,369,1317,617,268,718,1335,718,1335
,DongTangXiang,522722208,4260,720,3011,2138,6131,2988,1379,3308,6296,3348,6359
,FangCunXiang,522722209,4104,835,3240,2113,6637,3162,1772,3311,6473,3471,6711
Ң,BoYaoXiang,522722210,9470,1632,7178,4545,14460,7075,3814,7530,14605,7738,14916
ǹ,ChengGuanZhen,522723100,44507,4699,28726,17648,50099,27132,9573,26422,53554,30053,58779
,DeXinZhen,522723101,6996,865,4990,3053,9439,4848,2356,4973,9821,5227,10217
°,XinBaZhen,522723102,5548,1029,4011,2941,7748,3975,1712,4187,8162,4278,8289
̽,PanJiangZhen,522723103,7965,1199,5653,3371,10176,5092,2296,5126,10218,5807,11460
ɽ,YanShanZhen,522723104,9754,1604,7218,4105,13677,7019,3486,6950,13969,7626,14844
,JiuZhiZhen,522723105,7324,1088,5590,3013,10081,5273,2770,5167,10440,5592,11182
,ChangMingZhen,522723106,10881,1421,7610,4422,13932,7480,3837,7706,15186,8529,16139
,YunWuZhen,522723107,9126,1431,7188,4004,13531,7177,3955,7302,14479,7324,14512
,XinPuXiang,522723200,7796,1057,5862,3752,11120,5815,3241,6163,11978,6232,12094
䱱,LuoBeiHeXiang,522723201,6400,911,4767,2884,9219,4688,2405,4785,9473,4949,9716
�,MaChangHeXiang,522723202,3903,666,2880,1835,5528,2865,1441,3094,5959,3130,6010
,DingDongXiang,522723203,3280,553,2480,1643,4682,2467,1184,2514,4981,2537,5017
,DingNanXiang,522723204,6954,1108,5199,3213,10238,5121,2651,5441,10562,5514,10713
,GongGuXiang,522723205,4707,893,3914,2338,7187,3874,2367,3899,7773,4053,7967
,DouLiuXiang,522723206,4893,956,3855,2356,7670,3759,2143,4003,7762,4137,7992
,YanXiaXiang,522723207,3247,511,2405,1531,4789,2388,1339,2656,5044,2692,5097
ﳡ,HouChangBaoXiang,522723208,3318,593,2633,1464,5095,2562,1381,2541,5103,2659,5292
,BaoGuanXiang,522723209,3283,636,2636,1609,5145,2604,1449,2687,5291,2732,5368
,TieChangXiang,522723210,4590,809,3633,2170,7002,3614,2024,3734,7348,3790,7423
Ҥ,YaoShangXiang,522723211,1863,367,1415,951,2853,1399,777,1551,2950,1592,3007
Ӻ,YongYangZhen,522725100,66708,4837,42933,27609,58669,41324,17712,41728,83052,46324,89257
ƽӪ,PingDingYingZhen,522725101,15349,1664,10366,5277,20982,10366,4658,11305,21671,11305,21671
,CaoTangZhen,522725102,21680,2626,15595,9360,28326,15279,6977,15519,30798,15688,31283
ƺ,ZhongPingZhen,522725103,12597,1674,8942,6283,17372,8941,3987,9304,18245,9316,18258
,JianZhongZhen,522725104,6400,947,4704,3176,9017,4699,2476,5075,9774,5119,9823
,YongHeZhen,522725105,13090,1811,9353,6211,18115,9309,4370,9812,19121,9918,19271
,ZhuCangZhen,522725106,14093,1760,10333,6465,19415,10216,4919,10359,20575,10439,20772
ɽ,YuShanZhen,522725107,12259,1503,8679,5268,16950,8643,3944,8954,17597,9027,17706
,TianWenZhen,522725108,8995,1397,6622,4751,12865,6615,3119,6873,13488,6889,13511
,YuHuaXiang,522725200,7371,986,4989,3377,10127,4969,2260,5471,10440,5628,10617
յ,YinZhanXiang,522725201,7795,892,5596,3915,10327,5577,2726,5763,11340,5817,11413
ƺ,SongPingXiang,522725202,12533,1606,8763,5031,17367,8709,3746,9014,17723,9122,17885
Сɽ,XiaoHeShanXiang,522725203,3404,556,2530,1781,4981,2524,1336,2742,5266,2766,5296
ɳ,BaiShaXiang,522725204,6993,984,5042,3409,10263,5021,2502,5358,10379,5437,10479
᰹,LanGuanXiang,522725205,7357,906,5174,3371,10327,5170,2538,5608,10778,5627,10801
Ϸ,LaoFenZuiXiang,522725206,4814,755,3577,2562,6871,3564,1952,3917,7481,3944,7521
ˮ,GaoShuiXiang,522725207,8079,942,5843,3652,11760,5843,3103,6281,12124,6281,12124
ľ,MuYinCaoXiang,522725208,4213,651,3256,2143,6347,3256,1867,3475,6731,3475,6731
ͭ,TongLuoXiang,522725209,8765,1002,6061,3494,12312,6014,2884,6457,12471,6590,12651
ţ,NiuChangBaXiang,522725210,3656,583,2786,1953,5476,2767,1422,2808,5575,2875,5661
,YuHeXiang,522725211,6859,938,5090,3515,10010,5087,2505,5208,10295,5212,10302
,LongTangXiang,522725212,4945,603,3630,2205,7176,3630,1816,3734,7364,3734,7364
ľƺ,MuLaoPingXiang,522725213,7248,782,4800,3085,9445,4799,1891,5118,9917,5121,9921
ǹ,ChengGuanZhen,522726100,42215,5011,28156,19429,44877,27138,9457,27378,54516,28527,56683
ó,TuChangZhen,522726101,7169,1203,5049,3519,10471,4998,2315,5575,10573,5638,10687
,MaWanZhen,522726102,17607,2367,12464,7457,24378,12250,5350,12614,24864,12860,25324
,JiChangZhen,522726103,17743,3447,14047,8933,27942,13951,7005,14022,27973,14148,28195
˾,ShangSiZhen,522726104,12088,2026,8810,5495,18110,8678,4161,9329,18007,9465,18275
˾,XiaSiZhen,522726105,9843,1809,7400,4554,14931,7342,3636,7806,15148,7888,15288
,JiaLiZhen,522726106,5212,1132,4063,2731,8269,4049,2063,4307,8356,4344,8407
β,MaWeiZhen,522726107,12128,1722,8569,5264,14926,8242,3931,8647,16889,9212,17781
Ң,YaoSuoXiang,522726200,8479,1455,6122,3954,12300,6104,2678,6440,12544,6490,12612
,YangFengXiang,522726201,7117,1254,5188,3285,10595,5157,2379,5487,10644,5562,10750
׶ˮ,JiaDingShuiZuXiang,522726202,1195,292,936,879,1908,936,443,994,1930,994,1930
̨ˮ,WengTaiShuiZuXiang,522726203,1399,235,1053,755,2182,1053,557,1138,2191,1138,2191
կˮ,BenZhaiShuiZuXiang,522726204,11027,1978,8767,5547,17475,8704,5027,9136,17840,9265,18032
ˮ,ShuiYanXiang,522726205,4386,936,3362,2459,6844,3336,1721,3632,6968,3681,7043
,DaYangXiang,522726206,6368,1149,4812,3110,9606,4812,2300,5005,9817,5005,9817
Ң,YaoBangXiang,522726207,5051,1050,3879,2487,7831,3873,1920,4125,7998,4142,8021
ƺ,HuangHouXiang,522726208,4840,922,3755,2372,7616,3747,2065,4047,7794,4072,7827
,DongLingXiang,522726209,4031,785,3021,1957,6096,3000,1533,3183,6183,3328,6349
ƽ,PingHuZhen,522727100,23927,2896,16500,10209,26664,15775,6495,16217,31992,16818,33318
,YaZhouZhen,522727101,8166,1789,6981,4581,13218,6962,4375,7222,14184,7349,14330
ͨ,TongZhouZhen,522727102,12970,2619,10553,7134,20296,10539,6259,11238,21777,11295,21848
,DaTangZhen,522727103,7328,1270,5821,3793,10932,5810,3748,6495,12305,6525,12346
˶,KeDuZhen,522727104,9800,1899,8354,5000,15506,8317,5496,8678,16995,8841,17195
,TangBianZhen,522727105,10530,2571,9281,6074,17771,9272,6234,10032,19304,10054,19335
,BaiRuZhen,522727106,6286,1350,5348,3619,10543,5332,3411,5630,10962,5699,11047
,ZheMiZhen,522727107,8706,1862,6834,4540,13643,6834,3639,7362,14196,7373,14207
կ,SiZhaiZhen,522727108,5044,1091,3948,2647,8118,3927,2282,4424,8351,4469,8417
,MiaoErHeXiang,522727200,4854,850,3616,2366,7133,3614,1703,3775,7389,3791,7407
ë,KaPuMaoNanZuXiang,522727201,6394,1231,4845,2950,9723,4770,2401,4964,9734,5181,10026
,BaiLongXiang,522727202,5259,1140,4281,2909,8466,4280,2344,4456,8736,4462,8743
կ,GanZhaiXiang,522727203,3833,697,3111,2029,6026,3110,1866,3279,6389,3285,6396
,KaLuoXiang,522727204,3444,894,2891,2074,5625,2875,1654,3073,5948,3101,5992
,GuDongXiang,522727205,3245,610,2610,1548,5126,2568,1565,2733,5301,2810,5420
,ShuChangXiang,522727206,5937,1139,4806,3323,9691,4806,3092,5361,10167,5362,10168
,XinTangXiang,522727207,3372,697,2627,1774,5216,2619,1463,2875,5494,2905,5532
Ʋ,ZhangBuXiang,522727208,4707,800,3824,2363,7379,3807,2432,4061,7868,4115,7939
,XiLiangXiang,522727209,4969,1172,4366,2839,8391,4363,2753,4512,8875,4528,8894
ƺ,LongPingZhen,522728100,34897,3723,24285,14344,41422,23641,11026,24100,47741,25361,49646
,BianYangZhen,522728101,11643,1904,9162,5400,16086,8769,5013,8955,17724,9398,18560
ͤ,FengTingZhen,522728102,8219,1114,6359,3734,12188,6344,3473,6407,12751,6447,12806
ĭ,MoYangZhen,522728103,8076,1363,6327,3613,12399,6321,3293,6390,12711,6405,12732
ï,MaoJingZhen,522728104,5361,1131,4414,3067,8752,4408,2433,4481,8889,4511,8925
,LuoKunZhen,522728105,5760,1165,4920,3071,9418,4919,2842,4838,9757,4847,9767
ˮ,HongShuiHeZhen,522728106,2409,295,1915,1142,3570,1915,1107,1862,3777,1896,3811
,BanGengXiang,522728200,6517,1164,5110,3251,10286,5092,2719,5262,10354,5290,10400
Ƹ,YunGanXiang,522728201,5684,982,4335,2627,8707,4333,2382,4684,9017,4713,9048
,BaZongXiang,522728202,3500,668,2832,1779,5677,2827,1604,2918,5745,2940,5772
ľ,LiMuXiang,522728203,8086,1504,6525,3713,13044,6462,3867,6810,13272,6932,13457
ɳ,LuoShaXiang,522728204,6208,1038,5101,3094,10167,5086,3229,5343,10429,5374,10475
,JiaoYanXiang,522728205,4098,819,3217,2213,6519,3215,1765,3445,6660,3465,6682
,DongWangXiang,522728206,4315,766,3418,2095,6793,3398,2196,3709,7107,3859,7277
ľ,MuYinXiang,522728207,8965,1602,7216,4511,14488,7211,4326,7664,14875,7677,14893
ƺ,NaPingXiang,522728208,1746,329,1500,926,2965,1496,970,1533,3029,1545,3045
,DongDangXiang,522728209,6592,1404,5353,3303,10527,5344,2691,5304,10648,5334,10687
,DongJiaXiang,522728210,3506,802,3064,2088,5981,3058,1947,3187,6245,3191,6255
ƽ,PingYanXiang,522728211,3352,575,2668,1739,5495,2668,1648,2907,5575,2907,5575
ͤ,FengTingXiang,522728212,3695,663,3003,1921,6147,2994,1875,3209,6203,3230,6233
ͤ,DaTingXiang,522728213,4483,794,3545,2081,7158,3543,2007,3723,7266,3739,7284
,BanRenXiang,522728214,2241,372,1762,1086,3543,1756,1011,1845,3601,1862,3624
,LuoSuXiang,522728215,3060,531,2474,1558,4884,2471,1458,2567,5038,2575,5049
ĺ,LuoMuXiang,522728216,3751,642,2998,2011,5950,2982,1694,3048,6030,3089,6087
ͤ,GouTingXiang,522728217,2863,532,2498,1511,4822,2483,1546,2387,4870,2443,4941
,LuoTuoXiang,522728218,2496,466,2039,1315,4027,2039,1243,2166,4205,2166,4205
կ,ChangZhaiZhen,522729100,21960,2608,14315,8809,25717,13963,6580,14716,28679,16833,31148
˳,GuangShunZhen,522729101,13836,1800,10214,5718,19214,10097,5357,10543,20640,10779,20993
Զ,WeiYuanZhen,522729102,9122,1630,7039,4542,13640,7026,3608,7238,14264,7321,14360
,BaiSuoZhen,522729103,6166,1018,4590,2934,8953,4557,2364,4867,9424,4958,9548
,DaiHuaZhen,522729104,5876,960,5020,3187,9529,4997,3257,5019,10016,5073,10093
ɽ,BaiYunShanZhen,522729105,10592,1661,7731,4691,15406,7730,4077,8590,16320,8599,16330
,GuYangZhen,522729106,9108,1602,7169,4772,14078,7167,3841,7382,14549,7382,14551
·,MaLuXiang,522729200,6213,1041,5024,2928,9529,4992,2756,4898,9890,4986,10010
,KaiZuoXiang,522729201,4224,734,3279,2006,6253,3251,1754,3340,6591,3433,6712
,BaiTangXiang,522729202,4263,796,3209,2044,6573,3202,1687,3534,6736,3537,6746
ֻ,ZhongHuoXiang,522729203,2681,418,1911,1207,3877,1899,919,2086,3985,2107,4018
կ,XinZhaiXiang,522729204,7010,1050,4984,3271,9468,4915,2524,5227,10142,5600,10584
Ӫ,YingPanXiang,522729205,5755,1093,4508,3044,8720,4500,2320,4645,9145,4660,9168
а,ZhongBaXiang,522729206,5626,1076,4438,2883,8682,4415,2426,4653,9068,4690,9128
,MuHuaXiang,522729207,3977,734,3199,2056,6403,3194,1842,3342,6536,3354,6553
,JiaoMaXiang,522729208,2038,262,1607,957,3152,1599,1002,1654,3253,1695,3302
ز,DunCaoXiang,522729209,3216,504,2497,1670,5059,2489,1568,2752,5241,2791,5288
ʡ˳Ҷ,GuiZhouShengGuangShunChaYeGuoShu,522729501,1718,430,1248,1032,1881,1226,449,1294,2520,1349,2597
ɽ,LongShanZhen,522730100,36933,3395,25082,14629,36887,23747,10782,24080,47827,26028,51110
Ԫ,SanYuanZhen,522730101,4197,641,2920,1894,5374,2808,1271,3019,5827,3189,6109
ʨ,XingShiZhen,522730102,8250,1032,5628,3571,10780,5592,2572,6171,11763,6226,11854
Ƚ,GuJiaoZhen,522730103,10873,1238,7333,4599,13334,7279,3566,7933,15212,8344,15677
,YangChangZhen,522730104,8322,1375,6991,3772,12122,6991,4009,6714,13705,6715,13706
ϴ,XiMaZhen,522730105,12386,1748,8522,6254,16597,8516,3737,9239,17755,9349,17871
ԭ,CaoYuanXiang,522730200,6539,1038,5382,2860,9507,5376,3462,5645,11021,5657,11039
֥,MaZhiXiang,522730201,3903,642,2868,1791,5313,2852,1333,2943,5795,3010,5878
ˮ,ShuiChangXiang,522730202,3905,504,2636,1518,4689,2585,1232,2792,5377,3005,5641
կ,WanZhaiXiang,522730203,4415,811,3576,2163,6693,3564,2087,3707,7271,3737,7313
ʡ,BaiShengXiang,522730204,5527,760,4586,2460,8060,4571,3058,4612,9183,4759,9345
ͽ,BaJiangXiang,522730205,4527,567,3009,2059,5966,2980,1340,3333,6313,3425,6434
,GuLongXiang,522730206,6651,1006,4550,3104,9114,4531,2096,5161,9692,5203,9753
Ć,NaPangXiang,522730207,6145,1068,4249,3047,8515,4228,1922,4822,9050,4886,9135
ƽ,HePingZhen,522731100,45420,4673,31536,17967,47290,29467,13260,29609,59076,31817,63353
,GaoZhenZhen,522731101,17791,2391,12621,7347,22131,12370,5793,12829,25199,13354,25975
,SanDouZhen,522731102,12079,1648,8820,4574,16879,8729,4201,8762,17491,9108,17928
ڽ,BaiJinZhen,522731103,12769,1472,9733,5022,18508,9702,5399,9791,19493,9907,19640
ˮ,YaShuiZhen,522731104,7623,1315,6311,3552,12172,6309,3766,6390,12699,6393,12704
ɼ,DuanShanZhen,522731105,10341,1818,8286,4749,16533,8234,4963,8649,16883,8836,17122
«ɽ,LuShanZhen,522731106,8916,1938,7444,4645,14430,7374,4211,7470,14844,7621,15065
,WangYouZhen,522731107,3760,870,3379,2201,6566,3363,2174,3370,6733,3425,6804
,ChangTianXiang,522731200,6901,719,4404,2491,8344,4223,2018,4553,8776,5234,9638
ڰ,BaiBangXiang,522731201,4303,766,3624,2022,6786,3614,2314,3688,7302,3759,7383
,DouDiXiang,522731202,2478,517,2017,1314,4071,2014,1223,2177,4191,2201,4218
,JiaLieXiang,522731203,4456,710,3240,2014,6641,3215,1731,3573,6788,3657,6897
ڶ,GangDuXiang,522731204,5736,918,4544,2662,8607,4507,2587,4544,9051,4697,9241
,NingWangXiang,522731205,4494,664,3490,1979,6337,3446,2193,3678,7124,3861,7351
Ѽ,YaRongXiang,522731206,9213,1164,6988,3695,13909,6953,3958,7223,14176,7347,14335
̫,TaiYangXiang,522731207,6741,1127,5208,2914,10489,5189,2902,5473,10662,5562,10770
,XianTangXiang,522731208,9002,1851,7457,4275,14867,7428,4516,7816,15244,7912,15369
,JiaRongXiang,522731209,6465,1105,4963,2915,9851,4917,2713,5218,10135,5320,10283
ּ,DiJiXiang,522731210,8340,1699,6691,3962,13605,6663,4042,7312,13975,7390,14081
,DaLongXiang,522731211,7421,1175,5533,3235,10635,5519,3017,5989,11508,6080,11613
,DaBaXiang,522731212,4526,723,3593,2094,6867,3589,2132,3778,7367,3788,7381
,DiMaXiang,522731213,4854,577,3287,1571,6866,3285,1597,3697,6982,3741,7028
,ChangAnXiang,522731214,3353,827,2732,1938,5475,2710,1422,2799,5509,2870,5602
,DaYinXiang,522731215,3292,851,2939,1978,5860,2934,1890,3066,6000,3094,6033
û,HaoHuaHongXiang,522731216,11266,1641,8293,4139,16065,8246,3926,8463,16709,8540,16833
,SanHeZhen,522732100,27513,2624,18896,10835,31172,18252,9067,18830,37082,20308,39204
,DaHeZhen,522732101,6691,933,5128,3111,9653,5117,2777,5260,10377,5273,10401
Ͻ,HeJiangZhen,522732102,8911,1564,7046,4675,13897,7033,4045,7440,14473,7474,14520
,FengLeZhen,522732103,11617,1568,8905,5227,17634,8905,4787,9060,17965,9067,17972
հ,PuAnZhen,522732104,10117,1729,7431,4630,14959,7404,4069,8107,15511,8484,15915
,DouJiangZhen,522732105,9334,982,6848,3774,13192,6811,4237,7652,14463,7705,14553
к,ZhongHeZhen,522732106,6235,766,5116,2692,9229,5109,3418,5293,10402,5303,10419
,ZhouQinZhen,522732107,8081,1118,6430,3909,11979,6408,3905,6623,13031,6674,13104
͢,TingPaiZhen,522732108,9631,1523,8156,4793,15473,8143,5220,8144,16287,8218,16374
,JiuQianZhen,522732109,11038,1458,9169,5017,16640,9164,5959,9274,18438,9286,18455
,JiaoLiXiang,522732200,10329,1354,7803,4295,15655,7792,4464,8323,16115,8344,16147
,LaLanXiang,522732201,2346,353,1766,1042,3555,1751,1000,1889,3640,1933,3699
,DaYuXiang,522732202,6818,746,4406,2654,8969,4331,2667,5151,9482,5825,10231
ӽ,BaJieXiang,522732203,6059,632,4725,2469,9201,4718,3201,5149,9867,5167,9892
,YangFuXiang,522732204,3815,446,2466,1640,4987,2431,1534,2860,5291,3329,5795
ײ,WuBuXiang,522732205,2662,326,1888,1075,3885,1882,1170,2214,4096,2270,4158
ˮ,ShuiLongXiang,522732206,9169,1018,7178,3694,13361,7166,4596,7591,14757,7605,14783
,TangZhouXiang,522732207,10680,1247,8579,4508,15709,8544,5724,8934,17478,9072,17651
,SanDongXiang,522732208,11399,1481,8996,4788,16765,8930,5317,9069,17999,9201,18197
,HengFengXiang,522732209,4280,723,3504,2294,6581,3499,2169,3612,7111,3668,7172
ﹰ,YangGongXiang,522732210,2596,431,2242,1357,4282,2242,1470,2249,4491,2255,4497
ɽֵ´,HuaShanJieDaoBanShiChu,530102001,65229,9459,42781,19913,55855,29692,6940,28160,57852,38847,81628
ֵ´,HuGuoJieDaoBanShiChu,530102002,24671,4204,16368,12322,19938,15676,3310,15023,30699,15817,32185
۽ֵ´,DaGuanJieDaoBanShiChu,530102003,40619,8536,28813,20055,40321,27708,6263,25423,53131,26605,55418
ֵ´,LongXiangJieDaoBanShiChu,530102004,37401,6292,25395,18313,30369,23152,5135,21730,44882,23433,48828
ֵ´,FengNingJieDaoBanShiChu,530102005,73834,8873,46577,38526,50500,43092,9642,42697,85789,45772,92349
ֵ´,LianHuaJieDaoBanShiChu,530102006,113656,10058,67249,41271,79130,48971,12747,49179,98150,69212,136461
ƽֵ´,HongYunJieDaoBanShiChu,530102007,107962,6371,60912,39945,52735,47308,13101,47283,94591,66522,127434
ֵ̽´,HeiLinPuJieDaoBanShiChu,530102008,71099,5746,43816,27102,37109,32416,9681,33845,66261,42710,86526
ռֵ´,PuJiJieDaoBanShiChu,530102009,59044,4527,34424,28048,30250,31124,11033,33781,64905,40180,74604
ɳʽֵ´,ShaLangJieDaoBanShiChu,530102010,14513,1667,9557,5320,16591,9272,3952,8929,18201,10575,20132
ڽֵ´,ChangKouJieDaoBanShiChu,530102011,9355,1585,7018,4762,12901,6934,3257,6902,13836,7179,14197
Ҹ¼ҵ,KunMingGuoJiaGaoXinJiShuChanYeKaiFaQu,530102401,72154,4755,44185,26520,38041,32049,8850,32314,64363,41574,85759
ضֵ´,TuoDongJieDaoBanShiChu,530103001,28206,6777,20043,14027,27266,18274,4052,17232,35506,18992,39035
¥ֵ´,GuLouJieDaoBanShiChu,530103002,34806,5392,22740,17179,26323,21241,4622,20260,41501,22080,44820
ֵ´,DongHuaJieDaoBanShiChu,530103003,86390,9511,49325,38811,53842,44253,10621,44056,88309,57197,106522
˽ֵ´,LianMengJieDaoBanShiChu,530103004,95488,9503,59518,46220,58968,55930,13971,54474,110404,59444,118962
𳽽ֵ´,JinChenJieDaoBanShiChu,530103005,124886,9729,76227,65692,57640,72969,21044,74152,147121,79432,155659
ƽֵ´,QingYunJieDaoBanShiChu,530103006,109002,7048,62501,46547,49028,51643,17049,55107,106750,70598,133099
Ȫֵ´,LongQuanJieDaoBanShiChu,530103007,55712,2762,30177,18692,24313,22094,7199,23284,45378,35496,65673
İӽֵ´,CiBaJieDaoBanShiChu,530103008,51045,4600,29708,18563,26108,22196,7242,23726,45922,33179,62887
˫ֵ´,ShuangLongJieDaoBanShiChu,530103009,8578,722,5185,2861,6913,4341,2048,4291,8632,6163,11348
ɻֵ´,SongHuaJieDaoBanShiChu,530103010,7737,1185,5631,3542,10723,5568,2281,5458,11026,5572,11203
Դ,DianYuanZhen,530103401,23318,3462,16854,10143,32432,16703,6675,16329,33032,16601,33455
Ӫ,AZiYingZhen,530103402,18885,2597,13619,7680,26491,13345,5736,13147,26492,13599,27218
Ͻֵ´,GuanShangJieDaoBanShiChu,530111001,122326,7821,74350,67449,59738,70550,18892,70201,140751,74689,149039
̫ͽֵ´,TaiHeJieDaoBanShiChu,530111002,50197,9275,32739,24628,41274,31133,5837,30632,61765,32570,65309
⾮ֵ´,WuJingJieDaoBanShiChu,530111003,56922,8489,36623,28988,42490,35197,8005,34868,70065,36793,73416
ֵ´,JinMaJieDaoBanShiChu,530111004,98330,10521,60536,51318,60793,57337,16181,59678,117015,64496,125032
СŽֵ´,XiaoBanQiaoJieDaoBanShiChu,530111005,78796,3890,45350,40717,37908,42968,13902,46379,89347,51238,96588
ٶɽֵ´,GuanDuJieDaoBanShiChu,530111006,58938,3376,35112,24432,39299,32265,10461,32802,65067,37663,72775
ֵ´,YiLiuJieDaoBanShiChu,530111007,38608,3157,23736,16831,31797,21698,6828,21450,43148,24857,48593
׽ֵ´,LiuJiaJieDaoBanShiChu,530111008,45084,2779,26226,20004,25322,23513,7167,25046,48559,28804,55030
Žֵ´,DaBanQiaoJieDaoBanShiChu,530111009,55610,3983,30751,18215,41455,25073,10756,25926,50999,39598,70349
ֵ´,ALaJieDaoBanShiChu,530111010,46834,3425,24695,17256,25300,21094,8258,22248,43342,33822,58517
�ü�,KunMingJingJiJiShuKaiFaQu,530111402,32237,2725,19006,10141,22500,12277,3761,12633,24910,19717,38723
Էֵ´,XiYuanJieDaoBanShiChu,530112001,39970,5340,25788,21693,28077,25527,6248,25317,50844,25770,51558
ֵֽ´,MaJieJieDaoBanShiChu,530112002,66116,6072,38634,31272,34286,34924,9912,35701,70625,43466,82100
ֵ̽´,JinBiJieDaoBanShiChu,530112003,102824,14473,65702,47157,88148,62187,13173,60585,122772,64768,130470
ֵ´,YongChangJieDaoBanShiChu,530112004,41463,6714,26649,20639,37709,26008,5423,25937,51945,26951,53600
ǰֵ´,QianWeiJieDaoBanShiChu,530112005,47387,2995,28837,20688,22501,27266,8305,27416,54682,29850,58687
ֵ´,FuHaiJieDaoBanShiChu,530112006,101307,6287,58791,52872,40125,54928,14466,58177,113105,63269,122060
Ӫֵ´,ZongShuYingJieDaoBanShiChu,530112007,40069,6711,26499,18751,37878,22629,5534,22003,44632,25815,52314
ֵ̼´,BiJiJieDaoBanShiChu,530112008,27741,3195,16700,10384,21781,14302,4769,14292,28594,19005,35705
ڽֵ´,HaiKouJieDaoBanShiChu,530112009,59736,8104,36960,28342,55716,32037,10323,33052,65089,41203,78163
Žֵ´,TuanJieJieDaoBanShiChu,530112010,22809,2842,15377,8693,28490,14871,6086,14730,29601,16360,31737
عζȼ,KunMingDianChiGuoJiaLvYouDuJiaQu,530112403,48403,2979,28513,15291,23957,20370,6037,20050,40420,28906,57419
ͭ,TongDouZhen,530113101,89454,13370,63767,40391,110111,62983,25063,62936,125919,64120,127887
,TangDanZhen,530113102,27188,3438,16752,11265,33712,16280,7308,18206,34486,21182,37934
,YinMinZhen,530113103,9087,928,5758,3754,10761,5680,2608,6354,12034,6865,12623
,AWangZhen,530113104,20238,2872,14499,8434,29253,14468,7313,15831,30299,15924,30423
,WuLongZhen,530113105,10420,2095,8081,5199,15801,7974,3856,8105,16079,8290,16371
,HongTuDiZhen,530113106,9685,1857,7169,4962,14534,7099,3592,7804,14903,7965,15134
ϲ,TuoBuKaZhen,530113107,16427,2654,12234,7632,24518,12128,6712,13309,25437,13559,25793
,SheKuaiXiang,530113201,3817,586,2732,1700,5124,2690,1349,2904,5594,3020,5752
ǽֵ´,LongChengJieDaoBanShiChu,530121001,37997,2614,22797,16102,20340,20324,7205,21082,41406,25019,47816
ֵ´,LuoLongJieDaoBanShiChu,530121002,10372,782,5985,3436,7670,5068,1801,4967,10035,6970,12955
Ͻֵ´,DouNanJieDaoBanShiChu,530121003,24885,1722,15248,10493,16916,14419,4966,14657,29076,16325,31573
ֵ´,WuLongJieDaoBanShiChu,530121004,18852,1478,10662,7128,14566,9799,3214,9833,19632,12882,23544
Ӫֵ´,WuJiaYingJieDaoBanShiChu,530121005,54120,1168,27630,4707,25544,6646,2415,6548,13194,30073,57703
껨ֵ´,YuHuaJieDaoBanShiChu,530121006,19804,647,11270,3329,9868,4492,1828,4526,9018,11009,22279
ߵֵ´,QiDianJieDaoBanShiChu,530121007,17082,1359,9988,6783,17173,9432,3803,9776,19208,12256,22244
ֵ´,LuoYangJieDaoBanShiChu,530121008,30885,1521,15769,9604,14203,12848,5168,13588,26436,21805,37574
ֵ´,DaYuJieDaoBanShiChu,530121009,16125,1744,10285,7102,17134,10053,3379,9856,19909,10963,21248
ֵ̽´,MaJinPuJieDaoBanShiChu,530121010,25108,2746,16076,9513,26699,15193,6053,15153,30346,17831,33907
,KunYangZhen,530122101,84893,9830,55787,37578,88446,49796,16419,49724,99520,55355,111142
,JinChengZhen,530122102,44726,5380,30094,18915,50755,28805,11951,29288,58093,31963,62057
,ErJieZhen,530122103,11414,1527,7124,5456,12898,7015,2409,7223,14238,8226,15350
½,XinJieZhen,530122104,25048,3417,17155,12526,30861,16950,6045,16834,33784,17355,34510
,ShangSuanZhen,530122105,23627,3184,16105,11425,28681,15787,6476,16169,31956,17182,33287
,LiuJieZhen,530122106,7225,1392,5649,3801,10775,5607,2757,5584,11191,5725,11374
˫,ShuangHeYiZuXiang,530122201,5915,965,4132,2494,7697,4049,1658,4157,8206,4406,8538
Ϧ,XiYangYiZuXiang,530122202,5063,1040,3597,2643,6687,3536,1423,3519,7055,3929,7526
,YongDingZhen,530124101,56670,7195,38878,23363,68611,37652,15213,37415,75067,40200,79078
,LuoMianXiang,530124201,9541,1282,6689,3735,13034,6608,2760,6720,13328,6894,13583
,ChiJiuXiang,530124202,6110,987,4510,2606,8547,4452,1887,4344,8796,4474,8984
,DongCunXiang,530124203,8307,1283,6232,3540,11729,6124,2948,6151,12275,6306,12538
ׯ,KuanZhuangXiang,530124204,14525,2077,10404,5984,19608,10253,4500,10271,20524,10698,21102
ɢ,SanDanXiang,530124205,6988,1125,4988,2828,9645,4888,2156,5087,9975,5281,10269
Զ,KuangYuanZhen,530125101,119220,15035,81470,50547,132093,77373,30674,75364,152737,83459,164929
ų,BeiGuChengZhen,530125102,37064,5254,26434,14903,50738,26054,11286,26229,52283,27170,53604
,GouJieZhen,530125103,42835,5773,29832,17199,57731,29431,10981,29136,58567,29757,59589
,TangChiZhen,530125104,43531,6919,30242,18404,50429,29046,11155,28857,57903,31363,61605
ɽ,ZhuShanZhen,530125105,19747,2870,13271,7230,26939,13083,5114,14063,27146,14460,27731
,MaJieZhen,530125106,12948,1788,9238,4895,17886,9186,3761,9118,18304,9259,18497
Ӫ,GengJiaYingXiang,530125201,11416,1582,8124,4742,15897,8089,3632,8473,16562,8506,16630
,JiuXiangXiang,530125202,11455,1673,8217,4741,15903,8109,3686,8368,16477,8597,16814
¹,LuFuZhen,530126101,76191,8046,51119,32009,84752,47906,19903,48411,96317,53021,104140
ʯ,ShiLinZhen,530126102,29198,3123,19817,11540,34687,18806,8099,19046,37852,20603,40420
,BanQiaoZhen,530126104,19216,2715,13470,8787,25922,13378,5690,13659,27037,14151,27621
ֿ,XiJieKouZhen,530126105,12739,1576,8897,5644,16968,8847,4489,9701,18548,9907,18804
,ChangHuZhen,530126106,11253,1416,7689,4137,14858,7591,3084,7773,15364,8064,15753
ɽ,GuiShanZhen,530126107,18836,2049,11634,6427,22415,11262,5115,12081,23343,14366,26000
,DaKeXiang,530126201,9087,1492,6455,4313,12294,6345,2901,6579,12924,7025,13480
,SongYangZhen,530127101,83890,9113,54827,31422,95163,52586,21963,52082,104668,60139,114966
С,XiaoJieZhen,530127102,43966,5051,31358,16117,59131,30489,13016,29975,60464,30675,62033
,YangLinZhen,530127103,46904,5411,30248,15215,46618,24224,10057,24018,48242,32124,62372
ţ,NiuLanJiangZhen,530127104,32900,4614,24049,13904,44855,23884,10210,23253,47137,23675,47724
ɽ,PingShanZhen,530128101,56847,5365,37809,20290,61618,34553,14193,34684,69237,38596,76405
Ӫ,SaYingPanZhen,530128102,26356,4027,18983,11669,36613,18722,7660,18757,37479,19060,38043
ת,ZhuanLongZhen,530128103,19478,3130,14006,8081,27357,13807,5864,14144,27951,14466,28472
ïɽ,MaoShanZhen,530128104,21023,3035,15412,9169,29100,15356,6456,14979,30335,15102,30514
Ž,TuanJieZhen,530128105,15457,2143,10978,6492,21407,10968,4456,11062,22030,11078,22056
,ZhongPingZhen,530128106,11584,1837,8139,4985,15866,8116,3348,8497,16613,8630,16769
ƽ,JiaoPingDuZhen,530128107,13122,1878,9211,5476,18269,9180,3894,9569,18749,9683,18894
ڶ,WuDongDeZhen,530128108,8822,1440,6198,4119,12344,6158,2743,6695,12853,6807,13005
仪,CuiHuaZhen,530128109,22967,3027,15966,9325,31007,15914,6603,16502,32416,16631,32597
,JiuLongZhen,530128110,23966,3912,17684,10320,34439,17603,7566,17595,35198,17760,35444
,YunLongXiang,530128204,8311,1316,6130,3993,11849,6102,2535,5979,12081,6032,12162
,TangLangXiang,530128207,9501,1068,6696,3933,13122,6688,3073,6915,13603,6946,13642
¹,MaLuTangXiang,530128208,9752,1845,6641,4630,13921,6558,2732,7477,14035,7688,14329
,ZeHeiXiang,530128211,15092,2379,10551,6710,21968,10538,4960,11814,22352,11880,22431
,WuMengXiang,530128212,8642,1532,6449,4205,12614,6441,2817,6523,12964,6542,12991
ѩɽ,XueShanXiang,530128213,5493,938,4146,2676,8233,4122,2219,4452,8574,4504,8650
ʵ,RenDeZhen,530129101,95154,9718,64591,35322,113179,59330,26524,60067,119397,66805,131396
,YangJieZhen,530129103,25228,3777,18930,10270,36224,18832,8781,18554,37386,18856,37786
¶,KeDuZhen,530129104,15600,2991,11928,7626,22997,11911,5463,12025,23936,12126,24054
ȵ,TangDianZhen,530129105,25511,3808,18402,10143,35247,17879,7587,18032,35911,18504,36906
ɽ,GongShanZhen,530129106,22834,3087,16051,9845,31884,15977,7540,17300,33277,17410,33461
ӿ,HeKouZhen,530129107,21149,2767,14649,8527,28847,14339,7045,15092,29431,16312,30961
,QiXingZhen,530129108,11068,1561,8193,4537,15939,8183,3833,8257,16440,8269,16462
ȷ,XianFengZhen,530129109,13596,1723,9580,5439,18938,9508,4985,10175,19683,10724,20304
,JiJieZhen,530129110,18375,2608,13086,7698,25746,13008,5725,13259,26267,13622,26708
,FengHeZhen,530129111,20971,3111,15709,8955,30929,15699,7614,15929,31628,15987,31696
,LiuShaoXiang,530129205,12051,1177,8320,4406,16745,8264,4180,8868,17132,9088,17408
,LianHeXiang,530129208,7513,1083,5250,3255,10893,5249,2521,5847,11096,5867,11117
Դ,JinYuanXiang,530129209,13821,2257,10651,7087,21384,10649,5658,11081,21730,11085,21736
ɳ,DianShaXiang,530129210,11536,1333,8236,4949,16354,8236,4204,8834,17070,8837,17073
Ȼֵ´,LianRanJieDaoBanShiChu,530181001,90053,6063,51609,38560,50223,47902,18694,49750,97652,63201,114810
𷽽ֵ´,JinFangJieDaoBanShiChu,530181002,64710,8726,40316,32156,60971,38577,12166,40390,78967,45286,85602
˽,BaJieZhen,530181101,21201,4145,15602,11062,26571,15394,5680,14855,30249,15424,31026
Ȫ,WenQuanZhen,530181102,8188,1113,5452,3647,9381,5200,1690,5077,10277,5539,10991
,QingLongZhen,530181103,8532,729,4604,3819,6146,4351,1908,5091,9442,6565,11169
»à,LuBiaoZhen,530181104,8785,1539,6262,4271,9625,6006,2722,5943,11949,6784,13046
,CaoPuZhen,530181105,17942,1323,9656,6844,11376,9012,4630,9920,18932,14239,23895
̫ƽ,TaiPingZhen,530181106,19331,1684,11008,7770,12299,9462,3808,9924,19386,13815,24823
ؽ,XianJieZhen,530181107,18268,2757,12309,8723,20531,11765,4954,11820,23585,13670,25979
ֵ´,NanNingJieDaoBanShiChu,530302001,67626,5666,44795,32504,39870,40697,17683,40484,81181,46180,90975
ֵ´,JianNingJieDaoBanShiChu,530302002,61532,6622,38415,27385,42348,35473,12771,35919,71392,42510,80925
ʯֵ´,BaiShiJiangJieDaoBanShiChu,530302003,67664,7339,45246,33363,52962,41789,16949,41823,83612,46706,91952
ֵ´,LiaoKuoJieDaoBanShiChu,530302004,76930,7832,52660,39106,58043,48050,17877,46417,94467,49979,102639
ǽֵ´,XiChengJieDaoBanShiChu,530302005,33741,2950,23330,15426,40139,20124,10486,20737,40861,23847,47177
,SanBaoZhen,530302101,41870,4520,29006,15781,55521,28738,12911,29599,58337,30295,59301
Խ,YueZhouZhen,530302102,50156,5127,33929,20995,64097,33344,16168,36315,69659,37522,71451
ɽ,DongShanZhen,530302103,56253,5155,37060,22870,67164,36758,20081,41399,78157,44429,81489
,ZhuJieXiang,530302201,31081,4186,22677,12308,43764,22610,10302,22779,45389,22892,45569
ؽ,YanJiangXiang,530302202,27821,3304,19987,11103,37307,19912,9084,20047,39959,20222,40209
Ӫ,CiYingXiang,530302203,19479,2995,13861,8941,27850,13763,6586,14922,28685,15199,29060
ͨȪ,TongQuanZhen,530321101,40221,3050,26841,16164,41900,25152,11997,26093,51245,28427,55268
,JiuXianZhen,530321102,17773,2252,12935,7526,24664,12876,6194,13084,25960,13284,26219
,MaGuoHeZhen,530321103,8719,1030,6568,3691,12382,6504,3218,6362,12866,6399,12967
ׯ,WangJiaZhuangZhen,530321104,19233,2170,14233,8137,27585,14173,7259,14237,28410,14429,28662
,NaZhangZhen,530321105,8659,1120,6278,3468,12182,6202,3089,6454,12656,6590,12868
,MaMingXiang,530321201,8181,1155,5870,3503,11458,5791,2833,6086,11877,6299,12169
ׯ,DaZhuangXiang,530321202,8159,1060,5808,3419,11617,5785,2824,6160,11945,6235,12043
,YueWangXiang,530321203,16476,1989,11848,7044,23747,11723,6328,12547,24270,12945,24793
,ZhongShuZhen,530322101,92047,7255,60921,34098,92703,55462,26219,58388,113850,64600,125521
,BanQiaoZhen,530322102,60618,6434,40979,24509,85355,40245,19923,44987,85232,45996,86975
,SanChaHeZhen,530322103,74501,9169,51439,29586,104523,50861,23953,55574,106435,56184,107623
,MaJieZhen,530322104,68894,7811,48351,27507,98239,46935,23723,50591,97526,52077,100428
ٿ,ZhaoKuaZhen,530322105,21406,2188,15001,8443,29623,14730,7753,15835,30565,16346,31347
Ī,DaMoGuZhen,530322106,30701,3730,21682,12602,44886,21328,11376,23859,45187,24125,45807
,FangHuaZhen,530322107,25301,2660,16964,11005,31825,16647,7522,18051,34698,18519,35483
Сٻ,XiaoBaiHuZhen,530322108,27229,2728,18411,10530,37529,18001,9182,20019,38020,20728,39139
ˮ,HuoShuiXiang,530322201,14302,1511,10260,6170,20858,10220,6054,11475,21695,11607,21867
,LongHaiXiang,530322202,16937,1681,11681,6950,24544,11451,6396,12956,24407,13333,25014
½ȹ,LuLiangHuaQiaoGuanLiQuZhen,530322501,2242,351,1575,1110,2648,1544,600,1576,3120,1618,3193
,DanFengZhen,530323101,82666,7334,56205,29326,98872,52636,28696,56790,109426,62491,118696
۱,XiongBiZhen,530323102,35996,3237,25656,12971,50661,25490,15079,28043,53533,28656,54312
ɽ,KuiShanZhen,530323103,24470,2984,17320,9443,35426,17314,9178,19278,36592,19312,36632
,CaiYunZhen,530323104,26381,2771,19018,9786,37482,18582,10039,19921,38503,20173,39191
,ZhuJiZhen,530323105,32107,3876,23691,11697,47900,23637,13014,25220,48857,25306,48997
,LongQingXiang,530323202,24264,2541,17487,9165,35976,17486,10360,19667,37153,19678,37165
,WuLongXiang,530323203,20097,2298,14031,7647,29005,13931,7854,15949,29880,16218,30249
,GaoLiangXiang,530323204,18148,1617,12974,6595,24747,12948,7354,14114,27062,14145,27119
,LuoXiongZhen,530324101,97268,8928,65909,36248,103971,61723,30235,65533,127256,70522,136431
,BanQiaoZhen,530324102,28860,3855,20856,11896,41148,20819,11110,22893,43712,22969,43825
,MaJieZhen,530324103,36397,4072,27059,15055,54919,27006,16425,29667,56673,29835,56894
,FuLeZhen,530324104,25811,3453,20441,10988,40229,20393,12737,21454,41847,21560,42001
,JiuLongZhen,530324105,50921,5854,35267,19097,72653,35112,18840,40069,75181,40348,75615
,AGangZhen,530324106,46118,4398,32838,17462,67563,32456,19772,36346,68802,37450,70288
ˮ,DaShuiJingXiang,530324201,13774,2224,10167,5933,20798,10048,5608,11271,21319,11439,21606
³,LuBuGeXiang,530324202,11552,1145,8435,4290,16790,8396,4912,9070,17466,9174,17609
ݻ,JiuWuJiXiang,530324203,7258,959,4800,2757,10152,4799,2313,5730,10529,5730,10530
ɽ,ZhongShanXiang,530324204,18452,2354,13264,7177,26655,13224,7026,14499,27723,14568,27832
,ChangDiXiang,530324205,8634,1169,6223,3928,12312,6175,3361,6840,13015,6941,13164
ϳ,LaoChangXiang,530324206,21472,2605,15933,8766,32544,15865,9808,17733,33598,17952,33885
а,ZhongAnZhen,530325101,89581,6921,59142,35175,105009,55248,29199,58116,113364,66559,125701
Ӫ,YingShangZhen,530325102,46430,3877,35812,18520,69374,34892,23234,36410,71302,37729,73541
,HuangNiHeZhen,530325103,35722,4227,26801,14353,50572,25613,16602,27347,52960,29750,56551
԰,ZhuYuanZhen,530325104,28355,2740,21886,12313,43014,21710,14488,23041,44751,23697,45583
,HouSuoZhen,530325105,45179,4092,32400,18806,61409,31595,19051,34162,65757,35922,68322
,DaHeZhen,530325106,50219,4498,36676,21328,74280,36672,22481,40510,77182,40522,77198
ī,MoHongZhen,530325107,39896,3698,26575,16164,54559,26322,15246,30520,56842,32265,58840
,FuCunZhen,530325108,55656,5620,42714,21447,80940,41666,26954,44179,85845,45516,88230
ʮɽ,ShiBaLianShanZhen,530325109,46151,4471,31768,16323,63169,31614,17900,34395,66009,36754,68522
ϳ,LaoChangZhen,530325110,31351,3010,22007,11585,39130,21738,14172,23869,45607,26526,48533
Ÿ,GuGanXiang,530325201,7025,1118,5599,3648,10823,5557,3476,5912,11469,6020,11619
,JinZhongZhen,530326101,110665,11829,75386,41383,133228,70867,31834,72893,143760,78942,154328
ȹ,NaGuZhen,530326102,41840,5476,29411,16280,59475,29392,13808,31679,61071,31713,61124
Ƴ,YiCheZhen,530326103,54086,6268,37903,21398,74882,37808,21430,43588,81396,43881,81784
ҵ,LeYeZhen,530326104,48021,5662,31991,18238,68353,31947,16526,38122,70069,38218,70209
ɽ,KuangShanZhen,530326105,15786,1936,10520,6211,21836,10482,5837,12825,23307,13039,23559
ߺ,ZheHaiZhen,530326106,63253,7566,44317,25721,87724,44153,21289,47496,91649,47791,92108
,DaJingZhen,530326107,26350,3492,17596,10542,37206,17526,8401,20484,38010,20647,38243
,DaiBuZhen,530326108,26739,3523,18602,9810,39099,18561,10517,22022,40583,22177,40779
,DaHaiXiang,530326201,16289,1902,10714,6369,23412,10676,5915,13266,23942,13392,24106
ϳ,LaoChangXiang,530326202,12963,1764,8992,5246,19159,8981,5198,10897,19878,10933,19925
,WuXingXiang,530326203,20158,2357,13558,7919,28860,13381,6983,15530,28911,15940,29498
,DaQiaoXiang,530326204,19624,2203,13855,8295,29826,13806,8989,16835,30641,16961,30816
ֽ,ZhiChangXiang,530326205,11155,1357,7413,4670,15823,7406,4217,9302,16708,9316,16729
·,MaLuXiang,530326206,16986,2102,11958,7072,25102,11942,7040,14098,26040,14170,26128
,HuoHongXiang,530326207,20446,2826,14971,8394,30878,14921,8951,17143,32064,17252,32223
½,XinJieXiang,530326208,16745,2468,12754,6084,26842,12681,7735,14093,26774,14194,26948
µ,YuLuXiang,530326209,22015,3236,15690,8018,33798,15622,9227,18647,34269,18788,34478
³,LuNaXiang,530326210,11533,1900,7960,4497,17719,7923,4632,10026,17949,10105,18065
ϴ,ShangCunXiang,530326211,22510,2847,15352,8193,33306,15334,8364,18320,33654,18369,33721
ݳ,JiaCheXiang,530326212,15021,1952,10239,5386,21644,10187,5400,11989,22176,12134,22373
,TianBaXiang,530326213,21115,2735,14377,7603,30444,14336,7298,16661,30997,16771,31148
ƽ,XiPingZhen,530328101,92926,8059,57924,32763,97225,54331,23685,54437,108768,66746,124670
ˮ,BaiShuiZhen,530328102,27392,3060,18404,9324,34524,17773,8288,18753,36526,20336,38740
̽,PanJiangZhen,530328103,55837,5563,37198,20229,69570,35866,15083,36237,72103,39285,76483
׷,YanFangXiang,530328201,29447,3496,19874,10479,40480,19663,8994,21509,41172,22063,41937
,BoLeXiang,530328202,25617,2912,17271,9360,35807,17184,7739,18802,35986,18997,36268
,DaPoXiang,530328203,32490,3743,22645,10660,45771,22118,10504,23117,45235,24092,46737
,LingJiaoXiang,530328204,34295,3837,23899,11561,47363,23262,10562,24214,47476,24795,48694
,DeZeXiang,530328205,12318,1549,8051,4632,16358,7988,3662,8990,16978,9478,17529
ˮֵ´,WanShuiJieDaoBanShiChu,530381001,60822,4268,39566,21739,50891,33867,15016,33627,67494,40540,80106
ֵ´,XiNingJieDaoBanShiChu,530381002,42209,3162,27970,14892,40271,25376,12081,26813,52189,29482,57452
˫ֵ´,ShuangLongJieDaoBanShiChu,530381003,50627,3124,34105,20450,38113,32144,16102,32819,64963,35748,69853
Žֵ´,HongQiaoJieDaoBanShiChu,530381004,11347,1169,7916,4615,15509,7827,3483,7908,15735,8083,15999
,LaiBinZhen,530381101,48339,4970,32889,21211,65698,32243,15746,34944,67187,36166,69055
,GeYiZhen,530381102,32507,3849,22433,14847,44770,21371,11768,24360,45731,25691,48124
,TianBaZhen,530381103,43341,5473,29926,19312,60116,29910,14325,33162,63072,33213,63139
,YangChangZhen,530381104,37246,4430,25135,17173,50012,24661,11912,27351,52012,28453,53588
,BanQiaoZhen,530381105,45544,5230,31003,18604,58213,29465,13173,30972,60437,32944,63947
,TangTangZhen,530381106,52202,5160,37279,21023,76987,37223,22279,42255,79478,42362,79641
ˮ,LuoShuiZhen,530381107,25323,3460,17738,10388,35732,17684,8127,18948,36632,19172,36910
,WuDeZhen,530381108,27638,3969,18453,11852,39779,18248,8548,21383,39631,21702,40155
,HaiDaiZhen,530381109,37261,4691,25482,16458,51422,24776,11909,27520,52296,28379,53861
,LongChangZhen,530381110,35149,3759,23617,14980,49774,23547,12088,27273,50820,27379,50996
̶,LongTanZhen,530381111,35241,4155,23586,15117,50372,23556,12325,27965,51521,28135,51721
ˮ,ReShuiZhen,530381112,53088,6469,35767,23180,74861,35765,16578,40364,76129,40368,76135
ɽ,BaoShanZhen,530381113,38328,4237,25568,16423,53144,25406,12823,29142,54548,29820,55388
ɽ,DongShanZhen,530381114,32337,4298,22395,14320,46240,22389,11352,25540,47929,25592,47987
,PuLiXiang,530381201,17561,3125,13763,8452,28087,13730,8406,15274,29004,15329,29092
,XiZeXiang,530381202,24698,3524,16719,9845,35115,16704,7302,18778,35482,18805,35524
»,DeLuXiang,530381203,22425,2715,15231,9228,31887,15221,7688,17558,32779,17597,32828
,YangLiuXiang,530381204,24497,3031,17398,10940,37248,17371,10720,20817,38188,20850,38248
˫,ShuangHeXiang,530381205,17166,2090,12137,7715,26005,12133,7786,14767,26900,14905,27042
ַ,LeFengXiang,530381206,31204,3343,21409,12896,45498,21320,12874,25356,46676,26012,47421
,WenXingXiang,530381207,31666,3693,22867,13326,47993,22825,13590,25951,48776,26082,48949
,ADouXiang,530381208,19674,2620,13330,8365,29526,13296,7436,16324,29620,16400,29730
·ֵ´,YuXingLuJieDaoBanShiChu,530402001,58401,6817,36879,27597,38385,34422,10401,32616,67038,38740,75619
·ֵ´,FengHuangLuJieDaoBanShiChu,530402002,60867,5237,39335,23891,36244,30918,10051,30306,61224,36820,76155
·ֵ´,YuDaiLuJieDaoBanShiChu,530402003,39170,4029,26087,15832,26441,24468,9537,24109,48577,26649,52736
,BeiChengZhen,530402101,42164,6022,29702,15810,52983,28466,11254,28221,56687,29738,59440
,ChunHeZhen,530402102,42896,5571,29026,14176,50907,27191,11186,27008,54199,30627,59653
,LiQiZhen,530402103,26304,3441,18752,9828,29195,17448,7038,16736,34184,18031,36783
Ӫ,DaYingJieZhen,530402104,34629,4666,24243,13215,42100,23653,10044,23738,47391,25096,49339
к,YanHeZhen,530402105,34298,4752,23287,12622,40071,20862,8909,20937,41799,24672,47959
߲,GaoCangZhen,530402106,15339,2053,10738,5700,18867,10471,4578,10486,20957,11232,21970
Сʯ,XiaoShiQiaoXiang,530402201,3701,574,2743,1896,5410,2698,1302,2771,5469,2834,5577
,LuoHeXiang,530402202,7075,917,4698,2739,8378,4573,1906,4632,9205,5200,9898
,DaJieZhen,530421101,61749,7997,42784,25462,70732,40429,16537,40044,80473,43499,86283
,JiangChengZhen,530421102,50034,7148,35035,19859,67890,34288,13630,34516,68804,35777,70812
ǰ,QianWeiZhen,530421103,33702,4887,23933,14252,46170,23538,9577,23741,47279,24233,48166
Ϫ,JiuXiZhen,530421104,18752,2615,13259,7709,25640,13111,5393,13185,26296,13501,26760
·,LuJuZhen,530421105,20280,2599,13965,7693,27723,13567,5977,13709,27276,14891,28856
,AnHuaYiZuXiang,530421201,6413,828,4446,2797,8865,4437,1919,4668,9105,4714,9160
۹,XiongGuanXiang,530421202,7470,905,5254,2976,10314,5176,2477,5396,10572,5598,10852
´,FengLuZhen,530422101,18794,1909,12788,8141,18587,12359,4704,12187,24546,12619,25407
,LongJieZhen,530422102,40582,4969,28314,16214,52240,26290,11432,26220,52510,28669,56983
,YangZongZhen,530422103,16886,2336,11944,7493,23653,11690,5207,11890,23580,12485,24429
,YouSuoZhen,530422104,28524,3282,19735,10715,36089,18695,7881,18608,37303,19952,39687
,HaiKouZhen,530422105,7767,973,5357,3077,10455,5180,2452,5463,10643,5835,11192
Ŵ,JiuCunZhen,530422106,8109,1080,5626,3140,10933,5468,2479,5670,11138,6042,11668
ɽ,XiuShanZhen,530423101,59386,7045,39748,23904,60722,37866,13868,36961,74827,40551,80299
,YangGuangZhen,530423102,35044,4792,24021,13672,45603,23788,8676,24097,47885,24491,48512
Ž,JiuJieZhen,530423103,24944,3630,17812,9583,32098,17631,7248,17545,35176,18010,35822
,HeXiZhen,530423104,35388,5183,25196,15013,45902,24436,9852,24441,48877,25227,50423
Ľ,SiJieZhen,530423105,31816,4319,22216,12383,40830,21822,8662,21810,43632,22581,44797
ɹ,NaGuZhen,530423106,11084,633,7544,4200,8102,7245,4431,7623,14868,8604,16148
ɽ,LiShanXiang,530423201,6236,841,4093,2017,7391,3891,1657,4020,7911,4641,8734
ߴ,GaoDaXiang,530423202,7375,1040,5215,2868,9810,5067,2132,5067,10134,5332,10547
,XingMengXiang,530423203,3944,598,2763,1630,5254,2691,976,2665,5356,2755,5518
,NingZhouZhen,530424101,59988,6925,40617,25628,76260,37889,16300,39154,77043,42596,83213
Ϫ,PanXiZhen,530424102,39095,4534,26317,15539,50337,25941,10048,26765,52706,27360,53677
Ϫ,HuaXiZhen,530424103,9965,1076,6568,4009,12481,6501,2744,6940,13441,7217,13785
,QingLongZhen,530424104,38652,4988,26372,14989,52981,25684,11419,27326,53010,28687,55059
ͨ,TongHongDianXiang,530424201,5991,896,4198,2662,8460,4159,2029,4656,8815,4718,8916
Ȫ,LongQuanZhen,530425101,55762,5550,34543,19304,56075,30235,11440,29921,60156,38209,72752
,LiuJieZhen,530425102,18597,2195,11990,6461,22572,11516,4660,11672,23188,13462,25452
֭,LvZhiZhen,530425103,11933,1826,7913,5776,14819,7869,2651,8363,16232,8497,16410
ֱ,PuBeiXiang,530425201,11918,1824,7839,4499,15829,7743,2826,8189,15932,8729,16568
ʮ,ShiJieXiang,530425202,8412,1315,5642,3114,11326,5508,1924,5680,11188,6009,11651
ͭ,TongChangXiang,530425203,15422,2237,10412,5653,21313,10306,3950,10905,21211,11197,21609
С,XiaoJieXiang,530425204,8976,1235,6016,3751,11691,5973,2457,6472,12445,6652,12668
˫,ShuangJiangZhen,530426101,41801,4594,27926,15846,42924,25160,10137,24876,50036,28606,56532
С,XiaoJieZhen,530426102,19034,2458,13205,6796,23426,12807,5453,12792,25599,13740,26945
,DianZhongZhen,530426103,12711,2113,8885,5208,16879,8694,3534,8411,17105,9473,18358
,HuaNianZhen,530426104,8531,1025,5474,3118,9640,5319,1982,5446,10765,6064,11538
,TaDianZhen,530426105,10884,1264,7148,3537,13360,6868,2844,6918,13786,7844,14992
,ChaHeXiang,530426201,7824,997,4767,2596,9086,4569,1785,4694,9263,5839,10606
̶,DaLongTanXiang,530426202,9552,1295,6282,3482,12194,6217,2301,6422,12639,6866,13148
,FuLiangPengXiang,530426203,7454,1059,5217,2682,9853,5096,2199,5175,10271,5495,10712
ɽ,GuiShanZhen,530427101,38268,4478,25736,15067,36488,23799,9448,23257,47056,26458,52194
,YangWuZhen,530427102,18325,1750,11381,6165,20185,10669,4686,11168,21837,13380,24761
Įɳ,MoShaZhen,530427103,26563,3027,17499,9827,30951,17029,6216,17714,34743,18307,35806
,JiaSaZhen,530427104,34806,2317,19391,12182,28796,18371,7571,19950,38321,25303,44694
ˮ,ShuiTangZhen,530427105,14754,1594,10415,5384,20558,9736,5180,10294,20030,11113,21528
,YaoJieZhen,530427106,11758,1124,7247,4127,12282,7027,2785,7541,14568,8420,15667
ƽ,PingDianXiang,530427201,12657,1379,8072,4504,15665,7931,3385,8512,16443,9349,17421
»,XinHuaXiang,530427202,15891,2010,9946,5522,19311,9616,3907,10146,19762,11862,21808
,JianXingXiang,530427203,8955,1242,6183,3439,12392,5872,3037,6528,12400,7051,13234
ϳ,LaoChangXiang,530427204,10716,1416,7556,4077,14729,7145,3356,7455,14600,7932,15488
߸o,ZheNengXiang,530427205,8720,997,5829,3145,11135,5585,2190,5777,11362,6078,11907
ƽ,PingZhangXiang,530427206,7407,1113,5021,2928,10549,4736,2316,5406,10142,5815,10836
墽,LiJiangZhen,530428101,55269,4284,34878,19781,46431,32415,13300,32472,64887,37975,72853
Զ,YinYuanZhen,530428102,19631,2139,13309,7541,26677,13249,6083,14227,27476,14544,27853
,QingLongChangZhen,530428103,18210,1873,12116,6585,20306,11821,4883,11910,23731,12850,24966
,DongEZhen,530428104,12152,1476,8466,4657,15239,8362,3293,8325,16687,8455,16921
,YangChaJieXiang,530428201,8053,1011,5322,2857,10854,5299,2654,6335,11634,6396,11718
,YangJieXiang,530428202,11616,1418,8210,3957,16050,8157,3854,8532,16689,8678,16888
ŵ,NaNuoXiang,530428203,10076,1242,7141,3491,13825,7070,3777,7806,14876,7954,15095
,WaDieXiang,530428204,6882,1246,4870,2515,9631,4720,1917,4848,9568,5175,10045
,MiLiXiang,530428205,9714,1287,6503,3313,13205,6421,3046,7344,13765,7544,14047
̶,LongTanXiang,530428206,4981,632,3276,1789,6621,3222,1400,3582,6804,3737,7013
ǽֵ´,LanChengJieDaoBanShiChu,530502001,72224,6173,43782,23811,55048,36303,12444,35094,71397,47059,90841
ֵ´,YongChangJieDaoBanShiChu,530502002,79870,8018,54321,27806,79481,46331,16249,44318,90649,49816,104137
,BanQiaoZhen,530502101,68267,9243,49255,22744,94215,47779,20002,46579,94358,48257,97512
ͼ,HeTuZhen,530502102,32923,4433,24058,11860,46069,23857,10125,23178,47035,23423,47481
ׯ,HanZhuangZhen,530502103,50347,6681,35949,17635,71213,35681,15647,36235,71916,36726,72675
,PuPiaoZhen,530502104,37253,5266,25825,12778,51622,25592,10157,26496,52088,26851,52676
Ҥ,WaYaoZhen,530502105,26239,3144,18136,9140,35497,17955,7771,18297,36252,19018,37154
º,LuJiangZhen,530502106,53874,6389,36296,18788,70701,35707,13117,36119,71826,37084,73380
,JinJiXiang,530502201,16529,2805,12605,6351,23886,12389,5375,11860,24249,12104,24709
,XinJieXiang,530502202,45934,5816,33169,15653,63880,32007,14996,32676,64683,33577,66746
,XiYiXiang,530502203,42102,5826,30016,14287,59707,29458,13354,30443,59901,31266,61282
,BingMaXiang,530502204,19457,2686,13988,6327,27301,13752,5884,13696,27448,14039,28027
߶,WaDuXiang,530502205,16751,2343,11759,5366,23333,11463,4919,11739,23202,12254,24013
ˮկ,ShuiZhaiXiang,530502206,10204,1512,7005,3203,13659,6925,2737,7090,14015,7448,14453
,WaMaYiZuBaiZuXiang,530502207,17593,2230,11878,5733,24155,11710,4782,12419,24129,12727,24605
߷,WaFangYiZuMiaoZuXiang,530502208,22922,3012,15921,7582,32120,15798,6573,16369,32167,16586,32507
,YangLiuBaiZuYiZuXiang,530502209,26551,3890,18572,8921,37249,18387,8263,19652,38039,20132,38704
â,MangKuanYiZuDaiZuXiang,530502210,32733,2879,22200,10964,40048,21716,9104,21809,43525,22516,44716
,DianYangZhen,530521101,32491,4331,23138,12670,39738,22400,8596,21383,43783,22280,45418
,YouWangZhen,530521102,22896,4093,17181,9536,31841,16811,6989,16484,33295,16797,33978
Ҧ,YaoGuanZhen,530521103,24421,3069,17042,8642,32981,16818,7606,17633,34451,18054,35096
ʺ,RenHeZhen,530521104,32633,5527,23961,11927,45696,23593,9702,23466,47059,23901,47862
̫ƽ,TaiPingZhen,530521105,18520,2942,13196,7641,26515,13191,5885,14122,27313,14151,27347
,WanXingXiang,530521201,9532,1223,6625,3428,13337,6622,3081,7189,13811,7211,13836
岼,BaiLangYiZuBuLangZuXiang,530521202,4549,539,3204,1728,6373,3191,1490,3356,6547,3374,6578
Ʒ,JiuFangXiang,530521203,16812,2068,11591,5770,23377,11459,5366,12347,23806,12655,24246
ɳ,JiuChengXiang,530521204,10651,1186,7347,4089,13544,7283,3194,7345,14628,7684,15031
ľԪ,MuLaoYuanBuLangZuYiZuXiang,530521205,3733,507,2563,1362,5194,2553,1143,2781,5334,2820,5383
,LaoMaiXiang,530521206,13714,1968,9662,4988,19459,9650,4458,10459,20109,10478,20140
Ԫ,HeYuanXiang,530521207,9670,1480,6985,3716,13976,6979,3312,7422,14401,7477,14462
ˮ,ShuiChangXiang,530521208,10929,1550,7757,4414,14569,7662,3367,7799,15461,8089,15846
Խ,TengYueZhen,530522101,93470,10658,61974,31801,106903,58279,23005,57779,116058,65159,127133
̶,GuDongZhen,530522102,31616,3351,21531,10063,43531,20939,10561,22948,43887,23997,45528
̲,DianTanZhen,530522103,20125,1746,13237,6803,25943,12800,6741,13830,26630,15375,28612
,HouQiaoZhen,530522104,19019,1669,13321,6209,25950,12995,7277,13857,26852,14644,27965
˳,HeShunZhen,530522105,4789,753,3251,1649,5905,3067,1018,2974,6041,3309,6560
ͷ,JieTouXiang,530522201,46075,4670,31681,14378,63987,31105,15098,32622,63727,34162,65843
ʯ,QuShiXiang,530522202,29107,3013,20124,9647,41428,19934,10260,21822,41756,22256,42380
,MingGuangXiang,530522203,27837,2508,18678,8858,38079,18355,9876,20092,38447,21543,40221
վ,MaZhanXiang,530522204,18608,2234,12792,6331,26663,12625,6531,14301,26926,14581,27373
,BeiHaiXiang,530522205,15271,2000,11019,5288,22064,10908,5397,11471,22379,11649,22668
к,ZhongHeXiang,530522206,25850,3131,18025,8607,36640,17762,8701,19157,36919,19657,37682
ˮ,QingShuiXiang,530522207,10061,1391,7289,3674,14470,7185,3534,7533,14718,7697,14986
â,MangBangXiang,530522208,26397,3656,18710,9622,38148,18491,9220,20143,38634,20563,39273
,WuHeXiang,530522209,22525,2915,15478,7856,31921,15331,7418,16955,32286,17380,32858
»,XinHuaXiang,530522210,10952,1414,7760,3994,15786,7642,3970,8338,15980,8576,16336
Ѵ,PuChuanXiang,530522211,18437,2138,12982,6505,26313,12774,6474,13658,26432,14067,27049
,TuanTianXiang,530522212,11823,1442,8508,4246,16924,8438,4219,8761,17199,8976,17484
ɻ,HeHuaDaiZuWaZuXiang,530522213,17115,2167,12171,6240,24098,12085,5532,12474,24559,12643,24814
ɽ,LongShanZhen,530523101,39298,3987,25356,14115,41972,23729,10855,25281,49010,28784,54140
,ZhenAnZhen,530523102,27398,3677,19615,9700,37020,19002,9087,19602,38604,20547,40162
Ŵ,MengNuoZhen,530523103,13420,1017,8856,4784,15909,8614,4190,9193,17807,9771,18627
,LongJiangXiang,530523201,19041,2622,13393,7043,26555,13146,6453,14095,27241,14723,28116
,LaMengXiang,530523202,13849,1860,9857,4908,19252,9767,4492,10218,19985,10344,20201
կ,BiZhaiXiang,530523203,13495,2019,9438,4868,18780,9324,4775,10593,19917,10851,20289
,LongXinXiang,530523204,20129,2553,13755,7052,27737,13521,7082,15670,29191,16009,29764
,XiangDaXiang,530523205,23061,3107,15509,8149,31166,15218,7661,17835,33053,18320,33829
ƽ,PingDaXiang,530523206,16682,1797,11263,6193,22173,11236,5504,12674,23910,12720,23983
ľ,MuChengYiZuLiSuZuXiang,530523207,5705,671,3751,2088,7515,3726,1832,4400,8126,4457,8208
԰,TianYuanZhen,530524101,46886,6147,32068,16479,55138,29373,11232,28872,58245,32197,64265
ˮ,MangShuiZhen,530524102,20024,3115,13592,7158,27878,13390,5499,14547,27937,15046,28638
½,KeJieZhen,530524103,21336,2704,14775,8058,28187,14288,6067,14672,28960,15332,30107
˹,KaSiZhen,530524104,27779,3097,18767,9395,37241,18549,7540,19137,37686,19649,38416
ͳ,MengTongZhen,530524105,18533,2018,12316,5968,24851,12154,4968,12917,25071,13203,25519
Ȫ,WenQuanXiang,530524201,16945,2430,11937,6129,23914,11833,5151,12283,24116,12589,24526
,DaTianBaXiang,530524202,14325,2216,9921,5337,20172,9849,4185,10557,20406,10805,20726
,JiFeiXiang,530524203,12938,1725,8949,4625,17931,8771,3793,9201,17972,9507,18456
̶,WengDuXiang,530524204,9827,1408,6791,3526,13809,6685,2828,7094,13779,7272,14063
,WanDianDaiZuXiang,530524205,11551,1020,7328,3938,13501,7165,2888,7340,14505,8131,15459
,GengJiaXiang,530524206,18197,1929,11922,6116,24144,11841,4904,12941,24782,13108,25030
,ZhuJieYiZuXiang,530524207,10911,1139,7458,4077,14917,7457,3092,7678,15135,7684,15142
U,GouJieYiZuMiaoZuXiang,530524208,16379,2089,11109,5948,22387,10894,4751,11601,22495,12110,23219
˽ֵ´,FengHuangJieDaoBanShiChu,530602001,95818,8475,64738,37120,85906,57645,23702,56794,114439,63257,127995
Ȫֵ´,LongQuanJieDaoBanShiChu,530602002,60234,7845,40439,25564,61134,39876,16207,40386,80262,43847,84286
̫ƽֵ´,TaiPingJieDaoBanShiChu,530602003,55216,4513,39123,19323,57331,34410,18220,35554,69964,38826,77949
,JiuPuZhen,530602101,40160,4245,27774,17264,55462,27619,13359,29881,57500,29990,57764
,YongFengZhen,530602102,25595,2544,18387,11080,35671,18366,9962,19601,37967,19714,38101
բ,BeiZhaZhen,530602103,33174,3216,23925,12470,45706,23533,13594,25150,48683,26059,49984
»,BuGaHuiZuXiang,530602201,16150,1639,13332,6982,25700,13313,9507,13946,27259,13964,27296
,ShouWangHuiZuXiang,530602202,25182,2478,19240,10276,36856,19197,11776,20108,39305,20196,39436
С,XiaoLongDongHuiZuYiZuXiang,530602203,18322,1590,14048,7409,27190,14006,9480,14774,28780,15344,29392
̺,PanHeXiang,530602204,12110,1554,9367,5356,18353,9303,6109,10176,19479,10406,19773
,JingAnXiang,530602205,22699,2135,17671,8585,32954,17580,12699,19349,36929,19862,37533
,QingGangLingHuiZuYiZuXiang,530602206,12374,1503,10419,5458,19454,10389,7840,11191,21580,11298,21717
,SaYuXiang,530602207,33514,3497,24360,13936,47878,24358,13975,26615,50973,26626,50986
־,LeJuXiang,530602208,16534,1917,12225,7806,23779,12039,6781,12716,24755,13007,25232
ռԺ,SuJiaYuanXiang,530602209,20398,2325,15371,9467,29767,15369,9271,16616,31985,16623,31994
ռ,SuJiaXiang,530602210,13281,1550,9348,5726,18705,9290,5658,10997,20287,11141,20489
ɽ,DaShanBaoXiang,530602211,7272,522,5578,3088,10996,5574,4276,6476,12050,6492,12070
կ,DaZhaiZiXiang,530602212,6103,1016,4683,3010,8941,4600,2945,5193,9793,5381,10064
ɽ,YanShanXiang,530602213,9415,1432,7231,4353,14466,7173,4573,8034,15207,8189,15420
,TianBaXiang,530602214,6397,826,4742,2867,9043,4690,3133,5451,10141,5614,10356
,WenPingZhen,530621101,49947,3781,35132,18630,56926,33353,18215,33595,66948,36811,71943
ˮĥ,ShuiMoZhen,530621102,21957,1802,15906,7937,30753,15882,10051,17882,33764,17904,33810
ͷɽ,LongTouShanZhen,530621103,31155,2950,22575,11530,46049,22519,14045,25467,47986,25575,48150
Դ,TaoYuanHuiZuXiang,530621201,20903,2103,16589,8126,32193,16554,10497,16854,33408,16914,33503
Ժ,CiYuanHuiZuXiang,530621202,17867,1452,12885,6767,24299,12742,6977,12940,25682,13411,26296
Сկ,XiaoZhaiXiang,530621203,13233,1121,8820,4996,18137,8792,4542,9929,18721,10076,18896
,JiangDiXiang,530621204,17390,1563,12845,6049,25472,12816,7910,13958,26774,14018,26863
º,HuoDeHongXiang,530621205,13174,1290,9165,4633,18572,9118,5238,10396,19514,10537,19702
,LongShuXiang,530621206,20344,1934,14890,7509,30089,14878,9042,16396,31274,16430,31320
½,XinJieXiang,530621207,12213,886,8791,4273,18181,8766,5773,10008,18774,10081,18872
ɽ,SuoShanXiang,530621208,18916,1863,13961,6810,27540,13909,8405,15029,28938,15223,29184
ֺ,LeHongXiang,530621209,20560,1800,14500,7120,30101,14440,9755,17204,31644,17615,32115
׺̲,BaiHeTanZhen,530622101,69182,8874,49203,30092,88980,48130,23119,50374,98504,51972,101175
կ,DaZhaiZhen,530622102,23218,3092,15919,8848,32757,15913,7556,17904,33817,17947,33866
С,XiaoHeZhen,530622103,26791,2840,18272,9789,38105,18209,10609,21281,39490,21968,40240
ҩɽ,YaoShanZhen,530622104,28284,3310,19237,11100,41050,19161,11637,23775,42936,23994,43231
,MaShuZhen,530622105,21096,2190,13946,8024,31041,13939,8934,18255,32194,18274,32220
ϵ,LaoDianZhen,530622106,35223,4163,23728,13462,51229,23707,14190,29690,53397,29848,53576
ï,MaoZuXiang,530622201,11824,1422,8346,4911,17146,8345,4783,9678,18023,9683,18029
ƺ,DongPingXiang,530622202,19114,2002,12859,6996,26955,12858,7033,15287,28145,15290,28149
ɽ,HongShanXiang,530622203,12350,1330,8351,4588,17512,8342,4888,10072,18414,10217,18568
µ,XinDianXiang,530622204,19311,2305,13183,6997,27647,13130,7681,15773,28903,16114,29297
,BaoGuNaoXiang,530622205,14603,1692,9994,5718,21631,9980,6217,12501,22481,12518,22512
կ,ZhongZhaiXiang,530622206,6664,1106,4783,3064,10077,4776,2888,5794,10570,5875,10658
Ϫ,ChongXiXiang,530622207,20999,2429,14603,7700,30255,14595,9570,18262,32857,18395,32998
,JinTangXiang,530622208,9627,1418,7043,4276,14143,7039,4020,8003,15042,8022,15065
¯,LuFangXiang,530622209,12141,1354,8383,4351,18514,8380,5858,10962,19342,10970,19353
ɹ,MengGuXiang,530622210,10807,1678,8170,4300,16919,8170,4927,9236,17406,9242,17412
ξ,YanJingZhen,530623101,45506,4344,30396,15816,53098,28377,13200,30267,58644,32654,63050
ն,PuErZhen,530623102,40580,4328,28894,13968,57814,28788,16395,32061,60849,32409,61303
ɳ,DouShaZhen,530623103,15660,1764,10547,5080,21221,10406,5148,11719,22125,12025,22572
к,ZhongHeZhen,530623104,21591,2508,15338,6808,31022,15261,8422,16911,32172,17183,32521
¡,XingLongXiang,530623201,22831,2398,16544,7586,33159,16531,9214,17856,34387,17899,34443
,LuoYanXiang,530623202,16328,1668,11870,5138,23461,11858,6834,12917,24775,12960,24830
̲ͷ,TanTouXiang,530623203,19344,1861,13824,5794,26279,13762,7145,14248,28010,14526,28350
ţկ,NiuZhaiXiang,530623204,21879,2359,15191,7181,29704,15150,7440,16251,31401,16487,31678
,MiaoBaXiang,530623205,31028,3289,21717,10282,42976,21644,12074,24315,45959,24674,46391
,ShiZiXiang,530623206,17079,1853,11375,5887,21877,11032,5811,12575,23607,13368,24743
仪,CuiHuaZhen,530624101,30194,2821,20183,11294,35969,19353,9247,20957,40310,22079,42262
,YuWanZhen,530624102,10029,969,6786,3852,13729,6754,3616,7662,14416,7828,14614
,JiLiZhen,530624103,12577,1391,8464,4494,16908,8401,3829,9300,17701,9333,17797
,TianXingZhen,530624104,40911,3802,26845,13568,55258,26692,13508,30849,57541,31376,58221
ľ,MuGanZhen,530624105,18732,1903,12801,5845,25687,12769,6242,13926,26695,14076,26877
,YueLeZhen,530624106,21584,2075,15222,7012,30633,15164,8504,16740,31904,16941,32163
ϸŻ,ShangGaoQiaoHuiZuYiZuMiaoZuXiang,530624201,12952,1000,9052,4286,18568,9024,5449,10278,19302,10349,19401
ɽ,ShouShanXiang,530624202,18132,1711,12811,6091,25722,12641,7441,14007,26648,14473,27284
,GaoQiaoXiang,530624203,16166,1571,11695,5420,23378,11671,6869,12853,24524,12911,24606
Ϫ,XiLuoDuZhen,530625101,66598,6473,44750,28594,78841,43196,22368,46087,89283,50689,95439
Ϫ,GuiXiZhen,530625102,10594,1156,7256,3811,14132,7218,3860,7958,15176,8354,15610
ƻ,HuangHuaZhen,530625103,33478,3855,23838,13716,47300,23610,12699,25857,49467,26194,50032
ï,MaoLinZhen,530625104,13358,1438,9599,5183,19127,9580,6222,11390,20970,11419,21018
,DaXingZhen,530625105,22623,2630,16081,7868,31480,16047,8533,17483,33530,17705,33786
,LianFengZhen,530625106,20014,2497,14251,8297,29556,14213,8322,16467,30680,16582,30833
Ž,TuanJieXiang,530625201,12466,1542,8637,4622,17693,8630,4831,10166,18796,10202,18839
ϸɳ,XiShaXiang,530625202,11877,1334,8178,4389,17121,8158,4531,9533,17691,9564,17742
ʤ,QingShengXiang,530625203,6637,834,4688,2550,9886,4688,2913,5682,10370,5696,10384
,WuJiXiang,530625204,17204,1955,12553,6965,24634,12548,6693,13284,25832,13299,25852
,MaNanMiaoZuYiZuXiang,530625205,8014,736,5639,3201,10995,5639,3223,6334,11973,6334,11973
ˮ,ShuiZhuXiang,530625206,4888,601,3237,2108,6693,3235,1727,3975,7210,3979,7216
ī,MoHanXiang,530625207,13619,1678,9455,5380,19740,9446,5638,11455,20901,11480,20935
կ,WuZhaiYiZuMiaoZuXiang,530625208,7194,705,4738,2674,10131,4738,2585,5743,10481,5746,10484
,MaKouXiang,530625209,15436,2102,10936,5692,22627,10929,6586,13174,24103,13188,24124
г,ZhongChengZhen,530626101,54038,5888,36824,19069,68497,35463,15499,36444,71907,38601,75425
ϰ,NanAnZhen,530626102,9671,1063,6567,3254,13073,6509,3246,7105,13614,7413,13980
̲,XinTanZhen,530626103,16062,1595,10551,4768,20312,10336,4967,10902,21238,12073,22624
,HuiYiZhen,530626104,15392,1616,10624,5226,20753,10538,5025,11010,21548,11409,22033
,BanLiXiang,530626201,12815,1757,8832,4558,17828,8780,4457,10029,18809,10197,19029
ڷ,WuFengZhen,530627101,88938,7414,64140,34303,113185,62308,36254,65381,127689,68466,132606
û,PoJiZhen,530627102,70884,7388,55697,25781,109574,55544,35944,57441,112985,58519,114216
,HeiShuZhen,530627103,17594,1644,12292,5862,24500,12287,6901,13722,26009,13847,26139
ĸ,MuXiangZhen,530627104,36028,3797,26693,12962,53705,26588,16451,29265,55853,29583,56276
,DaWanZhen,530627105,31876,2941,23466,10407,47151,22818,14316,24741,47559,25667,49133
,YiLeZhen,530627106,41060,3674,30757,14515,61487,30682,19473,33281,63963,33450,64207
ˮԴ,ChiShuiYuanZhen,530627107,35273,3385,27503,14104,55415,27396,19344,30037,57433,30499,58002
â,MangBuZhen,530627108,26822,2556,20467,9742,41201,20106,13724,22184,42290,22635,43102
,YuHeZhen,530627109,26291,2452,19102,8700,38980,19088,11758,21288,40376,21399,40501
޿,LuoKanZhen,530627110,45390,4899,33720,14794,68789,33176,20129,36052,69228,36698,70418
ţ,NiuChangZhen,530627111,25357,2353,18541,8425,37345,18470,11402,20280,38750,20571,39112
,WuDeZhen,530627112,38029,3996,29104,13229,59679,28937,18626,31154,60091,31547,60651
ͷ,PoTouZhen,530627113,40557,4441,28888,15334,58775,28854,17218,33063,61917,33328,62216
Թ,YiGuZhen,530627114,19291,1851,14076,6497,29379,13983,9113,15941,29924,16179,30255
,ChangBaZhen,530627115,33020,3344,24592,10581,50543,24470,15570,26959,51429,27342,51934
,TangFangZhen,530627116,34006,3621,26181,12738,51669,25799,17508,26939,52738,28954,55135
,ZhongTunXiang,530627201,37086,4206,27911,13574,55984,27668,16434,29091,56759,29815,57726
㶴,YuDongXiang,530627202,12300,1164,9546,4499,18499,9478,6261,10060,19538,10179,19725
,HuaLangXiang,530627203,14534,1428,10326,4816,20249,10290,5603,11122,21412,11239,21565
ɽ,JianShanXiang,530627204,17786,1601,13245,6425,27065,13223,9064,15178,28401,15206,28451
ľ׿,MuZhuoXiang,530627205,17865,1787,13178,6157,26465,13093,8123,14378,27471,14597,27775
Դ,YanYuanXiang,530627206,23458,2322,17575,7927,35148,17537,10853,18928,36465,19058,36633
볧,WanChangXiang,530627207,13466,1340,9763,4676,19598,9752,6209,11187,20939,11252,21015
ɼ,ShanShuXiang,530627208,14366,1380,9915,4993,21082,9882,5889,11611,21493,11720,21635
ɽ,HuaShanXiang,530627209,17187,1505,12060,5694,23211,11981,7593,13657,25638,14225,26285
ƺ,PingShangXiang,530627210,25117,2294,18216,8518,38391,18206,11869,20762,38968,21064,39280
,GuoZhuYiZuXiang,530627211,21966,2208,16633,7620,31514,16572,11153,18546,35118,18694,35327
ֿ,LinKouYiZuMiaoZuXiang,530627212,24091,2295,18442,9414,37497,18378,12665,20330,38708,20609,39051
ǿ,JiaoKuiZhen,530628101,68392,6690,48996,27314,90692,47818,26275,50688,98506,52361,101357
,LuoZeHeZhen,530628102,38489,3583,28321,13592,55050,28207,18128,30410,58617,31879,60200
ţ,NiuJieZhen,530628103,22529,2609,16574,8618,32384,16297,9573,17687,33984,18137,34711
,LongJieMiaoZuYiZuXiang,530628201,27254,2335,20254,9677,40666,20178,13210,22337,42515,22545,42799
,KuiXiangMiaoZuYiZuXiang,530628202,29433,2161,21796,9835,44513,21693,13805,23447,45140,23603,45399
,ShuLinYiZuMiaoZuXiang,530628203,13106,1150,10005,4808,19582,9984,6531,10649,20633,10782,20787
,HaiZiXiang,530628204,16022,1589,11712,6726,23917,11684,7716,13568,25252,13615,25327
ɽ,QiaoShanXiang,530628205,27742,2180,18831,9321,39272,18775,10744,21595,40370,21835,40666
,LongAnXiang,530628206,15112,1540,10117,5229,20439,10056,4554,11013,21069,11089,21206
,ZhongMingXiang,530628207,11908,1119,8130,4373,16738,8098,4232,9055,17153,9129,17259
,LiangHeXiang,530628208,14278,1559,9983,4840,20704,9983,5497,11342,21325,11351,21334
Сݰ,XiaoCaoBaXiang,530628209,16038,1415,11023,5655,22548,10942,6130,12277,23219,12560,23583
,LongHaiXiang,530628210,14158,1401,9750,4753,19988,9738,5332,11100,20838,11141,20891
Ϫ,LiuXiMiaoZuXiang,530628211,12801,1237,9738,4155,19185,9694,5919,10075,19769,10219,19957
,LuoWangXiang,530628212,16491,1954,12608,5915,25443,12552,7917,13656,26208,13754,26362
,ZhaXiZhen,530629101,83925,7771,61191,29332,106909,60042,32762,62086,122128,63267,124458
ɳ,JiuChengZhen,530629102,18355,2486,12919,6136,26242,12876,6473,14284,27160,14395,27314
˫,ShuangHeMiaoZuYiZuXiang,530629201,19227,2270,13711,6690,27136,13697,6867,14498,28195,14653,28364
,GaoTianXiang,530629202,17974,2281,12834,6180,26246,12814,7164,14492,27306,14585,27419
޲,LuoBuXiang,530629203,32392,3525,23280,10676,46004,23245,12749,24830,48075,25386,48666
ַ,LinFengXiang,530629204,26839,2683,18731,9324,37274,18610,10241,19929,38539,21032,39763
,ChangAnXiang,530629205,18358,2219,13274,6041,26063,13269,6829,14095,27364,14132,27406
�,MiaoGouXiang,530629206,12390,1473,8838,4125,17366,8815,4430,9371,18186,9455,18293
,SanTaoXiang,530629207,18688,2118,13820,6322,27244,13783,8082,14903,28686,15068,28888
ˮ,ShuiTianXiang,530629208,9950,1142,7444,4035,14279,7425,4202,7787,15212,7850,15294
Ұ,XiangJiaBaZhen,530630101,53102,4890,34506,20675,53674,32410,14291,32897,65307,37777,72283
̫ƽ,TaiPingXiang,530630201,9462,1376,6934,3861,13619,6920,3783,7554,14474,7687,14621
,LiangWanXiang,530630202,10026,1269,7302,4007,13688,7268,3944,7863,15131,7937,15239
�ֵ´,XiAnJieDaoBanShiChu,530702001,45182,4070,27068,13157,32065,21150,6456,20431,41581,28640,55708
нֵ´,DaYanJieDaoBanShiChu,530702002,25912,1882,16736,6793,13592,10855,3211,10396,21251,14269,31005
ͽֵ´,XiangHeJieDaoBanShiChu,530702003,23586,1903,14875,9281,11885,13745,4595,13605,27350,15209,30084
ӽֵ´,ShuHeJieDaoBanShiChu,530702004,29438,1776,18084,6973,11437,11097,3733,11328,22425,16863,34947
,JinAnXiang,530702201,4805,516,2701,1370,4941,2401,1011,2604,5005,3631,6332
ߺ,QiHeXiang,530702202,13327,1874,8840,4672,16717,8469,3115,8757,17226,9476,18316
,DaDongXiang,530702203,4491,611,3017,1715,5967,2967,1159,3103,6070,3244,6261
ɽ,JinShanBaiZuXiang,530702204,18733,2330,11945,5890,22303,11662,3898,11870,23532,13016,24961
𽭰,JinJiangBaiZuXiang,530702205,2543,381,1656,981,3305,1619,613,1707,3326,1881,3537
ɽ,HuangShanZhen,530721101,15700,1627,9405,4298,13276,7879,2809,7761,15640,10731,20136
ʯ,ShiGuZhen,530721102,15415,2293,10119,5452,20342,9813,3298,10438,20251,10887,21006
޵,JuDianZhen,530721103,15960,2083,10310,5036,20958,9754,3325,10209,19963,11058,21368
ɳ,BaiShaXiang,530721201,5967,816,4024,1972,7622,3834,1374,3874,7708,4133,8157
,LaShiXiang,530721202,12344,1532,7747,3795,15051,7393,2570,7402,14795,8699,16446
̫,TaiAnXiang,530721203,6762,774,4509,2266,9131,4364,1752,4549,8913,4779,9288
,LongPanXiang,530721204,7854,1147,5147,2551,9984,4948,1699,5048,9996,5553,10700
,LiMingLiSuZuXiang,530721205,11297,1397,7414,3890,14715,7268,2650,7649,14917,7930,15344
³,LuDianXiang,530721206,12899,1157,8183,4140,16660,8080,2931,8654,16734,8804,16987
,TaChengXiang,530721207,6726,866,4372,2242,8832,4293,1525,4599,8892,4745,9117
,DaJuXiang,530721208,6784,991,4652,2507,8834,4358,1706,4413,8771,4829,9481
ɽ,BaoShanXiang,530721209,5315,700,3683,2062,7400,3652,1513,3785,7437,3845,7528
,FengKeXiang,530721210,5849,694,3629,1775,6986,3414,1204,3606,7020,4118,7747
,MingYinXiang,530721211,6597,655,3737,1845,6818,3449,1353,3626,7075,4868,8605
ʯͷ,ShiTouBaiZuXiang,530721212,6956,739,4416,2287,8923,4342,1412,4596,8938,4691,9107
źӰ,JiuHeBaiZuXiang,530721213,16835,2672,11348,5852,22497,10951,4173,11042,21993,12332,23680
,YongBeiZhen,530722101,45099,4906,30115,14969,51885,27641,10094,27404,55045,29984,60099
ʺ,RenHeZhen,530722102,18604,1413,11979,6189,23872,11773,4886,12505,24278,12924,24903
,QiNaZhen,530722103,27372,3891,18227,8819,35793,17323,5560,17685,35008,18596,36823
,SanChuanZhen,530722104,40241,5594,28397,14898,55707,27946,10510,27337,55283,27948,56345
̺,ChengHaiZhen,530722105,28974,3619,19702,9365,39395,19517,7173,19738,39255,20064,39766
ƺ,YangPingYiZuXiang,530722201,4856,392,3609,1883,7201,3560,2064,3607,7167,3703,7312
,LiuDeLiSuZuYiZuXiang,530722202,10593,947,6990,3566,14072,6806,2906,7130,13936,7456,14446
ɽ,DongShanLiSuZuYiZuXiang,530722203,5998,354,3998,2180,8184,3951,1958,4223,8174,4312,8310
,DongFengLiSuZuXiang,530722204,9523,715,6270,3442,12730,6217,2770,6590,12807,6738,13008
Դ,TaoYuanXiang,530722205,25444,2638,17223,9261,34115,17044,6573,17125,34169,17432,34655
Ƭ,PianJiaoXiang,530722206,18335,1957,12017,6111,24293,11869,4283,12336,24205,12558,24575
⻪,GuangHuaLiSuZuYiZuXiang,530722207,11076,1026,7500,3513,15069,7373,3119,7515,14888,7721,15221
ƺ,SongPingLiSuZuXiang,530722208,6276,562,4124,2343,8456,4045,1707,4252,8297,4421,8545
,DaAnYiZuNaXiZuXiang,530722209,11683,1135,7594,3578,15238,7477,3124,7875,15352,8348,15942
˳,ShunZhouXiang,530722210,23350,2439,15699,8135,31815,15497,6285,16124,31621,16375,32074
,ZhongXinZhen,530723101,39367,3827,24693,14736,38572,23112,8672,23891,47003,27173,51866
ٽ,RongJiangZhen,530723102,24225,2475,15454,8773,26635,14650,5591,15441,30091,16837,32291
Ȫ,XingQuanZhen,530723103,13333,1551,8268,4981,16000,7923,3042,8581,16504,9658,17926
ʯ,ShiLongBaYiZuDaiZuXiang,530723201,15816,1414,8122,4292,14640,7201,2844,7816,15017,11952,20074
ׯ,XinZhuangLiSuZuDaiZuXiang,530723202,12137,1379,7577,4513,14914,7447,2548,7977,15424,8487,16064
ͨ,TongDaLiSuZuXiang,530723203,5888,724,3833,2184,7703,3819,1363,4048,7867,4142,7975
,YongXingLiSuZuXiang,530723204,9754,1252,6287,3613,12002,6184,2512,7040,13224,7231,13518
,ChuanFangLiSuZuDaiZuXiang,530723205,5860,905,3733,2458,7126,3690,1549,4170,7860,4581,8314
,DaXingZhen,530724101,37815,2902,25395,14330,43636,24557,11851,25764,50321,27173,52568
,LaBoXiang,530724201,7115,746,4931,2335,9851,4918,2263,5083,10001,5193,10124
,YongNingXiang,530724202,15160,1278,10153,4356,19119,10041,4414,9898,19939,10699,20852
,CuiYuLiSuZuPuMiZuXiang,530724203,12686,989,7408,3716,14389,7136,3239,7709,14845,9506,16914
,HongQiaoXiang,530724204,13775,1330,9682,4911,19083,9364,4955,9684,19048,10378,20060
,NingLiXiang,530724205,9800,941,6886,3442,13764,6793,3522,7146,13939,7377,14263
,JinMianXiang,530724206,5582,595,3686,1957,7772,3648,1691,4117,7765,4182,7868
,XiChuanXiang,530724207,9797,813,7130,4170,14780,7103,4318,7737,14840,7798,14928
�,XiBuHeXiang,530724208,13061,1198,9292,4891,18886,9245,4991,9861,19106,9958,19250
ս,ZhanHeXiang,530724209,16274,1278,10954,6137,21507,10725,6302,11354,22079,12900,23854
ƺ,YongNingPingXiang,530724210,5332,395,3441,1825,6948,3407,1856,3701,7108,4142,7583
ƺ,PaoMaPingXiang,530724211,7406,669,5248,3041,10714,5210,2917,5637,10847,5744,10992
ս,ChanZhanHeXiang,530724212,4123,380,3084,1809,6185,3083,1918,3333,6416,3337,6421
Ӫ,XinYingPanXiang,530724213,14221,1263,10166,5583,20575,10117,5524,10732,20849,10842,21008
,LanNiQingXiang,530724214,7890,775,5911,3561,11994,5881,3519,6110,11991,6273,12184
˼é,SiMaoZhen,530802101,77942,7042,50797,33392,53439,44872,15188,44176,89048,49375,100172
,NanPingZhen,530802102,77358,4710,45876,27602,44942,40689,15515,42065,82754,51707,97583
,YiXiangZhen,530802103,28910,2424,19021,11016,28366,18779,8982,20683,39462,21295,40316
˼é,SiMaoGangZhen,530802104,18132,1097,9675,5883,13509,9163,4355,10638,19801,13909,23584
̶,LongTanYiZuDaiZuXiang,530802201,6867,813,4450,2413,8238,4430,1905,5086,9516,5135,9585
,YunXianYiZuXiang,530802202,9140,1375,5827,3702,11707,5805,2098,6701,12506,6786,12613
˳,LiuShunXiang,530802203,9229,877,5859,3377,9827,5836,2606,6731,12567,6853,12712
,NingErZhen,530821101,58410,5779,38058,22548,62339,36871,12385,36721,73592,38516,76574
ĥ,MoHeiZhen,530821102,15900,1818,9930,5822,18433,9845,3244,10572,20417,11032,20962
°,DeAnXiang,530821201,7321,989,4650,2469,9042,4641,1530,5156,9797,5190,9840
»,DeHuaXiang,530821202,7661,1042,4829,2949,9566,4818,1752,5565,10383,5626,10455
ͬ,TongXinXiang,530821203,12293,1322,7276,4027,13362,7053,2477,7778,14831,8816,16092
,MengXianXiang,530821204,14208,2335,9126,5085,17978,9077,3123,10235,19312,10540,19666
,PuYiXiang,530821205,8838,1125,5361,3063,9038,5332,1971,6264,11596,6573,11934
,LiMingXiang,530821206,7479,1133,4755,2527,9532,4623,1533,5225,9848,5390,10145
÷,MeiZiXiang,530821207,7421,860,4805,2670,9368,4804,1770,5242,10046,5246,10051
,LianZhuZhen,530822101,68438,7688,44284,24212,78522,42923,15753,45673,88596,47595,91879
ͨ,TongGuanZhen,530822102,22171,2892,14094,7677,26867,13583,4498,14836,28419,15467,29561
,LongBaXiang,530822201,16581,1572,10086,5547,21691,10077,4133,12177,22254,12200,22286
°,XinAnXiang,530822202,13468,1542,8128,4137,17394,8068,3016,9745,17813,9898,18026
Ū,MengNongYiZuXiang,530822203,9175,944,5305,2874,11395,5275,2052,6628,11903,6866,12171
,TuanTianXiang,530822204,11498,1164,7306,3799,15260,7304,3050,8404,15708,8406,15712
¸,XinFuXiang,530822205,14504,1649,8816,5228,18593,8800,3226,10529,19329,10563,19379
,JingXingXiang,530822206,16625,2138,10177,5531,21539,10177,3438,12024,22201,12024,22201
,YuTangYiZuXiang,530822207,12036,1532,7158,3682,15626,7155,2382,8785,15940,8792,15950
̶,LongTanXiang,530822208,9897,1109,5711,2874,12162,5681,2013,6896,12577,7308,13019
,WenWuXiang,530822209,15654,1571,9634,4901,20830,9631,4129,11714,21345,11720,21354
,BaLiuXiang,530822210,15234,1556,9250,4506,19632,9230,3684,11187,20417,11224,20474
Ͻ,SiNanJiangXiang,530822211,16422,1672,9946,5061,20186,9913,3776,11743,21656,11924,21870
ǹ,NaHaXiang,530822212,11585,814,7150,3317,14472,7087,2946,8074,15161,8195,15345
,YaYiXiang,530822213,16042,1719,9655,4930,20471,9650,3519,11605,21255,11625,21280
,JinPingZhen,530823101,47829,5027,32038,17954,54236,30364,11465,30428,60792,32283,64321
ľ,WenJingZhen,530823102,47792,5418,32518,18666,58245,32164,12931,33174,65338,33623,66141
,ManWanZhen,530823103,14442,1386,9814,5417,19193,9808,4014,10011,19819,10028,19842
ɽ,DaChaoShanDongZhen,530823104,20571,1991,12577,7425,27308,12550,5244,15017,27567,15229,27806
,ManDengXiang,530823201,11476,1422,7562,4404,15743,7561,3076,8410,15971,8412,15974
ɽ,HuaShanXiang,530823202,20150,2545,13265,7511,27439,13251,5347,14712,27963,14777,28042
,DaJieXiang,530823203,16189,1882,10813,5541,22040,10724,4491,11582,22306,11749,22562
̫,TaiZhongXiang,530823204,16289,1835,10789,5954,22487,10757,4801,12035,22792,12136,22925
,LongJieXiang,530823205,14463,1730,9411,5180,19806,9368,3910,10562,19930,10692,20103
,WenLongXiang,530823206,13488,1287,8715,4727,17777,8653,3375,9287,17940,9435,18150
,AnDingXiang,530823207,13714,1388,9162,5469,18547,9133,3909,9746,18879,9849,19011
ֽ,LinJieXiang,530823208,9878,1015,6378,3687,13386,6358,2690,7156,13514,7205,13583
,JingFuXiang,530823209,15181,1966,10094,5943,20702,10024,3920,10898,20922,10973,21067
Զ,WeiYuanZhen,530824101,68318,6040,43867,27122,69249,41876,17178,44664,86540,47669,91536
ƽ,YongPingZhen,530824102,45501,4777,29121,17133,58006,28868,12764,32683,61551,33921,63042
,ZhengXingZhen,530824103,12831,1526,7862,4956,16019,7791,3185,9290,17081,9680,17542
,MinYueZhen,530824104,16428,1715,10603,6417,20185,10519,4821,12066,22585,12361,22964
̰,BiAnXiang,530824201,14853,1655,9234,5239,19498,9194,3876,11017,20211,11150,20384
ɽ,FengShanXiang,530824202,12693,1617,8157,5076,16937,8142,3451,9469,17611,9604,17761
,JingGuXiang,530824203,11039,1419,7168,4228,14607,7148,2873,8138,15286,8163,15331
,YiZhiXiang,530824204,9015,1013,5709,3469,11782,5679,2510,6654,12333,6829,12538
,BanPoXiang,530824205,8797,1046,5382,3088,11409,5351,2096,6498,11849,6557,11939
°,MengBanXiang,530824206,13291,1576,8561,5430,17446,8510,3768,10006,18516,10074,18635
,EnLeZhen,530825101,25189,2352,16065,9740,25958,15091,5907,15907,30998,17383,33448
,AnBanZhen,530825102,15460,1812,9815,5987,18487,9612,3538,10657,20269,10995,20810
´,MengDaZhen,530825103,30678,3829,19690,11158,39079,19297,6836,21159,40456,21653,41343
߶,ZheDongZhen,530825104,21244,2440,13410,7738,27719,13290,5357,15371,28661,15631,29041
,TianBaXiang,530825201,6321,915,3993,2062,8229,3951,1365,4542,8493,4608,8601
ų,GuChengXiang,530825202,10849,1246,6833,3654,13682,6704,2625,7608,14312,7887,14720
ż,JiuJiaXiang,530825203,11442,1441,7247,4345,15054,7198,2696,8230,15428,8332,15579
̫,ZhenTaiXiang,530825204,24642,2808,15387,8381,31855,15197,5635,17480,32677,17698,33085
ƽ,HePingXiang,530825205,8740,956,5284,3096,10812,5233,2283,6229,11462,6695,11979
,MengLieZhen,530826101,24598,1867,15667,9806,18519,15056,5841,15552,30608,16639,32306
,ZhengDongZhen,530826102,9198,666,5901,3073,9129,5837,2321,5907,11744,6284,12185
ˮ,QuShuiXiang,530826201,12811,907,7577,4810,10830,7516,3093,9005,16521,9234,16811
,GuoQingXiang,530826202,10456,1110,6757,3653,12800,6749,2332,7116,13865,7141,13898
κ,JiaHeXiang,530826203,11133,1248,6918,3702,13394,6901,2346,7740,14641,7809,14727
,BaoZangXiang,530826204,6825,723,4334,2300,8091,4289,1554,4640,8929,4768,9102
ƽ,KangPingXiang,530826205,15899,1380,10560,5819,17525,10503,5237,11615,22118,11956,22516
,NaYunZhen,530827101,36559,2337,23386,14136,31957,23029,9132,23562,46591,24642,48028
,MengMaZhen,530827102,22707,1577,14720,8113,24165,14618,6202,15502,30120,15766,30486
â,MangXinZhen,530827103,12922,744,8127,4491,14222,8097,3273,8734,16831,8812,16939
,JingXinXiang,530827201,9300,700,6104,3370,11257,6068,2545,6374,12442,6441,12545
,GongXinXiang,530827202,10897,747,7367,3962,13505,7347,3386,7647,14994,7663,15030
,FuYanXiang,530827203,9143,606,6134,3797,11403,6091,2761,6331,12422,6376,12510
,MengLangZhen,530828101,68381,5436,41817,24399,61775,39714,13060,40770,80484,45060,86877
,ShangYunZhen,530828102,34106,2942,22113,12114,41866,21900,7870,22400,44300,22805,44918
Ŵ,NuoZhaDuZhen,530828103,22192,1778,13931,7643,27697,13828,5733,15495,29323,15772,29703
չӹ,FaZhanHeHaNiZuXiang,530828201,11486,1057,7238,4090,15040,7224,2940,8198,15422,8245,15483
ǫ,QianLiuYiZuXiang,530828202,36765,3087,22554,11775,47593,22507,8238,25418,47925,25536,48090
Ŵ,NuoFuXiang,530828203,14541,878,8592,4777,16956,8518,3110,9601,18119,9937,18529
,DongHeXiang,530828204,11126,1159,6640,3956,14344,6626,2486,8050,14676,8131,14771
ɽ,DaShanXiang,530828205,11869,1514,7192,4431,15618,7181,2597,8750,15931,8788,15980
,NanLingXiang,530828206,18117,1856,11222,6310,23480,11221,4086,12821,24042,12837,24059
ѩ,XueLinWaZuXiang,530828207,10841,701,6883,3558,12829,6859,2616,7213,14072,7275,14158
ľ,MuJiaXiang,530828208,12529,1158,7581,4623,15845,7576,2493,8589,16165,8599,16180
ƾ,JiuJingHaNiZuXiang,530828209,10239,840,6466,3544,12889,6454,2637,7208,13662,7250,13716
,HuiMinHaNiZuXiang,530828210,12793,1158,8128,4615,15094,8033,3352,8935,16968,9175,17303
,DongHuiXiang,530828211,11933,859,7270,4323,14699,7266,2588,8064,15330,8110,15380
,LaBaXiang,530828212,11296,839,6938,3891,14061,6906,2501,7476,14382,7698,14636
,ZhuTangXiang,530828213,28023,2068,16772,9010,34141,16617,5675,18132,34749,18994,35766
,FuBangXiang,530828214,16734,1595,10181,5537,20512,9847,3499,10538,20385,11647,21828
,AnKangWaZuXiang,530828215,9955,722,6191,3225,12252,6132,2559,6540,12672,7045,13236
Ķ,WenDongWaZuXiang,530828216,10503,1282,6956,4112,13969,6951,2732,7547,14498,7561,14517
,FuDongXiang,530828217,12610,1407,7746,4089,16606,7746,2737,9008,16754,9008,16754
,MengSuoZhen,530829101,16222,946,10074,6131,17606,9781,4139,10551,20332,11233,21307
¿,MengKaZhen,530829102,12850,932,8154,4777,14695,8109,3272,8788,16897,8900,17054
̸¿,WengGaKeXiang,530829201,8197,527,5322,2920,9999,5321,2270,5636,10957,5672,10994
,LiSuoLaHuZuXiang,530829202,8793,587,5685,3071,10923,5674,2519,6118,11792,6214,11899
,YueSongXiang,530829203,5359,267,3631,2106,6776,3619,1725,3664,7283,3720,7351
п,ZhongKeXiang,530829204,8174,548,5275,3198,9963,5270,2219,5634,10904,5666,10941
³,XinChangXiang,530829205,8831,490,5773,3067,10944,5768,2468,6005,11773,6016,11789
ֵ´,FengXiangJieDaoBanShiChu,530902001,87746,7375,57424,28212,84763,45503,16689,44561,90064,54386,111810
æϽֵ´,MangPanJieDaoBanShiChu,530902002,31019,2930,20802,10360,34495,19377,8826,19899,39276,21973,42775
,BoShangZhen,530902102,24651,3849,17541,9467,35086,17319,8264,18832,36151,19223,36764
,NanMeiXiang,530902202,3210,408,2205,1241,4428,2183,960,2338,4521,2373,4578
϶,MaYiDuiXiang,530902203,20249,2465,13931,7989,28743,13808,6872,15387,29195,15655,29586
,ZhangTuoXiang,530902204,13680,1478,9519,5039,19761,9395,5124,10531,19926,10763,20282
Ȧ,QuanNeiXiang,530902206,21820,2911,14384,7786,30040,14037,6555,15867,29904,16902,31286
̨,MaTaiXiang,530902207,17148,1936,11647,6233,23511,11647,5431,12868,24515,12868,24515
,BangDongXiang,530902208,9328,1227,6227,3586,12982,6166,2856,7096,13262,7184,13411
ƽ,PingCunXiang,530902209,6309,641,4027,2300,7795,3985,1751,4559,8544,4674,8701
ɽ,FengShanZhen,530921101,60808,6196,40344,20151,70130,37828,12853,37056,74884,39513,79857
³ʷ,LuShiZhen,530921102,22333,2370,14245,7233,29046,13984,5291,15052,29036,15749,29994
С,XiaoWanZhen,530921103,20796,1809,12887,6629,25374,12575,4942,13451,26026,14660,27547
Ӫ,YingPanZhen,530921104,34348,3305,21423,10268,42823,20938,8056,22753,43691,24286,45709
,SanChaHeZhen,530921105,21361,2019,13416,6516,27339,13190,5328,14773,27963,15292,28708
,MengYouZhen,530921106,37591,4073,24646,11780,49412,24547,9549,26214,50761,26567,51213
ѩɽ,XueShanZhen,530921107,22478,2575,14863,7304,29819,14795,5900,16010,30805,16090,30953
嵳,LuoDangZhen,530921108,29735,3181,19649,8796,38438,19347,7156,19850,39197,20423,40072
ʫ,ShiLiXiang,530921201,18865,2175,12419,6520,25448,12373,5084,13482,25855,13705,26124
»,XinHuaXiang,530921202,20467,2021,13691,6374,26963,13606,5424,13949,27555,14221,27912
,DaSiXiang,530921204,28625,3033,17876,9238,36001,17570,6440,19030,36600,20222,38098
,YaoJieXiang,530921206,6884,486,4359,2234,9024,4258,1863,4639,8897,4874,9233
կ,GuoDaZhaiXiang,530921207,16517,1853,10862,4991,21449,10737,4532,11617,22354,12040,22902
,AiHuaZhen,530922101,79427,7395,51092,26516,91324,48689,19232,49539,98228,54962,106054
,ManWanZhen,530922102,17497,1415,11166,5650,22649,11016,4705,12140,23156,12451,23617
ɽ,DaChaoShanXiZhen,530922103,12329,1222,7871,4145,16858,7674,3982,9122,16796,9662,17533
ӿ,YongBaoZhen,530922104,30183,3623,19779,10262,41868,19644,8630,22450,42094,22657,42436
ï,MaoLanZhen,530922105,31687,2969,21171,10352,43563,21151,9269,22722,43873,22754,43925
Ҹ,XingFuZhen,530922106,33852,2931,22392,11749,44981,22230,10696,24594,46824,25087,47479
կ,DaZhaiZhen,530922107,25014,2916,16714,8673,35467,16502,7837,18776,35278,19053,35767
æ,MangHuaiXiang,530922201,12524,1474,8156,4954,17319,8128,3667,9429,17557,9509,17665
,XiaoJieXiang,530922202,28196,2923,18856,9589,38974,18721,8386,20430,39151,20649,39505
跿,ChaFangXiang,530922203,24738,3456,16603,8727,34202,16600,6650,18231,34831,18241,34844
,LiShuXiang,530922204,15387,1523,9187,5121,20440,9141,4673,11479,20620,12396,21583
,HouQingXiang,530922205,13358,1647,8807,5162,18960,8799,4047,10224,19023,10245,19052
µ,DeDangZhen,530923101,47949,5591,32045,16774,59011,30533,12302,32068,62601,33797,65842
Сͳ,XiaoMengTongZhen,530923102,40911,4011,24755,12283,49104,23672,11205,27337,51009,31372,56127
,YongKangZhen,530923103,46233,4516,30219,15866,55281,29570,12101,31129,60699,32631,62850
°,MengBanXiang,530923203,18839,2388,12527,6526,26276,12489,5760,14391,26880,14460,26987
,YaLianXiang,530923204,20781,1832,12508,6096,25890,12351,5988,13536,25887,16093,28601
ľ,WuMuLongXiang,530923205,20154,2049,13448,7002,28067,13336,6759,14960,28296,15514,28962
ѩɽ,DaXueShanXiang,530923206,14932,1358,9450,5005,18365,9173,4354,10096,19269,11194,20644
࿨,BanKaXiang,530923207,15346,1721,10014,5374,21438,9984,4843,11779,21763,11896,21910
,ChongGangXiang,530923208,24193,2463,15320,7778,31950,15114,8067,17635,32749,19403,34723
ɽ,DaShanXiang,530923209,17024,1724,9804,5067,20473,9675,4308,11439,21114,13252,23056
β,FengWeiZhen,530924101,13073,1294,8264,4696,15902,8073,3799,8941,17014,9902,18166
,MengPengZhen,530924102,28612,3121,18711,9254,38141,18516,8684,21334,39850,21706,40417
ɡ,NanSanZhen,530924103,30545,2315,20066,11087,33155,19239,10237,21507,40746,23031,43097
æ,MangBingXiang,530924201,15823,1841,10084,4977,20760,9762,4514,11174,20936,12094,22178
¶,MengDuiXiang,530924202,14721,1396,9842,4785,19041,9779,4519,10642,20421,10794,20636
ľ,MuChangXiang,530924204,13107,1553,8474,4451,17974,8440,4006,10019,18459,10192,18666
,JunSaiXiang,530924205,9416,963,6072,3141,11410,5988,2817,6682,12670,7124,13196
,MengMengZhen,530925101,35876,3070,23334,13301,42620,22175,9020,23031,45206,24632,47966
¿,MengKuZhen,530925102,26180,2349,16418,8768,32509,16176,6617,17411,33587,18728,35146
ɳ,ShaHeXiang,530925201,23383,2118,14635,7814,26456,14141,5716,14992,29133,16582,31217
,DaWenXiang,530925202,15829,1431,9925,4825,20563,9862,3648,10867,20729,10983,20908
æŴ,MangNuoXiang,530925203,16945,1339,10381,5069,21961,10207,4261,11390,21597,12164,22545
,BangBingXiang,530925205,14313,1214,8880,4381,18160,8709,3240,9423,18132,9887,18767
,GengMaZhen,530926100,43989,3342,29320,15752,52292,28267,11993,28445,56712,30004,59324
,MengYongZhen,530926101,21237,1702,15038,7138,29484,14926,8202,15923,30849,16103,31141
,MengSaZhen,530926102,25838,2262,18146,9421,34458,18069,9199,18966,37035,19153,37299
϶,MengDingZhen,530926103,73629,5341,50259,24843,82150,49307,24022,50930,100237,52733,102992
,DaXingXiang,530926200,6344,675,4226,2253,9177,4219,2230,5015,9234,5023,9249
â,MangHongXiang,530926201,6092,559,3972,2058,8301,3884,1871,4409,8293,4550,8522
ɽ,SiPaiShanXiang,530926202,10681,815,7021,3687,13464,6674,3573,7371,14045,8048,15069
,HePaiXiang,530926203,13378,925,8891,4305,17417,8779,4006,9146,17925,9418,18309
¼,MengJianXiang,530926204,10429,780,6912,3516,12846,6806,3188,7263,14069,7485,14397
¶,MengDongZhen,530927101,27617,1831,17336,10045,27209,16354,6293,16576,32930,18405,35741
˧,YanShuaiZhen,530927102,24255,2127,15429,9444,30555,15367,6104,16616,31983,17057,32486
ʡ,MengShengZhen,530927103,17858,1447,11012,6882,18064,10862,4225,11493,22355,12518,23530
â,MangKaZhen,530927104,9963,777,6552,3362,11936,6536,2949,6957,13493,7137,13689
,DanJiaXiang,530927202,8052,568,5253,2730,10533,5224,2460,5780,11004,5827,11080
Ŵ,NuoLiangXiang,530927203,10763,962,6867,3706,13569,6836,2940,7414,14250,7798,14665
,MengLaiXiang,530927204,10684,960,6953,3514,13548,6907,2799,7354,14261,7490,14443
½,MengJiaoXiang,530927205,10458,861,6836,3583,12863,6817,2671,6995,13812,7154,13990
,BanHongXiang,530927206,7710,698,5098,2638,9383,5057,2179,5365,10422,5489,10587
,BanLaoXiang,530927207,6077,466,4341,2140,7506,4291,2344,4430,8721,4546,8887
¹,LuChengZhen,532301101,174834,16213,108145,63370,126222,89880,30205,90164,180044,113107,221252
,DongGuaZhen,532301102,82776,5717,50736,28821,56746,41130,14622,41489,82619,52379,103115
,LvHeZhen,532301103,19398,2329,12690,6242,24989,12477,4295,12852,25329,13332,26022
Ϫ,ZiXiZhen,532301104,9822,1133,6482,3628,12327,6312,2386,6507,12819,6859,13341
,DongHuaZhen,532301105,18369,2397,12518,7059,24812,12378,4730,12572,24950,12978,25496
,ZiWuZhen,532301106,23971,2619,15545,7920,31077,15348,5300,15907,31255,16345,31890
,CangLingZhen,532301107,20021,2587,13777,7527,26707,13597,5142,13650,27247,13973,27750
,SanJieZhen,532301108,16009,2035,11064,5559,22055,11003,4380,11184,22187,11360,22424
˽,BaJiaoZhen,532301109,12075,1464,7984,4064,15939,7919,2778,8089,16008,8333,16317
ɽ,ZhongShanZhen,532301110,17055,2052,11737,5827,23550,11639,4991,12193,23832,12361,24098
´,XinCunZhen,532301111,10233,1333,6897,3480,14081,6753,2704,7062,13815,7373,14270
,ShuJuXiang,532301201,13120,1754,8660,4461,17791,8573,3164,9044,17617,9378,18038
,DaGuoKouXiang,532301202,11721,918,7446,3751,15116,7394,2688,7718,15112,7881,15327
ػ,DaDiJiXiang,532301203,8121,747,5231,2580,10523,5121,1964,5447,10568,5601,10832
·,XiSheLuXiang,532301204,13079,1778,8815,4693,18049,8649,3591,9251,17900,9633,18448
׵,TuoDianZhen,532322101,33503,3452,21246,12740,38073,20179,7310,21485,41664,23019,44265
ׯ,DaZhuangZhen,532322102,19880,2412,12962,6927,25946,12893,4588,13729,26622,13918,26880
à,FaBiaoZhen,532322103,18268,2338,11605,6909,24079,11596,4050,12987,24583,13051,24656
,EJiaZhen,532322104,19893,2254,12935,7092,26138,12914,5088,14238,27152,14300,27235
,DaMaiDiZhen,532322105,7443,762,4673,2553,9525,4650,1836,5176,9826,5368,10041
,AnLongBaoXiang,532322201,7033,911,4400,2561,9100,4337,1506,4909,9246,5050,9450
ɽ,AiNiShanXiang,532322202,10024,1104,6330,3312,12631,6215,2067,6642,12857,6865,13195
,DuTianXiang,532322203,3174,303,1964,1056,4040,1945,668,2115,4060,2181,4145
,GongHeZhen,532323101,60421,6752,40664,22189,73582,38758,14494,38881,77639,41003,81667
,XinQiaoZhen,532323102,21199,2895,14057,7803,28454,14039,5200,15158,29197,15237,29294
,JiangPoZhen,532323103,19318,2434,12701,6637,25937,12582,4695,13413,25995,13746,26447
,FengTunZhen,532323104,12687,1781,8536,4222,17366,8472,3046,8858,17330,8978,17514
è,PanMaoXiang,532323201,8825,993,5744,3058,11167,5664,1938,5636,11300,6012,11756
,XuJieXiang,532323202,12910,1626,8570,4441,17082,8483,3288,8861,17344,9254,17824
,AnLeXiang,532323203,17497,2439,11497,6424,23724,11483,4288,12705,24188,12727,24224
,LongChuanZhen,532324101,63833,6539,42301,22695,76002,40721,15688,41394,82115,43759,86060
ɳ,ShaQiaoZhen,532324102,22240,2970,15812,7759,31160,15522,6600,15223,30745,15998,31810
,WuJieZhen,532324103,12631,1055,8993,4195,17617,8939,4332,8895,17834,9025,18018
,HongTuPoZhen,532324104,8655,1248,6071,3483,11994,6064,2554,6340,12404,6386,12457
,MaJieZhen,532324105,13519,1611,8967,4460,18168,8752,3361,9119,17871,9524,18491
ý,TuJieZhen,532324106,9738,1124,6453,3498,13286,6411,2690,6943,13354,7099,13552
¶,YuLouBaiZuZiZhiXiang,532324201,10372,1052,6957,3336,13893,6912,2752,7098,14010,7219,14176
һ,YiJieXiang,532324202,14005,1448,9567,5156,19097,9533,3992,9790,19323,9878,19445
ׯ,LuoWuZhuangXiang,532324203,8691,1026,5940,3096,11960,5924,2443,6139,12063,6220,12160
嶥ɽ,WuDingShanXiang,532324204,7036,942,4911,2602,9713,4893,1986,4975,9868,5053,9964
,DongChuanZhen,532325101,65253,8067,44114,23880,82753,42036,15161,42043,84079,44367,88481
»,GuangLuZhen,532325102,21447,3235,15231,7928,29612,14964,5451,14448,29412,14902,30133
ǰ,QianChangZhen,532325103,12563,1614,8229,4264,16713,8150,2832,8541,16691,8780,17009
,MiXingZhen,532325104,14454,2072,9726,5491,19626,9526,3536,10028,19554,10336,20062
̫ƽ,TaiPingZhen,532325105,7007,900,4513,2290,8998,4424,1413,4541,8965,4807,9320
,ShiZhongXiang,532325201,4044,551,2567,1375,5237,2512,720,2635,5147,2748,5315
,ZuoMenXiang,532325202,3393,363,2159,1094,4387,2115,720,2204,4319,2317,4476
,GuanTunXiang,532325203,11485,1340,7458,3893,15046,7352,2607,7713,15065,7974,15432
ӿ,DaHeKouXiang,532325204,5558,687,3588,1787,7329,3490,1203,3650,7140,3860,7448
,JinBiZhen,532326101,71004,9705,48112,26253,87931,45548,14930,44853,90401,47527,95639
ʯ,ShiYangZhen,532326102,19048,2558,12345,6968,24909,12243,4112,13207,25450,13373,25718
,LiuJuZhen,532326103,12784,1336,7400,5714,13224,7170,2471,8424,15594,9191,16591
,LongJieXiang,532326201,16661,2164,10899,5944,22438,10898,3828,11741,22639,11754,22653
Լҵ,ZhaoJiaDianXiang,532326202,11369,1580,7180,4280,14936,7151,2200,7823,14974,7969,15149
½,XinJieXiang,532326203,18418,2568,12279,6732,24851,12279,4287,12994,25273,12994,25273
꼻,TanHuaXiang,532326204,5674,656,3712,2385,7286,3712,1219,3837,7549,3837,7549
,GuiHuaXiang,532326205,8974,881,5696,3369,11379,5621,2108,5938,11559,6267,11963
,WanBiXiang,532326206,12994,1048,8428,4681,17329,8373,3412,8855,17228,9026,17454
,TieSuoXiang,532326207,7584,724,5032,2660,10125,4988,2005,5157,10145,5281,10313
̨,SanTaiXiang,532326208,8820,797,5791,3066,11353,5689,2173,5761,11450,5999,11790
,SanChaHeXiang,532326209,9839,1017,6454,3476,12954,6402,2367,6685,13087,6769,13223
,YongDingZhen,532327101,24439,2660,15987,10300,28274,15651,5733,16017,31668,16845,32832
˾,YiJiuZhen,532327102,12534,1600,8023,4571,16385,8011,2775,8769,16780,8886,16909
к,ZhongHeZhen,532327103,8669,1027,5331,3027,10414,5239,1751,5514,10753,6116,11447
,LianChiXiang,532327201,9913,1056,6682,3648,12631,6606,2597,6765,13371,6884,13566
ά,WeiDeXiang,532327202,8772,1076,5603,3059,11156,5601,1816,6046,11647,6061,11664
ͻ,MengHuXiang,532327203,7229,879,4661,2536,9146,4655,1493,4933,9588,4940,9601
,YongXingXiang,532327204,9920,1341,6242,3500,12715,6221,2024,6901,13122,7043,13285
Ԫ,YuanMaZhen,532328101,47406,5159,31764,17271,53976,29856,11371,30165,60021,32172,63936
ƹ԰,HuangGuaYuanZhen,532328103,27413,3090,18362,9165,35381,17941,7025,18513,36454,19166,37528
,YangJieZhen,532328104,12273,1417,8274,4584,16813,8157,3613,8804,16961,9029,17303
ϳ,LaoChengXiang,532328202,19101,2785,13163,6318,25915,12539,5197,13077,25616,13920,27083
ï,WuMaoXiang,532328203,11673,1402,7849,4211,14942,7761,2927,8016,15777,8153,16002
,JiangBianXiang,532328204,10420,1613,7302,3744,14288,6551,2727,6721,13272,7458,14760
»,XinHuaXiang,532328205,6017,717,3853,2090,7845,3726,1349,3990,7716,4230,8083
ƽ,PingTianXiang,532328206,10334,1143,6851,3593,13493,6798,2658,7133,13931,7284,14135
ɽ,LiangShanXiang,532328209,2546,188,1779,849,3440,1747,927,1817,3564,1882,3661
,JiangYiXiang,532328210,9548,1157,6473,3620,13020,6312,2599,6485,12797,6831,13304
ʨɽ,ShiShanZhen,532329101,69119,6659,45562,23352,77611,42650,17090,42270,84920,47306,92868
,GaoQiaoZhen,532329102,23979,2798,16800,8214,32281,16779,6981,16865,33644,16958,33758
è,MaoJieZhen,532329103,18579,2156,12597,6534,24944,12555,5312,13212,25767,13450,26047
,ChaDianXiang,532329201,16589,1853,11043,5813,21394,10989,4261,11350,22339,11660,22703
,TianXinXiang,532329202,12733,1425,8621,4451,16901,8582,3202,8596,17178,8739,17360
,FaWoXiang,532329203,9563,1071,6394,3540,12281,6379,2476,6677,13056,6716,13110
·,BaiLuXiang,532329204,10123,1168,6896,3625,13618,6879,2865,7207,14086,7260,14156
,WanDeXiang,532329205,10709,1196,7104,4103,14301,7094,2688,7459,14553,7489,14593
,JiYiXiang,532329206,10460,1110,6857,3914,13896,6844,2665,7340,14184,7378,14235
,HuanZhouXiang,532329207,7419,1000,5020,2842,9867,5015,1770,5156,10171,5169,10189
´,DongPoDaiZuZiZhiXiang,532329208,9496,1006,6345,3370,12381,6343,2442,6531,12874,6599,12944
ɽ,JinShanZhen,532331101,70998,7254,46026,28167,75911,42532,16792,43545,86077,49018,95044
,RenXingZhen,532331102,23982,2828,16430,8945,32101,16321,6939,16673,32994,17319,33749
̳,BiChengZhen,532331103,33140,3843,23348,11565,44528,22620,9594,22584,45204,23229,46577
ڷ,QinFengZhen,532331104,18810,2057,12579,7595,23830,12416,5282,12737,25153,13570,26149
һƽ,YiPingLangZhen,532331105,32108,5888,21929,15586,40353,21705,7480,22730,44435,23547,45476
ͨ,GuangTongZhen,532331106,30852,3483,20500,11876,37593,20016,7971,20613,40629,21806,42306
ھ,HeiJingZhen,532331107,10270,1783,7239,4402,14351,7148,2847,7475,14623,7661,14900
,TuGuanZhen,532331108,9206,1045,5957,3557,11223,5924,2359,6103,12027,6653,12610
,CaiYunZhen,532331109,11681,1754,8589,5051,16268,8504,3914,8573,17077,8760,17349
ƽ,HePingZhen,532331110,15211,1872,10592,6551,20664,10529,4743,10935,21464,11234,21826
ɽ,KongLongShanZhen,532331111,11677,1562,8307,4676,16236,8118,3864,8408,16526,8796,17103
д,ZhongCunXiang,532331201,11560,1426,7892,4580,15513,7885,3180,8147,16032,8274,16166
߷,GaoFengXiang,532331203,6332,720,4567,2689,8849,4548,2139,4536,9084,4624,9191
װ,TuoAnXiang,532331204,17303,2492,11826,6189,23654,11768,4529,12235,24003,12498,24324
ֵ´,ChengQuJieDaoBanShiChu,532501001,134943,19398,88398,59872,138297,81224,19988,76281,157505,85931,174329
,XiChengZhen,532501101,22046,1178,13694,8896,12646,13374,6520,14450,27824,16050,29744
ɳ,ShaDianZhen,532501102,14034,1136,8934,4336,12700,8330,3782,8631,16961,10018,18952
,JiJieZhen,532501103,41784,3912,27162,16193,44075,26282,11093,27333,53615,29627,56789
,DaTunZhen,532501104,59793,5458,35500,21673,54784,33602,12650,33916,67518,42401,77901
ϳ,LaoChangZhen,532501106,15799,634,8828,6908,9219,8729,5075,10204,18933,12680,21508
,KaFangZhen,532501107,30990,2435,20211,11150,31780,19571,10777,21367,40938,23991,44202
,ManHaoZhen,532501108,6529,320,3459,1748,4749,3178,1678,3333,6511,5068,8527
ɳ,JiaShaXiang,532501202,12160,1584,8327,4643,17157,8259,3917,9248,17507,9334,17661
,BaoHeXiang,532501203,7118,810,4737,2531,9400,4621,2240,5000,9621,5431,10168
ְ׵ֵ´,LeBaiDaoJieDaoBanShiChu,532502001,75009,5931,46628,28206,73729,43963,15751,43382,87345,50063,96691
Ȫֵ´,LingQuanJieDaoBanShiChu,532502002,68070,9589,45461,32920,66434,43474,13754,42830,86304,45952,91413
кӪ,ZhongHeYingZhen,532502101,26321,2469,18351,8517,36377,18075,8918,18657,36732,19357,37708
С̶,XiaoLongTanZhen,532502102,18438,1616,11630,7738,18571,11237,4932,11834,23071,13356,24986
ׯ,DaZhuangHuiZuXiang,532502201,14148,1196,9445,4273,17739,9151,4109,9154,18305,10008,19453
,YangJieXiang,532502202,26344,2390,18123,8642,34368,17980,7919,17984,35964,18530,36653
,BeiGeXiang,532502203,11257,1000,7348,3250,15366,7244,3532,8109,15353,8441,15789
,WenLanZhen,532503101,142464,11822,90080,54372,138342,84298,30844,83231,167529,95050,185130
ݰ,CaoBaZhen,532503102,27566,2846,18745,10333,32140,18561,7284,18629,37190,18951,37696
,YuGuoPuZhen,532503103,18797,1610,11575,6630,20003,11138,4396,11643,22781,13228,24803
°,XinAnSuoZhen,532503104,34906,2820,21423,8984,31415,16681,6082,17242,33923,22385,43808
ƴ,ZhiCunZhen,532503105,28136,2558,18997,9372,35811,18647,8726,19076,37723,20423,39420
,MingJiuZhen,532503106,13048,1123,9393,4164,17018,9304,5159,9772,19076,9937,19330
Ȫ,LengQuanZhen,532503107,14402,1408,9765,4641,19461,9645,4746,10480,20125,10791,20556
·,QiLuBaiMiaoZuXiang,532503201,10706,1139,7204,3654,14430,7075,3474,7874,14949,8115,15319
կ,LaoZhaiMiaoZuXiang,532503202,11386,824,6289,3384,10411,5825,3269,6547,12372,9190,15479
ˮ,ShuiTianXiang,532503203,3855,486,2530,1488,5330,2505,1145,2917,5422,2956,5486
,XiBeiLeXiang,532503204,6870,497,4926,2082,9824,4860,2762,5057,9917,5203,10129
,YuPingZhen,532523101,24679,2284,15824,10120,26591,15463,5859,16090,31553,16998,32822
,XinXianXiang,532523201,15601,1591,9916,5230,19681,9778,3967,10582,20360,11243,21159
ƽ,HePingXiang,532523202,19994,2494,13120,6272,26705,13091,4859,14139,27230,14227,27347
׺,BaiHeXiang,532523203,17564,1487,11377,6470,20661,11355,5062,12658,24013,12736,24113
,BaiYunXiang,532523204,12037,1400,7815,3724,15660,7786,2735,8309,16095,8357,16172
»,XinHuaXiang,532523205,13834,1320,8742,4476,18591,8740,3703,10108,18848,10115,18857
,WanTangXiang,532523206,10008,989,6420,3274,12550,6391,2497,6998,13389,7074,13494
ٰ,LinAnZhen,532524101,132032,14194,88289,48518,144484,82547,31077,80964,163511,89014,177303
,GuanTingZhen,532524102,25677,2797,17247,8294,34314,16963,8410,18104,35067,19637,36884
ׯ,XiZhuangZhen,532524103,23205,3209,16796,8799,30797,16225,6680,15786,32011,16298,33094
,QingLongZhen,532524104,10177,1325,7191,3747,13593,7022,3214,7244,14266,7525,14716
ׯ,NanZhuangZhen,532524105,33728,3376,22637,12798,44274,22359,9592,23339,45698,24059,46696
,ChaKeZhen,532524106,16341,2181,11649,6412,23080,11592,5583,12395,23987,12456,24105
,QuJiangZhen,532524107,49999,6485,35593,17638,68239,34695,14918,34847,69542,35809,71402
,MianDianZhen,532524108,28128,3260,19466,9707,36937,19315,7645,19375,38690,19567,39033
,PuXiongXiang,532524201,9060,984,6140,3167,11687,6085,2919,6578,12663,6823,12963
կ,LiHaoZhaiXiang,532524202,10170,1467,7495,4296,14708,7428,3468,7543,14971,7610,15105
ͷ,PoTouXiang,532524203,16003,1775,10362,5526,20992,10065,5044,11288,21353,12460,22822
̽,PanJiangXiang,532524204,7196,982,5069,2951,9791,5024,2279,5270,10294,5388,10457
,LiMinXiang,532524205,10014,1149,6612,3641,13047,6463,3064,6938,13401,7615,14227
β,DianWeiXiang,532524206,8465,1454,6292,3969,12255,6253,2730,6302,12555,6357,12649
,YiLongZhen,532525101,73992,8737,52089,28421,88032,50203,20194,48724,98927,50834,102923
,BaoXiuZhen,532525102,34154,4808,24919,13285,47382,24600,10613,24289,48889,24656,49575
,BaXinZhen,532525103,19047,2690,14122,7350,26150,14023,5566,13050,27073,13181,27303
,LongPengZhen,532525104,18015,2287,12925,7196,25423,12800,6115,13374,26174,13492,26417
,LongWuZhen,532525105,14608,1833,10036,5747,20586,10031,4639,11029,21060,11044,21080
ڳ,ShaoChongZhen,532525106,11709,1561,8408,4748,16699,8377,3953,8710,17087,8815,17223
ţ,NiuJieZhen,532525107,19317,2167,13420,7134,27062,13359,6859,14509,27868,14923,28343
³,XinChengXiang,532525201,7291,765,4958,2681,9788,4949,2169,5229,10178,5267,10225
,DaQiaoXiang,532525202,11002,1265,7551,4436,15360,7511,3758,8375,15886,8474,16025
,MiYangZhen,532526101,119656,11774,79619,44247,135513,74402,30905,76784,151186,82716,162335
,XinShaoZhen,532526102,41354,4709,28205,15679,51651,27932,12728,29632,57564,30586,58791
Ϫ,HongXiZhen,532526103,29612,3985,20800,12254,41699,20617,8817,21371,41988,21614,42414
԰,ZhuYuanZhen,532526104,38771,4027,26131,14781,50325,24999,10324,25486,50485,26991,53122
,PengPuZhen,532526105,34648,3827,23731,13161,45183,23608,9489,23897,47505,24233,47964
Ѳ˾,XunJianSiZhen,532526106,21886,2349,14719,7889,29046,14636,5924,15242,29878,15440,30159
һ,XiYiZhen,532526107,19935,2393,13155,6921,26429,12976,5097,13473,26449,14270,27425
,XiErZhen,532526108,28764,3350,19303,10909,39988,19223,8425,21075,40298,21236,40539
,XiSanZhen,532526109,17354,2143,11444,6034,22720,11292,4483,11792,23084,12536,23980
ɽ,DongShanZhen,532526110,13842,1419,8971,4695,18918,8875,4522,10524,19399,10812,19783
ɽ,WuShanXiang,532526202,13135,1593,9138,4344,18356,9100,3824,9367,18467,9414,18552
,JiangBianXiang,532526203,10454,836,7129,3333,14053,7054,3371,7308,14362,7532,14661
,ZhongShuZhen,532527101,93215,10109,62810,34907,109136,59356,27348,63375,122731,67862,130672
,JinMaZhen,532527102,35683,3850,24465,14482,50491,24334,12694,27516,51850,27762,52227
ɳ,JiuChengZhen,532527104,39858,4216,26968,15294,56169,26828,14267,30660,57488,31373,58341
,WuJiePuZhen,532527106,31129,4021,21586,11849,43423,21488,10519,23584,45072,24083,45669
ˮ,BaiShuiZhen,532527107,31469,3583,22428,11799,45102,21959,12349,24039,45998,24973,47401
,XiangYangXiang,532527201,17141,2343,12127,6735,24595,12050,7227,14380,26430,14584,26711
,SanTangXiang,532527202,11530,1909,8058,4456,16979,7976,4511,9565,17541,9892,17950
,YongNingXiang,532527203,14805,1811,10020,5626,20832,9759,5147,11264,21023,11743,21763
ɳ,NanShaZhen,532528101,19337,1349,12580,7399,20369,12109,5790,12910,25019,13896,26476
½,XinJieZhen,532528102,49560,5651,34878,16297,69098,34189,19361,38710,72899,39694,74572
ţկ,NiuJiaoZhaiXiang,532528202,18626,2288,13564,6836,28683,13547,7916,15233,28780,15266,28830
ɳ,ShaLaTuoXiang,532528203,12676,1466,9046,4285,19688,9031,5863,10848,19879,10959,20005
,GaNiangXiang,532528204,12891,1270,9698,4372,20230,9698,6361,10823,20521,10824,20522
³,ShangXinChengXiang,532528205,15401,1230,10967,5014,23029,10957,6618,12211,23168,12282,23249
С½,XiaoXinJieXiang,532528206,16902,1553,12551,5592,25873,12499,7951,13759,26258,13855,26406
괺,FengChunLingXiang,532528207,23318,2521,16068,7653,34015,15843,8753,18216,34059,18524,34592
ƺ,DaPingXiang,532528208,18475,1363,11996,6288,22842,11918,6975,14070,25988,14817,26813
֦,PanZhiHuaXiang,532528209,10800,1410,7956,3795,16812,7956,4879,9130,17086,9133,17089
é,HuangMaoLingXiang,532528210,12709,1334,8614,4088,18090,8612,4689,10105,18717,10118,18732
Ʋ,HuangCaoLingXiang,532528211,22232,2441,15322,7775,32830,15322,8545,17890,33212,17896,33218
,EZhaXiang,532528212,13667,1353,9305,4791,19918,9271,5294,10809,20080,11009,20314
,MaJieXiang,532528213,17215,2223,12023,5777,25375,11913,6521,13749,25662,13936,25959
,YiSaZhen,532529101,25308,2376,17495,9584,30732,17183,8083,17479,34662,18272,35767
,JiaYinXiang,532529201,16997,1855,12636,5666,25965,12514,7342,13296,25810,13558,26194
,BaoHuaXiang,532529202,13796,1652,10572,4929,21277,10550,6443,11202,21752,11319,21891
,LuoEnXiang,532529203,14951,1234,11627,5255,22514,11582,7326,11799,23381,11884,23511
ʯͷկ,ShiTouZhaiXiang,532529204,11046,1232,7882,3660,16691,7867,4491,8844,16711,8887,16769
,AZhaHeXiang,532529205,25239,2394,18290,8318,39609,18262,12195,21467,39729,21538,39828
,LeYuXiang,532529206,15457,1627,11420,5163,23231,11345,6571,12134,23479,12235,23655
˵,LangDiXiang,532529207,17302,2045,13624,6174,27441,13571,8512,14155,27726,14235,27859
,DaYangJieXiang,532529208,12056,1284,9075,4571,18785,9054,5835,10049,19103,10100,19175
,CheGuXiang,532529209,7991,748,6048,2626,12398,6006,4030,6641,12647,6721,12769
ܳ,JiaCheXiang,532529210,13796,1060,9887,4121,20277,9713,6085,10691,20404,11054,20941
,DieMaXiang,532529211,9551,666,7141,3229,14767,7107,4720,7720,14827,7796,14937
,SanCunXiang,532529212,8966,820,6029,3258,12720,5991,3398,7049,13040,7155,13184
,JinHeZhen,532530101,56497,5177,38582,19539,71195,37629,17984,39361,76990,41076,79658
ˮ,JinShuiHeZhen,532530102,15357,1123,10656,5089,20195,10591,5815,11450,22041,11639,22295
ͭ,TongChangXiang,532530202,20673,2191,14325,6403,29407,14271,8056,16191,30462,16595,30920
,MengLaXiang,532530203,23616,1927,16440,8031,31384,16184,8410,17140,33324,17513,33953
ϼկ,LaoJiZhaiXiang,532530204,17209,1691,11689,6034,24900,11652,6610,13691,25343,13821,25510
,ZheMiLaHuZuXiang,532530205,15009,1190,10853,4899,20644,10566,6282,11280,21846,11628,22481
ò,ADeBoXiang,532530206,10023,1103,7269,3178,14597,7224,4048,7764,14988,7905,15174
ɳ,ShaYiPoXiang,532530207,13463,1514,9373,4590,19227,9354,5105,10652,20006,10709,20082
կ,DaZhaiXiang,532530208,11765,887,7701,3710,15754,7499,3910,8178,15677,8861,16562
�,MaAnDiXiang,532530209,12964,1015,8855,4145,17741,8813,4467,9540,18353,9591,18446
,MengQiaoXiang,532530210,17600,1130,11183,5872,21826,11051,6020,12962,24013,13567,24750
Ӫ,YingPanXiang,532530211,20361,2374,13722,6522,27483,13676,7299,16052,29728,16312,30034
,LaoMengXiang,532530212,11150,1125,7446,3567,15334,7424,4087,8841,16265,8916,16362
,DaXingZhen,532531101,36332,3073,25155,12319,47082,24204,12407,25171,49375,26657,51812
,GeKuiXiang,532531201,13529,1214,9125,4560,19316,9042,5430,10600,19642,11048,20173
ţ,NiuKongXiang,532531202,23091,1940,15849,6826,32727,15628,8526,17415,33043,17708,33557
ˮ,DaShuiGouXiang,532531203,13408,1159,8420,4291,17862,8371,3583,9647,18018,9730,18150
ɽ,DaHeiShanXiang,532531204,14502,1255,9305,4536,19322,9270,4124,10491,19761,10576,19881
,BanPoXiang,532531205,7955,563,5049,2697,9993,4988,2441,5831,10819,5910,10959
,QiMaBaXiang,532531206,9164,955,6005,2901,12315,5991,2639,6640,12631,6753,12758
,SanMengXiang,532531207,17159,1674,12125,4993,24716,12078,6309,12914,24992,13017,25142
ƽ,PingHeXiang,532531208,20728,1788,14524,6319,29059,14473,7232,15141,29614,15224,29748
ӿ,HeKouZhen,532532101,29114,2397,17542,12203,24583,16676,5563,17075,33751,19532,37074
Ϫ,NanXiZhen,532532102,16100,1267,9972,6497,13498,9476,3850,10172,19648,11245,21217
Ϸկ,LaoFanZhaiXiang,532532201,3624,224,2175,1140,4032,2139,958,2297,4436,2631,4806
ͷ׳,QiaoTouMiaoZuZhuangZuXiang,532532202,11655,1344,8270,4344,15418,8188,3617,8248,16436,8346,16616
ɽ,YaoShanXiang,532532203,9772,641,5887,3321,10639,5791,2818,6701,12492,7344,13231
̲,LianHuaTanXiang,532532204,8376,495,5327,2986,8048,5177,2794,5742,10919,6338,11665
,KaiHuaZhen,532621101,169916,13398,109001,57703,150702,87212,37987,88628,175840,112300,221301
ľ,GuMuZhen,532621102,16055,1737,10592,5537,21388,10491,4471,11429,21920,11671,22263
ƽ,PingBaZhen,532621103,21883,2754,14840,7196,29744,14654,6491,16037,30691,16288,31128
,MaTangZhen,532621104,23000,2455,16516,8018,30699,16049,9067,16482,32531,18006,34522
º,DeHouZhen,532621105,22090,2219,16183,7792,30384,16019,8816,16589,32608,16942,33125
С,XiaoJieZhen,532621106,15783,2014,10252,5377,21546,10164,4383,11689,21853,11928,22180
,BaoZhuZhen,532621107,17897,1965,13114,6397,26641,13006,7447,14018,27024,14195,27309
׷,ZhuiLiJieZhen,532621108,6784,897,4700,2548,8980,4592,2159,4916,9508,5140,9840
ɽ,DongShanYiZuXiang,532621201,6652,742,4577,2222,9246,4546,2064,4842,9388,4881,9458
,LiuJingYiZuXiang,532621202,8257,1253,5947,3162,11770,5876,2882,6292,12168,6445,12392
½,XinJieXiang,532621203,7376,1297,5205,3000,10595,5176,2458,5866,11042,5926,11131
ϲ,XiGuXiang,532621204,6105,830,4594,2564,8963,4537,2430,4693,9230,4771,9365
,BaXinYiZuXiang,532621205,3569,524,2480,1594,5001,2454,1195,2742,5196,2808,5288
,BingLieYiZuXiang,532621206,13231,1394,9810,5026,19454,9756,5246,9956,19712,10061,19871
,HongDianHuiZuXiang,532621207,8365,879,6147,3246,11537,6099,3088,6124,12223,6185,12332
,JiangNaZhen,532622101,58206,4730,37959,20716,60722,36364,16512,36969,73333,41489,79448
ƽԶ,PingYuanZhen,532622102,59446,4989,43401,21221,79187,42756,23668,43860,86616,44702,88103
,JiaYiZhen,532622103,29371,2241,20207,9799,37482,19650,10305,20999,40649,21710,41917
,AMengZhen,532622104,36499,3324,25542,11386,51021,25370,13468,27430,52800,27749,53291
,ASheYiZuXiang,532622201,16490,1366,11387,5714,21290,11280,6500,12473,23753,12969,24356
άĩ,WeiMoYiZuXiang,532622202,34657,3434,24359,11070,48995,24053,13010,26265,50318,26742,51101
,PanLongYiZuXiang,532622203,21220,2232,14406,6879,29270,14240,6624,15486,29726,15670,30076
˸,BaGaXiang,532622204,22553,2605,15180,7363,30963,14981,6539,16142,31123,16517,31697
,ZheLaXiang,532622205,19680,1840,14000,6290,28138,13790,7354,14551,28341,14874,28874
,BangEXiang,532622206,8669,923,6100,2971,12314,6070,3205,6602,12672,6697,12797
ɺ,GanHeYiZuXiang,532622207,14727,1358,10526,4677,21281,10435,5516,10930,21365,11075,21601
,XiSaZhen,532623101,32999,3783,21944,11422,41635,21397,8736,22985,44382,23574,45518
˽,XingJieZhen,532623102,36356,4370,24638,11482,49459,23952,10279,25488,49440,26367,51005
,BangGuXiang,532623201,14599,2031,9985,4890,20713,9982,4316,10955,20937,10961,20946
,LianHuaTangXiang,532623202,16271,1941,11023,5352,22469,10910,4838,11807,22717,12027,23050
,XinMaJieXiang,532623203,11845,1473,8045,3854,16491,8010,3526,8741,16751,8799,16844
,BoLinXiang,532623204,8312,938,5529,2612,11390,5443,2461,6010,11453,6182,11711
,FaDouXiang,532623205,20789,2578,13680,6748,29022,13591,5926,15450,29041,15613,29293
,DongMaXiang,532623206,13636,1857,9438,4461,19266,9287,4508,10391,19678,10563,20001
,JiJieXiang,532623207,25379,2878,17209,8012,35953,17168,8661,19616,36784,19709,36918
,MaLiZhen,532624101,39819,4426,26275,13486,46284,24301,10266,25497,49798,28236,54511
ƺ,DaPingZhen,532624102,17345,2276,11690,5982,22960,11575,4947,12418,23993,12878,24568
,DongGanZhen,532624103,30903,4052,22576,10823,43698,22384,11589,23578,45962,23968,46544
챣,TianBaoZhen,532624104,14506,1660,9500,4714,18050,9153,3943,9834,18987,10609,20109
,MengDongYaoZuXiang,532624201,10617,1203,7134,3589,14090,7020,3483,7724,14744,8169,15303
½,XiaJinChangXiang,532624202,7488,1015,4981,2479,10349,4920,2245,5661,10581,5767,10748
˲,BaBuXiang,532624203,14364,1684,9587,4724,19397,9499,4339,10572,20071,10800,20387
,LiuHeXiang,532624204,10902,1438,7501,3783,15825,7450,3781,8485,15935,8620,16121
,YangWanXiang,532624205,11093,1323,7780,3996,15748,7718,3990,8435,16153,8626,16406
,TieChangXiang,532624206,19056,2653,13470,6307,26562,13406,6205,14290,27696,14444,27914
,MaJieXiang,532624207,17459,2236,11909,5729,24574,11861,5654,13303,25164,13440,25349
,MaBaiZhen,532625101,58270,5670,39310,21276,59346,37719,15594,37951,75670,40224,79534
կ,BaZhaiZhen,532625102,31194,3949,20644,11122,41413,20485,8612,22818,43303,23111,43755
ʺ,RenHeZhen,532625103,21472,2756,14397,6943,29208,14286,6062,15688,29974,15893,30290
ľ,MuChangZhen,532625104,16821,2273,11462,5615,23396,11377,5064,12519,23896,12696,24158
к,JiaHanQingZhen,532625105,25129,3133,17339,8698,35557,17185,8685,19115,36300,19608,36947
С,XiaoBaZiZhen,532625106,9272,1048,6362,3051,12699,6298,3133,6963,13261,7091,13453
,DouLongZhen,532625107,25716,2341,17654,9242,32897,17497,8904,18765,36262,19307,36961
,JinChangZhen,532625108,5962,628,4094,2166,7898,4079,1999,4443,8522,4495,8589
½,PoJiaoZhen,532625109,14977,2330,10217,5409,21156,10134,4646,11457,21591,11736,21953
,NanLaoXiang,532625201,9207,1077,5966,3102,12368,5835,2655,6553,12388,6973,12939
,DaLiShuXiang,532625202,21870,2952,14233,7265,29606,14154,5451,15876,30030,16040,30273
,MieChangXiang,532625203,11868,1589,7867,4070,16145,7825,3272,8746,16571,8862,16729
,GuLinQingXiang,532625204,8685,933,5582,3059,10315,5573,2308,6294,11867,6344,11926
,JinPingZhen,532626101,49193,4707,35161,18700,53847,33770,17846,34813,68583,36585,71746
Ի,YueZheZhen,532626102,21947,2540,16035,7080,31271,15935,8736,17019,32954,17188,33223
˫Ӫ,ShuangLongYingZhen,532626103,50895,4993,35632,15899,71790,35213,19302,38893,74106,39558,75190
˵,BaDaoShaoYiZuXiang,532626201,20987,2068,14773,6844,29733,14693,8290,16411,31104,16572,31345
,TianXingXiang,532626202,28350,2495,19847,8771,40771,19668,12159,22761,42429,23157,43004
ƽկ,PingZhaiXiang,532626203,22150,2326,15357,6798,32428,15211,9127,17989,33200,18246,33603
Ƥ,ShuPiYiZuXiang,532626204,27058,2448,19611,9642,39924,19426,12651,22106,41532,22546,42157
,NiJiaoYiZuXiang,532626205,16459,1776,12504,5994,23561,12419,8341,13952,26371,14072,26576
µ,XinDianYiZuXiang,532626206,12093,1189,8757,4359,17475,8689,5926,10000,18689,10451,19208
,SheDeYiZuXiang,532626207,11384,1212,7845,3760,16977,7821,4818,9487,17308,9569,17414
կ,GuanZhaiXiang,532626208,31172,3136,22511,10091,45794,22398,13381,24884,47282,25178,47689
,WenLiuXiang,532626209,23977,2741,17127,7669,34667,17045,9568,18930,35975,19159,36286
,LianChengZhen,532627101,71110,6748,48493,24635,83109,47315,23363,50133,97448,52728,101221
˱,BaBaoZhen,532627102,47488,4532,33412,15552,67089,32695,18645,36033,68728,37253,70665
,NanPingZhen,532627103,27508,2815,19394,8821,41114,19252,11648,22327,41579,22577,41971
,ZhuJieZhen,532627104,26682,2512,18719,7707,39592,18456,11429,21490,39946,21904,40623
,NaSaZhen,532627105,33976,3428,24016,11131,49973,23742,13495,26511,50253,26883,50899
,ZhuLinZhen,532627106,43444,4264,29883,13340,60826,29509,15606,32662,62171,33431,63314
,BaMeiZhen,532627107,44014,4119,29883,13912,61834,29738,16055,33683,63421,34305,64188
,DongBaoXiang,532627201,13906,1587,9766,4605,20121,9717,5410,10798,20515,11137,20903
Ī,JiuMoXiang,532627202,39794,4166,28327,11841,57477,28076,15231,30303,58379,30864,59191
,YangLiuJingXiang,532627203,25037,2635,16820,7690,34574,16642,8861,19308,35950,19713,36533
,BanBangXiang,532627204,9644,874,6918,3139,14183,6879,4294,7781,14660,7894,14812
,ShuGuangXiang,532627205,21078,2009,15435,5920,31740,15338,9514,16963,32301,17166,32601
֧,HeiZhiGuoXiang,532627206,34090,3253,23620,10511,49596,23498,14061,27550,51048,27784,51404
׭,ZhuanJiaoXiang,532627207,14004,1738,10343,5035,21540,10279,6455,11728,22007,11854,22197
,WuZhuXiang,532627208,18482,1787,12137,5678,25765,12062,6118,14117,26179,14250,26387
,ZheTuXiang,532627209,23478,2226,17886,8126,36433,17755,11822,19250,37005,19640,37526
̫,ZheTaiXiang,532627210,11597,940,8196,4194,17317,8138,5244,9455,17593,9585,17781
,DiWeiXiang,532627211,22198,1627,16739,7460,34710,16618,11408,18154,34772,18494,35233
»,XinHuaZhen,532628101,49189,3543,33193,17457,43867,31035,15244,32098,63133,34783,67976
鳯,GuiChaoZhen,532628102,26591,3004,19096,8882,37254,18917,9365,19287,38204,19864,38960
,BaoAiZhen,532628103,14994,1419,10516,4808,20338,10406,4758,10406,20812,10655,21171
,LiDaZhen,532628104,14330,1607,10525,4917,20949,10401,5921,11007,21408,11333,21858
,TianPengZhen,532628105,32491,4245,25006,12673,50388,24818,15249,26661,51479,26979,51985
ľ,MuYangZhen,532628106,32866,3445,24093,11248,47782,23927,13965,25867,49794,26183,50276
,BanLunXiang,532628201,16314,1946,11808,5766,23473,11649,6339,12195,23844,12791,24599
,GuLaXiang,532628202,14887,2054,11162,5192,21895,11120,5558,11228,22348,11337,22499
ɣ,ZheSangXiang,532628203,9925,958,6982,3388,13215,6901,3462,6921,13822,7363,14345
,NaNengXiang,532628204,12438,1255,8917,4044,17495,8835,4445,9006,17841,9221,18138
,DongBoYaoZuXiang,532628205,24386,2527,17465,8077,35045,17328,8789,18051,35379,18237,35702
,AYongXiang,532628206,12176,1089,8668,3807,17503,8628,4641,9079,17707,9238,17906
,HuaJiaXiang,532628207,14351,1473,10777,5070,21105,10734,6298,11198,21932,11345,22122
ʾֵ´,YunJingHongJieDaoBanShiChu,532801001,118694,7153,71381,49279,65900,63416,20907,63806,127222,75373,146754
,GaSaZhen,532801102,55451,6144,35331,20930,54630,33537,11708,34654,68191,37972,73303
,MengLongZhen,532801103,77741,7646,50326,27580,86833,49455,18033,51342,100797,53094,103420
º,MengHanZhen,532801104,32903,3101,21221,11723,32048,20777,7961,21719,42496,22744,43965
,MengYangZhen,532801105,20746,1755,13205,7451,19038,12429,4947,13037,25466,14243,27448
,PuWenZhen,532801106,20381,2050,13589,8727,16159,13490,5813,14516,28006,14655,28244
,JingHaXiang,532801202,17641,1273,11444,6443,17026,11312,5045,12120,23432,12515,23959
ګ,JingNeXiang,532801203,10610,1026,6564,3655,10675,6526,2409,7387,13913,7481,14045
ɸ,DaDuGangXiang,532801204,14425,1135,9287,5906,10527,9168,4039,10109,19277,10312,19599
,MengWangXiang,532801205,9028,701,6159,3390,8860,6144,3408,6944,13088,6978,13137
ŵ,JiNuoXiang,532801206,10630,928,6594,3869,11053,6513,2498,7266,13779,7462,14056
˫ݶɼίԱ,XiShuangBanNaZhouDuJiaQuGuanLiWeiYuanHui,532801501,6257,313,3435,1818,2819,2827,891,2920,5747,4026,7461
鹤ҵ԰,JingHongGongYeYuanQu,532801502,3477,342,2260,1166,3593,2237,725,2223,4460,2284,4544
º,MengHaiZhen,532822101,54146,4417,34843,19643,50391,33959,12265,34169,68128,35985,70828
,DaLuoZhen,532822102,19985,1673,13047,7031,21401,12961,5112,13546,26507,13723,26770
»,MengHunZhen,532822103,23300,2046,15242,7108,28318,15210,5598,15622,30832,15702,30944
,MengZheZhen,532822104,48295,4842,31471,15294,56826,31338,10382,31707,63045,32048,63519
,MengManZhen,532822105,14851,1253,9017,5291,17566,8958,3346,10153,19111,10433,19450
°,MengAZhen,532822106,17578,1561,11319,6075,20258,11227,4392,12068,23295,12212,23531
,MengSongXiang,532822201,16795,1623,10915,5257,20983,10824,4597,11818,22642,12100,23015
,MengWangXiang,532822202,10693,879,6883,3636,13424,6835,3059,7677,14512,7748,14631
ʺ,GeLangHeXiang,532822203,11334,1412,7155,3936,14184,7112,2427,7964,15076,8018,15173
ɽ,BuLangShanXiang,532822204,14324,906,9515,4640,18131,9323,5044,10335,19658,10759,20274
,XiDingXiang,532822205,17370,1653,11117,5839,18800,11101,4692,12481,23582,12598,23715
,MengLaZhen,532823101,42614,3499,27548,17449,38537,26880,10499,27684,54564,29064,56612
,MengPengZhen,532823102,48039,3313,30497,17973,43263,30124,11853,31975,62099,32708,63205
,MengManZhen,532823103,19269,1382,12481,7095,17556,12447,5131,13166,25613,13301,25782
,MengLunZhen,532823104,19949,1529,12874,7417,18566,12453,5129,13121,25574,13733,26607
,ShangYongZhen,532823105,13579,908,8861,4807,13546,8784,4060,9489,18273,9686,18547
°,MengBanZhen,532823106,9377,540,6516,3285,10624,6500,3818,7179,13679,7219,13735
,GuanLeiZhen,532823107,22519,1323,14406,8494,18429,14220,6596,15543,29763,16032,30438
,YiWuXiang,532823201,11759,991,8000,4396,12290,7963,4365,9013,16976,9115,17115
,XiangMingXiang,532823202,9566,761,6294,3406,8915,6282,3237,7215,13497,7270,13564
,YaoQuXiang,532823203,7547,417,4765,2650,7105,4722,2608,5311,10033,5807,10572
˫ĥÿ,XiShuangBanNaMoHanJingJiKaiFaQu,532823501,4251,206,2567,1361,2549,2340,1096,2551,4891,2986,5553
�ÿ쾮´,DaLiJingJiKaiFaQuTianJingBanShiChu,532901001,36113,2558,22677,13929,21980,19970,6761,19494,39464,22755,45432
�ÿ´,DaLiJingJiKaiFaQuManJiangBanShiChu,532901002,16178,1761,10902,5588,20427,10762,4066,10669,21431,11103,22005
¹,XiaGuanZhen,532901101,184774,19008,115930,73316,160757,104190,31523,102083,206273,119375,235305
,DaLiZhen,532901102,64457,7015,42864,20069,63733,35792,11094,34442,70234,39702,82566
,FengYiZhen,532901103,45759,5074,30757,14974,56530,29437,11057,28905,58342,31133,61890
ϲ,XiZhouZhen,532901104,38955,5427,28352,14906,52454,27634,10557,25983,53617,26587,54939
,HaiDongZhen,532901105,15091,1788,10377,5966,20198,10283,4395,10197,20480,10897,21274
ɫ,WaSeZhen,532901106,11628,1902,8295,4585,15837,8150,3343,7881,16031,8578,16873
,WanQiaoZhen,532901107,14284,2231,10642,5811,20295,10582,4269,10040,20622,10142,20784
,YinQiaoZhen,532901108,20172,2769,14072,6705,27328,13651,5061,13043,26694,13930,28002
˫,ShuangLangZhen,532901109,11607,1495,8021,4421,15924,7899,3370,8112,16011,8451,16472
Ϲ,ShangGuanZhen,532901110,27352,3475,19660,9487,38162,19491,8095,18972,38463,19262,38922
̫,TaiYiYiZuXiang,532901201,5738,599,3748,1958,7112,3721,1244,3699,7420,3833,7581
ɽ,CangShanXiZhen,532922101,30118,2995,19981,12121,38052,19636,7343,19995,39631,20475,40456
,YangJiangZhen,532922102,11243,1169,7430,4235,14717,7417,2860,7757,15174,7842,15272
ƽ,PingPoZhen,532922103,6249,633,4115,2180,8061,4071,1612,4231,8302,4379,8494
,FuHengXiang,532922201,6385,529,4110,2220,8359,4002,1663,4327,8329,4467,8577
̫ƽ,TaiPingXiang,532922202,5048,409,3190,1856,6416,3182,1260,3460,6642,3527,6717
˳,ShunBiXiang,532922203,4939,416,3010,1702,5975,2933,1167,3152,6085,3512,6522
߳,WaChangXiang,532922204,3873,411,2499,1588,5090,2499,903,2677,5176,2688,5187
̶,LongTanXiang,532922205,4631,432,2952,1978,6028,2952,1141,3252,6204,3252,6204
,JiJieXiang,532922206,3649,417,2334,1532,4777,2325,810,2519,4844,2542,4876
,XiangChengZhen,532923101,87218,9836,60426,32777,106591,57911,24905,57931,115842,61533,121959
ɳ,ShaLongZhen,532923102,21032,2888,15237,7746,30238,15199,6923,15540,30739,15606,30843
,YunNanYiZhen,532923103,64713,8650,46388,24097,91906,45499,20308,46390,91889,47283,93671
ׯ,XiaZhuangZhen,532923104,38089,4602,26654,13927,51470,25600,11263,26288,51888,27300,53954
,PuPengZhen,532923105,17730,2009,12439,6787,25124,12397,5741,12859,25256,13041,25480
,LiuChangZhen,532923106,23744,3528,17423,9395,34205,17418,7741,17571,34989,17590,35013
̵,HeDianZhen,532923107,30679,4038,22056,11130,43984,21939,9944,22316,44255,22605,44661
׵,MiDianZhen,532923108,19706,2174,13506,6869,26973,13377,6131,13805,27182,14505,28011
¹,LuMingXiang,532923201,9120,975,5937,3467,12379,5903,2594,6587,12490,6752,12689
ɽ,DongShanYiZuXiang,532923202,6601,734,4549,2508,9218,4544,1989,4766,9310,4775,9324
ţ,JinNiuZhen,532924101,71418,6743,47702,25031,86662,45976,18722,47168,93144,49181,96883
,BinJuZhen,532924102,26214,3439,17992,9009,35662,17882,6622,18127,36009,18283,36275
ݳ,ZhouChengZhen,532924103,33279,3646,21994,10562,43796,21389,8065,21910,43299,22996,44990
Ӫ,DaYingZhen,532924104,17346,2111,11780,6144,23236,11664,4691,12099,23763,12368,24148
ɽ,JiZuShanZhen,532924105,20349,2100,13981,6931,27373,13681,5740,13766,27447,14208,28189
,LiJiaoZhen,532924106,22813,2223,15394,7692,31186,15277,6389,15875,31152,16031,31425
ƽ,PingChuanZhen,532924107,26192,3021,16800,8580,34058,16048,5922,17211,33259,18335,35135
ǵ,QiaoDianZhen,532924108,15742,1564,10563,5494,21147,10519,4368,10938,21457,11111,21674
Ӣ,ZhongYingLiSuZuYiZuXiang,532924201,7901,641,4519,2483,8656,4259,1573,4665,8924,5596,10115
,LaWuYiZuXiang,532924202,7512,733,4801,2685,10095,4761,2034,5416,10177,5478,10279
ʷﻪȹ,CaiFengHuaQiaoGuanLiQu,532924501,1878,284,1271,826,2023,1251,421,1309,2560,1312,2583
̫ͻȹ,TaiHeHuaQiaoGuanLiQu,532924502,3467,270,2247,980,2953,1492,464,1444,2936,1954,4201
ӻȹ,BinJuHuaQiaoGuanLiQu,532924503,2149,270,1478,899,2271,1475,438,1376,2851,1379,2857
ֳ,MiChengZhen,532925101,64230,7203,44905,24214,78286,42807,17711,42585,85392,44239,89144
,HongYanZhen,532925102,33150,4041,23155,11960,45542,22843,9416,22853,45696,23452,46607
½,XinJieZhen,532925103,34459,4177,24547,12704,48269,24182,10810,24213,48395,24899,49446
,YinJieZhen,532925104,30886,3875,21738,11825,43151,21476,9232,21763,43239,22255,43993
,JuLiZhen,532925105,18034,2067,12416,6598,23930,11779,5140,12098,23877,12825,25241
,MiZhiXiang,532925202,10786,1514,7468,4270,15068,7416,3189,7919,15335,8021,15489
,DeJuXiang,532925203,16401,2199,11241,6505,22993,11196,4748,11999,23195,12107,23348
ţ,NiuJieYiZuXiang,532925204,14437,1681,9530,5147,19592,9442,3770,10151,19593,10358,19888
Ͻ,NanJianZhen,532926101,36817,3648,24691,13282,44438,23298,9618,23925,47223,25392,50083
С嶫,XiaoWanDongZhen,532926102,12580,1199,8802,4547,17126,8564,4325,8551,17115,9302,18104
,GongLangZhen,532926103,20356,2258,14418,8018,28455,14391,6390,14547,28938,14586,29004
,BaoHuaZhen,532926104,20427,2349,14189,7714,28686,14170,6235,14805,28975,14822,29011
ɽ,WuLiangShanZhen,532926105,24207,2788,16646,9244,33580,16638,7207,17525,34163,17556,34202
ӵ,YongCuiXiang,532926201,12594,1603,9008,4971,17750,8979,3803,8940,17919,8992,18000
,LeQiuXiang,532926202,11422,1409,7964,4539,15858,7948,3367,8198,16146,8234,16198
Ϫ,BiXiXiang,532926203,11736,1421,8312,4436,16507,8261,3674,8396,16657,8519,16831
گ,NanZhaoZhen,532927101,34217,4058,23372,12770,42466,22425,8193,22303,44728,23096,46468
,MiaoJieZhen,532927102,44361,4779,31079,15092,61811,30856,13400,31107,61963,31461,62540
,DaCangZhen,532927103,35563,3909,24778,12252,48393,24594,10195,24643,49237,24889,49667
,YongJianZhen,532927104,38260,3809,26903,13701,52988,26380,11901,26664,53044,27067,53970
Ρɽ,WeiBaoShanXiang,532927201,8519,933,5903,3354,11770,5896,2529,6056,11952,6078,11981
�ɽ,MaAnShanXiang,532927202,10987,1127,7761,3964,15519,7701,3683,7901,15602,8036,15797
Ͻ,ZiJinXiang,532927203,9399,927,6474,3504,12953,6471,2876,6673,13144,6728,13202
ӡ,WuYinXiang,532927204,17584,1726,11901,6784,24092,11893,5091,12467,24360,12500,24401
ţ,NiuJieXiang,532927205,8481,683,5736,3112,11237,5636,2475,5638,11274,5903,11639
໪,QingHuaXiang,532927206,10175,1180,7144,4351,14523,7121,3348,7522,14643,7559,14703
,BoNanZhen,532928101,41154,4537,27344,14263,50360,26496,9994,26725,53221,28341,55685
ɼ,ShanYangZhen,532928102,25924,3503,18520,9814,36211,18271,7943,18365,36636,18850,37370
,LongJieZhen,532928103,16581,1594,10925,5858,22121,10906,4475,11700,22606,11725,22650
,LongMenXiang,532928201,7959,974,5548,2849,10931,5468,2277,5585,11053,5662,11210
,BeiDouYiZuXiang,532928202,10012,951,6124,3624,12282,5991,2408,6396,12387,7247,13371
,ChangJieYiZuXiang,532928203,13312,1406,9021,4843,18089,9003,3841,9469,18472,9538,18559
ˮй,ShuiXieYiZuXiang,532928204,11929,1358,7771,4368,15855,7747,3031,8420,16167,8547,16318
ŵ,NuoDengZhen,532929101,20147,2386,12904,8693,22385,12028,3988,12459,24487,13617,26521
,JiuZhouZhen,532929102,26967,3003,15908,9396,30963,15230,6169,16580,31810,20231,36139
,CaoJianZhen,532929103,23897,2669,15605,9670,30640,15488,6213,16777,32265,17174,32779
ʯ,BaiShiZhen,532929104,9079,1028,6256,4103,12631,6256,2849,6689,12945,6700,12956
,BaoFengXiang,532929201,12218,1537,7935,4977,16230,7886,2975,8625,16511,8795,16730
ƺ,GuanPingXiang,532929202,8237,847,5492,3159,11078,5475,2310,5793,11268,5902,11394
Ž,TuanJieYiZuXiang,532929203,7857,763,5155,2832,10404,5041,2100,5363,10404,5565,10720
,ChangXinXiang,532929204,14884,1800,10193,6156,20395,10157,4271,10506,20663,10762,20955
,JianCaoXiang,532929205,10395,1470,6827,4576,13985,6780,2620,7492,14272,7658,14485
,BiaoCunLiSuZuXiang,532929206,6194,767,3742,2589,7372,3660,1509,4011,7671,4728,8470
,MinJianXiang,532929207,6280,710,4080,2344,8444,4062,1741,4587,8649,4651,8731
̺,ZiBiHuZhen,532930101,40565,4273,28166,14369,52666,26567,11408,25883,52450,28080,56246
˴,DengChuanZhen,532930102,13228,1264,8918,4265,15424,8047,3238,7863,15910,8812,17730
,YouSuoZhen,532930103,37797,3938,26322,13167,51451,26130,11498,26079,52209,26911,53233
Ӫ,SanYingZhen,532930104,25421,2773,17958,9627,34950,17785,7854,17689,35474,18090,36048
,FengYuZhen,532930105,18790,2552,14087,7879,27317,13970,6288,13270,27240,13543,27630
Ǻ,QiaoHouZhen,532930106,14673,1658,9935,5069,19973,9897,4075,10391,20288,10471,20406
ţ,NiuJieXiang,532930201,15129,1944,10494,5425,19805,10236,4434,9804,20040,11013,21507
,LianTieXiang,532930202,16373,1710,11218,6159,22162,11090,4723,11458,22548,11588,22806
ɽ,XiShanXiang,532930203,8874,907,6170,3358,12555,6163,2926,6518,12681,6537,12707
,JinHuaZhen,532931101,38779,4806,26496,13063,47981,25149,9938,24946,50095,27027,53523
Ͼɽ,LaoJunShanZhen,532931102,11722,1288,8305,4159,15878,8028,3788,7972,16000,8493,16798
,DianNanZhen,532931103,22584,3042,15670,7494,30115,15505,6113,15184,30689,16069,31739
ɳϪ,ShaXiZhen,532931104,15385,2035,10855,5147,21334,10732,4341,10703,21435,10906,21761
,MaDengZhen,532931105,13665,1654,9805,4937,19292,9697,4520,9705,19402,10034,19839
,YangCenXiang,532931201,8861,905,6291,3200,11938,6202,2904,6089,12291,6379,12670
ɳ,MiShaXiang,532931202,6095,620,4179,2055,8201,4132,1788,4185,8317,4324,8503
ͼ,XiangTuXiang,532931203,3537,366,2483,1308,4989,2454,1237,2561,5015,2657,5140
ƺ,YunHeZhen,532932101,20631,2494,14129,8131,20319,12671,4652,12250,24921,13648,27777
,XinTunZhen,532932102,24093,3194,17340,8594,34139,17313,7362,17278,34591,17309,34649
ɹ,SongGuiZhen,532932103,20223,2801,14374,7519,28375,14201,5876,14258,28459,14526,28900
ƺ,HuangPingZhen,532932104,23436,2331,16036,9822,32215,15982,7225,16893,32875,16956,32992
ݺ,CaoHaiZhen,532932105,28632,3607,21114,10047,39270,20119,9453,19706,39825,20578,41692
,XiYiZhen,532932106,10470,1113,7090,3398,13336,6633,2789,6687,13320,7282,14372
,LongKaiKouZhen,532932107,19320,2068,12421,6771,23695,11881,5069,12092,23973,14036,26457
,JinDunXiang,532932201,22638,3890,16587,9211,32176,16426,6595,16187,32613,16536,33123
,LiuHeYiZuXiang,532932203,11348,1354,7407,4127,14816,7293,2664,7556,14849,7959,15366
î,MengMaoZhen,533102101,88079,4285,53413,34610,53024,50039,20214,51148,101187,59165,112578
,WanDingZhen,533102102,10390,893,6847,4234,10076,6666,2623,6453,13119,7059,13906
Ū,NongDaoZhen,533102103,11384,817,7678,4348,11281,7537,3222,7359,14896,7745,15423
,JieXiangXiang,533102201,13027,1150,9050,5135,15053,9033,3807,8859,17892,8934,17984
,HuYuXiang,533102202,6606,611,4562,2783,7598,4526,1924,4542,9068,4579,9141
,MengXiuXiang,533102203,8683,630,5686,3077,9252,5621,2282,5658,11279,5909,11595
»ֵ´,MengHuanJieDaoBanShiChu,533103001,80140,6124,49888,28374,59464,41351,13706,39200,80551,50082,99970
â,MangShiZhen,533103101,33877,2902,22177,10412,37691,21540,9574,22626,44166,24176,46353
ڷ,ZheFangZhen,533103102,37564,3227,25476,12923,45480,25033,10686,25165,50198,26001,51477
,MengJiaZhen,533103103,16496,2087,11894,6471,21999,11847,5761,12395,24242,12450,24344
â,MangHaiZhen,533103104,3742,328,2771,1427,4599,2743,1571,2839,5582,2870,5641
ƽ,FengPingZhen,533103105,50425,4675,33939,15674,57104,33337,14486,33930,67267,35647,69586
,XuanGangXiang,533103201,14997,1432,10405,5100,19087,10303,5072,10841,21144,11096,21501
,JiangDongXiang,533103202,16867,2368,11840,6270,23996,11772,6005,13239,25011,13400,25240
ɽ,XiShanXiang,533103203,8913,685,5811,3381,9968,5730,2698,6188,11918,6485,12296
ɽ,ZhongShanXiang,533103204,6945,861,4698,2620,9133,4651,2364,5294,9945,5472,10170
̨ɽ,SanTaiShanXiang,533103205,5188,364,3326,1840,5817,3232,1516,3462,6694,3742,7068
·,WuChaLuXiang,533103206,11115,1254,7576,4058,15034,7485,3876,8195,15680,8669,16245
ڵ,ZheDaoZhen,533122101,17012,1476,10978,6154,15627,9820,3802,9841,19661,11312,22290
â,MangDongZhen,533122102,20570,2174,13796,7370,27230,13664,6843,14947,28611,15791,29587
,MengYangZhen,533122103,12767,1239,8240,4281,16377,8162,3365,8898,17060,9131,17371
ƽɽ,PingShanXiang,533122201,11294,1402,7767,3959,15577,7735,3513,8353,16088,8442,16209
С,XiaoChangXiang,533122202,6490,846,4483,2362,9074,4479,2079,4923,9402,4932,9415
,DaChangXiang,533122203,5611,754,3853,2129,7764,3833,1819,4297,8130,4331,8184
ű,JiuBaoAChangZuXiang,533122204,9476,1158,6633,3729,12400,6598,3039,6900,13498,7040,13673
ΰ,NangSongAChangZuXiang,533122205,13862,2077,9914,5820,19408,9888,4176,10123,20011,10201,20115
,HeXiXiang,533122206,12157,1623,8487,4921,16507,8476,3551,8695,17171,8844,17331
ƽԭ,PingYuanZhen,533123101,60694,4191,39044,22323,50292,36747,15596,37099,73846,41437,80481
ɳ,JiuChengZhen,533123102,16657,1313,9857,4894,18610,9700,4413,10225,19925,12526,22383
ǰ,NaBangZhen,533123103,2668,107,1526,897,1090,1463,720,1591,3054,1969,3495
Ū,NongZhangZhen,533123104,32931,2518,22372,10874,41500,22232,9821,22362,44594,22898,45270
յ,ZhanXiZhen,533123105,14964,1361,10421,5264,19679,10364,5190,10903,21267,11094,21515
,KaChangZhen,533123106,6783,400,4719,2212,7216,4560,2928,4936,9496,5392,10111
,XiMaZhen,533123107,7645,755,5631,2665,9354,5575,3340,5961,11536,6109,11740
̫ƽ,TaiPingZhen,533123108,21572,1870,14847,7354,25494,14714,6590,14682,29396,15185,30032
³,XinChengXiang,533123201,13076,1119,8547,4399,16251,8349,3947,8892,17241,9595,18142
,YouSongLingXiang,533123202,8228,1009,5601,2983,11631,5569,2905,6477,12046,6541,12142
â,MangZhangXiang,533123203,8114,701,5558,2781,10575,5479,2768,5856,11335,6025,11583
֧,ZhiNaXiang,533123204,9350,653,6540,3075,12158,6423,3762,6774,13197,7225,13765
յ,SuDianLiSuZuXiang,533123205,5534,339,3833,1980,6885,3751,2344,4010,7761,4384,8217
Ū,MengNongXiang,533123206,6492,572,4531,2241,8794,4500,2768,5224,9724,5301,9832
ͭڹ,TongBiGuanXiang,533123207,4554,299,3151,1618,5592,3103,1606,3232,6335,3308,6459
·,ZhangFengZhen,533124101,40155,2730,26327,13514,43084,24789,10485,24678,49467,27043,53370
¤,LongBaZhen,533124102,13153,1884,9063,5395,15774,9007,3437,9003,18010,9411,18474
,JingHanZhen,533124103,16315,1530,11818,6595,21286,11801,5691,11701,23502,11718,23536
,ChengZiZhen,533124104,17783,1667,12251,6415,21848,12189,5318,12339,24528,12517,24768
�,HuSaAChangZuXiang,533124201,15662,1190,11297,5300,21151,11100,5921,10900,22000,11476,22773
,HuGuoXiang,533124202,4200,428,2890,1574,5716,2880,1553,3265,6145,3291,6181
ƽ,QingPingXiang,533124203,7807,654,5348,2623,10110,5307,2559,5554,10861,5672,11020
,WangZiShuXiang,533124204,9906,903,6716,3172,13399,6707,3167,7235,13942,7260,13976
Լ,MengYueXiang,533124205,5344,367,3590,1937,5859,3545,1771,3802,7347,3892,7482
,LiuKuZhen,533321101,50360,2975,28471,15124,50462,24351,9678,24552,48903,34542,63013
³,LuZhangZhen,533321102,8977,905,5784,3326,10299,5458,2493,5727,11185,6591,12375
Ƭ,PianMaZhen,533321103,2544,85,1469,1046,1642,1380,617,1560,2940,1777,3246
Ͻ,ShangJiangXiang,533321201,19017,1529,13295,6756,24428,12931,6979,13470,26401,14230,27525
,LaoWoXiang,533321202,10006,1288,6571,3586,12855,6316,2713,6858,13174,7436,14007
˵,DaXingDiXiang,533321203,11529,1166,7628,4549,15438,7327,3550,7993,15320,8617,16245
Ƹ,ChengGanXiang,533321204,13619,1188,8825,4930,17201,8424,4205,9313,17737,10187,19012
ŵ,GuDengXiang,533321205,10926,1012,7456,3410,13964,6376,3845,7102,13478,8327,15783
屾׿,LuoBenZhuoXiang,533321206,9000,850,6469,2816,11776,5311,3779,6047,11358,7160,13629
,ShangPaZhen,533323101,21253,1642,14765,8251,26257,14500,7234,14751,29251,15364,30129
ƥ,PiHeXiang,533323201,7059,776,5069,2925,9545,5052,2599,5318,10370,5365,10434
,ZiLiJiaXiang,533323202,7026,693,5031,2609,8945,5007,2794,5381,10388,5482,10513
ܿƵ,JiaKeDiXiang,533323203,8698,742,6543,2945,12260,6531,3974,6831,13362,6871,13414
¹,LuMaDengXiang,533323204,9268,998,6943,3804,13018,6905,3629,6895,13800,6952,13895
ʯ,ShiYueLiangXiang,533323205,7935,823,5621,3252,10535,5596,2775,5839,11435,5912,11533
�,MaJiXiang,533323206,6314,650,4103,2686,7963,4066,1734,4502,8568,4595,8698
Ŀ,CiKaiZhen,533324101,11254,685,6806,4512,11614,6546,2539,6852,13398,7672,14478
,BingZhongLuoXiang,533324201,4755,320,3058,1810,5892,2990,1390,3249,6239,3407,6465
,PengDangXiang,533324202,4456,382,2808,1836,5556,2782,1247,3007,5789,3277,6085
,PuLaDiXiang,533324203,5120,450,3151,1925,6207,3103,1057,3252,6355,3476,6627
,DuLongJiangXiang,533324204,2893,231,1977,1069,3921,1949,1115,2126,4075,2262,4239
,JinDingZhen,533325101,40442,2723,26103,13837,39712,24137,10502,24752,48889,27564,53667
,LaJingZhen,533325102,9827,1009,6681,4273,12984,6665,3063,7129,13794,7218,13899
Ӫ,YingPanZhen,533325103,27679,2136,16252,9265,30213,15468,7591,16684,32152,21154,37406
ͨ,TongDianZhen,533325104,16913,1670,11472,6173,21135,11336,5333,11737,23073,12444,23916
,HeXiXiang,533325201,11970,1249,8069,4375,15096,8043,3772,8725,16768,8922,16991
,ZhongPaiXiang,533325202,16184,1573,10901,6304,20949,10822,5231,11666,22488,12087,22988
ʯ,ShiDengXiang,533325203,18434,1552,12089,6372,23219,11789,6162,12750,24539,14059,26148
ö,TuEXiang,533325204,12783,1258,8027,5252,16064,7902,3936,9027,16929,9950,17977
,JianTangZhen,533421101,52830,2026,30555,14934,35555,24851,10333,25100,49951,34634,65189
Се,XiaoZhongDianZhen,533421102,7125,688,5041,2089,9885,4925,2356,4954,9879,5128,10169
Ͽ,HuTiaoXiaZhen,533421103,14255,1347,9564,5000,17151,9097,4320,9235,18332,10358,19922
,JinJiangZhen,533421104,12145,1703,8221,4423,16070,8210,2890,8482,16692,8517,16738
Ͻ,ShangJiangXiang,533421201,7482,1084,4942,2757,9934,4797,1896,5158,9955,5520,10462
,SanBaXiang,533421202,13510,1484,8485,4129,16769,8237,3603,8637,16874,10112,18597
弪,LuoJiXiang,533421203,3433,327,2110,1138,3901,2028,964,2079,4107,2614,4724
,NiXiXiang,533421204,6223,671,3488,1266,6435,3298,1217,3341,6639,4623,8111
,GeZanXiang,533421205,6505,488,3506,1236,6243,3288,1391,3048,6336,4878,8384
,DongWangXiang,533421206,4667,554,3246,1054,6117,3169,1284,3129,6298,3259,6505
徳,WuJingXiang,533421207,2959,364,2000,861,3828,1913,864,1974,3887,2187,4187
ƽ,ShengPingZhen,533422101,9468,492,5066,2474,7874,4294,1635,4349,8643,6529,11595
,BenZiLanZhen,533422102,8374,893,4719,1672,8622,4457,1570,4530,8987,6118,10837
ɽ,FoShanXiang,533422201,2862,321,1940,842,3636,1858,715,1770,3628,1958,3898
,YunLingXiang,533422202,5376,454,2912,1083,5539,2720,1021,2720,5440,3939,6851
,YanMenXiang,533422203,5625,591,3609,1676,6862,3522,1175,3402,6924,3782,7391
϶,TuoDingXiang,533422204,7087,820,4812,2115,9174,4730,1789,4737,9467,4884,9696
ϼ,XiaRuoXiang,533422205,6080,672,4022,2033,7982,3982,1506,4116,8098,4236,8258
,YangLaXiang,533422206,6244,649,3561,1055,6004,3019,1170,2902,5921,4502,8063
,BaoHeZhen,533423101,10622,846,6562,3944,8656,6199,1978,6222,12421,6884,13446
Ҷ֦,YeZhiZhen,533423102,8262,758,5235,2772,10239,5146,2134,5566,10712,5919,11154
,TaChengZhen,533423103,12129,1234,7569,3652,14719,7415,2871,7705,15120,8665,16234
,YongChunXiang,533423201,24666,2344,16144,8682,31815,15993,6794,16899,32892,17660,33804
,PanTianGeXiang,533423202,11705,983,7388,3851,14782,7323,3077,7950,15273,8377,15765
׼Ѵ,BaiJiXunXiang,533423203,18098,1617,11863,5868,23094,11558,5700,12513,24071,13552,25415
,KangPuXiang,533423204,8131,788,5204,2811,10014,5112,2038,5386,10498,5753,10957
͵,BaDiXiang,533423205,7884,612,4174,2025,7459,3849,1488,3933,7782,5810,9984
·,ZhongLuXiang,533423206,7411,620,4787,2658,9935,4734,2285,5326,10060,5529,10316
ά,WeiDengXiang,533423207,9926,858,6384,3479,12926,6258,2746,6893,13151,7146,13530
ֵ´,ChongSaiKangJieDaoBanShiChu,540102001,5850,347,3624,2598,4623,3422,919,3261,6683,3492,7116
ֵ´,BaKuoJieDaoBanShiChu,540102002,10940,482,6356,4886,6790,5836,1322,5691,11527,6388,12744
սֵ´,JiRiJieDaoBanShiChu,540102003,17549,605,10879,6730,12577,8975,2868,8497,17472,10143,21022
ڽֵ´,JiBengGangJieDaoBanShiChu,540102004,25369,959,14765,10994,20187,13400,3656,13325,26725,15219,29984
ϸֵ´,ZhaXiJieDaoBanShiChu,540102005,26543,1272,15155,11457,17933,13425,3005,13629,27054,15665,30820
ֵֽ´,GongDeLinJieDaoBanShiChu,540102006,63518,2036,35848,22971,46778,26459,6693,26900,53359,36399,72247
깱ɣֵ´,GaMaGongSangJieDaoBanShiChu,540102007,16169,1200,9821,7064,11959,8858,2103,8560,17418,9651,19472
ֵ´,LiangDaoJieDaoBanShiChu,540102008,5338,125,2932,3110,1370,2722,291,2527,5249,2822,5754
̹,CaiGongTangXiang,540102200,6888,425,4347,2437,5866,4179,1487,4198,8377,4453,8800
ɽ,NaJinXiang,540102201,26675,639,10806,6672,17002,7977,2261,8693,16670,18769,29575
,NiangReXiang,540102202,22358,1108,12895,8113,13795,11032,2888,10979,22011,13459,26354
,DuoDiXiang,540102203,12651,541,7270,4579,10058,7069,1994,6887,13956,7916,15186
ʵ,GanDanQuGuoZhen,540121100,5759,521,4166,2135,7758,3975,1987,3834,7809,4101,8267
,ChunDuiXiang,540121200,3224,431,2452,893,4717,2396,1185,2282,4678,2388,4840
,SongPanXiang,540121201,2372,267,1815,741,3494,1740,884,1686,3426,1708,3523
ǿ,QiangGaXiang,540121202,3501,442,2778,974,5293,2693,1375,2476,5169,2540,5318
,KaZiXiang,540121203,3432,316,2466,1001,4830,2434,1247,2328,4762,2529,4995
߽,BianJiaoLinXiang,540121204,3283,292,2410,1070,4597,2367,1129,2251,4618,2294,4704
,JiangReXiaXiang,540121205,3588,383,2684,1148,5159,2658,1284,2541,5199,2571,5255
,ALangXiang,540121206,2554,386,1924,789,3819,1912,965,1925,3837,1981,3905
ƹ,TangGuXiang,540121207,2826,346,2123,802,4235,2070,1144,2163,4233,2193,4316
Զ,PangDuoXiang,540121208,3653,356,2298,882,4388,2206,1114,2246,4452,2825,5123
,DangQuKaZhen,540122100,3722,214,2534,1388,4520,2420,1266,2327,4747,2668,5202
˾,YangBaJingZhen,540122101,3155,273,2475,964,4902,2435,1589,2475,4910,2542,5017
,GeDaXiang,540122200,2905,194,2168,878,4211,2149,1202,2110,4259,2133,4301
,NingZhongXiang,540122201,5648,648,4447,1583,9024,4433,2803,4608,9041,4652,9099
,GongTangXiang,540122202,3713,411,2958,1214,5839,2931,1774,2876,5807,2940,5898
,LongRenXiang,540122203,2888,286,2374,895,4621,2356,1512,2286,4642,2312,4686
,WuMaTangXiang,540122204,4448,325,3663,1364,7234,3643,2630,3712,7355,3740,7403
ľ,NaMuHuXiang,540122205,3106,233,2441,1026,4608,2441,1518,2411,4852,2416,4857
,TaRongZhen,540123100,4508,395,3171,1634,5923,3024,1490,3012,6036,3222,6393
齭,MaJiangXiang,540123200,1850,160,1249,461,2588,1164,745,1288,2452,1506,2755
,PuSongXiang,540123201,1516,114,1054,311,2089,1032,478,1008,2040,1054,2108
,KaRuXiang,540123202,742,87,521,189,1070,474,272,544,1018,580,1101
ľ,NiMuXiang,540123203,3868,453,3009,1021,5936,2824,1687,2819,5643,2999,6008
,XuMaiXiang,540123204,3093,318,2294,867,4485,2281,1084,2187,4468,2201,4495
,PaGuXiang,540123205,2191,182,1503,524,3132,1405,786,1528,2933,1656,3159
̰,TunBaXiang,540123206,1503,139,1069,471,2117,1061,488,1052,2113,1061,2130
ˮ,QuShuiZhen,540124100,6696,522,3734,1991,7276,3521,1477,3439,6960,4961,8695
,DaGaXiang,540124200,4752,448,3815,1800,6821,3802,1850,3231,7033,3235,7050
,CaiNaXiang,540124201,3243,289,2224,964,4066,2063,939,2056,4119,2247,4471
ľ,NanMuXiang,540124202,2264,169,1545,574,2940,1447,723,1463,2910,1611,3156
,NieDangXiang,540124203,3624,221,2408,1302,4297,2297,1057,2242,4539,2494,4902
,ChaBaLaXiang,540124204,2413,266,1890,803,3527,1865,907,1669,3534,1696,3586
,DongGaZhen,540125100,10882,503,6288,4108,8186,5418,1986,5290,10708,7083,13371
,NaiQiongZhen,540125101,8538,537,5608,3365,9073,5315,2410,5053,10368,5877,11485
,YangDaXiang,540125200,3693,201,2354,1181,3786,2098,966,1909,4007,2506,4860
,GuRongXiang,540125201,4093,354,2757,1330,5408,2715,1316,2722,5437,3006,5763
,LiuWuXiang,540125202,4681,286,2565,1321,4301,2172,1060,2239,4411,3462,6027
,MaXiang,540125203,3152,257,2269,1054,4251,2238,1091,2103,4341,2231,4500
,DeQingXiang,540125204,4255,414,3123,1276,5905,3082,1574,2985,6067,3120,6243
,DeQingZhen,540126100,6783,427,4321,2855,8031,4167,1830,4251,8418,4719,9040
,TaJieXiang,540126200,1934,161,1430,713,2735,1429,728,1388,2817,1393,2823
¶,ZhangDuoXiang,540126201,2816,218,1806,923,3662,1806,924,1793,3599,2152,3958
Ƹ,TangGaXiang,540126202,3414,246,2434,1091,4840,2430,1294,2511,4941,2520,4954
ѩ,XueXiang,540126203,1869,130,1316,589,2510,1316,634,1314,2630,1317,2633
,BangDuiXiang,540126204,2271,214,1645,960,3184,1644,815,1654,3298,1655,3300
,GongKaZhen,540127100,4942,278,3154,1874,5906,3110,1273,3215,6325,3339,6493
ѩ,ZhaXueXiang,540127200,4362,487,3373,1056,6339,3351,2090,3476,6827,3566,6939
Ű,MenBaXiang,540127201,2470,203,1852,685,3271,1745,1002,1642,3387,1823,3675
,ZhaXiGangXiang,540127202,4943,348,3502,1348,6834,3452,1957,3663,7115,3746,7248
ն,RiDuoXiang,540127203,1558,105,1167,479,2341,1155,707,1175,2330,1203,2370
꽭,NiMaJiangReXiang,540127204,5524,525,4005,1437,7684,3840,2037,3846,7686,4081,8086
,JiaMaXiang,540127205,2588,224,1594,599,3254,1519,810,1645,3164,2028,3622
Ƽ,TangJiaXiang,540127206,4373,355,3063,1118,6008,3025,1513,3084,6109,3178,6241
ǹ,ChengGuanZhen,542121100,36835,1705,21318,11420,32932,18690,7321,18561,37251,24543,45861
,ELuoZhen,542121101,4618,380,3229,1552,6333,3222,1504,3270,6492,3273,6502
ŵ,KaNuoZhen,542121102,2865,264,2011,838,3867,2011,826,1944,3955,1944,3955
â,MangDaXiang,542121200,2407,257,1721,565,3566,1721,931,1874,3595,1874,3595
ɳ,ShaGongXiang,542121201,3445,425,2539,969,4949,2533,1209,2451,4984,2540,5079
,RuoBaXiang,542121202,2420,302,1620,690,3356,1617,678,1714,3331,1780,3400
,AiXiXiang,542121203,3010,353,2035,705,4284,2035,981,2309,4344,2309,4344
,RuYiXiang,542121204,2325,207,1696,717,3210,1662,871,1661,3323,1707,3403
ͨ,RiTongXiang,542121205,3387,402,2495,943,4649,2495,1136,2430,4925,2430,4925
ά,ChaiWeiXiang,542121206,5348,589,3645,1315,7161,3635,1401,3534,7169,3693,7338
װ,TuoBaXiang,542121207,4613,459,3571,1091,7269,3546,2314,3761,7307,3815,7386
,GaMaXiang,542121208,2626,334,1840,623,3793,1840,846,1966,3806,1966,3806
,MianDaXiang,542121209,4149,399,2932,1213,5965,2930,1447,3057,5987,3063,5995
Լ,YueBaXiang,542121210,2631,297,1803,636,3724,1803,808,1933,3736,1933,3736
,LaDuoXiang,542121211,4577,493,3528,1193,7137,3528,2105,3647,7175,3647,7175
,JiangDaZhen,542122100,3126,207,2132,942,3759,1956,922,1850,3806,2123,4255
,GangTuoZhen,542122101,2356,246,1716,524,2917,1689,882,1744,3433,1768,3484
˿,DengKeXiang,542122200,3928,264,2949,906,6210,2945,2037,3041,5986,3280,6229
ұ,YanBiXiang,542122201,2684,253,1909,570,3349,1903,915,1881,3784,1943,3852
,KaGongXiang,542122202,2782,325,1932,685,3879,1926,1068,1754,3680,2243,4175
,ShengDaXiang,542122203,6232,547,4990,1679,7808,4983,3440,4824,9807,5229,10219
,NiangXiXiang,542122204,1453,128,1076,321,1881,1066,619,1058,2124,1124,2200
,ZiGaXiang,542122205,4730,498,3483,1203,7171,3471,2119,3846,7317,3864,7347
ප,QingNiDongXiang,542122206,2705,230,1728,525,3266,1637,1063,1717,3354,2270,3998
�,WangBuDingXiang,542122207,5723,554,4291,1231,8637,4283,2393,4341,8624,4379,8670
µ,DeDengXiang,542122208,4168,352,2906,970,6129,2894,1630,2816,5710,3244,6150
ͬ,TongPuXiang,542122209,5429,429,4059,1236,8132,4028,2283,3997,8025,4082,8141
,BoLuoXiang,542122210,4814,611,3637,1091,6809,3626,1881,3657,7283,3669,7306
Ī,MoLuoZhen,542123100,7625,716,5253,2079,10173,5218,2685,5570,10788,5773,11026
,MinDouXiang,542123200,1019,160,837,253,1573,837,395,737,1574,737,1574
,ZeBaXiang,542123201,1968,139,1430,420,2844,1427,748,1384,2811,1425,2855
,LuoMaiXiang,542123202,1095,108,815,262,1663,815,468,856,1671,856,1671
ɳ,ShaDongXiang,542123203,1261,167,968,315,1961,964,583,1029,1993,1043,2011
,KeRiXiang,542123204,689,64,436,167,901,436,148,465,901,465,901
ľЭ,MuXieXiang,542123205,1159,126,842,258,1678,842,397,840,1682,840,1682
,AWangXiang,542123206,1277,172,884,346,1873,880,437,954,1834,1002,1886
,LaTuoXiang,542123207,1371,85,922,344,1930,922,478,1005,1927,1012,1934
,XiongSongXiang,542123208,1177,143,960,287,1824,960,505,865,1825,865,1825
,HaJiaXiang,542123209,4077,492,2934,837,5809,2934,1243,2878,5812,2878,5812
Ƥ,XiangPiXiang,542123210,4793,493,3619,1090,7257,3619,1971,3638,7257,3638,7257
ɣ,SangDuoZhen,542124100,7406,478,5802,2399,10993,5150,3863,5212,10362,5945,11747
,LeiWuQiZhen,542124101,4252,375,3332,1192,5921,3272,2273,3292,6564,3568,6900
,JiDuoXiang,542124200,3356,359,2603,853,5108,2398,1536,2492,4890,2648,5251
ɫ,GangSeXiang,542124201,1335,145,978,362,1987,867,507,901,1768,1009,1987
,BinDaXiang,542124202,1584,153,1268,485,2345,1107,819,1073,2180,1288,2556
,KaMaDuoXiang,542124203,2810,274,2364,743,4504,2349,1629,2284,4633,2349,4713
п,ShangKaXiang,542124204,2342,208,1772,571,3396,1668,955,1621,3289,1733,3505
,YiRiXiang,542124205,1781,149,1379,450,2702,1373,777,1312,2685,1328,2707
ɣ,JiaSangKaXiang,542124206,2473,237,1839,618,3661,1833,952,1677,3510,1823,3662
ë,ZhangMaoLingXiang,542124207,3992,439,3338,1098,6837,3319,2411,3485,6804,3504,6842
,DingQingZhen,542125100,7040,352,4854,2113,8833,4786,2636,4932,9718,5174,10028
߶,ChiDuZhen,542125101,5849,501,4538,1344,9364,4537,3113,4884,9421,4925,9463
ľ,MuTaXiang,542125200,803,70,682,196,1362,680,489,672,1352,680,1362
,BuTaXiang,542125201,1537,94,1092,291,2259,1092,628,1137,2229,1167,2259
ʹ,BaDaXiang,542125202,1476,97,1058,384,2148,1054,596,1081,2135,1111,2169
,GanYanXiang,542125203,1241,87,920,289,1908,915,611,986,1901,1019,1939
,GaTaXiang,542125204,2326,143,1719,537,3686,1718,1218,1933,3651,1968,3687
ɫ,SeZhaXiang,542125205,5355,298,4157,1195,8426,4136,2871,4307,8443,4367,8524
Э,XieXiongXiang,542125206,4535,325,3481,1033,7027,3458,2167,3368,6826,3546,7027
ɣ,SangDuoXiang,542125207,2522,175,1777,441,3782,1752,1100,1879,3631,2020,3797
,DangDuiXiang,542125208,4021,321,2999,798,5919,2988,1584,2903,5891,2927,5926
ɳ,ShaGongXiang,542125209,2429,174,1707,387,3794,1698,1191,1854,3552,2087,3794
,JiaoEnXiang,542125210,6690,570,4736,1302,9889,4719,2653,5126,9845,5177,9913
̶,YanDuoZhen,542126100,5320,573,3951,1718,7103,3837,1985,3754,7591,3927,7878
,JiTangZhen,542126101,2982,333,2238,857,4172,2219,1030,2094,4313,2107,4345
,XiangDuiZhen,542126102,5517,516,4143,1434,8230,4143,2269,4159,8302,4159,8302
ɳ,ZongShaXiang,542126200,3122,314,2240,714,3919,2239,1290,2468,4707,2486,4726
ͨ,KenTongXiang,542126201,1536,101,1052,488,2187,1052,552,1137,2189,1137,2189
,KuoDaXiang,542126202,3835,413,3066,962,5632,3061,1903,3083,6144,3085,6151
¿,XinKaXiang,542126203,797,99,546,212,1071,537,175,515,1052,525,1071
,WangKaXiang,542126204,3235,510,2390,855,4709,2390,964,2319,4709,2319,4709
,AZiXiang,542126205,1169,65,744,247,1646,741,412,893,1634,902,1646
,BaRiXiang,542126206,3178,243,2237,601,4479,2233,1171,2343,4576,2355,4592
,RongZhouXiang,542126207,3783,328,2960,843,5229,2960,1767,2918,5878,2918,5878
,KaGongXiang,542126208,2612,228,1898,639,3627,1891,842,1761,3652,1784,3682
,ChaLaXiang,542126209,1030,87,807,237,1589,805,503,812,1617,813,1620
,BaiMaZhen,542127100,4667,277,3016,1567,5518,2919,1458,2823,5742,3386,6402
Ȼ,RanWuZhen,542127101,2952,199,2195,682,4196,2173,1184,2109,4282,2140,4335
,BangDaZhen,542127102,1509,153,1081,350,2198,1079,622,1187,2266,1203,2284
ͬ,TongKaZhen,542127103,2934,290,2165,771,4230,2151,1163,2199,4350,2222,4387
ֿ,LinKaXiang,542127200,2182,213,1603,514,3202,1581,817,1565,3146,1609,3212
,XiaLiXiang,542127201,631,47,486,153,922,479,263,438,917,455,941
ӵ,YongXiang,542127202,765,66,600,176,1149,600,345,576,1176,576,1176
,WaXiang,542127203,449,26,311,108,627,311,176,340,651,340,651
,JiDaXiang,542127204,3038,253,2237,814,4340,2237,1079,2133,4370,2133,4370
߰,KaWaBaiQingXiang,542127205,165,17,119,27,249,117,67,125,242,130,249
,JiZhongXiang,542127206,872,71,670,177,1312,652,522,773,1425,795,1465
,YiQingXiang,542127207,1644,138,1266,454,2495,1266,820,1336,2602,1336,2602
,LaGenXiang,542127208,1367,101,1017,373,1939,1017,542,993,2010,993,2010
,GuoQingXiang,542127209,3229,267,2465,833,4719,2465,1441,2472,4937,2472,4937
,WangDaZhen,542128100,6301,413,4486,1993,8354,4388,2416,4497,8885,4644,9130
,TianTuoZhen,542128101,4310,344,3049,1029,5309,3037,1733,2970,6007,3338,6387
,ZhaYuZhen,542128102,4536,310,3266,1285,6327,3244,1653,3155,6399,3233,6499
,DongBaXiang,542128200,1616,191,1247,375,2351,1241,747,1284,2525,1307,2554
ֿ,ZhongLinKaXiang,542128201,4119,298,3036,1044,6027,3023,1622,2946,5969,3003,6039
,MeiYuXiang,542128202,2375,232,1959,623,3279,1892,1308,1940,3832,1956,3915
ֿ,XiaLinKaXiang,542128203,1848,132,1291,415,2385,1288,681,1357,2645,1370,2661
,BiTuXiang,542128204,1500,138,1142,392,1844,1133,595,1087,2220,1091,2233
ʹ,RenGuoXiang,542128205,2046,238,1352,431,2485,1346,623,1527,2873,1555,2907
ƽ,RaoJinXiang,542128206,1324,83,991,360,1731,985,588,997,1982,1004,1995
,GaTuoZhen,542129100,8911,634,5560,2526,10243,5470,2672,5759,11229,6657,12217
,RuMeiZhen,542129101,3503,343,2289,770,4723,2264,1209,2276,4540,2766,5055
ο,QuZiKaXiang,542129200,2545,252,1807,617,3575,1794,910,1796,3590,1900,3707
ľ,MuXuXiang,542129201,1753,228,1194,430,2443,1192,523,1169,2361,1310,2504
,NaXiMinZuXiang,542129202,3443,301,2341,1100,4756,2336,1196,2335,4671,2599,4940
,ZhuBaLongXiang,542129203,3157,347,2287,721,4546,2287,1330,2413,4700,2547,4834
,QuDengXiang,542129204,2420,199,1720,580,3609,1706,1045,1693,3399,1944,3664
,XuZhongXiang,542129205,3851,322,2495,819,5238,2495,1236,2597,5092,2914,5409
,BangDaXiang,542129206,5428,647,3780,1023,7640,3773,2107,4034,7807,4402,8182
겨,GeBoXiang,542129207,1839,146,1304,347,2737,1298,815,1299,2597,1496,2800
,LuoNiXiang,542129208,2375,255,1729,461,3349,1726,1044,1788,3514,1945,3674
,CuoWaXiang,542129209,5636,550,4187,1140,8120,4149,2460,4110,8259,4459,8646
,AngDuoXiang,542129210,1411,105,1013,307,2122,1013,640,1063,2076,1143,2156
,ZongXiXiang,542129211,3588,343,2359,660,5035,2336,1423,2567,4903,2995,5354
ç,MangLingXiang,542129212,1906,197,1448,448,3058,1445,982,1516,2961,1637,3085
,SuoDuoXiXiang,542129213,3455,447,2469,717,5114,2468,1270,2583,5051,2703,5172
,ZiTuoZhen,542132100,7116,417,5406,2270,10073,5386,3409,5453,10839,5536,10942
˶,ShuoDuZhen,542132101,2908,315,2441,818,4626,2415,1721,2378,4793,2503,4944
ɳ,KangShaZhen,542132102,3591,207,2871,870,5625,2856,1905,2806,5662,2832,5703
,MaLiZhen,542132103,2594,272,2243,579,3779,2243,1635,2258,4501,2258,4501
,YuXiXiang,542132200,766,56,582,203,1152,580,394,621,1201,634,1216
,XinRongXiang,542132201,2184,287,1779,502,2998,1768,1212,1814,3582,1904,3683
,DaLongXiang,542132202,781,89,601,165,1241,597,374,623,1220,643,1244
,LaJiuXiang,542132203,3410,232,2677,926,4907,2661,1712,2652,5313,2677,5354
,EXiXiang,542132204,3884,270,3065,1014,4336,3048,1986,2985,6033,3075,6140
,ZhongYiXiang,542132205,1847,185,1458,607,2289,1454,967,1508,2962,1541,2999
״,BaiDaXiang,542132206,478,37,380,116,743,374,250,376,750,385,765
ݿ,CaoKaZhen,542133100,5093,314,3396,1363,6226,3292,1843,3286,6578,3854,7250
߰,BianBaZhen,542133101,3296,294,2493,853,4818,2472,1442,2376,4848,2539,5032
,MaWuXiang,542133200,1548,77,1201,469,2255,1194,747,1144,2338,1171,2372
,ReYuXiang,542133201,1315,127,874,371,1735,870,356,880,1750,924,1798
ľ,NiMuXiang,542133202,1602,147,1252,426,2442,1243,786,1226,2469,1283,2535
ɳ,ShaDingXiang,542133203,1988,201,1633,487,3312,1623,1144,1665,3288,1700,3333
,JinLingXiang,542133204,2518,237,1853,647,3716,1842,970,1794,3636,1872,3725
ӹ,JiaGongXiang,542133205,637,50,461,146,879,454,270,433,887,496,957
,MaXiuXiang,542133206,1495,129,1156,380,2177,1142,709,1130,2272,1177,2333
,DouWaXiang,542133207,1835,188,1433,507,2735,1422,809,1351,2773,1399,2832
,LaZiXiang,542133208,2252,190,1763,603,3283,1754,1158,1775,3529,1837,3600
,ZeDangZhen,542221100,25346,939,14548,11833,21624,14008,4085,14289,28297,15822,30370
,ChangZhuZhen,542221101,4920,439,3348,1779,6487,3340,1262,3245,6585,3273,6621
,PoZhangXiang,542221200,5260,475,3623,2088,7143,3619,1439,3550,7169,3551,7174
,JieBaXiang,542221201,3278,322,2280,1120,4486,2249,908,2205,4454,2228,4508
,DuoPoZhangXiang,542221202,1263,131,882,385,1716,881,331,841,1722,843,1725
,SuoZhuXiang,542221203,1760,152,1190,647,2371,1189,462,1181,2370,1184,2374
Ƕ,YaDuiXiang,542221204,4970,395,3414,1896,6812,3410,1478,3427,6837,3429,6843
,ZhaTangZhen,542222100,6965,652,4754,2567,9043,4676,1878,4519,9195,4741,9495
ɣҮ,SangYeZhen,542222101,3324,289,2275,1104,4491,2234,1012,2245,4479,2350,4625
,AZhaXiang,542222200,1583,115,1102,483,2204,1077,551,1140,2217,1147,2249
,ZhaQiXiang,542222201,6336,648,4642,1951,8846,4636,2037,4315,8951,4379,9021
,JiRuXiang,542222202,7108,755,5101,2053,9973,5084,2220,4895,9979,4982,10083
,JiXiongZhen,542223100,3937,238,2340,1399,4607,2164,841,2076,4240,2676,5016
ڶ,GangDuiZhen,542223101,4744,475,3470,1482,6583,3398,1613,3175,6573,3362,6832
,JiaZhuLinZhen,542223102,6366,421,4122,1770,7363,3849,1672,3734,7583,4337,8459
,JiangTangZhen,542223103,3424,302,2434,1003,4683,2386,1126,2301,4687,2418,4852
ܵ,JieDeXiuZhen,542223104,5332,524,3822,1781,7275,3773,1652,3639,7412,3686,7508
ʽѧ,LangJieXueXiang,542223200,4668,421,3173,1338,6190,3147,1293,3185,6332,3209,6382
,ChangGuoXiang,542223201,1982,185,1332,590,2601,1295,615,1323,2618,1450,2782
,DongLaXiang,542223202,2569,216,1919,779,3518,1914,1092,1928,3842,1958,3877
ɣ,SangRiZhen,542224100,3505,234,2229,1467,4618,2219,981,2403,4622,2491,4720
,ZengQiXiang,542224200,3090,210,2169,1030,4321,2169,1039,2170,4339,2170,4339
׶,BaiDuiXiang,542224201,1364,96,960,488,1843,960,386,886,1846,886,1846
,RongXiang,542224202,4621,425,3113,1412,5978,3025,1310,3007,6032,3243,6356
,QiongJieZhen,542225100,3867,326,2571,1667,4758,2528,962,2374,4902,2584,5155
,LaYuXiang,542225200,3155,330,2307,1059,4247,2295,965,2134,4429,2143,4450
ˮ,XiaShuiXiang,542225201,2242,239,1605,745,3059,1599,677,1544,3143,1553,3158
,JiaMaXiang,542225202,3123,287,2284,1099,4182,2273,920,2035,4308,2046,4330
,QuSongZhen,542226100,4432,360,2993,1980,5862,2913,1367,2997,5910,3166,6159
޲ɳ,LuoBuShaZhen,542226101,820,59,576,350,1169,563,304,587,1150,607,1183
཭,QiuDuoJiangXiang,542226200,1672,98,1213,666,2396,1212,657,1204,2416,1214,2427
,DuiSuiXiang,542226201,1824,156,1387,703,2677,1372,709,1273,2645,1302,2689
½,XiaJiangXiang,542226202,1232,90,923,486,1787,911,500,896,1807,899,1822
,CuoMeiZhen,542227100,3656,308,2446,1541,4550,2396,962,2346,4742,2480,4926
ܹ,ZheGuZhen,542227101,3521,265,2576,1163,4746,2561,1254,2387,4948,2464,5040
,NaiXiXiang,542227200,1646,188,1134,674,2172,1123,420,1094,2217,1120,2254
Ŷ,GuDuiXiang,542227201,1057,56,710,375,1340,707,308,705,1412,711,1421
,LuoZhaZhen,542228100,4239,303,2785,1555,5529,2727,1154,2657,5384,2911,5696
,LaKangZhen,542228101,1279,110,921,463,1783,909,410,852,1761,878,1799
,ShengGeXiang,542228200,2160,165,1486,690,2936,1478,640,1462,2940,1479,2965
߰,BianBaXiang,542228201,929,62,662,338,1296,648,315,595,1243,644,1306
,ZhaRiXiang,542228202,3240,299,2267,1128,4366,2247,921,2117,4364,2193,4460
ɫ,SeXiang,542228203,1438,139,1009,474,2010,988,452,924,1912,1020,2029
,LaJiaoXiang,542228204,144,8,108,48,198,106,46,85,191,90,198
Ӳ,JiaChaZhen,542229100,2309,163,1666,843,3253,1654,789,1572,3226,1595,3261
,AnRaoZhen,542229101,6512,232,3178,1777,4905,2742,1265,2722,5464,4831,8009
,LaSuiXiang,542229200,2580,218,1877,975,3694,1867,906,1812,3679,1827,3704
޾,CuiJiuXiang,542229201,419,26,305,159,618,303,175,301,604,315,620
,BaXiang,542229202,829,48,612,283,1221,612,394,656,1268,659,1271
,LengDaXiang,542229203,1562,144,1158,618,2244,1151,539,1072,2223,1087,2245
,LuoLinXiang,542229204,3079,271,2082,1022,4088,2059,974,2038,4097,2242,4324
¡,LongZiZhen,542231100,5936,378,3788,2521,7001,3753,1464,3720,7473,3990,7778
յ,RiDangZhen,542231101,6097,363,3940,2102,7470,3898,1880,3854,7752,4400,8340
,JiaYuXiang,542231200,2460,220,1734,1025,3222,1734,661,1607,3341,1607,3341
,LieMaiXiang,542231201,1638,148,1047,664,2163,1047,406,1145,2192,1145,2192
,ReRongXiang,542231202,2813,132,1961,1129,3785,1961,951,1935,3896,1935,3896
,SanAnQuLinXiang,542231203,1987,134,1405,844,2634,1405,719,1435,2840,1435,2840
׼,ZhunBaXiang,542231204,318,28,212,128,430,212,89,223,435,223,435
,DouYuXiang,542231205,397,39,315,174,556,315,156,277,592,277,592
ѩ,XueSaXiang,542231206,2819,257,2084,956,3975,2084,1087,2079,4163,2079,4163
,ZhaRiXiang,542231207,362,25,259,168,503,259,144,272,531,272,531
,YuMaiXiang,542231208,23,0,15,12,33,15,10,18,33,18,33
,CuoNaZhen,542232100,2616,119,1431,1091,2488,1347,497,1390,2737,1801,3232
Ű,LeMenBaMinZuXiang,542232200,125,10,86,66,159,86,36,85,171,85,171
Ű,GongRiMenBaMinZuXiang,542232201,138,16,98,68,184,98,36,92,190,92,190
Ű,JiBaMenBaMinZuXiang,542232202,164,17,126,81,234,126,60,115,241,115,241
Ű,MaMaMenBaMinZuXiang,542232203,183,6,119,82,209,117,38,105,222,108,227
,KuJuXiang,542232204,287,12,216,88,394,216,113,194,410,196,412
׿ľ,QuZhuoMuXiang,542232205,2747,248,2023,1056,3709,2020,857,1826,3846,1829,3852
,LangPoXiang,542232206,236,24,165,118,320,165,67,162,327,162,327
,JiaoLaXiang,542232207,3393,419,2359,1417,4447,2344,669,2098,4442,2122,4481
,KaDaXiang,542232208,1561,164,1063,675,1970,1061,266,922,1983,928,1991
˿,LangQiaZiZhen,542233100,3393,212,2107,1396,4273,2081,955,2323,4404,2453,4560
¡,DaLongZhen,542233101,3302,216,2355,1192,4612,2346,1154,2297,4643,2317,4672
꽭,PuMaJiangTangXiang,542233200,685,20,487,263,973,487,274,492,979,492,979
ȴ,DuoQueXiang,542233201,3871,276,2800,1205,5495,2794,1481,2813,5607,2828,5628
,KaLongXiang,542233202,1373,127,973,482,1910,973,450,977,1950,977,1950
,AZhaXiang,542233203,1413,144,1053,450,2009,1044,459,936,1980,963,2016
ѧ,GongBuXueXiang,542233204,4443,291,3196,1490,6505,3172,1771,3265,6437,3309,6505
,KaReXiang,542233205,1768,147,1279,639,2513,1271,627,1237,2508,1263,2542
׵,BaiDiXiang,542233206,1445,142,1008,452,2026,1001,451,1007,2008,1030,2038
Ŵ,ZhangDaXiang,542233207,2639,181,1933,638,3759,1931,1057,1933,3864,1944,3877
Ǳ´,ChengBeiBanShiChu,542301001,10142,625,7190,4155,11912,7154,2343,5640,12794,5920,13110
ϰ´,ChengNanBanShiChu,542301002,42301,1944,24910,17336,37017,22550,6612,21066,43616,25947,50857
,QuMeiXiang,542301200,4130,321,2726,933,5910,2707,1547,3077,5784,3272,5998
,NieRiXiongXiang,542301201,3592,258,2353,737,4919,2318,1269,2572,4890,2766,5119
,QuBuXiongXiang,542301202,3666,259,2566,785,5421,2566,1503,2862,5428,2862,5428
,LianXiang,542301203,3292,263,2235,711,4771,2224,1268,2562,4786,2588,4823
״,JiaCuoXiongXiang,542301204,8044,597,5792,1906,11930,5754,3305,6060,11814,6154,11946
ɶ,NaErXiang,542301205,1433,108,985,327,2058,985,523,1079,2064,1079,2064
ľ,NianMuXiang,542301206,2264,189,1614,527,3297,1614,894,1733,3347,1733,3347
,DongGaXiang,542301207,5964,493,4021,1377,8572,3997,2168,4578,8575,4604,8625
,BianXiongXiang,542301208,2767,200,2020,628,4070,2015,1139,2072,4087,2086,4106
,JiangDangXiang,542301209,3371,297,2266,710,4873,2252,1283,2633,4885,2685,4951
ľ,NanMuLinZhen,542322100,7098,519,4796,2283,9651,4553,2411,4680,9233,5232,10028
յ,PuDangXiang,542322200,2161,195,1529,586,3221,1508,871,1683,3191,1698,3227
ʶ,RenDuiXiang,542322201,961,69,694,318,1355,691,326,648,1339,662,1356
,LaBuPuXiang,542322202,1372,88,977,374,2061,973,601,1078,2051,1084,2061
,DuoJiaoXiang,542322203,3317,257,2311,811,4816,2274,1286,2505,4779,2549,4860
,KaZiXiang,542322204,3717,252,2515,958,5440,2500,1504,2945,5445,2958,5473
,TuBuJiaXiang,542322205,3721,308,2706,985,5593,2701,1578,2860,5561,2901,5607
,AiMaXiang,542322206,6454,464,4689,1753,9594,4689,2694,4914,9603,4923,9612
ū,NuMaXiang,542322207,2017,166,1322,493,2958,1322,784,1621,2943,1645,2967
,DaZiXiang,542322208,2813,255,2000,771,4160,1997,1163,2226,4223,2231,4231
,SuoJinXiang,542322209,2322,195,1626,533,3427,1622,917,1802,3424,1808,3434
,ChaErXiang,542322210,1553,151,1188,472,2388,1187,700,1216,2403,1216,2404
ľ,QiuMuXiang,542322211,1588,106,1115,459,2282,1108,608,1181,2289,1187,2302
,DaNaXiang,542322212,1682,155,1156,440,2444,1137,611,1243,2380,1292,2448
â,MangReXiang,542322213,2024,165,1411,579,2935,1409,767,1520,2929,1545,2956
ȵ,ReDangXiang,542322214,4955,442,3389,1233,7292,3380,1913,3887,7267,3921,7310
״,JiaCuoXiang,542322215,3178,295,2232,777,4610,2185,1181,2376,4561,2422,4654
,JiangZiZhen,542323100,8563,564,5438,2923,9991,4975,1912,4503,9478,5601,11039
,NaRuXiang,542323200,2735,268,1990,679,3798,1962,995,1990,3952,2008,3998
,KaMaiXiang,542323201,3520,339,2543,788,5019,2517,1315,2611,5128,2631,5174
,KaDuiXiang,542323202,3422,332,2535,808,4815,2533,1288,2486,5019,2507,5042
ظ,CangGaiXiang,542323203,1621,134,1198,403,2231,1191,554,1099,2290,1111,2309
,RiLangXiang,542323204,750,68,549,197,1049,547,251,509,1056,520,1069
,DaZiXiang,542323205,1715,114,1192,422,2352,1161,654,1269,2430,1291,2483
,ReSuoXiang,542323206,2232,166,1614,595,3138,1598,846,1609,3207,1630,3244
,ZhongZiXiang,542323207,2988,261,2157,799,4112,2138,983,2040,4178,2075,4232
,LongMaXiang,542323208,1251,96,832,299,1665,829,385,885,1714,900,1732
Ͻ,ZiJinXiang,542323209,2453,144,1712,596,3312,1687,827,1685,3372,1712,3424
,JiangReXiang,542323210,3091,151,2172,701,4106,2131,1000,2030,4161,2070,4242
,NianDuiXiang,542323211,2274,156,1699,602,3204,1673,884,1591,3264,1615,3314
׿,KangZhuoXiang,542323212,1531,102,1109,347,2122,1100,565,1071,2171,1089,2198
,JinGaXiang,542323213,1741,154,1247,507,2444,1245,612,1248,2493,1260,2507
,RiXingXiang,542323214,1546,132,1038,347,2166,1036,548,1158,2194,1188,2226
,ReLongXiang,542323215,1419,85,1076,399,1957,1076,539,959,2035,967,2043
,CheRenXiang,542323216,1878,134,1308,456,2550,1302,591,1276,2578,1295,2603
ӿ,JiaKeXiXiang,542323217,429,31,304,119,607,304,164,320,624,320,624
Э,XieGeErZhen,542324100,6859,357,4658,2538,9051,4628,2312,4722,9350,4870,9528
ڸ,GangGaZhen,542324101,4650,356,3312,1361,6703,3252,1844,3480,6732,3538,6850
Ӵ,JiaCuoXiang,542324200,908,56,629,249,1286,628,355,687,1315,690,1319
Ͻ,RongXiaXiang,542324201,485,44,398,178,753,393,254,368,761,385,783
Ͻ,NiXiaXiang,542324202,1201,77,910,359,1588,902,549,897,1799,917,1827
,PenGuXiang,542324203,932,92,724,269,1433,719,429,705,1424,729,1453
,QuDangXiang,542324204,3612,290,2971,1255,5788,2966,2001,2897,5863,2932,5903
,ZhaGuoXiang,542324205,1536,92,1125,461,2278,1125,657,1159,2284,1160,2285
,ZhaXiZongXiang,542324206,4260,330,3380,1265,6680,3347,2132,3312,6659,3342,6722
,ChangSuoXiang,542324207,2502,169,1759,721,3396,1759,930,1842,3601,1842,3601
,QuLuoXiang,542324208,2051,132,1474,562,3031,1456,850,1539,2995,1559,3033
,CuoGuoXiang,542324209,2474,126,1790,747,3472,1790,956,1766,3556,1766,3556
,KeMaXiang,542324210,2601,211,1901,720,3958,1901,1146,2057,3958,2057,3958
,SaJiaZhen,542325100,3402,268,2284,1160,4613,2132,1088,2073,4205,2474,4758
,JiDingZhen,542325101,4204,376,3056,1143,6134,2955,1602,2993,5948,3126,6182
ľ,MuLaXiang,542325200,2259,151,1484,623,3183,1484,774,1700,3184,1700,3184
,ChaRongXiang,542325201,2782,286,1915,699,3976,1802,934,1943,3745,2087,4002
,LaLuoXiang,542325202,2575,187,1737,718,3621,1728,865,1865,3593,1890,3627
,SaiXiang,542325203,2401,197,1602,637,3446,1536,859,1769,3305,1855,3457
,CheXiuXiang,542325204,3498,242,2472,916,5106,2472,1371,2639,5111,2639,5111
,ZhaXiGangXiang,542325205,3026,206,2234,928,4439,2145,1277,2144,4289,2275,4509
,XiongMaXiang,542325206,4064,299,2766,869,5766,2632,1433,2866,5498,3030,5796
鲼,MaBuJiaXiang,542325207,2934,217,2069,848,4259,1973,1145,2057,4030,2227,4296
,XiongMaiXiang,542325208,1600,91,1196,484,2359,1196,691,1186,2382,1186,2382
,QuXiaZhen,542326100,4670,201,3060,1563,5582,2933,1392,2773,5706,3203,6263
,LaZiZhen,542326101,3955,251,2942,1120,5837,2900,1664,2835,5735,2928,5870
,ZhaXiZongXiang,542326200,1804,148,1321,518,2729,1314,785,1392,2706,1416,2737
,QuMaXiang,542326201,2931,210,2186,723,4518,2182,1400,2333,4515,2355,4541
,PengCuoLinXiang,542326202,2435,209,1777,689,3661,1744,1070,1902,3646,1937,3714
,ZhaXiGangXiang,542326203,4181,332,3046,1088,6340,3039,1845,3279,6318,3312,6358
,LiuXiang,542326204,2345,197,1739,662,3512,1728,1001,1768,3496,1804,3543
ɯ,ReShaXiang,542326205,2214,207,1653,566,3431,1643,1024,1768,3411,1792,3445
â,MangPuXiang,542326206,2277,165,1687,676,3368,1679,951,1665,3344,1706,3393
,XiQinXiang,542326207,3884,254,2832,1151,5673,2832,1592,2877,5709,2898,5730
,ChaWuXiang,542326208,2515,178,1798,767,3666,1781,999,1872,3653,1894,3692
,KaGaZhen,542327100,6112,475,4143,2339,8187,4120,1980,4277,8397,4424,8567
ɣɣ,SangSangZhen,542327101,3086,199,2202,992,4309,2180,1094,2166,4346,2177,4379
,QieReXiang,542327200,854,62,667,310,1303,667,400,649,1316,649,1316
,QiuWoXiang,542327201,4457,474,3301,1387,6214,3295,1776,3379,6674,3406,6707
,DaJuXiang,542327202,2868,266,2170,772,3743,2150,1273,2196,4346,2237,4407
ľ,YaMuXiang,542327203,4232,478,3135,1220,6082,3135,1603,3158,6293,3178,6313
ò,GongJiuBuXiang,542327204,743,55,567,271,1115,567,349,580,1147,580,1147
,DaRuoXiang,542327205,365,27,327,148,581,327,220,285,612,285,612
,CuoMaiXiang,542327206,936,64,755,384,1493,755,508,745,1500,753,1508
,NiGuoXiang,542327207,894,67,720,371,1430,720,476,717,1437,717,1437
¡,KongLongXiang,542327208,494,29,365,190,727,365,205,348,713,363,728
,RuSaXiang,542327209,458,30,359,196,721,359,233,362,721,362,721
ľ,AMuXiongXiang,542327210,533,43,393,202,819,393,281,428,821,464,857
,ChaZiXiang,542327211,813,52,560,325,1166,559,322,616,1175,627,1187
,RiWuQiXiang,542327212,3211,293,2430,820,4874,2430,1466,2524,4954,2540,4970
,DuoBaiXiang,542327213,3937,359,2861,1000,5791,2861,1534,2953,5814,2969,5830
۰,XiongBaXiang,542327214,480,39,404,178,754,404,267,382,786,382,786
,KaGaZhen,542328100,5138,358,3437,1800,6607,3298,1527,3319,6617,3586,7023
ľ,DaMuXiaXiang,542328200,2752,213,2070,828,4215,2069,1272,2154,4223,2167,4237
鲼,ChaBuXiang,542328201,1077,80,774,293,1643,764,509,856,1620,892,1666
,ChunZheXiang,542328202,793,72,594,232,1221,589,357,596,1185,628,1222
,ZiXuXiang,542328203,449,36,341,152,683,337,215,338,675,359,700
,NiangReXiang,542328204,908,61,558,209,1075,526,339,533,1059,750,1308
벼,CuoBuXiXiang,542328205,1134,84,863,371,1717,861,502,852,1713,857,1720
ɵ,NaDangXiang,542328206,910,70,720,278,1407,718,430,684,1402,690,1410
඼,QingDouXiang,542328207,471,32,325,156,653,320,153,328,648,331,656
,QieQiongXiang,542328208,376,18,319,124,617,318,226,295,613,301,620
,MeiBaQieQinXiang,542328209,747,38,545,224,1112,541,350,567,1108,590,1135
а,LieBaXiang,542328210,937,89,743,285,1500,716,483,756,1472,766,1509
,TaDingXiang,542328211,1335,123,909,400,1817,907,366,907,1814,915,1824
,RongMaXiang,542328212,1584,131,1057,331,2299,1036,591,1227,2263,1249,2306
ͨ,TongMenXiang,542328213,1939,150,1315,482,2725,1287,681,1405,2692,1455,2770
,RenQinZeXiang,542328214,3513,303,2411,902,5184,2389,1397,2766,5155,2802,5213
,DaNaPuXiang,542328215,1503,137,999,436,2202,996,576,1212,2208,1217,2216
,DaNaTaXiang,542328216,2554,128,1711,647,3537,1681,949,1857,3538,1920,3631
ľ,NanMuQieXiang,542328217,728,75,542,200,1111,538,311,565,1103,572,1114
彭,LuoJiangZhen,542329100,5191,381,3449,1546,6892,3330,1671,3626,6956,3794,7243
¶,GaDongZhen,542329101,5415,321,3813,1200,7491,3799,1865,3753,7552,3788,7601
,BaZhaXiang,542329200,3575,277,2494,791,5059,2460,1282,2640,5100,2640,5134
,MaXiang,542329201,3157,288,2202,724,4595,2169,1187,2390,4559,2430,4632
,WangDanXiang,542329202,2794,231,1881,716,3927,1881,1011,2135,4016,2155,4036
ū,QuNuXiang,542329203,2175,199,1590,488,3274,1582,931,1714,3296,1715,3305
,DuQiongXiang,542329204,2113,214,1535,556,3126,1530,865,1648,3178,1657,3192
ǿ,QiangDuiXiang,542329205,1603,145,1067,364,2326,1067,621,1298,2365,1302,2369
,GaPuXiang,542329206,1442,103,939,341,1932,919,444,1008,1927,1050,1989
,ZheXiaXiang,542329207,1323,155,829,289,1859,829,428,1077,1906,1077,1906
ϲ,DongXiXiang,542329208,867,50,510,188,1095,507,227,622,1129,634,1144
¼,DeJiLinZhen,542330100,3194,303,2312,920,4478,2156,1225,2180,4336,2410,4722
,PaDangXiang,542330200,1927,252,1420,506,2945,1420,768,1527,2947,1527,2947
,KangXiongXiang,542330201,2240,267,1620,481,3342,1611,846,1703,3314,1733,3353
,PuSongXiang,542330202,1191,112,820,251,1758,810,460,924,1734,943,1763
Ȼ,RanBaXiang,542330203,1330,172,961,334,1987,957,507,1037,1994,1048,2009
,ChaBaXiang,542330204,2570,322,1851,689,3853,1842,984,2015,3857,2025,3876
,QieWaXiang,542330205,2336,254,1778,591,3600,1743,1015,1797,3540,1827,3605
ķ,MuXiang,542330206,2006,226,1515,595,3032,1504,835,1511,3015,1552,3067
ʲ,RenBuXiang,542330207,1609,206,1216,505,2462,1200,669,1251,2451,1268,2484
,KangMaZhen,542331100,2269,137,1516,1017,2889,1508,679,1523,3031,1569,3085
,NieRuMaiXiang,542331200,1134,60,812,304,1657,811,464,843,1654,846,1658
,NieRuDuiXiang,542331201,1423,60,1013,381,2044,995,592,1006,2001,1062,2075
,GaLaXiang,542331202,2355,168,1649,688,3389,1649,881,1745,3394,1755,3404
,SaMaDaXiang,542331203,1356,90,979,395,1938,979,498,964,1943,965,1944
,KangRuXiang,542331204,1296,135,964,363,1855,960,457,908,1868,924,1888
ٸ,ShaoGangXiang,542331205,1604,151,1214,506,2331,1214,589,1130,2344,1130,2344
,NanNiXiang,542331206,1511,126,1113,414,2186,1111,595,1083,2194,1119,2232
,XiongZhangXiang,542331207,1340,90,919,362,1865,910,462,947,1857,973,1892
,JiangGaZhen,542332100,3463,132,1739,835,4254,1606,833,1627,3233,2689,4428
,ChenTangZhen,542332101,1189,104,976,404,1996,976,750,1048,2024,1067,2043
,RiWuZhen,542332102,764,21,593,274,1131,589,350,523,1112,542,1135
ȷ,QueBuXiang,542332200,1113,74,792,280,1608,788,422,809,1597,817,1609
,ZhaXiGangXiang,542332201,1394,75,1007,371,2039,1002,579,1027,2029,1041,2048
಼,DuoBuZhaXiang,542332202,1131,54,769,286,1605,766,421,816,1582,837,1606
,DingJieXiang,542332203,1146,79,753,304,1574,744,361,818,1562,833,1586
,QiongZiXiang,542332204,1863,87,1326,453,2695,1300,754,1360,2660,1378,2704
,SaErXiang,542332205,1662,78,1185,490,2360,1181,620,1172,2353,1175,2360
,GuoJiaXiang,542332206,525,52,394,131,794,389,223,393,782,406,800
,PaYangZhen,542333100,1359,87,1069,545,1977,1059,672,1026,2085,1049,2118
,LaRangXiang,542333200,1497,62,898,645,1604,846,407,876,1722,1068,1966
,PaJiangXiang,542333201,1625,115,1130,439,2331,1112,745,1172,2284,1355,2485
ʶ,RenDuoXiang,542333202,1213,70,983,350,1952,978,704,978,1956,1004,1987
,JiMaXiang,542333203,1112,109,960,431,1740,954,652,899,1853,913,1873
¡¶,LongGaErXiang,542333204,2041,134,1577,657,3094,1521,1100,1605,3126,1698,3275
,HuoErBaXiang,542333205,849,85,683,342,1306,679,407,657,1336,658,1341
,JiLaXiang,542333206,523,57,451,249,899,448,327,455,903,456,907
ɾ,NaJiuXiang,542333207,768,57,600,306,1084,600,377,590,1190,602,1202
ƫ,PianJiXiang,542333208,1100,89,813,414,1702,805,517,868,1673,893,1706
,BuDuoXiang,542333209,389,26,300,138,561,297,215,300,597,330,630
,YaReXiang,542333210,840,50,685,302,1336,681,452,648,1329,657,1342
,QiongGuoXiang,542333211,865,69,660,345,1085,655,381,650,1305,655,1315
˾,XiaSiMaZhen,542334100,2723,171,1628,926,2770,1481,447,1286,2767,1713,3341
,PaLiZhen,542334101,1900,136,1398,645,2399,1367,518,1044,2411,1156,2554
Ƕ,XiaYaDongXiang,542334200,822,63,565,303,1024,559,212,498,1057,532,1097
,DuiNaXiang,542334201,1946,101,1372,540,2621,1367,699,1343,2710,1374,2746
Ƕ,ShangYaDongXiang,542334202,959,146,721,403,1199,711,171,519,1230,555,1276
,JiRuXiang,542334203,623,36,425,169,785,422,169,389,811,403,828
,KangBuXiang,542334204,806,56,542,227,962,533,216,517,1050,536,1078
ڸ,ZongGaZhen,542335100,2977,127,1834,1060,3756,1807,943,1802,3609,2213,4047
¡,JiLongZhen,542335101,3199,292,2309,1042,4702,2263,1372,2329,4592,2554,4863
۰,ZheBaXiang,542335200,1496,66,1131,445,2324,1127,762,1182,2309,1193,2324
,GongDangXiang,542335201,675,39,540,240,1047,540,333,506,1046,507,1047
,ChaNaXiang,542335202,1722,113,1268,546,2690,1253,856,1406,2659,1423,2691
ľ,NieLaMuZhen,542336100,2194,116,1420,720,2687,1347,676,1291,2638,1566,2986
ľ,ZhangMuZhen,542336101,2839,80,1519,795,1801,1227,550,1195,2422,1950,3469
,YaLaiXiang,542336200,1031,74,753,293,1503,736,450,760,1496,802,1555
,SuoZuoXiang,542336201,2090,172,1531,524,3146,1521,904,1622,3143,1635,3166
Ų,MenBuXiang,542336202,1764,129,1245,514,2627,1237,785,1397,2634,1433,2678
,NaiLongXiang,542336203,882,74,653,244,1311,646,388,682,1328,691,1344
,BoRongXiang,542336204,1505,88,1117,450,2353,1117,777,1223,2340,1253,2370
Ӽ,JiaJiaZhen,542337100,2500,88,1501,696,2559,1232,654,1187,2419,1741,3242
,XiaRuXiang,542337200,1647,148,1140,417,2462,1129,695,1320,2449,1350,2490
,DanGaXiang,542337201,995,75,741,291,1473,730,435,746,1476,764,1505
Ｊ,DaJiLingXiang,542337202,795,40,581,285,1165,569,334,572,1141,588,1169
,RuJiaoXiang,542337203,550,45,405,195,830,399,256,438,837,446,851
,LaCangXiang,542337204,962,67,733,361,1439,727,466,754,1481,762,1495
,XiongRuXiang,542337205,1277,78,975,401,1815,950,545,906,1856,925,1900
,ChangGuoXiang,542337206,861,39,699,291,1338,691,484,668,1359,685,1384
ڰ,GangBaZhen,542338100,2582,74,1620,843,3153,1540,761,1548,3088,1797,3417
,ChangLongXiang,542338200,1506,72,1032,386,2098,1019,535,1020,2039,1081,2113
ֱ,ZhiKeXiang,542338201,861,27,597,262,1212,591,338,616,1207,629,1226
,KongMaXiang,542338202,966,48,692,304,1350,682,350,655,1337,672,1364
,LongZhongXiang,542338203,1688,85,1144,455,2298,1131,571,1162,2293,1200,2344
,NaQuZhen,542421100,36648,1532,23756,15622,35387,23497,12350,25566,49063,26774,50530
,LuoMaZhen,542421101,4330,284,3321,1221,6303,3320,1958,3247,6567,3251,6572
¶,GuLuZhen,542421102,2363,166,1838,836,3695,1838,1166,1857,3695,1857,3695
ï,XiangMaoXiang,542421200,4118,257,3176,1416,6318,3153,2027,3190,6343,3226,6402
ǡ,YouQiaXiang,542421201,2874,146,2497,895,4881,2497,1993,2499,4996,2516,5013
,NaMaQieXiang,542421202,4816,367,3922,1566,7841,3922,2715,3976,7898,3976,7898
,KongMaXiang,542421203,2982,216,2366,1029,4643,2350,1492,2310,4660,2324,4690
,DaSaXiang,542421204,5056,335,3964,1690,8012,3964,2707,4134,8098,4134,8098
,LuoMaiXiang,542421205,1878,143,1495,670,3122,1495,1106,1632,3127,1632,3127
ɫ,SeXiongXiang,542421206,2245,160,1971,831,3913,1971,1642,2076,4047,2076,4047
,NiMaXiang,542421207,2449,248,2021,842,4078,2018,1478,2050,4068,2154,4175
ǰ,DaQianXiang,542421208,2730,204,2168,913,4533,2158,1600,2340,4498,2366,4534
,AZhaZhen,542422100,3280,184,2289,1334,4323,2246,1415,2388,4634,2590,4879
,JiaLiZhen,542422101,2019,163,1741,617,3405,1723,1273,1692,3415,1714,3455
Ⱥ,GeQunXiang,542422200,1423,115,1142,385,2280,1141,754,1139,2280,1150,2292
ر,CangBiXiang,542422201,1091,76,947,283,1863,947,719,939,1886,939,1886
,ZhongYuXiang,542422202,1327,93,978,365,1880,968,477,894,1862,919,1897
,CuoDuoXiang,542422203,2632,208,2286,737,4521,2276,1836,2378,4654,2390,4676
,CuoLaXiang,542422204,2664,227,2098,819,4217,2090,1375,2139,4229,2168,4266
ֵ,LinDiXiang,542422205,995,87,831,364,1638,831,584,835,1666,835,1666
,XiaMaXiang,542422206,2469,187,2043,716,4151,2043,1522,2135,4178,2135,4178
޶,RongDuoXiang,542422207,1860,137,1528,537,3101,1528,1164,1633,3161,1633,3161
,BiRuZhen,542423100,7239,422,4845,1543,9659,4214,3048,4725,8939,5864,10709
,XiaQuZhen,542423101,7544,460,5305,2346,11357,5301,3474,6163,11464,6173,11478
׸,BaiGaXiang,542423200,4588,440,3647,1279,7409,3647,2403,3784,7431,3784,7431
,YangXiuXiang,542423201,3314,286,2545,1088,5307,2491,1707,2697,5188,2762,5307
,XiangQuXiang,542423202,3033,313,2542,776,5144,2542,1798,2602,5144,2602,5144
,DaTangXiang,542423203,4037,308,3493,1099,7024,3490,2680,3517,7007,3532,7025
,LiangQuXiang,542423204,2054,177,1641,579,3364,1617,1156,1685,3302,1746,3387
,ChaQuXiang,542423205,3198,294,2724,864,5550,2724,2065,2833,5557,2833,5557
,ZhaLaXiang,542423206,1579,141,1307,451,2644,1296,954,1348,2644,1367,2674
ǡ,QiaZeXiang,542423207,926,68,680,401,1466,679,473,781,1460,787,1467
,NieRongZhen,542424100,3052,167,2102,1212,3871,2018,1066,2042,4060,2183,4285
,NiMaXiang,542424200,3064,230,2254,956,4426,2238,1186,2216,4454,2226,4480
鵱,ChaDangXiang,542424201,1867,159,1510,538,2751,1502,927,1419,2921,1443,2953
ľ,DangMuJiangXiang,542424202,1735,120,1430,539,2691,1429,962,1386,2815,1387,2817
,YongQuXiang,542424203,1173,103,961,351,1768,950,615,919,1869,930,1891
,SuoXiongXiang,542424204,1166,93,956,331,1706,945,582,880,1825,885,1841
,BaiXiongXiang,542424205,2288,176,1908,754,3544,1908,1285,1841,3749,1841,3749
ɣ,SangRongXiang,542424206,1134,111,927,388,1763,925,590,908,1833,908,1835
,XiaQuXiang,542424207,2236,181,1720,715,3352,1720,966,1663,3383,1663,3383
ɫ,SeQingXiang,542424208,3495,233,2578,1093,5036,2571,1414,2564,5135,2564,5142
,ZhaRenZhen,542425100,5623,430,4205,1968,8497,4205,2454,4302,8507,4302,8507
ʯƺ,YanShiPingZhen,542425101,1919,121,1428,618,2706,1348,836,1371,2719,1448,2876
ǿ,QiangMaZhen,542425102,2875,224,2130,953,4389,2128,1362,2316,4444,2331,4461
,PaNaZhen,542425103,4424,225,2815,1719,5279,2665,1314,2754,5419,3148,5963
,CuoMaXiang,542425200,2630,191,2002,988,3962,1972,1177,1973,3945,1996,3998
̲,TanDuiXiang,542425201,760,64,569,267,1108,569,319,543,1112,574,1143
,ZhaQuXiang,542425202,729,47,559,251,1097,555,333,544,1099,550,1109
,GangNiXiang,542425203,1161,53,870,361,1705,855,491,826,1681,835,1705
,MaQuXiang,542425204,1549,103,1254,446,2458,1247,834,1218,2465,1232,2486
ɫ,SeWuXiang,542425205,565,35,456,194,918,456,343,487,943,487,943
,MaRongXiang,542425206,653,33,504,216,979,501,317,492,993,499,1003
,DuoMaXiang,542425207,1104,74,826,327,1682,822,507,851,1673,859,1685
,BangMaiXiang,542425208,1265,85,984,427,1893,978,573,936,1914,939,1923
,ShenZhaZhen,542426100,2909,179,2099,1147,3966,2068,1208,2088,4156,2197,4296
÷,XiongMeiZhen,542426101,2131,169,1693,663,3419,1691,1137,1739,3430,1744,3437
Ծ,MaYueXiang,542426200,1178,128,897,335,1813,897,523,923,1820,932,1829
,MaiBaXiang,542426201,904,81,673,278,1367,673,398,710,1383,710,1383
,TaErMaXiang,542426202,2123,198,1678,748,3366,1676,1084,1711,3387,1727,3405
¹,XiaGuoXiang,542426203,1458,123,1206,482,2329,1206,749,1124,2330,1124,2330
ǡ,QiaXiang,542426204,1000,94,742,356,1550,740,471,818,1558,823,1565
,BaZhaXiang,542426205,1458,153,942,403,1896,933,429,934,1867,1098,2040
,YaLaZhen,542427100,6172,553,4721,2379,9174,4609,3060,4673,9282,5064,9785
ٲ,RongBuZhen,542427101,4303,388,3640,1341,7116,3635,2523,3565,7200,3574,7214
,RuoDaXiang,542427200,1487,181,1367,501,2695,1355,1027,1310,2665,1328,2695
,ReWaXiang,542427201,1571,172,1296,525,2532,1272,823,1255,2527,1270,2566
ɫ,SeChangXiang,542427202,1885,189,1491,527,3101,1474,1056,1617,3091,1639,3130
ľ,GaMuXiang,542427203,1264,92,1043,380,2138,1034,799,1085,2119,1112,2155
,ChiDuoXiang,542427204,1863,151,1438,490,2942,1428,977,1527,2955,1553,2991
,GaMeiXiang,542427205,3094,218,2346,852,4878,2319,1635,2578,4897,2601,4947
,JiaLeXiang,542427206,3413,219,2405,910,4940,2388,1351,2419,4807,2578,4983
,JiangDaXiang,542427207,2159,161,1552,538,3153,1547,835,1583,3130,1603,3155
ձ,PuBaoZhen,542428100,4716,314,3349,1856,6256,3201,1723,3146,6347,3404,6753
,BeiLaZhen,542428101,3056,239,2373,1122,4560,2372,1361,2255,4627,2283,4656
,JiaQiongZhen,542428102,1839,140,1530,670,2921,1530,947,1396,2926,1396,2926
,DeQingZhen,542428103,2411,177,1854,781,3663,1828,1110,1813,3641,1844,3698
ǰ,MaQianXiang,542428200,1349,113,1104,475,2157,1099,725,1073,2172,1083,2187
ŵ,MenDangXiang,542428201,3009,264,2418,1017,4629,2398,1464,2277,4675,2319,4737
,BaoJiXiang,542428202,1315,134,1058,465,2045,1049,599,972,2021,990,2048
,QingLongXiang,542428203,2549,226,1907,879,3776,1862,1017,1840,3702,1885,3792
¼,XinJiXiang,542428204,2300,174,1812,782,3670,1802,1229,1863,3665,1891,3703
,NiMaXiang,542428205,1532,142,1168,494,2282,1159,668,1152,2311,1174,2342
Ű,YaAnZhen,542429100,2988,230,2181,739,4693,2181,1584,2621,4802,2621,4802
,LaXiZhen,542429101,5490,172,3151,1958,7462,3120,2370,4783,7903,4881,8032
ɫ,ZaSeZhen,542429102,5614,265,3995,1439,9370,3995,3496,5380,9375,5380,9375
,JiangMianXiang,542429200,3656,214,2580,869,5734,2578,2012,3298,5876,3302,5882
,GangQieXiang,542429201,2510,200,1886,681,4081,1886,1379,2203,4089,2203,4089
,BaQingXiang,542429202,1681,103,1186,392,2440,1182,736,1310,2492,1334,2520
,AXiuXiang,542429203,1376,133,1017,369,2248,1017,753,1245,2262,1245,2262
,MaRuXiang,542429204,3770,255,2701,822,5758,2701,1890,3214,5915,3214,5915
,BenTaXiang,542429205,2627,149,1577,654,3657,1577,894,2093,3670,2093,3670
,GongRiXiang,542429206,1033,78,848,278,1713,848,626,889,1737,889,1737
,NiMaZhen,542430100,5121,342,3009,1162,6236,2530,1480,2599,5129,3934,6943
,CuoZheLuoMaZhen,542430101,1782,185,1422,475,2741,1391,851,1296,2687,1396,2818
Ĳ,WenBuXiang,542430200,1237,138,917,443,1850,910,475,909,1819,933,1850
в,ZhongCangXiang,542430201,1604,158,1242,586,2492,1242,730,1250,2492,1250,2492
׿,ZhuoWaXiang,542430202,1279,103,976,396,1986,971,614,1016,1987,1020,1996
׿,ZhuoNiXiang,542430203,1140,90,905,336,1751,898,561,864,1762,886,1791
,JiWaXiang,542430204,1155,88,848,380,1643,840,421,802,1642,816,1664
׹,JiaGuXiang,542430205,1231,99,957,487,1857,955,541,891,1846,914,1871
,ASuoXiang,542430206,1091,93,785,376,1577,785,400,799,1584,799,1584
,EJiuXiang,542430207,1311,128,1057,392,2058,1041,642,977,2018,1024,2081
,RongMaXiang,542430208,584,41,470,209,931,470,319,474,944,474,944
,DaGuoXiang,542430209,1064,88,788,312,1644,775,497,812,1587,861,1649
,ShenYaXiang,542430210,1169,100,836,446,1680,831,422,849,1680,855,1691
,LaiDuoXiang,542430211,1245,136,965,372,1902,957,521,925,1882,937,1902
,JunCangXiang,542430212,996,125,649,353,1373,649,277,746,1395,749,1398
Э,XieDeXiang,542430213,1332,91,1115,438,2152,1113,815,1110,2223,1123,2238
,YaQuXiang,542430214,680,39,527,223,992,518,332,494,1012,524,1051
´,GaCuoXiang,542430215,358,40,271,104,524,269,139,257,526,266,537
ǿ,CuoZheQiangMaXiang,542430216,648,40,558,187,1052,556,404,523,1079,534,1092
,DuoMaXiang,542430217,1861,105,1329,660,2501,1288,798,1303,2591,1435,2764
,BaLingXiang,542430218,988,71,753,375,1456,753,440,745,1498,746,1499
,PuLanZhen,542521100,4396,348,2842,1445,5649,2784,1303,2582,5366,3205,6047
͸,BaGaXiang,542521200,1157,72,823,459,1415,800,430,802,1602,836,1659
,HuoErXiang,542521201,1287,93,964,469,1887,953,571,981,1934,987,1951
,TuoLinZhen,542522100,1566,73,914,504,1639,859,375,802,1661,1100,2014
,SaRangXiang,542522200,511,32,332,170,645,325,120,302,627,331,663
,DaBaXiang,542522201,815,65,614,284,1203,606,361,616,1222,627,1241
,DiYaXiang,542522202,527,46,429,209,778,421,216,354,775,360,789
,XiangZiXiang,542522203,841,87,667,316,1222,653,320,563,1216,581,1248
,QuSongXiang,542522204,609,49,471,215,917,465,270,452,917,457,928
ʨȪ,ShiQuanHeZhen,542523100,9222,141,4393,2614,7051,3279,1144,3380,6659,6114,10507
ɳ,KunShaXiang,542523200,1273,143,1016,542,1962,993,581,961,1954,981,1997
,ZuoZuoXiang,542523201,903,66,676,362,1316,661,374,643,1304,667,1343
,MenTuXiang,542523202,1425,130,1096,502,2087,1053,638,1020,2073,1097,2193
,ZhaXiGangXiang,542523203,594,49,435,213,814,418,218,366,784,426,861
,RiTuZhen,542524100,2446,115,1368,861,2524,1171,496,1177,2348,1689,3057
Ȱ,ReBangXiang,542524200,1294,95,1082,460,2237,1082,853,1160,2242,1160,2242
,RiSongXiang,542524201,1238,98,963,438,1920,963,585,958,1921,958,1921
,DongRuXiang,542524202,840,53,642,317,1278,642,385,636,1278,636,1278
,DuoMaXiang,542524203,824,60,641,281,1229,640,356,593,1233,599,1240
Ｊ,GeJiZhen,542525100,2631,132,1834,1024,3702,1764,1123,1861,3625,2052,3886
۰,XiongBaXiang,542525200,2054,124,1507,705,3127,1477,1024,1636,3113,1695,3202
,YaReXiang,542525201,2152,176,1620,738,3248,1598,1017,1649,3247,1725,3345
κ,YanHuXiang,542525202,1828,132,1511,708,3046,1503,1164,1588,3091,1613,3124
Ĳɣ,WenBuDangSangXiang,542525203,1199,112,918,436,1849,911,615,989,1900,1008,1926
,GaiZeZhen,542526100,3490,227,2386,1234,4385,2238,1355,2214,4452,2686,5072
,WuMaXiang,542526200,1448,140,1178,638,2315,1170,727,1120,2290,1137,2315
ǲ,XianQianXiang,542526201,1139,74,901,475,1798,890,612,908,1798,924,1825
,MaMiXiang,542526202,2649,247,2223,997,4298,2207,1467,2116,4323,2140,4363
,DongCuoXiang,542526203,1577,186,1272,598,2508,1254,808,1243,2497,1299,2571
ķ,GuMuXiang,542526204,1434,84,1108,511,2298,1103,794,1171,2274,1204,2312
첼,ChaBuXiang,542526205,2288,182,1812,888,3695,1810,1249,1903,3713,1907,3719
,CuoQinZhen,542527100,3020,210,1923,981,3597,1781,960,1887,3668,2267,4190
ʯ,CiShiXiang,542527200,1704,159,1218,619,2456,1216,635,1268,2484,1280,2498
,QuLuoXiang,542527201,1569,133,1160,600,2286,1149,696,1162,2311,1238,2398
,JiangRangXiang,542527202,1987,230,1434,642,2921,1431,707,1471,2902,1490,2924
,DaXiongXiang,542527203,1639,159,1290,507,2499,1285,818,1268,2553,1326,2616
֥,LinZhiZhen,542621100,2322,261,1588,724,2464,1551,684,1577,3128,1679,3267
ٰ,BaiBaZhen,542621101,2571,185,1879,771,3502,1857,992,1865,3722,1869,3748
һ,BaYiZhen,542621102,32855,811,18550,12165,17047,15711,5444,15828,31539,20560,39110
³,LuLangZhen,542621103,1210,96,776,426,1489,762,282,799,1561,812,1588
Ű,GengZhangMenBaMinZuXiang,542621200,1104,88,789,392,1320,787,422,823,1610,825,1614
,BuJiuXiang,542621201,2367,213,1550,757,2323,1503,548,1526,3029,1578,3128
,MiRuiXiang,542621202,1604,174,1128,465,2039,1109,469,1065,2174,1119,2247
,GongBuJiangDaZhen,542622100,4174,197,2732,1784,4252,2543,1080,2442,4985,2719,5451
,JinDaZhen,542622101,3034,209,2247,912,4448,2217,1321,2264,4481,2317,4564
ͺ,BaHeZhen,542622102,2019,148,1457,662,2666,1419,759,1421,2840,1469,2926
,CuoGaoXiang,542622200,1622,99,1148,520,2207,1133,644,1191,2324,1217,2365
,ZhuLaXiang,542622201,1907,158,1353,728,2620,1344,674,1377,2721,1386,2739
ɯ,ZhongShaXiang,542622202,1761,148,1295,677,2473,1294,651,1264,2558,1265,2560
,JiangDaXiang,542622203,1617,111,1201,555,2272,1192,604,1119,2311,1131,2332
,NiangPuXiang,542622204,1648,97,1345,487,2666,1335,983,1332,2667,1383,2728
,JiaXingXiang,542622205,2890,198,2090,888,3936,2083,1176,2154,4237,2174,4264
,MiLinZhen,542623100,4317,187,2626,1906,3694,2540,1113,2636,5176,2991,5617
,WoLongZhen,542623101,2845,193,2080,969,3635,2039,1120,2013,4052,2078,4158
,PaiZhen,542623102,1648,161,1116,580,1984,1054,525,1098,2152,1218,2334
,DanNiangXiang,542623200,1230,104,904,384,1672,889,440,856,1745,870,1774
,NanYiLuoBaMinZuXiang,542623201,452,31,327,127,532,300,161,256,556,317,644
Ǽ,QiangNaXiang,542623202,1903,181,1380,545,2553,1366,633,1303,2669,1337,2717
,LiLongXiang,542623203,1339,110,1015,459,1805,993,589,1005,1998,1023,2038
Ƶ,ZhaXiRaoDengXiang,542623204,2442,187,1797,822,3086,1772,923,1717,3489,1755,3552
ī,MoTuoZhen,542624100,2333,100,1438,865,2422,1410,724,1548,2958,1719,3157
ʵ,GanDeXiang,542624200,221,20,141,61,326,136,89,174,310,189,330
,JiaLaSaXiang,542624201,439,29,310,140,633,308,185,329,637,343,653
ľ,DaMuLuoBaMinZuXiang,542624202,918,29,556,241,917,516,316,515,1031,707,1263
,PangXinXiang,542624203,811,87,607,237,1228,607,368,659,1266,659,1266
,GeDangXiang,542624204,367,26,295,106,563,287,192,280,567,290,585
,DeXingXiang,542624205,960,60,705,284,1448,693,453,754,1447,768,1473
,BeiBengXiang,542624206,1469,85,1059,383,2206,1043,682,1152,2195,1177,2236
ľ,ZhaMuZhen,542625100,6994,271,4240,2645,5514,4022,1785,4232,8254,4810,9050
,QingDuoZhen,542625101,3850,210,2256,1042,5185,2238,1342,2419,4657,3146,5402
,SongZongZhen,542625102,1361,116,1042,408,1964,1035,557,983,2018,992,2034
,GuXiang,542625200,1054,71,771,321,1186,762,424,753,1515,778,1549
,YuXuXiang,542625201,3643,260,2734,997,5462,2725,1666,2815,5540,2835,5569
༪,DuoJiXiang,542625202,2015,142,1511,546,3027,1490,884,1508,2998,1530,3041
,KangYuXiang,542625203,1214,76,850,297,1678,850,433,873,1723,873,1723
,YuPuXiang,542625204,1147,44,739,394,1464,724,396,752,1476,848,1587
׹,YiGongXiang,542625205,1524,191,1116,551,2077,1101,527,1097,2198,1126,2242
˸,BaGaiXiang,542625206,866,45,601,213,1235,599,372,647,1246,682,1283
߸,ZhuWaGenZhen,542626100,4937,259,3156,1660,5476,3005,1326,2934,5939,3366,6522
ϲ,ShangChaYuZhen,542626101,2077,172,1520,680,2968,1495,850,1545,3040,1579,3099
²,XiaChaYuZhen,542626102,3640,301,2633,1148,5016,2591,1245,2512,5103,2553,5186
,GuYuXiang,542626200,1990,165,1484,553,2819,1470,744,1376,2846,1415,2899
,GuLaXiang,542626201,1949,147,1464,498,2862,1450,815,1393,2843,1447,2911
,ChaWaLongXiang,542626202,4605,331,3296,1176,6221,3281,1702,3285,6566,3342,6638
,LangZhen,542627100,3354,142,2042,1501,3642,1975,895,2128,4103,2349,4391
ٴ,ZhongDaZhen,542627101,1669,136,1200,770,2242,1187,516,1085,2272,1121,2321
,DongGaZhen,542627102,1791,103,1278,734,2419,1278,595,1209,2487,1211,2489
,JinDongXiang,542627200,1266,100,844,545,1670,826,377,882,1708,899,1743
,LaDuoXiang,542627201,1515,109,1042,568,2130,1030,519,1091,2121,1101,2143
ľ,DengMuXiang,542627202,2066,166,1394,708,2827,1378,627,1424,2802,1465,2859
һ·ֵ´,XiYiLuJieDaoBanShiChu,610102001,39922,6671,26156,15702,37934,22859,5296,21740,44599,25733,51889
·ֵ´,ChangLeZhongLuJieDaoBanShiChu,610102002,71345,12963,47311,31853,74720,46020,11881,44866,90886,48878,96189
ɽŽֵ´,ZhongShanMenJieDaoBanShiChu,610102003,38749,6532,24728,18786,42244,23615,4019,23158,46773,24572,49300
ɭկֵ´,HanSenZhaiJieDaoBanShiChu,610102004,82146,11520,50523,32055,66617,43691,11096,42829,86520,54239,104762
Žֵ´,JieFangMenJieDaoBanShiChu,610102005,24066,3844,16158,10813,23633,15567,3774,14774,30341,15526,31684
ǿ·ֵ´,ZiQiangLuJieDaoBanShiChu,610102006,33397,4863,20514,14624,28229,19455,4087,19292,38747,21833,42347
̫·ֵ´,TaiHuaLuJieDaoBanShiChu,610102007,55477,8369,35707,26782,48901,35482,7664,35364,70846,35803,71510
·ֵ´,ChangLeXiLuJieDaoBanShiChu,610102008,42645,6451,26014,17630,37572,23776,5271,22612,46388,28353,54367
ֵ´,HuJiaMiaoJieDaoBanShiChu,610102009,69229,9497,42118,28408,51155,38239,8965,38596,76835,45573,87691
ԺŽֵ´,NanYuanMenJieDaoBanShiChu,610103001,17745,2753,11800,8452,13529,10973,2478,10508,21481,11176,22976
ֵֽ´,BaiShuLinJieDaoBanShiChu,610103002,37451,7301,25306,19179,35843,24685,5197,24076,48761,24643,49949
ֵַ´,ChangLeFangJieDaoBanShiChu,610103003,61450,8540,38511,26325,46176,35314,8309,34844,70158,39788,78299
Ͻֵֽ´,DongGuanNanJieJieDaoBanShiChu,610103004,62147,6493,34947,19979,45531,26132,6008,25429,51561,39701,74648
̫·ֵ´,TaiYiLuJieDaoBanShiChu,610103005,95826,14267,56318,36032,87015,49179,11372,47177,96356,65147,121465
·ֵ´,WenYiLuJieDaoBanShiChu,610103006,64074,10739,39736,25469,60329,33158,7004,32406,65564,42081,81817
·ֵ´,ChangAnLuJieDaoBanShiChu,610103007,44337,7164,29251,20345,39606,26704,5915,26035,52739,28165,57416
żҴֵ´,ZhangJiaCunJieDaoBanShiChu,610103008,102348,14446,61821,36466,84517,49319,11346,48288,97607,66319,128140
·ֵ´,QingNianLuJieDaoBanShiChu,610104001,43037,8556,29640,21921,40139,29181,6255,27625,56806,28208,57848
ԺŽֵ´,BeiYuanMenJieDaoBanShiChu,610104002,61879,9436,40509,29083,54061,39424,8556,38229,77653,39362,79871
ؽֵ´,BeiGuanJieDaoBanShiChu,610104003,52016,6633,33469,24989,35296,32580,7781,31734,64314,32961,66430
½ֵ´,HongMiaoPoJieDaoBanShiChu,610104004,84597,7907,50737,37522,53595,48383,12641,49040,97423,54408,105145
·ֵ´,HuanChengXiLuJieDaoBanShiChu,610104005,38023,6166,24339,17071,33547,23096,5382,22891,45987,25232,49571
ؽֵ´,XiGuanJieDaoBanShiChu,610104006,67293,8330,42845,33203,54814,42205,9608,41161,83366,42386,85231
Žֵ´,TuMenJieDaoBanShiChu,610104007,60481,9998,39642,29421,53496,38311,9381,37635,75946,40218,79860
԰·ֵ´,TaoYuanLuJieDaoBanShiChu,610104008,81107,13192,52727,38468,71310,49890,12151,49634,99524,53723,106450
԰ֵ´,ZaoYuanJieDaoBanShiChu,610104009,52419,7579,33480,24994,44749,33200,8109,33517,66717,34627,68107
֯ǽֵ´,FangZhiChengJieDaoBanShiChu,610111001,69745,13150,48125,33598,77774,46074,9540,43371,89445,44310,92435
ʮֵ̽´,ShiLiPuJieDaoBanShiChu,610111002,83209,4015,48154,41304,24532,46927,13643,50213,97140,52713,100867
ֵ´,HongQiJieDaoBanShiChu,610111003,41242,4160,24664,16076,38878,23985,6737,25024,49009,27475,52139
ϯֵ´,XiWangJieDaoBanShiChu,610111004,56867,5676,35503,22773,53953,33999,10056,33910,67909,37096,72599
ֵ´,HongQingJieDaoBanShiChu,610111005,50142,7922,33541,21281,62592,32631,9639,32891,65522,34162,67703
կֵ´,DiZhaiJieDaoBanShiChu,610111006,52409,2558,27263,9308,32366,15509,4770,15671,31180,32474,59737
Žֵ´,BaQiaoJieDaoBanShiChu,610111007,41702,4466,24245,12641,42644,21373,6389,21342,42715,28312,52557
ֵ´,XinZhuJieDaoBanShiChu,610111008,41055,4184,27260,15767,44419,27062,8952,26708,53770,26931,54191
ºϽֵ´,XinHeJieDaoBanShiChu,610111009,32748,3281,21334,11586,41178,21215,6867,21365,42580,21562,42896
żұֵ´,ZhangJiaBaoJieDaoBanShiChu,610112001,116125,8235,65895,43999,53774,56013,14687,56062,112075,73152,139047
Žֵ´,SanQiaoJieDaoBanShiChu,610112002,108745,11703,65950,41865,95989,59654,15325,59771,119425,69823,135773
ֵ´,XinJiaMiaoJieDaoBanShiChu,610112003,39222,4129,24046,16530,27916,22760,6822,22859,45619,26127,50173
ֵ´,XuJiaWanJieDaoBanShiChu,610112004,34219,6390,22778,15248,38978,22473,5838,22414,44887,23669,46447
�ֵ´,DaMingGongJieDaoBanShiChu,610112005,56635,4083,34985,24815,17724,34236,9955,34452,68688,35688,70673
̷ҽֵ´,TanJiaJieDaoBanShiChu,610112006,50405,3274,28821,22834,26632,28107,9011,30563,58670,33869,62690
ֵ̲´,CaoTanJieDaoBanShiChu,610112007,76900,2710,45080,14154,43095,21198,6961,21561,42759,41491,86571
層ֵ´,LiuCunBaoJieDaoBanShiChu,610112008,50663,3931,30358,14553,46582,25482,7739,25503,50985,31975,62333
δ빬ֵ´,WeiYangGongJieDaoBanShiChu,610112009,61788,2712,36445,27191,23080,35034,11864,37693,72727,39919,76364
ǽֵ´,HanChengJieDaoBanShiChu,610112010,65200,3051,30977,17488,34943,25034,8489,26325,51359,45763,76740
Сկ·ֵ´,XiaoZhaiLuJieDaoBanShiChu,610113001,137831,11960,79822,40681,87635,53726,12884,51850,105576,82853,162675
ֵ´,DaYanTaJieDaoBanShiChu,610113002,78177,9239,49868,35777,51969,43953,12366,43776,87729,49914,99782
ӱֵ´,ChangYanBaoJieDaoBanShiChu,610113003,185472,10880,104827,73201,106872,77102,18360,81454,158556,109885,214712
ӳǽֵ´,DianZiChengJieDaoBanShiChu,610113004,183349,14424,109308,81648,113799,92675,23994,95174,187849,112459,221767
ȼ½ֵ´,DengJiaPoJieDaoBanShiChu,610113005,73508,4565,41926,30919,38000,38173,10947,39539,77712,47094,89020
㻯կֵ´,YuHuaZhaiJieDaoBanShiChu,610113006,112439,5392,62420,43769,45472,43068,9373,46291,89359,64784,127204
ɰ˹ֵ´,ZhangBaGouJieDaoBanShiChu,610113007,161144,6111,88919,70117,81914,77984,24618,82973,160957,102954,191873
ֵ´,QuJiangJieDaoBanShiChu,610113008,61113,2748,30844,17039,30941,23475,7635,23713,47188,40652,71496
·ֵ´,FengHuangLuJieDaoBanShiChu,610114001,46126,5146,27412,16843,42374,23086,6788,23020,46106,30648,58060
»·ֵ´,XinHuaLuJieDaoBanShiChu,610114002,52595,7398,31985,23096,56609,29912,7834,30125,60037,35842,67827
˽ֵ´,ZhenXingJieDaoBanShiChu,610114003,20005,2024,12711,6758,23101,12444,3389,11939,24383,12707,25418
˽ֵ´,XinXingJieDaoBanShiChu,610114004,11222,1326,7172,3712,13938,7028,1795,6974,14002,7171,14343
ͽֵ´,BeiTunJieDaoBanShiChu,610114005,19133,1711,11201,5157,19779,10068,2797,9898,19966,12440,23641
,WuTunZhen,610114100,28206,3145,17700,8998,35237,16541,4416,16740,33281,18067,35767
ɽ,GuanShanZhen,610114101,40904,4880,26747,14715,50786,25308,7764,25414,50722,26801,53548
ɽֵ´,LiShanJieDaoBanShiChu,610115001,63462,7667,41772,27188,64736,37771,11208,36011,73782,40565,82337
ֵ´,QinLingJieDaoBanShiChu,610115002,21970,2149,14286,7816,24114,13238,4169,13055,26293,14002,28288
·ֵ´,XinFengJieDaoBanShiChu,610115003,28750,3340,18343,10184,34973,17413,5932,17673,35086,19679,38022
ֵ´,DaiWangJieDaoBanShiChu,610115004,36493,4940,23966,13919,47244,23484,7604,23864,47348,25071,49037
бڽֵ´,XieKouJieDaoBanShiChu,610115005,53199,3407,30956,11617,43082,21851,7660,21880,43731,33310,64266
ֵ߽´,XingZheJieDaoBanShiChu,610115006,19467,2029,12875,6933,22845,12855,4325,12857,25712,12946,25821
ڽֵ´,LingKouJieDaoBanShiChu,610115007,23432,2763,15726,8108,30699,15701,5433,15833,31534,15902,31628
Žֵ´,XiangQiaoJieDaoBanShiChu,610115008,23628,2962,15946,8739,30997,15884,5111,15630,31514,15755,31701
ֵ´,YuJinJieDaoBanShiChu,610115009,15441,1894,10335,5378,19930,10314,3284,10235,20549,10284,20619
нֵ´,XinShiJieDaoBanShiChu,610115010,21244,2266,13969,7085,27764,13831,4643,14033,27864,14184,28153
ֵ´,XuYangJieDaoBanShiChu,610115011,16690,1874,11031,5940,20666,10826,3337,10726,21552,10870,21901
Ȫֵ´,XiQuanJieDaoBanShiChu,610115012,16489,1867,11013,5987,21149,10960,3903,11084,22044,11246,22259
ֵ´,LiYangJieDaoBanShiChu,610115013,21673,2352,14022,7086,27880,13912,4364,14204,28116,14367,28389
ֵ´,MaEJieDaoBanShiChu,610115014,15321,2244,10177,5332,20132,9927,3378,10244,20171,10766,20943
կֵ´,HeZhaiJieDaoBanShiChu,610115015,21839,2515,14604,7151,28345,14575,5115,14758,29333,14865,29469
ڽֵ´,JiaoKouJieDaoBanShiChu,610115016,19377,2116,12663,6167,24946,12542,3987,12583,25125,12817,25480
ͻֵ´,YouHuaiJieDaoBanShiChu,610115017,17998,1909,11676,6012,22776,11594,3414,11554,23148,11645,23321
ֵ´,BeiTianJieDaoBanShiChu,610115018,17122,1873,11132,5731,22124,11130,3421,11282,22412,11284,22416
¯ֵ´,TieLuJieDaoBanShiChu,610115019,11774,1443,7909,4084,15257,7868,2778,8007,15875,8086,15995
ֵ´,RenLiuJieDaoBanShiChu,610115020,16408,1764,10896,5312,21100,10893,3463,10738,21631,10739,21635
կ,MuZhaiXiang,610115201,6743,921,4549,2529,9029,4542,1622,4714,9256,4737,9286
С,XiaoJinXiang,610115202,4432,599,3082,1743,6141,3081,1257,3200,6281,3206,6288
,RenZongXiang,610115204,6340,842,4244,2229,8440,4214,1439,4318,8532,4377,8621
Τֵ´,WeiQuJieDaoBanShiChu,610116001,181256,15173,113823,59466,118755,87273,27411,85577,172850,110017,223840
Žֵ´,GuoDuJieDaoBanShiChu,610116002,109512,5495,63956,30483,58874,46904,15981,47263,94167,67032,130988
ֵ´,LuanZhenJieDaoBanShiChu,610116003,46087,3598,29281,12824,46226,22360,7290,23231,45591,27694,56975
ֵ´,YinZhenJieDaoBanShiChu,610116004,25203,3299,16593,9701,32291,16345,5041,16617,32962,16950,33543
½ֵ´,WangSiJieDaoBanShiChu,610116005,25344,2042,16109,7833,30891,15880,5554,16504,32384,16831,32940
ֵ´,MaWangJieDaoBanShiChu,610116006,20754,2356,13158,7437,25510,12864,3834,13410,26274,13786,26944
̫ҹֵ´,TaiYiGongJieDaoBanShiChu,610116007,28062,1716,18948,5387,22708,9745,3198,9987,19732,14028,32976
ֵ´,DongDaJieDaoBanShiChu,610116008,33081,2268,16594,7680,25760,13121,4205,13610,26731,22960,39554
ֵ´,ZiWuJieDaoBanShiChu,610116009,22838,2390,14553,7812,27850,14119,4596,14577,28696,15271,29824
Žֵ´,DouMenJieDaoBanShiChu,610116010,44321,4050,28283,13994,54341,27352,9099,28194,55546,29187,57470
ϸֵ´,XiLiuJieDaoBanShiChu,610116011,25042,2939,16418,9613,30798,15668,5127,15885,31553,16690,33108
ֵ´,DuQuJieDaoBanShiChu,610116012,28853,3111,18677,9519,33873,16673,5473,16962,33635,18760,37437
׽ֵ´,DaZhaoJieDaoBanShiChu,610116013,23925,2411,15350,8423,29857,15131,4951,15365,30496,15937,31287
ֵ´,HuangLiangJieDaoBanShiChu,610116014,23645,1481,13551,5001,17221,8918,2757,9109,18027,14332,27883
¡ֵ´,XingLongJieDaoBanShiChu,610116015,36885,3000,20353,10168,36959,18695,5842,19346,38041,25374,45727
ֵ´,WangQuJieDaoBanShiChu,610116016,42916,2880,27191,9409,34462,17203,5681,17650,34853,24286,51477
ֵ´,MingDuJieDaoBanShiChu,610116017,25985,2953,16493,9252,33366,16304,5163,17236,33540,17608,34101
çֵ´,WangMangJieDaoBanShiChu,610116018,22798,2649,14803,8170,29493,14531,4947,15342,29873,15591,30394
ֵ̨´,WuTaiJieDaoBanShiChu,610116019,8244,1017,5359,3111,10692,5351,1741,5628,10979,5643,11002
Žֵ´,GaoQiaoJieDaoBanShiChu,610116020,20097,2047,12848,6812,26049,12768,4242,13458,26226,13538,26386
,LingZhaoXiang,610116201,15348,2166,10314,6539,20393,10256,3488,10547,20803,10688,21002
,WuXingXiang,610116203,22099,2107,13607,7273,27600,13234,3965,14020,27254,14564,28171
ׯ,YangZhuangXiang,610116207,12338,1577,8292,4777,16341,8288,2795,8408,16696,8418,16710
h,PaoLiXiang,610116209,8828,1445,6120,3922,12045,6077,2063,6152,12229,6216,12336
κկ,WeiZhaiXiang,610116210,8089,1215,5549,3562,11042,5481,1906,5549,11030,5661,11210
,LanGuanZhen,610122100,55008,5684,37144,17771,57419,27527,13144,26669,54196,36692,73836
,YiHuZhen,610122101,24635,3402,16734,9324,31224,15694,5644,15772,31466,16947,33681
,HuaXuZhen,610122102,21050,3414,14702,8240,28359,14580,5066,14340,28920,14828,29530
ǰ,QianWeiZhen,610122103,18404,3088,13233,8197,25587,13020,5087,12988,26008,13346,26579
,TangYuZhen,610122104,16932,1972,11020,6566,21883,10809,3894,11382,22191,11778,22798
,JiaoDaiZhen,610122105,15582,1944,10182,5733,19870,9752,3376,10144,19896,10720,20902
ɽ,YuShanZhen,610122106,16347,2071,11269,6120,22335,11103,4896,11749,22852,12045,23314
,SanLiZhen,610122107,30821,4195,21578,13108,35312,20696,8348,20215,40911,21786,43364
ջ,PuHuaZhen,610122108,31485,4266,22377,12715,43665,22119,9365,22432,44551,22739,45116
,GePaiZhen,610122109,7724,1276,5686,3599,11224,5661,2451,5715,11376,5765,11451
,WangChuanXiang,610122200,5972,853,4305,2628,8296,4301,1750,4253,8554,4270,8575
,LanQiaoXiang,610122201,5941,919,4460,2636,8524,4398,2131,4432,8830,4531,8991
,YuChuanXiang,610122202,6186,828,4082,2393,8372,4064,1596,4424,8488,4528,8610
Դ,BaYuanXiang,610122203,11595,1382,7296,4281,14831,7174,3250,7684,14858,8931,16227
ϴ,MengCunXiang,610122204,15666,2345,10780,6322,20849,10172,3768,10216,20388,10999,21779
,AnCunXiang,610122205,18509,2732,13120,7912,25941,13083,5099,13157,26240,13220,26340
ʷկ,ShiJiaZhaiXiang,610122206,12369,1615,8501,4856,16676,8477,3137,8503,16980,8620,17121
Сկ,XiaoZhaiXiang,610122207,13074,1640,8619,5063,17250,8573,3535,9193,17766,9630,18249
,SanGuanMiaoXiang,610122208,11468,1445,7885,4113,15830,7885,3280,8308,16193,8308,16193
ɽ,JinShanXiang,610122209,9359,1109,6259,3289,12704,6241,2450,6592,12833,6659,12918
ż䷿,JiuJianFangXiang,610122210,9829,1381,6551,4013,12955,6463,2705,6726,13189,7364,13915
,HouZhenXiang,610122211,10067,1352,7241,3914,14086,7241,3118,7296,14537,7296,14537
,ErQuZhen,610124100,60774,4997,36773,18305,63063,29663,12004,31810,61473,41002,77775
ư,YaBaiZhen,610124101,33826,3997,21788,10934,43005,19771,7768,21149,40920,23803,45591
,ZhongNanZhen,610124102,42603,4826,27888,15351,54367,26841,9625,27825,54666,29166,57054
,MaZhaoZhen,610124103,22910,3080,15290,9191,30887,14927,6033,15892,30819,16733,32023
,JiXianZhen,610124104,19085,2565,12717,7880,25208,12663,4517,13091,25754,13450,26167
¥,LouGuanZhen,610124105,34737,4247,22390,12051,43824,21307,7658,22497,43804,24252,46642
д,ShangCunZhen,610124106,34793,3895,22659,12047,41626,20510,7349,20491,41001,23378,46037
,GuangJiZhen,610124107,25792,3218,16861,9202,31966,15270,6213,16120,31390,18362,35223
,HouZhenZiZhen,610124108,1828,243,1098,672,2320,1083,441,1281,2364,1414,2512
,SiTunXiang,610124200,12134,1767,8340,5217,16967,8259,3365,8772,17031,8926,17266
Ҵ,HouJiaCunXiang,610124201,13013,1844,8973,5293,17786,8886,3634,9416,18302,9518,18491
,ZhuYuXiang,610124202,13255,1932,9056,5550,17920,9034,3637,9727,18761,9768,18824
໯,QingHuaXiang,610124203,15202,2046,10213,5792,20757,10211,3956,10989,21200,10991,21204
,CuiFengXiang,610124204,13931,2188,9620,6140,19241,9546,3914,10307,19853,10413,20033
ŷ,JiuFengXiang,610124205,17103,2431,11994,7474,23132,11991,4367,11892,23883,11907,23901
,FuRenXiang,610124206,13395,1650,8382,4726,17108,8333,2405,8997,17330,9068,17450
˾,SiZhuXiang,610124207,15801,2013,10651,5967,21123,10649,4054,11216,21865,11217,21868
կ,XinJiaZhaiXiang,610124208,16208,1627,10321,5132,16781,8525,3570,9007,17532,11084,21405
,LuoYuXiang,610124209,3786,589,2560,1635,5275,2560,1018,2827,5387,2833,5393
º,ChenHeXiang,610124210,2381,303,1496,962,3308,1495,648,1830,3325,1836,3332
巿,BanFangZiXiang,610124211,1596,259,1034,743,2221,1034,409,1206,2240,1230,2264
Һ,WangJiaHeXiang,610124212,1667,202,1013,607,2192,1004,444,1205,2209,1300,2313
ͤ,GanTingZhen,610125100,80033,8097,50080,31376,84316,46931,14976,48286,95217,53026,103106
,YuXiaZhen,610125101,45992,6674,27098,16098,54603,23219,7334,23750,46969,32902,60000
,ZuAnZhen,610125102,21161,2311,13214,7107,27293,13163,4170,14275,27438,14428,27642
ض,QinDuZhen,610125103,40973,4085,27548,11489,43315,21237,5992,21906,43143,23502,51050
,DaiWangZhen,610125104,22145,2909,14297,7296,28731,13919,4261,14423,28342,15018,29315
,CaoTangZhen,610125105,24089,2681,14880,8524,29774,14541,4467,15474,30015,16357,31237
,JiangCunZhen,610125106,24542,3089,15895,9135,31780,15685,5190,16552,32237,16926,32821
ӹ,PangGuangZhen,610125107,20718,2707,12886,7216,25630,12342,3497,13212,25554,14036,26922
Ե,LaoDianZhen,610125108,24715,3188,15659,8509,31659,15512,4443,16409,31921,16687,32346
ʺ,GanHeZhen,610125109,21278,2394,13189,6944,24814,12224,3682,12821,25045,14165,27354
ʯ,ShiJingZhen,610125110,19168,2702,12292,7346,24003,12240,3714,13224,25464,13292,25584
,WuZhuXiang,610125200,22160,1881,12575,5957,20572,10633,3755,11296,21929,15221,27796
,YuChanXiang,610125201,18596,2268,11771,6737,23786,11768,3613,12686,24454,12706,24477
,TianQiaoXiang,610125202,11086,1434,7164,4237,14009,7141,2273,7596,14737,7629,14793
μ,WeiFengXiang,610125203,18873,2731,12174,6536,24239,12028,3553,12768,24796,12983,25157
,CangYouXiang,610125204,12669,1792,8286,4792,16435,8286,2316,8491,16777,8491,16777
¹Է,LuYuanZhen,610126100,55476,5981,35638,17348,63334,29585,10099,28789,58374,35918,71556
ͨԶ,TongYuanZhen,610126101,20090,2287,13050,6633,24908,12686,3782,12531,25217,13109,26159
,GengZhen,610126102,12438,1269,7904,4298,15250,7902,2260,8059,15961,8063,15967
μ,JingWeiZhen,610126103,108674,7561,59640,29323,86198,47262,16070,47524,94786,72665,132305
,ChongHuangXiang,610126200,18317,1759,11989,5623,21248,11211,3516,10942,22153,11603,23592
,WanZiXiang,610126201,11477,1492,7417,4030,14342,7204,2118,7251,14455,7670,15087
ܳ,YuChuXiang,610126202,14683,1778,9487,4847,17980,9195,2717,9121,18316,9691,19178
Ų,ZhangBuXiang,610126203,22725,2548,14773,7639,29091,14753,4360,14838,29591,14860,29633
һ·ֵ´,QiYiLuJieDaoBanShiChu,610202001,21278,3481,14251,10039,23707,13846,3248,13507,27353,13756,28007
ֵ´,HongQiJieDaoBanShiChu,610202002,40837,6393,26338,17223,46121,23482,6362,22864,46346,27254,53592
԰ֵ´,TaoYuanJieDaoBanShiChu,610202003,21275,3345,13304,9611,23487,13131,2909,12980,26111,14225,27529
·ֵ´,QingNianLuJieDaoBanShiChu,610202004,18517,3521,12168,8256,22154,11882,2497,11869,23751,12367,24535
Ʊ,HuangBaoZhen,610202100,26308,3428,16587,10750,32209,16221,3792,16331,32552,16941,33528
Һ,WangJiaHeXiang,610202101,16275,2945,10650,7250,20077,10320,2540,10320,20640,11110,21760
,WangYiXiang,610202201,8809,934,5683,3820,9128,5624,1537,5484,11108,5597,11280
ǹؽֵ´,ChengGuanJieDaoBanShiChu,610203001,27569,2599,17719,10958,28395,15817,5017,15274,31091,17466,35185
ﶴֵ´,SanLiDongJieDaoBanShiChu,610203002,15172,2477,10119,7281,14504,9984,2343,9610,19594,9873,19992
¯,ChenLuZhen,610203100,11593,1913,7597,4807,15103,7533,2136,7729,15262,8045,15642
,HongTuZhen,610203101,16960,1908,10629,6707,19528,10487,3218,10911,21398,11457,22086
,GuangYangZhen,610203102,18266,2423,11418,7332,22231,11365,2946,11727,23092,12217,23635
,YuHuaZhen,610203103,14655,2119,9103,6827,17819,9092,2178,9498,18590,9849,18952
,JinSuoGuanZhen,610203104,18090,1541,7487,5026,14636,7377,2087,8059,15436,14231,21718
ʯ,WangShiAoZhen,610203105,14105,3426,9379,7269,18310,9362,2203,9701,19063,10355,19734
ׯ,AZhuangZhen,610203106,7883,776,5085,2535,9848,5025,1716,5192,10217,5290,10375
ӡ̨,YinTaiXiang,610203200,10935,1079,6899,3912,12725,6869,1970,7014,13883,7085,13984
¥,GaoLouHeXiang,610203201,12849,1456,7524,4459,15397,7428,1901,7903,15331,8682,16206
·ֵ´,YongAnLuJieDaoBanShiChu,610204001,29063,3130,18563,12600,31926,17348,4991,17264,34612,18621,37184
챦·ֵ´,TianBaoLuJieDaoBanShiChu,610204002,16512,1666,10428,6557,18475,9915,3464,10017,19932,11214,21642
̷·ֵ´,XianFengLuJieDaoBanShiChu,610204003,23098,2267,14829,8978,23270,14134,4698,14537,28671,15234,30063
·ֵ´,ZhengYangLuJieDaoBanShiChu,610204004,35315,2484,21517,11497,27631,17867,5815,18073,35940,22097,43614
Һ,DongJiaHeZhen,610204101,8959,977,5559,3184,10978,5390,1566,5493,10883,5943,11502
,MiaoWanZhen,610204102,14632,1288,8312,5970,15986,8112,2357,8817,16929,9965,18277
,YaoQuZhen,610204103,16425,1415,9729,6054,18499,9395,3055,10087,19482,11166,20895
ս,ZhaoJinZhen,610204104,7137,588,3713,2068,7330,3535,1248,3873,7408,5260,8973
¹,SiGouZhen,610204105,13618,1521,8517,4645,17133,8416,2419,8809,17225,9041,17558
ͷ,PoTouZhen,610204106,11426,1126,7064,3835,14228,6976,1970,7256,14232,7458,14522
С,XiaoQiuZhen,610204107,21029,2202,13443,7522,27006,13407,4236,13933,27340,14024,27467
ܫ,SunYuanZhen,610204108,14501,1865,9038,5745,18085,8772,2425,9148,17920,9753,18791
ׯ,GuanZhuangZhen,610204109,14965,1467,9289,4865,18726,9229,2797,9803,19032,9940,19229
,LiuLinZhen,610204110,7725,767,4621,2637,9499,4575,1263,5042,9617,5134,9755
ݳ,YanChiXiang,610204200,7729,850,4809,2622,9550,4805,1229,4912,9717,4999,9808
ʯ,ShiZhuXiang,610204201,12571,1303,7828,4204,15900,7709,2383,8009,15718,8429,16257
ǹ,ChengGuanZhen,610222100,15682,1341,9764,6329,17599,9348,3162,9775,19123,10421,20185
,PengZhen,610222101,9993,1227,6067,3835,12615,5924,1746,6583,12507,6899,12966
,WuLiZhen,610222102,4742,597,2793,1872,5957,2719,660,3122,5841,3206,5999
̫,TaiAnZhen,610222103,8016,790,4628,2861,9437,4520,1395,5156,9676,5573,10201
,QiPanZhen,610222104,5848,632,3574,1997,7238,3435,1116,3765,7200,4022,7596
Ȫ,KuQuanXiang,610222200,3568,372,2172,1237,4323,2112,639,2327,4439,2407,4579
,YunMengXiang,610222201,8363,848,5021,2855,10244,4978,1427,5539,10517,5617,10638
ܫ,LeiYuanXiang,610222202,4137,446,2420,1524,4990,2379,633,2716,5095,2796,5216
Ң,YaoShengXiang,610222203,5226,540,3201,1870,6405,3057,866,3205,6262,3431,6632
,XiCunXiang,610222204,5541,668,3395,1890,6708,3247,939,3472,6719,3753,7148
ֵ´,JinLingJieDaoBanShiChu,610302001,28848,4762,19053,14601,31243,18385,4067,17908,36293,18624,37677
·ֵ´,JingErLuJieDaoBanShiChu,610302002,38749,4922,24916,14880,41841,19118,6281,18450,37568,25036,49952
彪ֵ´,QingJiangJieDaoBanShiChu,610302003,43127,7824,28625,21002,52252,27229,7106,26241,53470,29432,58057
̷ֵ´,JiangTanJieDaoBanShiChu,610302004,30506,2981,19151,12422,34486,15670,5914,15962,31632,20250,39401
Ͻֵ´,QiaoNanJieDaoBanShiChu,610302005,81585,8068,51240,30581,76536,40433,11728,39008,79441,50141,101381
Ӫ,MaYingZhen,610302100,44485,3971,27303,16667,42910,24991,8398,26173,51164,29551,56854
ʯ,ShiGuZhen,610302101,18640,1593,11311,8431,15395,11100,3638,12233,23333,12560,23871
ũ,ShenNongZhen,610302102,18325,1624,11338,8090,15840,11243,3328,11739,22982,11939,23277
߼,GaoJiaZhen,610302103,15612,1649,9622,6673,14602,9431,2727,9990,19421,10366,19988
,BaYuZhen,610302104,20612,1839,12664,6626,23337,11688,4150,12582,24270,13937,26601
,ChaoYuXiang,610302200,8115,1482,5448,3432,11013,5354,1533,5463,10817,5682,11130
ɽ·ֵ´,ZhongShanDongLuJieDaoBanShiChu,610303001,24113,2830,15855,10641,22129,14567,3838,14211,28778,14926,30781
ؽֵ´,XiGuanJieDaoBanShiChu,610303002,40048,4274,22654,14395,31243,18591,5360,18426,37017,27028,49682
ɽ·ֵ´,ZhongShanXiLuJieDaoBanShiChu,610303003,12951,1725,8726,6757,13089,8715,2584,8495,17210,8534,17260
Ⱥ·ֵ´,QunZhongLuJieDaoBanShiChu,610303004,22003,2504,13042,9197,20232,12478,3994,12359,24837,15459,28501
·ֵ´,DongFengLuJieDaoBanShiChu,610303006,47056,6520,29934,20408,52625,27668,6819,27237,54905,30461,60395
ʮֵ̽´,ShiLiPuJieDaoBanShiChu,610303007,38241,4632,24985,18421,39726,24824,7116,24657,49481,25004,49989
½ֵ´,WoLongSiJieDaoBanShiChu,610303008,18369,1864,11398,6857,19834,9850,3485,9860,19710,12320,23718
²,ChenCangZhen,610303100,38203,3143,24017,18558,27233,23932,7754,24823,48755,25083,49100
,PanLongZhen,610303101,29869,3109,19292,8943,34396,16779,4924,17012,33791,18610,37902
ԭ,LingYuanXiang,610303200,10190,1337,6505,3501,12985,6452,1705,6700,13152,6727,13232
,JinHeXiang,610303201,13383,1456,8539,4252,16100,8017,2394,8345,16362,8694,17233
ʯ,XiaShiXiang,610303202,12873,1598,7997,4669,16541,7962,2274,8646,16608,8748,16745
,GuoZhen,610304100,93546,11029,59655,38398,105784,56934,17139,57670,114604,62059,121714
ƽ,YangPingZhen,610304101,32709,3745,20763,10264,41874,20679,6370,21609,42288,22061,42824
ǧ,QianHeZhen,610304102,35497,3578,21970,9965,42411,19982,6718,20556,40538,23823,45793
Ϫ,PanXiZhen,610304103,33935,3651,21321,10403,43532,21221,6625,22567,43788,22890,44211
,TianWangZhen,610304104,24621,2444,14949,7142,29326,14154,4300,15188,29342,16416,31365
Ľ,MuYiZhen,610304105,28303,3004,17881,9005,35878,17788,5176,18256,36044,18602,36483
ԭ,ZhouYuanZhen,610304106,33505,3587,20824,10105,40940,20304,5933,20977,41281,22201,43025
ִ,JiaCunZhen,610304107,19974,2206,12702,6479,25477,12661,3615,13030,25691,13093,25795
,QiaoZhen,610304108,19881,2155,12518,6173,25213,12410,3727,12778,25188,13245,25763
ع,XianGongZhen,610304109,39523,3341,25520,10743,41628,19619,6325,21479,41098,23669,49189
½,XinJieZhen,610304110,11829,1141,7561,3972,15458,7526,2709,8028,15554,8118,15679
ƺͷ,PingTouZhen,610304111,11483,1421,7126,3746,15134,6843,2257,7348,14191,8035,15161
Ȫ,XiangQuanZhen,610304112,9221,772,5802,3005,11874,5763,2251,6245,12008,6442,12244
ɳ,ChiShaZhen,610304113,10483,831,6741,3565,13777,6709,2880,7319,14028,7453,14194
ʯ,TuoShiZhen,610304114,9615,969,6026,2852,12649,5829,2320,6465,12294,6878,12904
,FengGeLingZhen,610304115,7699,723,4878,2421,9925,4818,1828,5195,10013,5372,10250
μ,DiaoWeiZhen,610304116,30021,2616,18239,9560,36987,18161,5849,19574,37735,20247,38486
,HuDianXiang,610304200,7615,860,4670,2430,9901,4612,1520,5062,9674,5325,9995
ǹ,ChengGuanZhen,610322100,77004,7949,48887,28272,84276,44876,15383,45993,90869,51449,100336
,GuoWangZhen,610322101,23228,2946,15196,7805,30468,14828,4887,15208,30036,15865,31061
,BiaoJiaoZhen,610322102,24485,2895,15404,8047,30925,15087,4285,15633,30720,16261,31665
ˮ,HengShuiZhen,610322103,30285,3826,19598,10587,39388,19022,5691,19112,38134,20204,39802
ׯ,TianJiaZhuangZhen,610322104,16926,1977,11091,6193,21784,11025,3290,10773,21798,11102,22193
Ӹ,MiGanQiaoZhen,610322105,24415,3034,15884,8692,32201,15410,4980,15447,30857,16545,32429
,GuoDianZhen,610322106,19062,2445,12452,7208,24909,12451,3639,12693,25144,12694,25146
ָ,NanZhiHuiZhen,610322107,25404,2998,16626,8736,32964,16585,4776,16463,33048,16552,33178
´,ChenCunZhen,610322108,18665,2208,12048,6105,24167,11811,3455,11705,23516,12280,24328
,ChangQingZhen,610322109,19049,2052,11365,5607,22225,11064,3361,10983,22047,13097,24462
,LiuLinZhen,610322110,22182,2506,13814,7793,28005,13096,3857,13155,26251,14731,28545
Ҧҹ,YaoJiaGouZhen,610322111,4646,592,2660,1871,5882,2494,720,2732,5226,3298,5958
,YinJiaWuXiang,610322200,16939,1981,10987,5867,22050,10906,3364,11079,21985,11297,22284
ƴ,TangCunXiang,610322201,18059,2521,11893,6395,23765,11762,3602,11933,23695,12289,24182
Һ,DongJiaHeXiang,610322202,11185,1217,7234,3979,14302,7170,2121,7100,14270,7289,14523
կ,FanJiaZhaiXiang,610322203,12310,1510,8133,4694,16202,8094,2505,8096,16190,8192,16325
,HanFengXiang,610322204,5221,638,3426,2002,6953,3399,1195,3541,6940,3628,7054
,FengMingZhen,610323100,57566,7164,37489,23529,69125,36049,11206,36431,72480,38447,75936
̼,CaiJiaPoZhen,610323101,56271,6893,36445,23987,61230,34132,10867,34524,68656,37586,74031
ԭ,WuZhangYuanZhen,610323102,21760,1961,13544,7799,25792,13190,4607,14257,27447,14784,28328
,YiDianZhen,610323103,26732,2923,16521,8084,30482,14945,4251,15531,30476,17385,33906
Ѵ,PuCunZhen,610323104,18255,2633,11647,6276,24005,11415,3348,11848,23263,12589,24236
ףׯ,ZhuJiaZhuangZhen,610323105,16729,2085,10702,5429,21451,10636,2964,10913,21549,11076,21778
໯,QingHuaZhen,610323106,20805,2332,12553,6603,26236,12412,3500,13696,26108,14084,26637
,ZaoLinZhen,610323107,24425,3015,15731,8375,31914,15610,5186,16716,32326,16895,32626
Ӻ,YongChuanZhen,610323108,37225,4675,23682,12462,48342,23224,7083,24526,47750,25301,48983
,AnLeZhen,610323109,20513,2113,12574,6661,26007,12480,3738,13586,26066,13790,26364
ܼ,CaoJiaZhen,610323110,15427,1375,8802,5628,18397,8496,3117,9534,18030,11117,19919
Ӫ,DaYingXiang,610323200,12628,1765,8344,4536,16568,8291,2453,8390,16681,8502,16846
ʿ,GuJunXiang,610323201,14862,2130,9551,5377,19164,9430,2573,9663,19093,10014,19565
,JingDangXiang,610323202,7515,953,4745,2490,9810,4710,1441,5059,9769,5164,9909
ǹ,ChengGuanZhen,610324100,68462,7480,42624,22318,83265,37944,13333,40110,78054,46651,89275
,TianDuZhen,610324101,15835,2027,10055,5371,20650,9947,3086,10594,20541,10893,20948
羮,WuJingZhen,610324102,26313,3764,17211,9337,34771,17001,5620,17735,34736,18486,35697
,JiangZhangZhen,610324103,38248,4044,23415,12903,48113,22135,8387,23849,45984,27264,50679
μ,DuanJiaZhen,610324104,18182,1877,11778,5703,23478,11691,4052,12206,23897,12333,24111
,XingLinZhen,610324105,18884,2076,11947,6403,24526,11786,3906,12679,24465,12919,24866
ٹ,ZhaoGongZhen,610324106,23052,2726,15326,8175,30716,15178,5517,15773,30951,15969,31295
,FaMenZhen,610324107,54685,5722,33461,15932,65532,30295,10445,32350,62645,37391,70852
,NanYangZhen,610324108,15864,2132,10021,5604,20482,9909,2884,10646,20555,10859,20880
,ShangSongXiang,610324200,19441,1978,12288,6114,24839,12197,4343,13216,25413,13474,25762
̫,TaiBaiXiang,610324202,16588,1826,10664,5447,21326,10579,3623,11241,21820,11373,22037
,ShouShanZhen,610326100,51005,4677,31875,17702,54614,29409,9974,30207,59616,33781,65656
,HengQuZhen,610326101,22422,2543,13608,7898,28400,13512,4055,15231,28743,15412,29020
ѿ,HuaiYaZhen,610326102,16558,1900,10402,5581,20567,9635,3029,9960,19595,11085,21487
,TangYuZhen,610326103,28608,3140,17485,9392,35908,17072,4856,18323,35395,19119,36604
,ChangXingZhen,610326104,21017,2286,13339,7026,26362,12904,4433,13251,26155,14397,27736
,JinQuZhen,610326105,25584,2664,15981,8407,31675,15471,4810,16356,31827,17077,33058
Ӫͷ,YingTouZhen,610326106,16155,1604,9524,5010,17478,8322,2656,8873,17195,10891,20415
,QiZhen,610326107,22917,2886,14427,8633,29110,14308,3880,14976,29284,15256,29683
,MaJiaZhen,610326108,14238,1961,9263,5298,18158,8930,2918,9297,18227,9854,19117
໯,QingHuaXiang,610326200,12918,1662,8215,4552,16664,8078,2634,8709,16787,8999,17214
ǹ,ChengGuanZhen,610327100,50931,4141,31302,17021,57354,28392,10895,29898,58290,34665,65967
,DongFengZhen,610327101,13632,1483,8776,4788,17174,8675,3193,8965,17640,9532,18308
˶,BaDuZhen,610327102,6329,686,3972,2281,8385,3967,1418,4447,8414,4461,8433
,DuYangZhen,610327103,10064,1009,6680,3511,13362,6662,2543,6891,13553,6936,13616
,DongNanZhen,610327104,19257,1820,12454,6332,25184,12400,4771,13258,25658,13394,25848
ٵ,DiXiaZhen,610327105,10892,1043,7081,3740,14476,7037,2779,7499,14536,7633,14714
ˮ,WenShuiZhen,610327106,14698,1222,9564,4628,19462,9525,3888,10032,19557,10244,19808
,TianChengZhen,610327107,9326,930,6037,3328,12343,5997,2385,6513,12510,6604,12641
ܼ,CaoJiaWanZhen,610327108,11415,1085,7654,4100,15526,7510,3335,7835,15345,8181,15835
̹,GuGuanZhen,610327109,6216,684,4135,2234,8361,4126,1582,4303,8429,4347,8482
կ,HuoShaoZhaiZhen,610327110,5744,506,3583,1804,7198,3533,1380,3850,7383,4047,7630
,YaKeXiang,610327200,9529,960,6261,3237,12805,6207,2621,6634,12841,6849,13110
ӱ,HeBeiXiang,610327201,7854,696,4902,2417,10167,4893,1706,5335,10228,5354,10256
Һ,LiJiaHeXiang,610327202,6632,501,4150,2007,8583,4143,1582,4526,8669,4565,8715
¼,XinJiChuanXiang,610327204,4070,422,2675,1328,5455,2653,1046,2780,5433,2863,5538
ǹ,ChengGuanZhen,610328100,26408,2612,17208,11178,31202,16859,6491,17575,34434,18303,35511
޼ͷ,CuiJiaTouZhen,610328101,6168,704,3691,1987,7379,3610,1148,3815,7425,4329,8020
կ,NanZhaiZhen,610328102,15089,1806,9852,5324,19563,9684,3339,9880,19564,10382,20234
żܫ,ZhangJiaYuanZhen,610328103,6172,982,4456,2974,8598,4404,1744,4278,8682,4442,8898
ˮ,ShuiGouZhen,610328104,7136,655,4254,2359,8529,4176,1429,4539,8715,4966,9220
ݱ,CaoBiZhen,610328105,4621,389,2690,1442,4855,2500,928,2746,5246,3248,5938
ɳ,ShaJiaAoXiang,610328200,3418,383,2173,1200,4298,2164,601,2198,4362,2229,4402
ļ,WenJiaPoXiang,610328201,6030,806,3933,2387,8025,3902,1354,4160,8062,4257,8190
,ShiGouXiang,610328202,6657,724,4338,2396,8751,4285,1703,4641,8926,4746,9084
ܼҺ,KouJiaHeXiang,610328203,7865,810,5024,2768,10122,4989,1761,5317,10306,5412,10436
,GaoYaXiang,610328204,3017,326,1915,1108,3902,1908,683,2054,3962,2111,4026
ųɹ,JiuChengGongZhen,610329100,23257,1803,14194,9571,21992,14080,5120,14876,28956,15986,30180
ľ,CuiMuZhen,610329101,6596,590,3526,2011,7173,3422,1183,3769,7191,4843,8369
,ZhaoXianZhen,610329102,7577,755,4647,2716,9186,4644,1340,5022,9666,5025,9672
ͤ,LiangTingZhen,610329103,5064,559,3313,1770,6468,3256,1155,3339,6595,3465,6778
,TianTangZhen,610329104,4779,391,2354,1169,4516,2206,738,2411,4617,3554,5908
,ChangFengXiang,610329200,6300,570,4021,2058,8204,3969,1418,4135,8104,4267,8288
,HeXiXiang,610329201,2602,293,1628,872,3367,1625,601,1839,3464,1868,3496
ɰ,ZhangBaXiang,610329202,4753,513,2952,1461,6018,2907,899,3133,6040,3213,6165
ɣܫ,SangShuYuanXiang,610329203,2865,317,1772,940,3515,1751,483,1779,3530,1893,3665
Ʒ,JiuFangXiang,610329204,6177,706,3906,2125,8048,3882,1324,4191,8073,4301,8207
˫ʯ,ShuangShiPuZhen,610330100,27977,2733,17231,13600,28710,16908,5320,17594,34502,18799,36030
,FengZhouZhen,610330101,12547,1855,7478,4925,14916,7071,1858,7442,14513,8782,16260
ţ,HuangNiuPuZhen,610330102,5545,610,3204,1775,6783,3147,802,3342,6489,3753,6957
컨,HongHuaPuZhen,610330103,2957,386,1774,1017,3459,1714,386,1791,3505,1955,3729
ӿ,HeKouZhen,610330104,5083,581,3103,1613,6253,3041,842,3306,6347,3403,6506
Ʋ,TangCangZhen,610330105,3601,449,2274,1334,4491,2237,670,2292,4529,2446,4720
ƽľ,PingMuZhen,610330106,6664,850,4199,2240,8640,4147,1280,4497,8644,4595,8794
ƺ,PingKanZhen,610330107,3544,231,1218,1165,1855,1109,267,1797,2906,2824,4042
,NanXingZhen,610330108,5305,697,3186,1785,6294,2976,877,3175,6151,3693,6879
,SanChaZhen,610330109,4247,485,2476,1683,4467,2329,780,2574,4903,3036,5512
,YanWanXiang,610330200,3340,452,1999,1115,4092,1963,535,2187,4150,2328,4327
½,WenJiangSiXiang,610330201,1281,211,769,521,1612,754,244,917,1671,967,1736
ͷ,JuTouZhen,610331100,21187,1802,12632,6756,24035,10880,3959,11142,22022,14316,26948
Ҵ,TaoChuanZhen,610331101,4692,546,2945,1533,5734,2848,868,2935,5783,3161,6106
и,YingGeZhen,610331102,5329,630,3321,1765,6560,3179,945,3335,6514,3583,6904
,JingKouZhen,610331103,2503,263,1535,977,3103,1534,494,1708,3242,1725,3260
̫׺,TaiBaiHeZhen,610331104,1978,104,801,571,1206,771,256,861,1632,1537,2338
ܨ,WangJiaLengXiang,610331200,1123,149,707,407,1326,679,188,692,1371,753,1460
ưܫ,HuangBoYuanXiang,610331201,1377,175,795,503,1592,766,216,833,1599,973,1768
,GaoLongXiang,610331202,1647,226,1029,594,2094,999,271,1045,2044,1115,2144
·ֵ´,RenMinLuJieDaoBanShiChu,610402001,28039,4482,18744,12116,31752,16400,4117,15801,32201,17894,36638
·ֵ´,XiLanLuJieDaoBanShiChu,610402002,40463,6241,26969,17403,40100,23132,5680,22504,45636,25415,52384
ұֵ´,WuJiaBaoJieDaoBanShiChu,610402003,25963,2752,17705,9802,19988,13076,3625,13081,26157,14635,32340
μ·ֵ´,WeiYangXiLuJieDaoBanShiChu,610402004,59361,6145,37592,29116,59826,36332,10326,36365,72697,38240,75832
կֵ´,ChenYangZhaiJieDaoBanShiChu,610402005,30087,1995,19613,8538,29275,14254,4584,14248,28502,17053,36666
Ŷɽֵ´,GuDuJieDaoBanShiChu,610402006,39357,3445,25035,17771,35284,25002,7413,25133,50135,25180,50215
㶫ֵ´,FengDongJieDaoBanShiChu,610402007,22831,1550,12192,6272,22006,11666,3687,12372,24038,15876,28068
ֵ̨´,DiaoTaiJieDaoBanShiChu,610402008,51032,2740,32023,8792,37564,16698,4965,17268,33966,26714,58737
Ȫֵ´,MaQuanJieDaoBanShiChu,610402009,17629,2332,10851,6468,20210,10091,2618,10210,20301,11728,22579
μ,WeiBinZhen,610402102,38149,4477,24634,14735,43555,24365,7211,24804,49169,25203,49837
˫,ShuangZhaoZhen,610402104,28227,3032,18036,9547,36110,17994,5516,18631,36625,18739,36775
ׯ,MaZhuangZhen,610402105,20997,2269,13181,7166,26440,13040,3756,13685,26725,13841,27022
ֵ´,YangLingJieDaoBanShiChu,610403001,72571,3872,38940,14090,51603,19040,6389,19318,38358,43892,82832
Ȫ,WuQuanZhen,610403100,14268,1790,9310,5336,18787,9139,2952,9369,18508,9700,19010
̨,LiTaiXiang,610403200,25567,1783,15891,6214,23922,12047,4657,12481,24528,16116,32007
,YangCunXiang,610403201,15415,1647,10051,4956,19004,9642,3445,9873,19515,10456,20507
կ,DaZhaiXiang,610403202,11583,1300,7626,4391,15165,7617,2672,7876,15493,7929,15555
,RouGuXiang,610403203,22948,2425,15216,7931,30907,15214,5888,16037,31251,16045,31261
ɽֵ´,ZhongShanJieDaoBanShiChu,610404001,22931,3101,15141,10729,22466,14567,3726,14301,28868,14617,29758
Ļ·ֵ´,WenHuiLuJieDaoBanShiChu,610404002,61138,7924,37822,20762,58719,28001,7411,27454,55455,38651,76473
˽ֵ´,XinXingJieDaoBanShiChu,610404003,45000,6966,30543,19401,47061,28951,6812,27576,56527,28235,58778
μֵ´,WeiYangJieDaoBanShiChu,610404004,85964,6527,53136,31720,71000,42158,13339,42399,84557,52694,105830
μ,WeiChengZhen,610404100,18485,1710,10812,6511,18941,10253,3034,10609,20862,12417,23229
Ҥ,YaoDianZhen,610404101,17825,2131,11122,6122,22178,10990,2803,11011,22001,11637,22759
,ZhengYangZhen,610404102,29563,3212,18897,10978,36648,18816,5276,18761,37577,19154,38051
,ZhouLingZhen,610404103,25960,2113,14727,8003,27232,14245,4477,15055,29300,17823,32550
,DiZhangZhen,610404104,25373,1910,12740,6026,23388,11875,3380,12099,23974,17923,30663
,BeiDuZhen,610404105,15966,1604,9970,4727,19095,9588,2666,9680,19268,10266,20236
ǹ,ChengGuanZhen,610422100,85192,10702,55979,39428,100589,54173,15296,52338,106511,55211,111190
,AnLeZhen,610422101,11924,1646,7882,4392,15349,7532,2202,7439,14971,7890,15772
,BeiXiZhen,610422102,21392,2334,13341,6724,27024,12508,3588,12445,24953,13973,27314
,DuLiZhen,610422103,17604,2064,11013,5806,22088,10609,2812,10841,21450,11467,22480
,DaChengZhen,610422104,19345,2168,12296,6633,23156,11805,3102,11597,23402,12319,24615
,XiYangZhen,610422105,17915,2055,11271,5719,22352,10696,2714,10731,21427,11413,22684
³,LuQiaoZhen,610422106,19824,2127,12334,6258,24133,12105,2920,12176,24281,12537,24871
ǰ,LingQianZhen,610422107,22673,2588,14061,7072,28213,13516,3275,13618,27134,14475,28536
,MaEZhen,610422108,12158,1546,7539,4242,15290,7240,1695,7446,14686,7860,15399
,XinXingZhen,610422109,22271,2533,13582,7291,27761,13573,3061,14272,27845,14283,27865
,GaoQuXiang,610422200,13229,1647,8636,4872,16666,8632,2454,8693,17325,8694,17330
,QuAnXiang,610422201,24403,2502,15581,7754,23460,13397,4023,13297,26694,15347,30928
ľ,XuMuXiang,610422202,10533,1290,6675,3721,13285,6528,1712,6684,13212,6860,13535
϶,CuoEXiang,610422203,16446,2174,10444,5869,20663,9545,2385,9722,19267,10561,21005
,JingGanZhen,610423100,78628,7372,49984,25726,77820,46398,14518,46634,93032,50534,100518
,YongLeZhen,610423101,24935,2291,14685,7401,27380,13307,3788,13458,26765,16329,31014
,YunYangZhen,610423102,43002,4130,27431,12617,51423,25474,7407,25915,51389,27108,54539
ŵ,QiaoDiZhen,610423103,23000,2213,14611,7326,26925,13563,3707,13511,27074,14309,28920
,WangQiaoZhen,610423104,19429,2267,12328,6100,24598,12061,3286,12249,24310,12654,24982
,KouZhen,610423105,17717,1944,10923,5507,22417,10534,3153,10922,21456,11891,22814
,ZhongZhangZhen,610423106,16292,2123,10694,5434,21089,10531,3047,10559,21090,10768,21462
,SanQuZhen,610423107,29873,3550,19420,10019,37201,18976,5577,19217,38193,19580,39000
ׯ,GaoZhuangZhen,610423108,22250,2307,14129,6828,28154,13877,4358,14128,28005,14786,28915
¡,XingLongZhen,610423109,12427,1293,7866,3947,15605,7866,2215,8067,15933,8069,15935
,BaiWangZhen,610423110,14753,1759,9413,5001,18696,9398,2655,9660,19058,9754,19167
̫ƽ,TaiPingZhen,610423111,21274,2711,13699,7248,27209,13611,3868,14036,27647,14154,27853
,ChongWenZhen,610423112,15778,1678,10318,5031,20290,10308,3059,10176,20484,10197,20515
,YanWangXiang,610423201,11809,1469,7872,4468,15448,7840,2372,7719,15559,7778,15650
·,JiangLuXiang,610423202,14340,1563,9244,4890,18563,9137,2833,9363,18500,9492,18736
Ȫ,LongQuanXiang,610423203,13628,1632,8799,4888,17525,8795,2469,8924,17719,8930,17729
ǹ,ChengGuanZhen,610424100,71092,7142,43369,20647,82447,36515,13494,39151,75666,48359,91728
Ѧ¼,XueLuZhen,610424101,19155,2757,12829,6948,26174,12548,4384,12890,25438,13467,26296
,LiangCunZhen,610424102,22877,3127,15673,7970,32077,15664,6155,16449,32113,16486,32159
ƽ,LinPingZhen,610424103,21617,2313,13887,7185,28747,13605,5099,14608,28213,15142,29029
,JiangCunZhen,610424104,20651,2511,13584,6868,27448,13548,4651,14175,27723,14229,27813
,WangCunZhen,610424105,20772,2311,13852,7273,28037,13852,5090,14321,28173,14321,28173
,MaLianZhen,610424106,19711,2274,12785,6222,26023,12781,4207,13407,26188,13407,26192
,YangYuZhen,610424107,22345,2720,14569,7592,30029,14449,5209,15354,29803,15705,30274
,FengYangZhen,610424108,14425,1557,9356,4934,19690,9356,3801,10427,19783,10427,19783
ע,ZhuGanZhen,610424109,13134,1879,8634,5354,17903,8610,3027,9345,17955,9406,18040
Դ,LingYuanZhen,610424110,16210,2254,10675,5730,21688,10648,3388,11153,21801,11177,21852
,YangHongZhen,610424111,15561,2166,10154,5547,20214,10026,3203,10559,20585,10776,20930
ǽ,DaQiangXiang,610424200,8956,1460,6327,3715,12570,6286,2230,6259,12545,6319,12646
ܳ,ZhouChengXiang,610424201,17738,2395,11957,6931,24676,11804,4631,12319,24123,12807,24764
,DaYangXiang,610424202,30169,4012,19432,9811,40016,18976,6178,20359,39335,20927,40359
,XinYangXiang,610424203,16460,2115,10588,5896,22379,10553,3831,11623,22176,11818,22406
Į,MoXiXiang,610424204,13829,1711,9075,4956,18682,8972,3215,9475,18447,9680,18755
ɽ,LiangShanXiang,610424205,13371,1413,8643,4861,17958,8620,3262,9301,17921,9403,18046
ʯţ,ShiNiuXiang,610424206,8143,888,5295,3279,10899,5295,1957,5693,10988,5693,10988
ͷ,GuanTouXiang,610424207,4960,487,3339,1822,6823,3339,1408,3516,6855,3516,6855
ǹ,ChengGuanZhen,610425100,63904,5518,40516,24535,69422,37181,14720,40211,77392,43626,84142
ʷ,ShiDeZhen,610425101,27109,3533,17699,9541,36535,17699,5991,18933,36632,18934,36633
ű,XiZhangBaoZhen,610425102,17088,2260,11167,6399,22538,11157,3539,11692,22849,11720,22887
䶫,QianDongZhen,610425103,23587,2817,14981,7974,29968,14312,4458,14962,29274,15881,30862
,FengHuoZhen,610425104,20444,2494,12979,7204,26342,12979,3686,13628,26607,13645,26624
ϼ,YanXiaZhen,610425105,20799,2902,13427,8079,26909,13283,4010,14005,27288,14284,27711
,ZhaoZhen,610425106,20189,2968,13115,7433,26440,12765,3744,13352,26117,13786,26901
,JianLingZhen,610425107,14059,1932,9070,5345,18656,9030,3002,9847,18877,9923,18993
߳,ChiGanZhen,610425108,21414,2449,13619,6955,28561,13560,4711,14761,28321,14955,28574
Ϸ,NanFangZhen,610425109,16986,1702,10703,5960,22419,10687,3966,11911,22598,11951,22654
ʯ̶,ShiTanZhen,610425110,17855,2650,11430,6895,24072,11286,3630,12391,23677,12705,24135
ҩ,YaoWangDongXiang,610425200,19050,2416,12452,6857,24612,12314,4124,12693,25007,13138,25590
ʱ,XinShiXiang,610425201,19863,2705,12892,6931,26495,12892,3985,13661,26553,13661,26553
,JunMaXiang,610425202,18568,2454,12304,6751,24552,12216,3964,12529,24745,12682,24986
,ZhaoLingXiang,610425203,15055,2398,9986,5980,20415,9967,3073,10526,20493,10540,20526
,JianJunZhen,610426100,45384,3430,28021,14564,54384,24522,10142,26100,50622,30935,58956
ͷ,DianTouZhen,610426101,12234,1348,7905,4250,15991,7825,2632,8175,16000,8309,16214
,ChangNingZhen,610426102,12213,1083,8102,4227,16376,7997,3361,8212,16209,8555,16657
Ǿ,YiJingZhen,610426103,9060,1107,6115,3388,12127,5982,2335,6116,12098,6387,12502
ʾ,GanJingZhen,610426104,11235,999,7658,4234,15203,7571,3305,7787,15358,7881,15539
�,MaFangZhen,610426105,9252,754,5902,3121,12105,5814,2373,6308,12122,6477,12379
,DouJiaZhen,610426106,6313,681,4268,2420,8447,4219,1885,4414,8633,4611,8879
ݹ,YuJiaGongXiang,610426200,6496,694,4093,2340,8577,4051,1447,4417,8468,4544,8637
,DuMaXiang,610426201,3600,446,2510,1472,4863,2443,1010,2436,4879,2546,5056
,ShangYiXiang,610426202,8195,763,5418,2772,11067,5391,2199,5558,10949,5739,11157
,QuZiXiang,610426203,6198,607,3991,2158,8179,3938,1438,4117,8055,4252,8243
̫,YongTaiXiang,610426204,4199,508,2762,1589,5604,2738,1021,2847,5585,2966,5728
ƽ,YongPingXiang,610426205,3619,399,2087,1231,4335,2016,677,2182,4198,2608,4695
ǹ,ChengGuanZhen,610427100,62229,4263,36815,23581,60062,34915,15295,38326,73241,44972,81787
,BeiJiZhen,610427101,15186,1895,9920,5169,19829,9668,3567,10014,19682,10728,20648
,XinMinZhen,610427102,19965,2160,13388,7385,26544,13380,5249,13965,27345,13986,27374
,LongGaoZhen,610427103,12053,1294,7627,4183,15401,7582,2666,8195,15777,8386,16013
С,XiaoZhangZhen,610427104,13844,1503,9124,4859,18300,9047,3668,9315,18362,9891,19015
,YongLeZhen,610427105,12944,1592,8276,4421,16488,8191,2915,8995,17186,9175,17451
,YiMenZhen,610427106,25249,2948,16075,8547,33310,15978,5771,17513,33491,17893,33968
ˮ,ShuiKouZhen,610427107,10961,1263,7461,3858,14865,7445,3102,7849,15294,7865,15326
,XiangMiaoXiang,610427200,9268,951,5896,3509,11491,5877,2126,6403,12280,6449,12345
̿,TanDianXiang,610427201,11374,1145,6941,3566,14345,6745,2533,7390,14135,8111,15052
,XiPoXiang,610427202,10617,1400,7136,3691,14188,7080,2549,7232,14312,7430,14566
ׯ,CheJiaZhuangXiang,610427203,9347,949,5820,3055,11181,5747,2305,6264,12011,6781,12601
,HanJiaXiang,610427204,3122,393,1867,1143,4001,1858,610,2242,4100,2258,4125
׵,DiDianXiang,610427205,7488,793,4791,2503,9849,4753,1800,5165,9918,5290,10081
̫,TaiYuXiang,610427206,8634,896,5287,2923,10707,5215,1983,5650,10865,6226,11513
±,XinBuZiXiang,610427207,8531,842,5370,2798,10695,5328,2018,5716,11044,6021,11391
,ZhaoRenZhen,610428100,27340,2759,16642,8787,29348,13948,5426,14783,28731,18883,35525
๫,XiangGongZhen,610428101,9177,1115,5927,3383,12094,5898,2107,6348,12246,6472,12399
޼,JuJiaZhen,610428102,10705,1311,6901,3736,14316,6736,2631,7314,14050,7746,14647
,DingJiaZhen,610428103,7828,882,4649,2812,8819,4509,1518,4651,9160,5579,10228
,HongJiaZhen,610428104,9274,1174,6036,3425,12163,5925,2155,6317,12242,6567,12603
ͤ,TingKouZhen,610428105,15679,1686,9185,5350,18618,8551,3420,9381,17932,11600,20785
Ƚ,RanDianXiang,610428200,8092,758,4470,2746,8644,4298,1475,4889,9187,5855,10325
԰,YuYuanXiang,610428201,7017,924,4439,2429,9283,4335,1555,4751,9086,5057,9496
�,PengGongXiang,610428202,11225,1445,7313,4121,14960,7262,2554,7764,15026,7911,15224
,DiZhangXiang,610428203,13780,1761,8739,4789,18291,8649,2885,9399,18048,9687,18426
Ԫ,ZaoYuanXiang,610428205,5800,735,3760,2088,7712,3732,1377,4037,7769,4152,7912
ǹ,ChengGuanZhen,610429100,26220,1801,14012,6957,22331,10353,4430,11389,21742,18439,32451
,TuQiaoZhen,610429101,15855,1602,9923,5277,19471,9516,3338,10085,19601,10872,20795
ְ,ZhiTianZhen,610429102,18005,2047,11688,6045,23078,11363,4283,11959,23322,12647,24335
ź,ZhangHongZhen,610429103,13130,1365,8404,4429,16480,8144,2875,8615,16759,8966,17370
̫,TaiCunZhen,610429104,25386,2534,16366,7905,32770,16008,6053,17103,33111,17607,33973
֣,ZhengJiaZhen,610429105,14614,1461,8886,4623,17760,8726,3364,9349,18075,10553,19439
ͷ,QiuPoTouZhen,610429106,16547,2032,10794,5773,21586,10638,3916,11372,22010,11701,22495
,DiMiaoZhen,610429107,13706,1673,8579,4450,18005,8498,2833,9380,17878,9633,18212
ɰ,ZhangBaSiZhen,610429108,9014,887,5539,2930,11261,5488,1738,5990,11478,6100,11639
,MaLanZhen,610429109,9358,1143,5930,3129,11742,5671,2107,5930,11601,6678,12608
ܫ,QingYuanXiang,610429200,7695,809,4543,2415,9057,4412,1583,4784,9196,5544,10087
,ChiDaoXiang,610429201,8610,900,5477,2907,10791,5387,1953,5862,11249,5986,11463
ԭ,YuanDiXiang,610429202,10644,1436,7121,3953,14101,7022,2478,7253,14275,7437,14558
,PaiShaXiang,610429203,9219,1034,5748,2903,11790,5561,1888,6069,11630,6393,12141
ǹ,ChengGuanZhen,610430100,26194,1964,15563,12319,29803,14592,4261,15968,30560,16856,32419
ׯ,GuanZhuangZhen,610430101,13384,1320,8387,4118,16549,8049,2884,8536,16585,9201,17588
,MaJiaZhen,610430102,11381,1273,7079,4773,14338,6952,2034,7275,14227,7609,14688
,FangLiZhen,610430103,16415,1842,10157,5805,20411,10014,2610,10499,20513,10710,20867
,RunZhen,610430104,13649,1481,8507,4213,16594,8107,2327,8146,16253,8950,17457
,HuJiaMiaoXiang,610430200,11899,1107,7467,3956,15093,7389,2447,7808,15197,7986,15453
ʮܫ,ShiLiYuanXiang,610430201,11432,1305,7474,4221,14829,7461,2167,7389,14850,7430,14904
,BuJiaXiang,610430202,6448,707,4062,2177,8076,3993,1216,4188,8181,4309,8371
,CheWuXiang,610430203,5838,610,3695,1933,7340,3586,1089,3690,7276,3842,7537
,DaDianXiang,610430204,4882,464,2944,1764,5707,2884,865,3114,5998,3267,6211
ʯ,ShiQiaoXiang,610430205,5337,588,3109,1774,6324,2959,859,3146,6105,3675,6784
غ,QinHeXiang,610430206,6261,589,3683,2128,7618,3527,1262,3785,7312,4429,8112
,TieWangXiang,610430207,5436,575,3454,2070,6841,3381,1079,3519,6900,3636,7090
ׯ,QinZhuangXiang,610430208,6127,579,3760,1940,7544,3725,1013,3902,7627,3959,7719
,GuXianXiang,610430209,6531,629,4028,2119,8053,3982,1017,4067,8049,4149,8177
ռ,PuJiZhen,610431100,48909,4867,31285,15052,60162,27165,10963,28022,55187,33454,64739
շ,SuFangZhen,610431101,19877,2311,13166,6688,25463,12750,4641,13134,25884,13663,26829
书,WuGongZhen,610431102,33213,3844,20881,10195,43291,20118,6455,21267,41385,22631,43512
η,YouFengZhen,610431103,13744,1763,9691,5308,18913,9621,3570,9315,18936,9386,19077
Ԫ,ZhenYuanZhen,610431104,25599,2588,16475,8074,33905,16176,5991,17232,33408,17703,34178
,ChangNingZhen,610431105,23554,2416,15388,6825,31209,14764,5732,15407,30171,16314,31702
С,XiaoCunZhen,610431106,30664,4371,20811,11148,40664,19996,7087,20272,40268,21311,42122
ׯ,DaZhuangZhen,610431107,31056,3622,20524,9919,41678,20523,7396,21550,42073,21550,42074
,DaiJiaXiang,610431200,21009,2287,13874,6944,28431,13684,5272,14385,28069,14694,28568
ӵ,HeDaoXiang,610431201,19432,2047,12757,6369,26007,12689,4764,13378,26067,13486,26243
,NanRenXiang,610431202,16228,2099,11386,5737,22544,11136,4398,10999,22135,11339,22725
ռ,PuJiJieXiang,610431203,21627,2479,14641,6379,28961,14383,5437,14424,28807,14902,29543
ǽֵ´,DongChengJieDaoBanShiChu,610481001,85044,9608,53391,33301,86929,49567,16843,51548,101115,58104,111495
ǽֵ´,XiChengJieDaoBanShiChu,610481002,68378,10704,44387,27481,78827,40302,12734,40634,80936,47429,91816
Žֵ´,DianZhangJieDaoBanShiChu,610481003,20379,2573,13083,7062,26986,12375,4276,12682,25057,14145,27228
,MaWeiZhen,610481100,23198,2887,15622,8343,31739,15622,6030,16493,32115,16493,32115
Դ,ZhaoCunZhen,610481101,19667,2707,13534,7191,27495,13270,5606,13987,27257,14446,27980
ɣ,SangZhen,610481102,18335,2709,12846,7394,25506,12792,5039,13150,25942,13237,26083
,XiWuZhen,610481103,26598,3103,17497,8762,34919,17289,6436,18215,35504,18640,36137
,NanShiZhen,610481104,25004,2991,16403,8482,32957,16079,5636,16732,32811,17228,33631
ׯͷ,ZhuangTouZhen,610481105,21372,2684,13957,7307,28583,13796,4937,14710,28506,15036,28993
λ,NanWeiZhen,610481106,24714,3362,16513,9214,33466,16267,5906,16960,33227,17469,33982
,TangFangXiang,610481200,18700,2785,13225,7386,26458,13219,5254,13497,26716,13514,26739
︷,TianFuXiang,610481201,12948,1905,8809,4775,17443,8745,3275,8874,17619,9319,18128
,FengYiXiang,610481202,17697,2582,12277,6787,24390,12106,4777,12521,24627,12779,25056
կ,FuZhaiXiang,610481203,15964,2267,10899,5975,21732,10832,3940,11157,21989,11272,22171
Žֵ´,DuQiaoJieDaoBanShiChu,610502001,44093,4048,28500,19899,33298,26181,7131,25827,52008,26772,55272
ֵ´,RenMinJieDaoBanShiChu,610502002,51258,5195,32128,26681,51558,31887,9840,30916,62803,34165,66293
Žֵ´,JieFangJieDaoBanShiChu,610502003,19999,3137,13341,9986,18552,13046,3478,12924,25970,13273,26614
ֵ´,XiangYangJieDaoBanShiChu,610502004,33179,4136,21624,13109,36135,18905,5734,18359,37264,21425,43049
վϽֵ´,ZhanNanJieDaoBanShiChu,610502005,73717,6638,42828,23608,67111,31454,8666,31110,62564,46193,89021
˫ֵ´,ShuangWangJieDaoBanShiChu,610502006,22754,2416,15310,8126,29163,14911,4927,14743,29654,14787,30097
ֵ´,LiangTianJieDaoBanShiChu,610502007,14025,1260,8758,4765,13556,8093,2735,8240,16333,9262,18020
ҵ·ֵ´,ChongYeLuJieDaoBanShiChu,610502008,25541,1389,14676,8091,18742,11792,4259,11391,23183,16513,31189
,QiaoNanZhen,610502100,15625,1952,10517,6160,20983,10436,3690,10646,21082,10750,21267
,YangGuoZhen,610502101,21058,2754,14487,7974,27927,14345,5111,14207,28552,14436,28923
,GuShiZhen,610502102,21121,2782,14253,8276,27644,14250,4378,14025,28275,14028,28281
¼,XiaJiZhen,610502103,31927,4734,22361,13648,42320,22271,6561,20755,43026,20861,43222
,SanZhangZhen,610502104,19950,2625,13337,7205,26369,13206,4234,13208,26414,13472,26809
б,JiaoXieZhen,610502105,18529,2345,12403,6637,24448,12315,3794,12156,24471,12265,24668
,XinShiZhen,610502106,21936,2816,14561,8441,28169,14517,4427,14533,29050,14618,29179
,ChongNingZhen,610502107,20868,2410,13321,6716,26472,12857,3980,12909,25766,13937,27258
Т,XiaoYiZhen,610502108,15842,2430,10751,5771,19984,10625,3151,10507,21132,10672,21423
ߵ,LinDianZhen,610502109,18235,2814,12905,8178,24400,12899,4015,12146,25045,12159,25064
,TianShiZhen,610502110,16447,2184,10812,6041,21212,10752,3164,10879,21631,10983,21795
ٵ,GuanDiZhen,610502111,24606,3048,16292,8518,32055,16127,4586,15632,31759,15948,32240
·,GuanLuZhen,610502112,15269,2170,10245,5418,19863,9712,2754,9261,18973,9948,20193
ԭ,FengYuanZhen,610502113,19049,2298,12288,6623,24270,12023,3482,12147,24170,12541,24829
ִ,YanCunZhen,610502114,13854,1549,8873,4421,17153,8602,2904,8893,17495,9434,18307
,HeXiXiang,610502200,6894,823,4476,2499,9026,4464,1381,4614,9078,4622,9098
,DaiWangXiang,610502201,10848,1369,7262,3573,14744,7225,2675,7523,14748,7630,14892
,LongBeiXiang,610502202,15095,2066,10033,5853,20234,9988,3294,10313,20301,10422,20455
,XinYiXiang,610502203,15701,2240,10866,6185,20842,10859,3448,10513,21372,10523,21389
ʦ,NanShiXiang,610502204,13795,1823,9373,5221,18004,9262,2793,8869,18131,9038,18411
ƾ,PingXinXiang,610502205,9652,1414,6612,3898,12813,6590,1934,6338,12928,6388,13000
ٵ,GuanDaoXiang,610502206,19784,3085,13372,7832,26166,12891,4015,12708,25599,13512,26884
,HuaZhouZhen,610521100,35311,3836,21158,13102,35383,20191,5467,19810,40001,23456,44614
,XingLinZhen,610521101,20335,2490,13120,8363,22013,13023,3531,12928,25951,13236,26356
ˮ,ChiShuiZhen,610521102,15702,1750,10003,5405,19691,9998,2437,9879,19877,9886,19889
,GaoTangZhen,610521103,19898,2400,12598,6557,24406,12259,3169,12584,24843,12869,25467
,DaMingZhen,610521104,16393,1787,10292,5489,20659,10292,2557,10445,20737,10445,20737
,GuaPoZhen,610521105,23049,2539,14368,8248,28280,14189,3629,14519,28708,14849,29217
,LianHuaSiZhen,610521106,20078,2437,12417,7815,24741,12355,2868,12779,25134,12966,25383
֦,LiuZhiZhen,610521107,11012,1321,6995,3998,13854,6992,1882,7217,14209,7220,14215
,XiaMiaoZhen,610521108,17067,2007,10964,6068,21613,10919,2821,10886,21805,10931,21895
,JinDuiZhen,610521109,17972,1443,11153,7912,21262,10868,3329,11143,22011,11591,22744
ׯ,XinZhuangXiang,610521200,17509,2025,10879,5921,21778,10879,2519,11173,22052,11174,22053
,DongYangXiang,610521201,16037,1999,10141,5492,20470,10109,2574,10406,20515,10469,20610
,JinHuiXiang,610521202,9876,1182,6256,3563,12530,6248,1659,6452,12700,6461,12717
ϼ,BiJiaXiang,610521203,12537,1426,8175,4422,15930,8111,2288,7932,16043,8076,16251
ǹ,ChengGuanZhen,610522100,38581,3114,24708,15130,41544,23511,8107,23736,47247,25094,49802
ض,QinDongZhen,610522101,13923,1400,8907,4436,17519,8891,2543,8928,17819,8959,17866
̫Ҫ,TaiYaoZhen,610522102,20900,1343,11172,5723,21627,11127,3389,11459,22586,14460,25632
ͩ,TongYuZhen,610522103,10090,830,6045,3600,10874,6005,1708,6236,12241,6583,12628
Ӫ,DaiZiYingZhen,610522104,9315,798,5650,2755,11262,5621,1461,5775,11396,5924,11574
,AnLeXiang,610522200,8503,847,5090,2820,10031,4753,1569,4835,9588,5829,10919
,GaoQiaoXiang,610522201,11497,985,7409,3819,14380,7351,2180,7165,14516,7253,14662
ͷ,NanTouXiang,610522202,9807,904,6064,3053,12313,6064,1669,6315,12379,6316,12380
ǹ,ChengGuanZhen,610523100,88656,8580,55580,28801,93423,45148,13489,44498,89646,55145,110725
ׯ,XuZhuangZhen,610523101,31153,3521,20205,10345,38800,19168,5186,18603,37771,19655,39860
,ChaoYiZhen,610523102,16368,2193,10646,5815,20394,10488,2750,10496,20984,10665,21311
,AnRenZhen,610523103,24552,3055,15536,7562,30522,15326,3562,15435,30761,15633,31169
,LiangYiZhen,610523104,16128,2278,10027,5084,19963,9542,2166,9655,19197,10545,20572
Ǽ,QiangBaiZhen,610523105,27388,2927,16968,7794,33665,16097,4836,16480,32577,18183,35151
ٳ,GuanChiZhen,610523106,19902,2245,13178,6054,26172,13027,4512,13057,26084,13481,26659
,FengCunZhen,610523107,19665,2222,12585,5921,24922,11966,3349,12028,23994,12651,25236
˫Ȫ,ShuangQuanZhen,610523108,20808,2688,13330,6609,26538,13029,3379,12882,25911,13545,26875
,GaoMingZhen,610523109,19271,2523,12175,5891,23862,11957,2408,11688,23645,12027,24202
կ,XiaZhaiZhen,610523110,13254,1715,8626,4126,17123,8501,2262,8433,16934,8605,17231
Τ,WeiLinZhen,610523111,16493,1845,10897,5161,21594,10641,3690,10642,21283,11131,22028
,FanJiaZhen,610523112,21311,2981,13676,7055,27559,13450,3355,13319,26769,13971,27647
,HuJiaXiang,610523200,12912,1658,8453,4377,16285,8436,2170,8270,16706,8287,16740
,NianQiaoXiang,610523201,20901,2464,13522,6935,26705,13221,3817,13238,26459,13660,27182
ʿ,BoShiXiang,610523202,11877,1819,8091,4382,15821,7866,2241,7413,15279,7846,15937
,BuChangXiang,610523203,14547,1699,9293,4458,18518,9285,2393,9319,18604,9346,18639
μ,DuanJiaXiang,610523204,18245,2122,11481,5761,23297,11331,3102,11655,22986,11988,23469
,BaYuXiang,610523205,16609,1767,10280,5158,21189,10235,2904,10921,21156,11000,21280
ż,ZhangJiaXiang,610523206,15297,1658,9848,4437,19577,9788,2781,9773,19561,9888,19736
մ,SuCunXiang,610523207,20282,2407,13363,6623,26766,13196,4227,13226,26422,13553,26916
կ,XiZhaiXiang,610523208,9788,1283,6868,3979,12960,6866,2297,6497,13363,6500,13368
ʯ,ShiCaoXiang,610523209,23913,2325,15095,7324,30890,14910,4911,15742,30652,16054,31149
ɳ,ShaDiXiang,610523210,11035,1317,7089,3874,14213,7042,1990,7150,14192,7253,14342
Զ,ZhaoDuXiang,610523211,10781,1293,7282,3951,14105,7251,2462,7209,14460,7254,14536
ƽ,PingMinXiang,610523212,11423,1235,7470,3568,15024,7462,2451,7633,15095,7639,15109
Ӫҵ,GuoYingShanXiLiBeiQiYeGong,610523400,1771,442,1175,1027,2058,1106,224,1146,2252,1262,2437
ӪɳԷҵ,GuoYingShanXiShaYuanQiYeGong,610523401,1426,312,961,723,1769,906,259,944,1850,1036,1997
Ӫƺҵ,GuoYingShanXiHuangHeQiYeGong,610523402,1298,370,924,446,1879,620,221,687,1307,965,1889
ǹ,ChengGuanZhen,610524100,66055,4752,40550,22804,66307,35093,11942,36133,71226,42199,82749
ʾ,GanJingZhen,610524101,20381,2230,13037,6661,25770,12754,3613,12868,25622,13187,26224
,FangZhen,610524102,31579,3529,20709,10233,39929,20046,6005,19823,39869,20404,41113
Ǣ,QiaChuanZhen,610524103,6412,794,4281,2231,8421,4208,1387,4102,8310,4312,8593
³,XinChiZhen,610524104,21106,2572,13876,6932,27274,13273,4177,13231,26504,13979,27855
ڳ,HeiChiZhen,610524105,22266,2603,14957,7459,26659,13247,4424,12188,25435,14336,29293
·,LuJingZhen,610524106,29416,4226,19653,11476,37573,18592,4931,17952,36544,18920,38573
ͼׯ,HeJiaZhuangZhen,610524107,19081,2840,12981,7213,24963,12885,3514,12308,25193,12454,25435
,WangCunZhen,610524108,21729,2492,13521,8240,25528,13226,3808,13287,26513,14508,28029
ʸׯ,HuangFuZhuangZhen,610524109,6782,848,4303,2349,8589,4200,1219,4349,8549,4546,8849
ͬׯ,TongJiaZhuangZhen,610524110,15422,1975,9848,5334,19826,9741,2705,9934,19675,10254,20102
,BaiLiangZhen,610524111,30588,3532,19901,10212,39230,19367,6278,19804,39171,20497,40398
֪,ZhiBaoXiang,610524200,12227,1440,8098,4231,15825,8098,2297,7866,15964,7866,15964
ׯ,MaJiaZhuangXiang,610524201,13738,1709,9104,4971,17947,8997,2791,8829,17826,9134,18238
²կ,FangLuZhaiXiang,610524202,11412,1694,7397,3841,14495,7179,1874,7102,14281,7583,14980
ׯ,YangJiaZhuangXiang,610524203,7747,933,4922,2583,9645,4829,1366,4884,9713,5124,10046
ǹ,ChengGuanZhen,610525100,79477,7016,54190,36870,72910,52248,19324,49896,102144,51627,105817
ԭ,FengYuanZhen,610525101,21062,2885,13719,7454,27247,13511,4146,14041,27552,14374,28093
ׯ,WangZhuangZhen,610525102,18811,2145,11785,5948,20879,10451,3074,10853,21304,12245,24030
Ңͷ,YaoTouZhen,610525103,16294,2078,9327,7099,18828,9202,2238,10291,19493,11283,20610
ׯ,ZhaoZhuangZhen,610525104,11590,1540,7647,4333,15200,7634,2313,7755,15389,7796,15443
,JiaoDaoZhen,610525105,13690,2068,9323,5100,17880,9323,2525,8960,18283,8960,18283
ǰ,SiQianZhen,610525106,24990,3128,16054,7977,29144,14765,3435,14165,28930,15499,31553
Τׯ,WeiZhuangZhen,610525107,28034,3324,17627,9231,34292,16573,4121,16272,32845,17852,35479
׼,LeiJiaWaXiang,610525200,12698,1502,8475,4646,16641,8473,2600,8325,16798,8325,16800
ƻ,ShanHuaXiang,610525201,7206,1343,5018,3327,9796,5000,1455,4903,9903,4986,10004
,LiuJiaWaXiang,610525202,13917,1696,9065,4770,18219,8913,2911,9270,18183,9459,18524
,AnLiXiang,610525203,17593,2142,11546,5951,22859,11543,3671,11852,23395,11860,23406
޼,LuoJiaWaXiang,610525204,12719,1723,8631,4543,16688,8613,2528,8296,16909,8339,16970
ׯͷ,ZhuangTouXiang,610525205,16336,1933,10527,5282,20328,10463,2869,10503,20966,10611,21138
ǹ,ChengGuanZhen,610526100,77552,6642,45490,22215,67639,33084,13242,33831,66915,51946,97436
,HanJingZhen,610526101,33743,5068,22536,14499,42824,22454,6799,22662,45116,23074,45610
,SunZhen,610526102,25134,2401,15880,8180,30328,15395,4836,15734,31129,16491,32371
,XingZhen,610526103,22284,2448,14130,6817,27422,13992,4103,14268,28260,14705,28835
ľ,DangMuZhen,610526104,31543,3693,20519,10526,40213,20309,5685,20124,40433,20402,40921
,GaoYangZhen,610526105,13157,1683,8977,4704,16793,8579,3157,8516,17095,9020,17997
,YongFengZhen,610526106,19843,2464,12862,6581,25511,12817,3756,12933,25750,13201,26063
Ҧ,JingYaoZhen,610526107,42940,5334,28019,14309,54767,27347,8376,27469,54816,28631,56650
շ,SuFangZhen,610526108,23079,3136,15135,8039,30264,15135,4444,15523,30658,15524,30659
,LongYangZhen,610526109,19642,2265,12327,6045,24430,11956,3311,12049,24005,12891,25218
,DongChenZhen,610526110,15714,1621,9855,4530,19239,8744,2487,8730,17474,9967,19822
ͷ,PoTouZhen,610526111,18669,2013,12213,6094,23644,12111,3897,12257,24368,12366,24579
,LuoBinZhen,610526112,21149,2855,13729,8051,27359,13510,3942,13634,27144,14217,27946
ׯ,ChenZhuangZhen,610526113,19389,2118,12364,6169,23957,11987,3310,12059,24046,12453,24817
,XiangCunXiang,610526200,20319,2248,13175,6572,25087,13040,4187,13037,26077,13579,26754
,SanHeXiang,610526201,17033,1973,11167,5315,21336,11057,3379,11074,22131,11218,22385
,JiaQuXiang,610526202,21760,2508,14060,7063,27473,13777,4116,13995,27772,14324,28384
,DongYangXiang,610526203,18574,2049,12270,6002,23108,12270,3626,11979,24249,11979,24249
ԭ,YuanRenXiang,610526204,13146,2062,9007,4932,16716,8720,2612,8264,16984,8813,17820
,LongChiXiang,610526205,25842,3228,16752,8204,32754,16621,4504,16558,33179,16822,33574
,ChunLinXiang,610526206,24454,2994,16108,8271,31336,15974,4811,15978,31952,16151,32259
ƽ·,PingLuMiaoXiang,610526207,15493,1750,10091,5191,19666,9979,2949,9943,19922,10101,20192
,ShangWangXiang,610526208,16125,1881,10519,5364,20587,10339,3288,10513,20852,10775,21294
,DaKongXiang,610526209,12872,1629,8168,4445,16313,8052,2664,8537,16589,8997,17165
ǹ,ChengGuanZhen,610527100,54740,4094,34597,20098,49440,29621,12014,29843,59464,36251,70848
,FengLeiZhen,610527101,14830,2130,9410,5988,17767,9001,2708,9014,18015,10258,19668
Ң,YaoHeZhen,610527102,22023,2634,14224,7860,27154,13745,4441,14334,28079,14874,29098
ſ,DuKangZhen,610527103,15013,1531,9264,5286,18589,9175,2926,9719,18894,10206,19470
,XiGuZhen,610527104,13117,1460,8191,4808,16113,8188,2148,8524,16712,8534,16725
ָ,LinGaoZhen,610527105,16622,1902,10396,5600,21145,10308,3356,10940,21248,11484,21880
ʷ,ShiGuanZhen,610527106,11039,1428,7100,4019,14542,7089,2207,7524,14613,7574,14674
ͷ,BeiJingTouXiang,610527200,13753,1532,8743,4611,17266,8742,2287,8823,17565,8829,17572
,LeiYaXiang,610527201,8532,1276,5537,3136,11196,5514,1516,5757,11271,5787,11324
״,LeiCunXiang,610527202,11322,1406,7368,3976,14481,7367,2120,7473,14840,7480,14848
ˮ,ShouShuiXiang,610527203,4354,586,2839,1688,5656,2834,873,2949,5783,2974,5813
̨,YunTaiXiang,610527205,8232,1007,5337,2622,10546,5287,1895,5586,10873,5797,11134
Ŀ,ZongMuXiang,610527206,8634,947,5530,3042,11113,5514,1914,5925,11439,5965,11495
ܫ,BeiYuanXiang,610527208,11511,1276,7192,4130,15011,7192,2343,7937,15129,7938,15130
Ŵ,DuCunZhen,610528100,61654,6524,39354,23195,66609,35040,10711,34627,69667,39535,78889
ׯ,ZhuangLiZhen,610528101,47592,5742,27988,16400,54733,25671,6649,25624,51295,31995,59983
,ZhangQiaoZhen,610528102,25040,3247,16080,8095,30890,15120,4380,15230,30350,16587,32667
ԭ,MeiYuanZhen,610528103,36011,4468,23412,11440,46150,22018,7041,22362,44380,24108,47520
,LiuQuZhen,610528104,27690,2768,17068,8348,33500,16162,4557,16101,32263,17947,35015
,DanCunZhen,610528105,19795,2006,12032,5913,23384,11487,2975,11737,23224,12744,24776
,WangLiaoZhen,610528106,18689,2315,11850,5560,21569,10370,3374,10333,20703,12528,24378
,LiuGuZhen,610528107,22932,2749,15165,8040,27874,14142,3961,13754,27896,14477,29642
,LaoMiaoZhen,610528108,24810,3230,16168,8084,31882,15511,5617,15571,31082,17489,33657
Ѧ,XueZhen,610528109,28631,3224,17711,9000,34537,16015,4844,16635,32650,18988,36699
,DaoXianZhen,610528110,17974,2115,10940,5490,21796,10421,2847,10297,20718,11996,22936
ܴ,CaoCunZhen,610528111,23526,2858,14932,7862,29358,14042,4073,13657,27699,15525,30457
,GongLiZhen,610528112,26780,3156,16625,8872,33226,15943,4646,15930,31873,17957,34582
÷ƺ,MeiJiaPingZhen,610528113,23906,2542,14144,8309,28707,13260,3784,14095,27355,16088,30232
,LiuJiZhen,610528114,29728,4452,19633,10458,37854,18394,5989,17842,36236,20536,40169
,QiCunZhen,610528115,25511,2752,15942,8252,31278,15394,3931,15264,30658,16252,32194
,NanSheXiang,610528200,13491,1540,8353,4676,16474,8072,1956,8306,16378,8634,16987
,HuaZhuXiang,610528201,22771,2781,14679,7466,29188,14520,4116,14622,29142,14989,29668
Ϲ,DongShangGuanXiang,610528202,17650,2009,11462,6218,21991,11413,2985,11108,22521,11182,22644
,YuLingXiang,610528203,7481,907,4831,2585,9802,4815,1459,4995,9810,5016,9847
׵,DiDianXiang,610528204,13914,1894,9221,5196,18479,9177,2976,9462,18639,9563,18784
С,XiaoHuiXiang,610528205,15606,1872,10254,5510,20217,10154,3122,10179,20333,10346,20600
,BaiMiaoXiang,610528206,10256,1260,6789,3613,13473,6785,2098,6822,13607,6825,13614
,MiZiXiang,610528208,13896,1667,8546,4589,16896,8236,1882,8310,16546,8899,17445
³ǽֵ´,XinChengJieDaoBanShiChu,610581001,89395,7507,55436,33233,82260,52231,16034,52484,104715,57500,112936
ǽֵ´,JinChengJieDaoBanShiChu,610581002,39764,4655,25288,15788,44664,25065,7011,25284,50349,26142,51430
,LongMenZhen,610581100,44247,3595,25159,14895,47760,23954,8005,25126,49080,30688,55847
ɣƺ,SangShuPingZhen,610581101,15931,1490,8581,6557,19004,8516,2591,10856,19372,11431,20012
ͤ,LongTingZhen,610581102,12880,1356,8176,4911,16362,8173,2247,8292,16465,8307,16483
֥,ZhiChuanZhen,610581103,15095,1775,9539,5691,19052,9518,2376,9641,19159,9707,19246
ׯ,XiZhuangZhen,610581104,19581,2224,12384,6637,23293,11955,3440,12175,24130,12861,25245
ô,ZanCunZhen,610581105,11084,1413,7184,3911,13930,7178,1863,7174,14352,7176,14360
֥,ZhiYangZhen,610581106,15731,1841,9965,5760,19852,9964,2549,10155,20119,10156,20121
,PanLongXiang,610581200,4688,589,2691,1454,5330,2656,689,2792,5448,3275,5966
,QiaoZiXuanXiang,610581201,5515,632,3672,2273,7194,3671,1300,3772,7443,3775,7447
Ͷ,WeiDongXiang,610581202,8896,1303,5873,3774,11275,5866,1296,5606,11472,5622,11495
,BanQiaoXiang,610581203,7404,1072,4982,3225,9640,4978,1495,4956,9934,4989,9971
Ѧ,XueFengXiang,610581204,3703,511,2358,1405,4830,2343,659,2485,4828,2515,4873
,WangFengXiang,610581205,9588,1489,6242,4121,12527,6240,1588,6420,12660,6423,12665
Ȫ,DuQuanXiang,610581206,2326,303,1520,840,3033,1520,438,1547,3067,1547,3067
̫·ֵ´,TaiHuaLuJieDaoBanShiChu,610582001,39648,3540,24545,15221,45822,22705,7403,23451,46156,26046,50591
ֵ´,YueMiaoJieDaoBanShiChu,610582002,21790,2338,14142,7750,26586,14022,3939,13546,27568,13925,28067
Ȫֵ´,YuQuanJieDaoBanShiChu,610582003,33792,3923,20140,12870,38742,18153,5369,19017,37170,22944,43084
ܫ,MengYuanZhen,610582100,18904,2500,11892,7178,24467,11720,3283,12360,24080,12795,24687
,TaoXiaZhen,610582101,18931,3434,12161,9988,24394,12109,3646,13469,25578,13850,26011
ˮ,FuShuiZhen,610582102,21901,2815,14145,7985,26938,12652,4078,12516,25168,14649,28794
,HuaXiZhen,610582103,12999,1218,8295,4651,16482,8198,2772,8599,16797,8694,16989
,WeiYuXiang,610582200,7657,848,5098,2762,9706,5091,1536,4924,10015,4943,10041
巽,WuFangXiang,610582201,13396,1550,8811,5026,17405,8810,2761,8895,17705,8896,17707
,BeiSheXiang,610582202,7707,813,5160,2816,9900,5149,1615,4961,10110,4975,10135
Ӫɽҵ,GuoYingShanXiHuaShanQiYeGong,610582400,1543,224,843,690,1494,798,240,842,1640,1164,2007
ɽֵ´,BaoTaShanJieDaoBanShiChu,610602001,56817,3046,32852,18625,42306,24423,7525,25622,50045,34536,67388
нֵ´,NanShiJieDaoBanShiChu,610602002,44265,3106,28465,20085,36833,27855,9949,28003,55858,28855,57320
ɽֵ´,FengHuangShanJieDaoBanShiChu,610602003,35726,2375,22184,14003,25209,18574,6193,19001,37575,22110,44294
Ź,QiaoGouZhen,610602100,53202,2480,34091,23399,27768,33875,13663,34974,68849,35254,69345
԰,ZaoYuanZhen,610602101,13020,678,7894,3955,8557,5711,2137,6083,11794,7941,15835
ׯƺ,HeZhuangPingZhen,610602102,15356,821,9253,7105,17659,9253,2908,9828,19081,9832,19085
,LiQuZhen,610602103,16479,1242,9990,6607,17460,9863,3446,10584,20447,11177,21167
Ҧ,YaoDianZhen,610602104,15428,1158,9604,6965,14838,9477,3426,9980,19457,10408,20012
໯,QingHuaBianZhen,610602105,8326,774,5089,3551,9698,5026,1681,5572,10598,5692,10781
,PanLongZhen,610602106,5667,821,3470,2669,6416,3341,863,3598,6939,3881,7351
,LiuLinZhen,610602107,35982,1766,22335,14032,19991,21320,9243,22827,44147,24656,46991
,NanNiWanZhen,610602108,3828,339,2344,1517,4630,2318,793,2556,4874,2616,4960
,LinZhenZhen,610602109,5992,633,3486,2349,6198,3418,1137,3640,7058,4276,7762
ʹ,GanGuYiZhen,610602110,7137,721,4440,3351,7883,4344,1309,4616,8960,4727,9167
,ChuanKouXiang,610602200,7623,614,4909,2476,8902,4909,1901,5228,10137,5229,10138
,SongShuLinXiang,610602201,2361,244,1488,1050,2618,1453,533,1495,2948,1650,3138
ׯ,FengZhuangXiang,610602202,7727,722,4945,2599,9891,4938,1686,5160,10098,5190,10135
Ԫ,YuanLongSiXiang,610602203,3140,558,1976,1388,4032,1939,486,2139,4078,2208,4184
,LiangCunXiang,610602204,5571,673,3479,2187,7201,3479,991,3756,7235,3756,7235
鶴,MaDongChuanXiang,610602205,4875,589,3222,2134,6178,3222,1080,3309,6531,3322,6544
,GuanTunXiang,610602206,1706,317,1052,815,2089,1029,307,1064,2093,1278,2330
ׯ,GuanZhuangXiang,610602207,2875,335,1746,1172,3557,1741,437,1886,3627,1901,3647
ɽ,WanHuaShanXiang,610602208,21975,1050,13316,6413,7251,9286,3400,9739,19025,13109,26425
,QiLiCunZhen,610621100,45139,3373,29081,19778,42349,27904,10320,28933,56837,29751,58832
ڼұ,HeiJiaBaoZhen,610621101,6414,710,3913,2577,7924,3841,1072,4132,7973,4283,8196
֣ׯ,ZhengZhuangZhen,610621102,5174,503,3008,2003,5942,2978,940,3335,6313,3609,6617
ż̲,ZhangJiaTanZhen,610621103,8774,1201,5560,4261,11400,5559,1654,6053,11612,6069,11629
,JiaoKouZhen,610621104,5067,733,3132,2263,6249,3122,848,3474,6596,3516,6648
,AnHeZhen,610621105,2740,539,1696,1315,3577,1694,341,1923,3617,1924,3620
,GuoQiXiang,610621200,3182,445,1940,1427,3922,1940,460,2147,4087,2147,4087
Һ,LiuJiaHeXiang,610621201,3669,471,2262,1539,4638,2257,584,2460,4717,2462,4724
,AnGouXiang,610621202,5266,670,3294,2435,6629,3282,963,3552,6834,3605,6899
ɽ,LuoZiShanXiang,610621203,3717,516,2333,1673,4738,2319,714,2606,4925,2614,4947
׳,LeiChiXiang,610621204,3784,565,2348,1668,4806,2344,629,2616,4960,2630,4978
Ϻӹ,NanHeGouXiang,610621205,3106,592,1927,1513,4130,1926,516,2283,4209,2287,4214
Ӵ,YanChuanZhen,610622100,48079,2094,31102,19098,28834,30313,14281,32599,62912,33352,64454
ƺ,YongPingZhen,610622101,25920,1590,16831,11349,19798,16431,7237,17426,33857,17916,34747
ˮ,YanShuiGuanZhen,610622102,5980,671,3548,2466,7525,3509,906,3953,7462,4009,7557
İ,WenAnYiZhen,610622103,3288,417,1929,1278,4117,1924,473,2239,4163,2249,4178
̨,YangJiaGeTaiZhen,610622104,5319,815,3228,2057,6827,3228,775,3681,6909,3681,6909
ּƺ,JiaJiaPingZhen,610622105,4337,610,2662,1599,5504,2639,655,2901,5540,2940,5602
,YuJuZhen,610622106,5322,672,3229,2054,6765,3229,903,3668,6897,3668,6897
ׯ,GuanZhuangZhen,610622107,5511,802,3181,2049,6575,3138,725,3480,6618,3857,7038
߼,GaoJiaTunXiang,610622200,7137,744,4335,2768,8685,4329,1292,4719,9048,4838,9173
ƺ,FengJiaPingXiang,610622201,3240,371,1896,1187,3865,1894,459,2155,4049,2174,4070
ؼ,HeJiaWanXiang,610622202,2893,427,1717,1081,3463,1679,324,1851,3530,1927,3644
Һ,MaJiaHeXiang,610622203,5280,681,3163,1818,6675,3155,813,3570,6725,3611,6774
۲,YanChaSiXiang,610622204,3104,382,1840,1239,3873,1840,458,2104,3944,2104,3944
,TuGangXiang,610622205,2514,432,1603,1157,3355,1602,442,1781,3383,1785,3388
Ҥ,WaYaoPuZhen,610623100,85401,4348,54786,34050,58246,52854,23949,55493,108347,58912,113698
԰,YangJiaYuanZiZhen,610623101,8376,793,5328,3140,9412,5241,2079,5445,10686,5920,11248
,YuJiaWanZhen,610623102,4464,806,3075,1875,5922,3069,1061,3220,6289,3256,6331
,AnDingZhen,610623103,8418,1051,5648,3374,10838,5629,2223,5905,11534,6044,11692
,MaJiaBianZhen,610623104,6910,1039,4478,2809,8939,4474,1445,4852,9326,4916,9394
Ϲ,NanGouChaZhen,610623105,6055,784,4069,2083,7536,4069,1561,4331,8400,4331,8400
,JianYuChaZhen,610623106,7765,1191,5285,3065,10059,5271,1901,5478,10749,5572,10857
Ҳ,LiJiaChaZhen,610623107,8225,1061,5572,3491,10772,5571,2095,5738,11309,5809,11381
,ReSiWanXiang,610623200,2521,347,1484,1077,3152,1484,363,1747,3231,1747,3231
ʷ,ShiJiaPanXiang,610623201,6002,756,3903,2251,7650,3725,1266,3973,7698,4121,8024
ƺ,LuanJiaPingXiang,610623202,7475,678,4598,2771,8281,4587,1816,4814,9401,5371,9969
ƺ,YuJiaPingXiang,610623203,5213,493,2958,1979,5723,2941,953,3153,6094,3701,6659
,SiWanXiang,610623204,4441,455,2844,1694,5495,2834,1130,2959,5793,3182,6026
䶴,ZhenWuDongZhen,610624100,42827,2178,28032,17485,30809,25986,12897,27399,53385,29870,57902
שҤ,ZhuanYaoWanZhen,610624101,8751,792,5591,3192,10753,5541,2317,6036,11577,6269,11860
غ,YanHeWanZhen,610624102,10883,998,6767,4043,13036,6555,2618,6996,13551,7732,14499
а,ZhaoAnZhen,610624103,9396,823,6093,3395,11463,5971,2560,6421,12392,6686,12779
ƺ,HuaZiPingZhen,610624104,11233,797,6818,3837,11668,6181,2909,6653,12834,8121,14939
ƺ,PingQiaoZhen,610624105,8030,618,4383,2751,7838,4032,1849,4460,8492,6114,10497
,JianHuaZhen,610624106,10455,1010,6616,4377,11778,6462,2723,7000,13462,7572,14188
,GaoQiaoXiang,610624200,4986,474,3121,1871,5815,3078,1163,3265,6343,3502,6623
¥ƺ,LouPingXiang,610624201,3964,395,2436,1636,4774,2387,824,2587,4974,2747,5183
Ҥ,WangYaoXiang,610624202,8924,678,5016,2811,8722,4747,1851,5054,9801,6437,11453
,LianDaoWanXiang,610624203,5602,535,3375,2184,6287,3304,1454,3628,6932,4216,7591
,WangJiaWanXiang,610624204,3105,392,1771,1379,3347,1636,541,1797,3433,2267,4038
,BaoAnZhen,610625100,46315,1998,29198,17422,32353,27746,12058,29415,57161,31173,60371
Ӻ,XingHeZhen,610625101,10105,898,6225,3370,10869,5660,2210,5911,11571,6988,13213
˳,ShunNingZhen,610625102,6955,615,4108,2466,6681,3704,1290,3829,7533,4752,8860
,DanBaZhen,610625103,8146,614,4624,2925,7119,4217,1644,4570,8787,5780,10404
,JinDingZhen,610625104,6979,746,3838,2269,7373,3688,1170,3901,7589,5057,8895
,YongNingZhen,610625105,7257,649,4406,2566,8222,4223,1627,4610,8833,5127,9533
˫,ShuangHeXiang,610625200,6869,546,3786,2165,6785,3197,969,3469,6666,4598,8384
ֽ,ZhiFangXiang,610625201,4142,407,2158,1323,4170,2087,619,2240,4327,3010,5168
,YiZhengXiang,610625202,5563,458,3187,1736,5910,2920,1175,3176,6096,4009,7196
Ɽ,WuPuXiang,610625203,2899,270,1592,931,3033,1554,510,1667,3221,2087,3679
,ZhangQuXiang,610625204,3562,429,2265,1545,4151,2219,795,2270,4489,2521,4786
,WuQiZhen,610626100,55146,2327,32862,19822,33653,29017,13569,30668,59685,38180,71042
߳,TieBianChengZhen,610626101,4621,477,2676,1498,4394,2350,781,2547,4897,3203,5879
,ZhouWanZhen,610626102,4402,710,2874,1778,5758,2874,781,3019,5893,3019,5893
ױ,BaiBaoZhen,610626103,9905,1012,6159,3286,11183,5616,2004,5791,11407,6762,12921
,ZhangGuanMiaoZhen,610626104,3497,443,2198,1389,3496,2022,674,2053,4075,2416,4614
,ChangChengZhen,610626105,4111,554,2617,1532,5208,2575,784,2741,5316,2832,5449
ֱ,WuCangBaoXiang,610626200,5891,739,3761,2407,6834,3677,1201,3841,7518,4070,7831
կ,XinZhaiXiang,610626201,4716,506,2603,1522,4288,2251,711,2468,4719,3330,5933
,WangWaZiXiang,610626202,2904,341,1759,1055,3181,1682,626,1853,3535,2112,3871
�,MiaoGouXiang,610626203,4568,616,2681,1662,4911,2476,773,2828,5304,3276,5957
Ѧ,XueChaXiang,610626204,5561,586,3521,1849,6421,3411,1243,3482,6893,3869,7390
ȳ,WuGuChengXiang,610626205,6196,738,3982,2093,7117,3808,1347,3977,7785,4299,8281
ǹ,ChengGuanZhen,610627100,29208,1564,18468,11518,23670,17646,7370,18430,36076,19674,38142
,XiaSiWanZhen,610627101,8151,554,4708,3193,7373,4530,2046,5014,9544,6043,10751
,DaoZhen,610627102,6794,746,4196,2742,7627,4038,1419,4326,8364,4763,8959
,QiaoZhenXiang,610627200,3176,407,1921,1411,3568,1867,709,2077,3944,2371,4292
ʯ,ShiMenXiang,610627201,3586,489,2271,1566,4364,2238,633,2379,4617,2437,4708
,GaoShaoXiang,610627202,2738,353,1724,1227,3428,1724,478,1840,3564,1845,3569
ɽ,LaoShanXiang,610627203,3423,338,1928,1220,3421,1873,615,2024,3897,2448,4376
,DongGouXiang,610627204,1849,266,1128,803,2197,1085,276,1200,2285,1263,2391
,FuChengZhen,610628100,30557,2207,19308,10132,31238,15464,6829,16309,31773,20285,39593
Ȫ,YangQuanZhen,610628101,11693,1263,7570,4233,14658,7558,2925,8288,15846,8311,15881
Ŵ,ZhangCunYiZhen,610628102,8428,874,4909,2871,9644,4817,1446,5420,10237,5839,10748
ż,ZhangJiaWanZhen,610628103,7591,559,4483,2478,8148,4282,1715,4713,8995,5382,9865
ֱ,ZhiLuoZhen,610628104,6746,690,4040,2277,7982,3901,1197,4258,8159,4593,8633
跻,ChaFangZhen,610628105,12048,1088,7350,4431,11824,7089,2512,7689,14778,8298,15648
ţ,NiuWuZhen,610628106,5553,488,3255,1969,6396,3185,1080,3590,6775,3866,7121
,JiaoDaoZhen,610628107,7448,805,4818,2675,9664,4788,1710,5122,9910,5145,9963
,JiZiXianZhen,610628108,5564,571,3424,1887,6790,3375,1152,3784,7159,3863,7287
ǯ,QianErXiang,610628200,6613,715,4248,2461,8255,4245,1638,4713,8958,4718,8966
ϵ,NanDaoDeXiang,610628202,2790,308,1744,905,3421,1715,664,1952,3667,2018,3762
,SiXianXiang,610628203,3513,413,2196,1361,4450,2196,740,2469,4665,2470,4666
,BeiDaoDeXiang,610628204,5611,639,3616,2261,7045,3604,1344,3951,7555,3978,7594
,FengQiZhen,610629100,42045,2874,26104,15731,35876,22714,10177,24402,47116,28992,55096
,JiuXianZhen,610629101,11741,1304,7263,3910,14886,7143,2422,7929,15072,8204,15467
ں,JiaoKouHeZhen,610629102,11373,378,5923,3788,7603,5098,1941,5478,10576,7769,13692
,LaoMiaoZhen,610629103,10613,1107,6551,3448,13140,6392,2207,7148,13540,7376,13927
,TuJiZhen,610629104,7380,826,4751,2584,9682,4749,1836,5291,10040,5291,10042
ʯͷ,ShiTouZhen,610629105,9813,929,6070,3617,11945,6070,2293,6964,13034,6965,13035
,HuaiBaiZhen,610629106,13222,1413,8397,4455,17344,8298,3003,9061,17359,9241,17638
е,PuDiXiang,610629200,5127,547,3153,1527,6599,3126,1008,3473,6599,3529,6682
,HuangZhangXiang,610629201,6924,776,4418,2239,8621,4370,1586,4788,9158,4868,9286
,YongXiangXiang,610629202,9370,1021,5796,3115,11895,5795,1902,6497,12292,6497,12293
,JingZhaoXiang,610629203,4544,434,2732,1523,5249,2690,751,2891,5581,2997,5729
,YangShuXiang,610629204,10627,1144,6679,3614,13671,6628,2321,7335,13963,7413,14092
ʯȪ,ShiQuanXiang,610629205,4100,487,2524,1424,4963,2508,710,2739,5247,2773,5297
ع,QinGuanXiang,610629206,7849,816,4755,2473,9809,4732,1612,5273,10005,5522,10277
,BaiYiXiang,610629207,6092,644,3986,1980,7762,3948,1566,4238,8186,4316,8302
ţ,ZhuNiuXiang,610629208,7499,754,4586,2536,9412,4562,1576,5163,9725,5243,9829
,DanZhouZhen,610630100,35486,2780,23614,16109,29607,21937,8939,22271,44208,23591,47205
,QiuLinZhen,610630101,6666,803,4218,2665,8267,4218,1297,4548,8766,4548,8766
,YunYanZhen,610630102,8414,951,5265,3447,10105,5258,1531,5611,10869,5631,10896
¥,GeLouZhen,610630103,5226,566,3227,1882,6503,3227,984,3549,6776,3549,6776
,JiYiZhen,610630104,5255,749,3397,2166,6725,3391,979,3571,6962,3586,6983
Ӣ,YingWangXiang,610630200,4152,425,2406,1612,4854,2404,624,2766,5170,2795,5201
,JiaoLiXiang,610630201,4771,629,2904,1936,5877,2904,724,3220,6124,3220,6124
ţϸ,NiuJiaXiXiang,610630202,5762,627,3596,2205,7138,3596,1078,3864,7460,3871,7467
к,XinShiHeXiang,610630203,4243,549,2506,1636,5235,2506,579,2840,5346,2865,5371
߰,GaoBaiXiang,610630204,3234,402,2014,1131,4081,2014,550,2172,4186,2172,4186
,HuKouXiang,610630205,3284,366,1891,1155,3839,1842,502,2094,3936,2261,4152
ٷ,ShouFengXiang,610630206,3250,381,1882,1336,4010,1882,445,2194,4076,2194,4076
ʯ,ShiBaoZhen,610631100,16438,1616,10197,6093,18955,9782,2974,10280,20062,10831,21028
̲,BaiMaTanZhen,610631101,3514,546,2284,1583,4267,2259,597,2297,4556,2373,4657
ӽ,WaZiJieZhen,610631102,1388,124,748,515,1444,710,188,795,1505,952,1700
,SanChaXiang,610631200,5929,545,3621,2167,7204,3588,1321,4050,7638,4174,7795
ͷ,JieTouMiaoXiang,610631201,3927,476,2460,1624,4700,2444,743,2654,5098,2686,5146
׿,FanJiaZhuoZiXiang,610631202,1844,255,1120,787,2320,1100,318,1253,2353,1297,2417
ʯ,HongShiYaXiang,610631203,739,132,454,329,850,437,98,480,917,515,969
,BaiYuXiang,610631204,942,151,571,416,1088,554,133,620,1174,655,1226
̨,GeTaiXiang,610631205,1494,246,917,654,1713,880,216,931,1811,1039,1956
ʍ,YaoYanXiang,610631206,1949,210,1110,822,2213,1082,339,1295,2377,1388,2498
ɽ,QiaoShanZhen,610632100,35665,2522,19814,12379,34020,17990,7115,18710,36700,25488,45302
ͷ,DianTouZhen,610632101,24250,1345,12600,9411,15006,12030,4081,13345,25375,17076,29676
¡,LongFangZhen,610632102,10863,1384,6974,4723,13316,6868,2356,7458,14326,7629,14603
ׯ,TianZhuangZhen,610632103,3670,585,2486,1788,4352,2437,930,2510,4947,2699,5185
,ADangZhen,610632104,4213,499,2676,1683,4701,2647,913,2822,5469,2949,5625
˫,ShuangLongZhen,610632105,5530,282,2135,2112,3033,2039,623,2661,4700,4300,6435
̫,TaiXianXiang,610632200,3954,647,2579,1656,4934,2512,852,2790,5302,2874,5453
ׯ,HouZhuangXiang,610632201,4056,655,2614,1683,5016,2534,696,2709,5243,2793,5407
ִ,CangCunXiang,610632202,4172,595,2720,1794,5273,2717,818,2851,5568,2865,5585
ƺ,YaoPingXiang,610632203,5259,429,2433,1640,4429,2325,844,2514,4839,4099,6532
ؽֵ´,BeiGuanJieDaoBanShiChu,610702001,80446,8387,51438,39065,65181,50205,14127,49752,99957,51522,102960
ֵֽ´,DongDaJieJieDaoBanShiChu,610702002,22395,3600,16031,10194,20507,13258,3412,12542,25800,13376,29407
·ֵ´,HanZhongLuJieDaoBanShiChu,610702003,45012,6528,30194,22815,43590,29534,8020,28255,57789,29366,59560
ɽֵֽ´,ZhongShanJieJieDaoBanShiChu,610702004,26671,3828,18036,12593,23413,16668,4426,15895,32563,16889,34925
ؽֵ´,DongGuanJieDaoBanShiChu,610702005,41153,4044,25774,14543,28799,18863,5490,17985,36848,24913,50687
Դֵ´,XinYuanJieDaoBanShiChu,610702006,12406,1358,6894,4132,12023,6246,1790,6143,12389,8660,15554
Ӫֵ´,ShuJiaYingJieDaoBanShiChu,610702007,7158,1048,4754,3188,8642,4746,1183,4606,9352,4635,9389
ֵ´,QiLiJieDaoBanShiChu,610702008,29884,3154,19169,12574,30936,18454,5611,18482,36936,19480,38649
,PuZhen,610702100,35007,4713,23293,16662,43896,23049,6580,22407,45456,23007,46300
,WuXiangZhen,610702101,18354,2806,12208,8869,23881,12162,3701,12519,24681,12653,24861
Ӷ,HeDongDianZhen,610702102,20501,2388,11338,7322,19224,9676,2699,9559,19235,14250,25588
,LongJiangZhen,610702103,16293,2159,10909,6984,20573,10803,3164,10573,21376,10707,21616
Ӫ,ZongYingZhen,610702104,18715,2890,12274,8013,23531,11885,3304,11558,23443,12635,24909
Ͼ,LaoJunZhen,610702105,20828,2244,10354,7248,25080,10324,3017,10453,20777,15735,26089
,HanWangZhen,610702106,7883,1530,5787,4193,10965,5782,1978,5590,11372,5604,11391
,WangJiangXiang,610702200,5504,955,3914,2944,7380,3901,1362,3827,7728,3907,7821
,XuJiaPoXiang,610702201,3622,703,2626,1985,4989,2625,892,2576,5201,2591,5217
ǹ,ChengGuanZhen,610721100,50073,5522,32477,23575,58889,30255,9951,30711,60966,33069,65546
ʥˮ,ShengShuiZhen,610721101,15606,2919,11042,8116,21521,10977,3422,10751,21728,10905,21947
ӿ,DaHeKanZhen,610721102,53537,5292,32604,19084,50267,26141,9325,25408,51549,35550,68154
Э˰,XieShuiZhen,610721103,12099,1687,8330,5468,16432,8326,2890,8310,16636,8346,16676
ɽ,LiangShanZhen,610721104,11936,1674,8168,5365,15710,8094,2568,7872,15966,8010,16178
,YangChunZhen,610721105,9268,1684,6760,4630,12907,6760,2319,6510,13270,6511,13271
̨,GaoTaiZhen,610721106,14960,2414,10438,6506,19243,9340,3727,9408,18748,10663,21101
¼,XinJiZhen,610721107,21454,4630,16154,11642,31840,16110,6287,16146,32256,16217,32371
ˮ,LianShuiZhen,610721108,10467,1551,7078,4158,13844,7037,2444,7282,14319,7384,14462
ƹ,HuangGuanZhen,610721109,10790,2109,8033,5649,14990,7805,3217,7636,15441,8083,16116
,QingShuZhen,610721110,16291,2688,11772,8350,22869,11770,4407,11599,23369,11614,23386
,HongMiaoZhen,610721111,11874,1948,7962,5082,16372,7898,2865,8503,16401,8725,16687
ĲҰ,MouJiaBaZhen,610721112,10279,1678,6722,4622,13290,6554,1983,6992,13546,7218,13940
,FaZhen,610721113,10140,1858,6984,4917,13927,6957,2176,7083,14040,7190,14174
ˮ,XiangShuiZhen,610721114,8121,1456,5493,3833,11262,5467,1812,5823,11290,5896,11389
СϺ,XiaoNanHaiZhen,610721115,7113,1595,4943,3293,10019,4900,1589,5210,10110,5354,10297
,BeiBaZhen,610721116,5821,973,4131,2470,8011,3984,1622,4027,8011,4285,8416
Ԫ,YuanBaZhen,610721117,4536,795,3015,2359,6202,2934,1171,3176,6110,3487,6502
Ӫ,HuJiaYingXiang,610721200,14054,1718,9165,5695,18405,9165,2695,9300,18465,9302,18467
Ъ,XieMaXiang,610721201,4829,758,3251,2197,6587,3250,1067,3395,6645,3403,6654
̲,GuoTanXiang,610721202,8187,1336,5900,4097,11260,5900,2035,5657,11557,5658,11558
ˮ,RenShuiXiang,610721203,4600,1024,3443,2536,6727,3430,1291,3425,6855,3472,6915
,LiangHeXiang,610721204,4225,978,3096,2297,6172,3075,1151,3176,6251,3258,6354
,TangKouXiang,610721205,3736,934,2835,1923,5551,2833,1063,2881,5714,2898,5733
ϲ,XiShenBaXiang,610721206,3643,797,2731,1937,5349,2726,1039,2738,5464,2748,5479
߼,GaoJiaLingXiang,610721207,6482,1069,4486,3033,8573,4451,1403,4378,8829,4468,8954
,XiHeXiang,610721208,1857,361,1306,851,2526,1273,468,1305,2578,1380,2686
,FuChengXiang,610721209,2699,634,1922,1156,3983,1903,744,2104,4007,2155,4077
,BaiYuXiang,610721210,1351,239,916,522,1966,916,379,1053,1969,1053,1969
κ,WeiJiaQiaoXiang,610721211,1405,438,996,746,2101,989,332,1135,2124,1179,2175
,BoWangZhen,610722100,86344,9991,59124,38114,89419,54251,20040,52377,106628,57251,116375
ͷ,LongTouZhen,610722101,19686,2588,12678,7497,25680,12277,4003,12535,24812,13599,26277
ɳӪ,ShaHeYingZhen,610722102,11836,1726,8031,4983,15389,7673,2662,7519,15192,8193,16224
Ĵ,WenChuanZhen,610722103,10660,1642,7120,4098,13922,6766,2358,6797,13563,7540,14660
,LiuLinZhen,610722104,12663,1620,8430,4857,16777,8017,2680,7751,15768,8533,16963
ׯ,LaoZhuangZhen,610722105,20952,3385,14052,10156,27502,13990,4268,14341,28331,14553,28605
޼ɽ,CuiJiaShanZhen,610722106,14001,1857,9298,6141,17352,9002,2941,8807,17809,9501,18799
԰,JuYuanZhen,610722107,24081,3607,16481,10776,32340,16120,5491,15746,31866,16698,33179
ԭ,YuanGongZhen,610722108,13294,2278,9478,6786,18499,9315,3287,8999,18314,9381,18859
Ԫ,ShangYuanGuanZhen,610722109,20644,3593,14585,8642,28823,13960,5158,13650,27610,14810,29395
,TianMingZhen,610722110,13603,2166,8881,5693,17865,8790,2665,9271,18061,9553,18434
,ErLiZhen,610722111,12845,2026,8430,5335,16926,8108,2551,8426,16534,8992,17422
,WuDuZhen,610722112,7875,1131,5024,3125,10083,4812,1590,5107,9919,5572,10596
ƺ,SunPingZhen,610722113,5562,808,3732,2413,7379,3699,1204,3779,7478,3842,7574
˫Ϫ,ShuangXiZhen,610722114,2096,410,1260,822,2821,1193,384,1414,2607,1630,2890
ˮĥ,ShuiMoZhen,610722115,2808,538,1807,1220,3759,1783,529,1994,3777,2068,3875
С,XiaoHeZhen,610722116,3085,552,1894,1240,3865,1837,578,1984,3821,2321,4215
ɽ,BaoShanZhen,610722117,10126,1344,6734,3965,13206,6603,2113,6646,13249,6849,13583
,WuLangMiaoXiang,610722200,8927,1108,5743,3332,11356,5606,1779,5758,11364,6071,11814
,SanHeXiang,610722201,12593,1841,8465,5477,17003,8300,2708,8334,16634,8677,17142
Ӫ,DongJiaYingXiang,610722202,16968,2734,11871,6976,23060,11702,4002,11371,23073,11833,23704
,DaPanXiang,610722203,4868,769,3113,1905,6432,3099,919,3370,6469,3443,6556
ξ,YanJingXiang,610722204,3850,601,2541,1526,5089,2534,798,2657,5191,2708,5249
,PanLongXiang,610722205,1786,417,1082,776,2274,1053,310,1226,2279,1431,2513
,YangZhouZhen,610723100,48454,4379,31859,20784,42461,29623,11516,29298,58921,32490,64349
,QiShiZhen,610723101,17685,2269,11293,7412,23192,11173,3873,12153,23326,12534,23827
Ϫ,GuanXiZhen,610723102,11913,1639,8057,5021,15506,8017,2733,8112,16129,8228,16285
ͤ,LongTingZhen,610723103,17228,2124,10953,6547,22562,10876,3504,11666,22542,11903,22856
л,XieCunZhen,610723104,28100,4494,18790,12619,36560,18202,5872,18168,36370,19676,38466
�,MaChangZhen,610723105,11040,1838,7662,5462,15000,7525,2674,7523,15048,7890,15552
ˮ,XuShuiZhen,610723106,13043,2162,8971,5767,17804,8730,3127,8610,17340,9361,18332
ˮ,YiShuiZhen,610723107,7589,1328,5137,3600,10659,5087,1879,5558,10645,5659,10796
ĥ,MoZiQiaoZhen,610723108,19292,2973,12895,8012,26168,12568,4402,12826,25394,13772,26667
ƼӪ,HuangJiaYingZhen,610723109,9188,1472,6263,4542,12933,6255,2375,6737,12992,6772,13035
ư,HuangAnZhen,610723110,10998,1769,7504,4823,14946,7480,2539,7700,15180,7802,15306
ƽϿ,HuangJinXiaZhen,610723111,6929,1167,4629,2917,9684,4629,1692,5155,9784,5159,9788
,HuaiShuGuanZhen,610723112,18339,2605,12233,7440,25058,12148,4699,13054,25202,13410,25643
ˮ,JinShuiZhen,610723113,6430,977,4108,2656,8676,4033,1482,4546,8579,4781,8889
,HuaYangZhen,610723114,4990,630,3137,1920,6058,3023,1146,3398,6421,3629,6766
éƺ,MaoPingZhen,610723115,4148,700,2674,1729,5628,2590,1059,2945,5535,3233,5907
ʯ,BaiShiXiang,610723200,4230,711,2793,1916,5806,2792,945,3061,5853,3093,5886
Ϫ,ChangXiXiang,610723201,4672,831,3106,2074,6459,3085,1032,3317,6402,3429,6535
,SiLangXiang,610723202,5890,957,3892,2593,8150,3892,1436,4391,8283,4391,8283
ص,GuanDiXiang,610723203,4075,714,2732,1832,5800,2731,1060,3112,5843,3117,5849
Ҥƺ,YaoPingXiang,610723204,896,192,589,383,1260,588,223,711,1299,722,1311
,CaoMiaoXiang,610723205,9974,1509,6731,4109,13494,6713,2213,6844,13557,6965,13696
ʯ,ShiGuanXiang,610723206,3311,521,2220,1540,4518,2212,796,2348,4560,2408,4628
,YangTianXiang,610723207,3054,560,2098,1321,4378,2096,868,2373,4469,2384,4482
ɣϪ,SangXiXiang,610723208,5531,893,3372,2089,7310,3340,1289,3983,7323,4341,7713
,BaLiGuanXiang,610723209,2235,390,1392,991,3011,1386,509,1706,3092,1742,3134
ǹ,ChengGuanZhen,610724100,73820,8222,50201,34642,72110,47950,17825,46614,94564,49666,99867
,YangHeZhen,610724101,18644,2594,12542,8974,24348,12534,4430,13007,25541,13126,25668
,LiuShuZhen,610724102,14239,1963,9922,6679,19472,9917,3924,10191,20108,10204,20126
ɳ,ShaHeZhen,610724103,18185,2718,12268,8626,23566,12131,4197,12471,24602,12832,25100
˽,SiDuZhen,610724104,5771,1097,3938,2741,7902,3904,1243,4081,7985,4173,8111
ɣ԰,SangYuanZhen,610724105,6940,1078,4748,3336,9284,4703,1587,4713,9416,4857,9605
,BaiLongTangZhen,610724106,9818,1523,6712,4770,13328,6710,2147,6737,13447,6776,13488
ų,GuChengZhen,610724107,11010,1715,7484,4887,14246,7356,2459,7303,14659,7700,15184
Ͽ,XiaKouZhen,610724108,8850,1385,6124,4234,11710,6118,2244,6344,12462,6355,12479
߿,YanKouZhen,610724109,17238,2569,11661,8371,21318,11514,4165,11850,23364,12311,23972
,ChaZhen,610724110,6628,1314,4566,3189,9391,4480,1697,4862,9342,5073,9639
ߴ,GaoChuanZhen,610724111,8768,1900,6168,4191,12744,6120,2485,6834,12954,6985,13153
ӿ,LiangHeKouZhen,610724112,8690,1811,5945,3994,12810,5940,2557,7070,13010,7113,13058
,WuLiBaZhen,610724113,5323,1001,3575,2242,7746,3553,1594,4268,7821,4343,7918
,DaHeZhen,610724114,3146,754,2156,1400,4605,2152,816,2528,4680,2560,4716
,LuoZhen,610724115,3531,521,2200,1336,4720,2200,734,2586,4786,2586,4786
Ұ,LuoJiaBaZhen,610724116,5459,1096,3677,2738,7777,3659,1337,4135,7794,4215,7892
Ϫ,ZuoXiXiang,610724201,2867,576,1955,1233,4226,1936,854,2274,4210,2342,4297
˾,SiShangXiang,610724203,3140,544,1897,1280,3935,1878,605,2239,4117,2392,4289
,MaJiaWanXiang,610724204,3112,608,1984,1389,4354,1966,716,2395,4361,2452,4436
ʯ,SanHuaShiXiang,610724205,4134,845,2753,2083,5705,2688,917,2890,5578,3143,5896
,ZiWuXiang,610724206,1499,348,1001,813,2074,1001,322,1168,2169,1168,2169
Ͽ,BaiMianXiaXiang,610724207,4342,720,2802,1865,5915,2801,901,3160,5961,3161,5963
,MianYangZhen,610725100,65435,7707,42170,30251,75745,40315,11464,39751,80066,42436,84606
,WuHouZhen,610725101,15073,1863,8864,4290,13211,5862,1704,6520,12382,9776,18640
ܼɽ,ZhouJiaShanZhen,610725102,14653,2065,9711,5465,18954,9693,2519,9503,19196,9526,19237
ͬ,TongGouSiZhen,610725103,12357,1873,8337,5447,16445,8320,2419,8297,16617,8312,16649
ɳ,HuangShaZhen,610725104,7391,1029,5014,3116,9809,5006,1451,4832,9838,4857,9871
½,XinJieZiZhen,610725105,16327,2208,10826,6594,21358,10816,2996,10684,21500,10705,21531
ϵ,LaoDaoSiZhen,610725106,18127,2823,12040,7521,23620,11913,3216,11805,23718,12126,24166
,BaoChengZhen,610725107,9207,1137,5915,3347,11272,5819,1553,5794,11613,5982,11897
,ChangLinZhen,610725108,7483,1129,4985,3181,9780,4983,1343,4964,9947,4970,9955
Ȫ,JinQuanZhen,610725109,10029,1613,6677,4109,13198,6677,1721,6656,13333,6686,13363
ɽ,DingJunShanZhen,610725110,27024,4131,17650,12681,33292,17570,4759,17780,35350,18264,35914
Ȫ,WenQuanZhen,610725111,11989,2003,8176,5339,16045,8164,2136,7907,16071,7952,16128
Ԫ,YuanDunZhen,610725112,8957,1782,6208,4323,12626,6207,1971,6491,12698,6502,12710
,FuChuanZhen,610725113,7324,1283,5045,3490,10098,5045,1538,5100,10145,5100,10145
,XinPuZhen,610725114,11220,2169,7505,4976,15536,7496,2269,8133,15629,8153,15658
,QingYangYiZhen,610725115,5653,995,3827,2387,7528,3788,1175,3899,7687,3996,7823
,ChaDianZhen,610725116,7147,1182,4247,2723,8379,4076,1097,4480,8556,5179,9426
,ErDaoHeXiang,610725200,1600,312,1001,646,2161,983,309,1183,2166,1220,2221
,ZhenChuanXiang,610725201,11494,1629,7187,4355,13474,7017,1914,7223,14240,7850,15037
С,XiaoHeMiaoXiang,610725202,4015,916,2785,1783,5744,2785,927,3069,5854,3073,5858
,QiShuBaXiang,610725203,3327,857,2278,1711,4861,2263,729,2598,4861,2635,4913
,TuGuanPuXiang,610725204,5012,1111,3407,2371,7042,3406,978,3670,7076,3694,7101
С�,XiaoBianHeXiang,610725205,3489,780,2277,1507,4848,2277,682,2674,4951,2674,4951
,ChangGouHeXiang,610725206,3531,938,2243,1841,4885,2229,516,2665,4894,2742,4985
żҺ,ZhangJiaHeXiang,610725207,3766,812,2408,1469,5292,2391,760,2868,5259,2930,5338
Դ,HanYuanZhen,610726100,38519,3987,25042,15073,40238,22517,7934,22627,45144,25398,50440
կ,GaoZhaiZiZhen,610726101,13688,1816,9173,6360,18129,9086,2891,9056,18142,9222,18395
,DaAnZhen,610726102,15785,2886,11068,7100,21111,10634,3533,10479,21113,11136,22204
Ұ,DaiJiaBaZhen,610726103,13102,1909,8224,5317,16519,8208,2220,8888,17096,9007,17231
ƽ,YangPingGuanZhen,610726104,22089,3283,14637,9448,28808,14078,4115,14355,28433,14850,29487
,YanZiBianZhen,610726105,19970,2480,12570,7137,24997,12456,3592,13205,25661,13472,26042
ƺ,GuangPingZhen,610726106,7076,845,4407,2559,8734,4345,1304,4665,9010,4818,9225
ľ,QingMuChuanZhen,610726107,5046,663,3111,1968,6272,3072,939,3317,6389,3537,6648
ëӺ,MaoBaHeZhen,610726108,8441,1419,5538,3565,11613,5531,1923,6235,11766,6245,11783
,TieSuoGuanZhen,610726109,10821,1674,7114,4666,14353,6998,2323,7512,14510,7704,14818
Ұ,HuJiaBaZhen,610726110,10826,2053,7113,4729,14788,7064,2353,7997,15061,8119,15232
ɽ,BaShanZhen,610726111,7157,1165,4648,2787,9577,4566,1482,5004,9570,5156,9804
Ұ,ShuJiaBaXiang,610726200,5455,1029,3611,2336,7477,3577,1092,3882,7459,3965,7576
,MiaoBaXiang,610726201,3328,729,2134,1364,4522,1957,669,2297,4254,2592,4726
,NanPingXiang,610726202,3741,863,2427,1546,5247,2405,745,2859,5264,2922,5349
�,KuanChuanXiang,610726203,4474,731,2882,1826,6017,2873,932,3239,6112,3255,6137
Һ,GongJiaHeXiang,610726204,4366,848,2919,1714,5965,2896,946,3186,6082,3241,6160
ʹ,DongHuangGouXiang,610726205,2582,510,1671,1043,3479,1671,512,1933,3604,1933,3604
Һ,CengJiaHeXiang,610726206,4615,720,2926,1711,6057,2921,806,3199,6120,3215,6141
̫,TaiYangLingXiang,610726207,4460,629,2808,1557,5782,2785,770,3002,5787,3051,5859
,CangSheXiang,610726208,2984,424,1933,1102,3871,1928,653,2086,4014,2128,4061
ͤ,JuTingXiang,610726209,2395,353,1528,850,3099,1526,413,1603,3129,1633,3161
ֺ,AnLeHeXiang,610726210,6390,925,3981,2357,8310,3970,1104,4351,8321,4438,8419
,ChanJiaYanXiang,610726211,4013,722,2628,1760,5604,2610,978,3011,5621,3085,5713
ư,HuangBaYiXiang,610726212,2871,397,1878,1132,3787,1868,565,1927,3795,1955,3833
ɰ,ErLangBaXiang,610726213,4667,909,3247,2281,6723,3246,1261,3589,6835,3590,6837
ǹ,ChengGuanZhen,610727100,51700,6217,32309,22797,50440,30909,9579,32082,62991,35187,67496
ӹͤ,JieGuanTingZhen,610727101,8152,997,4683,2198,7547,3597,1035,4101,7698,5501,10184
ֺ,HengXianHeZhen,610727102,5397,596,3121,1927,5726,2953,863,3356,6309,3735,6856
ӿ,LiangHeKouZhen,610727103,3183,584,1982,1201,4115,1916,529,2154,4070,2314,4296
Һ,JinJiaHeZhen,610727104,4116,678,2473,1629,5164,2441,630,2821,5262,2951,5424
ƺ,XuJiaPingZhen,610727105,9588,1223,5878,3560,12172,5810,1685,6485,12295,6618,12496
ˮ,BaiShuiJiangZhen,610727106,7719,1014,4433,2824,8508,4193,1321,4601,8794,5621,10054
̿,XiaKouYiZhen,610727107,8007,1244,4435,2701,9472,4270,1336,4988,9258,6152,10587
μ,HeJiaYanZhen,610727108,3515,434,1919,1133,3485,1813,601,1947,3760,2631,4550
غ,LeSuHeZhen,610727109,5215,924,3235,2060,6392,3141,753,3317,6458,3657,6892
,GuoZhen,610727110,8463,1324,5247,3285,10495,5151,1550,5694,10845,6090,11337
ʯ,BaiShiGouXiang,610727200,7935,853,3390,1790,6649,3128,778,3630,6758,6176,9566
,MaTiWanXiang,610727201,4211,361,1569,947,3042,1481,410,1576,3057,3413,4982
�,XiHuaiBaXiang,610727202,2547,334,1582,972,3346,1565,507,1751,3316,1806,3388
н,JiuZhongJinXiang,610727203,3369,675,2134,1380,4357,2104,545,2382,4486,2455,4589
̨,XianTaiBaXiang,610727204,2578,532,1600,1027,3358,1579,374,1813,3392,1884,3484
,GuanYinSiXiang,610727205,2233,616,1469,1012,3141,1456,358,1703,3159,1738,3207
㶴,YuDongZiXiang,610727206,5427,714,2424,1416,4778,2252,653,2655,4907,4370,6794
ںӰ,HeiHeBaXiang,610727207,4343,675,2253,1456,4664,2184,609,2495,4679,3374,5627
ȸ,BaiQueSiXiang,610727208,5366,995,3333,2068,6942,3305,783,3713,7018,3811,7144
ʷԺ,ShiJiaYuanXiang,610727209,1938,418,1299,822,2615,1299,336,1393,2692,1393,2692
,JingYangZhen,610728100,28683,3138,18996,12166,31269,17986,6981,18465,36451,19806,38802
,YuDuZhen,610728101,8300,1351,5992,4004,11563,5992,2782,6441,12433,6441,12433
γ,YanChangZhen,610728102,10646,1284,7469,4437,15398,7469,3536,7996,15465,7997,15466
,GuanYinZhen,610728103,7498,1428,5017,3423,10443,5017,1859,5768,10785,5768,10785
,BaMiaoZhen,610728104,10496,1906,6868,4645,14795,6865,2709,8229,15094,8243,15111
¡,XingLongZhen,610728105,8595,1412,5354,3326,11637,5354,1833,6486,11840,6486,11840
,ChangLingZhen,610728106,9233,1525,6303,3576,13021,6302,2444,6898,13200,6899,13202
Ԫ,SanYuanZhen,610728107,9648,1840,6570,4157,13711,6570,2768,7686,14256,7686,14256
,JianChiZhen,610728108,4595,691,3071,2095,5985,3071,1168,3383,6454,3383,6454
,NianZiZhen,610728109,7128,1254,4645,3089,9860,4645,1825,5562,10207,5562,10207
С,XiaoYangZhen,610728110,6325,1067,4365,2757,8923,4365,1839,4860,9225,4866,9231
ˮ,QingShuiXiang,610728200,5024,869,3216,2034,7080,3177,1290,3852,7029,3967,7183
,YongLeXiang,610728201,3847,766,2746,1723,5689,2746,1143,3005,5751,3010,5756
¼̲,ChenJiaTanXiang,610728202,2971,606,2098,1333,4372,2088,872,2324,4412,2351,4449
Һ,YangJiaHeXiang,610728203,3100,680,2081,1570,4330,2080,733,2429,4509,2432,4513
,ChiNanXiang,610728204,7450,1231,5563,3719,10943,5563,2595,5713,11276,5713,11276
ɽ,BaShanXiang,610728205,7320,1177,4761,2666,9884,4676,2064,5305,9981,5800,10561
,DaChiXiang,610728206,3385,683,2335,1410,4925,2335,979,2712,5047,2712,5047
,TianBaXiang,610728207,5105,900,3224,1893,7067,3222,1222,3985,7207,4003,7227
̲,MaLiuTanXiang,610728208,3466,791,2318,1798,4985,2318,842,2781,5099,2781,5099
ƽ,PingAnXiang,610728209,6177,1142,3985,2634,8636,3985,1477,4811,8796,4811,8796
ʴ,RenCunXiang,610728210,4092,681,2887,1812,5737,2887,1125,3011,5898,3011,5898
,LiBaXiang,610728211,5464,825,3778,2230,7712,3778,1455,3966,7744,3966,7744
Ϫ,SanXiXiang,610728212,3721,678,2618,1528,5320,2618,1082,2863,5481,2863,5481
ǹ,ChengGuanZhen,610729100,8277,921,5245,3991,9779,5168,1548,5410,10578,5501,10746
,MaDaoZhen,610729101,3794,650,2395,1460,5009,2317,650,2592,4909,2699,5094
,WuGuanYiZhen,610729102,3925,660,2363,1548,5083,2330,560,2729,5059,2782,5145
,LiuHouZhen,610729103,2241,372,1364,847,2820,1322,375,1555,2877,1624,2988
,JiangKouZhen,610729104,5451,743,3413,2040,6833,3413,977,3757,7170,3758,7171
,QingQiaoYiXiang,610729200,1425,277,888,563,1845,873,245,1018,1891,1059,1947
յ,HuoShaoDianXiang,610729201,2274,403,1448,893,2990,1438,393,1600,3038,1622,3070
,YuHuangMiaoXiang,610729202,3888,632,2341,1458,5007,2304,620,2741,5045,2799,5140
ɣԪ,SangYuanBaXiang,610729203,1567,253,965,632,1933,965,277,1132,2097,1132,2097
Ԭׯ,YuanJiaZhuangZhen,610730100,8068,773,5029,3459,8750,4913,1688,5201,10114,5500,10529
¼Ұ,ChenJiaBaZhen,610730101,2530,386,1555,1049,3212,1547,449,1767,3314,1810,3365
Ӱ,DaHeBaZhen,610730102,2694,423,1636,1020,3173,1586,483,1798,3384,1964,3600
,XiChaHeZhen,610730103,2393,431,1495,993,3188,1492,442,1769,3261,1771,3266
ǰ,ChangJiaoBaXiang,610730200,1956,325,1165,737,2406,1137,345,1351,2488,1461,2626
ʮĶ,ShiMuDiXiang,610730202,1364,217,785,525,1812,784,249,1040,1824,1045,1830
ʯպ,ShiDunHeXiang,610730204,1290,183,751,511,1588,740,185,879,1619,907,1658
Ӱ,LiZiBaXiang,610730205,1248,207,772,496,1596,752,258,896,1648,941,1713
,YueBaXiang,610730206,1088,199,663,418,1431,652,201,792,1444,825,1488
¥ֵ´,GuLouJieDaoBanShiChu,610802001,34354,2623,22552,12620,20664,16876,6839,16308,33184,21264,43816
ɽ·ֵ´,QingShanLuJieDaoBanShiChu,610802002,42578,2313,27031,17863,21339,24602,10128,25126,49728,27988,55019
Ͽ·ֵ´,ShangJunLuJieDaoBanShiChu,610802003,47116,2699,29251,18558,15587,25647,10489,27176,52823,31053,60304
¥ֵ´,XinMingLouJieDaoBanShiChu,610802004,20497,2384,14084,8320,15252,10706,4535,10378,21084,13332,27416
շ·ֵ´,TuoFengLuJieDaoBanShiChu,610802005,45238,2269,29722,18477,16514,26868,12617,27801,54669,30402,60124
·ֵ´,ChongWenLuJieDaoBanShiChu,610802006,43425,1269,25406,12990,13964,17861,7179,18972,36833,26467,51873
·ֵ´,HangYuLuJieDaoBanShiChu,610802007,39366,1230,22885,12722,6440,16901,7363,17978,34879,25074,47959
,YuHeZhen,610802100,11895,968,7626,4860,11625,7533,2865,7958,15491,8102,15728
,ShangYanWanZhen,610802101,4864,770,3239,2165,6217,3174,812,3117,6291,3207,6446
,ZhenChuanZhen,610802102,18280,1805,11577,7219,15818,11118,3861,11685,22803,12369,23946
Ȫ,QingQuanZhen,610802103,3620,863,2500,1907,4902,2477,570,2480,4957,2553,5053
,AnYaZhen,610802104,3502,690,2175,1583,4423,2158,345,2286,4444,2362,4537
,MaHuangLiangZhen,610802105,7127,802,3857,2738,7227,3767,1207,4042,7809,5279,9136
ţ,NiuJiaLiangZhen,610802106,13683,1030,7836,5282,13635,7601,2639,8186,15787,9516,17352
̲,JinJiTanZhen,610802107,10649,932,6126,4139,10374,5617,2091,5942,11559,7546,13672
,MaHeZhen,610802108,7363,754,4490,2895,9159,4490,1318,4944,9434,4945,9435
,BaLaSuZhen,610802109,5790,750,3615,2530,7036,3573,1001,3780,7353,3926,7541
,YuYangZhen,610802110,57811,2158,35168,26093,20493,33707,13490,36055,69762,38291,73459
,YuHeMaoZhen,610802111,6214,1362,4428,3172,8044,4334,1229,4228,8562,4377,8805
ׯ,YuXingZhuangXiang,610802200,1450,431,1007,824,1982,987,151,998,1985,1025,2032
ǧ,LiuQianHeXiang,610802201,1904,514,1324,1108,2640,1322,238,1313,2635,1332,2656
,GuTaXiang,610802202,3366,572,2235,1757,4406,2235,690,2393,4628,2393,4628
,QingYunXiang,610802203,9733,781,6162,4197,9505,6117,2258,6470,12587,6610,12772
,DaHeTaXiang,610802204,3273,629,1985,1818,3569,1945,451,2160,4105,2368,4353
ϼ,MengJiaWanXiang,610802205,8336,937,5324,3297,10932,5321,1913,5846,11167,5862,11186
С,XiaoHaoTuXiang,610802206,6612,874,3958,3015,7585,3850,1060,4109,7959,4588,8546
,ChaHeZeXiang,610802207,4280,536,2691,1916,5410,2686,740,2857,5543,2865,5556
˺,BuLangHeXiang,610802208,5770,879,3707,2665,7423,3685,991,3877,7562,3933,7640
ʯ,HongShiQiaoXiang,610802209,6677,803,4115,2666,7591,3912,1191,4019,7931,4556,8671
Сͺ,XiaoJiHanXiang,610802210,8931,750,5049,3236,9554,4806,1551,5134,9940,6183,11232
ۺ,QinHeXiang,610802211,13111,966,8377,4463,10535,6873,2647,7109,13982,8347,16724
ľ,ShenMuZhen,610821100,159486,8059,96035,64642,92638,91035,36980,100411,191446,108490,204525
߼ұ,GaoJiaBaoZhen,610821101,6593,1391,4279,3648,7912,4251,878,4495,8746,4583,8862
,DianTaZhen,610821102,24408,1026,10143,7492,9604,8680,3147,10585,19265,18438,28581
Ҳ,SunJiaChaZhen,610821103,16190,1260,7333,4439,11309,6440,2133,7631,14071,12250,19583
,DaLiuTaZhen,610821104,49562,1239,23551,16979,14414,21689,9082,25246,46935,36332,59883
ʯ,HuaShiYaZhen,610821105,1627,742,1226,1311,2454,1226,135,1278,2504,1278,2504
м,ZhongJiZhen,610821106,13783,1398,8184,6357,9058,7404,2823,8300,15704,9820,18004
ؼҴ,HeJiaChuanZhen,610821107,2315,880,1663,1814,3387,1661,232,1764,3425,1764,3427
,ErLinTuZhen,610821108,7719,1185,5087,3992,9622,5049,1696,5388,10437,5513,10600
,WanZhen,610821109,2850,1039,1923,2084,3902,1883,255,2033,3916,2221,4144
󱣵,DaBaoDangZhen,610821110,11997,1039,6877,4679,12638,6340,2172,6870,13210,8331,15208
,MaZhen,610821111,3043,1155,2236,2095,4472,2217,407,2348,4565,2369,4605
˱,LanGanBaoZhen,610821112,2798,1066,1982,2013,4119,1979,293,2173,4152,2175,4157
ɳ,ShaMaoZhen,610821113,3730,1261,2607,2719,5367,2582,526,2870,5452,2910,5517
,JinJieZhen,610821114,21119,1306,10109,5687,12074,8055,3136,8978,17033,15452,25561
,MaJiaTaXiang,610821200,26323,1322,12242,5621,9393,7174,2918,8314,15488,18321,30563
ǲ̲,QiaoChaTanXiang,610821201,3440,1067,2399,2279,4854,2399,482,2590,4989,2590,4989
̫կ,TaiHeZhaiXiang,610821202,1384,522,961,977,2006,961,116,1061,2022,1061,2022
ұ,JieJiaBaoXiang,610821204,1882,691,1351,1351,2715,1337,185,1391,2728,1407,2758
,FuGuZhen,610822100,92697,4447,54798,36295,53437,49946,22250,56457,106403,64596,119394
Ƹ,HuangFuZhen,610822101,5934,975,2550,1803,4726,2213,447,2346,4559,4806,7356
,MaZhen,610822102,2244,584,1478,1222,3112,1477,332,1672,3149,1682,3160
,HaZhen,610822103,3702,1009,2348,1842,4623,2269,521,2399,4668,2884,5232
�,MiaoGouMenZhen,610822104,12925,823,5930,3922,7977,5419,2401,6131,11550,10219,16149
,XinMinZhen,610822105,15425,860,6485,3832,8154,5134,2086,5656,10790,11886,18371
ɽ,GuShanZhen,610822106,7660,772,4197,2677,7058,3712,1198,4118,7830,5433,9630
ˮ,QingShuiZhen,610822107,3681,935,2391,1717,4515,2253,663,2343,4596,2888,5279
,DaChangHanZhen,610822108,8814,530,3720,2059,4982,2943,1122,3250,6193,6746,10466
ų,GuChengZhen,610822109,4308,843,2392,1714,4705,2257,542,2435,4692,3301,5693
,SanDaoGouZhen,610822110,10046,622,4455,3006,5330,3739,1469,4328,8067,7682,12137
ϸߴ,LaoGaoChuanZhen,610822111,12026,833,5578,3224,9558,4913,2050,5300,10213,9331,14909
,HaiZeMiaoXiang,610822200,3105,622,1864,1279,3738,1793,413,2021,3814,2276,4140
ǽͷ,QiangTouXiang,610822202,1719,444,1157,841,2336,1132,234,1203,2335,1240,2397
,ZhaoWuJiaWanXiang,610822204,2147,520,1444,1128,2911,1415,308,1478,2893,1531,2975
կ,TianJiaZhaiXiang,610822208,6518,856,3983,2785,8452,3950,1487,4441,8391,4878,8861
ľ,MuGuaXiang,610822209,2810,782,1984,1354,4004,1944,471,2001,3945,2079,4063
ܨ,QiLengXiang,610822210,3549,660,1730,1354,3414,1614,399,1848,3462,2878,4608
ׯ,WuJiaZhuangXiang,610822211,2197,489,1351,988,2707,1290,332,1463,2753,1667,3018
Ҷ,WangJiaDunXiang,610822212,1856,566,1277,1024,2727,1277,325,1470,2747,1470,2747
ɽ,HengShanZhen,610823100,63898,4278,41163,23827,59013,40110,18070,43837,83947,45083,86246
ʯ,ShiWanZhen,610823101,9670,961,5985,3010,11431,5816,2311,5691,11507,6957,12942
,GaoZhen,610823102,13317,1499,8806,4964,17705,8764,3012,8946,17710,9022,17828
,WuZhen,610823103,10553,1654,6972,4038,13928,6772,2160,7087,13859,7395,14367
,DangChaZhen,610823104,14799,1716,9399,4930,18926,9316,2881,9783,19099,9997,19396
ˮ,XiangShuiZhen,610823105,7704,920,5013,2465,10230,4901,1695,5095,9996,5306,10319
,BoLuoZhen,610823106,11695,1273,7473,3469,15043,7042,2571,7258,14300,8066,15539
,DianShiZhen,610823107,12777,1512,8104,4113,16084,7841,2883,8095,15936,9068,17172
,TaWanZhen,610823108,6502,927,4218,2612,8496,4190,1205,4326,8516,4416,8634
ʯ,ZhaoShiPanZhen,610823109,5887,863,3842,2334,7747,3773,1135,3915,7688,4043,7885
κ¥,WeiJiaLouXiang,610823200,5769,597,3762,1890,7422,3691,1432,3817,7508,4036,7798
˫,ShuangChengXiang,610823201,3292,411,2152,1139,4294,2145,632,2153,4298,2183,4335
ʯҤ,ShiYaoGouXiang,610823202,6381,1046,4352,2445,8847,4235,1496,4346,8581,4571,8923
׽,BaiJieXiang,610823203,17005,977,10243,6009,9746,9281,4188,9983,19264,11927,22170
,NanTaXiang,610823204,6563,752,4196,2011,8533,4189,1329,4417,8606,4448,8644
,HanChaXiang,610823205,9259,955,5812,2984,11784,5680,2012,5781,11461,6414,12226
,AiHaoMaoXiang,610823206,4372,586,2836,1592,5824,2836,879,3001,5837,3001,5837
,LeiLongWanXiang,610823207,6027,645,3761,1814,7753,3761,1120,4031,7792,4031,7792
ż,ZhangJiaPanZhen,610824100,140095,6343,86331,44223,73482,71960,34916,77256,149216,95023,181354
,DongKengZhen,610824101,35913,2964,23610,11869,41796,23341,9124,23939,47280,24391,48001
,QingYangChaZhen,610824102,6310,662,3719,2587,7044,3685,1209,4212,7897,4462,8181
,NingTiaoLiangZhen,610824103,13249,1347,8556,4580,15660,8234,2946,8426,16660,8986,17542
ܺ,ZhouHeZhen,610824104,4468,481,2804,1550,5068,2614,1048,2852,5466,3193,5997
ս,HongDunJieZhen,610824105,4153,696,2776,1869,5290,2697,690,2674,5371,2763,5539
,YangQiaoPanZhen,610824106,8054,725,5302,2783,9431,5231,1970,5273,10504,5447,10749
,WangQuZeZhen,610824107,5240,631,3329,1679,6496,3316,1066,3543,6859,3608,6937
ɽ,ZhongShanJianZhen,610824108,4753,659,3270,1812,6100,3270,1123,3249,6519,3265,6535
,LongZhouXiang,610824200,4105,557,2738,1695,5462,2738,910,2834,5572,2834,5572
̲,HaiZeTanXiang,610824201,4519,592,2947,1671,5561,2900,898,2934,5834,3062,6009
,HuangHaoJieXiang,610824202,3310,513,2157,1532,4054,2121,642,2208,4329,2308,4465
ϯ,XiMaWanXiang,610824203,7637,830,4927,2901,9781,4910,1710,5229,10139,5250,10177
·,DaLuGouXiang,610824204,3471,213,1717,1111,2603,1485,423,1744,3229,2390,4107
ǹ,QiaoGouWanXiang,610824205,3059,357,1910,1113,3562,1824,579,1913,3737,2085,3995
С,XiaoHeXiang,610824206,4514,454,2754,1514,5193,2674,937,2727,5401,3151,5905
,TianCiWanXiang,610824207,1743,185,873,551,1680,848,275,938,1786,1330,2203
߼ҹ,GaoJiaGouXiang,610824208,2073,350,1356,858,2711,1356,327,1394,2750,1394,2750
,WuLiWanXiang,610824209,2666,277,1594,1025,2904,1482,536,1691,3173,1885,3479
׽,YangMiJianXiang,610824210,3328,426,1924,1188,3695,1845,603,2032,3877,2433,4357
³,XinChengXiang,610824211,3040,301,1747,945,2881,1440,484,1575,3015,2078,3825
,ZhenJingXiang,610824212,6185,697,3987,2204,6967,3886,1378,3952,7838,4273,8260
,DingBianZhen,610825100,75833,4843,47992,30275,40458,46501,19056,48296,94797,51740,99732
Ȧ,HeQuanZhen,610825101,21795,1385,13029,6977,17816,12813,4916,13847,26660,15067,28096
,HongLiuGouZhen,610825102,7933,817,4929,2754,10105,4906,1478,5220,10126,5299,10228
ש,ZhuanJingZhen,610825103,12009,1023,7460,3525,14375,7414,2319,7659,15073,7891,15351
ྮ,BaiNiJingZhen,610825104,13524,1261,8734,4152,17342,8621,3076,9004,17625,9127,17861
,AnBianZhen,610825105,12097,1348,7856,4367,13546,7828,2713,8241,16069,8302,16158
,DuiZiLiangZhen,610825106,5464,732,3586,1972,7064,3586,1083,3693,7279,3693,7279
,BaiWanZiZhen,610825107,6068,503,3642,1784,7182,3632,1254,4039,7671,4183,7825
ܫ,JiYuanZhen,610825108,8969,835,5253,2429,10025,5015,1537,5518,10533,6088,11341
,YangJingZhen,610825109,7499,593,4467,2329,8889,4395,1388,4785,9180,5013,9480
°,XinAnBianZhen,610825110,4731,503,2949,1427,5905,2889,1049,3164,6053,3334,6283
γ,YanChangBaoXiang,610825200,3232,332,2074,1141,4013,2069,664,2152,4221,2154,4228
̨,ZhouTaiZiXiang,610825201,3009,384,1931,1142,3789,1930,573,2035,3965,2035,3966
ʯ,ShiDongGouXiang,610825202,8824,1043,5599,2604,11338,5599,1570,5836,11435,5838,11437
̲,HaoTanXiang,610825203,10942,1098,7189,3520,13976,7189,2429,7278,14467,7280,14469
ͷׯ,YouFangZhuangXiang,610825204,6682,559,4100,1952,8336,4080,1292,4365,8445,4433,8533
,JiPanXiang,610825205,4018,309,2395,1122,4962,2391,755,2637,5028,2687,5082
ɽ,WangPanShanXiang,610825206,3497,270,2009,952,3986,1945,666,2082,4027,2424,4433
ؿ,FengDiKengXiang,610825207,6676,344,3041,1318,4203,2205,823,2525,4730,4802,7843
,WuMaoZiXiang,610825208,4094,434,2503,1119,5245,2494,875,2828,5322,2900,5403
,HuangWanXiang,610825209,4415,380,2782,1471,5774,2720,1018,2976,5696,3031,5813
ѧׯ,XueZhuangXiang,610825210,4345,605,2765,1611,5565,2755,762,2940,5695,2947,5712
Ҫ,ZhangYaoXianXiang,610825211,4194,455,2548,1391,5327,2535,799,2871,5406,2900,5448
Ҫ,BaiMaYaoXianXiang,610825212,2286,307,1416,752,2900,1416,408,1583,2999,1585,3001
ѧ,FanXueXiang,610825213,3450,285,1992,981,3755,1884,633,2095,3979,2376,4368
,MingZhouZhen,610826100,42360,3465,28241,19058,27669,26321,10112,26276,52597,27696,55937
Ѧ,XueJiaMaoZhen,610826101,7223,1064,4599,2774,9392,4596,1253,4936,9532,4941,9540
޼,CuiJiaWanZhen,610826102,9615,1312,6032,3995,12603,6004,1760,6594,12598,6655,12687
ɉ,DingXianYanZhen,610826103,5304,693,3206,2199,6757,3129,874,3585,6714,3665,6871
ƺ,ZaoLinPingZhen,610826104,6053,715,3754,2524,7828,3702,1244,4176,7878,4258,8012
,YiHeZhen,610826105,16412,2256,10549,7388,21630,10547,3361,11475,22022,11480,22029
,JiZhen,610826106,7640,1148,4826,2833,9922,4494,1311,4928,9422,5273,10099
ѦҺ,XueJiaHeZhen,610826107,7818,1106,5106,3078,10348,5106,1514,5332,10438,5332,10438
ʮ,SiShiPuZhen,610826108,15047,1852,9838,6408,19620,9790,3278,10121,19911,10339,20177
ʯ,ShiJiaWanZhen,610826109,10698,1472,6784,3873,14111,6784,2044,7429,14213,7430,14214
ׯ,TianZhuangZhen,610826110,7867,1060,5081,3136,10108,5076,1404,5234,10310,5250,10331
,XinDianXiang,610826200,21647,2032,14191,9303,17087,13900,5507,14502,28402,14995,29186
׼Ҽ,BaiJiaJianXiang,610826201,7650,1086,4864,3379,9940,4864,1350,5209,10073,5222,10086
ӵ,HeDiXiang,610826202,4045,427,2471,1598,5113,2458,743,2713,5171,2744,5215
н,ZhongJiaoXiang,610826203,6956,985,4356,3267,8896,4318,1206,4752,9070,4791,9147
Ҵ,MaJiaChuanXiang,610826204,5123,697,3235,2191,6665,3235,918,3503,6738,3503,6738
Լ,ZhaoJiaBianXiang,610826205,6574,867,4207,2266,8696,4196,1334,4562,8758,4568,8775
԰,JiuYuanGouXiang,610826206,5062,916,3302,2201,6762,3300,927,3596,6896,3603,6905
ô,ManTangChuanXiang,610826207,13380,1892,8446,5611,17651,8445,2478,9298,17743,9304,17750
ż,ZhangJiaBianXiang,610826208,16558,1931,10925,7296,15521,10872,3462,10865,21737,11026,21951
,YinZhouZhen,610827100,48019,3945,30234,19378,39446,28709,9992,29584,58293,31722,61956
,TaoZhen,610827101,4968,868,3194,2164,6273,3169,862,3455,6624,3504,6698
,LongZhen,610827102,8406,1630,5569,3537,11060,5524,1329,5728,11252,5796,11365
ҹ,YangJiaGouZhen,610827103,6838,1222,4425,2923,8691,4367,1199,4757,9124,4834,9259
żʯ,DuJiaShiGouZhen,610827104,7428,1391,4712,2518,9654,4605,1147,5058,9663,5254,9966
ɳҵ,ShaJiaDianZhen,610827105,5635,1027,3617,2024,7571,3582,1065,4074,7656,4110,7727
ӡ,YinDouZhen,610827106,6481,1069,4023,2540,8165,3897,953,4279,8176,4480,8503
Ҳ,JiJiaChaXiang,610827200,4584,780,2916,1726,6031,2910,832,3278,6188,3280,6196
źӲ,QiaoHeChaXiang,610827201,6115,1016,3934,2434,7782,3892,920,4069,7961,4117,8051
,GaoQuXiang,610827202,3585,792,2270,1480,4774,2263,562,2658,4921,2669,4939
վ,LiJiaZhanXiang,610827203,2564,547,1639,1080,3436,1633,358,1819,3452,1830,3469
ʮ,ShiLiPuXiang,610827204,8618,1099,5537,3148,10951,5522,1531,5671,11193,5711,11248
ׯ,GuoXingZhuangXiang,610827205,4254,708,2687,1762,5211,2650,614,2719,5369,2889,5576
«,JiaLuZhen,610828100,22598,2688,14787,11531,28158,14650,5267,15526,30176,15766,30553
,KengZhen,610828101,8968,1032,5616,3522,11318,5510,1762,6007,11517,6146,11762
,DianZhen,610828102,8407,1197,5422,3358,10947,5420,1726,5904,11324,5908,11330
,WuZhen,610828103,11354,1704,7216,4800,15190,7204,2270,8102,15306,8112,15328
,JinMingSiZhen,610828104,5027,714,3325,2196,6651,3320,1163,3574,6894,3579,6904
ͨ,TongZhen,610828105,14971,1742,9731,5956,19131,9728,3534,10513,20241,10516,20247
,WangJiaBianZhen,610828106,8175,1055,5300,3383,10309,5282,1820,5638,10920,5750,11050
,FangTaZhen,610828107,4731,671,3071,1793,6294,3024,977,3213,6237,3308,6379
,LiuGuoJuXiang,610828200,6523,790,4181,2338,8368,4179,1229,4349,8528,4361,8542
,YuKouXiang,610828201,5303,597,3342,2090,6758,3340,1011,3556,6896,3569,6911
ľͷ,MuTouYuXiang,610828202,6482,960,4169,2743,8666,4169,1292,4565,8734,4565,8734
,XiZhenXiang,610828203,6906,861,4295,2964,8951,4295,1325,4797,9092,4797,9092
,DaFoSiXiang,610828204,5606,892,3765,2506,7477,3765,1097,3826,7591,3830,7595
Ҹ,KangJiaGangXiang,610828205,6328,874,4076,2447,8385,4074,1271,4390,8464,4397,8473
ϸկ,ShangGaoZhaiXiang,610828206,6229,743,4057,1976,8323,4055,1415,4324,8379,4330,8387
ɽ,LiuJiaShanXiang,610828207,5750,731,3588,2114,7535,3584,1101,3989,7573,3994,7582
¡,XingLongSiXiang,610828208,3574,618,2432,1456,4899,2388,820,2512,4900,2580,5012
ׯ,GuanZhuangXiang,610828209,5154,726,3319,1974,6798,3319,996,3557,6876,3557,6876
կ,ZhuGuanZhaiXiang,610828210,3950,626,2621,1440,5262,2544,826,2684,5228,2781,5402
҈q,ZhuJiaGuaXiang,610828211,6528,761,4094,2198,8422,4090,1218,4408,8498,4413,8507
μҴ,SongJiaChuanZhen,610829100,28001,2070,17270,11769,25152,15867,6356,16873,32740,19157,36427
ҹ,XinJiaGouZhen,610829101,4287,717,2709,1844,5448,2634,667,2835,5469,2962,5671
ҹ,GuoJiaGouZhen,610829102,5949,797,3788,2307,7270,3755,1130,4060,7815,4088,7876
ܼܫ,KouJiaYuanZhen,610829103,5631,764,3757,2542,7573,3740,1270,3852,7592,3908,7665
żɽ,ZhangJiaShanXiang,610829200,4006,647,2589,1740,5169,2570,729,2769,5339,2793,5382
,ChaShangXiang,610829201,2896,429,1781,1299,3629,1780,445,1976,3756,1989,3770
,DingJiaWanXiang,610829202,3305,452,2078,1450,4258,2061,586,2230,4291,2265,4343
Ѧ´,XueXiaCunXiang,610829203,3484,542,2293,1529,4503,2284,588,2284,4568,2321,4614
,KuanZhouZhen,610830100,34329,3578,22110,17323,32940,21760,7056,22455,44215,22853,44963
ʯ,ShiJuYiZhen,610830101,5618,1004,3459,2203,7145,3450,719,3803,7253,3882,7341
ۼƺ,ZheJiaPingZhen,610830102,7367,1102,4529,3143,9160,4520,1094,4985,9505,5034,9563
Һ,YuJiaHeZhen,610830103,4166,552,2468,1609,5098,2448,514,2704,5152,2764,5232
߽ܴ,GaoJieCunZhen,610830104,6142,881,3565,2385,7515,3542,588,3997,7539,4046,7611
,LiJiaTaZhen,610830105,6047,1057,3510,2596,7543,3503,511,4097,7600,4105,7615
,DianZeGouZhen,610830106,4373,792,2657,1969,5550,2608,539,2951,5559,3047,5704
ҹ,JieJiaGouZhen,610830107,5516,894,3275,2430,6833,3234,614,3648,6882,3749,7024
¼҉,HaoJiaYanXiang,610830200,2836,623,1830,1334,3772,1820,383,1973,3793,2012,3842
ñ,LeTangBaoXiang,610830201,4248,692,2626,1755,5318,2565,616,2819,5384,2930,5556
إ,XiaNianLiPuXiang,610830202,4288,730,2710,1788,5189,2677,529,2792,5469,2837,5547
˫,ShuangMiaoHeXiang,610830203,3995,702,2408,1667,4981,2399,442,2702,5101,2731,5139
,LaoSheKeXiang,610830204,4338,707,2574,1907,5317,2559,401,2837,5396,2872,5446
ɽ,ErLangShanXiang,610830205,2615,480,1510,1161,3271,1497,219,1743,3240,1804,3314
ʯ,ShiPanXiang,610830206,4005,499,2272,1695,4959,2267,537,2742,5009,2769,5041
˫,ShuangHuYuZhen,610831100,29046,2607,19956,12760,23052,17614,8374,17448,35062,20071,40027
μҼ,HeJiaJiZhen,610831101,8481,1084,5438,2514,10974,5430,1817,5858,11288,5944,11382
Ͼ,LaoJunDianZhen,610831102,7024,904,4367,2050,8988,3986,1475,4421,8407,5036,9403
,PeiJiaWanZhen,610831103,6573,1206,4684,3148,9244,4682,1623,4717,9399,4718,9402
ƺ,MiaoJiaPingZhen,610831104,12829,2322,8651,5621,17104,8633,2538,8989,17622,9038,17689
,SanChuanKouZhen,610831105,6551,1527,4443,3640,8844,4306,1087,4445,8751,4722,9165
㹵,MaTiGouZhen,610831106,9922,1989,6862,5258,13194,6784,1984,6842,13626,7033,13895
ܼҼ,ZhouJiaJianZhen,610831107,5047,803,3515,2639,6237,3504,1268,3531,7035,3603,7118
,DianShiZhen,610831108,3600,621,2503,1514,4857,2477,794,2437,4914,2512,5015
ש,ZhuanMiaoZhen,610831109,4153,680,2737,1725,5481,2721,784,2831,5552,2880,5617
ն,TuoErXiangXiang,610831200,3705,991,2746,1876,5327,2746,762,2712,5458,2712,5458
԰,GuaYuanZeWanXiang,610831201,3064,485,2004,977,4060,1985,580,2086,4071,2125,4129
Т,LiXiaoHeXiang,610831202,2366,601,1684,1329,3301,1679,414,1683,3362,1697,3381
ˮ,ShuiDiWanXiang,610831203,3439,534,2288,1245,4551,2287,708,2387,4674,2393,4681
,MaChaXiang,610831204,6575,748,4361,2157,8759,4347,1603,4547,8894,4565,8926
,HuaiShuChaXiang,610831205,4684,552,2974,1346,6071,2972,966,3131,6103,3228,6202
߼ƺ,GaoJiaPingXiang,610831206,3175,492,2003,1214,4087,1986,541,2130,4116,2205,4208
,HuaiNingWanXiang,610831207,5754,1393,4114,3121,7907,4089,1141,4130,8219,4174,8288
ϳǽֵ´,LaoChengJieDaoBanShiChu,610902001,32099,3587,20194,12910,30711,19179,5702,18639,37818,21194,41388
³ǽֵ´,XinChengJieDaoBanShiChu,610902002,113415,9287,75378,44820,100510,66260,22752,65085,131345,70076,145454
ֵ´,JiangBeiJieDaoBanShiChu,610902003,41134,5034,26543,18627,45719,26483,7674,27059,53542,27299,53842
,GuanMiaoZhen,610902100,31895,2560,20338,10699,38656,20189,7745,21582,41771,21862,42200
̲,ZhangTanZhen,610902101,21841,1733,13600,6650,27925,13098,4505,13747,26845,14479,28079
孺,YingHuZhen,610902102,12021,929,7492,3867,15323,7466,2809,8191,15657,8267,15759
,JianMinZhen,610902103,32009,2221,20298,9832,36977,19126,6754,19815,38941,20686,40984
,WuLiZhen,610902104,23983,2871,16529,10087,32445,16383,6958,17044,33427,17283,33812
,HeXiZhen,610902105,17302,1612,11150,6265,23338,11094,4764,12415,23509,12528,23678
ͬ,DaTongZhen,610902106,27794,3082,18114,9707,37104,17660,6802,18895,36555,19564,37678
,HengKouZhen,610902107,43139,4535,27938,16041,53792,27266,10301,29372,56638,30037,57975
÷,MeiZiPuZhen,610902108,10675,1266,6744,4018,14471,6739,2724,7908,14647,7921,14665
,JiHeZhen,610902109,10205,932,6247,3330,12966,6219,2230,7002,13221,7120,13367
ˮ,LiuShuiZhen,610902110,8841,873,5682,3134,11453,5657,2030,6023,11680,6062,11744
԰,DaZhuYuanZhen,610902111,7407,739,4956,3019,10010,4955,2067,5257,10212,5257,10213
ɽ,HongShanZhen,610902112,10184,1038,6372,3481,13585,6329,2585,7286,13615,7435,13807
ʯת,ShiZhuanZhen,610902113,5453,631,3359,1988,7503,3353,1487,4160,7513,4212,7571
Ĺ,CiGouZhen,610902114,9188,1153,5650,3125,12290,5563,2295,6726,12289,6986,12636
,DaHeZhen,610902115,11990,1704,7668,4558,16632,7328,3372,8740,16068,9398,17066
,ShenBaZhen,610902116,7459,940,4568,2597,10185,4557,2014,5803,10360,5845,10413
˫,ShuangLongZhen,610902117,10909,1234,6646,3634,14494,6646,2524,8021,14667,8021,14667
Ҷƺ,YePingZhen,610902118,2901,429,1776,1304,3914,1772,632,2164,3936,2186,3962
ԭ,ZhongYuanZhen,610902119,8238,1245,5487,3433,11660,5423,2415,6266,11689,6411,11898
԰,HuaYuanXiang,610902200,11797,1069,7349,3846,15248,7324,2680,8187,15511,8197,15546
,ZaoYangXiang,610902201,10837,1058,6911,3578,14299,6903,2714,7686,14589,7698,14609
,GongJinXiang,610902202,5823,615,3569,1920,7786,3553,1446,4291,7844,4315,7884
ʯ,ShiTiXiang,610902203,10952,1105,7119,3712,14927,7098,2919,7771,14869,7857,14976
ؼ,GuanJiaXiang,610902204,11577,1085,7385,4008,15600,7368,3081,8324,15692,8358,15743
ӭ,YingFengXiang,610902205,7808,808,5047,2794,10683,5010,2127,5621,10631,5696,10743
غ,XianHeXiang,610902206,9064,911,5818,2850,12228,5801,2476,6598,12399,6633,12451
,TianBaXiang,610902207,7033,774,4300,2195,9287,4292,1646,5101,9393,5153,9453
̰,YanBaXiang,610902208,6219,582,3921,2074,8452,3901,1772,4557,8458,4652,8573
Ϫ,NanXiXiang,610902209,6172,646,4102,2362,8524,4088,1801,4492,8580,4517,8619
ǿ,FuQiangXiang,610902210,5562,715,3553,2070,7482,3522,1448,4137,7659,4172,7725
Ϫ,YunXiXiang,610902211,6077,678,3931,2087,8187,3931,1691,4515,8446,4515,8446
˫Ϫ,ShuangXiXiang,610902212,5139,673,3201,1852,6952,3158,1365,3826,6984,3976,7177
̷,TanBaXiang,610902213,7512,1038,5115,3316,10737,5067,2412,5780,10847,5847,10962
ǰ,QianJinXiang,610902214,4601,463,2786,1580,6087,2765,1049,3274,6039,3327,6113
Ӻ,BaHeXiang,610902215,5958,724,4027,2612,8373,4026,1755,4408,8434,4410,8437
,YuLanXiang,610902216,5934,593,3798,1977,7931,3798,1576,4305,8103,4305,8103
°,XinBaXiang,610902217,6165,644,3819,2094,7870,3803,1400,4325,8128,4390,8209
ɽ,XiangShanXiang,610902218,3134,384,1912,1072,4181,1912,678,2284,4196,2284,4196
ţ,NiuTiXiang,610902219,3966,615,2779,1569,5689,2758,1418,3169,5927,3220,5999
,DongZhenXiang,610902220,3990,509,2535,1624,5451,2534,1047,3006,5540,3011,5546
ɳ,ShaBaXiang,610902221,3979,465,2406,1423,5364,2393,1064,3052,5445,3102,5508
,JingHeXiang,610902222,1607,222,1015,630,2193,1015,421,1235,2250,1235,2250
ǹ,ChengGuanZhen,610921100,49502,5421,32415,21315,60338,31829,12003,33234,65063,34511,66926
,JianChiZhen,610921101,15204,1865,9984,6423,19408,9957,3979,10934,20891,11064,21048
Ϫ,PuXiZhen,610921102,13888,1535,9120,6018,17634,8892,3475,9484,18376,9778,18898
ƽ,PingLiangZhen,610921103,17167,2061,10873,7817,22674,10716,4151,12293,23009,12506,23379
˫,ShuangRuZhen,610921104,8959,971,5555,3364,11397,5536,2020,6286,11822,6395,11950
,TieFoSiZhen,610921105,6722,840,4112,2472,8764,4054,1535,4855,8909,4985,9097
,LongYaZhen,610921106,6499,794,4120,2896,8641,4104,1663,4802,8906,4836,8956
,XuanWoZhen,610921107,17125,2564,11358,7134,23436,11162,4920,12926,24088,13251,24609
,HanYangZhen,610921108,11259,1890,7265,4921,15436,7242,2923,8735,15977,8807,16072
Ƶ,JiuDianZhen,610921109,3575,509,2138,1611,4653,2132,774,2700,4832,2720,4858
˫ӿ,ShuangHeKouZhen,610921110,2903,483,1897,1357,3979,1897,653,2139,4036,2142,4039
,ShangQiZhen,610921111,2470,463,1637,886,3501,1599,734,1916,3515,2030,3667
,YongNingXiang,610921200,9450,1216,6435,4487,12950,6430,2645,6854,13284,6876,13311
,GuanYinHeXiang,610921201,5230,786,3261,2328,7053,3249,1276,3961,7210,4031,7292
ʯ,ShiTiaoJieXiang,610921202,1530,292,926,681,2141,917,364,1210,2127,1260,2186
ͭǮ,TongQianXiang,610921203,902,165,571,405,1249,565,232,688,1253,728,1299
,TianHeXiang,610921204,3092,396,1846,1250,4059,1819,744,2318,4137,2386,4232
˫ƺ,ShuangPingXiang,610921205,2984,538,1912,1253,4134,1890,806,2382,4272,2416,4328
ǹ,ChengGuanZhen,610922100,41880,4324,25765,17682,42268,24477,7218,25533,50010,27657,53422
ķ,RaoFengZhen,610922101,8013,1273,4709,3118,10129,4609,1300,5576,10185,5877,10586
,LiangHeZhen,610922102,6541,1036,3942,2764,8184,3817,1085,4469,8286,4720,8662
ӭ,YingFengZhen,610922103,5346,704,3090,1977,6591,3033,890,3702,6735,3850,6940
غ,ChiHeZhen,610922104,15655,1604,9371,6041,18099,9173,2607,10167,19340,10495,19866
,HouLiuZhen,610922105,5457,770,3299,2415,7014,3270,995,3890,7160,3923,7222
ϲ,XiHeZhen,610922106,5847,956,3546,2398,7688,3494,1207,4316,7810,4464,8010
ٶ,YunDouZhen,610922107,8774,1454,5653,3309,12022,5614,2263,6747,12361,6838,12491
Ϫ,CengXiXiang,610922200,4294,691,2554,1812,5431,2536,730,3011,5547,3161,5715
,YinLongXiang,610922201,4151,619,2565,1672,5394,2561,737,2937,5498,2942,5507
,YinQiaoXiang,610922202,2872,392,1612,1092,3579,1607,397,2028,3635,2049,3661
,HongWeiXiang,610922203,3874,517,2207,1457,4916,2199,624,2761,4960,2808,5015
г,ZhongChiXiang,610922204,8717,970,4964,3286,10735,4924,1298,5957,10881,6021,10985
а,ZhongBaXiang,610922205,4318,746,2626,1679,5956,2555,928,3223,5778,3366,5992
,ChangYangXiang,610922206,5233,690,3093,2083,6874,3073,1100,3866,6939,3930,7023
ǹ,ChengGuanZhen,610923100,15887,1583,9865,6835,17312,9579,3045,10045,19624,10650,20515
Ķ,SiMuDiZhen,610923101,3074,433,1797,1176,3701,1776,563,2109,3885,2273,4070
,JiangKouZhen,610923102,6684,797,4001,2492,8029,3834,1213,4337,8171,4693,8694
ƺ,TangPingZhen,610923103,4210,592,2522,1704,5376,2505,714,2949,5454,2994,5516
,GuangHuoJieZhen,610923104,3032,314,1572,1029,3241,1482,388,1775,3257,2162,3734
,LongWangZhen,610923105,3489,512,2094,1413,4581,2066,682,2507,4573,2589,4683
Ͳ,TongCheWanZhen,610923106,4222,520,2361,1500,4816,2173,613,2722,4895,2994,5355
Ѯ,XunYangBaZhen,610923107,1547,190,846,574,1718,794,246,987,1781,1137,1983
,JinChuanZhen,610923108,2523,411,1561,1050,3263,1542,466,1790,3332,1839,3400
ʹ,HuangGuanZhen,610923109,2189,266,1200,693,2193,1085,336,1295,2380,1591,2791
ḻ,FengFuXiang,610923200,907,189,535,412,1204,534,138,686,1220,699,1234
÷,MeiZiXiang,610923201,1792,318,1035,702,2342,1033,291,1360,2393,1366,2401
³,XinChangXiang,610923202,632,132,357,282,803,345,101,468,813,508,865
̫ɽ,TaiShanMiaoXiang,610923203,3916,568,2344,1443,5051,2298,710,2762,5060,2850,5194
ǹ,ChengGuanZhen,610924100,26062,3464,17110,11965,30328,16988,5970,18075,35063,18386,35496
ƺ,HaoPingZhen,610924101,19052,2066,12412,7146,25034,12391,4785,13452,25843,13491,25903
,HanWangZhen,610924102,8023,1214,5777,4006,11356,5777,2563,6015,11792,6023,11800
,HuanGuZhen,610924103,7155,1023,4536,2815,9585,4534,1729,5356,9890,5371,9907
,XiangYangZhen,610924104,9256,1330,5960,3614,12400,5944,2122,6724,12668,6748,12708
,DongHeZhen,610924105,10631,1698,6798,4510,13978,6774,2280,7732,14506,7811,14609
ˮ,HuiShuiZhen,610924106,4627,868,3420,2481,6415,3402,1624,3634,7036,3699,7119
,BanTaoZhen,610924107,5304,784,3387,2126,7287,3384,1373,4055,7439,4074,7461
˫,ShuangQiaoZhen,610924108,7747,1278,5176,3387,10988,5176,2250,6099,11275,6099,11275
,GaoQiaoZhen,610924109,13045,1936,8629,5188,17825,8627,3512,9852,18479,9864,18493
촻,HongChunZhen,610924110,10283,1444,6330,4218,13810,6327,2466,7861,14188,7863,14193
̲,GaoTanZhen,610924111,10101,1498,6554,4047,13448,6551,2521,7550,14101,7566,14120
ë,MaoBaZhen,610924112,9503,1408,6239,4137,12753,6239,2447,7119,13358,7119,13358
,WaMiaoZhen,610924113,8322,1282,5593,3323,11350,5593,2210,6221,11814,6221,11814
,MaLiuZhen,610924114,8228,1141,5655,3411,11585,5655,2543,6254,11909,6257,11912
˫,ShuangAnXiang,610924200,7375,1152,5167,3224,10519,5167,2296,5654,10821,5656,10823
,JinChuanXiang,610924201,3634,665,2496,1801,5058,2494,1015,2810,5304,2818,5314
,MiaoHeXiang,610924202,2042,343,1226,822,2683,1215,426,1544,2759,1585,2811
,JieLingXiang,610924203,3419,523,2267,1373,4805,2267,1078,2743,5010,2753,5020
Ž,BaJiaoXiang,610924204,5469,798,3375,2127,7167,3355,1297,4131,7486,4189,7564
ľ,DongMuXiang,610924205,6023,823,3738,2250,7980,3738,1478,4586,8324,4586,8324
ԭ,LiaoYuanXiang,610924206,3034,522,1862,1185,4011,1855,688,2375,4230,2382,4244
,GuangChengXiang,610924207,5024,822,3091,1913,6845,3091,1077,3832,6923,3832,6923
Ϫ,RaoXiXiang,610924208,5019,780,3296,1862,6853,3294,1307,3804,7098,3810,7106
,LianHeXiang,610924209,3933,667,2616,1554,5359,2616,1050,3032,5648,3034,5650
ǹ,ChengGuanZhen,610925100,26635,2624,17269,11364,28805,16637,6089,17319,33956,18079,35348
,ZuoLongZhen,610925101,8837,1064,5260,3599,11319,5201,1689,6237,11438,6330,11590
,HuaLiZhen,610925102,4677,694,2975,2084,5969,2909,1042,3287,6196,3438,6413
Ϻ,TaoHeZhen,610925103,4384,704,2710,1777,5616,2652,814,3052,5704,3192,5902
Ԫ,GuanYuanZhen,610925104,4674,736,2891,1854,6290,2887,1180,3655,6542,3699,6590
ʯ,ShiMenZhen,610925105,7251,1097,4485,3348,9368,4394,1529,5142,9536,5392,9877
,MinZhuZhen,610925106,12233,1862,7627,5047,16377,7618,2601,9020,16638,9069,16696
,DaDaoHeZhen,610925107,4155,503,2520,1916,5197,2520,738,2874,5394,2876,5396
,LinHeXiang,610925200,5896,739,3440,2189,7400,3383,1033,4041,7424,4228,7668
,YiHeXiang,610925201,4448,648,2646,1738,5694,2611,719,3089,5700,3169,5815
ʯ,MengShiLingXiang,610925202,6746,1001,4249,2962,8859,4237,1366,4829,9066,4864,9113
ĺ,ZhangHeXiang,610925203,2617,404,1528,993,3390,1511,422,1865,3376,1915,3443
ļ,SiJiXiang,610925204,4082,574,2453,1704,5172,2422,754,2899,5321,2957,5410
Ϫ,HengXiXiang,610925205,2354,321,1407,904,2981,1400,426,1666,3066,1694,3101
,YanMenXiang,610925206,6060,996,3741,2526,8139,3717,1313,4542,8259,4628,8369
¯,TieLuXiang,610925207,6944,954,4028,2952,8846,4012,1192,4980,8992,5062,9090
,XiaoDaoXiang,610925208,3277,419,1905,1374,4136,1896,640,2413,4309,2431,4336
ǹ,ChengGuanZhen,610926100,34312,4173,22230,14610,37939,20962,7008,21755,42717,23263,45493
¡,XingLongZhen,610926101,8283,1299,4968,2917,10847,4905,1435,5941,10846,6049,11017
,LaoXianZhen,610926102,10864,1341,6580,4320,13614,6463,1945,7275,13738,7570,14150
,DaGuiZhen,610926103,8565,1231,5160,3488,11097,5147,1498,6083,11230,6134,11294
,SanYangZhen,610926104,8406,1379,4974,3155,11094,4950,1533,6250,11200,6344,11318
,LuoHeZhen,610926105,9765,1658,5913,4372,12911,5904,1678,7101,13005,7188,13101
,GuangFoZhen,610926106,15107,2281,9619,5946,20291,9597,3249,10906,20503,11018,20637
,BaXianZhen,610926107,17916,2715,11685,7618,23901,11564,4023,12736,24300,12969,24654
,ChangAnZhen,610926108,13075,1661,7937,4884,16596,7882,2670,9175,17057,9469,17406
,XiHeXiang,610926200,6517,791,3956,2442,8264,3920,1078,4346,8266,4430,8386
,ZhengYangXiang,610926201,5363,846,3451,2271,7311,3435,1195,3891,7326,3953,7404
Ůɽ,NvWaShanXiang,610926202,6246,863,3715,2518,7967,3694,990,4336,8030,4384,8099
ǹ,ChengGuanZhen,610927100,9682,1056,6120,4753,11685,5963,2194,6401,12364,6812,12932
,CengJiaZhen,610927101,4223,742,2822,1833,5677,2812,1032,3084,5896,3175,5997
ţͷ,NiuTouDianZhen,610927102,3120,617,2116,1543,4032,2082,649,2100,4182,2270,4386
ӱ,ZhongBaoZhen,610927103,5169,810,3502,2192,6881,3489,1253,3671,7160,3730,7232
ʯ,HongShiXiang,610927200,2648,530,1767,1220,3710,1767,533,1944,3711,1944,3711
׼,BaiJiaXiang,610927201,1863,362,1218,801,2444,1212,370,1343,2555,1377,2595
,ShangZhuXiang,610927202,2651,410,1759,1084,3592,1727,607,1830,3557,1909,3668
С,XiaoShuHeXiang,610927203,2605,423,1683,1238,3306,1683,608,1948,3631,1953,3636
ƺ,ShuPingXiang,610927204,3031,404,1953,1301,4047,1953,673,2155,4108,2155,4108
ƺ,HuaPingXiang,610927205,1926,281,1284,803,2610,1265,494,1393,2658,1417,2701
ǹ,ChengGuanZhen,610928100,52684,4329,33294,20851,51820,31395,10916,32101,63496,34635,67929
Ϫ,ZongXiZhen,610928101,19671,2375,12000,7344,25407,11937,3765,13583,25520,13811,25811
ؿ,GuanKouZhen,610928102,10755,1328,6636,4348,13967,6483,2269,7383,13866,7716,14352
,ShuHeZhen,610928103,24078,2492,15082,9179,28326,14072,4927,15131,29203,16415,31497
˫,ShuangHeZhen,610928104,12082,1618,7726,4820,15471,7677,2657,8505,16182,8631,16357
С,XiaoHeZhen,610928105,11096,1128,7308,4380,14685,7294,3196,8014,15308,8112,15420
,ZhaoWanZhen,610928106,12729,1418,7625,4480,14272,6473,2182,7022,13495,8704,16329
ƺ,MaPingZhen,610928107,8679,1138,5088,3625,11235,5031,1568,6167,11198,6297,11385
Ϫ,GanXiZhen,610928108,12753,1312,7359,4397,14889,7166,2041,7903,15069,8747,16106
,BaiLiuZhen,610928109,8662,893,5210,3479,10846,5178,1611,5818,10996,5956,11166
,LvHeZhen,610928110,14474,1615,8882,5598,18124,8794,2603,9390,18184,9810,18692
,ShenHeZhen,610928111,14281,1622,8560,5128,16269,7737,2481,8498,16235,9824,18384
,ChiYanZhen,610928112,9779,1185,5905,3876,12424,5831,1905,6740,12571,6964,12869
μҺ,DuanJiaHeZhen,610928113,12471,1364,7430,4312,15069,7192,2457,7980,15172,8862,16292
ɺ,XianHeZhen,610928114,16218,1765,10066,6234,21353,9836,3636,11169,21005,11553,21619
կ,JinZhaiZhen,610928115,10803,1220,6386,3836,13417,6317,1716,7200,13517,7353,13739
ͩľ,TongMuZhen,610928116,9184,1239,5826,3625,12365,5762,2253,6683,12445,6850,12676
Ԫ,GouYuanXiang,610928200,8546,934,5371,3230,11019,5247,1982,5831,11078,6091,11462
̲,LanTanXiang,610928201,4223,487,2607,1539,5386,2579,852,2893,5472,2955,5562
ƺ,MiaoPingXiang,610928203,7369,982,4659,2837,9451,4628,1463,5071,9699,5155,9814
,HongJunXiang,610928204,8149,1090,5133,3035,10595,5100,1747,5672,10772,5853,10986
,GongGuanXiang,610928205,6530,825,4086,2451,8644,4046,1531,4707,8753,4800,8886
ʺӿ,RenHeKouXiang,610928206,4784,644,2979,1807,6305,2976,1058,3503,6479,3507,6486
ƺ,ZhangPingXiang,610928208,2499,423,1477,994,3265,1474,396,1811,3285,1841,3318
,GuiHuaXiang,610928209,5236,605,3080,1996,6670,3072,973,3653,6725,3734,6814
ʯ,ShiMenXiang,610928210,8748,1128,5281,3298,11250,5211,1677,6104,11315,6272,11553
ͭǮ,TongQianGuanXiang,610928212,3652,606,2331,1504,4961,2320,872,2768,5088,2799,5130
ɳ,ShaYangXiang,610928213,4494,664,2725,1663,5887,2688,885,3196,5884,3318,6043
ǹ,ChengGuanZhen,610929100,24972,2350,15882,9531,26129,14599,5057,14765,29364,16497,32379
г,ZhongChangZhen,610929101,9110,1363,5756,3992,11752,5711,2012,6278,11989,6729,12485
,GouBaZhen,610929102,5884,879,3599,2521,7455,3559,1308,4005,7564,4472,8071
,QiaZiZhen,610929103,6864,1181,4468,3178,9191,4412,1644,4889,9301,5221,9689
éƺ,MaoPingZhen,610929104,11228,1570,6929,4759,13628,6460,2495,7429,13889,8364,15293
μ,SongJiaZhen,610929105,9579,1432,6151,4032,12824,6148,2318,7145,13293,7178,13329
Ӫ,XiYingZhen,610929106,9550,1070,5557,3272,10442,4740,2252,5297,10037,7315,12872
,CangShangZhen,610929107,9996,1338,6556,4285,12545,6539,2233,6932,13471,7011,13567
ˮ,LengShuiZhen,610929108,7806,998,5095,3068,10394,4970,1874,5316,10286,5583,10678
,SiXinXiang,610929200,2455,501,1670,1317,3546,1661,713,1947,3608,1999,3669
Ԫ,TaoYuanXiang,610929201,3937,575,2301,1783,4831,2260,884,2661,4921,3095,5396
˫,ShuangHeXiang,610929202,4903,838,3364,2352,6624,3328,1236,3481,6809,3613,6977
С˫,XiaoShuangXiang,610929203,3888,623,2526,1816,5346,2517,983,2915,5432,2968,5494
˫,DaShuangXiang,610929204,3834,720,2715,1901,5322,2705,998,2776,5481,2837,5552
黢,MaHuXiang,610929205,5576,912,3681,2670,7557,3670,1456,4175,7845,4263,7944
ǹؽֵ´,ChengGuanJieDaoBanShiChu,611002001,84862,6887,52363,31054,73527,41574,14102,42677,84251,53488,105851
ֵ´,DaZhaoYuJieDaoBanShiChu,611002002,18129,1422,10132,4901,17617,7853,2575,8223,16076,11994,22126
ܫֵ´,ChenYuanJieDaoBanShiChu,611002003,11794,932,7193,3803,14019,6754,2211,7124,13878,7744,14937
ֵ´,LiuWanJieDaoBanShiChu,611002004,18227,1792,11483,6954,22198,11247,3560,11771,23018,12096,23579
Т,XiaoYiZhen,611002100,10379,1148,6547,3629,13320,6475,2227,6977,13452,7207,13754
ҹ,YeCunZhen,611002101,11601,1310,7287,4237,15033,7192,2252,7618,14810,7876,15163
,BaiYangDianZhen,611002102,14244,1503,8906,4872,18283,8834,2911,9580,18414,9752,18658
Ŵ,ZhangCunZhen,611002103,12550,1261,7525,4262,16084,7484,2335,8494,15978,8621,16146
ɳ,ShaHeZiZhen,611002104,21503,1974,12959,7112,26444,12443,3904,13351,25794,14422,27381
,YangYuHeZhen,611002105,21583,2153,13423,7507,27456,13260,4235,14124,27384,14548,27971
,JinLingSiZhen,611002106,15547,1464,9349,5734,20005,9270,3185,10513,19783,10847,20196
ɽ,HeiShanZhen,611002107,9845,958,5878,3191,12585,5796,1867,6601,12397,6792,12670
б,YangXieZhen,611002108,11217,1317,6986,4149,14663,6923,2270,7556,14479,7818,14804
,MaJieZhen,611002109,10974,1183,6966,4206,14452,6965,2380,7564,14529,7571,14537
,HeiLongKouZhen,611002110,13828,1564,8451,4367,17733,8242,2508,9018,17260,9449,17900
,MuHuGuanZhen,611002111,6264,677,4004,2099,8314,3992,1487,4401,8393,4424,8428
,DaJingZhen,611002112,20577,2155,12267,6838,25227,12028,3970,12941,24969,14435,26702
,YaoShiZhen,611002113,15421,1623,9413,5223,19607,9332,3100,10425,19757,10731,20144
,BanQiaoZhen,611002114,8878,1165,5580,3523,11365,5484,1785,5788,11272,6248,11828
ƺ,BeiKuanPingZhen,611002115,11241,1286,6634,3898,14202,6487,1859,7311,13798,7752,14386
Ϲٷ,ShangGuanFangXiang,611002200,3294,509,2238,1628,4617,2226,830,2331,4557,2395,4633
غ,YanChiHeXiang,611002201,7214,815,4329,2377,9357,4300,1392,4990,9290,5092,9421
غ,MaChiHeXiang,611002202,8414,854,5160,3002,10883,5117,1713,5694,10811,5821,10981
ƴ,YanCunXiang,611002203,3547,404,2208,1252,4623,2202,716,2439,4641,2459,4667
,SanChaHeXiang,611002204,8681,1042,5415,3372,11321,5386,1687,5909,11295,5995,11410
ź,HongMenHeXiang,611002205,5961,639,3769,2197,7796,3769,1251,4082,7851,4082,7851
,XiJingXiang,611002206,8764,987,5614,3097,11484,5583,1900,5964,11547,6037,11651
,LiMiaoXiang,611002207,9106,929,5774,3220,11840,5750,1897,6071,11821,6158,11932
,PuYuXiang,611002208,4140,469,2598,1549,5325,2580,832,2771,5351,2843,5441
,LongWangMiaoXiang,611002209,5088,604,2977,1816,6481,2927,856,3252,6179,3571,6548
ǹ,ChengGuanZhen,611021100,70592,5626,43032,22613,82029,36084,13106,37181,73265,46292,89324
,JingCunZhen,611021101,30404,2997,18658,10111,37814,17767,5320,18664,36431,20063,38721
ų,GuChengZhen,611021102,20954,2180,12939,6910,25152,12261,3762,12985,25246,13957,26896
Ҫ,SanYaoZhen,611021103,10898,1067,6833,3527,13631,6450,2062,6670,13120,7194,14027
,LingKouZhen,611021104,16936,1807,10282,5646,21713,9954,3118,10790,20744,11579,21861
¶,ChenErZhen,611021105,3820,310,1995,1056,3879,1927,570,2039,3966,2705,4700
¶,SiErZhen,611021106,6463,563,3857,1975,7904,3787,1109,4131,7918,4278,8135
Ѳ,XunJianZhen,611021107,6407,604,3845,2097,7726,3679,1081,3715,7394,4247,8092
ʯ,ShiPoZhen,611021108,19562,2216,11988,6480,24140,11471,3308,11985,23456,13098,25086
ʯ,ShiMenZhen,611021109,20537,1916,11740,6830,23685,11497,3289,11892,23389,14002,25742
ƺ,MaPingZhen,611021110,12417,1271,7709,4516,15469,7632,2075,7967,15599,8054,15763
Դ,LuoYuanZhen,611021111,12599,1276,7857,4306,16375,7735,2797,8387,16122,8815,16672
,BaoAnZhen,611021112,17620,2066,11144,6362,23083,10790,3698,11716,22506,12240,23384
,WeiDongZhen,611021113,9554,701,5325,2711,11239,4800,1756,5416,10216,6686,12011
,YongFengZhen,611021114,16961,1572,10184,5921,20475,9912,3122,10490,20402,11471,21655
ƺ,MiaoPingXiang,611021200,11482,1175,7270,4102,14752,7259,2161,7490,14749,7548,14818
,BaiYuSiXiang,611021201,5055,601,3178,1788,6425,3160,904,3300,6460,3382,6560
,SiPoXiang,611021202,8451,865,5205,2958,10540,5042,1559,5345,10387,5670,10875
ҫ,GaoYaoXiang,611021203,8397,916,5433,3014,10859,5291,1768,5461,10752,5648,11081
,WangLingXiang,611021204,4805,512,2941,1676,6144,2885,1036,3268,6153,3412,6353
̨,MiaoTaiXiang,611021205,3047,363,1838,997,3805,1812,520,2001,3813,2092,3930
µ,ShangSiDianXiang,611021206,1915,272,1193,688,2333,1167,330,1172,2339,1324,2517
¹,JiaLuXiang,611021207,5816,488,3519,1879,7095,3488,1032,3647,7135,3817,7336
,SiHaoXiang,611021208,10407,1105,6417,3550,13146,6359,1972,6834,13193,7067,13484
л,XieWanXiang,611021209,9842,1025,5940,3399,12444,5868,1723,6526,12394,6650,12590
կ,LongJuZhaiZhen,611022100,51990,4271,32358,16783,60759,28265,9673,28785,57050,33576,65934
,YuLingZhen,611022101,12391,1310,7385,4201,15613,7353,2096,8210,15563,8412,15797
̴,CaiChuanZhen,611022102,6882,810,4104,2591,8503,4060,1097,4603,8663,4685,8789
ׯ,LuanZhuangZhen,611022103,11228,1220,6943,3895,14371,6878,2216,7515,14393,7721,14664
,TieYuPuZhen,611022104,12508,1016,7613,4070,15482,7485,2592,8117,15602,8503,16116
,WuGuanZhen,611022105,10468,913,6361,3582,13251,6330,2108,7005,13335,7128,13489
ֹ,ZhuLinGuanZhen,611022106,17137,1506,10510,5981,21698,10336,3559,11425,21761,11692,22202
,TuMenZhen,611022107,10292,924,6223,3448,13072,6166,2077,6976,13142,7070,13293
ƺ,SiPingZhen,611022108,6698,741,4030,2369,8472,3998,1213,4455,8453,4622,8652
,ShangZhen,611022109,22196,2241,13887,7550,27313,12620,4291,13003,25623,14841,28728
馻,DiHuaZhen,611022110,15576,1793,9818,5835,20049,9566,3152,10070,19636,10703,20521
,YueRiXiang,611022200,6596,596,4139,2115,8170,4099,1403,4349,8448,4456,8595
˫,ShuangCaoXiang,611022201,5782,622,3470,1940,7346,3454,1105,3961,7415,4039,7509
,ZiYuXiang,611022202,7104,572,4481,2233,9155,4432,1611,4692,9124,4806,9287
ƺ,TaoPingXiang,611022203,5034,497,3076,1739,6308,3064,849,3257,6321,3304,6380
ƿ,HuaPingZiXiang,611022204,6802,663,4080,2344,8446,4022,1414,4707,8729,4799,8879
Դ,BeiZhaoChuanXiang,611022205,5873,534,3460,1976,7344,3441,1046,3927,7368,3993,7453
,DongLingXiang,611022206,3291,254,2021,1117,4204,2020,822,2336,4356,2346,4367
ë,MaoLiGangXiang,611022207,3001,307,1775,1032,3744,1761,602,2093,3854,2135,3910
԰,HuaYuanXiang,611022208,3754,389,2406,1390,4865,2397,888,2565,4962,2625,5031
ƺ,LiuXianPingXiang,611022209,4437,535,2761,1646,5653,2744,781,2933,5677,2992,5753
ǹ,ChengGuanZhen,611023100,43696,2860,27460,15765,44478,24003,9281,24145,48148,28377,55837
ˮ,FuShuiZhen,611023101,17085,1531,10627,6139,19970,10042,3137,10394,20436,11126,21753
,XiangHeZhen,611023102,8713,913,5292,3069,10887,5215,1539,5720,10935,5873,11165
,BaiLangZhen,611023103,4592,482,2979,1701,6101,2955,1154,3168,6123,3249,6228
Դ,ZhaoChuanZhen,611023104,9048,1011,5505,3246,10840,5188,1641,5798,10986,6195,11700
,LiangJiaWanZhen,611023105,5790,699,3650,2265,7445,3593,1213,3937,7530,4052,7702
̫,TaiJiHeZhen,611023106,12058,1170,7353,4290,14911,7168,2230,7747,14915,8105,15458
¥,GuoFengLouZhen,611023107,10587,959,6490,3880,13171,6389,1897,6800,13189,6953,13443
,ShiMaZhen,611023108,11922,1285,7487,4639,15078,7474,2103,7749,15223,7823,15310
ͺ,QingYouHeZhen,611023109,9123,885,5587,3282,11286,5507,1649,5890,11397,6070,11657
ʮƺ,ShiLiPingZhen,611023110,8584,1117,5339,3226,11053,5300,1786,6052,11352,6148,11487
ɽ,QingShanXiang,611023200,7924,817,4842,2879,9796,4781,1412,5144,9925,5311,10153
κ̨,WeiJiaTaiXiang,611023201,4311,548,2633,1653,5489,2596,921,2964,5560,3147,5780
³,BaiLuChuXiang,611023202,4028,534,2585,1474,5201,2554,973,2837,5391,2950,5535
ˮ,ShuiGouXiang,611023203,5254,507,3007,1901,6365,2940,974,3394,6334,3728,6735
,DangMaXiang,611023204,9264,773,5580,3248,11164,5495,1589,5863,11358,6046,11626
ǹ,ChengGuanZhen,611024100,52080,3650,32207,18026,51605,29760,11464,31333,61093,34987,67194
߰ӵ,GaoBaDianZhen,611024101,22658,1997,13764,7291,29173,13464,4912,15182,28646,15803,29567
,ChangGouZhen,611024102,8703,847,5530,2944,11331,5487,2220,6123,11610,6240,11770
д,ZhongCunZhen,611024103,16515,1535,9931,5355,19961,8929,3472,9843,18772,11591,21522
,YinHuaZhen,611024104,11273,1037,6888,3799,14068,6743,2689,7764,14507,8111,14999
մ,XiZhaoChuanZhen,611024105,8351,883,5271,2949,10538,5185,1847,5631,10816,5810,11081
,ManChuanGuanZhen,611024106,13341,1200,8311,4121,15405,7590,2557,7836,15426,8787,17098
Ͽƺ,NanKuanPingZhen,611024107,12472,1423,8020,4625,16896,7961,3217,8994,16955,9092,17112
ܫ,HuJiaYuanZhen,611024108,14488,1480,8876,4971,18303,8694,3320,9977,18671,10412,19288
,YangDiZhen,611024109,15498,1672,9847,5246,20805,9792,3911,11081,20873,11234,21081
ţ,NiuErChuanZhen,611024110,5920,627,3545,2057,7753,3512,1332,4265,7777,4334,7879
Сӿ,XiaoHeKouZhen,611024111,10561,1148,6635,3536,14004,6545,2508,7415,13960,7582,14217
ɫ,SeHePuZhen,611024112,11324,1089,6969,3949,14287,6782,2315,7425,14207,7759,14728
,BanYanZhen,611024113,17416,1885,10885,6490,23159,10814,4157,12410,23224,12573,23458
Ԫӽ,YuanZiJieZhen,611024114,5681,654,3604,2111,7469,3576,1281,3936,7512,4012,7616
,WuZhuXiang,611024200,3494,372,2225,1277,4519,2202,796,2407,4609,2437,4662
ʮ,ShiLiPuXiang,611024201,16451,1412,10191,5811,21160,10134,3543,11133,21267,11215,21406
,GeTiaoXiang,611024202,3685,439,2323,1356,4828,2275,809,2530,4805,2610,4933
ׯ,WangZhuangXiang,611024203,3299,396,2127,1303,4351,2123,718,2267,4390,2286,4413
,ShenJiaDieXiang,611024204,6924,629,4251,2170,9090,4229,1583,4852,9081,4885,9136
,LiangLingXiang,611024205,7851,744,5019,2570,10422,4982,2040,5547,10529,5616,10635
Ȫ,XiQuanXiang,611024206,4126,452,2503,1344,5383,2489,998,3002,5491,3073,5576
,WangYanXiang,611024207,3821,494,2438,1473,5139,2405,945,2698,5103,2822,5260
,TianQiaoXiang,611024208,4407,519,2835,1594,6055,2783,1144,3155,5938,3235,6070
ʯ,ShiFoSiXiang,611024209,5952,716,3726,2067,7901,3706,1320,4198,7904,4262,7988
,FaGuanXiang,611024210,13022,1277,8359,4650,17213,8358,3029,8969,17327,8969,17328
ƺ,YanPingXiang,611024211,4211,494,2823,1551,5820,2817,1146,3002,5819,3028,5851
,LianHuaChiXiang,611024212,5918,659,3819,2135,8022,3799,1494,4197,7996,4252,8071
,HuangLongXiang,611024213,4807,614,3019,1811,6478,3012,1092,3460,6472,3494,6513
,ErYuHeXiang,611024214,4237,438,2717,1376,5734,2710,1128,3054,5764,3086,5803
,YongLeZhen,611025100,49110,3321,31076,19278,46170,28670,11428,30113,58783,32783,63859
,HuiLongZhen,611025101,8052,824,4679,2611,9535,4483,1588,5132,9615,5785,10464
,TieChangZhen,611025102,9189,1328,5618,3250,12188,5560,1851,6645,12205,6750,12368
ƺ,DaPingZhen,611025103,9105,1568,6366,4332,12788,6282,2584,6696,12978,6891,13257
,MiLiangZhen,611025104,14455,1791,8743,5076,18497,8592,2549,9795,18387,10052,18795
éƺ,MaoPingHuiZuZhen,611025105,5780,777,3724,2075,7802,3693,1434,4211,7904,4267,7991
ڻ,XiKouHuiZuZhen,611025106,7634,1020,5171,3020,10501,5105,2188,5558,10663,5671,10842
߷,GaoFengZhen,611025107,6383,996,4278,2651,8744,4255,1572,4619,8874,4673,8951
ͭ,QingTongGuanZhen,611025108,12258,1545,7341,4282,14622,7126,2745,8074,15200,9207,16548
ƺ,ChaiPingZhen,611025109,7618,1204,4913,2776,10298,4839,1885,5654,10493,5794,10707
,DaRenZhen,611025110,8108,1393,5083,3259,11011,4958,1746,5902,10860,6164,11247
ľ,MuWangZhen,611025111,5250,982,3374,2260,7094,3342,1088,3877,7219,3946,7320
,DongChuanZhen,611025112,3800,695,2362,1636,4975,2339,637,2715,5054,2770,5132
Ƹ,YunGaiSiZhen,611025113,9822,1411,6160,3527,12739,5986,1846,6630,12616,6919,13079
,LingLongXiang,611025200,7729,1005,4811,2936,9958,4770,1592,5435,10205,5515,10326
,XiGouXiang,611025201,1793,256,1130,649,2381,1126,397,1281,2407,1316,2446
ƺ,GuanPingHeXiang,611025202,4088,537,2583,1460,5359,2563,962,2962,5525,3004,5587
ż,ZhangJiaXiang,611025203,6237,871,4055,2376,8215,3979,1648,4472,8451,4701,8756
ʤ,LongShengXiang,611025204,2153,277,1292,789,2828,1279,500,1602,2881,1638,2930
ʦ,YuShiXiang,611025205,5514,1043,3518,2230,7409,3504,1067,4048,7552,4106,7624
,YangSiXiang,611025206,1660,314,959,644,2088,934,262,1188,2122,1277,2236
º,YueHeXiang,611025207,1472,274,847,551,1810,836,247,999,1835,1146,1993
Ƽ,HuangJiaWanXiang,611025208,4415,852,2835,1746,5981,2784,837,3195,5979,3269,6104
�,MiaoGouXiang,611025209,6566,1181,4096,2576,8742,4065,1248,4802,8867,4899,8995
,JieZiXiang,611025210,6274,774,3838,2214,7969,3780,1257,4427,8207,4467,8305
Ǭ,QianYouZhen,611026100,20841,1593,13010,8200,20787,12528,4703,13086,25614,14127,27137
Ӫ,YingPanZhen,611026101,5898,665,3404,2040,6613,3062,1009,3488,6550,4168,7572
,XiaLiangZhen,611026102,11135,1037,6317,3269,9909,5013,1744,5574,10587,7599,13916
ʯ,ShiWengZhen,611026103,4840,576,2944,1660,5821,2858,941,3104,5962,3413,6357
С,XiaoLingZhen,611026104,8877,991,4971,2994,9823,4617,1544,5326,9943,6441,11412
,FengHuangZhen,611026105,13316,1603,8459,5094,16673,8326,2931,9221,17547,9391,17850
,HongYanSiZhen,611026106,9908,1361,6526,4110,13333,6466,2408,6994,13460,7151,13677
ƺ,CaoPingZhen,611026107,3805,526,2384,1487,4903,2332,784,2601,4933,2731,5115
Ҥ,CaiYuYaoZhen,611026108,4822,758,3156,1868,6563,3150,1124,3526,6676,3548,6704
ƺ,XingPingZhen,611026109,12967,1624,8103,4651,17195,8063,2873,9226,17289,9361,17464
,LiangHeXiang,611026200,490,89,270,205,624,265,71,363,628,380,650
ׯ,ChaiZhuangXiang,611026201,4033,506,2435,1455,5348,2419,974,3022,5441,3078,5513
̨,MaTaiXiang,611026202,4215,584,2663,1645,5590,2644,974,3042,5686,3110,5773
߷,WaFangKouXiang,611026203,5354,747,3383,2055,7151,3348,1260,3889,7237,3978,7361
ż䷿,JiuJianFangXiang,611026204,2539,344,1621,970,3318,1617,486,1723,3340,1748,3369
ᱱ,FengBeiHeXiang,611026205,2641,433,1575,1031,3380,1558,454,1833,3391,1953,3528
Ȫ·ֵ,JiuQuanLuJieDao,620102001,34905,4696,22888,16288,27278,21553,5166,20538,42091,21879,44767
Ҵ·ֵ,ZhangYeLuJieDao,620102002,44491,5056,25605,16428,35705,22012,5201,20184,42196,29143,54748
Ͻֵ,YanNanJieDao,620102003,83767,4907,48558,39725,24248,42349,12667,46257,88606,52783,101341
·ֵ,LinXiaLuJieDao,620102004,34378,4681,22325,16349,24727,20723,4596,19788,40511,21330,43655
㱱ֵ,YanBeiJieDao,620102005,95288,4804,54246,40992,33490,46191,14896,51492,97683,60742,114988
Ȫֵ,WuQuanJieDao,620102006,38979,5083,24965,19291,31411,23601,5750,23652,47253,24847,49812
·ֵ,BaiYinLuJieDao,620102007,41010,5126,27313,17006,35044,22231,5159,20701,42932,23982,51295
·ֵ,GaoLanLuJieDao,620102008,41999,6606,27479,19659,37093,26185,5967,25585,51770,27093,54572
Žֵ,GuangWuMenJieDao,620102009,39848,5752,26609,19126,33145,25355,6355,23804,49159,25346,51955
ƺֵ,FuLongPingJieDao,620102010,10754,1196,6549,5185,7407,6146,1817,6554,12700,7218,13767
Զ·ֵ,JingYuanLuJieDao,620102011,45297,5240,28931,20783,27796,28013,8647,27881,55894,30253,59184
ݳֵֽ,CaoChangJieJieDao,620102012,44919,5233,27618,19636,29667,26067,7485,25745,51812,30019,57637
վֵ,HuoCheZhanJieDao,620102013,36712,4612,23392,17372,28463,22929,6065,23015,45944,23997,47389
Ƕսֵ,GongXingDunJieDao,620102014,69157,4581,42684,27084,31739,33447,11896,34280,67727,42950,85634
ڽֵ,DongGangJieDao,620102015,47610,3163,27699,14088,29979,18123,5787,18480,36603,28861,56560
Ž´ֵ,TuanJieXinCunJieDao,620102016,40174,5793,25459,17434,30174,22857,5663,22364,45221,26171,51630
·ֵ,DongGangXiLuJieDao,620102017,27897,4421,18909,12893,25598,17500,4572,16399,33899,17981,36890
·ֵ,TieLuDongCunJieDao,620102018,26467,4734,17754,13045,25197,17199,3648,16423,33622,17095,34849
·ֵ,TieLuXiCunJieDao,620102019,27472,5664,18769,13611,25416,18028,3928,17459,35487,18295,37064
μԴ·ֵ,WeiYuanLuJieDao,620102020,52759,6794,33572,16944,42448,22498,5575,21845,44343,31556,65128
γ·ֵ,YanChangLuJieDao,620102021,37775,3119,21474,16120,18384,20206,6510,21690,41896,25930,47404
·ֵ,JiaYuGuanLuJieDao,620102022,46338,4507,28818,17474,25209,24291,6864,24625,48916,28891,57709
ֵ,JiaoJiaWanJieDao,620102023,26531,2309,16318,10820,14095,13831,4392,13617,27448,16914,33232
ʯֵ,QingBaiShiJieDao,620102024,9092,804,4726,2873,7555,4590,1446,4995,9585,6616,11342
,GaoXinQu,620102400,13745,577,7590,6418,6085,6660,1871,7820,14480,8603,16193
԰ֵ,XiYuanJieDao,620103001,47650,5807,30893,21740,32269,30082,9198,30340,60422,31762,62655
ֵ,XiHuJieDao,620103002,69734,7280,36184,21248,54902,27894,7149,27791,55685,47979,84163
·ֵ,JianLanLuJieDao,620103003,39589,5165,25834,19427,35900,25286,6427,24887,50173,25347,51181
ػ·ֵ,DunHuangLuJieDao,620103004,49451,7410,32386,23606,47427,31931,8753,31756,63687,33228,65614
վֵ,XiZhanJieDao,620103005,30769,5331,20154,15061,30478,19753,4367,19711,39464,20313,40467
̼ƺֵ,YanJiaPingJieDao,620103006,21145,2911,12246,8611,18762,11084,2856,11488,22572,14666,26912
ֵ,GongJiaWanJieDao,620103007,39919,3604,20554,11648,34283,15577,4256,15991,31568,27225,47779
Ŷսֵ,TuMenDunJieDao,620103008,25466,3305,15577,11265,19832,14480,4060,15181,29661,17254,32831
㴨ֵ,XiuChuanJieDao,620103009,28763,3315,18555,11579,24432,17803,5479,17835,35638,19002,37557
,AGanZhen,620103100,15781,2445,10148,6609,18024,10130,2759,10576,20706,10837,20985
,BaLiZhen,620103101,17219,1994,10904,6206,18076,10571,3380,10875,21446,11689,22593
ƺ,PengJiaPingZhen,620103102,14144,1210,8914,4626,13367,8293,2873,8479,16772,9313,18227
԰,XiGuoYuanZhen,620103103,20071,1436,12406,5061,17157,9950,4772,10577,20527,13873,26279
κ,WeiLingXiang,620103200,7198,870,4683,2653,9006,4681,1706,5046,9727,5091,9774
,HuangYuXiang,620103201,10054,1213,6647,3545,13010,6645,2736,7335,13980,7356,14003
ƺֵ,ChenPingJieDao,620104001,32029,2510,18461,12255,21255,16861,5692,18096,34957,21770,40231
ȷ·ֵ,XianFengLuJieDao,620104002,46862,7078,29675,21040,50040,27868,6298,27087,54955,30563,60238
·ֵ,FuLiLuJieDao,620104003,49358,9329,32538,24187,56217,31507,6773,30886,62393,32922,65460
̳ǽֵ,XiGuChengJieDao,620104004,39617,4479,25145,18648,31403,24608,7107,24749,49357,26058,51203
ļֵ,SiJiQingJieDao,620104005,25354,2045,15193,9145,15371,12832,4644,13143,25975,16850,32043
䬽ֵֽ,LinTaoJieJieDao,620104006,16920,2347,10901,8145,14446,10858,3160,11193,22051,11526,22427
ֵ,XiLiuGouJieDao,620104007,16791,2265,10546,8325,12876,10490,3168,11379,21869,11678,22224
³,XinChengZhen,620104100,14421,1859,9088,6225,15874,9025,2393,9270,18295,9585,18673
ﴨ,DaChuanXiang,620104200,4314,556,2840,1933,5359,2837,906,2926,5763,2936,5776
ӿ,HeKouXiang,620104201,9424,1160,5885,3435,10676,5655,1569,5841,11496,6268,12153
,DongChuanZhen,620104202,6706,817,4303,3051,7925,4286,1173,4361,8647,4393,8696
Ȫ,LiuQuanXiang,620104203,4782,710,3169,1888,5929,3169,782,3105,6274,3105,6274
,JinGouXiang,620104204,2999,394,1944,1027,3536,1855,651,2038,3893,2100,4044
°·ֵ,XinAnLuJieDao,620104400,8090,2216,5893,4771,11150,5857,1403,5794,11651,5816,11709
º·ֵ,XinHeLuJieDao,620104401,2038,562,1418,1192,2594,1402,299,1396,2798,1481,2899
ֵ,PeiLiJieDao,620105001,55283,3052,34235,10283,38393,13837,3851,13409,27246,27951,62186
·ֵ,XiLuJieDao,620105002,66625,6489,34476,16492,56827,22087,5920,21722,43809,44558,79034
ɳֵ,ShaJingYiJieDao,620105003,9316,791,5352,2491,5673,3312,1274,3253,6565,6029,11381
ʮֵ,ShiLiDianJieDao,620105004,25917,2136,16244,11322,15713,15447,5117,15680,31127,16926,33170
׼½ֵ,KongJiaYaJieDao,620105005,22075,2128,14180,9129,16549,13595,4219,13307,26902,14242,28422
̲·ֵ,YinTanLuJieDao,620105006,26673,1604,13556,5978,18357,8649,2864,8625,17274,17585,31141
ұֵ,LiuJiaBaoJieDao,620105007,18748,1161,12087,4410,16358,6823,2293,6674,13497,10115,22202
ֵ,AnNingBaoJieDao,620105008,17161,1434,10018,4774,13979,7490,2379,7690,15180,10956,20974
Ҥֵֽ,YaoJieJieDao,620111001,13364,1807,8936,6027,14033,8919,2952,8967,17886,9187,18123
Ҥֵ,XiaYaoJieDao,620111002,13046,1446,7959,6179,13805,7946,2657,8436,16382,9190,17149
ֵ,KuangQuJieDao,620111003,4898,433,3032,1576,3594,2582,1026,2673,5255,3325,6357
ʯ,HaiShiWanZhen,620111101,42650,4230,26955,18630,42071,26243,8056,26236,52479,27981,54936
ׯ,HuaZhuangZhen,620111102,10030,1038,6246,3473,11474,6039,1882,6256,12295,6704,12950
ƽ,PingAnZhen,620111103,10610,1146,6681,3944,12374,6584,2130,6865,13449,7205,13886
,HongGuXiang,620111200,9640,927,6274,3271,11032,5933,2133,6129,12062,6426,12700
ǹ,ChengGuanZhen,620121100,46987,4512,31350,20048,35897,29484,10594,28536,58020,30743,62093
,HongChengZhen,620121101,13348,2025,9967,5419,16690,8876,3637,8052,16928,9043,19010
б,ZhongBaoZhen,620121102,14717,1646,9656,6449,16988,9613,3216,9656,19269,9923,19579
ʤ,WuShengYiZhen,620121103,19257,2174,12608,7307,24554,12449,4416,12687,25136,13239,25847
,HeQiaoZhen,620121104,24839,2251,15637,9437,29416,15353,5342,15958,31311,16795,32432
,LianChengZhen,620121105,21712,2530,14271,8714,26342,14002,4687,14207,28209,14658,28929
ˮ,KuShuiZhen,620121106,15912,2736,11365,7075,21677,11312,3805,10901,22213,11088,22453
д,ZhongChuanZhen,620121107,24325,2518,16348,9453,30255,16123,6310,16222,32345,16805,33153
ش,QinChuanZhen,620121108,26381,2777,18306,10070,33666,17519,7589,17704,35223,18441,36747
ͬ,DaTongZhen,620121109,17232,2368,11910,5532,17227,9129,4252,8813,17942,11942,23852
Ȫ,LongQuanSiZhen,620121110,10051,1591,7369,4504,13812,7312,2758,6918,14230,7031,14400
,ShuPingZhen,620121111,6633,929,4678,2760,8993,4660,2003,4869,9529,4887,9565
ϴ,ShangChuanZhen,620121112,13653,1898,9751,5894,17744,9721,3635,9400,19121,9435,19186
,LiuShuXiang,620121200,13026,1819,8986,5398,16831,8929,3062,8766,17695,8921,17907
ƺ,PingChengXiang,620121201,7042,970,4781,2917,9245,4762,1601,4765,9527,4832,9613
,MinYueXiang,620121202,21583,2703,14371,8234,27657,14285,5192,14836,29121,15107,29478
ͨԶ,TongYuanXiang,620121203,7738,1065,5242,3060,10184,5159,1824,5142,10301,5385,10627
ɽ,QiShanXiang,620121204,2959,468,1954,1405,3678,1946,491,1923,3869,1964,3918
ʯ,ShiDongZhen,620122100,34114,3699,22420,14069,35780,20896,7412,21296,42192,22805,45225
,XiChaZhen,620122101,20963,2625,14276,8162,27312,14243,5162,14346,28589,14474,28750
Һ,ZhongHeZhen,620122102,8578,1148,5655,3416,11195,5564,2051,5949,11513,6122,11777
ʲ,ShenChuanZhen,620122103,10557,1787,7002,4440,13920,6983,2202,7482,14465,7544,14546
ź,JiuHeZhen,620122104,7201,1110,4951,3041,9400,4795,1752,4848,9643,5112,10063
ʯ,HeiShiChuanXiang,620122200,9278,1580,6289,4072,11962,6224,1946,6218,12442,6515,12804
ˮ,ShuiFuXiang,620122202,5972,1129,4334,2803,8300,4315,1519,4252,8567,4286,8620
ǹ,ChengGuanZhen,620123100,52280,4916,33502,19033,48266,29181,10367,29113,58294,34061,67563
ĹӪ,XiaGuanYingZhen,620123101,34824,1479,16747,4139,12953,6628,2039,6730,13358,21595,38342
,GaoYaZhen,620123102,6951,1038,4777,3195,8861,4728,1559,4599,9327,4771,9548
,JinYaZhen,620123103,18073,2107,11758,5885,21558,10958,3704,11051,22009,12126,23884
ƽ,HePingZhen,620123104,56137,2409,31218,7339,27736,13579,4777,14197,27776,32105,63323
ʲݵ,GanCaoDianZhen,620123105,11484,1526,7395,4210,14753,7233,2166,7490,14723,7781,15176
,QingChengZhen,620123106,12017,2390,8240,5281,16493,8132,2611,8590,16722,8778,17018
Զ,DingYuanZhen,620123107,12498,1350,8111,4187,14885,7694,2651,7899,15593,8388,16499
ϱ,LaiZiBaoXiang,620123200,14533,1556,9150,5187,17130,8848,3082,8965,17813,10021,19171
ǳ,SanJiaoChengXiang,620123201,17597,2050,11394,6200,21821,11228,3588,11289,22517,11841,23235
СӪ,XiaoKangYingXiang,620123202,15484,2318,11092,6340,20955,11041,3596,10073,21114,10306,21398
,LianDaXiang,620123203,19933,2799,13552,7727,26963,13521,4633,13741,27262,13813,27365
ɽ,YinShanXiang,620123204,5732,658,3779,2117,7162,3736,1347,3877,7613,3958,7737
,MaPoXiang,620123205,10571,1427,7036,4079,14348,7017,2685,7595,14612,7647,14683
Ӫ,XinYingXiang,620123206,12434,1721,8212,4516,16329,8134,2863,8610,16744,8806,17018
ˮ,QingShuiYiXiang,620123207,11882,1900,8215,4945,15898,8213,2547,8093,16306,8114,16329
Ȫ,LongQuanXiang,620123208,7111,1030,4578,2655,9284,4530,1566,4899,9429,5129,9707
ΤӪ,WeiYingXiang,620123209,3116,562,2180,1357,4289,2169,747,2203,4372,2245,4425
,ZhongLianChuanXiang,620123210,4539,641,3284,1966,6452,3273,1420,3310,6583,3316,6600
,GongJingXiang,620123211,3659,558,2518,1577,4717,2435,868,2386,4821,2567,5085
԰Ӳ,YuanZiChaXiang,620123212,3541,614,2669,1514,5072,2656,1026,2457,5113,2512,5181
ϻ,ShangHuaChaXiang,620123213,3513,606,2403,1517,4901,2370,853,2475,4845,2569,4972
,HaXianXiang,620123214,1973,383,1492,949,2803,1472,548,1381,2853,1412,2904
ʤֵ´,ShengLiJieDaoBanShiChu,620201001,24089,2404,13735,10681,19463,13279,4326,14392,27671,17084,30819
»ֵ´,XinHuaJieDaoBanShiChu,620201002,14752,1861,8968,7151,14166,8823,2616,9172,17995,10261,19229
һֵ´,WuYiJieDaoBanShiChu,620201003,27663,2313,16529,12705,20867,15715,5718,16702,32417,19165,35694
ֵ´,JianSheJieDaoBanShiChu,620201004,46063,3939,27508,21092,43745,26594,8413,27584,54178,30907,58415
ǰֵ´,QianJinJieDaoBanShiChu,620201005,15583,2561,9431,8013,16056,9235,2437,9449,18684,11150,20581
Էֵ´,YuYuanJieDaoBanShiChu,620201007,18498,2484,12412,10022,18529,12286,4175,12450,24736,12745,25157
ֵ´,ZhaoYangJieDaoBanShiChu,620201008,17565,835,9850,4792,5798,6104,3244,6412,12516,11794,21644
³,XinChengZhen,620201100,5776,532,3802,2208,7069,3752,1320,3788,7540,3826,7628
Ȫ,YuQuanZhen,620201101,4420,364,2695,1669,4009,2630,933,2745,5375,3022,5717
,WenShuZhen,620201102,5531,460,3117,1987,5649,3056,978,3054,6110,3852,6969
·ֵ´,BinHeLuJieDaoBanShiChu,620302001,25053,2244,14547,11568,23206,14087,4134,14899,28986,16884,31431
·ֵ´,GuiLinLuJieDaoBanShiChu,620302002,25630,1752,16416,12110,21028,15766,6143,16278,32044,17109,33525
·ֵ´,BeiJingLuJieDaoBanShiChu,620302003,14932,1565,8965,7253,14926,8759,2156,8930,17689,9688,18653
·ֵ´,JinChuanLuJieDaoBanShiChu,620302004,35294,5495,23353,18314,35590,23068,6960,22991,46059,24396,47749
»·ֵ´,XinHuaLuJieDaoBanShiChu,620302005,16787,1437,10738,8128,13822,10423,3464,10219,20642,10950,21688
·ֵ´,GuangZhouLuJieDaoBanShiChu,620302006,16180,2197,10506,9087,15144,10358,3246,10651,21009,11117,21623
Զ,NingYuanBaoZhen,620302100,26255,2145,16187,11794,24018,16010,5904,17477,33487,18117,34304
˫,ShuangWanZhen,620302101,13898,1765,9294,6582,15569,9263,3925,10129,19392,10294,19588
ǹ,ChengGuanZhen,620321100,41170,3475,26228,18357,32563,25553,10792,26789,52342,29209,55437
,HeXiBaoZhen,620321101,35672,4164,22924,17138,41544,22469,7559,23244,45713,24471,47395
³,XinChengZiZhen,620321102,14854,1712,9798,6003,19559,9781,4058,10787,20568,10826,20624
,ZhuWangBaoZhen,620321103,19966,2099,12587,6985,25429,12244,4354,13275,25519,13832,26419
կ,DongZhaiZhen,620321104,8762,1045,5708,3838,9686,5646,2041,5965,11611,6140,11848
ˮԴ,ShuiYuanZhen,620321105,12662,1438,8020,4985,16207,7938,2725,8666,16604,8805,16825
ɽҤ,HongShanYaoXiang,620321200,18872,1655,12014,6669,23311,11947,4889,12903,24850,13402,25416
ׯ,JiaoJiaZhuangXiang,620321201,11405,1421,7485,4634,15021,7470,2809,8000,15470,8150,15635
,LiuBaXiang,620321202,8871,722,5772,3486,10782,5667,2476,6162,11829,6297,12069
ϰ,NanBaXiang,620321203,2783,295,1817,1112,3758,1812,743,1998,3810,2004,3821
·ֵ,RenMinLuJieDao,620402001,33241,4778,21615,15703,33537,20666,5818,20991,41657,22222,43837
԰·ֵ,GongYuanLuJieDao,620402002,49469,6715,32363,24715,52754,31934,9956,32761,64695,33777,66140
·ֵ,SiLongLuJieDao,620402003,30426,5216,19672,14949,34019,19177,5241,19670,38847,21211,40883
ũ·ֵ,GongNongLuJieDao,620402004,27396,3710,17393,13172,25675,16583,4493,16769,33352,18206,35599
֯·ֵ,FangZhiLuJieDao,620402005,29364,2177,15848,10958,29251,15244,5209,15417,30661,20902,36750
ˮ,ShuiChuanZhen,620402100,15946,2804,10641,6345,20232,10230,2939,10816,21046,11048,21689
,SiLongZhen,620402101,6958,926,4554,2766,8466,4345,1390,4594,8939,4720,9274
,WangXianZhen,620402102,14553,1234,8587,3652,7157,4853,2237,5132,9985,9437,18024
ǿ,QiangWanXiang,620402201,7675,1203,4920,3144,9079,4747,1289,5140,9887,5247,10167
䴨,WuChuanXiang,620402202,9293,1373,5891,3288,11371,5691,1371,5984,11675,6146,12037
ֵ,ChangZhengJieDao,620403001,21834,2497,13918,10709,23125,13622,4273,14268,27890,14686,28604
·ֵ,DianLiLuJieDao,620403002,16782,881,9992,6173,10089,7628,3236,8101,15729,10907,20899
·ֵ,HongHuiLuJieDao,620403003,10287,418,5640,5035,9552,5630,1778,6738,12368,6843,12483
ƽ·ֵ,XingPingLuJieDao,620403004,26335,1563,14186,9370,21759,12335,4764,13182,25517,18476,32662
ɽ,WangJiaShanZhen,620403100,11118,644,6557,4666,11355,6535,2638,7408,13943,7843,14400
ˮȪ,ShuiQuanZhen,620403101,24577,2524,16188,8374,31991,15894,5817,16435,32329,16730,32918
,GongHeZhen,620403102,11909,1191,7816,4038,14748,7728,2975,7764,15492,8259,16075
,BaoJiXiang,620403201,11234,943,7114,2948,9690,5388,2490,5585,10973,7553,14667
,HuangQiaoXiang,620403202,7490,765,5004,2516,9857,5004,1866,5082,10086,5117,10121
,ZhongTianXiang,620403203,3542,505,2505,1423,4774,2504,923,2465,4969,2465,4970
,FuXingXiang,620403204,3377,499,2246,1283,4419,2235,724,2330,4565,2354,4600
Զر,JingYuanXianBeiWanZhen,620421101,26826,3040,17759,9062,35927,17682,6375,18396,36078,18482,36241
Զض,JingYuanXianDongWanZhen,620421102,27401,3146,18506,9398,35874,18454,7450,19361,37815,19491,37997
Զ,JingYuanXianWuLanZhen,620421103,67556,5208,42627,20402,60717,32741,14226,35343,68084,44363,86990
Զƽ,JingYuanXianPingBaoXiang,620421200,11804,1433,7767,4512,15811,7693,2869,8239,15932,8339,16106
Զ̲,JingYuanXianMiTanXiang,620421202,15565,1793,10459,5208,20995,10127,3984,10546,20673,10883,21342
Զ̲,JingYuanXianSanTanXiang,620421203,18742,1940,11930,4952,19149,9437,4139,9824,19261,12891,24821
Զش«,JingYuanXianDaLuXiang,620421205,13163,1469,8919,4175,17546,8410,3238,8411,16821,8951,17870
Զ¡,JingYuanXianXingLongXiang,620421206,6396,885,4680,2526,9134,4647,2059,4599,9246,4660,9340
Զ˫,JingYuanXianShuangLongXiang,620421207,9018,910,6234,2938,12687,6146,2995,6505,12651,6689,12923
Զʯ,JingYuanXianShiMenXiang,620421208,9194,1168,6291,2954,12732,6098,2511,6239,12337,6582,12873
Զ,JingYuanXianLiuChuanXiang,620421209,22958,1621,14446,7346,28711,14316,5281,15237,29553,15414,29860
Զظ,JingYuanXianGaoWanXiang,620421210,19913,1503,12512,5739,25627,12145,4577,13051,25196,13481,25993
Զؾ,JingYuanXianJingAnXiang,620421211,8596,798,5710,3469,11403,5656,2254,5869,11525,5938,11648
Զ,JingYuanXianWuHeXiang,620421212,21261,1780,14335,6966,28168,14175,6341,14779,28954,15047,29382
Զض,JingYuanXianDongShengXiang,620421213,17130,1472,11599,5249,21909,11364,5207,11684,23048,12210,23809
Զر̲,JingYuanXianBeiTanXiang,620421214,30391,2535,20762,9646,40603,20535,9484,21302,41837,21648,42410
Զ,JingYuanXianYongXinXiang,620421215,5215,739,3728,1921,7315,3696,1719,3884,7580,3945,7673
Զ,JingYuanXianRuoLiXiang,620421216,5484,849,3712,1935,7448,3569,1314,3597,7166,3935,7647
ʦ,HuiShiZhen,620422100,55098,3672,33332,19320,44873,26283,10188,28394,54677,35626,68958
,GuoChengZhen,620422101,25495,2488,16856,7632,30393,14462,6093,14531,28993,17220,34076
,HePanZhen,620422102,19446,1803,12673,5087,21440,9954,4154,10233,20187,12730,25403
ͷկ,TouZhaiZiZhen,620422103,19620,2105,13327,5960,26521,12957,5269,13105,26062,13667,26994
̫ƽ,TaiPingDianZhen,620422104,13504,1623,8930,4358,17650,8518,3170,8796,17314,9367,18297
ʹ,GanGouYiZhen,620422105,15159,1896,10239,4734,20127,9874,3851,10030,19904,10667,20906
ҹ,DingJiaGouXiang,620422200,12996,1745,8591,4127,17124,8441,2898,8726,17167,9048,17639
д,ZhongChuanXiang,620422201,10769,1409,7272,3361,14447,7079,2551,7142,14221,7457,14729
�,XinTianBaoHuiZuXiang,620422202,9046,1199,6417,2841,12693,6277,2810,6400,12677,6638,13055
Ҵ,HouJiaChuanXiang,620422203,8143,1095,5766,2722,11249,5687,2247,5529,11216,5719,11485
,DangJiaXianXiang,620422204,12915,1595,8688,3824,17434,8461,3356,8584,17045,9178,17866
¼,YangYaJiXiang,620422205,14153,1958,9920,4594,19644,9896,3869,9914,19810,10060,19980
Ͼ,LaoJunPoXiang,620422207,15402,1892,10384,4534,20978,10113,3803,10278,20391,10713,21097
Լ,ZhaiJiaSuoXiang,620422209,12518,1650,8580,4231,16987,8359,3152,8356,16715,8740,17320
,ChaiJiaMenXiang,620422211,14279,1971,9507,4401,19044,9352,3090,9529,18881,9833,19340
,BaLiWanXiang,620422213,11509,1706,7851,3964,15794,7649,2834,7803,15452,8198,16049
ƽͷ,PingTouChuanXiang,620422214,7965,1074,5338,2748,10537,5231,1939,5434,10665,5640,10978
Ҽ,HanJiaJiXiang,620422215,10321,1515,6790,3219,13841,6636,2153,6831,13467,7199,13989
,DaGouXiang,620422217,13298,1621,8980,4072,18165,8652,3472,8873,17525,9411,18391
ķ,SiFangWuXiang,620422218,14279,1534,10028,3851,19830,9910,4098,9693,19603,9883,19911
Ҳ,HanJiaChaXiang,620422220,13809,1837,9429,4481,19074,9261,3748,9489,18750,9965,19394
,TuMenXianXiang,620422221,6615,778,4405,2017,8879,4317,1712,4491,8808,4700,9105
ܫ,XinYuanXiang,620422222,9787,1068,6617,3095,13582,6511,2985,7004,13515,7223,13840
կ,LiuJiaZhaiZiXiang,620422223,12094,1247,8273,3714,16522,8067,3365,8089,16156,8433,16706
̲,CaoTanXiang,620422224,8190,847,5462,2425,10974,5277,2257,5551,10828,5832,11294
ɽ,TuGaoShanXiang,620422225,7526,764,4823,1727,7598,3693,1738,3825,7518,5205,10028
ײܫ,BaiCaoYuanXiang,620422226,15769,1630,10768,4573,21193,10639,4244,10631,21270,10875,21643
ׯ,XinZhuangXiang,620422227,9045,1177,6437,2701,12464,6381,2578,6241,12622,6363,12800
һɽ,YiTiaoShanZhen,620423100,52764,3625,33578,19651,41352,30798,12563,33043,63841,35374,68952
«,LuYangZhen,620423101,16384,1801,10645,5393,20697,10645,3523,11063,21708,11063,21708
ɳ,ShangShaWoZhen,620423102,6080,665,3988,2047,7794,3988,1384,4141,8129,4141,8129
ϲȪ,XiQuanZhen,620423103,15620,1754,10258,5041,20294,10258,3397,10513,20771,10513,20771
̲,CaoWoTanZhen,620423104,14390,1513,9342,4535,18135,9332,3112,9616,18948,9673,19015
ˮ,HongShuiZhen,620423105,11318,1112,7513,4115,14075,7513,2792,7708,15221,7709,15222
Ȫ,ZhongQuanXiang,620423200,8570,1223,5595,2989,11169,5558,1668,5787,11345,5866,11461
·,ZhengLuXiang,620423201,9591,1279,6373,3445,12530,6373,1994,6490,12863,6491,12864
̲,SiTanXiang,620423203,9723,1362,6508,3670,12869,6503,2146,6660,13163,6723,13231
,WuFoXiang,620423205,9725,1127,6363,3420,12680,6363,2000,6489,12852,6489,12852
ˮ̲,ManShuiTanXiang,620423207,6966,679,4453,2530,8647,4453,1516,4708,9161,4708,9161
ɽ,TiaoShanJiTuan,620423400,9402,866,5886,2826,5351,4211,2121,4531,8742,6503,12389
ǽֵ´,DaChengJieDaoBanShiChu,620502001,20911,2124,12475,7659,15574,10333,2987,10275,20608,13547,26022
սֵ´,QiLiDunJieDaoBanShiChu,620502002,44209,5166,25623,17665,39323,22320,5999,22648,44968,29751,55374
ؽֵ´,DongGuanJieDaoBanShiChu,620502003,19483,2112,11747,7152,17890,9870,2832,10087,19957,12680,24427
гǽֵ´,ZhongChengJieDaoBanShiChu,620502004,18112,1882,10548,6692,14336,8933,2593,8937,17870,12039,22587
ؽֵ´,XiGuanJieDaoBanShiChu,620502005,32502,3292,19992,12243,27750,16132,4666,16282,32414,20468,40460
ʯƺֵ´,ShiMaPingJieDaoBanShiChu,620502006,36869,3507,22369,13911,30979,18978,5588,19301,38279,23595,45964
ˮֵ´,TianShuiJunJieDaoBanShiChu,620502007,39287,2537,22780,9204,25789,11381,3385,11841,23222,22429,45209
Ȫ,YuQuanZhen,620502100,34779,2367,21337,13425,31717,20616,7226,21914,42530,23035,44372
̫,TaiJingZhen,620502101,18008,1822,11929,6559,23447,11922,4557,12443,24365,12458,24387
,JieKouZhen,620502102,23151,2522,15539,8047,30829,15306,6283,15961,31267,16417,31956
�,ZaoJiaoZhen,620502103,23591,2415,15919,7905,31620,15900,6254,16310,32210,16341,32260
,WangChuanZhen,620502104,21727,2929,15632,7886,31042,15602,7417,16223,31825,16441,32073
ĵ,MuDanZhen,620502105,14190,1793,10572,5313,19720,10523,5121,10357,20880,10532,21104
,GuanZiZhen,620502106,17010,2120,11754,6102,22914,11588,5046,12036,23624,12422,24176
ƽ,PingNanZhen,620502107,25939,2369,18536,8963,35234,18486,7873,17530,36016,17645,36181
ˮ,TianShuiZhen,620502108,17192,2167,12795,6688,23434,12702,5460,11773,24475,12024,24819
,NiangNiangBaZhen,620502109,17034,1893,12130,5600,22969,12023,5117,11559,23582,11914,24044
,ZhongLiangXiang,620502200,9977,1304,6572,3891,13321,6572,2309,7017,13589,7018,13590
,QinLingXiang,620502201,8293,1037,5691,3111,11439,5660,2401,5971,11631,6040,11731
,YangJiaSiXiang,620502202,7850,1082,5647,3049,11027,5586,2578,5697,11283,5863,11510
,QiShouXiang,620502203,9698,1424,8428,4236,14436,8416,3784,6389,14805,6478,14906
,HuaQiXiang,620502204,12804,1603,9239,4643,17721,9079,4066,8916,17995,9234,18473
,DaMenXiang,620502205,12617,1406,9269,4362,17722,9226,4258,8866,18092,9012,18281
ֵ,DaoBeiJieDao,620503001,30271,4299,18850,12622,32991,17116,4531,18040,35156,20251,39101
ֵ,BeiDaoBuJieDao,620503002,29260,2674,16779,9190,20818,11834,3737,11984,23818,18892,35671
Ͻֵ,QiaoNanJieDao,620503003,37305,3472,22169,12764,31231,17133,5933,17539,34672,24541,46710
,SheTangZhen,620503100,23554,2270,14366,8218,26058,13140,3987,13417,26557,15445,29811
Ȫ,MaPaoQuanZhen,620503101,45577,3532,29206,13386,54056,25933,10621,26881,52814,30524,59730
Ȫ,GanQuanZhen,620503102,28800,2253,19142,9873,37916,18970,8055,19490,38460,19966,39108
μ,WeiNanZhen,620503103,22453,3807,16668,9217,32425,16530,6754,16035,32565,16346,33014
,DongChaZhen,620503104,7354,809,4660,2602,9790,4630,1757,5086,9716,5260,9920
ţ,HuaNiuZhen,620503105,43818,4041,27112,13126,50272,23679,9501,24750,48429,30248,57360
̲,ZhongTanZhen,620503106,19060,3188,14208,8433,26941,14117,5565,13388,27505,13605,27813
,XinYangZhen,620503107,19367,2563,13534,7226,27215,13381,5662,13627,27008,14058,27592
Ԫ,YuanLongZhen,620503108,13884,1253,9275,4749,18401,9078,3801,9179,18257,9663,18938
,BoYangZhen,620503109,16285,1484,11002,5154,22170,10837,4700,11181,22018,11467,22469
,MaiJiZhen,620503110,13943,1212,9171,4476,18540,8986,3775,9367,18353,9759,18930
ʯ,ShiFoXiang,620503200,23190,3101,16390,8938,31732,16113,6517,15874,31987,16418,32808
,WuLongXiang,620503201,13099,2037,10444,5594,19828,10383,4899,9328,19711,9591,20035
,HuPoXiang,620503202,7179,1018,5439,2937,10441,5390,2522,5120,10510,5280,10719
,DangChuanXiang,620503203,3409,512,2126,1144,4468,2040,749,2270,4310,2544,4670
,LiQiaoXiang,620503204,3917,463,2401,1180,4723,2306,766,2457,4763,2745,5146
,SanChaXiang,620503205,9833,960,6882,3515,13437,6850,2930,6727,13577,6841,13723
,YongQingZhen,620521100,40686,3071,27027,14930,47122,24867,11838,25972,50839,28568,55595
챤,HongBaoZhen,620521101,14280,1473,10028,5802,19999,9996,5115,10470,20466,10840,20868
,BaiTuoZhen,620521102,10748,1059,7650,3917,15403,7636,3748,7866,15502,7905,15555
,JinJiZhen,620521103,9140,1015,6517,3709,13009,6496,3095,6648,13144,6733,13250
ͤ,QinTingZhen,620521104,9132,845,6871,3438,13195,6809,3501,6442,13251,6607,13478
ɽ,ShanMenZhen,620521105,6686,629,4653,2227,9157,4617,2171,4729,9346,4833,9486
ɳ,BaiShaXiang,620521200,9601,1113,7605,3967,13977,7563,3870,6913,14476,6979,14584
,SongShuXiang,620521201,7560,870,5945,2942,11371,5914,3151,5569,11483,5636,11581
,WangHeXiang,620521202,8419,874,6177,3050,12144,6177,3117,6233,12410,6233,12410
Զ,YuanMenXiang,620521203,6737,798,4853,2425,9780,4824,2295,4869,9693,4977,9830
,TuMenXiang,620521204,9227,1083,6818,3476,13132,6789,3177,6600,13389,6669,13487
,GuoChuanXiang,620521205,10405,1447,7569,4339,15197,7533,3424,7596,15129,7707,15276
ִ,JiaChuanXiang,620521206,7537,810,5263,2788,10534,5245,2240,5282,10527,5324,10587
,FengWangXiang,620521207,5945,574,4195,2154,8242,4177,2021,4200,8377,4345,8540
ݴ,CaoChuanPuXiang,620521208,5817,599,4672,2345,8615,4621,2596,4159,8780,4340,9012
¤,LongDongXiang,620521209,7282,578,5466,2473,10566,5441,2954,5285,10726,5348,10814
,HuangMenXiang,620521210,8132,832,6370,3123,12085,6370,3230,5821,12191,5824,12194
³,XinChengXiang,620521211,7188,605,4918,2332,9973,4858,2568,5027,9885,5443,10361
˹,XingGuoZhen,620522100,69362,6381,46212,24035,75322,41871,19468,43156,85027,48999,95211
,LianHuaZhen,620522101,23275,3151,17362,7989,33751,17283,8021,16876,34159,17085,34447
,XiChuanZhen,620522102,20165,2808,14740,7747,28411,14673,6421,14548,29221,14654,29394
¤,LongChengZhen,620522103,16675,2146,13110,6091,24524,13110,6234,11922,25032,11945,25055
,GuoJiaZhen,620522104,25813,3967,18448,8817,36362,18279,7228,18176,36455,18560,37008
ƺ,LiuPingXiang,620522200,15007,1873,10573,4950,21071,10368,4526,10422,20790,10833,21406
Ӫ,WuYingXiang,620522201,23923,2978,17524,7643,34030,17477,7608,16861,34338,16985,34509
ɽ,ZhongShanXiang,620522202,17324,2542,13969,6765,26844,13932,7281,13081,27013,13178,27147
Ҷ,YeBaoXiang,620522203,20354,3131,15215,7514,29235,15061,6606,14561,29622,14876,30091
,AnFuXiang,620522204,22112,3240,16027,6651,31344,16010,6794,16068,32078,16119,32146
κ,WeiDianXiang,620522205,19229,2769,13212,6430,26241,12437,4898,12612,25049,13684,26896
,WangFuXiang,620522206,15977,2239,11775,5405,22835,11700,5198,11351,23051,11639,23414
ǧ,QianHuXiang,620522207,11831,1793,9512,5026,17884,9482,4877,8885,18367,8989,18501
Ҥ,WangYaoXiang,620522208,11828,1867,8925,4443,17527,8857,4230,8794,17651,9000,17925
ɽ,YunShanXiang,620522209,11179,1226,8188,3804,15879,8104,3815,7797,15901,8032,16220
,WangYinXiang,620522210,14472,2148,11506,5779,21815,11486,5511,10554,22040,10625,22131
˷,XingFengXiang,620522211,15523,2185,12283,6137,23606,12245,6214,11544,23789,11639,23922
ɽ,DaXiangShanZhen,620523100,75329,7901,50382,28368,94910,49120,20359,49286,98406,53207,103589
Ͱ,PanAnZhen,620523101,49134,5133,35151,15391,68780,35125,15805,34835,69960,34921,70072
,XinXingZhen,620523102,67769,8154,49858,23026,92489,48573,21560,45759,94332,47625,97483
Զ,AnYuanZhen,620523103,27630,3413,21271,8916,40400,20919,9785,18252,39171,19557,40828
,LiuFengZhen,620523104,25206,2995,19239,9190,35728,19184,8517,17411,36595,17479,36718
ɽ,JinShanXiang,620523203,25408,3285,19674,8646,37369,19674,9034,18053,37727,18053,37727
,BaLiWanXiang,620523204,21883,2470,15967,6788,31558,15967,7503,15887,31854,15889,31856
ƺ,XiPingXiang,620523205,9783,1444,8110,3486,14990,8110,3938,7055,15165,7055,15165
ׯ,DaZhuangXiang,620523206,10324,1219,8436,3569,15997,8436,4613,7720,16156,7720,16156
ʯ,DaShiXiang,620523208,19157,2376,14026,6035,27165,13948,5941,13253,27201,13448,27474
,LiXinXiang,620523209,11195,1477,8757,3975,16579,8757,4081,7996,16753,7996,16753
л,XieJiaWanXiang,620523211,14967,2116,11151,4613,21547,11131,4983,10771,21902,10915,22066
Һ,WuJiaHeXiang,620523213,9761,1034,7605,3333,14312,7584,3884,6998,14582,7074,14679
,GuPoXiang,620523214,5768,614,4413,2120,8327,4412,2279,4234,8646,4248,8661
׼,BaiJiaWanXiang,620523215,13667,1476,10463,4528,20250,10463,5343,10022,20485,10023,20486
ǹ,ChengGuanZhen,620524100,52445,4268,31138,21218,63006,29523,11930,34323,63846,37505,68643
,LuoMenZhen,620524101,68004,5747,42490,22934,89350,40140,16247,43869,84009,47508,89998
ԧ,YuanYangZhen,620524102,18118,2067,13190,6016,25454,13146,6167,13081,26227,13162,26352
̲,TanGeZhen,620524103,25494,2644,18040,8552,36192,18034,8936,19022,37056,19034,37074
,SiMenZhen,620524104,18611,2168,13501,6303,26631,13501,6389,13664,27165,13667,27168
,MaLiZhen,620524105,29489,2857,20544,8940,41526,20442,9914,21348,41790,21716,42260
ɽ,ShanDanXiang,620524200,17323,1796,11742,6505,23750,11738,5116,12485,24223,12493,24235
,YuPanXiang,620524201,9713,1089,7011,3279,13931,6988,3425,7146,14134,7216,14227
ͷ,JuTouXiang,620524202,11137,1340,8159,3730,16122,8127,3913,8150,16277,8231,16390
,HuaLinXiang,620524203,10683,1436,8161,3503,15871,8161,3984,7942,16103,7942,16103
¥,GaoLouXiang,620524204,11502,1545,9192,3957,17855,9189,5123,8966,18155,8978,18170
,YangHeXiang,620524205,8290,1198,7212,3626,12892,7175,3912,6088,13263,6188,13400
ذ,YanAnXiang,620524206,9135,943,7091,3346,13592,7067,3793,6698,13765,6780,13871
Ȫ,WenQuanXiang,620524207,12647,1438,8838,4107,18037,8713,4229,9161,17874,9476,18314
̨,LongTaiXiang,620524208,6859,965,5638,2740,10763,5637,3239,5419,11056,5425,11063
żҴ,ZhangJiaChuanZhen,620525100,43486,4190,30554,13804,56501,28886,14821,29190,58076,31943,62497
ɽ,LongShanZhen,620525101,27637,2395,18327,7323,34344,16884,7944,16407,33291,19649,37976
,GongMenZhen,620525102,15607,1611,11585,5200,22431,11469,5882,11091,22560,11515,23100
,LiuBaoXiang,620525201,8046,946,6333,2835,12390,6321,3589,6068,12389,6248,12581
,ZhangMianXiang,620525202,6144,613,4668,2058,9172,4627,2622,4495,9122,4711,9379
,HuChuanXiang,620525203,9590,1026,7551,2990,14942,7551,4377,7402,14953,7442,14993
ľ,MuHeXiang,620525204,10910,1266,8493,3287,16347,8405,4416,7803,16208,8099,16592
,DaYangXiang,620525206,14533,1585,11328,4629,21669,11257,5728,10307,21564,10518,21846
,ChuanWangXiang,620525207,8188,959,6240,2615,12107,6180,3372,6084,12264,6279,12519
,MaGuanXiang,620525208,14696,1575,11378,4782,21731,11308,5761,10437,21745,10654,22032
,LianWuXiang,620525209,7896,1061,6411,2685,11903,6371,3304,5665,12036,5850,12261
ɽ,LiangShanXiang,620525210,8185,1024,6661,2853,12553,6638,3685,6091,12729,6233,12894
ƽ,PingAnXiang,620525213,4883,468,3617,1600,7058,3599,1795,3466,7065,3529,7146
ּ,YanJiaXiang,620525214,5556,692,4146,1875,8040,4117,2077,3986,8103,4179,8325
¹,MaLuXiang,620525215,7970,806,5965,2640,11722,5875,3146,5697,11572,5957,11922
ֵֽ´,DongDaJieJieDaoBanShiChu,620602001,38450,3739,23445,17729,41958,22850,7748,23623,46473,26492,49937
ֵֽ´,XiDaJieJieDaoBanShiChu,620602002,52465,4892,31283,21198,47627,28718,8683,29480,58198,34757,66040
ؽֵֽ´,DongGuanJieJieDaoBanShiChu,620602003,18748,1384,12883,7138,15433,9785,3939,10300,20085,11188,24071
ؽֵֽ´,XiGuanJieJieDaoBanShiChu,620602004,27591,2274,17199,11002,26411,14427,5273,15018,29445,17939,35138
վֵֽ´,HuoCheZhanJieJieDaoBanShiChu,620602005,16697,1386,10278,7310,14780,9928,3339,10247,20175,11144,21422
´ֵֽ´,DiZhiXinCunJieJieDaoBanShiChu,620602006,2202,590,1636,1404,2898,1624,438,1589,3213,1594,3230
ٻֵֽ´,RongHuaJieJieDaoBanShiChu,620602007,7122,336,4564,2751,8606,4502,2361,4988,9490,5255,9819
,HuangYangZhen,620602100,49552,4042,29765,14591,55741,27135,10113,28815,55950,33942,63707
,WuNanZhen,620602101,39286,4708,25025,15388,48231,24673,7031,25434,50107,26000,51025
Դ,QingYuanZhen,620602102,18277,1917,11402,5411,23284,11317,3679,12091,23408,12471,23873
,YongChangZhen,620602103,32800,2828,20973,10008,43058,20973,7799,22434,43407,22454,43427
˫,ShuangChengZhen,620602104,26455,2534,16745,7797,33227,16408,5287,17203,33611,17531,34276
,FengLeZhen,620602105,13431,1003,8041,4024,16390,7799,2918,8484,16283,9311,17352
߰,GaoBaZhen,620602106,40143,3656,26324,12955,51089,25696,9873,26858,52554,27348,53672
,JinYangZhen,620602107,32247,2479,20688,11229,38251,20258,7496,20687,40945,21534,42222
ƽ,HePingZhen,620602108,18501,1715,11769,4329,16922,8900,3801,9006,17906,12248,24017
°,YangXiaBaZhen,620602109,12134,1242,7910,4158,15716,7901,2741,8146,16047,8207,16117
а,ZhongBaZhen,620602110,12477,1113,8091,3972,16269,8091,2856,8355,16446,8355,16446
,YongFengZhen,620602111,8073,544,4988,2611,10035,4886,1709,5101,9987,5338,10326
ų,GuChengZhen,620602112,18647,1895,11994,5793,23935,11994,4135,12683,24677,12683,24677
,ZhangYiZhen,620602113,28064,3261,18769,8760,37940,18475,6939,19077,37552,19495,38264
,FaFangZhen,620602114,18272,1899,11821,6580,24030,11818,4182,12473,24291,12532,24353
Ӫ,XiYingZhen,620602115,18415,1564,11529,5839,23185,11476,4163,12142,23618,12613,24142
İ,SiBaZhen,620602116,10430,1007,6576,3268,13220,6575,1952,6811,13386,6813,13389
,HongXiangZhen,620602117,14631,1384,9305,5285,18929,9295,3234,9885,19180,9944,19249
л,XieHeZhen,620602118,15981,1422,10071,4731,20039,9889,3704,10709,20598,11036,21107
,WuHeXiang,620602200,8811,690,5483,2807,11151,5483,1852,5870,11353,5870,11353
,HanZuoXiang,620602201,7270,676,4805,2230,9415,4803,1773,4913,9716,4914,9719
,SongShuXiang,620602202,10668,1014,6846,3400,13890,6842,2616,7449,14291,7452,14298
,DaLiuXiang,620602203,10237,952,6658,3054,13383,6658,2367,6898,13556,6898,13556
,ChangChengXiang,620602204,11740,1240,7496,3736,15000,7490,2612,8026,15516,8096,15592
ɳ,JinShaXiang,620602205,10488,821,6759,3126,13468,6759,2520,7055,13814,7070,13829
,BaiShuXiang,620602206,12066,1088,7772,3806,15446,7760,2833,8143,15903,8215,15987
,JinTaXiang,620602207,10797,1111,7220,3291,14530,7218,2922,7585,14803,7610,14830
˫,XiaShuangXiang,620602208,8325,1004,5442,2820,10669,5440,1767,5649,11089,5654,11096
Ŷ,JiuDunXiang,620602209,6265,661,3960,1885,8109,3945,1227,4083,8028,4193,8153
,HuaiAnXiang,620602210,10374,815,6604,3379,13159,6539,2439,6914,13453,7024,13628
ɽ,JinShanXiang,620602211,4199,415,2759,1595,5459,2747,1031,2868,5615,2886,5645
ˮ,QingShuiXiang,620602212,14341,1552,9157,4884,18646,9157,2967,9703,18860,9703,18860
Ҿ,WuJiaJingXiang,620602213,4801,492,3333,1652,6600,3333,1555,3515,6848,3515,6848
»,XinHuaXiang,620602214,13758,1451,9093,4042,18434,9091,3589,9693,18784,9705,18798
,KangNingXiang,620602215,7531,858,5042,2630,9995,5042,1911,5258,10300,5258,10300
,DongHeXiang,620602216,10081,879,6391,3108,12901,6391,2162,6731,13122,6731,13122
Ӷ,HeDongXiang,620602217,12001,1082,7627,3755,15393,7627,2584,8040,15667,8040,15667
Ŷָ̲Ӳ,JiuDunTanZhiHuiBu,620602400,5646,552,3727,1663,7560,3727,1518,3989,7716,3989,7716
,SanLeiZhen,620621100,33983,3472,22584,15224,36961,22414,8759,23375,45789,23630,46214
,DongBaZhen,620621101,8822,1193,5701,2914,10514,5272,1765,5415,10687,6079,11780
Ȫɽ,QuanShanZhen,620621102,9118,1315,5996,3527,11875,5931,1741,6021,11952,6178,12174
,XiQuZhen,620621103,15864,2426,10831,6381,21334,10712,3574,10742,21454,11033,21864
,DongHuZhen,620621104,9085,1551,6159,3501,12347,6142,1842,6243,12385,6319,12478
ɳ,HongShaGangZhen,620621105,1319,37,309,139,494,239,93,238,477,1140,1449
,ChangNingXiang,620621200,6484,694,4317,2364,8335,4296,1601,4436,8732,4462,8779
,CaiQiXiang,620621201,6257,776,4107,2353,8353,4077,1485,4362,8439,4411,8518
,ZhongXingXiang,620621202,5642,819,3692,2014,7354,3659,1084,3812,7471,3853,7545
Ѧ,XueBaiXiang,620621203,10547,1446,6943,3887,13950,6940,2279,7273,14213,7329,14272
,DaBaXiang,620621204,10922,1401,7180,4258,14156,7158,2318,7346,14504,7461,14641
,SuWuXiang,620621205,21174,2540,13674,7574,26795,13638,4649,14531,28169,14689,28363
к,JiaHeXiang,620621206,5849,790,4002,2109,7824,3983,1452,4020,8003,4089,8091
̲,DaTanXiang,620621207,7965,1090,5339,2977,10705,5269,1836,5441,10710,5552,10891
˫Ŀ,ShuangCiKeXiang,620621208,8355,1151,5601,3101,11205,5566,1899,5716,11282,5804,11405
ɳ,HongShaLiangXiang,620621209,6093,1004,4080,2387,8028,4034,1168,4087,8121,4185,8265
ճ,ShouChengXiang,620621210,9448,1403,6170,3547,12483,6140,1722,6277,12417,6403,12573
Ϻ,NanHuXiang,620621211,1445,143,931,622,1733,924,361,1005,1929,1018,1949
ǹؽֵ´,ChengGuanJieDaoBanShiChu,620622001,14886,1176,9175,6465,16043,8727,3534,9826,18553,10421,19596
,GuLangZhen,620622100,13533,1229,8677,3979,17962,8661,3450,9356,18017,9535,18212
ˮ,SiShuiZhen,620622101,16376,1516,10812,4753,22086,10660,4353,11031,21691,11433,22245
,TuMenZhen,620622102,29120,2811,18982,8437,38806,18433,7330,19019,37452,20279,39261
,DaJingZhen,620622103,29126,2689,20150,10336,40347,20112,8719,20330,40442,20384,40534
Ӫ,PeiJiaYingZhen,620622104,14821,1278,9769,4292,19568,9530,3869,9541,19071,10199,19968
̲,HaiZiTanZhen,620622105,20684,1591,13839,6137,27832,13791,5587,13919,27710,14023,27862
,DingNingZhen,620622106,17687,1749,11664,4852,23939,11664,4628,12400,24064,12400,24064
,HuangYangChuanZhen,620622107,18770,1946,12362,5823,25287,12229,4766,12757,24986,13120,25482
,HeiSongYiZhen,620622108,15725,1453,10367,4722,21161,10296,4218,10889,21185,11029,21396
̲,YongFengTanXiang,620622200,7996,689,5354,2114,10642,5293,2172,5260,10553,5503,10857
ƻ̲,HuangHuaTanXiang,620622201,12547,1098,8624,3829,16265,8563,3868,8725,17288,8889,17513
,XiJingXiang,620622202,3570,342,2405,1193,4853,2405,1007,2513,4918,2514,4919
Ȩ,MinQuanXiang,620622203,12638,1333,8808,4029,17017,8697,3692,8548,17245,8855,17663
ֱ̲,ZhiTanXiang,620622204,11738,1069,7921,3521,15731,7850,3314,8059,15909,8200,16121
±,XinBaoXiang,620622205,6003,656,3934,1926,8138,3933,1506,4203,8136,4231,8165
ɳ,GanChengXiang,620622206,9658,1140,6676,3353,13390,6674,2681,6795,13469,6803,13479
,HengLiangXiang,620622207,9921,1109,6890,3168,13537,6854,2777,6842,13696,6917,13807
ʮﱤ,ShiBaLiBaoXiang,620622208,7020,738,4812,1845,9512,4792,1861,4771,9563,4807,9619
ŷ,GuFengXiang,620622209,13206,1308,8752,3877,17753,8747,3443,9025,17772,9205,17957
,HuaCangSiZhen,620623100,40085,3102,25655,14599,37186,23607,8416,23474,47081,25948,51603
,DaChaiGouZhen,620623101,9566,840,6261,3324,12176,6212,2230,6255,12467,6375,12636
Զ,AnYuanZhen,620623102,5776,622,3785,2071,7593,3752,1402,3942,7694,4015,7800
̿ɽ,TanShanLingZhen,620623103,5659,392,3262,1833,6128,3231,1100,3269,6500,3889,7151
Ϫ,HaXiZhen,620623104,13451,1441,8543,4671,17248,8216,2944,8829,17045,9293,17836
ʲ˹,SaiShenSiZhen,620623105,7276,768,4748,2797,9433,4727,1772,4906,9633,5068,9816
ʯ,ShiMenZhen,620623106,4878,443,2891,1213,4242,2062,860,2200,4262,3290,6181
ɽ,SongShanZhen,620623107,5547,694,3666,2230,7310,3663,1195,3757,7420,3770,7436
,TianTangZhen,620623108,7446,607,4570,2426,9493,4569,1569,4992,9561,5052,9622
ƺ,DongPingXiang,620623201,2191,254,1449,826,2764,1445,511,1500,2945,1507,2956
¡,SaiLaLongXiang,620623202,157,18,98,47,185,98,32,107,205,109,207
̲,DongDaTanXiang,620623203,1286,182,900,550,1757,900,324,892,1792,892,1792
ץϲ,ZhuaXiXiuLongXiang,620623204,2536,227,1585,886,3014,1565,489,1520,3085,1667,3252
̲,XiDaTanXiang,620623205,5595,568,3726,1879,7408,3726,1487,3924,7650,3924,7650
ʲ,DuoShenXiang,620623206,6243,757,4284,2378,8416,4247,1643,4282,8529,4359,8643
칵,DaHongGouXiang,620623207,4964,564,3225,1737,6562,3216,1145,3390,6606,3448,6673
ë,MaoCangXiang,620623208,710,97,463,240,954,442,164,484,926,508,971
,QiLianXiang,620623209,2788,370,1916,954,3799,1887,732,1860,3747,1974,3890
,DanMaXiang,620623210,1882,252,1290,703,2566,1235,483,1255,2490,1327,2617
ףú繫˾,TianZhuMeiDianGongSi,620623400,3269,198,1933,1600,3487,1932,711,2120,4052,2245,4178
ףĳ,TianZhuJianCaiChang,620623401,1664,96,485,422,1016,485,123,498,983,1398,1883
ֵֽ,DongJieJieDao,620702001,29968,2424,18740,13894,21917,17973,5939,18272,36245,19591,38331
Ͻֵֽ,NanJieJieDao,620702002,33817,3663,22300,13269,26532,16651,5140,16487,33138,20320,42620
ֵֽ,XiJieJieDao,620702003,37130,3318,23697,14164,31283,18669,6231,18405,37074,22982,46679
ֵֽ,BeiJieJieDao,620702004,18517,1631,11943,8505,14565,11183,3632,10908,22091,11837,23780
վֵ,HuoCheZhanJieDao,620702005,16038,2074,10436,7344,13401,9065,2945,9122,18187,10621,21057
Ҷ,LiangJiaDunZhen,620702100,13473,1020,8431,4851,16222,8121,3077,8801,16922,9139,17570
,ShangQinZhen,620702101,17613,1622,11131,6231,21902,10832,3903,11571,22403,12007,23138
,DaManZhen,620702102,22577,2149,14255,8080,28765,14029,4763,14889,28918,15234,29489
ɳ,ShaJingZhen,620702103,26082,2129,16546,9297,33270,16158,6182,17220,33378,17847,34393
ڽ,WuJiangZhen,620702104,18262,1762,11670,7199,22691,11242,4255,12127,23369,12609,24279
ʿ,GanXunZhen,620702105,16233,1461,10489,5927,20530,10179,3804,10657,20836,11009,21498
¶,XinDunZhen,620702106,19944,1561,12826,7777,23076,12526,4647,12964,25490,13326,26152
կ,DangZhaiZhen,620702107,20659,1871,13032,8187,25893,12749,4657,13772,26521,14155,27187
̲,JianTanZhen,620702108,13200,1309,8487,5153,17247,8473,3049,9003,17476,9071,17558
բ,SanZhaZhen,620702109,13198,1225,8518,4351,16769,8142,3183,8676,16818,9088,17606
С,XiaoManZhen,620702110,16017,1393,10007,5971,19964,9742,3343,10427,20169,10746,20753
,LongQuXiang,620702202,6737,831,4382,2922,8940,4382,1495,4679,9061,4681,9063
,AnYangXiang,620702203,10673,959,6790,3451,14097,6732,2604,7252,13984,7446,14236
կ,HuaZhaiXiang,620702204,5065,573,3321,1873,6691,3268,1208,3415,6683,3525,6846
,ChangAnXiang,620702205,15052,1299,9456,5792,17484,9157,3401,9916,19073,10296,19752
,JingAnXiang,620702207,4560,506,3015,1762,6106,3015,1131,3182,6197,3182,6197
,MingYongXiang,620702210,8914,700,5612,3537,11416,5545,2067,5971,11516,6069,11681
ƽɽ,PingShanHuXiang,620702211,517,42,229,201,416,205,45,240,445,375,604
ӪҴũ,GuoYingZhangYeNongChang,620702400,2480,283,1631,1094,2685,1629,456,1584,3213,1588,3219
ʡũԺҴŹ鳡,ShengNongKeYuanZhangYeJiuGongLiShiYanChang,620702401,254,21,141,150,256,141,29,163,304,163,304
Ҵҵ԰,ZhangYeGongYeYuanQu,620702402,2654,173,1644,1187,2193,1641,614,1789,3430,1797,3441
,HongWanSiZhen,620721100,6286,630,4074,2820,5417,3387,1209,3166,6553,4051,8125
ʳ,HuangChengZhen,620721101,5174,459,3313,2010,6423,3180,1369,3309,6489,3689,7002
,MaTiZangZuXiang,620721200,3050,231,1810,1058,3372,1653,671,1697,3350,2142,3952
,KangLeXiang,620721201,2415,207,1451,970,2694,1389,424,1445,2834,1595,3046
ɹ,BaiYinMengGuZuXiang,620721202,443,30,268,174,440,241,92,253,494,297,565
,DaHeXiang,620721203,2790,205,1546,1171,2807,1471,414,1500,2971,1863,3409
,MingHuaXiang,620721204,2906,223,1710,1165,2618,1584,517,1722,3306,1936,3646
i,QiFengZangZuXiang,620721205,2721,198,1273,839,2186,1115,356,1175,2290,2002,3275
ʡƹվ,GanSuShengMianYangYuZhongTuiGuangZhan,620721400,369,57,230,227,457,230,69,260,490,265,495
Ҵƿ,ZhangYeBaoPingHeMuChang,620721401,115,3,66,40,0,62,20,57,119,72,138
ˮ,HongShuiZhen,620722101,45195,3319,28675,16802,47945,26310,11145,27115,53425,30984,59659
,LiuBaZhen,620722102,14108,1389,9424,5522,18760,9347,3960,9809,19156,10033,19457
,XinTianZhen,620722103,16167,1872,10978,6210,22059,10738,4821,11355,22093,11882,22860
Ϲ,NanGuZhen,620722104,16272,1679,10971,6013,21906,10861,4632,11253,22114,11612,22583
,YongGuZhen,620722105,10697,960,6954,4069,14308,6903,2726,7197,14100,7429,14383
,SanBaoZhen,620722106,11238,1042,7300,3767,14725,7116,2935,7507,14623,7915,15215
Ϸ,NanFengXiang,620722200,12715,1131,8401,4784,17002,8225,3370,8290,16515,8815,17216
,MinLianXiang,620722201,14621,1285,9422,5033,19393,9325,3812,9882,19207,10296,19718
˳,ShunHuaXiang,620722203,9586,1052,6609,3886,13138,6535,2935,6756,13291,6964,13573
,FengLeXiang,620722204,9222,983,6384,3852,12623,6315,2802,6438,12753,6623,13007
ʵü�,GaoXinShiYongJiShuKaiFaQu,620722400,1668,7,383,4,4,4,10,5,9,1302,1685
ɳ,ShaHeZhen,620723101,32340,2655,20431,12590,37092,18301,7159,18655,36956,21723,42154
»,XinHuaZhen,620723102,11447,1054,7409,4672,14147,7324,2637,7524,14848,7729,15138
ޤȪ,LiaoQuanZhen,620723103,11448,1141,7522,4582,14290,7289,2596,7309,14598,7663,15185
ƽ,PingChuanZhen,620723104,12964,1478,8671,5281,16090,8351,2859,8192,16543,8630,17301
,BanQiaoZhen,620723105,11688,1291,7589,4516,14642,7418,2380,7511,14929,7770,15359
Ѽů,YaNuanXiang,620723201,13863,1374,8984,5284,17158,8712,3055,8940,17652,9308,18292
߼Ӫ,NiJiaYingXiang,620723202,7053,583,4421,2529,8458,4251,1492,4389,8640,4707,9128
Ӫũ,GuoYingLinZeNongChang,620723400,1233,69,752,599,1008,750,212,762,1512,762,1514
Ȫֳ,WuQuanLinChang,620723401,50,1,15,45,22,15,1,37,52,37,52
ɳֳ,ShaHeLinChang,620723402,1,0,0,1,1,0,0,1,1,1,1
СȪɳվ,XiaoQuanZiZhiShaZhan,620723403,18,0,8,4,1,8,5,11,19,15,23
԰ճ,YuanYiChang,620723404,101,4,61,45,116,61,24,68,129,68,129
ֳַ,LiangZhongFanZhiChang,620723405,36,7,24,20,47,24,9,28,52,28,52
ǹ,ChengGuanZhen,620724100,21603,1957,14274,10223,20328,13655,4822,13362,27017,14108,28382
,XuanHuaZhen,620724101,10775,1160,7081,4537,14072,7081,2341,7180,14261,7195,14276
ϻ,NanHuaZhen,620724102,12973,1042,7970,5051,14485,7851,2739,8013,15864,8784,16754
,HangDaoXiang,620724200,18147,1748,11670,7002,22847,11557,3759,11741,23298,11984,23654
Ȫ,HeiQuanXiang,620724201,9286,974,6061,4163,11862,6060,1931,6127,12187,6130,12191
޳,LuoChengXiang,620724202,7572,951,4989,3481,9576,4848,1478,4776,9624,5012,10001
,HeLiXiang,620724203,6527,730,4269,3060,8409,4268,1352,4321,8589,4340,8609
ճ,LuoTuoChengXiang,620724204,10035,718,6151,3668,10912,6148,1892,6476,12624,6494,12645
°,XinBaXiang,620724205,12978,1492,8371,5070,16504,8354,2464,8474,16828,8563,16934
Ȫ,QingQuanZhen,620725101,52172,4641,34611,20886,51404,31774,13089,31935,63709,35291,69902
λ,WeiQiZhen,620725102,12538,1406,8629,5293,16701,8553,3459,8426,16979,8774,17403
,HuoChengZhen,620725103,8085,1220,5977,3562,11727,5921,2556,5700,11621,5884,11861
,DongLeXiang,620725200,7856,771,5512,3267,10495,5480,2400,5439,10919,5515,11027
Ӫ,DaMaYingXiang,620725201,8198,1175,5818,3663,11406,5692,2178,5461,11153,5733,11551
»,ChenHuXiang,620725202,12286,1311,8756,5084,16783,8619,3584,8235,16854,8425,17181
Ͼ,LaoJunXiang,620725203,3293,380,2209,1429,4189,2189,800,2070,4259,2264,4473
,LiQiaoXiang,620725204,3859,617,2883,1943,5574,2880,1195,2782,5662,2788,5671
Ӫɽũ,GuoYingShanDanNongChang,620725400,764,135,507,384,930,506,128,520,1026,520,1027
˾ɽ�,ZhongMuGongSiShanDanMaChang,620725402,8817,936,5325,4709,10271,5238,1450,5253,10491,5878,11203
ؽֵ,DongGuanJieDao,620802001,51577,3914,33686,17816,52922,25276,8681,26240,51516,30486,64172
нֵֽ,ZhongJieJieDao,620802002,48045,4235,26743,16812,46894,24192,8187,24020,48212,33724,60467
�ֵ,XiJiaoJieDao,620802003,49211,6473,32606,22977,57121,31226,9389,31291,62517,32467,65073
ʮ,SiShiLiPuZhen,620802100,33597,4499,22840,11699,43960,22524,8611,23106,45630,23867,46707
,KongTongZhen,620802101,13838,1850,9399,4434,18324,9281,3674,9733,19014,9963,19362
ˮ,BaiShuiZhen,620802102,19717,2533,13652,6512,26823,13541,5095,13457,26998,13693,27345
ݷ,CaoFengZhen,620802103,23125,2739,15373,7180,30880,15201,5295,15355,30556,15786,31159
,AnGuoXiang,620802200,8964,1257,6468,3208,12580,6437,2846,6520,12957,6599,13067
,LiuHuXiang,620802201,34505,3284,23263,12431,41912,23024,9653,23761,46785,24179,47442
,HuaSuoXiang,620802202,10087,1683,7457,4018,14260,7152,2840,6691,13843,7153,14610
,SuoLuoXiang,620802203,8232,1247,5872,2822,11524,5821,2325,5809,11630,5932,11804
,XiangLianXiang,620802204,5091,786,3309,1558,6658,3301,983,3510,6811,3551,6860
,XiYangXiang,620802205,8258,935,5894,2778,11765,5871,2885,6074,11945,6184,12078
,DaQinXiang,620802206,7267,888,5057,2405,10240,4992,2328,5243,10235,5426,10483
,BaiMiaoXiang,620802207,9378,968,6503,2767,12830,6457,3010,6726,13183,6853,13356
կ,ZhaiHeXiang,620802208,8968,1162,6305,2749,12878,6299,2958,6744,13043,6783,13088
կ,DaZhaiXiang,620802209,12769,1786,8591,4528,17108,8561,3589,9347,17908,9553,18144
,ShangYangXiang,620802210,5614,591,3644,1601,7576,3614,1644,4130,7744,4205,7849
,MaWuXiang,620802211,3522,460,2215,1204,4576,2212,686,2438,4650,2453,4668
Ͽ,XiaMenXiang,620802212,12090,1562,8158,3831,16195,8073,3462,8651,16724,8956,17114
ֵ´,JieDaoBanShiChu,620821001,24433,1912,14642,8563,20483,11280,5004,12150,23430,16707,31349
ǹ,ChengGuanZhen,620821100,15741,2050,11409,5960,22181,11409,4944,11326,22735,11326,22735
,YuDouZhen,620821101,13618,2176,10739,6063,19371,10064,4575,8751,18815,9630,20369
ƽ,GaoPingZhen,620821102,19831,3159,14553,8154,28032,14025,5892,13426,27451,14329,28882
,LiBaoZhen,620821103,16966,2532,12897,6956,24533,12538,5681,11671,24209,12282,25179
,WangCunZhen,620821104,15491,2219,11601,5920,22104,11424,4984,10832,22256,11093,22694
Ҥ,YaoDianZhen,620821105,9437,1447,6670,3764,13125,6453,2563,6305,12758,6777,13447
I,RuiFengXiang,620821200,4887,788,3702,2105,7033,3641,1647,3533,7174,3620,7322
޺,LuoHanDongXiang,620821201,6954,1273,5755,3415,10375,5641,2638,4894,10535,5110,10865
,JingMingXiang,620821202,5790,1209,4600,2955,8588,4550,1960,4238,8788,4359,8959
,HongHeXiang,620821203,3919,848,3019,1831,5855,3003,1254,2936,5939,3002,6021
,FeiYunXiang,620821204,8578,1532,6598,4009,12523,6518,2658,5985,12503,6170,12768
̫ƽ,TaiPingXiang,620821205,9679,1403,6583,3528,13294,6511,2528,6861,13372,7027,13610
̨,FengTaiXiang,620821206,15145,2090,11238,5940,21666,11013,4883,10353,21366,10880,22118
ԭ,DangYuanXiang,620821207,19303,2755,14580,7835,27556,14457,6161,13397,27854,13639,28219
Ȫÿ,WenQuanJingJiKaiFaQu,620821400,3508,395,2395,1138,4008,2053,928,2060,4113,2436,4831
ũ,ZhangLaoSiNongChang,620821500,1230,192,848,491,1751,848,355,929,1777,929,1777
ֵ´,JieDaoBanShiChu,620822001,12911,717,7730,5074,9656,6649,2802,7190,13839,8700,16430
̨,ZhongTaiZhen,620822100,8759,1097,5895,3587,11197,5866,2292,6184,12050,6253,12148
կ,ShaoZhaiZhen,620822101,8309,1264,5958,3892,11565,5877,2423,5794,11671,6038,11996
,DuDianZhen,620822102,17979,2818,13175,8374,25070,12996,5336,12584,25580,12958,26133
ʲ,ShenZiZhen,620822103,17405,2490,12803,7809,23956,12417,5288,11880,24297,12380,25183
,ZhuNaZhen,620822104,11900,1237,7912,4549,14828,7490,2974,7539,15029,8199,16111
¿,XinKaiXiang,620822201,4951,775,3468,2487,6591,3434,1203,3417,6851,3461,6929
,XiTunXiang,620822202,9305,1442,6799,4381,12769,6705,2612,6402,13107,6560,13359
,ShangLiangXiang,620822203,7911,1126,5800,3545,10917,5720,2369,5417,11137,5606,11406
ԭ,LiangYuanXiang,620822204,10453,1233,7271,3847,13959,7149,2830,6979,14128,7245,14516
,LongMenXiang,620822205,2587,350,1679,1112,3214,1650,559,1687,3337,1817,3496
ǻ,XingHuoXiang,620822206,6729,882,4710,2802,9054,4633,1704,4433,9066,4605,9315
,BaiLiXiang,620822207,6055,877,3758,2472,7564,3637,1218,4047,7684,4392,8150
,PuWoXiang,620822208,5924,909,4097,2682,8006,4015,1438,3995,8010,4174,8271
򱦴ũ,WanBaoChuanNongChang,620822400,375,57,230,219,417,227,62,259,486,264,494
ֵ,JinPingJieDaoBan,620823001,12960,905,8282,4517,13917,6800,2812,6822,13622,8395,16677
,JinPingZhen,620823100,20341,2159,13049,6690,26317,12887,4734,13357,26244,14185,27234
Ҥ,XinYaoZhen,620823101,7532,669,4801,2563,9704,4754,1713,4997,9751,5113,9914
,BaiShuXiang,620823200,9666,1066,6592,3272,13070,6502,2473,6424,12926,6613,13205
կ,HuangZhaiXiang,620823201,7251,831,4889,2342,9791,4873,1789,4953,9826,4982,9871
ƻ,HuangHuaXiang,620823202,5568,568,3544,1724,7003,3488,1192,3552,7040,3784,7328
ľ,MuLinXiang,620823203,6602,655,4364,2225,8628,4297,1642,4378,8675,4535,8899
Ҥֵ,XinYaoJieDaoBan,620823400,7601,90,2263,1468,3687,1774,615,2155,3929,6043,8306
ũ,WuJuNongChang,620823401,497,69,328,271,634,328,116,354,682,354,682
ֵ´,DongHuaJieDaoBanShiChu,620824001,32491,1625,19118,10568,27543,14794,6381,15525,30319,21379,40497
,DongHuaZhen,620824100,21000,1659,13083,7744,21690,13037,5609,13886,26923,15185,28268
,AnKouZhen,620824101,23132,2560,14406,9835,28752,13799,4529,15146,28945,15815,30221
,XiHuaZhen,620824102,17012,1910,11167,5982,21463,11036,4371,11389,22425,12126,23293
Ͽ,MaXiaZhen,620824103,7987,937,5184,3063,10608,5145,1865,5514,10659,5605,10789
ߵ,CeDiZhen,620824104,8053,680,4733,2460,8377,4469,1717,4548,9017,5717,10450
Ϲ,ShangGuanXiang,620824200,6329,815,4479,2392,8661,4459,1732,4320,8779,4397,8876
,ShenYuXiang,620824201,7461,830,4978,2766,9748,4868,1970,5081,9949,5283,10261
ɽկ,ShanZhaiXiang,620824202,8893,993,6156,2959,12261,6082,2574,6142,12224,6304,12460
,HeXiXiang,620824203,4347,691,3192,1740,5933,3164,1194,2956,6120,3040,6232
Ͽ,YanXiaXiang,620824204,3215,222,1520,812,2791,1414,536,1536,2950,2453,3973
ʯӿί,ShiBuZiKaiFaQuGuanWeiHui,620824400,3137,307,1720,1130,3420,1632,569,1789,3421,2293,4013
ˮֵ´,ShuiLuoJieDaoBanShiChu,620825001,20277,982,11865,6627,13325,9365,4785,10601,19966,14179,26044
ˮ,ShuiLuoZhen,620825100,24079,2489,16945,7787,33558,16922,7205,16809,33731,16828,33773
Ϻ,NanHuZhen,620825101,15727,2109,11541,5803,19946,10678,4630,9680,20358,10925,22466
,ZhuDianZhen,620825102,22593,2822,17039,7507,31740,16550,7367,15066,31616,15743,32782
Ȫ,WanQuanZhen,620825103,17375,2494,12652,5741,24816,12559,5038,11985,24544,12255,24907
,HanDianZhen,620825104,13318,1445,9701,4565,18576,9378,4338,8800,18178,9400,19101
,YueBaoXiang,620825200,10505,1308,7424,3580,14455,7380,2902,7041,14421,7291,14715
,YangHeXiang,620825201,7801,1253,6081,3022,11366,6040,2567,5434,11474,5540,11621
Զ,ZhaoDunXiang,620825202,10233,1512,7334,3632,14553,7276,2946,7063,14339,7357,14691
,LiuLiangXiang,620825203,13175,1824,10504,4966,19222,10314,4583,8648,18962,9078,19582
,WoLongXiang,620825205,17825,2326,13284,6545,25034,13185,5508,12106,25291,12375,25659
ׯ,DaZhuangXiang,620825207,11169,1722,8912,3963,16466,8820,3697,7312,16132,7676,16588
,YangChuanXiang,620825208,15884,2278,11712,5074,22753,11295,4988,10542,21837,11438,23150
,LiangYiXiang,620825211,10944,1347,9090,4083,16222,8969,4238,7251,16220,7439,16529
ͨ,TongHuaXiang,620825213,11799,1665,9531,4763,17666,9427,4269,7869,17296,8202,17733
,YongNingXiang,620825214,9964,1114,7325,3382,14439,7214,3485,6888,14102,7238,14563
֣,ZhengHeXiang,620825215,7668,843,5358,2580,10626,5339,2322,5322,10661,5475,10833
ƺ,NanPingXiang,620825217,11496,1301,8815,4102,16534,8709,4003,7845,16554,7985,16800
̰,PanAnXiang,620825219,13983,1750,11503,5460,21010,11440,5557,9597,21037,9787,21290
ֵ,ChengQuJieDao,620826001,28461,2041,18900,10404,21426,15556,7235,16551,32107,18837,37737
ǹ,ChengGuanZhen,620826100,9251,1026,6295,3330,10365,6289,2514,6481,12770,6496,12791
,WeiRongZhen,620826101,18492,2646,13690,7196,25792,13644,5326,12667,26311,12774,26464
ʯ,JieShiPuZhen,620826102,14382,2492,10933,6140,20728,10899,4345,10183,21082,10286,21219
,BaLiZhen,620826103,11242,1584,7864,4164,14845,7763,2884,7593,15356,7846,15710
,LiDianZhen,620826104,13995,1786,9437,4412,18366,8793,3439,8984,17777,9783,19220
Ǵ,ChengChuanXiang,620826200,11379,1518,8279,4128,15864,8217,3326,7851,16068,7944,16223
˾,SiQiaoXiang,620826201,6962,1206,5191,2884,9547,5108,2053,4871,9979,5030,10221
,CaoWuXiang,620826202,12463,1635,8797,4416,16951,8745,3249,8378,17123,8550,17347
ų,GuChengXiang,620826203,20279,2772,14331,7610,27527,14274,5313,13881,28155,14033,28364
˫,ShuangXianXiang,620826204,8710,1307,6170,3260,11844,6170,2305,6151,12321,6152,12322
״,LeiDaXiang,620826205,13239,1899,9118,4796,18163,9058,3432,9324,18382,9452,18570
,YuWanXiang,620826206,5780,925,4363,2232,8266,4339,1898,4180,8519,4240,8603
ʴ,RenDaXiang,620826207,17004,2518,12026,5824,23351,11947,4836,12161,24108,12332,24358
ֺ,JiaHeXiang,620826208,7154,1137,5015,2605,9871,5015,1945,5220,10235,5221,10236
,ShenGouXiang,620826209,4539,825,3214,1839,6385,3212,1135,3283,6495,3285,6499
ƽ,ZhiPingXiang,620826210,9666,1417,6837,3444,13394,6830,2846,7070,13900,7092,13929
µ,XinDianXiang,620826211,5817,923,4101,2087,8116,4093,1556,4134,8227,4195,8296
ʹ,GanGouXiang,620826212,22571,3204,16425,8142,30757,16031,6597,15449,31480,15947,32372
ĺ,SiHeXiang,620826213,15078,1951,10190,4865,20394,10095,3747,10311,20406,10586,20776
,HongSiXiang,620826214,11579,1595,7973,4108,15268,7973,2764,7965,15938,7965,15938
ϸ,XiXiangXiang,620826215,10575,1682,7908,4261,15182,7904,3278,7624,15528,7627,15535
,SanHeXiang,620826216,6252,1004,4426,2399,8637,4412,1562,4378,8790,4392,8818
ԭ,YuanAnXiang,620826217,9153,1472,6451,3399,12239,6385,2211,6190,12575,6385,12836
֥,LingZhiXiang,620826218,6423,1278,4864,3194,9004,4862,1742,4567,9429,4579,9443
ֵֽ´,DongBeiJieJieDaoBanShiChu,620902001,19348,2230,13161,9725,16437,13084,4463,12648,25732,12880,26041
Ͻֵֽ´,DongNanJieJieDaoBanShiChu,620902002,47670,4615,29952,21764,41737,28567,9541,27876,56443,31874,61826
ҵ԰ֵ´,GongYeYuanJieDaoBanShiChu,620902003,10588,233,5182,746,3722,820,460,924,1744,6099,11281
³ǽֵ´,XinChengJieDaoBanShiChu,620902004,17667,1213,11085,7466,13340,10066,3367,9969,20035,11162,22247
�ֵֽ´,XiBeiJieJieDaoBanShiChu,620902005,23360,2518,15176,11531,19956,14175,4425,13940,28115,15127,30303
Ͻֵֽ´,XiNanJieJieDaoBanShiChu,620902006,15159,1860,10216,7484,14343,9898,2925,9419,19317,9728,19944
,XiDongZhen,620902100,6490,629,4132,2555,7490,4123,1535,4279,8402,4522,8654
ˮ,QingShuiZhen,620902101,12785,1224,8513,5203,16886,8513,3307,8801,17314,8803,17316
կ,ZongZhaiZhen,620902102,13486,1477,9062,5714,17786,8992,3521,9156,18148,9422,18484
,JinFoSiZhen,620902103,10079,1527,7062,4570,13563,7049,2660,7088,14137,7204,14266
ϰ,ShangBaZhen,620902104,13750,1583,9120,6165,17206,9100,3405,9299,18399,9618,18738
,SanDunZhen,620902105,14924,1827,10082,6097,19800,10063,3502,10142,20205,10171,20253
,YinDaZhen,620902106,20437,2063,13259,7367,26524,13253,4452,13650,26903,13693,26952
,XiFengXiang,620902200,8508,601,5567,3370,9265,5560,2128,5617,11177,5670,11237
Ȫ,QuanHuXiang,620902201,20444,1468,12696,8741,18271,12646,4828,13879,26525,14044,26740
԰,GuoYuanXiang,620902202,10292,850,6788,4167,12955,6785,2630,6971,13756,6984,13772
º,XiaHeQingXiang,620902205,6019,493,3837,2084,5831,3788,1457,4035,7823,4132,7969
౤,HuangNiBaoXiang,620902207,900,130,595,406,1139,584,177,590,1174,612,1207
,HuaJianXiang,620902208,7007,824,4786,2658,9483,4757,1813,4829,9586,4858,9644
,DongDongXiang,620902209,5295,689,3631,2249,7185,3583,1453,3744,7327,3806,7437
,FengLeXiang,620902211,4258,520,2945,1913,5569,2901,1140,2881,5782,2973,5918
糡,DongFengChangQu,620902212,5094,226,4559,3413,4424,4027,2335,2208,6235,3096,7655
Ӫºũ,GuoYingXiaHeQingNongChang,620902401,2131,159,1333,968,1839,1332,426,1383,2715,1383,2716
ؽֵ´,YuMenYouTianShengHuoJiDiJieDaoBanShiChu,620902402,28522,4143,19240,14876,34928,19210,5081,18439,37649,18506,37746
ǹؽֵ´,ChengGuanJieDaoBanShiChu,620921001,23756,1920,15193,10309,21973,13609,5174,13614,27223,15657,30850
ж,ZhongDongZhen,620921100,8953,955,5755,3400,11406,5750,2013,6145,11895,6166,11921
,DingXinZhen,620921101,8144,997,5459,3299,10510,5434,1913,5536,10970,5595,11054
,JinTaZhen,620921102,15519,1477,10086,6022,18415,10081,3741,10638,20719,10651,20737
,DongBaZhen,620921103,8676,969,5897,3489,11588,5896,2436,6184,12080,6184,12081
,HangTianZhen,620921105,8156,913,5405,3153,10553,5396,2138,5784,11180,5802,11207
ׯ,DaZhuangZiXiang,620921203,6805,659,4409,2668,8701,4405,1666,4708,9113,4721,9130
ų,GuChengXiang,620921204,8285,950,5527,3119,10665,5526,2140,5848,11374,5848,11375
,XiBaXiang,620921205,7039,892,4825,2875,9185,4822,1822,4915,9737,4928,9753
,YangJingZiWanXiang,620921209,3664,316,2436,1207,4350,2436,1050,2594,5030,2594,5030
ʢũ̼ι˾,GanSuYaShengNongGongShangJiTuanYouXianZeRenGongSi,620921400,2325,170,1431,1064,2233,1427,477,1528,2955,1541,2972
ҵ԰ί,GongYeYuanQuGuanWeiHui,620921401,1598,93,690,835,62,570,121,601,1171,1122,1812
ũֳվ,NongLinChangZhan,620921402,136,4,46,79,5,46,1,93,139,95,141
,SanHeXiang,620921403,7034,670,4518,2706,8544,4517,1693,4870,9387,4879,9397
ԨȪ,YuanQuanZhen,620922100,22481,1960,14339,9492,19437,12727,5009,12474,25201,15111,29450
԰,LiuYuanZhen,620922101,6790,258,2379,1610,1490,1493,625,1929,3422,5294,7673
,SanDaoGouZhen,620922102,7470,578,4578,2902,8597,4533,1668,4884,9417,5138,9716
ϲ,NanChaZhen,620922103,7523,677,4921,3029,9440,4888,1989,5179,10067,5268,10189
,SuoYangChengZhen,620922104,4177,399,2570,1647,4953,2482,850,2676,5158,2856,5426
Ӷ,HeDongXiang,620922200,4182,349,2671,1708,5205,2652,1049,2807,5459,2909,5580
¡,BuLongJiXiang,620922201,4048,307,1974,1238,3520,1831,620,2012,3843,3001,4975
,XiHuXiang,620922203,10006,724,6191,3755,11197,6150,2359,6699,12849,6898,13089
,GuaZhouXiang,620922204,6053,425,3837,2092,7175,3786,1544,4123,7909,4185,8022
վ,YaoZhanZiXiang,620922209,9761,1233,5921,2806,9546,5852,1741,6543,12395,6814,12735
߶ջ嶫,QiDunHuiZuDongXiangZuXiang,620922212,2162,150,1305,696,2873,1301,612,1610,2911,1619,2924
˫,ShuangTaXiang,620922213,7406,596,4581,2268,8195,4523,1876,5201,9724,5297,9878
,GuangZhiZangZuXiang,620922214,6021,629,4168,1791,8300,4167,1699,4179,8346,4181,8349
ɳӻ,ShaHeHuiZuXiang,620922215,5165,556,3451,1457,5025,3416,1498,3717,7133,3768,7219
,LiangHuXiang,620922216,5037,488,3398,1474,5022,3382,1616,3729,7111,3743,7141
ӪСũ,GuoYingXiaoWanNongChang,620922400,4706,312,3095,1808,2073,3091,1414,3334,6425,3337,6432
,DangChengWanZhen,620923100,7625,594,4729,3440,8509,4682,1573,4891,9573,5063,9792
ɽ,MaZongShanZhen,620923101,3523,34,513,301,416,299,53,309,608,3097,3610
ʯ,ShiBaoChengXiang,620923202,1399,97,616,440,674,484,81,554,1038,961,1577
,HongLiuWanZhen,620924100,7975,366,4299,2518,5145,3853,1738,4052,7905,5780,10079
,AKeQiXiang,620924200,306,18,141,91,124,91,23,112,203,206,347
,ALeTengXiang,620924203,115,0,12,9,2,8,4,13,21,107,119
ίԱ,LaoShiQuGuanLiWeiYuanHui,620981001,16453,3222,9853,8354,17931,9249,2164,9580,18829,11986,21839
ֵ´,XinShiQuJieDaoBanShiChu,620981002,17738,1437,11216,8197,15773,10644,3769,10687,21331,11728,22944
Ŷ,YuMenDongZhen,620981100,1046,31,356,254,138,216,24,251,467,745,1101
,YuMenZhen,620981101,12031,862,7160,4130,8939,6085,2719,6772,12857,8452,15612
,ChiJinZhen,620981102,9085,891,5737,3520,11245,5636,1987,5889,11525,6226,11963
,HuaHaiZhen,620981103,9174,824,6184,3608,11808,6172,2638,6411,12583,6452,12636
,XiaXiHaoXiang,620981200,7111,620,4617,2789,8580,4576,1617,4661,9237,4731,9348
лբ,YuMenShiHuangZhaWanXiang,620981201,6160,619,3999,2379,7852,3999,1488,4267,8266,4268,8267
,LiuHeXiang,620981202,7749,587,5011,2931,9453,5005,1968,5263,10268,5293,10304
,ChangMaXiang,620981203,3107,225,1896,1157,3659,1863,638,1890,3753,2074,3970
Ȫ,QingQuanXiang,620981205,2866,282,1719,1174,3158,1684,622,1732,3416,2051,3770
С,XiaoJinWanXiang,620981206,4262,405,2923,1299,4707,2917,1510,3248,6165,3254,6177
,LiuHuXiang,620981207,3097,213,2024,1030,3915,2024,871,2155,4179,2157,4181
ɽ,DuShanZiXiang,620981208,4779,425,3419,1509,5301,3419,1955,3740,7159,3740,7159
,LiuDunXiang,620981209,1678,165,1032,517,2099,1032,402,1211,2243,1213,2245
Ӫũ,GuoYingYinMaNongChang,620981400,4260,595,2608,1771,4353,2604,636,2873,5477,2883,5491
Ӫƻũ,GuoYingHuangHuaNongChang,620981401,4791,817,2999,2390,4834,2994,666,3267,6261,3275,6274
ũԣʢũҵ˾,GanSuNongKenYuShengNongYeGongSi,620981402,2163,262,1348,812,1891,1092,408,1115,2207,1485,2833
ʡũѽ̹˾,GanSuShengNongKenJianZhuGongChengGongSi,620981403,1553,268,994,681,1576,933,309,1016,1949,1136,2130
,GanSuKuangQu,620981404,1456,86,242,171,924,105,6,115,220,1306,1548
,QiLiZhen,620982100,10993,932,7114,4504,10978,6966,2809,7305,14271,7620,14734
ɳ,ShaZhouZhen,620982101,34376,2840,22574,15867,28248,21291,7654,20865,42156,22296,44870
,SuZhouZhen,620982102,15334,1268,10249,5998,17423,9932,4230,10140,20072,10583,20832
Ī,MoGaoZhen,620982103,9168,964,6044,3898,10860,6002,2110,6132,12134,6198,12242
ת,ZhuanQuKouZhen,620982104,13269,1180,8782,5310,15775,8780,3499,9151,17931,9166,17948
,YangGuanZhen,620982105,3689,347,2414,1479,4236,2405,925,2488,4893,2547,4961
,YangJiaQiaoXiang,620982200,7537,673,4905,3004,8200,4875,1767,5030,9905,5072,9977
ұ,GuoJiaBaoXiang,620982201,5039,559,3424,2143,6650,3424,1338,3507,6931,3512,6936
,HuangQuXiang,620982204,8700,690,4941,2626,9533,4766,1849,4891,9657,6298,11239
Ӫػũ,GuoYingDunHuangNongChang,620982400,2144,147,1355,862,1917,1354,485,1413,2767,1421,2776
ຣʯ͹,QingHaiShiYouGuanLiJuShengHuoJiDi,620982401,32902,2285,19603,15681,273,19591,4325,19860,39451,19909,39512
ְ´,BeiJieBanShiChu,621002001,42221,3106,27569,14296,26806,20084,8588,20539,40623,26346,53915
Ͻְ´,NanJieBanShiChu,621002002,60235,4487,37842,21381,43969,30596,13029,31176,61772,39909,77751
ְ´,XiJieBanShiChu,621002003,18159,851,10962,7514,8226,10099,4107,10706,20805,12155,23117
Ф,XiaoJinZhen,621002100,25134,3434,17408,11186,33654,17211,6387,17221,34432,17547,34955
־,DongZhiZhen,621002101,40958,4155,26465,13459,51933,25921,9316,26970,52891,27964,54429
կ,HouGuanZhaiXiang,621002200,23994,2609,15212,7767,26656,14099,5175,14399,28498,16566,31778
ԭ,PengYuanXiang,621002201,24931,2828,16571,9079,31837,16330,5909,16703,33033,17097,33668
Ȫ,WenQuanXiang,621002202,27776,2373,17901,8369,26419,14842,5217,15268,30110,17465,35366
ʲ,ShenSheXiang,621002203,14446,2143,9953,5658,19281,9862,3479,9991,19853,10115,20068
ʤ,XianShengXiang,621002204,8828,1465,6187,4045,12131,6185,2188,6287,12472,6294,12481
,QingChengZhen,621021100,55599,3093,33021,18096,44553,25267,10333,27090,52357,36004,69025
,YiMaZhen,621021101,28059,2749,17978,8909,34286,16989,5928,17551,34540,18758,36736
ئ,SaPuZhen,621021102,14849,1532,9669,5197,18221,9376,3304,9635,19011,10016,19685
,MaLingZhen,621021103,15077,1535,9962,5093,19609,9874,3500,10013,19887,10150,20112
,XuanMaZhen,621021104,11339,1303,7268,3841,14323,7137,2380,7497,14634,7754,15022
,ChiChengXiang,621021200,10925,1218,7202,3943,14414,7126,2737,7544,14670,7678,14880
,BaiMaXiang,621021201,10641,974,6756,3354,13455,6600,2432,7037,13637,7291,14047
ͩ,TongChuanXiang,621021202,10345,1208,6843,3552,13737,6834,2500,7175,14009,7210,14053
̫,TaiBaiLiangXiang,621021203,6869,827,4624,2210,8956,4493,1752,4626,9119,4824,9448
,TuQiaoXiang,621021204,3541,437,2416,1290,4615,2391,923,2426,4817,2485,4901
̿ڼ,CaiKouJiXiang,621021205,3480,439,2379,1220,4558,2352,914,2368,4720,2454,4833
¥,GaoLouXiang,621021206,7427,755,4588,2472,9501,4506,1466,4885,9391,5060,9648
ׯ,NanZhuangXiang,621021207,6427,769,4166,2115,8447,4137,1376,4327,8464,4406,8572
ԼҺ,ZhaiJiaHeXiang,621021208,4463,437,2897,1474,5712,2839,1052,2967,5806,3055,5952
̼,CaiJiaMiaoXiang,621021209,11161,1247,7131,3678,14656,7080,2576,7764,14844,7853,14984
,HuanChengZhen,621022100,48240,4130,31463,16297,43923,26220,12881,27764,53984,33788,65251
,QuZiZhen,621022101,17395,1999,11747,6792,21954,11592,4228,11643,23235,11875,23622
ˮ,TianShuiZhen,621022102,7822,625,5201,2804,9702,5192,2317,5522,10714,5563,10764
ľ,MuBoZhen,621022103,13165,1621,8921,4846,17476,8920,3288,9147,18067,9153,18074
,TianChiXiang,621022200,12491,1449,8220,3924,16915,8149,3247,8775,16924,8967,17187
,YanWuXiang,621022201,7566,1051,5233,2678,10280,5229,2059,5442,10671,5443,10676
ϵ,HeDaoXiang,621022202,12936,1894,8774,4826,17338,8769,3229,9262,18031,9285,18059
Ҵ,FanJiaChuanXiang,621022203,7703,800,5183,2325,10540,5114,2116,5287,10401,5436,10619
,BaZhuXiang,621022204,7878,851,5285,2715,10460,5226,2090,5364,10590,5534,10819
,HongDeXiang,621022205,14940,1655,10347,5164,20408,10318,4420,10615,20933,10668,21015
,GengWanXiang,621022206,6574,701,4523,2081,9167,4419,2030,4614,9033,4782,9305
ׯ,QinTuanZhuangXiang,621022207,3960,460,2682,1494,5345,2643,1131,2786,5429,2869,5551
ɽ,ShanChengXiang,621022208,5804,590,3725,1993,7649,3722,1449,4115,7837,4118,7843
,NanQiuXiang,621022209,3175,299,2041,1069,4055,2025,798,2189,4214,2231,4272
ɽ,LuoShanChuanXiang,621022210,4704,448,3185,1524,6464,3166,1417,3336,6502,3384,6569
,HuDongXiang,621022211,8136,994,5401,2873,10643,5399,2086,5806,11205,5815,11216
СϹ,XiaoNanGouXiang,621022212,7394,816,4608,2626,9364,4603,1409,5001,9604,5011,9619
,CheDaoXiang,621022213,12854,1563,8479,4168,17293,8419,3191,8972,17391,9129,17608
ë,MaoJingXiang,621022214,8917,1002,5712,3254,11521,5712,1969,6176,11888,6176,11888
«,LuJiaWanXiang,621022215,6147,741,4071,2179,8272,4068,1535,4349,8417,4352,8423
ĺԭο칫,SiHeYuanLvYouKaiFaBanGongShi,621022500,3254,357,2131,1257,4329,2126,927,2357,4483,2407,4538
,YueLeZhen,621023100,8931,1028,5817,3327,10712,5604,2035,5744,11348,6177,11994
Զ,RouYuanZhen,621023101,25481,1534,16308,8979,20063,13629,6794,14520,28149,17501,33809
Ԫ,YuanChengZhen,621023102,3890,419,2499,1315,4662,2300,925,2425,4725,2735,5234
Ǻ,ChengHaoXiang,621023200,7630,852,4802,2794,9017,4578,1590,4871,9449,5270,10072
,WuJiaoXiang,621023201,9306,1027,6051,3029,11894,5959,2252,6394,12353,6534,12585
ܫ,ShangLiYuanXiang,621023202,3337,433,2319,1284,4268,2281,877,2228,4509,2328,4647
,WangJuZiXiang,621023203,4297,480,2780,1368,5535,2751,931,2875,5626,2928,5708
,BaiMaXiang,621023204,2912,403,1918,1013,3767,1902,697,2035,3937,2094,4012
,HuaiAnXiang,621023205,3543,498,2292,1296,4479,2265,748,2428,4693,2497,4789
Ǵ,QiaoChuanXiang,621023206,4188,532,2607,1269,5381,2578,819,2841,5419,2932,5539
Ǻ,QiaoHeXiang,621023207,2912,397,1812,1014,3469,1748,577,1868,3616,2074,3886
ɽׯ,ShanZhuangXiang,621023208,3457,297,2179,1196,4045,2137,798,2274,4411,2373,4552
,NanLiangXiang,621023209,3928,322,2404,1190,4039,2210,901,2351,4561,2747,5151
,LinZhenXiang,621023210,3493,352,2247,1305,4357,2222,821,2370,4592,2419,4666
Ϸ,ZiFangPanXiang,621023211,3118,318,2002,1115,3988,1975,795,2098,4073,2229,4231
�,XiHuaChiZhen,621024100,32451,3027,20706,12154,35499,18776,7860,19907,38683,22632,43338
ϳ,LaoChengZhen,621024101,7324,919,4861,2871,9132,4710,1751,4867,9577,5133,9994
̫,TaiBaiZhen,621024102,6006,540,3729,2144,7202,3649,1377,3928,7577,4194,7923
,JiXianXiang,621024200,6860,1057,4878,3306,9429,4847,1905,4893,9740,4944,9822
Ф,XiaoJuXiang,621024201,7669,891,5259,3085,10337,5070,2153,5205,10275,5454,10713
μҼ,DuanJiaJiXiang,621024202,5934,871,4306,2529,8309,4285,1671,4127,8412,4170,8476
̳,GuChengXiang,621024203,5294,870,3735,2347,7253,3697,1457,3656,7353,3886,7621
̫ݭ,TaiEXiang,621024204,3441,510,2396,1462,4746,2363,939,2398,4761,2494,4890
,DianZiXiang,621024205,5454,807,3917,2236,7519,3847,1520,3679,7526,3864,7781
μ,HeJiaPanXiang,621024206,11812,1284,7549,3893,15335,7486,2469,7910,15396,8016,15565
,BanQiaoXiang,621024207,11520,1354,7610,4101,15169,7573,2612,7810,15383,7876,15486
,HaoJuPuXiang,621024208,3035,369,1988,1208,3928,1970,709,2051,4021,2125,4113
ɽ,ShanHeZhen,621025100,29560,2914,19870,11536,34084,18501,8254,19266,37767,20858,40728
,YuLinZiZhen,621025101,18470,2274,12965,7421,24817,12783,5060,12462,25245,12839,25804
,GongHeZhen,621025102,15504,2577,11371,6738,21029,11034,4294,10389,21423,11004,22375
,YongHeZhen,621025103,14342,1955,10229,5913,19776,10143,4323,10129,20272,10391,20620
,XiPoXiang,621025200,8046,1080,5601,3288,11099,5585,2244,5707,11292,5769,11370
,YongZhengXiang,621025201,13208,1912,9377,5575,17899,9257,3586,9073,18330,9329,18706
ܼ,ZhouJiaXiang,621025202,12340,1940,8747,5486,16656,8615,3204,8368,16983,8737,17484
ͷ,QiuTouXiang,621025203,9739,1389,7122,4075,13598,7045,2957,6784,13829,6963,14085
ܫ,WuQingYuanXiang,621025204,3340,471,2288,1385,4508,2254,900,2310,4564,2423,4711
,SanJiaXiang,621025205,3534,602,2401,1579,4731,2380,890,2494,4874,2625,5026
,XinNingZhen,621026100,29363,2618,18413,10848,29358,15837,7018,16963,32800,20586,38999
ƽ,PingZiZhen,621026101,19222,2732,14265,7421,26985,13846,5963,13056,26902,13652,27917
ʤ,ZaoShengZhen,621026102,19517,3339,14884,8741,27835,14237,5780,12887,27124,13752,28636
,ChangQingQiaoZhen,621026103,6957,662,4265,1673,7750,2789,1484,2663,5452,4838,9103
ʢ,HeShengZhen,621026104,25425,3266,17595,9254,33338,16737,6862,16550,33287,17958,35553
,XiangLeZhen,621026105,12469,1858,9256,4932,18167,9092,4183,8832,17924,9254,18510
ׯ,XinZhuangZhen,621026106,24838,3090,16703,8409,34168,16569,6354,17126,33695,17579,34282
̿,PanKeZhen,621026107,19013,2787,14398,8040,27910,14233,6665,13589,27822,14067,28465
,MiQiaoXiang,621026200,10989,1845,8740,4767,16574,8636,4052,7954,16590,8146,16886
ƽ,LiangPingXiang,621026201,12049,2032,9588,5459,17718,9270,4274,8257,17527,8767,18355
д,ZhongCunXiang,621026202,16370,3522,13344,8068,25013,13108,5480,11538,24646,12028,25372
̫,TaiChangXiang,621026203,8960,1278,6551,3504,12509,6379,2781,6144,12523,6468,13019
,JiaoCunXiang,621026204,25372,3885,18475,10331,35389,17911,7343,16869,34780,18125,36600
,NanYiXiang,621026205,10678,1629,7842,4397,15289,7755,3258,7519,15274,7723,15565
б,WaXieXiang,621026206,7797,1087,5339,2864,10679,5218,2086,5387,10605,5631,10970
,JinCunXiang,621026207,4005,543,2924,1689,5517,2896,1197,2718,5614,2821,5745
,JiuXianXiang,621026208,5283,665,3864,2129,7410,3809,1617,3590,7399,3701,7565
,ChunRongXiang,621026209,22640,3783,17774,9656,33543,17519,7649,15830,33349,16298,34072
ǹ,ChengGuanZhen,621027100,33476,4494,21762,11314,39152,17946,8104,18263,36209,24312,46074
,TunZiZhen,621027101,25298,4275,18426,10931,35682,17554,7606,17292,34846,18753,37179
ϰ,MengBaZhen,621027102,22447,2995,15839,8840,30789,15321,6549,15271,30592,16152,31991
,SanChaZhen,621027103,12069,1434,8156,3960,14695,7360,3181,7252,14612,8528,16684
ƽȪ,PingQuanZhen,621027104,23905,3740,17615,9394,33358,16885,7225,16156,33041,17255,34870
,KaiBianZhen,621027105,12097,1930,8921,4545,16196,8239,3686,7862,16101,8792,17713
̫ƽ,TaiPingZhen,621027106,17266,2753,12347,7305,24326,12211,4832,12194,24405,12504,24851
,LinJingXiang,621027200,16634,3123,13096,7833,24738,12979,5860,12236,25215,12521,25617
ϴ,NanChuanXiang,621027201,10432,2065,7917,4515,15371,7827,3243,7624,15451,7823,15740
Ф,ShangXiaoXiang,621027202,17344,2869,13583,7810,25913,13398,6473,12740,26138,13103,26686
¼,XinJiXiang,621027203,11964,1754,8498,4704,16824,8419,3522,8499,16918,8742,17240
ɽ,FangShanXiang,621027204,8268,1147,5757,2854,11327,5719,2347,5867,11586,6005,11762
ҳ,YinJiaChengXiang,621027205,4258,617,3148,1789,5785,3122,1543,3180,6302,3270,6418
,MaQuXiang,621027206,8738,1073,6028,2975,11926,5922,2522,5998,11920,6305,12333
,MiaoQuXiang,621027207,10765,1558,7521,3938,14899,7377,3050,7557,14934,7852,15373
乵,WuGouXiang,621027208,8673,1010,5839,2822,11874,5774,2348,5954,11728,6192,12031
ԭ,GuoYuanXiang,621027209,8768,1375,6632,3782,12693,6598,2986,6372,12970,6497,13129
ԭ,ZhongYuanXiang,621027210,11635,1623,8464,4631,16516,8339,3668,8003,16342,8462,16926
³,XinChengXiang,621027211,23978,2834,16157,7408,32847,15637,6298,15847,31484,16953,33110
л·ֵ´,ZhongHuaLuJieDaoBanShiChu,621102001,42353,4007,25728,18923,38391,24257,8497,25141,49398,29129,54857
·ֵ´,YongDingLuJieDaoBanShiChu,621102002,53296,4317,34874,20889,44767,28642,10277,29699,58341,33016,67890
,FengXiangZhen,621102101,24409,3049,15752,9067,30835,15731,4822,16370,32101,16528,32280
ڹ,NeiGuanZhen,621102102,39194,4737,24569,13311,49822,24414,7058,25823,50237,26420,50989
,ChanKouZhen,621102103,16681,2596,11152,6673,20731,10649,2996,10606,21255,11121,22273
ƹ,ChengGouYiZhen,621102104,10338,1778,7004,3953,14012,6882,2196,7097,13979,7308,14312
³ҹ,LuJiaGouZhen,621102105,8650,1333,5733,3501,11351,5650,1631,5720,11370,5881,11614
,XiGongYiZhen,621102106,13513,1924,8567,4566,17512,8309,2435,8926,17235,9305,17872
Զ,NingYuanZhen,621102107,11545,1912,7902,4574,15598,7718,2344,7603,15321,7899,15801
ұ,LiJiaBaoZhen,621102108,14377,2223,9680,5561,19173,9664,2900,9800,19464,9820,19500
Ž,TuanJieZhen,621102109,8271,1393,5823,3354,11283,5727,1960,5619,11346,5801,11624
Ȫ,XiangQuanZhen,621102110,12764,1626,8320,4398,16482,8192,2670,8385,16577,8740,17060
Ҵ,FuJiaChuanZhen,621102111,8240,1226,5363,2972,10617,5269,1670,5392,10661,5773,11136
Ҳ,GeJiaChaZhen,621102112,6850,1084,4624,2782,9137,4607,1386,4637,9244,4696,9320
µ,BaiLuXiang,621102204,2497,484,1762,1208,3466,1730,609,1758,3488,1828,3590
ʯϿ,ShiXiaWanXiang,621102207,5494,816,3601,2246,7259,3576,1108,3754,7330,3817,7418
¼,XinJiXiang,621102208,8517,1332,5606,3205,10967,5555,1465,5554,11109,5708,11314
ɽ,QingLanShanXiang,621102209,11244,1685,7221,3978,14750,7148,1920,7444,14592,7628,14849
߷,GaoFengXiang,621102210,5378,652,3354,1854,7019,3297,1062,3595,6892,3738,7092
ʯȪ,ShiQuanXiang,621102211,9751,1466,6357,3613,13032,6221,1947,6526,12747,6807,13164
԰,XingYuanXiang,621102214,4882,774,3224,1853,6563,3198,1003,3385,6583,3435,6659
ƽ,PingXiangZhen,621121100,38653,4463,26734,14108,48437,25722,11578,26407,52129,27960,54694
Ӫ,MaYingZhen,621121101,23398,3526,16756,8805,32065,16158,6629,15950,32108,16797,33553
,JiChuanZhen,621121102,12136,2156,8511,4869,14593,7566,2761,7345,14911,8542,17053
,BangLuoZhen,621121103,20522,3343,15896,8060,30762,15745,7508,15128,30873,15477,31373
,ChangHeZhen,621121104,19846,3168,15365,7419,29007,14821,6702,13560,28381,14351,29716
,YiGangZhen,621121105,12211,1666,8766,4476,17227,8620,3764,8541,17161,8875,17641
¤,LongYangXiang,621121200,7866,1303,5940,3268,11553,5932,2628,5839,11771,5857,11797
¤ɽ,LongShanXiang,621121201,10655,1405,7460,3566,14024,6843,2931,6839,13682,7531,14991
¤,LongChuanXiang,621121202,7949,1261,5800,3257,11328,5780,2269,5549,11329,5679,11479
¾,XinJingXiang,621121203,6752,1211,4960,2775,9518,4855,2010,4775,9630,5013,9973
,BiYuXiang,621121204,9881,1940,7575,4028,14386,7487,2894,6945,14432,7140,14715
,XiangNanXiang,621121206,12003,2265,9297,4648,17285,9066,3798,8453,17519,8769,18066
,LiDianXiang,621121207,7648,1573,6038,3273,11206,5831,2407,5195,11026,5590,11628
ʲ,ShenChuanXiang,621121210,11153,1667,8001,4328,15558,7957,3206,7816,15773,8025,16026
,SanPuXiang,621121212,8527,1567,6652,3475,12584,6597,2761,6081,12678,6203,12855
,HuaLingXiang,621121214,9624,1434,6865,3612,13547,6789,2792,6788,13577,6985,13850
,SiZiXiang,621121215,8302,1290,6373,3285,12043,6314,2898,5971,12285,6117,12490
,BeiChengXiang,621121216,11834,1917,8864,4618,17242,8804,3888,8612,17416,8775,17639
,GongChangZhen,621122100,85102,9076,56293,33819,109250,56108,20741,58049,114157,58626,114919
ķ,WenFengZhen,621122101,56119,6561,37240,21116,71731,37075,14164,39106,76181,39604,76844
,ShouYangZhen,621122102,32019,3371,20645,10194,41325,20001,7616,21250,41251,22361,43006
,CaiZiZhen,621122103,22771,3160,16670,9110,32722,16669,7228,16486,33155,16489,33159
,FuXingZhen,621122104,21954,2745,14806,8079,29686,14669,5940,15489,30158,15833,30639
ͨ,TongAnYiZhen,621122105,15609,2121,10397,5679,21058,10327,3718,10868,21195,11051,21448
,YunTianZhen,621122106,13457,1979,9579,5024,18690,9482,3733,9236,18718,9590,19169
,BiYanZhen,621122107,14219,1621,9481,5386,14933,8466,3871,8632,17098,10230,19711
,MaHeZhen,621122108,8239,1109,5522,3101,11196,5458,1965,5527,10985,5791,11313
μ,WeiYangXiang,621122200,8084,1243,5986,3005,11884,5905,2629,5741,11646,5970,11956
ΰ,HongWeiXiang,621122201,7840,1148,5343,2930,10748,5301,1887,5423,10724,5532,10875
ƽ,HePingXiang,621122202,7578,1184,5489,2854,10629,5480,2165,5375,10855,5438,10927
կ,KeZhaiXiang,621122203,8053,1086,5369,2875,11037,5347,2150,5831,11178,5920,11289
˫Ȫ,ShuangQuanXiang,621122204,8272,1094,5552,2789,11018,5472,1979,5601,11073,5793,11345
,DeXingXiang,621122205,7114,943,4858,2362,9899,4858,1962,5157,10015,5161,10019
,YongJiXiang,621122206,6409,883,4297,2435,8827,4272,1710,4637,8909,4705,9002
Ȩ,QuanJiaWanXiang,621122207,5264,960,3786,2026,7466,3754,1414,3733,7487,3852,7638
Դ,QingYuanZhen,621123100,37839,3908,24641,13728,48390,23335,8624,23720,47055,25730,50371
,LianFengZhen,621123101,29574,3483,19925,10706,40200,19710,8058,20248,39958,21190,41115
ᴨ,HuiChuanZhen,621123102,31137,3674,20085,11289,40748,19804,6748,21125,40929,21474,41559
,WuZhuZhen,621123103,10114,1285,6586,4013,12363,6452,2316,6879,13331,7129,13715
·԰,LuYuanZhen,621123104,14037,1546,9487,4678,18926,9259,3444,9180,18439,9540,19027
կ,BeiZhaiZhen,621123105,12993,1613,8398,4148,17157,8153,2830,8516,16669,9038,17436
կ,XinZhaiZhen,621123106,15206,1739,9907,4825,20293,9875,3432,10388,20263,10470,20377
Ҽ,MaJiaJiZhen,621123107,11723,1175,7671,3710,15650,7607,3054,8117,15724,8281,15952
,QiaoYuXiang,621123200,11005,1396,7247,3730,14669,7185,2450,7486,14671,7604,14851
,DaAnXiang,621123203,8022,974,5389,2736,10842,5344,1943,5418,10762,5550,10939
,QinQiXiang,621123204,6534,892,4078,2172,8214,4016,1358,4200,8216,4706,8784
ƺ,QingPingXiang,621123206,10509,1339,6889,3468,13872,6812,2340,7079,13891,7299,14188
,QiJiaMiaoXiang,621123207,12330,1475,7834,4009,16310,7780,2761,8620,16400,8732,16566
,ShangWanXiang,621123208,15038,1842,9888,4906,19934,9751,3386,10118,19869,10378,20266
Ͽ,XiaChengXiang,621123209,6035,710,4015,1976,8011,3974,1497,4081,8055,4227,8242
Һ,TianJiaHeXiang,621123210,8141,934,5144,2551,10647,5062,1752,5475,10537,5683,10827
,TaoYangZhen,621124100,81940,9303,55611,31519,83903,52537,18057,50614,103151,53689,109300
,BaLiPuZhen,621124101,23935,2780,15775,8323,30939,15562,5026,15724,31286,15966,31741
,XinTianZhen,621124102,29743,3932,20483,10986,39204,19862,6649,19343,39205,19841,40324
,XinDianZhen,621124103,25654,2908,16652,8661,33376,16496,5706,17335,33831,17616,34268
̫ʯ,TaiShiZhen,621124104,22848,2495,15013,7450,30114,14766,5046,14976,29742,15376,30389
,ZhongPuZhen,621124105,13649,1552,8702,4472,17633,8605,2982,9236,17841,9481,18183
Ͽ,XiaKouZhen,621124106,10018,1232,6493,3439,13133,6259,2184,6526,12785,6941,13434
,LongMenZhen,621124107,17202,2127,11298,5557,22572,11297,3540,11553,22850,11571,22869
Ҥ,YaoDianZhen,621124108,16890,1835,10951,5916,20211,10627,3563,10920,21547,11337,22288
,YuJingZhen,621124109,26653,3127,17757,8942,34521,17553,5263,16993,34546,17286,35043
¼,YaXiaJiZhen,621124110,31440,3407,20680,9585,40901,20550,6607,20618,41168,20774,41454
,NanPingZhen,621124111,20578,2359,13723,6697,27165,13591,4661,13586,27177,13875,27598
,HongQiXiang,621124200,8600,1160,5929,3096,11444,5845,1905,5595,11440,5736,11665
Ӫ,ShangYingXiang,621124201,11764,1458,7704,4210,15658,7698,2833,8286,15984,8351,16055
Ҽ,KangJiaJiXiang,621124202,10514,1172,6729,3611,13741,6720,2336,7264,13984,7293,14022
վ̲,ZhanTanXiang,621124203,10136,1187,6307,3323,13074,6212,2033,6850,13062,7049,13356
,ManWaXiang,621124204,7741,796,4705,2421,9365,4611,1554,4819,9430,5386,10091
,LianErWanXiang,621124205,11442,1290,7372,3976,15040,7353,2574,7872,15225,7934,15306
,WuYangZhen,621125100,21591,2134,14503,6935,28145,14160,6235,14931,29091,15457,29960
,SanChaZhen,621125101,14889,1573,10299,4899,20812,10299,4429,10592,20891,10592,20891
,XinSiZhen,621125102,16910,1449,10971,5459,21969,10931,4470,11758,22689,11858,22829
,JinZhongZhen,621125103,12757,1137,8351,3840,17213,8327,3643,8973,17300,9186,17537
ξ,YanJingXiang,621125201,9618,1075,6424,3048,12616,6386,2678,6447,12833,6947,13371
컢,YiHuQiaoXiang,621125202,10718,985,7216,3177,14643,7198,3108,7475,14673,7595,14811
̲,DaCaoTanXiang,621125203,8368,842,5504,2509,11099,5463,2220,5689,11152,5926,11430
Ȫ,MaQuanXiang,621125204,6661,745,4559,2043,9393,4559,2039,4886,9445,4886,9445
,SiZuXiang,621125205,8038,720,5452,2513,10993,5452,2359,5665,11117,5665,11117
ʯ,ShiChuanXiang,621125206,8931,896,6038,2891,12385,6032,2609,6389,12421,6398,12436
̲,CaoTanXiang,621125207,8079,770,5342,2548,11016,5342,2205,5710,11052,5712,11054
䵱,WuDangXiang,621125208,6877,737,4718,2036,9744,4673,2139,4941,9614,5035,9753
Ȫ,DongQuanXiang,621125209,6100,520,3864,1830,8314,3864,1703,4458,8322,4459,8323
,MinYangZhen,621126100,40665,3545,26775,15152,47439,26718,10019,27324,54042,27454,54229
,PuMaZhen,621126101,15659,1581,11200,5817,21919,11158,5241,11228,22386,11281,22481
կ,XiZhaiZhen,621126102,13557,1255,8861,4668,17180,8748,3588,9330,18078,9539,18400
÷,MeiChuanZhen,621126103,31668,2606,20896,8995,41400,20649,9470,21386,42035,22848,43744
,XiJiangZhen,621126104,18983,1862,13304,5793,26695,13245,6017,13421,26666,13558,26862
̾,LvJingZhen,621126105,22904,2220,16299,7674,31832,16161,7856,16408,32569,16681,32980
ʮ,ShiLiZhen,621126106,27004,2734,19377,9450,37348,19316,8885,19153,38469,19246,38623
貺,ChaBuZhen,621126107,16643,1614,11348,5356,21995,11237,4880,11305,22542,11789,23137
կ,ZhongZhaiZhen,621126108,24748,1968,17288,7705,34580,17207,8725,17946,35153,18153,35441
ˮ,QingShuiXiang,621126200,20699,1827,13485,6526,27789,13446,5567,14537,27983,14608,28093
,MaWuXiang,621126201,7610,844,5187,2736,10870,5187,2561,5826,11013,5828,11015
¹,SiGouXiang,621126202,16159,1473,10389,4919,21500,10263,4197,11229,21492,11440,21829
Ӵ,MaZiChuanXiang,621126203,8643,745,5649,2710,11706,5649,2384,6123,11772,6123,11772
,QinXuXiang,621126204,15894,1489,10559,5146,21481,10488,4450,11138,21626,11274,21833
,HeTuoXiang,621126205,13490,1280,9130,4188,18571,9130,4065,9705,18835,9705,18835
ά,WeiXinXiang,621126206,15124,1408,10559,5249,21151,10547,5212,11163,21710,11185,21744
궼,ShenDouXiang,621126207,5971,623,4406,2245,8756,4383,2276,4384,8767,4464,8870
,SuoLongXiang,621126208,7715,803,5055,2537,9957,5010,2248,5286,10296,5711,10766
ǹ,ChengGuanZhen,621202100,65867,5175,40871,28026,65733,39943,14784,40997,80940,44955,85826
,AnHuaZhen,621202101,21923,2579,14634,7689,28627,14246,5414,14842,29088,15282,29916
,DongJiangZhen,621202102,13529,774,8161,2391,8057,4699,2513,4600,9299,8655,16816
ˮ,LiangShuiZhen,621202103,20076,2113,13206,7743,25950,13172,5092,13733,26905,14075,27281
,HanWangZhen,621202104,20584,2203,13737,6307,26359,12417,4887,13159,25576,13937,27674
,LuoTangZhen,621202105,19090,2443,12069,6000,24286,11924,4338,12698,24622,13802,25871
ǹ,JiaoGongZhen,621202106,13507,1535,9286,4742,18577,9228,4041,9526,18754,9797,19083
,MaJieZhen,621202107,20330,2188,13974,7212,27559,13923,5851,14259,28182,14395,28369
,SanHeZhen,621202108,8654,1102,5584,3034,10841,5496,2160,5783,11279,6332,11916
Ȫ,GanQuanZhen,621202109,6609,971,4506,2810,9072,4462,1792,4829,9291,4866,9372
,YuLongZhen,621202110,11085,1633,7264,4323,15103,7226,2679,8001,15227,8133,15397
,PiPaZhen,621202111,10162,1467,6413,3285,13001,6342,2424,6877,13219,7640,14053
ǽ,ChengJiaoXiang,621202200,14917,1447,9826,5177,18443,9719,4105,10375,20094,10643,20469
ƺ,PingYaZangZuXiang,621202201,3232,419,2478,1119,4720,2462,1157,2282,4744,2330,4808
ѳ,PuChiXiang,621202203,11436,1358,7783,3816,16032,7775,3478,8448,16223,8489,16272
ʯ,ShiMenXiang,621202204,7839,862,5246,2457,10736,5234,2161,5569,10803,5616,10862
,HanLinXiang,621202207,7515,774,5239,2837,10564,5237,2509,5550,10787,5559,10798
,BoLinXiang,621202208,8169,945,5427,2983,10980,5424,2030,5714,11138,5717,11144
Ӫ,MaYingXiang,621202210,11546,1356,7719,4025,15771,7713,3219,8375,16088,8402,16121
ذ,ChiBaXiang,621202211,3841,376,2468,1389,5127,2464,1013,2734,5198,2762,5230
,FoYaXiang,621202213,9009,1117,5642,2988,11845,5583,2029,6400,11983,6513,12155
ƺ,HuangPingXiang,621202215,6671,861,4111,2125,8745,4103,1398,4801,8904,4819,8930
¡,LongXingXiang,621202217,5987,1032,3959,2621,8197,3939,1391,4413,8352,4451,8410
,LongBaXiang,621202218,3623,726,2379,1401,4988,2350,762,2695,5045,2732,5111
,LongFengXiang,621202219,7349,975,4807,2918,9947,4800,1883,5375,10175,5400,10207
۸,JuGanXiang,621202220,4773,622,3135,1719,6278,3096,1197,3387,6483,3457,6592
ĥӲ,MoBaZangZuXiang,621202221,3778,522,2467,1299,5102,2447,965,2760,5207,2798,5265
,WaiNaXiang,621202223,14305,1899,9041,4598,18559,8949,3190,9780,18729,10353,19394
,YuHuangXiang,621202225,6374,857,3722,1977,7685,3688,1237,4129,7817,4746,8468
,GuoHeXiang,621202226,9140,1269,6038,3119,12400,6035,2176,6535,12570,6547,12585
,FengXiangXiang,621202229,7983,950,4552,2186,9331,4492,1732,4927,9419,6113,10665
,SanCangXiang,621202230,9160,1224,6149,3147,12653,6136,2449,6644,12780,6684,12833
,WuKuXiang,621202231,7920,1113,5260,2833,10981,5258,2133,5901,11159,5906,11166
,YueZhaoXiang,621202233,3365,488,2213,1090,4608,2200,810,2409,4609,2450,4663
,WuMaXiang,621202235,4974,850,3085,1606,6654,3064,919,3589,6653,3658,6743
ԣ,YuHeXiang,621202237,3362,559,2165,1245,4431,2159,618,2322,4481,2374,4539
ǹ,ChengGuanZhen,621221100,52477,4245,34449,19763,58337,30945,12705,32129,63074,34978,69427
,HuangZhuZhen,621221101,6695,795,4266,2940,8160,4228,1696,4748,8976,4920,9186
촨,HongChuanZhen,621221102,7551,955,5101,2960,9695,4893,1899,5006,9899,5304,10405
С,XiaoChuanZhen,621221103,13329,1456,8844,4637,16644,8203,3313,8543,16746,9254,18098
ֽ,ZhiFangZhen,621221104,8326,1278,5705,3275,11581,5660,2195,6016,11676,6094,11799
ɳ,PaoShaZhen,621221105,15557,1873,10503,6041,19939,10412,4477,10908,21320,11404,21907
,DianCunZhen,621221107,10759,1273,7298,4249,14561,7279,2820,7531,14810,7554,14852
ĥ,WangMoZhen,621221108,6245,696,3939,2146,7863,3844,1562,4119,7963,4564,8503
Ժ,ChenYuanZhen,621221109,6931,942,4665,2672,9292,4654,1698,4875,9529,4906,9571
ɳ,ShaBaZhen,621221110,6971,1054,4979,2690,9813,4957,2082,5085,10042,5128,10107
Ƴ,HuangChenZhen,621221111,7610,1058,5099,3005,10116,5075,1967,5464,10539,5536,10635
,JiFengZhen,621221112,11838,1722,7734,4292,15927,7707,2713,8493,16200,8539,16273
ƺ,SongPingXiang,621221203,3905,596,2459,1468,5150,2449,776,2779,5228,2818,5277
,ErLangXiang,621221206,3704,436,2350,1225,3580,2041,837,2334,4375,2627,4977
Ԫ,SuYuanXiang,621221209,5115,739,3545,2034,6933,3505,1441,3676,7181,3750,7295
,SuoChiXiang,621221210,6368,892,4348,2321,8898,4309,1853,4690,8999,4765,9113
,TanHeXiang,621221213,3651,488,2310,1454,4733,2305,779,2573,4878,2608,4918
ǹ,ChengGuanZhen,621222100,23490,2402,15422,9377,28418,14743,5447,15243,29986,15917,31339
̿,BiKouZhen,621222101,12582,1165,7884,5144,14618,7843,2500,8281,16124,8363,16247
е,ShangDeZhen,621222102,6992,1253,4851,3014,9695,4834,1660,5026,9860,5054,9905
¥,TieLouXiang,621222200,5759,975,4079,2540,8082,4077,1510,4160,8237,4165,8244
,DanBaoXiang,621222203,5190,867,3468,2383,7106,3461,1195,3757,7218,3784,7252
ƺ,LiuJiaPingXiang,621222205,2257,208,962,471,1280,625,185,694,1319,1688,2650
,YuLeiXiang,621222206,3189,536,2049,1351,4181,2036,635,2281,4317,2311,4360
,FanBaXiang,621222207,8085,1087,5002,3113,10463,4998,1370,5530,10528,5540,10542
,ZhongMiaoXiang,621222210,8993,1041,5659,3324,11224,5622,1817,5867,11489,6192,11851
ͷ,KouTouBaXiang,621222211,4742,806,3228,2059,6599,3209,1260,3498,6707,3580,6808
ɽ,JianShanXiang,621222212,3146,462,2146,1365,4356,2145,805,2257,4402,2267,4413
ٽ,LinJiangXiang,621222213,5498,696,3598,1942,7216,3502,1389,3780,7282,3985,7583
ƺ,LiPingXiang,621222214,7065,1068,4970,2954,10140,4960,2154,5307,10267,5317,10287
,SheShuXiang,621222215,3020,479,2039,1138,4139,2035,739,2163,4198,2199,4238
,TianChiXiang,621222216,4258,650,3034,1655,5981,3017,1288,3106,6123,3162,6196
ͷ,QiaoTouXiang,621222217,15062,1829,10123,5751,20597,10051,4382,11031,21082,11150,21273
Ӱ,BuZiBaXiang,621222218,9269,1369,5897,3769,12262,5878,1966,6580,12458,6707,12604
ʯ,ShiFangXiang,621222219,6967,865,4568,2575,8631,4441,1740,4808,9249,5004,9572
ʯ,ShiJiBaXiang,621222220,9998,1317,6540,3466,13226,6487,2476,6910,13397,7251,13791
կ,ZhongZhaiXiang,621222222,14317,1789,9610,4961,19377,9597,3535,10007,19604,10031,19641
ǹ,ChengGuanZhen,621223100,24813,1858,15327,8667,28236,14469,5190,14729,29198,16534,31861
,HaDaPuZhen,621223101,20470,1992,13303,6489,26560,12861,5830,13599,26460,14989,28292
�,LiChuanZhen,621223102,13723,1425,9608,4752,19384,9583,4553,9811,19394,10093,19701
,NanYangZhen,621223103,8710,1139,6013,3202,12145,5921,2418,6075,11996,6254,12267
ͤ,GuanTingZhen,621223104,7153,1028,4795,2506,9564,4714,1883,4885,9599,5269,10064
ɳ,ShaWanZhen,621223105,14936,1767,10200,5598,19853,10012,4848,10084,20096,11351,21551
,AWuXiang,621223200,6553,816,4519,2402,9132,4494,2308,4747,9241,5158,9677
Ϻ,NanHeXiang,621223204,4746,583,3177,1773,6612,3172,1296,3427,6599,3448,6625
,BaLiXiang,621223205,4665,563,3482,1873,7023,3482,1873,3618,7100,3619,7101
ľ,MuErXiang,621223206,3562,481,2813,1591,5661,2813,1670,2900,5713,2900,5713
Ӽ,PangJiaXiang,621223207,5514,577,3868,1788,7920,3862,1865,4074,7936,4088,7956
μұ,HeJiaBaoXiang,621223209,3609,462,2621,1490,5078,2620,1139,2575,5195,2589,5210
ֺ,JiaHeXiang,621223211,5774,823,4015,2095,8136,3967,1661,4176,8143,4243,8258
̨,JiangTaiXiang,621223212,5108,582,3347,1615,6901,3321,1404,3583,6904,3747,7094
,CheLaXiang,621223213,7821,910,5059,2553,10664,5015,2314,5710,10725,5986,11045
³Ӳ,XinChengZiZangZuXiang,621223214,5305,448,3013,1438,6058,2951,1104,3035,5986,3844,6857
ٽ,LinJiangXiang,621223215,4278,454,2656,1364,5091,2606,1066,2490,5096,3142,5798
,HaoTiXiang,621223216,4364,564,3158,1645,6120,3146,1380,3101,6247,3150,6308
Ժ,HanYuanXiang,621223217,8288,923,5464,2496,11436,5464,2252,5999,11463,5999,11463
Ժ,ZhuYuanXiang,621223218,4149,461,2665,1169,5512,2636,1024,2896,5532,2969,5634
˻,XingHuaXiang,621223219,7587,801,4832,2243,10289,4832,1954,5510,10342,5510,10342
ʽͷ,GanJiangTouXiang,621223220,5209,564,3048,1606,6286,2991,1062,3309,6300,3787,6835
կ,XinZhaiXiang,621223223,7583,1298,5576,2898,11032,5576,2361,5666,11242,5666,11242
ʨ,ShiZiXiang,621223224,4319,484,2783,1351,5689,2781,963,2974,5755,2983,5766
ӿ,LiangHeKouXiang,621223225,8401,1069,5417,3069,10696,5327,2183,5455,10782,6236,11653
ǹ,ChengGuanZhen,621224100,20655,2066,12811,7951,22468,11940,4306,13068,25008,14216,27027
ƽ,PingLuoZhen,621224101,6904,1130,4523,2806,9377,4490,1624,5053,9543,5135,9658
,DaBaoZhen,621224102,7097,1040,4440,2757,9400,4325,1464,4946,9271,5161,9601
ſ,AnMenKouZhen,621224103,6182,1187,4036,2618,8113,3859,1308,4454,8313,4641,8677
,LiangHeZhen,621224104,3152,500,2030,1368,4131,2021,588,2167,4188,2210,4240
,ChangBaZhen,621224105,9007,1438,5778,3525,11997,5637,2043,6530,12167,6710,12488
̨,YunTaiZhen,621224106,8473,1049,4998,2970,10672,4969,1440,5861,10830,5964,10962
,YangBaZhen,621224107,8821,1064,5462,3292,11053,5402,1698,5944,11346,6121,11583
,WangGuanXiang,621224200,4380,661,2886,1714,5886,2862,1059,3172,6034,3214,6100
̨,SiTaiXiang,621224202,4362,543,2710,1598,5677,2692,893,3051,5743,3088,5798
,DaNanYuXiang,621224203,7056,979,4518,2620,9263,4508,1485,4949,9457,5002,9520
԰,MiBaXiang,621224204,3967,476,2455,1347,5063,2433,732,2643,5076,2720,5175
,WangBaXiang,621224206,5590,827,3658,2180,7537,3654,1335,4074,7728,4094,7752
,NianBaXiang,621224207,6691,1135,4436,2743,9247,4434,1605,4995,9429,4995,9431
,DouBaXiang,621224208,4032,797,2661,1542,5425,2635,865,2960,5595,3033,5694
,DianZiXiang,621224209,3010,672,2040,1171,4282,2023,652,2252,4275,2294,4334
ƺ,DouPingXiang,621224210,9215,1307,5910,3342,12420,5819,2250,6715,12534,6862,12772
,BaiYangXiang,621224212,4233,750,2767,1677,5364,2635,864,2870,5505,3080,5847
̫ʯ,TaiShiXiang,621224214,2520,352,1635,923,3354,1626,607,1812,3438,1844,3479
ͭǮ,TongQianXiang,621224215,3075,347,1952,1157,3871,1916,660,2044,3960,2130,4082
Ӱ,SanHeBaXiang,621224218,4276,721,2731,1511,5502,2685,844,2873,5558,3110,5841
Դ,HanYuanZhen,621225100,27707,2117,17925,10274,35685,17875,7460,19291,37166,19359,37284
,ChangDaoZhen,621225101,16643,1895,11810,5564,23545,11624,5402,11655,23279,12130,23940
ΰ,HeBaZhen,621225102,22149,2492,16469,6909,32018,16225,7897,15590,31815,16069,32538
ϯ,JiangXiZhen,621225103,19005,2269,12986,5855,26771,12901,5824,13865,26766,14112,27098
ʯϿ,ShiXiaZhen,621225104,7644,1086,5216,2332,11005,5201,2342,5788,10989,5856,11072
,LuoYuZhen,621225105,19966,2621,14945,6869,29555,14871,7368,14897,29768,15010,29955
ʯ,ShiBaoXiang,621225201,15260,1801,11385,5151,22611,11359,5560,11181,22540,11236,22621
,XiYuXiang,621225202,17751,1593,11998,5391,24255,11998,5108,12454,24452,12454,24452
պ,SuHeXiang,621225203,13037,1309,9054,4189,18738,9028,4555,9743,18771,9847,18901
¬,LuHeXiang,621225204,16767,1698,11496,4941,23770,11434,5387,12180,23614,12356,23852
¡,XingLongXiang,621225205,13912,1491,9513,4021,19705,9513,4400,10290,19803,10290,19803
,ShaoYuXiang,621225206,12237,1256,9124,3899,18178,9124,4834,9203,18327,9203,18327
Ԫ,MaYuanXiang,621225207,9014,1236,6339,2867,13245,6329,3086,6928,13257,6997,13336
ɹ,ShaiJingXiang,621225208,3055,441,2046,1055,4344,2038,865,2276,4314,2315,4361
ʮ,ShiLiXiang,621225211,27296,2743,19073,8168,38449,18979,8922,19666,38645,19888,38961
,DaQiaoXiang,621225216,6543,889,4635,2144,9353,4602,2161,4877,9479,4958,9593
,HaoLinXiang,621225217,6433,956,4486,1927,9443,4480,2142,5041,9521,5045,9531
̫ʯ,TaiShiHeXiang,621225218,3878,618,2557,1307,5386,2545,946,2816,5361,2885,5442
,LiuXiangXiang,621225220,4085,577,2554,1134,5109,2427,993,2613,5040,3101,5655
ɽ,XiGaoShanXiang,621225221,11375,1511,7905,3597,16482,7905,3664,8638,16543,8645,16550
سǹ,LiXianChengGuanZhen,621226100,44177,3650,27101,13129,44530,23151,10473,25406,48557,31199,58300
ι,YanGuanZhen,621226101,31956,3382,21783,10468,43293,21509,9616,22494,44003,23171,44954
ʯ,ShiQiaoZhen,621226102,20262,2771,13583,7666,28581,13445,6017,15196,28641,15467,29050
׺,BaiHeZhen,621226103,12831,1422,8962,4430,17744,8886,3824,8856,17742,9115,18077
�,KuanChuanXiang,621226200,17845,2546,13243,6800,27204,13234,7047,14170,27404,14195,27438
,YongXingXiang,621226201,15446,1815,10573,5590,21593,10573,4818,11502,22075,11506,22079
ɽ,QiShanXiang,621226202,10247,1332,7290,3634,14623,7271,3366,7633,14904,7655,14945
,MaHeXiang,621226203,7073,893,5092,2661,10273,5050,2531,5273,10323,5405,10497
,HongHeXiang,621226204,7955,1193,5816,2964,11624,5696,2794,5824,11520,6126,11942
ƺ,YongPingXiang,621226208,12526,1388,8494,4571,18084,8490,4365,9778,18268,9785,18279
̳,GuChengXiang,621226209,7818,940,5256,2638,10972,5256,2338,5840,11096,5840,11096
³,YaChengXiang,621226210,7183,1046,4820,2627,10176,4814,2038,5421,10235,5447,10267
ް,LuoBaXiang,621226211,6363,994,4441,2614,9083,4439,2017,4933,9372,4933,9374
ɽ,QiuShanXiang,621226212,6996,1010,4875,2647,9803,4844,2304,5336,10180,5435,10310
ƺ,TaoPingXiang,621226214,8593,1411,5718,3194,11901,5625,2597,6478,12103,6883,12601
ƺ,ShangPingXiang,621226215,3827,677,2680,1558,5548,2648,1163,2905,5553,2987,5667
,JiangKouXiang,621226218,5728,865,4076,2274,8203,4054,1770,4230,8284,4287,8363
,LeiWangXiang,621226219,7502,998,5378,2773,10992,5357,2643,5686,11043,5765,11143
,LongLinXiang,621226220,12256,1759,8646,4296,17859,8614,4133,9387,18001,9502,18148
а,ZhongBaXiang,621226221,11441,1651,7640,4130,15963,7507,3068,8133,15640,8520,16160
׹,BaiGuanXiang,621226222,12973,1638,8579,4133,17994,8579,3518,9544,18123,9550,18129
ɳ,ShaJinXiang,621226224,5498,728,3535,1861,7473,3522,1332,3914,7436,4023,7558
ͷ,QiaoTouXiang,621226227,8953,1045,6205,2885,12537,6200,2651,6403,12603,6444,12649
ƺ,CaoPingXiang,621226228,5638,636,3648,1813,7695,3646,1498,4086,7732,4124,7772
װ,LeiBaXiang,621226229,6310,940,4480,2148,9070,4439,1967,4604,9043,4737,9217
,WangBaXiang,621226230,6841,1178,5068,2534,9822,5035,2197,5005,10040,5148,10216
Ф,XiaoLiangXiang,621226231,5007,817,3396,1616,6840,3379,1390,3761,7140,3818,7214
,SanYuXiang,621226232,3994,700,2498,1217,5462,2477,899,3019,5496,3095,5593
̲ƺ,TanPingXiang,621226233,7843,1206,5370,2474,11127,5366,2150,5788,11154,5829,11199
ǹ,ChengGuanZhen,621227100,29644,2963,19696,11857,33691,18835,7036,19056,37891,19947,39643
,FuJiaZhen,621227101,17042,2087,11672,6781,22307,11170,4531,11575,22745,11988,23660
,JiangLuoZhen,621227102,13866,1772,9285,5216,18601,8965,3566,9511,18476,9919,19204
,NiYangZhen,621227103,9570,1224,6540,3644,13035,6496,2490,6657,13153,6744,13284
,LiuLinZhen,621227104,7318,916,4327,2555,8575,4017,1306,4436,8453,5213,9540
,JiaLingZhen,621227105,7402,1052,4658,2482,9709,4442,1503,4932,9374,5299,9957
,YongNingZhen,621227106,7217,1022,4886,2919,9727,4865,1760,5083,9948,5113,9999
,YinXingXiang,621227201,10892,1306,7165,4031,14614,7165,2608,7631,14796,7641,14806
ˮ,ShuiYangXiang,621227202,9571,1166,6344,3618,12445,6328,2292,6632,12960,6685,13029
,LiChuanXiang,621227203,8835,1212,6224,3616,12182,6199,2507,6273,12472,6330,12554
,MaYanXiang,621227205,5975,1037,4089,2393,8152,3962,1485,4198,8160,4408,8497
,GaoQiaoXiang,621227206,4249,777,2876,1741,5930,2860,1035,3083,5943,3185,6061
,YuShuXiang,621227208,4319,660,2876,1616,5935,2858,1033,3078,5936,3136,6012
ӵ,DaHeDianXiang,621227210,6152,928,3949,2252,8207,3936,1323,4412,8348,4454,8403
ݹ,YuGuanXiang,621227211,4377,509,2596,1374,5094,2407,759,2687,5094,3049,5645
ǹ,ChengGuanZhen,621228100,9099,753,5602,3223,10496,5132,1625,5303,10435,5875,11477
վ,ZhanErXiangZhen,621228101,2959,476,1832,1336,3531,1822,512,2099,3921,2115,3947
,XiPoZhen,621228102,3874,447,2374,1544,4740,2366,754,2672,5038,2701,5075
,YangDianXiang,621228200,2773,428,1732,1033,3674,1663,494,1823,3486,1963,3695
,ZuoJiaXiang,621228201,1917,264,1157,696,2369,1135,320,1247,2382,1344,2501
,XianLongXiang,621228202,2439,369,1529,1012,3214,1528,505,1764,3292,1784,3313
,YuChiXiang,621228203,1798,260,1125,694,2362,1125,349,1278,2403,1282,2407
˻,XingHuaXiang,621228204,1585,240,977,578,2043,977,285,1132,2109,1133,2110
ż,ZhangJiaXiang,621228207,1287,205,789,445,1574,733,212,805,1538,915,1704
,YunPingXiang,621228209,1922,416,1212,841,2619,1212,347,1462,2674,1473,2685
̩ɽ,TaiShanXiang,621228210,781,137,428,317,971,424,96,580,1004,586,1014
,JinDongXiang,621228212,4150,617,2517,1599,5145,2510,703,2911,5421,2953,5470
Ͻֵ,ChengNanJieDao,622901001,11047,1456,7415,4761,9513,7224,2396,6954,14178,7484,14899
Ǳֵ,ChengBeiJieDao,622901002,25946,3227,17283,10892,20607,16539,5192,15957,32496,17082,34365
ؽֵ,DongGuanJieDao,622901003,18166,1939,12291,6694,13948,12015,4781,11691,23706,12595,24886
ؽֵ,XiGuanJieDao,622901004,30763,3114,18913,10822,25570,18768,6866,18290,37058,21830,40743
˷ֵ,BaFangJieDao,622901005,9813,1152,6526,2976,8997,5693,2222,5451,11144,6661,13187
԰ֵ,HongYuanJieDao,622901006,16554,1975,11060,7000,12344,10884,3641,10694,21578,11110,22170
ǽ,ChengJiaoZhen,622901100,31719,3066,22037,9791,23912,18723,7612,18597,37320,20360,42397
,FuHanZhen,622901101,23581,2924,16457,7711,28955,16237,6848,16556,32793,16896,33353
,NanLongZhen,622901102,18861,2174,12467,6871,19777,12377,4781,12970,25347,13349,25816
,ZheQiaoZhen,622901103,16637,1994,11134,5561,18732,10467,4019,10577,21044,11516,22650
,HanJiZhen,622921100,12687,1523,8804,3988,15491,7887,3760,8011,15898,9166,17970
,TuQiaoZhen,622921101,11707,1389,7694,4010,14527,7548,2471,7653,15201,7873,15567
�,MaJiZhen,622921102,9526,1599,7152,3214,14042,7142,3314,7260,14402,7287,14439
,LianHuaZhen,622921103,5122,568,3425,1622,6581,3424,1136,3398,6822,3401,6826
¼,XinJiZhen,622921104,13248,1681,9230,4438,17705,9189,3665,9305,18494,9364,18594
,YinJiZhen,622921105,18607,2723,13375,6288,26137,13306,5399,13237,26543,13354,26729
Ӫ̲,YingTanXiang,622921200,7430,1014,5315,2359,10468,5315,2446,5563,10878,5575,10890
ӹ,ZhangZiGouXiang,622921201,5364,775,3959,1817,7588,3959,1874,4054,8013,4054,8013
¹,MaNiSiGouXiang,622921202,12356,1737,9096,4174,17637,9091,4102,9045,18136,9099,18195
Į๵,MoNiGouXiang,622921204,6405,1023,4976,2317,9491,4976,2340,4771,9747,4792,9768
,DiaoQiXiang,622921205,14076,2010,9991,4652,19663,9972,4272,10247,20219,10367,20358
·,ManLuXiang,622921208,11948,1579,8007,3783,16178,8006,3087,8597,16603,8607,16614
,YuLinXiang,622921209,9183,1289,6515,2966,12769,6512,2758,6693,13205,6715,13230
,JingGouXiang,622921210,11029,1430,7556,3451,14720,7550,3098,7953,15503,8001,15557
ܫ,BeiYuanXiang,622921211,12703,1518,8644,4162,16450,8635,3087,8622,17257,8664,17308
ͷ,PoTouXiang,622921213,4542,566,3004,1503,5917,3004,1026,3129,6133,3130,6134
,QiaoSiXiang,622921214,8191,994,5499,2752,10572,5486,1897,5566,11052,5583,11082
ȷ,XianFengXiang,622921215,10832,1324,7349,3690,14013,7304,2363,7127,14431,7170,14519
,HeXiXiang,622921216,5472,684,4037,1769,7562,4019,1679,3762,7781,3798,7835
,AnJiaPoXiang,622921217,7029,819,4978,2268,9524,4978,2069,4922,9900,4939,9917
ܫ,NanYuanXiang,622921218,7520,795,4934,2512,9783,4934,1693,5074,10008,5074,10008
̨,HongTaiXiang,622921220,10614,1352,7335,3402,14169,7326,2986,7602,14928,7617,14952
,HuangNiWanXiang,622921222,7064,910,4895,2349,9281,4880,1919,4897,9777,4998,9893
·,LuPanXiang,622921223,4008,493,2649,1313,5166,2649,953,2805,5454,2805,5454
,MinZhuXiang,622921224,4663,603,3086,1604,6078,3086,1005,3185,6271,3185,6271
,FuChengZhen,622922100,23330,2064,15881,8242,27726,15250,7069,15781,31031,16582,32463
ռ,SuJiZhen,622922101,12688,1808,9281,4328,17350,9212,3765,8829,18041,8980,18261
֬,YanZhiZhen,622922102,13581,1892,10487,4724,20247,10486,5372,10311,20797,10358,20845
,JingGuZhen,622922103,9877,1076,6806,3457,12591,6726,2348,6330,13056,6495,13301
´,LianLuZhen,622922104,7583,734,5066,2492,9526,4957,1891,4807,9764,5142,10208
,KangFengXiang,622922200,10678,1253,7812,3432,14628,7804,3623,7685,15489,7742,15554
,HuGuanXiang,622922201,14263,1692,10412,4699,20147,10409,4845,10369,20778,10388,20800
,LiuChuanXiang,622922202,9281,1202,7234,3149,13574,7230,3751,6963,14193,7000,14234
,BaiWangXiang,622922203,7927,1045,5875,2624,11090,5864,2837,5891,11755,5934,11809
,BaSongXiang,622922205,8114,1002,5475,2778,10740,5468,1933,5546,11014,5574,11049
¹,MingLuXiang,622922206,8017,1129,5872,2693,11228,5847,2507,5698,11545,5781,11653
˵,BaDanXiang,622922207,5852,800,4373,1926,8567,4373,2168,4425,8798,4447,8820
,ShangWanXiang,622922208,12492,1532,9549,3975,18631,9547,4969,9416,18963,9444,18993
̲,CaoTanXiang,622922211,10284,1378,7502,3241,14843,7500,3552,7687,15187,7712,15214
廧,WuHuXiang,622922212,7395,786,5061,2477,9662,5046,1788,4876,9922,4908,9969
Ͽ,LiuJiaXiaZhen,622923100,36841,3943,24179,15651,33013,22384,7721,21691,44075,24326,48505
ιϿ,YanGuoXiaZhen,622923101,17052,2033,10709,6258,20825,10152,3287,10495,20647,11663,22372
̫,TaiJiZhen,622923102,15952,1630,9926,4688,17590,9072,2893,9205,18277,10549,20475
,XiHeZhen,622923103,7724,876,4915,2696,9599,4847,1581,5000,9847,5266,10181
ܫ,SanYuanZhen,622923104,11951,1307,7838,4390,15373,7650,2545,7660,15310,7965,15803
ܫ,XianYuanZhen,622923105,5791,732,3882,2080,7501,3857,1177,3772,7629,3818,7700
¾,ChenJingZhen,622923106,5920,957,3764,2265,7303,3676,988,3837,7513,4101,7865
,ChuanChengZhen,622923107,3680,453,2486,1307,5006,2476,1113,2731,5207,2760,5246
̨,WangTaiZhen,622923108,4378,496,2906,1410,5449,2830,1113,2900,5730,3081,5987
Ȫ,HongQuanZhen,622923109,2998,379,1887,1024,3615,1853,562,1970,3823,2052,3939
ɽ,GuanShanXiang,622923200,5062,695,3065,1893,6167,2992,773,3328,6320,3465,6530
춥,XuDingXiang,622923201,2530,404,1554,919,3046,1496,414,1620,3116,1794,3348
,SanTiaoXianXiang,622923202,2384,352,1608,961,3170,1606,530,1643,3249,1658,3266
ƺ,PingGouXiang,622923203,3136,391,2013,1058,3842,1990,654,2082,4072,2168,4181
,XinSiXiang,622923206,4526,568,2993,1505,5564,2945,1080,3072,6017,3181,6174
С,XiaoLingXiang,622923207,3629,551,2587,1220,5244,2584,1237,2806,5390,2830,5417
,YangTaXiang,622923208,2443,304,1535,868,2960,1494,425,1587,3081,1637,3172
ǹ,ChengGuanZhen,622924100,30512,2929,21400,9429,37686,20707,10951,20902,41609,22992,44392
׼,SanJiaJiZhen,622924101,28673,3179,22020,8462,40599,21990,12137,21699,43689,21969,43989
Ҽ,QiJiaJiZhen,622924102,22442,2575,17366,6438,33416,17330,9631,17111,34441,17282,34648
ׯ̼,ZhuangHeJiZhen,622924103,13599,1784,10568,4345,20132,10565,5909,10634,21199,10724,21292
,MaiJiaXiangZhen,622924104,13810,1765,10793,4187,19290,10770,5609,10224,20994,10391,21184
,QiJiaZhen,622924105,13869,1470,10577,4099,20046,10565,5976,10612,21177,10738,21315
ˮȪ,ShuiQuanXiang,622924202,11632,1408,9175,3461,17633,9165,5226,9025,18190,9091,18266
ٷ,GuanFangXiang,622924203,5245,730,4045,1617,7686,4038,2107,3979,8017,4037,8082
,ALiMaTuXiang,622924204,9451,1049,7144,2602,13799,7140,3798,7099,14239,7154,14298
ǹ,ChengGuanZhen,622925100,22595,2230,15146,7571,25690,14165,5533,13984,28149,15212,30358
,SanHeZhen,622925101,7290,815,4942,2292,9286,4899,1921,4919,9818,5084,10026
ʮ,SanShiLiPuZhen,622925102,12601,1492,9080,3985,16950,9052,4290,9066,18118,9303,18383
ұ,MaJiaBaoZhen,622925103,10089,1128,7097,3197,13635,7095,3174,7259,14354,7294,14391
Ҽ,MaiJiaJiZhen,622925104,7928,986,5541,2615,10340,5504,2229,5469,10973,5602,11143
,LiangJiaSiXiang,622925200,8468,846,6050,2523,11701,6046,3017,6220,12266,6281,12331
¼Ҽ,ChenJiaJiXiang,622925201,7856,955,5430,2495,10627,5430,2424,5780,11210,5805,11235
޼Ҽ,LuoJiaJiXiang,622925202,8193,1053,5640,2797,10803,5627,2148,5729,11356,5754,11394
ׯ,BuJiaZhuangXiang,622925203,6607,867,4847,2181,9260,4847,2169,4784,9631,4796,9643
Ӫ,XinYingXiang,622925204,8683,1190,6147,2899,11963,6144,2588,6285,12429,6314,12461
ׯ,XinZhuangXiang,622925205,11588,1401,7904,3788,15505,7900,3146,8201,16101,8231,16135
̲,DiaoTanXiang,622925206,10831,1309,7581,3496,14895,7542,3193,7600,15142,7752,15333
,DaLangXiang,622925207,8484,983,6142,2765,11915,6137,2783,6073,12210,6108,12250
,SuoNanZhen,622926100,17301,1301,10509,3867,21530,8517,4897,9217,17734,12990,23499
,DaBanZhen,622926101,16716,1685,12322,4892,23456,12241,5776,11707,23948,11855,24177
̲,HeTanZhen,622926102,21593,2343,14706,6294,28487,14434,5582,14413,28847,14812,29518
,NaLeSiZhen,622926103,15909,1492,11537,4483,23100,11491,6700,12386,23877,12564,24101
,TangWangZhen,622926104,9039,1223,6446,2780,12167,6390,2354,6024,12414,6170,12616
̨,ChunTaiXiang,622926200,7205,754,4997,2015,9936,4976,2441,5346,10322,5403,10400
,LiuShuXiang,622926201,4145,480,2982,1198,5826,2953,1502,3031,5984,3145,6127
ܫ,DongYuanXiang,622926202,9629,955,6936,2701,13511,6858,3416,6888,13746,7064,14000
ƺׯ,PingZhuangXiang,622926204,8481,925,6293,2428,12481,6276,3524,6594,12870,6637,12930
ٺ,BaiHeXiang,622926205,6971,736,4970,1979,9752,4935,2607,5242,10177,5344,10314
ز,GuanBuXiang,622926206,5808,666,4116,1660,7987,4103,1952,4259,8362,4310,8426
Լ,ZhaoJiaXiang,622926208,6072,629,4528,1808,9089,4511,2751,4824,9335,4924,9452
,WuJiaXiang,622926209,6765,629,5190,2114,10373,5173,3257,5418,10591,5461,10651
԰,GuoYuanXiang,622926210,10782,1115,8029,3071,15741,8000,4682,8443,16443,8550,16579
,YanLingXiang,622926212,3807,379,2805,1128,5375,2786,1544,2892,5678,2925,5730
,WangJiXiang,622926213,7721,688,5669,2372,10796,5625,3305,5915,11540,6045,11714
ɽ,FengShanXiang,622926214,3848,374,2793,1138,5537,2789,1607,3017,5806,3036,5829
,CheJiaWanXiang,622926215,2568,247,1887,744,3777,1873,1136,2001,3874,2064,3951
ɽ,GaoShanXiang,622926216,2092,221,1551,638,3092,1549,907,1658,3207,1669,3220
,DaShuXiang,622926219,5473,500,3974,1504,8037,3961,2382,4347,8308,4381,8355
,BeiLingXiang,622926220,3210,307,2370,972,4653,2345,1321,2411,4756,2468,4838
Ȫ,LongQuanXiang,622926221,8611,793,6324,2701,12409,6268,3829,6722,12990,6909,13233
,KaoLeXiang,622926222,5794,588,4316,1878,8476,4280,2548,4429,8709,4614,8930
,DongLingXiang,622926223,3840,335,2772,1232,5623,2729,1742,3009,5738,3145,5917
̲,ChuiMaTanZhen,622927100,18369,1689,12614,6105,21307,12066,5986,12423,24489,13430,26044
Ӽ,DaHeJiaZhen,622927101,18673,2100,13962,5605,26643,13877,7182,13792,27669,13993,27955
Ӽ,JuJiZhen,622927102,8884,1081,6537,2743,12601,6522,3169,6525,13047,6597,13134
,BieCangZhen,622927103,9712,1217,7417,3008,13978,7321,3791,7073,14394,7303,14720
,LiuJiXiang,622927200,11035,1301,7884,3343,15474,7854,3595,7979,15833,8047,15931
ʯܫ,ShiYuanXiang,622927201,6519,814,4912,2238,9212,4883,2250,4618,9501,4671,9583
,LiuGouXiang,622927202,7356,914,5372,2282,10524,5370,2624,5513,10883,5522,10894
ؼҴ,GuanJiaChuanXiang,622927203,7671,922,5552,2474,10844,5517,2618,5558,11075,5659,11211
ּ,HuLinJiaXiang,622927204,8292,1037,6185,2632,12036,6165,3128,6195,12360,6272,12457
,AnJiXiang,622927205,9107,1086,6536,3133,12510,6484,2682,6246,12730,6339,12875
կӹ,ZhaiZiGouXiang,622927206,9069,1093,6545,2690,12631,6532,3114,6653,13185,6731,13276
,GuoGanXiang,622927207,4403,563,3377,1442,6462,3362,1741,3293,6655,3330,6707
,XuHuJiaXiang,622927208,5857,726,4654,1937,8994,4653,2830,4735,9388,4759,9413
о,ZhongJuLingXiang,622927209,7600,997,5691,2355,11013,5671,2836,5673,11344,5742,11433
С,XiaoGuanXiang,622927210,6806,924,5049,2096,9775,5030,2490,5049,10079,5171,10220
̴,PuChuanXiang,622927211,7194,834,5306,2212,10236,5282,2573,5178,10460,5295,10601
,YinChuanXiang,622927212,13060,1493,9571,3748,18996,9550,4691,9576,19126,9673,19244
ֵܽ´,DangZhouJieDaoBanShiChu,623001001,13498,462,7427,2469,11069,3904,1669,3923,7827,8202,15629
ϰֵ´,YiHeAngJieDaoBanShiChu,623001002,9251,678,6014,3779,8988,5685,2239,5640,11325,6154,12168
ľ˶ֵ´,JianMuKeErJieDaoBanShiChu,623001003,9779,835,6543,3795,9699,6392,2827,6425,12817,6898,13441
ͨսֵ´,TongQinJieDaoBanShiChu,623001004,14347,698,8651,5489,12735,7606,2865,7598,15204,9259,17910
,KaJiaManXiang,623001200,2075,286,1507,651,2898,1502,625,1476,2978,1479,2986
ӵ,KaJiaDaoXiang,623001201,1652,237,1162,415,2215,1132,538,1137,2269,1265,2427
Ƕ,ZuoGaiDuoMaXiang,623001202,2773,337,1861,741,3797,1837,830,1903,3740,2079,3940
,ZuoGaiManMaXiang,623001203,3911,591,2902,1032,5724,2902,1377,2842,5744,2977,5879
,LeXiuXiang,623001204,6393,930,4232,1308,8815,4232,1734,4317,8549,4825,9057
,NaWuXiang,623001205,4556,556,3323,1136,6313,3277,1741,3201,6478,3530,6853
ǹ,ChengGuanZhen,623021100,16069,1619,11338,6037,20597,11212,5347,11362,22574,11697,23035
³,XinChengZhen,623021101,14873,1391,10037,5032,20196,9987,4271,10374,20361,10498,20535
ұ,YeLiGuanZhen,623021102,7624,688,4907,2678,9522,4874,1754,5100,9974,5159,10066
,ChuBuXiang,623021200,2463,235,1613,766,3297,1610,679,1635,3245,1764,3377
ս,GuZhanHuiZuXiang,623021201,3361,343,2324,1195,4554,2320,1013,2375,4695,2393,4717
׿,ZhuoLuoHuiZuXiang,623021202,1444,183,1033,486,1977,1032,473,1060,2092,1067,2100
,ChangChuanHuiZuXiang,623021203,7028,688,4927,2066,9823,4896,2321,5030,9926,5110,10037
,YangYongXiang,623021204,5557,471,3849,1964,7598,3845,1821,3995,7840,4000,7849
˳,LiuShunXiang,623021205,6381,545,4384,2148,8591,4372,1950,4431,8803,4492,8876
,DianZiXiang,623021206,3425,267,2285,1058,4590,2265,1030,2377,4642,2437,4722
䬱,TaoBinXiang,623021207,6652,582,4436,2243,8758,4426,1826,4608,9034,4624,9060
,SanChaXiang,623021208,1757,182,1144,630,2361,1144,454,1248,2392,1249,2393
,WangQiXiang,623021209,8608,917,5767,2975,11731,5761,2416,6129,11890,6174,11941
ʯ,ShiMenXiang,623021210,5348,490,3437,1722,7091,3437,1318,3719,7156,3719,7156
ɳ,YangShaXiang,623021211,4509,408,2920,1439,5947,2861,1125,2995,5856,3122,6042
˽,BaJiaoXiang,623021212,3786,407,2501,1196,4966,2477,902,2501,4978,2594,5095
,LiuLinZhen,623022100,13460,898,8494,5481,16007,8261,3373,8578,16839,9237,17731
ľ,MuErZhen,623022101,6808,519,4541,2321,9087,4535,2103,4866,9401,4889,9430
¼,ZhaGuLuZhen,623022102,4301,477,3059,1566,6020,3059,1591,3310,6369,3310,6369
,NaLangXiang,623022200,5384,421,3426,1714,7079,3369,1470,3770,7139,3849,7275
,KaErQinXiang,623022201,7403,668,4992,2519,10071,4980,2226,5288,10268,5305,10297
,DaoGaoXiang,623022202,3049,441,2241,1047,4628,2241,1323,2572,4813,2572,4813
,NiBaXiang,623022203,3179,584,2708,1008,5195,2708,1488,2543,5251,2543,5251
ð,WanMaoXiang,623022204,2530,335,1878,756,3687,1878,939,1926,3804,1926,3804
,AZiTangXiang,623022205,4867,484,3407,1646,6737,3403,1530,3460,6863,3474,6881
,ShenCangXiang,623022206,5549,569,3821,1730,7651,3820,1652,3948,7768,3949,7770
ǡ,QiaGaiXiang,623022207,2271,301,1575,785,3211,1574,781,1755,3329,1778,3353
,KangDuoXiang,623022208,1589,242,1125,516,2264,1125,517,1223,2348,1223,2348
,ShaoWaTuZuXiang,623022209,1285,115,880,416,1752,879,408,918,1797,928,1808
,TaoYanXiang,623022210,4039,339,2564,1544,5207,2542,951,2744,5286,2765,5329
ذ,CangBaWaXiang,623022211,5892,560,3856,1972,7745,3775,1611,3976,7751,4207,8063
ǹ,ChengGuanZhen,623023100,15709,1484,10641,5971,20497,10538,4774,11047,21585,11326,21967
,DaChuanZhen,623023101,4103,544,2770,1502,5408,2698,1076,2843,5541,2953,5723
,QuWaXiang,623023200,3071,373,2102,1014,4185,2090,926,2227,4317,2268,4370
Ͳ,BaCangXiang,623023201,3576,369,2439,1168,4923,2422,1095,2547,4969,2601,5040
,DaYuXiang,623023202,3748,456,2423,1360,4938,2418,910,2670,5088,2691,5114
,LiJieXiang,623023203,3854,411,2572,1327,5180,2565,1017,2691,5256,2710,5282
,HanBanXiang,623023204,3622,351,2328,1270,4680,2291,934,2525,4816,2579,4907
,FengDieXiang,623023205,7908,915,5247,2719,10672,5164,2122,5545,10709,5698,10945
ƺ,PingDingXiang,623023206,3633,355,2492,1209,4899,2477,1103,2529,5006,2599,5091
,JiangPanXiang,623023207,3687,352,2528,1251,4882,2518,1110,2587,5105,2621,5149
ɽ,DongShanXiang,623023208,7326,828,5195,2871,10345,5179,2485,5402,10581,5444,10639
,NanYuXiang,623023209,2785,449,2004,1166,3865,2002,858,2079,4081,2088,4092
Ү,GuoYeXiang,623023210,5954,764,4504,2286,8786,4491,2345,4515,9006,4559,9063
,BaLengXiang,623023211,2797,371,2139,1075,4044,2131,973,1988,4119,2002,4141
ƺ,WuPingXiang,623023212,3865,550,2797,1570,5475,2792,1241,2831,5623,2859,5656
,ChaGangXiang,623023213,2093,276,1526,821,3027,1526,793,1636,3162,1636,3162
,GongBaXiang,623023214,3564,487,2713,1175,5405,2712,1512,2842,5554,2850,5563
,QuGaoNaXiang,623023215,7386,865,5676,2550,11077,5636,3330,5767,11403,5905,11581
,BoYuXiang,623023216,3130,225,2222,1038,4434,2216,1268,2378,4594,2401,4623
,DianGaZhen,623024100,11736,1006,7594,4695,14860,7489,3251,7949,15438,8399,15993
,YiWaXiang,623024200,3010,443,2365,715,4587,2363,1266,2350,4713,2354,4719
,KaBaXiang,623024201,1539,217,1127,438,2231,1115,546,1107,2222,1175,2302
,DaLaXiang,623024202,1364,228,1054,471,2092,1040,550,1047,2087,1088,2142
,NiAoXiang,623024203,1440,236,1112,446,2192,1112,521,1085,2197,1085,2197
,WangCangXiang,623024204,4713,613,3453,1586,6720,3422,1525,3343,6765,3398,6851
,AXiaXiang,623024205,820,129,648,308,1216,627,328,594,1221,629,1277
,DuoErXiang,623024206,2481,383,1834,600,3749,1807,887,1804,3611,1917,3751
ɣ,SangBaXiang,623024207,2266,281,1727,643,3429,1718,978,1686,3404,1798,3525
ӿ,LaZiKouXiang,623024208,2152,165,1640,743,3249,1636,1014,1641,3277,1691,3331
,LuoDaXiang,623024209,4267,487,2901,1502,5887,2881,1324,3113,5994,3177,6078
,NiMaZhen,623025100,13276,634,7884,5003,13786,7537,3910,8095,15632,9936,17820
ŷ,OuLaXiang,623025200,3428,280,2370,925,4895,2361,1434,2462,4823,2772,5142
ŷ,OuLaXiuMaXiang,623025201,2009,149,1541,670,2899,1505,1025,1566,3071,1642,3183
,AWanCangXiang,623025202,4394,376,3250,1512,6271,3224,1849,3101,6325,3369,6619
ľ,MuXiHeXiang,623025203,2196,176,1724,689,3519,1706,1206,1686,3392,1854,3578
,QiHaMaXiang,623025204,3658,350,2732,1141,5498,2691,1650,2532,5223,2926,5658
,CaiRiMaXiang,623025205,3452,270,2668,1078,5138,2645,1741,2501,5146,2795,5463
,ManRiMaXiang,623025206,4692,461,3400,1397,7081,3379,2129,3406,6785,3882,7282
ľ,LangMuSiZhen,623026100,3457,277,2388,1212,4171,2331,1320,2220,4551,2666,5054
갬,MaAiZhen,623026101,8104,525,5326,3022,9086,4962,2359,4948,9910,5662,10988
غ,GaHaiXiang,623026200,3553,321,2591,1003,4730,2527,1383,2334,4861,2666,5257
,XiCangXiang,623026201,1957,285,1329,957,2423,1317,685,1573,2890,1598,2927
ʹ,LaRenGuanXiang,623026202,1874,213,1458,598,2605,1430,783,1289,2719,1412,2870
˫,ShuangChaXiang,623026203,3496,469,2671,910,5212,2524,1433,2431,4955,2727,5398
,ALaXiang,623026204,1963,303,1548,469,2969,1529,870,1484,3013,1588,3136
,LaBuLengZhen,623027100,17175,1792,10655,6340,17967,10060,4003,9620,19680,12315,22970
,WangGeErTangZhen,623027101,2744,314,1841,746,3340,1711,692,1588,3299,1909,3750
ľȥ,AMuQuHuZhen,623027102,8593,998,6031,2084,12172,5969,3032,6041,12010,6592,12623
ɣ,SangKeXiang,623027200,4806,432,3623,1362,7173,3603,1998,3573,7176,3613,7236
ʼ,GanJiaXiang,623027201,5219,496,3717,1432,7192,3674,1619,3497,7171,3617,7334
,DaMaiXiang,623027202,2626,295,1843,820,3370,1782,712,1667,3449,1790,3633
鵱,MaDangXiang,623027203,4054,574,2763,1164,5239,2645,1034,2574,5219,2899,5662
,QuAoXiang,623027204,2161,230,1416,608,2647,1359,477,1310,2669,1452,2868
ذ,TangGaAngXiang,623027205,1964,286,1349,520,2653,1300,524,1345,2645,1425,2774
,ZhaYouXiang,623027206,2454,379,1828,548,3618,1804,862,1823,3627,1867,3695
,BoLaXiang,623027207,3859,618,2930,939,5583,2885,1269,2739,5624,2816,5746
,JiCangXiang,623027208,3075,459,2306,649,4591,2280,1116,2291,4571,2344,4650
Ʋ,KeCaiXiang,623027209,2570,226,1816,677,3612,1780,933,1862,3642,1913,3729
شֵֽ´,DongGuanDaJieJieDaoBanShiChu,630102001,23875,3162,16187,10354,17115,15419,4857,15001,30420,15707,31894
ֵ´,QingZhenXiangJieDaoBanShiChu,630102002,34294,3908,21919,14131,24860,21668,7118,21375,43043,23401,45320
ڽֵֽ´,DaZhongJieJieDaoBanShiChu,630102003,34140,4198,21730,13493,20832,21402,7841,21243,42645,24449,46179
ܼȪֵ´,ZhouJiaQuanJieDaoBanShiChu,630102004,22272,2647,14123,9833,11977,13571,4952,14004,27575,15748,29871
վֵ´,HuoCheZhanJieDaoBanShiChu,630102005,24076,3077,15026,10295,17567,14136,4324,14074,28210,16451,31477
һ·ֵ´,BaYiLuJieDaoBanShiChu,630102006,53821,6704,34441,22121,32682,29632,9366,29262,58894,35450,69891
ּ½ֵ´,LinJiaYaJieDaoBanShiChu,630102007,20022,2251,13235,8413,12935,13124,5010,13585,26709,14048,27283
ּ,LeJiaWanZhenRenMinZhengFu,630102100,28041,2680,16915,11230,16934,15380,4919,14883,30263,18725,35640
ϼҿ,YunJiaKouZhenRenMinZhengFu,630102101,32286,3076,19391,13656,20996,18997,6771,19943,38940,22742,42133
ֵֽ´,RenMinJieJieDaoBanShiChu,630103001,14224,2262,9519,6853,11625,9010,2370,8679,17689,9337,18856
ֵ̲´,NanTanJieDaoBanShiChu,630103002,38325,5551,25258,18061,32015,24373,6693,23571,47944,25311,50569
Žֵֽ´,CangMenJieJieDaoBanShiChu,630103003,17743,1899,10690,6513,14353,8841,2366,8665,17506,11318,22008
ýֵֽ´,LiRangJieJieDaoBanShiChu,630103004,18187,3170,12347,9042,15650,11965,2770,11367,23332,11780,24127
ֵֽ´,YinMaJieJieDaoBanShiChu,630103005,22890,2999,15222,10164,17205,13936,3813,13417,27353,14480,29702
ϴ·ֵ´,NanChuanDongLuJieDaoBanShiChu,630103006,24573,3346,15896,12307,18098,15598,4256,15644,31242,16279,32175
ϴ·ֵ´,NanChuanXiLuJieDaoBanShiChu,630103007,54636,6100,34433,24969,29364,32113,9439,32184,64297,35742,70175
կ,ZongZhaiZhen,630103100,37093,3208,24597,13772,32869,23402,9074,23086,46488,24778,49375
شֵֽ´,XiGuanDaJieJieDaoBanShiChu,630104001,28215,3737,18836,11559,20768,15330,4289,14299,29629,17405,36241
ųֵ̨´,GuChengTaiJieDaoBanShiChu,630104002,29369,3996,19093,13543,21979,17514,4680,16917,34431,18952,38045
ֵ̨´,HuTaiJieDaoBanShiChu,630104003,65930,6655,42599,27328,47802,35912,10988,35417,71329,40974,83573
ʤ·ֵ´,ShengLiLuJieDaoBanShiChu,630104004,22621,2772,12584,8812,14665,11598,3207,11598,23196,16016,28600
˺·ֵ´,XingHaiLuJieDaoBanShiChu,630104005,24140,2982,15852,10770,20164,14351,3840,14026,28377,15110,30962
կ,PengJiaZhaiZhen,630104100,20220,1366,10034,6117,11819,9325,3620,9548,18873,15172,25206
ֵ´,ZhaoYangJieDaoBanShiChu,630105001,56346,5916,33990,25584,33239,33242,9827,34866,68108,38099,72089
СŴֵֽ´,XiaoQiaoDaJieJieDaoBanShiChu,630105002,76990,8270,48568,34256,48985,44177,13241,44228,88405,49933,98501
�ֵ´,MaFangJieDaoBanShiChu,630105003,46449,6354,30093,21864,41697,29479,8426,29271,58750,31136,61229
,DaBuZiZhen,630105100,19424,1987,12730,7456,22464,12564,4638,12876,25440,13319,26049
ʮ,ErShiLiPuZhen,630105101,34271,2146,18555,7949,26995,13214,4717,13175,26389,22579,41134
ͷ,QiaoTouZhen,630121100,86834,7174,56050,34131,95156,54618,20704,55848,110466,58662,114712
ǹ,ChengGuanZhen,630121101,17781,1210,12147,5618,22487,11632,5419,11963,23595,12263,24410
,TaErZhen,630121102,22544,1376,15262,6872,30046,15247,7533,15896,31143,16191,31453
Ͽ,DongXiaZhen,630121103,10500,758,6866,3598,13809,6727,3004,7267,13994,7396,14262
Ƽկ,HuangJiaZhaiZhen,630121104,26142,2222,16597,9514,32433,16454,6524,17559,34013,18291,34888
,ChangNingZhen,630121105,29020,2096,18883,8744,36786,18353,8121,19150,37503,20354,39237
,JingYangZhen,630121106,17880,1540,12006,5595,23935,11794,5072,12264,24058,12486,24492
,DuoLinZhen,630121107,7053,442,4619,2178,9329,4610,2051,4919,9529,4927,9546
ׯ,XinZhuangZhen,630121108,11182,644,7736,3213,14619,7707,3959,7719,15426,8049,15785
,QingLinXiang,630121200,6989,458,4936,2442,9475,4923,2274,4751,9674,4785,9721
ɽ,QingShanXiang,630121201,11333,806,7566,3686,15398,7566,3444,8014,15580,8017,15583
ѷ,XunRangXiang,630121202,8758,546,5806,2814,11866,5805,2694,6192,11997,6192,11998
,JiLeXiang,630121203,8418,501,5974,2681,11427,5972,2989,5924,11896,5934,11908
ʯɽ,ShiShanXiang,630121204,4800,316,3505,1663,7005,3505,2000,3598,7103,3611,7116
,BaoKuXiang,630121205,6942,432,4158,2057,8047,4103,1822,4242,8345,5038,9196
б,XieGouXiang,630121206,5358,342,3829,1802,7295,3828,1934,3793,7621,3805,7634
,LiangJiaoXiang,630121207,12071,789,8377,3807,16223,8377,4180,8657,17034,8663,17040
,XiangHuaXiang,630121208,4946,424,3237,1708,6682,3232,1439,3560,6792,3572,6809
,HuaLinXiang,630121209,9248,725,6348,3196,12546,6344,3076,6672,13016,6701,13049
˷,ShuoBeiXiang,630121210,12608,952,8289,4248,16631,8265,3538,8728,16993,8809,17098
³ɳ,LuShaErZhen,630122100,52037,3456,30605,15650,51304,27419,11660,28578,55997,36548,67153
,XiBaoZhen,630122101,16952,1604,11210,5973,22051,11150,4575,11807,22957,11921,23131
ׯ,ShangXinZhuangZhen,630122102,23190,1724,15578,7872,31112,15494,7523,16660,32154,16859,32437
կ,TianJiaZhaiZhen,630122103,27540,2647,17957,10102,36911,17624,8042,19906,37530,20272,38229
ʺ̲,GanHeTanZhen,630122104,18653,1293,10768,5434,19001,10129,4306,10672,20801,13484,24252
,GongHeZhen,630122105,21259,1896,14477,7761,28469,14465,6168,14756,29221,14846,29323
,DuoBaZhen,630122106,48662,4130,32799,16603,57722,31382,13975,32015,63397,33968,66767
¡,LanLongKouZhen,630122107,26513,2344,17685,9657,35035,17326,7744,18561,35887,18916,36601
ׯ,ShangWuZhuangZhen,630122108,19024,1617,13442,6433,26229,13442,7028,14191,27633,14227,27669
ɽ,LiJiaShanZhen,630122109,17501,1503,11678,6217,22874,11390,5108,12101,23491,12434,24112
Ⱥ,QunJiaXiang,630122200,1529,151,1077,533,1998,1064,471,1026,2090,1074,2151
Ź,TuMenGuanXiang,630122201,10793,1247,7264,4059,14634,7251,3288,8038,15289,8064,15328
,HanDongXiang,630122202,9449,914,6863,2937,13307,6821,3553,6787,13608,7053,13916
,DaCaiXiang,630122203,16068,1247,11591,5272,22833,11554,6262,11929,23483,11986,23577
ӹ,HaiZiGouXiang,630122204,9399,965,6309,3484,12863,6309,2825,6874,13183,6880,13189
ǹ,ChengGuanZhen,630123100,33733,3175,22413,14821,32774,21112,6963,20174,41286,21458,43871
,DaHuaZhen,630123101,15891,1274,9912,5398,20228,9878,3723,10807,20685,10976,20888
Ͽ,DongXiaXiang,630123200,4481,417,2751,1542,5473,2716,1033,2949,5665,3180,5931
,RiYueXiang,630123201,10048,787,6304,3405,12813,6212,2480,6838,13050,7011,13315
ƽ,HePingXiang,630123202,10243,941,6408,3554,13271,6370,2444,7162,13532,7220,13628
,BoHangXiang,630123203,6418,573,3997,2175,8375,3995,1487,4481,8476,4481,8478
,ShenZhongXiang,630123204,11086,912,7124,3651,14230,7096,2596,7343,14439,7470,14594
,BaYanXiang,630123205,7134,682,4687,2615,9237,4680,1753,4812,9492,4882,9569
կ,SiZhaiXiang,630123206,4779,457,2976,1677,6167,2961,1122,3343,6304,3382,6358
ƽ,PingAnZhen,632121100,42782,4184,28234,18729,40901,27099,10186,26314,53413,28918,57152
СϿ,XiaoXiaZhen,632121101,7840,682,5126,2927,9420,5047,2101,5069,10116,5497,10623
,SanHeZhen,632121102,5906,918,4102,2625,8130,4082,1587,4278,8360,4309,8411
ˮȪ,HongShuiQuanXiang,632121200,1898,307,1328,774,2579,1328,555,1432,2760,1432,2760
ʯҤ,ShiHuiYaoXiang,632121201,3311,427,2377,1399,4621,2376,1111,2466,4842,2472,4849
ų,GuChengXiang,632121202,5950,683,4180,2263,7842,4129,2017,4271,8400,4470,8650
ɳ,ShaGouXiang,632121203,5181,587,3716,1888,7065,3689,1728,3668,7357,3780,7496
Ͳع,BaCangGouXiang,632121204,2063,292,1458,871,2915,1448,679,1540,2988,1576,3034
,ChuanKouZhen,632122100,49842,4319,34473,18853,54111,33634,15091,33307,66941,34779,69252
۷,GuShanZhen,632122101,15823,1304,10333,5010,21264,10228,4729,11303,21531,11523,21856
Ӫ,MaYingZhen,632122102,15808,1429,10672,4385,21662,10305,5178,11207,21512,11743,22415
ͤ,GuanTingZhen,632122103,11744,936,7638,3921,13606,6971,3098,7366,14337,8140,15778
,BaZhouZhen,632122104,12530,1221,8981,3995,17572,8971,4359,9121,18092,9129,18110
ƺ,ManPingZhen,632122105,9934,918,6741,3297,13919,6722,3510,7597,14319,7621,14362
,LiErBaoZhen,632122106,11334,1103,7918,3533,15850,7918,3894,8412,16330,8413,16331
Ͽ,XiaMenZhen,632122107,9154,877,5902,3002,12043,5863,2452,6509,12372,6581,12483
�ԫ,MaChangYuanXiang,632122200,14289,1285,9102,4105,16333,8942,4281,9017,17959,10753,19855
ɽ,BeiShanXiang,632122201,2476,278,1636,895,3311,1618,654,1739,3357,1772,3408
,SongShuXiang,632122202,4925,431,3019,1514,5901,2970,1353,3143,6113,3690,6709
,XiGouXiang,632122203,13513,1124,9485,4161,18373,9480,4805,9922,19402,9957,19442
ܱ,ZongBaoXiang,632122204,8984,717,5790,2817,11886,5686,2475,6182,11868,6386,12176
¡,LongZhiXiang,632122205,5634,617,3624,1861,7495,3623,1385,4006,7629,4012,7636
ׯ,DaZhuangXiang,632122206,6780,633,5017,2079,9887,4995,2991,5364,10359,5387,10404
ת,ZhuanDaoXiang,632122207,10235,982,7222,3093,14533,7213,3857,7809,15022,7852,15074
ǰ,QianHeXiang,632122208,6079,649,4139,1972,8464,4139,2069,4654,8793,4658,8797
ʹ,GanGouXiang,632122209,7805,829,5593,2579,10983,5593,2810,5850,11443,5851,11444
д,ZhongChuanXiang,632122210,17436,1663,11834,5048,23970,11834,5031,12243,24077,12296,24130
Ӷ,XingErXiang,632122211,2782,249,2014,874,4034,1997,1057,2010,4007,2074,4088
ׯ,HeTaoZhuangXiang,632122212,6380,726,4482,2003,8902,4472,2240,4727,9199,4864,9346
,XinMinXiang,632122213,5116,560,3365,1686,6825,3365,1346,3656,7021,3657,7022
벮,NianBoZhen,632123100,56873,5228,37960,21753,59468,34797,13833,34272,69069,37974,75934
,YuRunZhen,632123101,10877,1140,7180,4585,13720,7115,2498,7137,14252,7335,14515
,ShouLeZhen,632123102,16631,1671,10775,6336,21658,10695,3925,11272,21967,11452,22227
,GaoMiaoZhen,632123103,17048,1877,11484,5621,21218,10901,4473,11199,22100,11914,23398
ˮ,HongShuiZhen,632123104,11537,1396,7784,4399,15081,7441,3162,7604,15045,8311,16095
ߵ,GaoDianZhen,632123105,6299,687,4156,2373,7843,4079,1402,4050,8129,4232,8388
,QuTanZhen,632123106,13829,1405,8929,4676,18316,8819,3367,9440,18259,9672,18601
,GongHeXiang,632123200,5449,678,3641,2124,7091,3638,1346,3832,7470,3832,7473
,ZhongLingXiang,632123201,4321,491,2821,1675,5717,2819,1011,3001,5820,3002,5823
,LiJiaXiang,632123202,6090,621,3814,2014,7877,3814,1421,4318,8132,4318,8132
Ӫ,XiaYingZangZuXiang,632123203,2533,410,1754,1017,3421,1754,692,1879,3633,1881,3635
«,LuHuaXiang,632123204,5674,594,3551,1835,7235,3540,1248,3946,7486,3965,7516
Ӫ,MaYingXiang,632123205,7583,813,4774,2814,9940,4766,1793,5406,10172,5415,10189
�,MaChangXiang,632123206,2715,366,1843,1082,3531,1841,618,1849,3690,1856,3699
̨,PuTaiXiang,632123207,8670,953,5692,3166,11423,5654,2180,6025,11679,6111,11803
аӲ,ZhongBaZangZuXiang,632123208,4923,504,3185,1692,6329,3117,1262,3380,6497,3504,6689
,FengDuiXiang,632123209,3715,434,2474,1401,4968,2455,953,2608,5063,2628,5102
̨,ChengTaiXiang,632123210,2775,318,1707,963,3545,1707,563,1949,3656,1949,3656
,DaLaTuZuXiang,632123211,5409,514,3518,1848,6900,3518,1386,3791,7309,3791,7309
Զ,WeiYuanZhen,632126100,51918,3181,32449,17228,54431,28262,11391,29291,57553,34041,66490
,DanMaZhen,632126101,13755,1050,9235,4992,18676,9212,4369,9908,19120,9939,19174
կ,GaoZhaiZhen,632126102,9396,856,6321,3086,11925,6137,2651,6105,12242,6582,12903
Ͽ,NanMenXiaZhen,632126103,12774,1129,8244,4626,16901,8131,3377,8786,16917,9036,17280
Ӷ,JiaDingZhen,632126104,5225,459,3421,1728,6537,3322,1395,3392,6714,3658,7079
,TangChuanZhen,632126105,28408,2299,18437,8937,36586,18028,7700,18976,37004,19970,38407
ʮ,WuShiZhen,632126106,13442,939,8467,4538,16995,8014,3686,9041,17055,9600,18067
,WuFengZhen,632126107,16849,1201,10692,5247,22547,10551,4725,11750,22301,12083,22775
̨,TaiZiXiang,632126200,15133,1153,9687,5105,20125,9624,4139,10610,20234,10738,20425
ɽ,XiShanXiang,632126201,12602,1023,8234,4112,17199,8184,3889,9128,17312,9280,17514
ӹ,HongYaZiGouXiang,632126202,12125,1354,8099,4256,16082,7969,3171,8353,16322,8551,16650
,BaZhaZangZuXiang,632126203,3359,279,2186,1208,4282,2167,792,2160,4327,2244,4430
ֱ,HaLaZhiGouXiang,632126204,9926,1086,6611,3395,13501,6550,2674,6933,13483,7075,13686
ɶ,SongDuoZangZuXiang,632126205,4297,420,2730,1434,5663,2701,1104,2980,5681,3091,5821
ɽ,DongShanXiang,632126206,7123,516,4565,2521,9443,4529,2076,5049,9578,5150,9715
,DongHeXiang,632126207,12447,869,7681,4065,15929,7529,3021,8327,15856,8656,16337
,DongGouXiang,632126208,14695,1005,9488,4803,19795,9444,4375,10405,19849,10587,20075
ִ,LinChuanXiang,632126209,17253,1344,10903,6107,22029,10451,4324,11417,21868,12018,22921
̼ұ,CaiJiaBaoXiang,632126210,4912,495,3210,1831,6580,3188,1281,3406,6594,3478,6688
,BaYanZhen,632127100,26934,2047,18925,10713,33771,18564,9334,18662,37226,19390,38315
Ⱥ,QunKeZhen,632127101,15040,1508,11938,5142,21016,11668,6852,10831,22499,11462,23400
ʲ,YaShenGaZhen,632127102,8765,848,7004,3131,12370,6879,3967,6281,13160,6576,13580
ʶ,GanDouZhen,632127103,12454,1453,10496,4514,18890,10448,6629,9926,20374,10040,20536
,ZhaBaZhen,632127104,12385,972,9437,4344,17795,9216,5675,9308,18524,9595,19032
˼,AngSiDuoZhen,632127105,11093,1062,8385,3951,16060,8252,4584,8132,16384,8354,16739
Ȳ,XiongXianZangZuXiang,632127200,5955,414,3847,2008,7486,3772,1864,4219,7991,4386,8233
,ChuMaXiang,632127201,3858,342,2870,1129,5672,2848,1641,2892,5740,2971,5841
鸦,ChaFuXiang,632127202,4021,279,2553,1431,5118,2521,1255,2949,5470,3002,5555
,TaJiaXiang,632127203,2700,288,1939,817,3828,1934,950,1977,3911,1999,3938
Դ,JinYuanXiang,632127204,4343,398,3187,1228,6286,3173,1810,3225,6398,3364,6551
,ErTangXiang,632127205,5394,519,4149,1888,7763,4119,2331,4053,8172,4095,8244
л̲,XieJiaTanXiang,632127206,4540,457,3279,1517,6385,3269,1674,3382,6651,3392,6671
º¡,DeHengLongXiang,632127207,6193,583,4761,2068,9471,4745,2923,4848,9593,4938,9699
ɳ,ShaLianBaoXiang,632127208,2493,260,2045,852,3772,2023,1353,2012,4035,2061,4106
ʲū,AShenNuXiang,632127209,2508,217,1900,830,3746,1895,1156,1946,3841,1981,3881
ʯ,ShiDaCangXiang,632127210,3687,380,2825,1205,5402,2814,1654,2843,5657,2896,5721
ϿίԱ,LiJiaXiaGuanLiWeiYuanHui,632127400,119,12,93,47,158,93,47,85,178,85,178
ϿίԱ,GongBoXiaGuanLiWeiYuanHui,632127401,2116,147,1561,904,2403,1557,834,1509,3066,1536,3097
ʯ,JiShiZhen,632128100,22820,1899,16138,7692,26589,15474,8303,15275,30749,16884,33022
ׯ,BaiZhuangZhen,632128101,13419,1442,10403,4276,20363,10234,6058,10101,20335,10516,20919
,JieZiZhen,632128102,11239,985,8549,3170,16669,8429,5032,8505,16934,8707,17256
,DaoWeiZangZuXiang,632128200,7836,931,5861,2672,11324,5818,2868,5726,11544,5774,11635
ˮ,QingShuiXiang,632128201,8897,826,6889,2550,12837,6776,3822,6400,13176,6656,13545
ڲ,GangChaZangZuXiang,632128202,1289,118,913,372,1804,895,505,894,1789,999,1912
麹˹,ChaHanDouSiXiang,632128203,7226,766,5892,2313,10803,5797,3687,5442,11239,5787,11679
Ķ,WenDouZangZuXiang,632128204,6178,586,4214,1905,7646,3816,1913,4003,7819,4463,8677
,GaLengZangZuXiang,632128205,3457,397,2570,1112,4941,2552,1315,2534,5086,2599,5169
,HaoMenZhen,632221100,27001,1967,17047,10712,28165,16652,7547,16685,33337,19468,36515
ʯ,QingShiJuZhen,632221101,20120,1552,13894,6543,28201,13877,6889,14492,28369,14667,28561
Ȫ,QuanKouZhen,632221102,12960,936,9055,4160,18025,9055,4412,9252,18307,9253,18308
,DongChuanZhen,632221103,13074,882,8654,4341,17834,8654,4026,9325,17979,9328,17982
ɽ,BeiShanXiang,632221200,4452,328,3180,1646,6031,3180,1439,3038,6218,3039,6219
,MaLianXiang,632221201,4093,357,3031,1376,5654,3031,1600,3019,6050,3019,6050
̲,XiTanXiang,632221202,6640,486,4607,2253,9195,4607,2200,4714,9321,4719,9326
,YinTianXiang,632221203,5171,424,3782,1660,7471,3782,2067,3880,7662,3880,7662
,XianMiXiang,632221204,4158,286,2638,1427,5339,2638,1142,2809,5447,2948,5586
,ZhuGuXiang,632221205,3520,252,2286,1194,4585,2274,955,2380,4654,2441,4727
ռ̲,SuJiTanXiang,632221206,1118,100,739,407,1482,739,301,780,1519,780,1519
ʳɹ,HuangChengMengGuZuXiang,632221207,1489,86,828,475,1581,824,346,900,1724,1093,1921
,XuNiDiQu,632221400,1417,44,712,803,1338,705,172,829,1534,921,1633
Դ�,MenYuanZhongMaChang,632221401,1255,108,818,598,1494,811,338,873,1684,883,1701
˱,BaBaoZhen,632222100,18699,1220,12675,8304,20126,12474,5684,12570,25044,12928,25603
뱤,EBaoZhen,632222101,1943,141,1351,823,2471,1316,671,1304,2620,1404,2755
Ĭ,MoLeZhen,632222102,5178,306,3151,1690,5794,3065,1359,3034,6099,3692,6843
ʲ,ZhaMaShenXiang,632222200,2410,198,1628,889,3099,1613,714,1638,3251,1694,3322
,ARouXiang,632222201,2061,173,1376,675,2573,1327,565,1269,2596,1423,2799
Ұţ,YeNiuGouXiang,632222202,2124,99,1289,733,2347,1258,524,1318,2576,1458,2747
¡,YangLongXiang,632222203,1774,92,1134,675,2014,1110,538,1051,2161,1270,2404
ǳ,SanJiaoChengZhen,632223100,8642,525,5363,3408,6555,5038,2029,5161,10199,5833,11196
򣨺פأ,XiHaiZhenHaiBeiZhouZhengFuZhuDi,632223101,10434,289,6637,4401,8022,5767,2438,5857,11624,6524,13161
̲,JinTanXiang,632223200,3706,321,2464,1399,5013,2456,1073,2625,5081,2636,5100
վɹ,HaLeJingMengGuZuXiang,632223201,974,49,659,325,1295,659,295,659,1318,659,1318
ຣ,QingHaiHuXiang,632223202,1738,154,1151,659,2318,1134,550,1167,2301,1291,2442
Ӻ,GanZiHeXiang,632223203,3320,278,2287,1305,4507,2287,973,2284,4571,2284,4571
ɳ,ShaLiuHeZhen,632224100,9601,570,6323,4036,10624,6260,2793,6304,12564,6641,12964
,HaErGaiZhen,632224101,8112,511,4872,2646,9018,4769,2505,5097,9866,6256,11128
,YiKeWuLanXiang,632224200,3754,347,2851,1462,5584,2851,1550,2673,5524,2800,5651
Ȫ,QuanJiXiang,632224201,3839,294,2597,1306,5211,2584,1176,2618,5202,2712,5309
,JiErMengXiang,632224202,2368,149,1591,913,3171,1584,790,1607,3191,1716,3307
ຣũ,QingHaiHuNongChang,632224400,879,22,352,377,635,332,110,428,760,659,1011
ǳ,SanJiaoChengZhongYangChang,632224401,1470,113,966,733,1851,966,380,997,1963,997,1963
¡,LongWuZhen,632321100,26645,1885,16952,10098,25924,15595,7082,15735,31330,18660,35612
,BaoAnZhen,632321101,7396,934,5439,2462,10265,5421,2441,5266,10687,5332,10771
,LanCaiXiang,632321200,2664,231,2074,933,4044,2074,1312,2093,4167,2133,4207
˫,ShuangPengXiXiang,632321201,2155,347,1694,759,3029,1681,774,1537,3218,1582,3276
ë,ZhaMaoXiang,632321202,2873,263,2159,961,4169,2158,1228,2073,4231,2205,4364
˺,HuangNaiHaiXiang,632321203,2152,231,1560,703,3024,1533,769,1554,3087,1592,3152
,QuKuHuXiang,632321204,4889,487,3593,1481,6917,3575,1847,3475,7050,3630,7223
궼,NianDouHuXiang,632321205,5914,667,4239,1856,8146,4239,2039,4329,8568,4381,8620
,DuoWaXiang,632321206,4278,318,3260,1409,6394,3251,1944,3254,6505,3280,6540
ʲ,GuaShenZeXiang,632321207,2960,281,2190,920,4245,2143,1114,2028,4171,2165,4355
,JiaWuXiang,632321208,2998,375,2234,906,4267,2234,1108,2244,4478,2247,4481
,MaKeTangZhen,632322100,13054,1003,9385,4354,12894,7405,5169,7136,14541,9841,19226
,KangYangZhen,632322101,5584,502,4159,2108,7190,4118,2096,3911,8029,4023,8182
,KanBuLaZhen,632322102,7593,594,5314,2577,9524,4988,2529,4881,9869,5402,10716
ּ,JiaJiaXiang,632322200,1115,144,823,390,1508,823,353,743,1566,789,1612
,CuoZhouXiang,632322201,3105,319,2221,866,4226,2219,991,2117,4336,2194,4415
,AngLaXiang,632322202,1687,193,1199,568,2349,1149,569,1092,2241,1250,2449
ܿ,NengKeXiang,632322203,1385,169,949,441,1942,945,422,885,1830,1027,1976
˳,DangShunXiang,632322204,1286,151,962,416,1775,916,441,817,1733,916,1878
̲,JianZhaTanXiang,632322205,3256,273,2488,1139,4733,2478,1342,2347,4825,2383,4871
,ZeQuZhen,632323100,10879,793,8056,4565,14647,8030,4994,8335,16365,8610,16666
,MaiXiuZhen,632323101,6918,645,5609,2926,10874,5607,3576,5414,11021,5530,11139
,NingXiuXiang,632323200,8869,672,7374,3437,14391,7372,5079,7102,14474,7246,14620
,HeRiXiang,632323201,6983,544,5318,2479,10626,5314,3354,5493,10807,5563,10881
,WangJiaXiang,632323202,2740,232,2185,1003,4278,2185,1399,2151,4336,2186,4371
ɳ,XiBuShaXiang,632323203,1742,134,1430,700,2769,1430,951,1297,2727,1397,2827
ï,DuoHeMaoXiang,632323204,5704,491,4406,1982,8730,4358,2717,4284,8642,4506,8912
Ÿ,YouGanNingZhen,632324100,15270,1160,10365,6086,14798,10323,4893,10734,21057,10958,21323
ľ,NingMuTeXiang,632324200,6552,506,4812,2302,9374,4810,2619,4857,9667,4865,9677
,DuoSongXiang,632324201,1645,119,1168,566,2249,1161,555,1111,2272,1151,2319
,SaiErLongXiang,632324202,2259,179,1434,781,2947,1407,600,1389,2796,1604,3038
,KeShengXiang,632324203,2108,145,1471,776,2810,1471,764,1496,2967,1546,3017
ǡǡ,QiaBuQiaZhen,632521100,40113,2373,25651,15605,35898,24202,10014,23887,48089,26849,52500
ʺ,DaoTangHeZhen,632521101,7257,502,4982,2264,9019,4888,2678,4765,9653,5455,10437
Ͽ,LongYangXiaZhen,632521102,4869,368,3117,1855,5582,3041,1341,3135,6176,3461,6578
ľ,TangGeMuZhen,632521103,7049,516,5062,2695,9926,5062,2649,5152,10214,5152,10214
,HeiMaHeXiang,632521200,3527,231,2587,1383,4529,2563,1405,2505,5068,2576,5163
ʯ˺,ShiNaiHaiXiang,632521201,4506,335,3284,1605,6256,3280,1730,3208,6488,3287,6571
ɳ,ShaZhuYuXiang,632521202,3789,307,2515,1396,4904,2513,1057,2636,5149,2638,5153
,TieGaiXiang,632521203,3532,238,2434,1304,4839,2432,1137,2435,4867,2473,4907
إ,NianDiXiang,632521204,2887,255,1973,1016,3831,1955,930,1979,3934,2099,4072
м,QieJiXiang,632521205,6233,340,4456,2082,8549,4431,2375,4356,8787,4492,8948
,JiangXiGouXiang,632521206,4130,278,3064,1384,5389,2951,1708,2841,5792,3052,6116
,HuDongZhongYangChang,632521401,1362,108,1020,458,1848,1020,537,987,2007,987,2007
Ϳ̨ũ,BaKaTaiNongChang,632521402,171,8,123,65,217,120,67,112,232,123,246
ũ,AnZhiNongChang,632521403,28,0,15,19,19,15,1,14,29,14,29
Ӳݸվ,TieBuJiaCaoGaiZhan,632521404,23,1,8,9,25,8,1,7,15,17,25
ذɶ,GaBaSongDuoZhen,632522100,18976,1193,13341,7053,19773,13062,7573,13586,26648,14401,27742
ƹ,TangGuZhen,632522101,7364,576,5549,2316,10829,5528,3319,5446,10974,5710,11259
͹,BaGouXiang,632522200,5811,445,4029,1837,7670,4012,1884,4042,8054,4111,8140
,XiuMaXiang,632522201,4728,355,3576,1710,7005,3568,2203,3670,7238,3710,7286
ӱ,HeBeiXiang,632522202,5299,418,3525,1943,6804,3507,1902,3757,7264,4094,7619
ʡֳַ,ShengMuCaoLiangZhongFanZhiChang,632522400,1692,58,1104,774,1700,1083,573,1100,2183,1219,2323
,HeYinZhen,632523100,18308,1772,12492,7883,19070,12174,4948,11907,24081,12536,25028
,HeXiZhen,632523101,15180,1579,10733,5947,19474,10652,4848,10706,21358,10874,21607
,LaXiWaZhen,632523102,5747,359,3330,2085,5477,3124,1485,3392,6516,4261,7591
,ChangMuZhen,632523103,11226,1044,8379,4122,16160,8357,4433,8125,16482,8324,16703
Ӷ,HeDongXiang,632523200,9600,938,6534,3575,11708,6199,2785,6279,12478,6789,13323
½ֻ,XinJieHuiZuXiang,632523201,3155,347,2352,1194,4463,2346,1228,2350,4696,2378,4730
,GaRangXiang,632523202,9172,747,6102,3121,11661,6032,2870,6240,12272,6687,12789
ӿ̲,ZiKeTanZhen,632524100,16913,947,11824,6523,14434,11715,6898,12054,23769,12934,24758
ӿ,HeKaZhen,632524101,9671,659,6981,3563,12873,6897,3903,6915,13812,7252,14233
ʲ,QuShenAnZhen,632524102,3897,244,2431,1414,4499,2369,1248,2510,4879,2958,5389
Ȫ,WenQuanXiang,632524200,6012,382,4313,1902,7488,4287,2785,4383,8670,4866,9179
,LongCangXiang,632524201,3782,290,2906,1387,5362,2905,1844,2947,5852,3010,5916
,ZhongTieXiang,632524202,4214,390,3199,1398,6044,3184,1944,3213,6397,3349,6548
˺,TangNaiHaiXiang,632524203,5746,447,4267,2126,8304,4236,2485,4340,8576,4411,8678
ӿ,HeKaZhongYangChang,632524400,863,56,677,323,1234,677,405,647,1324,647,1324
ã,MangQuZhen,632525100,11186,628,7627,4757,13237,7490,3795,7723,15213,7982,15609
Ӫ,GuoMaYingZhen,632525101,9435,820,7079,3385,13432,7074,3823,6940,14014,6999,14078
ɳ,ShaGouXiang,632525200,5370,489,3892,1780,7533,3851,1927,3763,7614,3894,7786
ɭ,SenDuoXiang,632525201,9245,829,6999,3047,13486,6980,4272,6905,13885,7347,14346
ã,MangLaXiang,632525202,4627,369,3251,1531,6517,3169,1712,3232,6401,3457,6708
,TaXiuXiang,632525203,6281,475,4833,1889,8920,4817,2963,4562,9379,4886,9719
ຣʡϲҵι˾,QingHaiShengGuiNanCaoYeKaiFaYouXianZeRenGongSi,632525400,6242,495,4110,3633,6672,4093,1577,4167,8260,4204,8314
,DaWuZhen,632621100,16396,539,9863,7549,11785,9380,4677,10390,19770,11749,21612
,LaJiaZhen,632621101,7920,623,5640,3155,10603,5596,3502,5823,11419,6405,12045
,DaWuXiang,632621200,3575,209,2283,1115,4068,2157,1364,2162,4319,2865,5148
㹵,DongQingGouXiang,632621201,1374,121,1048,581,2027,1048,677,1124,2172,1124,2172
ѩɽ,XueShanXiang,632621202,1160,97,934,546,1677,933,593,916,1849,916,1850
´,XiaDaWuXiang,632621203,1121,109,807,546,1567,804,433,856,1660,856,1663
,YouYunXiang,632621204,1847,162,1371,798,2815,1371,856,1445,2816,1494,2865
,DangLuoXiang,632621205,2379,214,1860,915,3774,1821,1297,1965,3786,2030,3890
,SaiLaiTangZhen,632622100,4702,331,3296,2140,4478,3261,1874,3451,6712,3611,6907
๱,DuoGongMaXiang,632622200,1304,147,1040,531,2015,1030,691,1091,2121,1102,2142
ɺ,MaKeHeXiang,632622201,1017,97,811,439,1581,809,571,847,1656,874,1685
,JiKaXiang,632622202,1507,116,1069,684,1902,1065,588,1134,2199,1142,2211
￨,DaKaXiang,632622203,1946,166,1299,849,2548,1279,643,1238,2517,1456,2755
֪,ZhiQinXiang,632622204,1555,168,1093,752,2141,1089,626,1232,2321,1256,2349
,JiangRiTangXiang,632622205,1984,220,1502,743,3056,1502,899,1600,3102,1601,3103
Ƕ,YaErTangXiang,632622206,1623,183,1234,644,2405,1234,690,1262,2496,1262,2496
,DengTaXiang,632622207,2290,252,1703,806,3174,1687,995,1809,3496,1834,3537
,KeQuZhen,632623100,6373,520,4505,2958,7559,4429,2637,4715,9144,5025,9530
Ϲ,ShangGongMaXiang,632623200,1927,201,1353,849,2905,1353,829,1545,2898,1604,2957
¹,XiaGongMaXiang,632623201,2718,254,1843,881,3344,1771,1112,1769,3540,2241,4084
,GangLongXiang,632623202,2499,216,1933,1048,3877,1933,1256,1954,3887,2038,3971
,QingZhenXiang,632623203,3592,249,2776,1512,5509,2772,1863,2738,5510,2928,5704
ǧ,JiangQianXiang,632623204,2328,183,1760,1055,3404,1760,951,1702,3462,1702,3462
²ؿ,XiaCangKeXiang,632623205,3220,233,2388,1172,4935,2386,1679,2741,5127,2744,5132
,JiMaiZhen,632624100,5979,351,4252,2731,4326,4104,2376,4249,8353,4454,8706
,ManZhangXiang,632624200,1827,114,1316,600,2608,1314,714,1337,2651,1339,2655
°,DeAngXiang,632624201,1790,124,1261,716,2500,1252,806,1420,2672,1459,2720
,WoSaiXiang,632624202,1071,72,811,468,1570,800,565,806,1606,897,1708
Ī,MoBaXiang,632624203,1433,92,1050,635,2141,1050,626,1101,2151,1101,2151
Ϻ,ShangHongKeXiang,632624204,2127,161,1598,796,3178,1584,970,1629,3213,1660,3258
º,XiaHongKeXiang,632624205,1518,125,1184,568,2367,1184,744,1161,2345,1203,2387
,JianSheXiang,632624206,2197,219,1507,1041,3147,1474,1011,1659,3133,1920,3427
ɣ,SangRiMaXiang,632624207,1493,75,1138,654,2288,1134,815,1140,2274,1245,2383
غ,TeHeTuXiang,632624208,991,60,769,456,1550,769,549,809,1578,831,1600
ɶ,ZhiQingSongDuoZhen,632625100,4701,307,3262,2107,5305,3238,1826,3166,6404,3572,6834
,MenTangXiang,632625200,1757,123,1315,644,2308,1270,800,1276,2546,1365,2680
,WaSaiXiang,632625201,2135,155,1631,774,2941,1629,954,1613,3242,1613,3244
,SuoHuRiMaXiang,632625202,2825,225,2221,1006,4092,2220,1495,2144,4364,2324,4545
,BaiYuXiang,632625203,3567,335,2406,1238,4397,2403,1421,2450,4853,2917,5323
۶,WaErYiXiang,632625204,2053,190,1761,705,3144,1761,1212,1694,3455,1694,3455
,MaChaLiZhen,632626100,3193,177,1946,1605,2939,1897,946,2137,4034,2370,4316
ʯϿ,HuaShiXiaZhen,632626101,2849,176,2067,1425,3913,2065,1165,2086,4151,2123,4190
ƺ,HuangHeXiang,632626200,1076,77,776,534,1525,776,432,809,1585,809,1585
,ZhaLingHuXiang,632626201,811,37,615,412,1215,615,397,630,1245,630,1245
,JieGuZhen,632721100,43214,3005,30539,18520,31592,30053,17061,31189,61242,32741,63280
¡,LongBaoZhen,632721101,4453,324,3565,1729,6999,3565,2536,3748,7313,3748,7313
,XiaLaXiuZhen,632721102,7951,674,6402,2594,12337,6339,4869,6511,12850,7092,13494
ٴ,ZhongDaXiang,632721200,2631,235,1520,663,2816,1433,731,1383,2816,2077,3597
,BaTangXiang,632721201,3223,349,2648,1389,5116,2648,1805,2729,5377,2729,5377
Сç,XiaoSuMangXiang,632721202,7296,681,6138,2706,12047,6138,4070,5909,12047,5909,12047
,ShangLaXiuXiang,632721203,4616,364,4032,1680,8007,4032,3048,3996,8028,3996,8028
,HaXiuXiang,632721204,3084,233,2127,1136,4189,2090,1249,2137,4227,2439,4566
,AnChongXiang,632721205,1793,255,1391,694,2720,1391,697,1354,2745,1354,2745
,SaHuTengZhen,632722100,15428,1123,12546,5426,10084,12394,9318,12754,25148,13323,25869
,AngSaiXiang,632722200,2744,215,2141,847,3952,2094,1492,2012,4106,2310,4451
,JieDuoXiang,632722201,3217,294,2860,1145,5731,2860,2232,2883,5743,2883,5743
,ADuoXiang,632722202,2623,263,2422,1045,4646,2422,1918,2382,4804,2382,4804
³,SuLuXiang,632722203,2885,239,2493,943,4818,2493,1767,2398,4891,2398,4891
鵩,ChaDanXiang,632722204,2404,210,1938,859,3975,1938,1390,2066,4004,2066,4004
Ī,MoYunXiang,632722205,2182,185,1770,876,3708,1770,1369,1966,3736,1966,3736
,ZhaQingXiang,632722206,2641,226,2384,957,4672,2384,1903,2386,4770,2386,4770
,ChengWenZhen,632723100,7586,592,4947,3237,9601,4822,2481,5019,9841,5712,10659
Ъ,XieWuZhen,632723101,3473,362,2642,1358,5020,2640,1537,2469,5109,2730,5372
,ZhaDuoZhen,632723102,5262,358,4196,2282,7503,4196,2836,4260,8456,4260,8456
ˮ,QingShuiHeZhen,632723103,5270,360,3871,2257,6766,3862,2253,3994,7856,4012,7883
,ZhenQinZhen,632723104,7008,505,5480,3134,9942,5479,3791,5472,10951,5824,11304
ض,GaDuoXiang,632723200,4534,347,3436,1827,7354,3436,2545,3990,7426,3990,7426
,LaBuXiang,632723201,3226,380,2059,1136,4074,1970,913,2116,4086,2460,4519
Ӽ,JiaJiBoLuoGeZhen,632724100,8353,606,6290,3796,4461,6235,3814,6261,12496,6483,12773
,SuoJiaXiang,632724200,2276,184,1846,978,3495,1846,1125,1739,3585,1739,3585
,ZhaHeXiang,632724201,3114,244,2577,1372,5015,2573,1846,2598,5171,2627,5204
,DuoCaiXiang,632724202,2626,188,1854,1046,3551,1850,1067,1757,3607,2027,3881
,ZhiQuXiang,632724203,1714,135,1428,736,2710,1374,881,1302,2676,1302,2730
,LiXinXiang,632724204,1141,84,924,558,1819,924,639,940,1864,940,1864
,XiangDaZhen,632725100,20323,1656,15233,6408,22283,14742,10196,15898,30640,16942,32175
,BaiZhaXiang,632725200,4723,543,3919,1627,7398,3919,2749,4096,8015,4096,8015
,JiQuXiang,632725201,6343,668,4981,1724,9473,4605,3148,4642,9247,5178,10159
,NiangLaXiang,632725202,2179,184,1620,537,3327,1620,1041,1784,3404,1784,3404
ëׯ,MaoZhuangXiang,632725203,3616,386,2624,1193,5315,2522,1761,2472,4994,3139,5763
,JiaoLaXiang,632725204,3171,358,2818,1166,5042,2818,2147,2858,5676,2858,5676
,DongBaXiang,632725205,4033,421,3465,1526,6849,3465,2398,3387,6852,3387,6852
,GaYangXiang,632725206,1698,155,1455,534,2903,1455,1064,1462,2917,1462,2917
,JiNiSaiXiang,632725207,2890,280,2330,1039,4232,2330,1548,2388,4718,2388,4718
,ZheXiaoXiang,632725208,3687,319,3073,1111,6142,3073,2140,3073,6146,3073,6146
Լ,YueGaiZhen,632726100,6603,503,5037,3392,4565,4993,3185,5120,10113,5254,10291
͸,BaGanXiang,632726200,2530,171,1865,1027,3703,1847,1375,1890,3737,2211,4076
,QiuZhiXiang,632726201,2025,125,1635,909,2953,1587,1193,1648,3235,1708,3343
Ҷ,YeGeXiang,632726202,1607,124,1294,808,2344,1293,933,1366,2659,1370,2664
,MaDuoXiang,632726203,2827,149,2137,1108,4162,2124,1377,2159,4283,2216,4353
,QuMaHeXiang,632726204,2230,150,1725,1056,3118,1724,1136,1790,3514,1791,3516
·ֵ´,KunLunLuJieDaoBanShiChu,632801001,44254,1428,23910,17728,33195,22605,8648,23671,46276,30420,54330
ƺ·ֵ´,HuangHeLuJieDaoBanShiChu,632801002,21967,836,12273,9673,18214,11606,4060,12407,24013,14590,26863
·ֵ´,JinFengLuJieDaoBanShiChu,632801003,27850,1087,18871,11603,10589,18724,10594,20195,38919,20660,39531
ֵ´,HeXiJieDaoBanShiChu,632801004,17819,1299,11798,8452,12008,11401,4840,11522,22923,12160,23958
·ֵ´,XiZangLuJieDaoBanShiChu,632801005,9486,322,5383,4147,3921,5045,2289,5818,10863,6714,12097
ľ,GuoLeMuDeZhen,632801100,23208,1127,15173,7832,18141,14968,7606,16046,31014,16768,31941
ƹ,TangGuLaZhen,632801101,1164,56,731,389,1326,706,385,716,1422,874,1605
,DaGeLeXiang,632801200,1724,80,973,519,1906,880,374,962,1842,1205,2178
ͼ,WuTuMeiRenXiang,632801201,3458,126,914,543,1352,730,247,864,1594,2917,3831
�ί,ChaErHanGongHangWei,632801400,6897,30,1497,1267,116,1010,182,1453,2463,5612,7109
ľũ޹˾,GeErMuNongKenYouXianGongSi,632801401,8138,501,5740,2981,1166,5662,3132,5764,11426,6031,11771
ֵ´,HeXiJieDaoBanShiChu,632802001,18841,1145,11784,7900,16535,11679,4975,12485,24164,13177,24961
Ӷֵ´,HeDongJieDaoBanShiChu,632802002,17587,890,10831,7431,16379,10152,3490,10386,20538,11136,21967
վֵ´,HuoCheZhanJieDaoBanShiChu,632802003,6811,368,3414,2647,3071,3133,1187,3537,6670,4952,8366
غ,GaHaiZhen,632802100,4322,339,2873,1718,5440,2870,1304,3066,5936,3092,5965
ͷ,HuaiTouTaLaZhen,632802101,2260,157,1215,727,2285,1155,481,1273,2428,1683,2898
³,KeLuKeZhen,632802102,8918,555,5884,3245,10821,5872,2720,6263,12135,6309,12193
,ChaiDanZhen,632802103,8767,109,2969,2830,3305,2684,874,3377,6061,6781,9750
ɽ,XiTieShanZhen,632802104,3611,16,1179,1609,279,1082,294,1702,2784,2742,3921
,LengHuZhen,632802105,2241,9,691,724,973,528,184,717,1245,1743,2434
,HuaTuGouZhen,632802106,26606,54,11740,4066,20679,3371,1165,4462,7833,16085,27825
ã,MangYaZhen,632802107,2634,20,1393,1311,2648,1362,538,1602,2964,1799,3192
,XuJiXiang,632802200,1456,151,756,539,1557,735,227,837,1572,1078,1834
ϣ﹵,XiLiGouZhen,632821100,10434,609,6679,4482,8959,6457,2680,6329,12786,7044,13723
迨,ChaKaZhen,632821101,3436,100,1706,1362,2216,1569,587,1720,3289,2417,4123
¿,KeKeZhen,632821102,9772,545,5866,3648,10450,5808,2402,6360,12168,6853,12719
ͭ,TongPuZhen,632821103,6329,187,2144,1134,3412,1760,698,1991,3751,5070,7214
Ī,HaiXiZhouMoHeXuMuChang,632821500,426,34,194,164,283,166,33,156,322,299,493
캺,ChaHanWuSuZhen,632822100,15644,797,9678,6342,13330,9162,4129,9505,18667,10892,20570
յ,XiangRiDeZhen,632822101,18468,1183,12206,6486,21769,12075,5596,12658,24733,13041,25247
չ,XiaRiHaZhen,632822102,4053,212,2380,1308,4556,2346,1122,2502,4848,3007,5387
ڼ,ZongJiaZhen,632822103,8062,385,4233,2628,3341,4049,1925,4435,8484,6139,10372
ˮ,ReShuiXiang,632822200,2658,191,1788,951,3592,1775,882,1834,3609,1943,3731
,XiangJiaXiang,632822201,3029,177,1817,1101,3464,1767,836,1884,3651,2225,4042
,GouLiXiang,632822202,1560,82,762,374,1402,720,347,702,1422,1227,1989
¡,BaLongXiang,632822203,3854,275,2494,1390,4935,2459,1156,2698,5157,2791,5285
Դ,XinYuanZhen,632823100,13469,532,6809,4942,7199,6367,2584,6557,12924,9776,16585
ľ,MuLiZhen,632823101,6005,57,742,438,985,579,267,683,1262,5587,6329
,JiangHeZhen,632823102,1277,110,951,498,1760,951,518,954,1905,954,1905
,KuaiErMaXiang,632823200,1356,128,945,500,1710,925,395,875,1800,934,1879
Ⱥ,ZhouQunXiang,632823201,744,37,521,281,914,519,263,521,1040,523,1044
֪,ZhiHeMaXiang,632823202,1097,75,771,392,1479,771,379,780,1551,780,1551
,SuLiXiang,632823203,911,62,645,322,1204,645,302,629,1274,630,1275
,ShengGeXiang,632823204,673,49,458,300,901,458,240,504,962,504,962
,YangKangXiang,632823205,798,67,535,272,1010,534,240,567,1101,570,1105
,LongMenXiang,632823206,941,59,649,337,1148,643,288,635,1278,639,1288
˱ֵֽ´,FengHuangBeiJieJieDaoBanShiChu,640104001,31840,3779,21222,15666,28933,20122,5783,19197,39319,20180,41402
ֵֽ´,JieFangXiJieJieDaoBanShiChu,640104002,34343,5341,23589,17815,30826,22543,5962,21024,43567,22057,45646
Ļֵֽ´,WenHuaJieJieDaoBanShiChu,640104003,21598,2997,14493,10506,19178,13911,3234,12894,26805,13336,27829
ֵֽ´,FuNingJieJieDaoBanShiChu,640104004,37018,4482,24242,18653,27952,23156,6293,22557,45713,23551,47793
»ֵֽ´,XinHuaJieJieDaoBanShiChu,640104005,22100,1925,14161,10611,15252,13575,3852,13214,26789,13716,27877
ʸ󱱽ֵֽ´,YuHuangGeBeiJieJieDaoBanShiChu,640104006,40501,4269,26485,19928,32177,26142,7048,24957,51099,25333,51818
ǰֵֽ´,QianJinJieJieDaoBanShiChu,640104007,25309,3031,16862,12088,21057,15863,4777,15336,31199,16255,33117
ɽϽֵֽ´,ZhongShanNanJieJieDaoBanShiChu,640104008,22688,2127,14735,10934,14293,13803,4181,13482,27285,14261,28996
·ֵ´,YinGuLuJieDaoBanShiChu,640104009,83337,3477,48571,35578,42641,46631,17224,48558,95189,55467,104038
ʤֵֽ´,ShengLiJieJieDaoBanShiChu,640104010,49340,4399,32748,21033,32179,26853,8594,26675,53528,29585,62333
�ֵֽ´,LiJingJieJieDaoBanShiChu,640104011,57655,2824,34094,25575,30504,33144,12257,35929,69073,38642,72736
,ZhangZhengZhen,640104100,26603,1911,17712,10341,25120,15155,5742,15646,30801,16544,34256
,DaXinZhen,640104101,59433,4152,36730,27999,43462,36342,12951,38394,74736,39806,76536
ͨ,TongGuiXiang,640104200,9619,1177,6779,4823,12426,6764,2694,6686,13450,6711,13490
,YueYaHuXiang,640104201,7520,306,4638,2381,8376,4555,2613,4885,9440,5801,10439
԰ֵ´,XiHuaYuanJieDaoBanShiChu,640105001,41077,5401,26757,20123,35147,25699,7892,25156,50855,27613,54370
·ֵ´,BeiJingXiLuJieDaoBanShiChu,640105002,28445,3002,18318,13435,21845,17715,5540,17828,35543,18669,36987
Ĳ·ֵ´,WenChangLuJieDaoBanShiChu,640105003,22129,2740,14042,10171,18757,12992,4003,12833,25825,14830,28872
˷·ֵ´,ShuoFangLuJieDaoBanShiChu,640105004,56390,3588,33798,16415,35211,21652,7502,22085,43737,33682,67480
·ֵ´,NingHuaLuJieDaoBanShiChu,640105005,22691,2352,14775,11109,16216,14570,5199,14929,29499,15467,30242
ɽ·ֵ´,HeLanShanXiLuJieDaoBanShiChu,640105006,56440,2221,30672,11128,25388,16449,6958,16930,33379,34947,65619
,XingJingZhen,640105100,15015,740,10082,4665,13402,9843,5279,10252,20095,10952,21034
򱱱,ZhenBeiBaoZhen,640105101,18393,1163,11893,6545,13040,11767,5150,12387,24154,12813,24706
Ǳֵֽ´,ManChengBeiJieJieDaoBanShiChu,640106001,32599,3815,21301,14981,27115,20289,6383,20051,40340,21496,42797
ƺӶ·ֵ´,HuangHeDongLuJieDaoBanShiChu,640106002,43698,3451,27048,19283,31382,26023,9379,26503,52526,29480,56528
·ֵ´,ChangChengZhongLuJieDaoBanShiChu,640106003,59029,3423,34458,21715,32226,29503,10154,29456,58959,38148,72606
·ֵ´,BeiJingZhongLuJieDaoBanShiChu,640106004,26191,1968,16465,11787,18664,16032,4805,15609,31641,16499,32964
Ϻ·ֵ´,ShangHaiXiLuJieDaoBanShiChu,640106005,33824,2175,20412,14430,20577,19674,6578,19499,39173,22165,42577
,LiangTianZhen,640106100,15274,747,10670,5098,16952,10505,6139,11263,21768,11490,22160
,FengDengZhen,640106101,9570,837,6252,4042,10773,6100,2515,6256,12356,6670,12922
,YangHeZhen,640121100,52569,3858,33344,21522,46231,29902,11474,30395,60297,34557,67901
,LiJunZhen,640121101,20383,2214,13620,8411,26515,13614,5126,14076,27690,14103,27723
Զ,WangYuanZhen,640121102,32548,2261,19280,13152,29820,18525,7213,19570,38095,22742,42022
,WangHongZhen,640121103,23062,2364,15223,9033,30067,15178,5517,15579,30757,15720,30943
,MinNingZhen,640121104,16712,628,11784,5348,16989,11784,7356,12910,24694,12912,24696
ʤ,ShengLiXiang,640121200,11894,1140,7723,4959,13170,7637,2927,8051,15688,8238,15961
̲ũ,HuangYangTanNongChang,640121400,2980,341,1934,1289,2893,1884,663,1998,3882,2050,3984
ȪӪũ,YuQuanYingNongChang,640121401,3505,249,2475,1414,2522,2274,1276,2359,4633,2555,5030
ϰ,XiGangZhen,640122100,88741,5033,52262,37474,55199,49157,18287,50148,99305,59799,112061
,JinGuiZhen,640122101,21701,2574,14664,9298,27486,14622,5521,14898,29520,15132,29796
,LiGangZhen,640122102,17588,2135,12005,8689,22507,11969,4442,11975,23944,12160,24165
,HongGuangZhen,640122103,13094,1185,8224,5730,13099,8072,3130,8401,16473,9185,17409
,ChangXinXiang,640122200,18672,1937,12326,8299,22994,12280,4486,12588,24868,12769,25095
̨ӹί,NanLiangTaiZiGuanWeiHui,640122400,5243,228,3767,1780,5390,3757,2339,3987,7744,4043,7810
ůȪũ,NuanQuanNongChang,640122401,3270,522,2274,1534,3215,2262,786,2254,4516,2304,4578
ԭֳ,NingXiaYuanZhongChang,640122402,1162,112,702,567,937,694,197,707,1401,769,1471
ũ,JingXingNongMuChang,640122403,454,37,291,212,561,291,105,305,596,305,596
ֵ´,ChengQuJieDaoBanShiChu,640181001,38720,2938,26204,18785,29669,25813,11205,25797,51610,26659,52863
,DongTaZhen,640181100,16570,1233,10147,5756,14649,9386,4237,9699,19085,11893,22040
¼,HaoJiaQiaoZhen,640181101,21982,2258,15787,7936,29123,15730,8267,16442,32172,16720,32507
,ChongXingZhen,640181102,27965,3012,20141,10257,38938,20097,10235,20896,40993,21071,41212
,NingDongZhen,640181103,39206,975,19199,14825,16948,17618,8406,20619,38237,29388,48587
̲,MaJiaTanZhen,640181104,7771,207,2129,1756,2335,1705,672,2206,3911,6521,8650
ٺ,LinHeZhen,640181105,14905,421,4161,1938,5552,3147,1397,3306,6453,12562,16723
ͩ,WuTongShuXiang,640181200,14511,1467,9996,6157,19587,9976,4528,10434,20410,10510,20506
,BaiTuGangXiang,640181201,6133,466,3913,2148,6714,3812,2041,3900,7712,4727,8640
ũ,LingWuNongChang,640181400,7513,1048,4946,3494,7848,4567,1388,4526,9093,5003,9949
ʤֵ´,ChangShengJieDaoBanShiChu,640202001,17698,2023,10912,8268,15509,10762,3348,11451,22213,12157,23069
ֵ´,ZhaoYangJieDaoBanShiChu,640202002,37623,4111,24624,16845,38089,24248,7756,24119,48367,24866,49490
·ֵ´,RenMinLuJieDaoBanShiChu,640202003,28444,2611,18157,12848,22733,17696,5996,17894,35590,18894,37051
ǽֵ´,ChangChengJieDaoBanShiChu,640202004,27883,3159,18463,13020,26638,17754,5890,17386,35140,18469,36932
ɽֵ´,QingShanJieDaoBanShiChu,640202005,36588,4813,22141,15726,34688,21885,6380,21400,43285,25640,47781
ʯֵ̿´,ShiTanJingJieDaoBanShiChu,640202006,7890,787,4189,4393,7358,4101,1071,4861,8962,5559,9748
ֵܸ´,BaiJiGouJieDaoBanShiChu,640202007,7563,186,2750,2989,3670,2348,463,3127,5475,5462,8212
ڽֵ´,GouKouJieDaoBanShiChu,640202008,4432,1295,3114,2474,4925,3042,724,3038,6080,3337,6451
˽ֵ´,ChangXingJieDaoBanShiChu,640202010,7898,740,4837,3447,6575,4750,1635,4931,9681,5436,10273
ֵֽ´,JinLinJieDaoBanShiChu,640202011,11178,1624,7571,5192,8553,7535,2105,7238,14773,7336,14907
Ǻ¡ÿ,XingHaiZhenLongHuJingJiKaiFaQu,640202400,30997,1816,20552,11714,29327,20487,9942,21798,42285,22203,42755
·ֵ´,YuCaiLuJieDaoBanShiChu,640205001,16248,1749,10568,7661,13731,10421,3440,10598,21019,10869,21437
Ͻֵֽ´,NanJieJieDaoBanShiChu,640205002,18800,3734,13235,10183,18812,13077,3559,12598,25675,12858,26093
нֵֽ´,ZhongJieJieDaoBanShiChu,640205003,12434,1515,8237,6391,11477,8219,2646,8348,16567,8358,16595
ֵֽ´,BeiJieJieDaoBanShiChu,640205004,3248,499,2153,1897,2993,2136,665,2209,4345,2259,4412
ӱֵ´,HeBinJieDaoBanShiChu,640205005,18997,1828,10866,8871,13882,10483,3429,11355,21838,13388,24254
վֵ´,HuoCheZhanJieDaoBanShiChu,640205006,5534,949,3321,2852,3998,3141,987,3402,6543,4149,7470
,HongGuoZiZhen,640205100,16330,1187,10121,7106,11222,9698,3909,10005,19703,11305,21426
βբ,WeiZhaZhen,640205101,6000,699,3831,2893,6553,3734,1188,3818,7552,4056,7887
԰,YuanYiZhen,640205102,20506,2774,13866,9813,14714,13789,4615,13757,27546,14029,27895
̨,MiaoTaiXiang,640205200,4351,589,2892,2105,5497,2880,848,2838,5718,2896,5788
,LiHeXiang,640205201,5695,829,4159,2942,7813,4116,1684,4027,8143,4049,8208
Ӷ,YanZiDunXiang,640205202,6678,948,4436,3134,8576,4425,1540,4696,9121,4730,9166
Ȫũ,JianQuanNongChang,640205401,1925,183,1180,833,1484,1134,394,1175,2309,1322,2502
Ӫũ,GuoYingNongLinMuChang,640205402,2309,101,565,354,714,464,111,497,961,1956,2521
ֳַ,LiangZhongFanZhiChang,640205403,113,21,71,53,99,65,15,54,119,78,149
ǹ,ChengGuanZhen,640221100,69486,4972,45131,31085,60273,44290,17454,44846,89136,46781,91912
,HuangQuQiaoZhen,640221101,10636,1419,7367,5318,14045,7302,2684,7291,14593,7372,14739
,BaoFengZhen,640221102,7561,1018,5252,3416,10243,5252,1973,5299,10551,5300,10552
ͷբ,TouZhaZhen,640221103,10060,1241,6750,4316,13331,6709,2245,6773,13482,6796,13546
Ҧ,YaoFuZhen,640221104,12074,1540,8003,5861,15091,7968,2386,7915,15883,7997,16000
,ChongGangZhen,640221105,13629,926,7901,5662,12353,7483,2985,8317,15800,9639,17540
,TaoLeZhen,640221106,6307,828,4376,3237,7015,4345,1655,4349,8694,4414,8790
ׯ,GaoZhuangXiang,640221200,10803,1464,7565,5353,14457,7557,2854,7553,15110,7556,15121
ɳ,LingShaXiang,640221201,10101,1281,7211,4415,14135,7161,3052,7217,14378,7223,14434
,QuKouXiang,640221202,11308,1428,7599,5122,14950,7599,2586,7718,15317,7723,15322
ͨ,TongFuXiang,640221203,11535,1237,7885,4698,15657,7885,3170,8057,15942,8057,15942
,GaoRenXiang,640221204,3786,388,2575,1693,4823,2575,937,2535,5110,2536,5111
,HongYaZiXiang,640221205,4971,420,2984,1690,4900,2786,1255,2907,5693,3662,6646
ǰũ,QianJinNongChang,640221400,5553,822,3493,2415,5112,3184,980,3158,6342,3862,7355
,JinJiZhen,640302100,25444,2574,17616,10305,33553,17517,8074,18264,35781,18476,36092
̲,JinYinTanZhen,640302101,19619,1796,14128,8631,25783,14093,7554,14651,28744,14841,28969
բ,GaoZhaZhen,640302102,16114,1426,9439,4994,18418,9390,4073,9780,19170,12174,21613
ⵣ,BianDanGouZhen,640302103,11654,826,8131,4511,14189,8063,4441,8525,16588,8790,16921
,ShangQiaoZhen,640302104,24064,2239,16997,10543,27414,16898,7799,16956,33854,17105,34102
ų,GuChengZhen,640302105,28689,1810,18735,11235,25965,17708,8038,17925,35633,19802,38537
,JinXingZhen,640302106,44793,3581,30241,20347,37866,29780,11712,29174,58954,29845,60086
ʤ,ShengLiZhen,640302107,27400,3120,18944,13334,27161,18657,6417,17732,36389,17993,36937
,DongTaSiXiang,640302200,16970,1648,11620,6429,20075,11494,5221,11947,23441,12219,23839
,BanQiaoXiang,640302201,21871,1605,15031,6223,22689,12038,6048,12384,24422,14493,29524
,MaLianQuXiang,640302202,14341,1472,10221,5472,20819,10212,5309,10872,21084,10901,21122
,GuoJiaQiaoXiang,640302203,11634,1231,8729,5121,16648,8718,4755,8843,17561,8891,17620
˺ũ,BaLangHuNongChang,640302400,4717,552,3454,2306,6156,3453,1697,3468,6921,3512,6966
̲ί,SunJiaTanGuanWeiHui,640302401,2576,139,1720,902,1126,1664,1004,1846,3510,1999,3719
̫ɽ,TaiYangShanKaiFaQu,640302402,2908,16,1014,515,76,705,375,761,1466,2285,3299
±,HongSiBaoZhen,640303100,50877,2520,35743,18355,50155,35083,20353,37167,72250,38007,73750
̫ɽ,TaiYangShanZhen,640303101,23409,1362,17196,8589,29079,17140,10174,17682,34822,17749,34945
,DaHeXiang,640303200,16774,1032,12153,5766,19468,12095,7407,12456,24551,13060,25213
ϴ,NanChuanXiang,640303201,20197,1469,15028,7600,24293,14982,9094,15670,30652,15732,30760
±ҵ԰ί,HongSiBaoGongYeYuanQuGuanWeiHui,640303400,343,5,60,52,15,14,0,46,60,288,348
,HuaMaChiZhen,640323100,56337,4297,37659,25503,43241,36079,16792,37271,73350,39767,77426
ˮ,DaShuiKengZhen,640323101,14830,1396,10361,7840,16295,10289,4888,10403,20692,10753,21114
ݰ,HuiAnBaoZhen,640323102,10885,929,7291,4990,11556,7139,3675,7471,14610,8198,15489
ɳ,GaoShaWoZhen,640323103,4302,514,2965,2476,5459,2965,1229,3066,6031,3080,6045
־,WangLeJingXiang,640323200,5606,832,3762,3479,7620,3745,1348,3888,7633,4024,7786
ǹ,FengJiGouXiang,640323201,5401,511,3162,2533,6168,3097,1278,3385,6482,4028,7190
ɽ,QingShanXiang,640323202,3744,464,2415,2104,4912,2407,860,2581,4988,2653,5068
ɽ,MaHuangShanXiang,640323203,4877,473,2971,2347,6043,2961,1092,3311,6272,3471,6442
ԥ,YuHaiZhen,640324100,56555,3174,41683,20403,54531,38690,24158,39469,78159,42204,83887
,HeXiZhen,640324101,26913,1698,20129,10148,38040,20129,12303,20783,40912,20785,40914
Τ,WeiZhouZhen,640324102,15253,1241,11386,6167,18760,11216,6431,11190,22406,11539,22925
,XiaMaGuanZhen,640324103,14536,1294,10554,5532,19816,10552,5320,10531,21083,10596,21150
Ԥ,YuWangZhen,640324104,12533,1201,10199,5934,19582,10167,6586,10091,20258,10121,20320
,WangTuanZhen,640324105,22696,1515,18137,8830,35376,18136,12518,18590,36726,18592,36729
,DingTangZhen,640324106,25674,1787,18942,8797,34753,18928,11567,20040,38968,20086,39028
ׯ,TianLaoZhuangXiang,640324201,10750,1064,8294,4894,16623,8294,5032,8552,16846,8552,16846
ׯ,MaGaoZhuangXiang,640324202,8829,875,6868,3867,13537,6868,4149,6985,13853,6985,13853
żܫ,ZhangJiaYuanXiang,640324203,8223,890,6212,3574,12395,6210,3544,6443,12653,6445,12657
¡,XingLongXiang,640324204,6184,596,4874,2537,9706,4872,3064,4962,9834,4970,9844
ԣֵ´,YuMinJieDaoBanShiChu,640381001,42264,3146,28445,20036,34090,27461,11409,27040,54501,28374,56819
С,XiaoBaZhen,640381100,17526,1489,11211,6838,18338,10745,4421,11341,22086,12225,23436
,DaBaZhen,640381101,21758,2098,14180,9894,24454,14090,5570,14804,28894,15246,29426
ͭϿ,QingTongXiaZhen,640381102,31179,2726,19856,14335,30216,19589,7866,20455,40044,21915,41771
Ҷ,YeShengZhen,640381103,10795,1204,7495,4775,14691,7483,3207,7679,15162,7711,15206
ľ,QuJingZhen,640381104,20277,2139,13684,9390,26303,13637,5670,14175,27812,14402,28086
Ͽ,XiaKouZhen,640381105,19510,1803,13581,7867,25996,13555,6553,14126,27681,14285,27866
۸,ShaoGangZhen,640381106,13492,1394,9106,5396,15519,9059,3662,9309,18368,9442,18548
Ԭ̲,ChenYuanTanZhen,640381107,11957,987,7917,4771,15487,7881,3436,8198,16079,8463,16380
ũ,LianHuNongChang,640381400,3812,429,2538,1789,3295,2455,940,2508,4963,2643,5181
ֳ,ShuXinLinChang,640381401,1609,105,885,782,920,867,284,964,1831,1113,1998
ɽֵ´,ZhongShanJieDaoBanShiChu,640402001,104158,7335,71144,41053,83544,61982,31012,62446,124428,71361,142505
Ӫ,SanYingZhen,640402100,28219,2423,21234,10935,38241,21067,12595,21726,42793,22003,43237
,QingHeZhen,640402103,26611,1970,18754,9489,23979,16213,8988,16256,32469,18815,37569
,KaiChengZhen,640402104,21475,2122,15529,8262,27991,15492,7919,15811,31303,15987,31516
,ZhangYiZhen,640402105,22926,2753,16877,9276,32539,16858,8462,17212,34070,17264,34141
�,PengBaoZhen,640402106,14498,1739,10571,6193,20452,10522,5415,10997,21519,11081,21652
ͷӪ,TouYingZhen,640402107,28469,2939,21494,11618,41350,21407,12290,22012,43419,22204,43698
к,ZhongHeXiang,640402200,15652,1351,12090,6010,23146,12080,7688,12551,24631,12601,24691
Ӵ,HeChuanXiang,640402201,5814,720,4163,2733,8351,4161,2057,4427,8588,4428,8591
,GuanTingXiang,640402202,2625,287,1979,1106,3721,1964,1090,1966,3930,2023,4002
̿ɽ,TanShanXiang,640402204,5976,518,4654,2306,8692,4632,2996,4793,9425,4836,9490
կ,ZhaiKeXiang,640402205,7249,817,5279,3136,10273,5268,2696,5455,10723,5483,10762
ǿ,JiQiangZhen,640422100,52743,4030,39481,21102,56294,36871,22575,37271,74142,39867,79348
¡,XingLongZhen,640422101,21857,2223,17852,8415,34846,17804,11625,17768,35572,17853,35705
ƽ,PingFengZhen,640422102,11196,1986,9045,4612,17382,8977,4790,8658,17635,8927,17972
Ӫ,XinYingXiang,640422200,14635,1733,11103,5850,21327,11019,6060,11150,22169,11325,22428
ҫ,HongYaoXiang,640422201,4604,614,3582,1824,6848,3563,1942,3545,7108,3578,7160
ƺ,TianPingXiang,640422202,5614,952,4587,2569,8638,4566,2564,4485,9051,4543,9130
�,MaJianXiang,640422203,8287,1062,7010,3451,13359,7010,4612,6951,13961,6951,13961
,ZhenHuXiang,640422204,8605,1366,7023,3955,13225,7010,3661,6585,13595,6609,13632
ƽ,XingPingXiang,640422205,9635,846,7732,2986,14768,7729,5152,7890,15619,7901,15633
̲,XiTanXiang,640422206,5763,491,4849,2222,9261,4833,3542,4808,9641,4947,9796
,WangMinXiang,640422207,5249,636,4225,1780,8385,4204,2753,4316,8520,4413,8638
ʲ,ShenZiXiang,640422208,9796,1027,8427,3873,16226,8423,5904,8290,16713,8300,16727
,MaLianXiang,640422209,9430,890,7542,3446,14763,7518,4835,7576,15094,7613,15155
̨,JiangTaiXiang,640422210,11421,1440,9450,4565,17493,9415,5703,9051,18466,9114,18564
,XiaoHeXiang,640422211,7857,813,6405,3026,12407,6402,4262,6507,12909,6527,12932
ƫ,PianChengXiang,640422212,11945,1029,9856,4407,19121,9849,6732,9802,19651,9850,19706
ɳ,ShaGouXiang,640422213,7233,610,6167,2997,11607,6149,4657,6283,12432,6333,12500
,BaiYaXiang,640422214,8078,740,6803,3233,13231,6789,4847,6782,13571,6862,13665
ʯկ,HuoShiZhaiXiang,640422215,7281,632,5728,2796,11477,5728,3756,5940,11668,5941,11669
ɽֵ´,LiuPanShanJieDaoBanShiChu,640423001,20663,1567,14429,7964,14340,12137,6041,11618,23755,13842,28271
ǹ,ChengGuanZhen,640423100,7735,797,5312,2772,10154,5267,2314,5361,10628,5534,10846
ɳ,ShaTangZhen,640423101,8767,1198,6358,3613,11961,6316,2558,6029,12345,6165,12523
,LianCaiZhen,640423102,6493,937,4828,2786,9130,4770,2164,4669,9439,4766,9594
½,ChenJinXiang,640423200,4029,429,2754,1380,5497,2734,1176,2839,5573,2880,5634
ˮ,HaoShuiXiang,640423201,4824,623,3309,1842,6475,3300,1431,3543,6843,3569,6878
ׯ,GuanZhuangXiang,640423202,12300,1365,8549,4199,16955,8542,3927,9009,17551,9043,17592
,YangHeXiang,640423203,6658,628,5147,2531,10079,5138,3299,5425,10563,5438,10585
,ShenLinXiang,640423204,6139,904,4301,2447,8581,4268,1789,4456,8724,4531,8832
ų,ZhangChengXiang,640423205,5319,602,3996,2111,7535,3981,2249,4131,8112,4174,8170
,FengLingXiang,640423206,7547,925,5138,2878,10227,5121,2126,5410,10531,5460,10598
ɽ,ShanHeXiang,640423207,4658,610,3078,1730,6318,3054,1268,3390,6444,3458,6536
±,WenBaoXiang,640423208,12689,1576,9111,4554,17692,9075,4043,9097,18172,9197,18308
찲,DianAnXiang,640423209,4602,565,3096,1660,6098,3081,1220,3224,6305,3291,6387
ˮ,XiangShuiZhen,640424100,19387,1812,14749,7976,26412,14440,8599,14478,28918,15049,29798
Դ,JingHeYuanZhen,640424101,11108,1372,8970,4714,16513,8945,5667,9115,18060,9177,18147
ɽ,LiuPanShanZhen,640424102,9289,1215,6435,3850,12047,6195,2840,6161,12356,6909,13344
,XinMinXiang,640424200,6937,924,5968,2961,10371,5958,3806,5678,11636,5699,11667
ʢ,XingShengXiang,640424201,5132,665,4274,2120,7987,4274,2689,4195,8469,4212,8486
ƻ,HuangHuaXiang,640424202,5910,739,4685,2482,8715,4642,2734,4593,9235,4698,9383
,DaWanXiang,640424203,6949,868,5140,2955,9629,5136,2384,5040,10176,5061,10201
,BaiYangZhen,640425100,36329,2840,26220,14324,34368,23652,13522,23885,47537,26471,52691
,WangWaZhen,640425101,14491,1355,9552,5260,18200,9068,4454,9434,18502,10748,20300
ų,GuChengZhen,640425102,14539,1608,11063,5939,20621,10959,6112,10869,21828,11196,22259
¼,XinJiXiang,640425200,18430,1819,13785,6788,27184,13700,7846,14086,27786,14310,28095
,ChengYangXiang,640425201,10217,1233,7843,4413,14890,7823,3902,7468,15291,7509,15352
,HongHeXiang,640425202,12129,1402,8743,4869,17265,8722,4302,9040,17762,9090,17833
ׯ,FengZhuangXiang,640425203,4805,656,3481,2010,6600,3451,1713,3507,6958,3693,7174
С,XiaoChaXiang,640425204,2895,464,2124,1309,4105,2112,958,2155,4267,2193,4317
ܫ,MengYuanXiang,640425205,7369,1029,5747,3330,10864,5739,2967,5581,11320,5618,11365
,LuoWaXiang,640425206,3602,350,2213,1270,4120,2148,1056,2178,4326,2795,5008
,JiaoChaXiang,640425207,2971,335,2238,1201,4258,2214,1248,2206,4420,2316,4554
,CaoMiaoXiang,640425208,7491,1000,5495,3296,10556,5429,2762,5565,10994,5758,11253
,BinHeZhen,640502100,50514,4309,32982,23130,46374,31259,11508,31670,62929,33349,66331
Ĳ,WenChangZhen,640502101,58421,4288,38066,26900,49814,36908,14627,37247,74155,39270,77336
԰,DongYuanZhen,640502102,23254,1799,14775,9477,26746,14752,5893,16060,30812,16171,30946
Զ,RouYuanZhen,640502103,17122,1645,11251,7143,21250,11067,4321,11684,22751,11837,23088
,ZhenLuoZhen,640502104,19302,1817,12519,8047,24767,12475,4542,13070,25545,13142,25661
,XuanHeZhen,640502105,31466,2738,21702,12916,35830,21413,10390,22545,43958,22892,44594
,YongKangZhen,640502106,19469,1837,13512,7980,23607,13499,6176,13927,27426,13970,27482
,ChangLeZhen,640502107,13442,1151,8991,5486,17574,8971,3980,9465,18436,9582,18573
ӭˮ,YingShuiQiaoZhen,640502108,18400,1736,11833,7934,22665,11758,4833,12661,24419,13136,24969
,XingRenZhen,640502109,13986,1177,10237,5643,18918,10172,5653,10471,20643,10579,20816
ɽ,XiangShanXiang,640502200,5692,580,3917,2350,7977,3917,1901,4246,8163,4256,8173
ﴨ,HaoChuanXiang,640502201,4853,468,3709,1999,7329,3709,2289,3899,7608,3901,7610
ɽѡ,ZhongWeiShanYangXuanYuChang,640502400,1268,61,997,513,437,997,666,998,1995,998,1995
ҵ԰,MeiLiGongYeYuanQu,640502401,1017,12,92,18,2,19,3,17,36,940,1032
,NingAnZhen,640521100,55474,4293,36747,22391,53598,35753,14563,36265,72018,37583,74330
ɳ,MingShaZhen,640521101,13937,1487,9408,5911,18103,9404,3614,9622,19026,9630,19038
ʯ,ShiKongZhen,640521102,19359,1770,11910,7341,21782,11716,4479,12298,24014,13698,25608
±,XinBaoZhen,640521103,16730,1582,11054,6240,17689,10203,4044,10430,20633,11302,22356
,EnHeZhen,640521104,13705,1486,9579,5678,15370,9577,4085,9690,19267,9697,19276
,ZhouTaXiang,640521200,17259,1682,11696,6326,22427,11676,4853,12000,23676,12098,23794
,BaiMaXiang,640521201,5216,530,3503,2165,6847,3496,1372,3605,7101,3615,7118
ඡ,YuDingXiang,640521202,8985,967,6046,3658,11846,6017,2370,6206,12223,6276,12322
ս,DaZhanChangXiang,640521203,33376,1796,24321,11904,25775,24298,14508,25313,49611,25359,49680
ˮ,HanJiaoShuiXiang,640521204,19503,1628,15449,6511,26798,15443,9782,15431,30874,15464,30913
,XuTaoXiang,640521205,2553,291,1957,1183,3850,1956,1071,1948,3904,1958,3915
ɽͷũ,ChangShanTouNongChang,640521400,5990,411,4260,2420,6182,4252,2331,4458,8710,4472,8732
ũ,QuKouNongChang,640521401,10935,1033,7857,4559,10681,7851,3871,7965,15816,7982,15839
,HaiChengZhen,640522100,13618,1145,10164,5023,20536,10164,6081,10680,20844,10680,20844
,LiWangZhen,640522101,21043,1643,16201,7970,31894,16039,10440,16665,32704,16925,33126
,XiAnZhen,640522103,14653,1343,10941,5479,21540,10936,6100,11131,22067,11155,22096
ڳ,HeiChengZhen,640522104,25392,2271,18478,8941,35028,18220,10012,18741,36961,19197,37675
Ӫ,QiYingZhen,640522105,17478,1529,12984,6725,24160,12960,7546,13483,26443,13569,26553
ʷ,ShiDianXiang,640522200,11456,979,8590,3934,17328,8588,5319,9151,17739,9164,17754
̨,ShuTaiXiang,640522201,14923,1194,11673,5854,22929,11657,7315,11737,23394,11759,23432
,GuanQiaoXiang,640522202,16466,1593,12304,6048,24699,12270,6938,12626,24896,12693,24997
,GaoYaXiang,640522206,14791,1104,11529,5849,22933,11527,7533,11895,23422,11899,23428
֣,ZhengQiXiang,640522207,11428,854,8439,4148,17276,8375,5165,8828,17203,9008,17447
,JiaTangXiang,640522208,13838,1215,10822,5688,21231,10813,7160,11368,22181,11391,22213
,CaoWaXiang,640522209,6698,477,4824,2562,9878,4813,2780,5082,9895,5131,9955
Ų,JiuCaiXiang,640522210,6142,488,4722,2289,9507,4722,3024,4932,9654,4932,9654
,LiJunXiang,640522211,7011,646,5555,2970,10821,5555,3476,5576,11131,5578,11133
,HongYangXiang,640522212,11338,906,7992,3848,16641,7769,4594,8380,16149,8846,16838
ׯ,GuanZhuangXiang,640522213,6105,526,4151,1962,8508,4150,2036,4505,8655,4516,8667
ʳ,GanChengXiang,640522214,5241,483,3781,2134,7464,3781,1991,3933,7714,3934,7715
,ZhongYangChang,640522400,2410,230,1655,903,3248,1655,769,1754,3409,1754,3409
ϻɽ�,NanHuaShanGuanLiChu,640522401,185,14,163,73,289,163,100,136,299,136,299
ϳǹ칫,LaoChengGuanLiBanGongShi,640522402,35389,1956,25452,13258,30004,23919,14725,24371,48290,26618,52070
ѽֵ,YanErWoJieDao,650102002,18426,1294,10298,5491,8536,6963,2086,7197,14160,11508,21806
ʤ·ֵ,ShengLiLuJieDao,650102003,48704,4501,31914,15395,43352,21815,6760,21064,42879,28051,59965
Ž·ֵ,TuanJieLuJieDao,650102004,56414,4088,34307,24571,34834,30862,11012,30706,61568,37207,71514
·ֵ,JieFangNanLuJieDao,650102005,18356,2792,12025,9142,16677,11296,2828,11069,22365,11951,23976
»·ֵ,XinHuaNanLuJieDao,650102006,27389,3539,17825,13655,22202,17101,4536,16775,33876,17639,35464
ƽ·ֵ,HePingLuJieDao,650102007,24896,2306,15290,12156,15330,14332,4018,14682,29014,15930,31220
ű·ֵ,JieFangBeiLuJieDao,650102008,18337,3324,12490,9688,19854,11907,2687,11155,23062,11858,24348
Ҹ·ֵ,XingFuLuJieDao,650102009,51117,5193,33887,24401,39371,29622,8984,28519,58141,31407,65294
Žֵ,DongMenJieDao,650102010,29482,5241,20278,15475,27320,19067,4526,17622,36689,18971,39249
»·ֵ,XinHuaBeiLuJieDao,650102011,22148,3904,14382,11257,18200,13149,2970,13129,26278,14640,29022
·ֵ,QingNianLuJieDao,650102012,32943,5163,22781,16630,28948,20180,5261,19055,39235,20586,43367
Ȫֵ,JianQuanJieDao,650102013,56309,6195,36190,29177,33963,35345,10942,35232,70577,37256,73446
Ӱ·ֵ,YanAnLuJieDao,650102014,28259,918,17841,14402,7118,17548,6593,17471,35019,17929,35770
ֵ,HongYanJieDao,650102015,5843,506,3711,2564,2898,3596,1793,3822,7418,4431,8142
ڼɽƬ,HeiJiaShanPianQuGuanLi,650102016,34913,1231,21155,16315,7026,19125,7011,20656,39781,22000,43155
Ƭ,ErDaoQiaoPianQuGuanLi,650102017,21407,2693,14955,10864,16405,14676,5775,14457,29133,14920,29875
�Ƭ,SaiMaChangPianQuGuanLi,650102018,25555,1842,16678,11709,11782,15738,6975,16236,31974,17694,34372
Ƭί,DaWanPianQuGuanLiWei,650102019,19586,916,11980,8504,4783,11212,5790,12040,23252,14312,26292
·ֵ,ChangJiangLuJieDao,650103001,29791,3356,16837,12040,20478,15743,4342,15511,31254,20652,37489
ֵֽ,HeTianJieJieDao,650103002,45880,8909,31425,23226,44069,30381,7257,29501,59882,30621,62046
ӽ·ֵ,YangZiJiangLuJieDao,650103003,33784,5705,22807,17177,27178,22083,5402,21304,43387,22084,44891
Ѻ·ֵ,YouHaoNanLuJieDao,650103004,22137,4238,14960,10356,19310,13153,2696,12333,25486,14111,29071
Ѻñ·ֵ,YouHaoBeiLuJieDao,650103005,41787,3831,26651,16266,28874,19991,5283,19104,39095,24250,50901
һֵ,BaYiJieDao,650103006,73586,6340,43562,25841,52732,31461,8220,31295,62756,44584,88146
¯Ժֵֽ,LuYuanJieJieDao,650103007,79358,6521,50141,36187,38333,48836,17255,50255,99091,52993,103134
ɽֵ,XiShanJieDao,650103008,48050,5019,30752,23708,25331,30287,10159,31181,61468,32476,63228
ɽֵ,YaMaLiKeShanJieDao,650103009,33473,3776,21156,17466,17908,20928,7024,22381,43309,23117,44273
ӽֵ,HongMiaoZiJieDao,650103010,78548,8724,50108,41318,42488,48932,14063,49519,98451,51227,101335
ũʮʦһ,BingTuanNongShiErShiYi,650103501,26138,3272,16848,12717,16023,16358,5774,17152,33510,18336,35184
ʮʦɽ,BingTuanShiErShiXiShan,650103502,3831,422,2307,1862,3090,2263,765,2534,4797,2711,5018
·ֵ,BeiJingLuJieDao,650104001,68524,6550,41792,27538,43850,32672,8806,32527,65199,42088,83880
ֵ,ErGongJieDao,650104002,42042,3515,25455,21049,25145,24161,6543,24934,49095,26645,52100
ֵ,SanGongJieDao,650104003,55050,5162,33047,24395,30718,28579,7727,28791,57370,34892,67939
ʯ´ֵ,ShiYouXinCunJieDao,650104004,38022,5614,24584,19410,29997,24309,6386,24559,48868,25438,50022
ӭ·ֵ,YingBinLuJieDao,650104005,39732,6348,25555,19988,33245,23857,6362,24379,48236,26887,52442
ʲ·ֵ,KaShiDongLuJieDao,650104006,42668,3127,19742,12033,16987,14372,4047,15003,29375,30100,49842
վ·ֵ,BeiZhanDongLuJieDao,650104007,6594,252,3511,2891,1870,3424,1424,4093,7517,4759,8270
·ֵ,TianJinLuJieDao,650104009,23070,1259,12653,10420,7538,11915,4093,13405,25320,15769,28422
·ֵ,YinChuanLuJieDao,650104010,61610,5115,38057,29586,33343,35753,10854,35915,71668,39522,77579
γ·ֵ,NanWeiLuJieDao,650104011,37115,6256,23477,18764,35232,21885,4722,21501,43386,24616,48093
·ֵ,HangZhouLuJieDao,650104012,51887,5037,31925,20568,35115,24595,7492,25095,49690,32491,64416
Ǳ·ֵ,ZhongYaBeiLuJieDao,650104013,19690,1085,11576,9346,7982,10856,3534,11538,22394,12733,24309
·ֵ,ZhongYaNanLuJieDao,650104014,27261,3118,17073,13657,15795,16025,4353,16709,32734,17659,34732
·ֵ,YouYiLuJieDao,650104015,11334,303,6397,5579,2958,6314,2608,7585,13899,7848,14245
ɽֵֽ,SongShanJieJieDao,650104016,7178,195,2195,1486,153,1612,326,1719,3331,5504,7699
,ErGongXiang,650104200,13318,529,7602,6245,5440,7457,3105,8675,16132,9350,16952
ѱ,DiWoBaoXiang,650104201,6737,339,4033,2534,4384,3782,1908,4213,7995,4951,8984
³ľ¼ҵ,WuLuMuQiGaoXinJiShuChanYeKaiFaQu,650104400,33492,1274,19094,15696,8873,18174,5615,19175,37349,21287,40381
ˮĥֵ´,ShuiMoGouJieDaoBanShiChu,650105001,37014,5105,24955,18142,26883,22066,6425,21541,43607,23589,48544
ֵ´,LiuDaoWanJieDaoBanShiChu,650105002,62253,5356,37466,31534,28193,35395,9845,36701,72096,39988,77454
έֵ´,WeiHuLiangJieDaoBanShiChu,650105003,31582,5159,21565,16558,27181,21378,6989,21428,42806,22165,43730
˵ֵ´,BaDaoWanJieDaoBanShiChu,650105004,2471,313,1574,1190,1722,1551,542,1631,3182,1752,3326
·ֵ´,XinMinLuJieDaoBanShiChu,650105005,54090,4335,34113,25250,34053,30469,8167,30181,60650,32479,66592
Ϻ·ֵ´,NanHuNanLuJieDaoBanShiChu,650105006,63549,3071,36089,32713,19624,34926,10696,39061,73987,41227,77316
Ϻ·ֵ´,NanHuBeiLuJieDaoBanShiChu,650105007,33904,1131,18230,16482,6634,17639,5864,19681,37320,22669,40899
ߵֵ´,QiDaoWanJieDaoBanShiChu,650105008,25980,1071,11686,8327,6326,9892,3307,11165,21057,18672,30358
ˮĥũ칫,ShuiMoGouQuNongCunShiWuGuanLiBanGongShi,650105400,1948,218,1314,751,2267,1304,558,1357,2661,1410,2724
ͷͺӽֵ,TouTunHeJieDao,650106001,41015,6864,26129,23299,47480,25714,7673,26848,52562,29423,55552
վֵ,HuoCheXiZhanJieDao,650106002,28865,4560,18709,14685,25060,16648,4047,16754,33402,18763,37472
ҹֵ,WangJiaGouJieDao,650106003,7944,393,4320,3345,2718,4104,1630,4586,8690,5647,9967
ڲ·ֵ,WuChangLuJieDao,650106004,5067,205,2461,1381,1902,1586,589,1705,3291,3400,5861
վ·ֵ´,BeiZhanXiLuJieDaoBanShiChu,650106005,5531,251,3110,2720,1093,3060,1385,3749,6809,4057,7167
ͷͺ,TouTunHeQuXiangLeiSi,650106198,6334,253,3740,2754,1925,3629,1756,4174,7803,4603,8343
ʮʦƺ,BingTuanShiErShiSanPing,650106501,8748,1085,5570,4774,7676,5527,1965,6090,11617,6228,11798
ʮʦһ,BingTuanShiErShiWuYi,650106502,8947,1114,5832,3911,6306,5692,2045,5950,11642,6274,12106
½ʮʦ,XinJiangBingTuanShiErShi,650106503,19288,851,10806,9593,5119,10666,4391,12821,23487,13724,24530
άֵ,AiWeiErGouJieDao,650107001,7000,157,3483,3557,2280,3435,1318,4407,7842,4992,8475
ֵ,WuLaBoJieDao,650107004,5693,1542,3982,3857,6161,3950,877,4069,8019,4130,8112
κֵ,DaBanChengQuYanHuJieDao,650107006,2605,288,1540,1554,1982,1426,416,1598,3024,1769,3309
,DaBanChengZhen,650107100,4363,328,2299,1632,3360,2185,849,2475,4660,3241,5540
,DongGouXiang,650107200,3285,446,1980,1658,4144,1964,835,2525,4489,2586,4566
,XiGouXiang,650107201,2199,295,1465,973,2466,1442,660,1601,3043,1689,3154
,AKeSuXiang,650107202,2125,155,1477,754,2829,1477,729,1532,3009,1532,3009
ѱί,ChaiWoBaoGuanWeiHui,650107400,3607,207,1788,1107,2455,1705,678,1793,3498,2704,4492
ʯֵ,ShiHuaJieDao,650109001,23998,2575,14522,12559,23083,14277,4196,15076,29353,16247,30769
ذֵ,DiBangJieDao,650109002,11828,1493,6879,4938,8117,6219,2051,6631,12850,8493,15372
ֵ,QiaZiWanJieDao,650109003,30804,5253,19223,13494,22096,15336,4236,15965,31301,21070,40293
ض·ֵ,GuMuDiDongLuJieDao,650109004,37774,2667,23125,18243,25158,22244,7855,23812,46056,25171,48296
·ֵ,GuMuDiXiLuJieDao,650109005,43320,3174,27473,21747,25629,27071,9839,28158,55229,28860,56333
Ѻ·ֵ,YouHaoLuJieDao,650109006,19235,2228,10327,7369,9892,8756,2980,9722,18478,14116,24443
,GuMuDiZhen,650109100,26959,2307,16631,12206,20797,15926,6800,18101,34027,19435,36066
�,TieChangGouZhen,650109101,11099,1098,5510,5109,6611,5052,1914,6010,11062,8601,14111
ɽ,ChangShanZiZhen,650109102,13656,2134,8466,7709,17358,8455,2983,10276,18731,10307,18773
ë,YangMaoGongZhen,650109103,11435,1717,7348,6535,14598,7347,2851,8646,15993,8655,16003
,SanDaoBaZhen,650109104,8825,1286,5166,5242,8926,5113,1349,5951,11064,6294,11460
,BaiYangHeXiang,650109200,6530,270,2503,1904,3757,2182,864,2695,4877,5161,7664
«ݹ,LuCaoGouXiang,650109201,10522,1307,6391,5512,7976,6292,2264,7269,13561,7702,14093
ˮ,ShuiXiGouZhen,650121100,8725,622,5159,3834,8577,5029,1861,5221,10250,6049,11208
,AnNingQuZhen,650121101,14605,1427,9249,6678,15112,9161,3205,9685,18846,9988,19237
,QingGeDaHuXiang,650121204,3225,534,2124,1612,3928,2106,555,2167,4273,2190,4314
ʮ,LiuShiHuXiang,650121206,5414,658,3380,2468,5662,3273,1212,3430,6703,3904,7284
,SaErDaBanXiang,650121207,7734,405,4552,3177,6848,4355,1783,4775,9130,5370,9922
ʹ,GanGouXiang,650121208,4424,363,2924,1915,5399,2913,1243,3076,5989,3106,6030
,YongFengXiang,650121210,5097,638,3356,2680,5798,3348,1363,3702,7050,3742,7098
巿,BanFangGouXiang,650121212,9941,1067,6350,4191,11108,6229,2649,6685,12914,7307,13657
,TuoLiXiang,650121213,3243,264,2134,1467,3837,2125,930,2265,4390,2303,4437
ɽ·ֵ´,JinShanLuJieDaoBanShiChu,650202001,19553,2749,12919,10067,14780,12329,4275,12038,24367,13658,26577
·ֵ´,XiNingLuJieDaoBanShiChu,650202002,31760,2580,19712,14847,31873,18528,6826,18387,36915,21454,41166
±´,XinBeiQuBanShiChu,650202003,1402,39,577,394,68,482,177,593,1075,1041,1618
ɽ·ֵ´,TianShanLuJieDaoBanShiChu,650203001,31347,4786,20806,16403,29493,20143,5144,19290,39433,20471,41277
ʤ·ֵ´,ShengLiLuJieDaoBanShiChu,650203002,39891,5684,25703,21730,32773,25357,6788,26184,51541,26660,52363
·ֵ´,KunLunLuJieDaoBanShiChu,650203003,62005,4026,36972,28216,53685,35658,11948,36465,72123,41007,77979
·ֵ´,YinHeLuJieDaoBanShiChu,650203004,26821,1777,16870,12700,21200,16410,5907,16732,33142,17635,34505
ֵ´,JinLongZhenJieDaoBanShiChu,650203005,11894,960,6716,5444,7201,6537,2468,7018,13555,8606,15322
ֵ´,WuWuXinZhenJieDaoBanShiChu,650203006,1623,138,948,711,1419,928,306,1012,1940,1119,2067
С,XiaoGuaiXiang,650203200,1246,48,600,369,987,513,202,527,1040,896,1496
ũҵ,NongYeKaiFaQu,650203400,1446,105,684,658,44,607,77,798,1405,944,1628
һ,BingTuanYiErJiuTuan,650203506,20526,2454,12318,8848,21743,12034,3440,12537,24571,14102,26420
һ,BingTuanYiSanLiuTuan,650203530,6200,714,4099,2985,5744,3949,1474,4124,8073,4289,8388
·ֵ,ZhongXingLuJieDao,650204001,36114,2703,21888,16453,33654,21526,6529,21751,43277,23458,45346
ƽ·ֵ,SanPingLuJieDao,650204002,4019,90,2171,1531,1853,2044,967,2168,4212,2905,5076
ֵֽ´,LiuShuJieJieDaoBanShiChu,650205001,1069,47,604,455,194,540,223,601,1141,735,1339
ڶ,WuErHeXiang,650205200,734,70,482,312,788,472,185,495,967,507,989
һ,BingTuanYiSanQiTuan,650205509,5383,864,3629,2607,5461,3570,1205,3641,7211,3823,7452
ϳǽֵ´,LaoChengJieDaoBanShiChu,652101001,16915,1279,11524,7067,15425,11356,4614,11115,22471,11284,22808
ֵ߲´,GaoChangJieDaoBanShiChu,652101002,37622,2035,20347,12892,29262,18574,7335,18167,36741,26645,46992
ѹֵ´,PuTaoGouJieDaoBanShiChu,652101003,6415,480,4511,2003,8503,4495,2146,4481,8976,4530,9041
Ȫ,QiQuanHuZhen,652101100,7143,1125,4764,3525,7733,4748,1786,5148,9896,5290,10054
,DaHeYanZhen,652101101,7392,907,3773,2964,4743,3244,834,3485,6729,5360,9133
Ƕ,YaErXiang,652101200,37490,2680,26459,12734,44551,26281,13137,26610,52891,26848,53307
,AiDingHuXiang,652101201,13374,1139,9020,4637,17801,8998,4377,9596,18594,9870,18890
,PuTaoXiang,652101202,10807,934,7796,3555,14541,7796,3942,7887,15683,7887,15683
ǡؿ,QiaTeKaLeXiang,652101203,19052,1512,13218,6369,25510,13218,6610,13956,27174,13956,27174
,ErBaoXiang,652101204,8593,629,6099,2586,11398,6076,3195,6276,12352,6318,12417
,SanBaoXiang,652101205,10613,779,7494,3402,14449,7487,3743,7609,15096,7641,15135
ʤ,ShengJinXiang,652101206,16795,1398,11907,5756,23645,11895,6053,12306,24201,12339,24246
԰ճ,HongLiuHeYuanYiChang,652101400,1736,249,1155,909,1832,1155,328,1158,2313,1158,2313
ԭֳ,YuanZhongChang,652101401,1527,131,1077,555,2100,1074,548,1109,2183,1129,2206
Ŷһ,BingTuanErErYiTuan,652101502,2949,508,1971,1473,3593,1959,529,1980,3939,2015,3986
۷,ShanShanZhen,652122100,34714,1871,20462,13272,30663,18736,7738,18531,37267,23861,44323
߿̨,QiKeTaiZhen,652122101,12357,981,7694,4524,13915,7289,2948,7782,15071,8592,16286
վ,HuoCheZhanZhen,652122102,17093,572,7933,6324,4374,6391,2388,7005,13396,12120,20053
ľ,LianMuQinZhen,652122103,23994,1637,16385,8408,30704,16096,8004,16714,32810,17250,33635
³,LuKeQinZhen,652122104,22793,1647,16011,7658,30763,15936,8057,16403,32339,16486,32497
չ,PiZhanXiang,652122200,18954,1583,12850,7191,24366,12821,5457,13096,25917,13144,25994
,DongBaZhaHuiZuMinZu,652122201,3441,352,2226,1443,3918,2225,736,2289,4514,2303,4529
,TuYuGouXiang,652122202,16590,1298,11736,6080,23087,11678,6066,12140,23818,12218,23954
˿,DaLangKanXiang,652122203,10501,889,7432,3824,14397,7416,3619,7534,14950,7577,15009
Ͽ,DiKanXiang,652122204,6363,420,4076,2355,7316,4013,1851,4225,8238,4558,8634
ɽ,NanShanKuangQu,652122400,2014,1,249,13,0,8,6,20,28,1772,2021
԰ճ,YuanYiChang,652122500,3273,398,2171,1391,3484,2129,691,2126,4255,2191,4362
пѷ,TuoKeXunZhen,652123100,22531,1805,14140,10421,17871,13298,5321,14105,27403,15517,29657
ʲ,KuMiShenZhen,652123101,1167,39,576,384,421,493,183,584,1077,813,1389
˶,KeErJianZhen,652123102,2599,136,1093,547,1981,934,435,1004,1938,2077,3170
ֻ,ALeHuiZhen,652123103,3403,101,859,760,3,439,72,780,1219,2717,3576
,XiaXiang,652123200,17905,1950,11887,7875,24015,11885,5327,13285,25170,13295,25182
ղ,GuoLeBuYiXiang,652123201,13443,1306,9097,5455,18073,9080,4116,9749,18829,9768,18865
,YiLaHuXiang,652123202,11015,1000,7062,4340,14025,6936,3150,7625,14561,8103,15165
˹̹,BoSiTanXiang,652123203,15332,1350,9995,6007,20353,9923,4535,10771,20694,11222,21217
ֵ,DongHeQuJieDao,652201001,50461,6862,33572,24907,46193,32813,10069,32173,64986,33820,67392
ֵ,XiHeQuJieDao,652201002,33009,3645,21921,15490,28927,20932,6837,20194,41126,21570,43491
ֵ,XinShiQuJieDao,652201003,43887,7904,29301,23716,42364,28559,6885,28487,57046,29375,58676
԰ֵ´,LiYuanJieDaoBanShiChu,652201004,30764,2965,19209,13665,24238,18222,5788,18664,36886,20308,39517
ʯ³ǽֵ´,ShiYouXinChengJieDaoBanShiChu,652201005,30991,1298,17490,12777,28564,16502,5008,16867,33369,19807,37297
,YaManSuZhen,652201100,2891,30,565,421,178,312,65,438,750,2421,2986
߽Ǿ,QiJiaoJingZhen,652201101,4038,97,919,586,673,668,208,737,1405,3424,4343
Ͽ,XingXingXiaZhen,652201102,2165,7,330,69,2,68,3,81,149,1845,2175
,ErBaoZhen,652201103,8625,1067,5688,4131,10185,5616,2280,6055,11671,6284,11972
߳,QinChengXiang,652201200,8468,620,3871,2333,6641,3258,1199,3540,6798,6416,10287
̨,WuLaTaiHaSaKeMinZuXiang,652201201,580,40,404,222,558,386,190,402,788,406,810
˫,ShuangJingZiXiang,652201202,657,1,75,68,4,50,0,74,124,583,658
Ȫ,DaQuanWanXiang,652201203,7896,759,5191,3543,8757,5133,1946,5312,10445,5410,10601
ռҹ,TaoJiaGongXiang,652201204,14009,1453,9022,5607,16195,8989,3256,9562,18551,9696,18718
س,HuiChengXiang,652201205,7588,766,5060,3068,6536,5049,1948,5176,10225,5242,10302
԰,HuaYuanXiang,652201206,7714,834,4477,2599,7744,4363,1782,4649,9012,5853,10330
Ϻ,NanHuXiang,652201207,2162,249,1113,781,2128,1053,392,1131,2184,1690,2803
層,WuBaoXiang,652201208,8497,805,5954,3310,11647,5903,3228,6408,12311,6576,12530
ﶼ˹,DeWaiLiDouRuKeHaSaKeXiang,652201209,2581,125,1754,1023,2344,1754,794,1744,3498,1746,3500
ɽ,XiShanXiang,652201210,2364,211,1567,1098,3006,1566,726,1734,3300,1734,3301
ɽ,TianShanXiang,652201211,5379,467,3522,2378,7062,3513,1596,3873,7386,3920,7442
ʯͷ,BaiShiTouXiang,652201212,1185,90,756,530,1265,745,294,769,1514,813,1569
,LiuShuGouXiang,652201214,1008,61,702,432,1269,702,370,737,1439,737,1439
,SanDaoLingKuangQu,652201401,23040,3828,14852,11717,26771,14598,3645,14642,29240,15661,30513
ɽϿ,BaLiKunXianShanNanKaiFaQu,652201402,1052,90,686,548,1,686,250,706,1392,706,1392
ɽϿί,YiWuXianShanNanKaiFaQuGuanWeiHui,652201403,748,107,533,386,0,531,223,533,1064,545,1078
ũҵۺϿ,XiGeBiNongYeZongHeKaiFaQu,652201404,2616,86,1611,982,1187,1605,699,1754,3359,1790,3401
�,HaMiYiWuMaChang,652201405,1822,302,1175,1046,2145,1160,409,1286,2446,1358,2533
źһ,BingTuanHongXingYiChang,652201500,8848,1026,5378,3650,7929,4991,1630,5215,10206,6126,11504
źǶ,BingTuanHongXingErChang,652201501,5043,837,3180,2355,5196,3053,928,3085,6138,3628,6808
źĳ,BingTuanHongXingSiChang,652201502,5647,396,3690,2422,5959,3614,1545,3790,7404,3898,7588
Żũ,BingTuanHuangTianNongChang,652201503,6564,904,4493,2993,8312,4473,1789,4737,9210,4764,9257
Żũ,BingTuanHuoJianNongChang,652201504,19735,1704,11980,8996,14570,11830,4000,12977,24807,13459,25439
Ȫũ,BingTuanLiuShuQuanNongChang,652201505,7749,868,4817,3506,9129,4782,1906,5490,10272,5706,10523
,BaLiKunZhen,652222100,10503,959,7112,5288,8864,6821,2851,6678,13499,7201,14313
Ǽ,BoErQiangJiZhen,652222101,1715,24,505,48,207,40,58,59,99,1292,1797
,DaHeZhen,652222102,7107,1279,4783,4251,9143,4779,1398,4993,9772,5001,9784
,KuiSuZhen,652222103,4956,712,3193,2688,6462,3193,967,3442,6635,3442,6635
ǿ,SaErQiaoKeXiang,652222200,2474,171,1836,978,3341,1835,1017,1823,3658,1826,3662
,HaiZiYanXiang,652222201,3715,254,2655,1469,5011,2646,1328,2611,5257,2642,5297
԰,XiaLaoBaXiang,652222202,2987,141,2158,1273,4074,2151,1207,2157,4308,2177,4335
ʯ,ShiRenZiXiang,652222205,3591,585,2317,2067,4403,2317,581,2440,4757,2440,4757
԰,HuaYuanXiang,652222206,3711,493,2303,2059,3989,2295,738,2606,4901,2639,4942
,SanTangHuXiang,652222207,1735,133,503,353,760,373,85,438,811,1450,1953
Ͽ,DaHongLiuXiaXiang,652222208,2637,123,1267,1068,2492,1233,628,1457,2690,2121,3388
ǽ,BaQiangZiXiang,652222209,1412,85,967,667,1372,967,540,1070,2037,1070,2037
ַ,LiangZhongFanYuChang,652222400,269,52,190,164,328,190,46,177,367,177,367
,HuangTuChangKaiFaQu,652222401,1451,79,962,662,1895,962,579,1147,2109,1147,2109
źɽũ,BingTuanHongShanNongChang,652222500,7373,878,4653,3791,8278,4638,1815,5201,9839,5413,10066
,YiWuZhen,652223100,3471,158,1991,1937,3698,1921,701,2098,4019,2339,4330
ë,NaoMaoHuZhen,652223101,5656,205,2638,1900,3677,2231,986,2329,4560,4209,6847
έϿ,WeiZiXiaXiang,652223201,580,51,369,263,709,363,121,364,727,383,752
,XiaMaYaXiang,652223202,713,114,463,396,959,457,170,521,978,534,997
γ,YanChiXiang,652223203,2958,229,1947,1349,3943,1946,779,2006,3952,2019,3966
º«,TuHuLuXiang,652223204,1960,229,1247,1070,2485,1247,393,1330,2577,1335,2582
ǰɽ,QianShanHaSaKeMinZu,652223205,2185,130,1549,938,2935,1544,815,1574,3118,1581,3130
ëũ,BingTuanNaoMaoHuNongChang,652223500,1672,98,1048,831,1963,1043,409,1104,2147,1131,2179
·´,NingBianLuBanShiChu,652301001,20252,1994,13170,9763,14813,12977,4524,13415,26392,13600,26770
Ӱ·´,YanAnBeiLuBanShiChu,652301002,43686,5015,29295,21336,32769,24512,7212,24695,49207,26618,55913
·´,BeiJingNanLuBanShiChu,652301003,62769,7953,39712,31438,63871,37966,10322,38486,76452,41332,81044
·´,JianGuoLuBanShiChu,652301004,34679,1489,20880,16750,16342,20269,7130,21466,41735,22418,43298
ɽ·ֵ´,ZhongShanLuJieDaoBanShiChu,652301005,25346,1116,12631,8801,11938,10178,3689,11171,21349,17520,30151
·ֵ´,LvZhouLuJieDaoBanShiChu,652301006,55029,5751,34056,26152,41036,30992,9232,32330,63322,35956,70012
ǹ,LiuHuangGouZhen,652301100,3168,68,1475,1738,913,1448,525,2046,3494,2286,3761
,SanGongZhen,652301101,11312,1663,7260,5472,13808,6997,2433,7662,14659,8148,15408
,YuShuGouZhen,652301102,10266,771,6329,4298,9916,6064,2644,6629,12693,7352,13681
,ErLiuGongZhen,652301103,8814,809,5791,4197,10331,5774,2706,6499,12273,6538,12329
,DaXiQuZhen,652301104,10086,1284,6506,5257,9997,6363,2546,7137,13500,7410,13916
,LiuGongZhen,652301105,7438,1138,4649,4097,8395,4596,1439,5173,9769,5366,10015
,DianBaXiang,652301200,3865,669,2428,2264,4821,2410,679,2774,5184,2785,5213
,BinHuXiang,652301201,6810,1020,3687,3308,7142,3618,1110,4391,8009,5253,8940
ʲ,AShenLiHaSaKeMinZuXiang,652301202,5853,320,3733,2407,7501,3702,1948,4043,7745,4388,8121
,MiaoErGouXiang,652301203,2948,160,2025,1255,4014,2025,979,2062,4087,2062,4087
½ũҵƼ԰ίԱ,XinJiangChangJiGuoJiaNongYeKeJiYuanQuGuanLiWeiYuanHui,652301400,881,48,410,443,773,399,85,523,922,604,1014
бĮ,ChangJiShiBeiBuHuangMo,652301401,228,10,112,67,2,88,22,98,186,148,260
Źũ,BingTuanGongQingTuanNongChang,652301503,5621,768,3432,3048,5985,3422,1144,4079,7501,4101,7533
žũ,BingTuanJunHuNongChang,652301504,10650,1060,6986,5173,10915,6969,3077,7780,14749,7801,14787
ְ´,BoFengJieBanShiChu,652302001,25664,3388,17312,12798,25801,16066,5240,15672,31738,16980,34292
½ְ´,FuXinJieBanShiChu,652302002,12519,1078,7768,5990,9586,7527,2527,7864,15391,8356,16124
׼´,ZhunDongBanShiChu,652302003,12512,1274,8004,6281,13956,7902,2448,7792,15694,8230,16234
ʺ,GanHeZiZhen,652302100,7687,662,3720,3074,4280,3169,1003,3548,6717,5632,9352
ǹ,ChengGuanZhen,652302101,14354,1432,8644,6509,12012,8057,2845,8959,17016,9987,18631
˽,JiuYunJieZhen,652302102,10777,1688,6344,6382,12602,6285,1950,7487,13772,8071,14415
Ȫ,ZiNiQuanZiZhen,652302103,10302,1359,6354,5383,12041,6267,2121,7207,13474,7428,13782
ӹ,SanGongHeHaSaKeMinZuXiang,652302200,3014,244,1694,1582,3312,1611,668,1825,3436,2232,3926
ϻ,ShangHuGouHaSaKeMinZuXiang,652302201,7259,662,4335,3490,8252,4257,1774,5040,9297,5360,9695
ˮĥ,ShuiMoGouXiang,652302202,3628,267,2037,1681,3207,1940,777,2355,4295,2635,4672
Ŵɽú,BingTuanDaiHuangShanMeiKuang,652302203,3158,482,1929,1780,2389,1882,707,2176,4058,2418,4347
ũʦũ,BingTuanNongLiuShiTuDunZiNongChang,652302503,3946,364,2276,1722,3568,2050,810,2329,4379,2844,5120
˺ũ,BingTuanLiuYunHuNongChang,652302504,4175,591,2595,2647,4722,2580,906,3016,5596,3077,5672
Ŷũ,BingTuanErErErTuanNongChang,652302505,6220,1367,4173,3728,7076,4061,1157,4382,8443,4571,8744
ͼ,HuTuBiZhen,652323100,32338,3078,21441,15849,27392,21246,7711,21234,42480,21686,43127
,DaFengZhen,652323101,8424,869,5355,3891,9606,5294,2161,5852,11146,6099,11454
ȸ,QueErGouZhen,652323102,8793,483,5032,3862,9920,5024,2104,6046,11070,6348,11380
ʮ,ErShiLiDianZhen,652323103,10808,1205,6768,5135,11651,6326,2307,7027,13353,7552,14320
԰,YuanHuCunZhen,652323104,14510,1477,9239,7290,13700,9224,3663,10302,19526,10411,19650
幤̨,WuGongTaiZhen,652323105,13286,1552,8269,6998,14825,8120,3061,9366,17486,9630,17899
ʯӹ,ShiTiZiHaSaKeMinZuXiang,652323201,5074,294,3213,2467,6205,3213,1566,3584,6797,3721,6934
ַ,XianLiangZhongFanYuChang,652323401,681,62,422,331,535,422,173,494,916,494,916
ɺֳ,GanHeZiLinChang,652323402,606,73,404,324,659,399,151,423,822,426,830
ͼţ,HuTuBiZhongNiuChang,652323405,5043,960,3440,3041,5712,3403,1026,3514,6917,3589,7029
һ,BingTuanYiLingWuTuan,652323520,10583,1258,6335,5956,9686,6178,2061,7413,13591,7567,13902
һ,BingTuanYiLingLiuTuan,652323521,4060,628,2373,2507,4960,2373,728,3040,5413,3043,5416
ŷݺܳ,BingTuanFangCaoHuZongChang,652323523,43360,6954,25282,26607,48235,24702,7030,29882,54584,32062,57344
˹,MaNaSiZhen,652324100,28320,3133,18798,14176,22469,18522,6624,18468,36990,19279,38077
,LeTuYiZhen,652324101,7001,847,4712,3231,8395,4684,1954,4942,9626,5090,9802
ҵ,BaoJiaDianZhen,652324102,9002,1164,6025,4078,11169,5994,2336,6400,12394,6477,12502
ݻ,LiangZhouHuZhen,652324103,4899,663,3171,2481,5484,3123,1100,3368,6491,3491,6662
,BeiWuChaZhen,652324104,5137,637,3175,2639,5843,3073,962,3412,6485,3561,6736
,LiuHuDiZhen,652324105,4803,628,2973,2571,5457,2822,926,3203,6025,3384,6357
,LanZhouWanZhen,652324106,8980,1080,5597,4831,9037,5530,1872,6118,11648,6335,11932
ͷ,TouGongXiang,652324200,8124,949,5098,4323,6461,5066,1823,5564,10630,5798,10896
㶫,GuangDongDiXiang,652324201,4328,617,2753,2368,4610,2691,853,2948,5639,3045,5798
ˮӹ,QingShuiHeZiHaSaKeMinZuXiang,652324202,5307,351,2834,2216,5472,2765,1162,3298,6063,3986,6820
ӹ,TaXiHeHaSaKeMinZuXiang,652324203,2416,165,1371,960,2720,1322,545,1545,2867,1755,3126
̲,HanQiaZiTanHaSaKeMinZuXiang,652324204,3372,318,2059,1588,3860,2035,785,2307,4342,2416,4475
繤ҵ,MaDianGongYeQu,652324400,2548,92,1346,1407,1693,1342,473,1522,2864,1767,3113
԰ճ,YuanYiChang,652324401,2001,223,1206,1006,1452,1185,361,1297,2482,1379,2585
ҵ˹ƽԭֳ,ZiZhiQuLinYeTingMaNaSiPingYuanLinChang,652324402,1320,198,825,683,1099,814,278,933,1747,971,1796
½ũԺ˹վ,XinJiangNongKeYuanMaNaSiShiYanZhan,652324403,1184,161,718,590,1211,709,183,782,1491,810,1528
ũʦºũ,BingTuanNongLiuShiXinHuNongChang,652324520,25535,3634,14824,13692,28862,14652,4476,16715,31367,18821,33645
һ,BingTuanYiSiQiTuan,652324521,10008,2405,6627,6676,12220,6482,1898,7393,13875,7684,14311
һİ,BingTuanYiSiBaTuan,652324522,20676,3489,12537,12646,23360,12232,3137,14158,26390,14765,27302
һľ,BingTuanYiSiJiuTuan,652324523,11227,2305,7402,6976,13921,7298,2128,8083,15381,8258,15660
һ,BingTuanYiWuLingTuan,652324524,10729,1948,6709,6465,13031,6671,1758,7621,14292,7726,14435
̨,QiTaiZhen,652325100,48858,4518,30869,22709,35443,29181,10401,29941,59122,32908,63777
̨,LaoQiTaiZhen,652325101,7499,1094,4552,4168,9006,4552,1313,5352,9904,5354,9906
ع,BanJieGouZhen,652325102,11788,1611,7254,6000,15209,7222,2645,8635,15857,8790,16044
,JiBuKuZhen,652325103,7801,1093,4829,4020,10404,4829,1746,5811,10640,5811,10640
,DongWanZhen,652325104,5293,819,3240,2902,6865,3237,912,3780,7017,3784,7024
,XiDiZhen,652325105,8215,1174,5023,4469,10471,5022,1491,5856,10878,5857,10880
,BiLiuHeXiang,652325200,5742,823,3433,3074,7337,3427,982,4101,7528,4114,7547
,XiBeiWanXiang,652325201,13416,1679,8344,6613,15722,8320,2884,9528,17848,9635,17979
,KanErZiXiang,652325202,3077,324,1945,1387,3959,1945,861,2317,4262,2317,4262
�,WuMaChangXiang,652325203,5070,403,3448,2350,6774,3448,1699,3724,7172,3724,7172
ų,GuChengXiang,652325204,6281,541,3835,3088,5610,3781,1270,4087,7868,4257,8092
,QiaoRenXiang,652325205,3273,172,1552,1091,2905,1419,681,1719,3138,2574,4126
߻,QiHuXiang,652325206,4248,669,2447,2423,5324,2431,547,2981,5412,3017,5464
ׯ,SanGeZhuangZiXiang,652325207,2864,355,1602,1526,3177,1564,448,1954,3518,2065,3667
,TaTaErXiang,652325208,2727,179,1706,1152,3378,1698,820,1972,3670,2020,3726
̨ũ,BingTuanQiTaiNongChang,652325503,19566,3610,12397,11335,24053,12318,3692,14289,26607,14471,26868
ũʦ,BingTuanNongLiuShiBeiTaMuChang,652325504,2398,115,1577,1027,3267,1572,879,1794,3366,1815,3392
ľ,JiMuSaErZhen,652327100,26295,2446,17304,12573,20336,17043,6401,17140,34183,17838,35142
̨,SanTaiZhen,652327101,6713,1082,4424,3474,7661,4406,1478,4744,9150,4849,9273
Ȫӽ,QuanZiJieZhen,652327102,5846,902,3560,3182,7575,3556,1174,4345,7901,4362,7922
ͥ,BeiTingZhen,652327103,4819,876,2818,2938,5754,2785,668,3442,6227,3545,6363
,ErGongXiang,652327200,8611,1210,5243,4585,9925,5196,1735,6119,11315,6313,11556
,QingYangHuXiang,652327202,4756,671,2968,2441,5884,2958,965,3379,6337,3424,6392
̨,LaoTaiXiang,652327203,5456,690,3217,2736,6681,3147,1070,3825,6972,3999,7216
,DaYouXiang,652327204,7798,1105,4647,4242,10272,4634,1781,6017,10651,6037,10684
µ,XinDiXiang,652327205,3641,399,1900,1673,3904,1844,686,2352,4196,2826,4726
幤ҵ԰,WuCaiWanGongYeYuanQu,652327400,2456,6,274,5,0,2,4,9,11,2192,2466
ũʦũ,BingTuanNongLiuShiHongQiNongChang,652327500,8516,1547,5255,5073,10773,5226,1481,6231,11457,6289,11544
ľ,MuLeiZhen,652328100,14916,1623,10082,7053,11325,9904,3807,9865,19769,10264,20346
�,XiJiErZhen,652328101,3089,612,2025,1520,4074,2025,488,2164,4189,2164,4189
,DongChengZhen,652328102,5172,877,3480,2391,6902,3480,1087,3656,7136,3656,7136
Ӣ,YingGeBaoXiang,652328200,2655,535,1745,1390,3504,1745,403,1848,3593,1848,3593
ձɽ,ZhaoBiShanXiang,652328201,3902,558,2525,1807,4115,2522,774,2689,5211,2709,5234
»,XinHuXiang,652328202,3636,588,2383,1778,4343,2378,705,2531,4909,2546,4929
ȸ,QueRenXiang,652328203,3761,264,2422,1418,4024,2405,1122,2658,5063,2725,5147
,BaiYangHeXiang,652328204,1338,128,905,512,1792,905,396,953,1858,957,1862
ʯͷ,DaShiTouXiang,652328205,3836,264,2804,1356,5504,2804,1585,2881,5685,2881,5685
Ϲα,DaNanGouWuZiBieKe,652328206,1704,93,1168,599,2266,1168,599,1228,2396,1228,2396
˹̹,BoSiTanXiang,652328207,2798,204,1787,1239,3760,1786,924,2134,3920,2139,3926
ַ,LiangZhongFanYuChang,652328400,571,64,373,259,351,373,121,383,756,383,756
ȿ˿ⶼ,KeReKeKuDouKeMu,652328401,460,9,102,110,147,100,51,167,267,418,520
ֵ,QingDeLiJieDao,652701001,18685,1693,12441,8902,18172,12184,4513,11865,24049,12450,24891
ľͼֵ,GuLiMuTuJieDao,652701002,18481,2023,12768,8913,20657,12649,4398,11990,24639,12134,24902
˶׿ֵ,KeErGenZhuoJieDao,652701003,24137,3586,16538,12273,24108,16400,5199,16001,32401,16384,32922
ϳֵ´,NanChengQuJieDaoBanShiChu,652701004,2459,81,1204,848,439,1134,472,1345,2479,1808,3012
СӪ,XiaoYingPanZhen,652701100,14065,1353,9145,5659,17612,9141,3690,9963,19104,9963,19108
,DaLeTeZhen,652701101,10148,844,6206,3839,11513,6200,2314,6630,12830,7100,13306
ͼ,WuTuBuLaGeZhen,652701102,10900,826,7352,3995,12187,7285,3337,7627,14912,7711,15063
,QingDeLiXiang,652701200,18424,1349,12590,7115,18205,12557,5890,12964,25521,13073,25663
ֹĪ,BeiLinHaRiMoDun,652701201,5364,353,3368,1973,4846,3357,1200,3539,6896,3549,6917
к,AReLeTuoHaiMu,652701400,4911,515,3348,2078,6654,3328,1397,3460,6788,3475,6823
ո,XiangBanHaRiGenMu,652701407,709,23,438,235,818,438,156,450,888,450,888
ɽ,ALaShanKou,652701450,7447,57,3014,2555,923,2478,1021,3099,5577,5511,8525
Űʮһ,BingTuanBaShiYiTuan,652701501,7582,736,4896,3353,8057,4874,1659,5047,9921,5081,9977
Űʮ,BingTuanBaShiSiTuan,652701502,5361,711,3587,2501,6128,3587,1169,3654,7241,3654,7241
Űʮ,BingTuanBaShiLiuTuan,652701504,10360,909,6822,4579,9980,6817,2780,7195,14012,7227,14049
Űʮ,BingTuanBaShiJiuTuan,652701505,10509,1110,6870,4525,11677,6836,2422,7060,13896,7171,14041
žʮ,BingTuanJiuShiTuan,652701506,6486,512,4046,2794,7074,4024,1259,4153,8177,4211,8257
,JingHeZhen,652722100,14055,1258,9518,5859,13020,8135,3414,7863,15998,9209,18727
,DaHeYanZiZhen,652722101,20881,1749,13650,8468,25769,13220,5432,13856,27076,14412,28062
ã,MangDingXiang,652722200,18557,1514,12056,7875,17838,11788,4670,12282,24070,12685,24741
,TuoLiXiang,652722201,14915,1036,9104,6268,12932,8838,3663,9995,18833,10510,19614
,TuoTuoXiang,652722202,2687,201,1486,1525,2953,1453,588,1909,3362,1990,3476
ũ,AHeQiNongChang,652722400,5177,442,3260,2359,6300,3199,1348,3640,6839,3707,6967
˼һũ,BaJiaHuNongChang,652722401,10450,1059,6444,5149,9996,6383,2739,7682,14065,7804,14248
Űʮ,BingTuanBaShiSanTuan,652722503,16764,2202,10331,8973,18742,10171,3167,11598,21769,11802,22133
žʮһ,BingTuanJiuShiYiTuan,652722504,2681,289,1755,1309,2915,1745,655,1841,3586,1870,3625
,BoGeDaErZhen,652723100,7067,536,4728,3267,6921,4596,1767,4405,9001,4642,9370
ղ,HaRiBuHuZhen,652723101,10277,984,6580,4608,11677,6495,2252,6830,13325,6933,13513
,AnGeLiGeXiang,652723200,7031,719,4590,3166,8853,4521,1673,4758,9279,4833,9423
͸,ChaGanTunGeXiang,652723201,4734,471,2965,2295,5858,2963,956,3192,6155,3196,6161
ľ,ZhaLeMuTeXiang,652723202,2331,105,1491,1116,2772,1488,594,1522,3010,1539,3030
,TaXiuXiang,652723203,4767,462,2859,2430,5624,2828,864,3191,6019,3234,6093
й,HuHeTuoHaZhongChu,652723400,4604,515,2871,2476,5895,2855,1005,3221,6076,3253,6124
,KunDeLunMuChang,652723401,2400,215,1415,1332,2881,1399,554,1740,3139,1754,3169
Ͽ,MengKeMuChang,652723402,160,7,97,103,180,97,58,128,225,128,225
Űʮ,BingTuanBaShiQiTuan,652723502,3369,847,2360,2111,4428,2347,636,2467,4814,2492,4852
Űʮ,BingTuanBaShiBaTuan,652723503,3250,644,2088,2060,3894,2087,648,2444,4531,2454,4542
Žֵ,TuanJieJieDao,652801001,62970,5479,41843,29082,50932,40671,14954,40144,80815,41560,83403
͸ֵ,SaYiBaGeJieDao,652801002,92819,10493,61958,44148,80524,58733,19422,57527,116260,60776,122734
ɽֵ,TianShanJieDao,652801003,26356,2780,17236,12765,20248,17015,5998,17186,34201,17898,35134
³ǽֵ,XinChengJieDao,652801004,44483,3374,26321,17003,28124,22827,8277,23355,46182,29813,56134
ֵ,JianSheJieDao,652801005,73749,5250,46484,35344,56939,45531,15626,46185,91716,48141,94625
ʲ,TaShenDianZhen,652801100,9964,1405,5534,4583,6913,5141,1420,5645,10786,7255,12789
ϻ,ShangHuZhen,652801101,11353,509,6594,3466,8757,5880,2676,6067,11947,7944,14538
,KuErLeShiXiNiEr,652801102,7273,501,4255,2912,4172,4006,1670,4156,8162,5189,9444
,TieKeQiXiang,652801200,369,12,248,149,105,248,114,245,493,247,495
ǡ͸,QiaErBaGeXiang,652801201,7161,381,4325,2689,5071,4244,1819,4580,8824,5036,9361
Ӣ,YingXiaXiang,652801202,7711,460,5423,2988,6453,5421,2764,5497,10918,5512,10935
,KuErLeShiLanGanXiang,652801203,5410,405,3671,2062,6291,3625,1760,3854,7479,3904,7575
ʲ,HeShenLiKeXiang,652801204,4221,318,2919,1594,5647,2917,1366,2958,5875,2986,5905
,HaLaYuGongXiang,652801205,6141,469,4322,2450,7958,4298,2195,4475,8773,4483,8805
,AWaTiXiang,652801206,7512,524,5242,2868,10418,5168,2782,5481,10649,5576,10818
в,KuErLeShiTuoBuLi,652801207,4592,355,3228,1777,6007,3170,1545,3181,6351,3264,6492
ջ,PuHuiXiang,652801208,2646,127,1676,933,2693,1503,700,1569,3072,1797,3473
԰ճ,KuErChuYuanYiChang,652801400,2823,157,1835,1088,2525,1810,832,1927,3737,1977,3812
ͷũ,BaoTouHuNongChang,652801401,1576,155,1096,682,1723,1086,504,1120,2206,1139,2235
ջũ,PuHuiNongChang,652801402,5200,221,3205,1827,3900,2907,1401,3190,6097,3617,6822
ݰũ,BaZhouAWaTiNongChang,652801403,2575,76,1476,1002,3115,1476,476,1651,3127,1651,3127
ɳ԰,BaZhouShaYiDongYuanYi,652801404,4834,319,3280,2070,5827,3280,1604,3474,6754,3477,6757
ţ,BaZhouNaiNiuChang,652801408,354,31,230,144,296,230,79,234,464,234,464
ջ,PuHuiMuChang,652801409,1149,49,735,415,851,647,304,708,1355,767,1502
,JingJiMuChang,652801410,943,29,550,283,835,489,213,512,1001,635,1185
ֳ,LiangZhongChang,652801411,422,12,245,176,392,245,82,271,516,271,516
Ŷʮ,BingTuanErShiJiuTuan,652801501,16799,2458,10196,7964,16893,9962,2865,10546,20508,11926,22122
ũʦʮ,NongErShiSanShiTuan,652801502,6047,857,3935,2974,6833,3905,1218,4070,7975,4187,8122
̨,LunTaiZhen,652822100,33124,2145,20691,15596,32861,20415,8045,21620,42035,22623,43314
,LunNanZhen,652822101,3857,26,1385,702,244,725,194,825,1550,2692,4077
ȺͿ,QunBaKeZhen,652822102,10427,585,6502,3901,12478,6223,2971,6787,13010,7481,13983
ϼ,YangXiaZhen,652822103,8727,556,5826,3258,11601,5753,2826,6145,11898,6283,12109
Ϳ,HaErBaKeXiang,652822201,8057,618,5572,3449,10885,5563,2731,5825,11388,5834,11406
Ұƹ,YeYunGouXiang,652822202,2318,125,1462,860,3023,1453,630,1590,3043,1611,3073
,AKeSaLaiXiang,652822203,4232,251,2710,1670,5562,2680,1182,2923,5603,2955,5665
,TaErLaKeXiang,652822204,3357,272,2191,1281,4516,2191,922,2360,4551,2360,4551
ݺ,CaoHuXiang,652822205,969,78,639,458,1293,639,266,674,1313,674,1313
ȿ˰,TieReKeBaZhaXiang,652822206,7269,520,4805,2611,9608,4773,2294,5181,9954,5278,10083
ߴ,CeDaYaXiang,652822207,5028,267,3148,1900,6151,3096,1297,3226,6322,3444,6592
ξ,YuLiZhen,652823100,16733,1057,10969,7532,13885,10546,4684,10872,21418,11505,22474
ľ,TaLiMuXiang,652823200,4903,316,3271,1978,6312,3247,1494,3417,6664,3442,6713
ƽ,XingPingXiang,652823201,8099,463,5218,3357,8906,5096,2309,5502,10598,5653,10871
Ž,TuanJieXiang,652823202,5468,400,3446,2398,5036,3413,1390,3704,7117,3812,7258
̹,DunKuoTanXiang,652823203,3091,210,2085,1238,3760,2016,862,2060,4076,2078,4163
,KaErQuGaXiang,652823204,2601,227,1696,1009,3380,1661,762,1856,3517,1894,3590
,AKeSuPuXiang,652823205,2023,139,1293,904,2481,1260,603,1420,2680,1472,2765
հ͸,GuLeBaGeXiang,652823206,4102,262,2750,1608,5154,2704,1166,2738,5442,2780,5530
ʮһ,BingTuanSanShiYiTuan,652823501,7156,829,4449,4003,7685,4378,1306,4766,9144,4842,9291
ũʦʮ,NongErShiSanShiSanTuan,652823502,9298,1231,5746,4442,9818,5680,1791,5828,11508,6574,12320
ʮ,BingTuanSanShiSiTuan,652823503,8474,1221,4939,4765,9723,4930,1398,5608,10538,6154,11093
Ǽ,RuoQiangZhen,652824100,7716,342,4610,3245,7274,4506,1814,4663,9169,5262,9872
̲,YiTunBuLaKeZhen,652824101,768,5,194,223,34,176,27,255,431,606,800
޲,LuoBuPoZhen,652824102,1704,8,244,77,0,39,1,80,119,1469,1713
,TieGanLiKeXiang,652824200,3970,276,2442,1554,4452,2402,910,2614,5016,2714,5156
ľ,WuTaMuXiang,652824201,3050,201,1973,1101,3433,1946,831,2007,3953,2109,4082
ʯϿ,WaShiXiaXiang,652824202,4485,204,2753,1603,4880,2655,1197,2922,5577,3133,5886
ľ,TieMuLiKeXiang,652824203,437,5,84,83,99,78,15,128,206,373,457
,QiManTaGeXiang,652824204,12,0,5,4,6,5,2,7,12,9,14
ʮ,SanShiLiuTuan,652824501,6060,541,3208,2604,5422,3120,999,3414,6534,4392,7600
ĩ,QieMoZhen,652825100,14578,770,9316,6417,16857,9187,3545,9422,18609,9577,18893
,AReLeXiang,652825200,1830,79,1103,697,2270,1103,395,1201,2304,1201,2304
,QiongKuLeXiang,652825201,4174,257,2709,1432,5056,2702,1024,2739,5441,2746,5455
иտ,TuoGeLaKeLeKeXiang,652825202,6168,339,3976,2134,7045,3967,1504,4020,7987,4035,8011
͸տ,BaGeAiRiKeXiang,652825203,3182,203,2081,1256,4097,2081,850,2154,4235,2154,4235
Ӣ˹,YingWuSiTangXiang,652825204,4700,261,3061,1608,5891,2984,1272,3111,6095,3172,6233
ῲ,AKeTiKanDunXiang,652825205,3046,117,1966,1128,3489,1964,918,2113,4077,2115,4081
ʲ,KuoShenSaTeMaXiang,652825206,2303,96,1429,836,2728,1390,583,1489,2879,1553,2982
,TaTiRangXiang,652825207,3304,147,1959,1019,3538,1824,775,1950,3774,2267,4226
Ǽ,AQiangXiang,652825208,1467,123,962,682,2062,962,474,1102,2064,1102,2064
ľտ,KuLaMuLeKeXiang,652825209,1502,92,901,672,1897,899,414,1092,1991,1107,2008
,AoYiYaYiLaKeXiang,652825210,1408,85,836,524,1523,819,360,852,1671,1017,1853
ũʦĩ֧,BingTuanNongErShiQieMoGongChengZhiDui,652825501,1428,68,514,343,886,477,219,545,1022,1201,1715
ʮ,BingTuanSanShiBaTuan,652825502,1132,4,611,468,0,591,376,707,1298,901,1512
,YanQiZhen,652826100,27976,3049,18551,13597,27787,18345,6624,18498,36843,19098,37649
߸,QiGeXingZhen,652826101,9985,838,6278,3977,12221,6167,2529,6701,12868,7074,13352
,YongNingZhen,652826102,12310,1303,8133,4952,15198,7992,3342,8599,16591,8822,16955
ʮ,SiShiLiChengZiZhen,652826103,6926,461,3509,2301,6939,3504,1521,3856,7360,5399,8908
,BeiDaQuXiang,652826200,7254,681,4903,2937,9848,4902,2269,5296,10198,5301,10204
,WuHaoQuXiang,652826201,13317,988,8698,5160,14947,8692,3854,9446,18138,9461,18159
麹ɿ,ChaHanCaiKaiXiang,652826203,3379,237,2230,1396,4271,2230,897,2283,4513,2283,4513
,BaoErHaiXiang,652826204,4356,423,2770,1738,5740,2768,1068,3074,5842,3077,5847
ׯ,WangJiaZhuangMuChang,652826400,1325,97,634,429,1096,587,220,635,1222,1008,1642
պֳ,SuHaiLiangZhongChang,652826401,1333,106,795,622,1421,795,332,971,1766,976,1771
Ŷʮ,BingTuanErShiQiTuan,652826501,6247,1376,4026,3232,7154,3976,1005,3946,7922,4602,8628
;,HeJingZhen,652827100,35054,2629,23140,15069,35497,22182,8699,22232,44414,23242,46382
̨,BaLunTaiZhen,652827101,7489,482,3626,3016,4298,3372,1249,3932,7304,5594,9220
Ī,BaRunHaErMoDunZhen,652827102,14586,907,9232,5428,17465,9170,3876,10006,19176,10137,19369
Ī,HaErMoDunZhen,652827103,13283,950,8471,5019,16382,8348,3701,8905,17253,9463,17934
³,BaYinBuLuKeZhen,652827104,2930,68,1734,1294,3386,1712,789,1985,3697,2053,3787
Ī,NaiMenMoDunXiang,652827200,5721,455,3747,2073,7483,3747,1758,4165,7912,4187,7934
Э˶,XieBiNaiErBuHuXiang,652827201,3584,279,2359,1323,4814,2359,989,2493,4852,2493,4852
˶,KeErGuTiXiang,652827203,551,18,327,255,727,327,169,411,738,411,738
,ALaGouXiang,652827204,852,40,516,363,1079,516,207,575,1091,583,1099
³,ELeZaiTeWuLuXiang,652827205,2127,59,1244,860,2528,1233,548,1350,2583,1490,2734
,BaYinGuoLengXiang,652827206,2062,69,1341,913,2751,1341,666,1456,2797,1456,2797
˹,GongNaiSiGouXiang,652827208,2042,28,546,330,888,484,176,474,958,1700,2246
˹̨ũ,WuLaSiTaiNongChang,652827400,5466,501,3616,2437,6308,3580,1476,3728,7308,3827,7443
Ŷʮһ,BingTuanErShiYiTuan,652827501,6938,1366,4647,3876,8189,4534,1168,4654,9188,4825,9472
Ŷʮ,BingTuanErShiErTuan,652827502,11420,2727,7944,6482,14285,7877,2050,8157,16034,8253,16197
Ŷ,BingTuanErErSanTuan,652827503,5578,577,3527,2369,5949,3477,1485,3628,7105,4113,7640
ũʦǳ,BingTuanNongErShiHuGuangTangChang,652827504,792,94,443,405,559,431,74,467,898,517,960
,TeWuLiKeZhen,652828100,14843,1309,9380,7704,11968,9227,3368,9728,18955,10140,19520
ʲ,WuShenTaLaHuiZuMinZuXiang,652828200,9910,588,5930,4279,9032,5825,2421,6644,12469,6989,12919
,QuHuiXiang,652828201,3898,202,2406,1473,3130,2275,1008,2539,4814,2702,5108
,TaHaQiXiang,652828202,6037,439,3612,2650,6171,3485,1342,4034,7519,4206,7818
չ,SuHaTeXiang,652828203,2712,186,1577,1226,2715,1556,442,1656,3212,1763,3340
ʿ˶,NaiRenKeErXiang,652828204,731,65,408,371,909,407,150,535,942,538,946
,XinTaReXiang,652828205,2369,348,1527,1205,2710,1510,393,1568,3078,1583,3110
ˮũ,QingShuiHeNongChang,652828400,5870,697,3796,2879,5208,3784,1279,4042,7826,4050,7846
˶,HeShuoXianMaLanGongAnGuanQu,652828402,254,1,73,67,1,65,13,87,152,195,268
Ŷʦʮ,BingTuanErShiErShiSiTuan,652828504,8664,1384,5736,4138,10258,5717,1633,5910,11627,5945,11681
,BoHuZhen,652829100,9904,989,6387,4797,10832,6349,2164,6529,12878,6670,13057
ͼ,BenBuTuZhen,652829101,6741,879,4518,2819,8660,4500,1788,4818,9318,4890,9408
¾,TaWenJiaoKenXiang,652829200,5410,667,3575,2432,7000,3575,1280,3782,7357,3782,7357
ٸɭ,WuLanZaiGeSenXiang,652829202,2147,257,1376,922,2620,1373,443,1468,2841,1471,2847
ſŵ,CaiKanNuoErXiang,652829203,4805,445,2967,2001,6104,2967,916,3199,6166,3199,6166
ŵ,ChaGanNuoErXiang,652829204,6662,674,4279,2798,8405,4268,1597,4553,8821,4654,8933
˹ں,BoSiTengHuXiang,652829205,1594,45,827,516,587,598,218,744,1342,1030,1857
Ŷʮ,BingTuanErShiWuTuan,652829501,3709,858,2619,2137,4818,2609,596,2519,5128,2544,5163
˽ֵ´,LanGanJieDaoBanShiChu,652901001,56155,4053,34488,24707,36571,31119,11538,32570,63689,37258,71746
Ӣֵ´,YingBaZhaJieDaoBanShiChu,652901002,31921,2606,21491,13500,28967,19684,8819,19560,39244,21855,43346
Žֵ´,HongQiaoJieDaoBanShiChu,652901003,22931,1841,15941,9521,21297,14597,6456,13772,28369,15287,31228
³ǽֵ´,XinChengJieDaoBanShiChu,652901004,66429,7035,43218,31202,65255,41008,13904,40687,81695,44150,87368
ϳǽֵ´,NanChengJieDaoBanShiChu,652901005,29171,1298,17854,13354,14207,17269,7297,18895,36164,19912,37766
,KaLeTaLeZhen,652901100,25042,1717,17898,8394,34669,17850,9549,18373,36223,18410,36308
,AYiKuLeZhen,652901101,26518,1696,19369,8629,33972,19299,11679,20440,39739,20524,39893
,YiGanQiXiang,652901200,29054,1499,20056,10271,28159,19738,10184,20347,40085,20681,40737
ʲ¸,BaiShenTuGeManXiang,652901201,16090,1255,11716,5796,22765,11671,6453,12033,23704,12082,23798
³,TuoPuLuKeXiang,652901202,10382,660,6954,3651,13832,6879,3545,7562,14441,7633,14587
ľϣ,KuMuBaXiXiang,652901203,14121,919,10274,4958,19635,10203,6035,10712,20915,10801,21075
ֳ,LiangZhongChang,652901400,3963,242,2614,1419,3872,2580,1170,2722,5302,2761,5375
ũ,HongQiPoNongChang,652901401,16294,915,10159,6398,14133,9984,4019,10696,20680,11069,21228
ʵֳ,ShiYanLinChang,652901404,15149,616,9685,6076,3713,9676,4396,10423,20099,10476,20161
һ,BingTuanYiTuan,652901502,16126,1883,10720,7041,18579,10075,3961,10447,20522,11250,21970
Ŷ,BingTuanErTuan,652901503,7235,774,4626,3333,8086,4309,1533,4571,8880,4916,9542
ҵ԰,XiGongYeYuanQuGuanLi,652901505,5608,724,3644,3070,4812,3633,1148,3761,7394,3836,7480
ũһʦɳˮ�,BingTuanNongYiShiShaJingZiShuiLiGuanLiChu,652901506,1636,76,975,720,279,913,337,1019,1932,1074,2049
,WenSuZhen,652922100,32603,2600,19596,14617,34166,19463,7509,20437,39900,23116,42712
ľ,TuMuXiuKeZhen,652922101,7540,613,5051,3061,10049,5035,2562,5643,10678,5664,10715
,KeZiLeZhen,652922102,13422,1106,9586,4703,17858,9493,5017,9877,19370,9959,19545
,AReLeZhen,652922103,15642,1025,11466,6259,20843,10717,6902,11426,22143,12103,23569
ľ,JiaMuZhen,652922104,13041,778,8803,4701,17291,8769,4289,9235,18004,9305,18108
к,TuoHuLaXiang,652922200,9191,704,6197,3560,11100,6192,2909,6601,12793,6607,12804
ǡ,QiaGeLaKeXiang,652922202,11146,784,7652,4339,13907,7579,3798,8007,15586,8076,15728
ϣľ,YiXiLaiMuQiXiang,652922204,9233,646,6327,3379,11941,6327,3168,6719,13046,6720,13047
հ,GuLeAWaTiXiang,652922206,12016,1286,8752,4429,16535,8573,4496,8830,17403,9046,17798
ζտ¶,BoZiDunKeErKeZiZuXiang,652922207,4058,303,2370,1367,4470,2284,874,2414,4698,2865,5235
ˮũ,ShuiDaoNongChang,652922400,4378,293,3008,1858,4833,2999,1472,3130,6129,3135,6143
ũ,QingNianNongChang,652922401,4754,320,3199,2029,5376,3188,1475,3339,6527,3350,6549
ũ,GongQingTuanNongChang,652922402,1690,81,994,674,1608,985,340,1097,2082,1117,2111
,TaGeLaKeMuChang,652922403,2497,195,1562,1000,2717,1545,597,1686,3231,1727,3289
ζ,BoZiDunMuChang,652922404,2012,113,1200,734,2365,1173,539,1291,2464,1464,2664
߸,SaWaFuQiMuChang,652922405,2176,124,1390,764,2702,1367,654,1521,2888,1564,2954
ǡ,QiaQiLiKeMuChang,652922406,1204,41,758,471,883,731,299,724,1455,786,1544
ľֳ,JiaMuLinChang,652922407,2539,162,1622,1108,1800,1585,692,1728,3313,1771,3393
,BingTuanWuTuan,652922509,13496,1329,8467,6196,14022,8364,2961,8851,17215,9319,17786
,BingTuanLiuTuan,652922510,6355,557,3999,2945,6132,3934,1327,4081,8015,4240,8239
˹ֵ̹´,ReSiTanJieDaoBanShiChu,652923001,9620,1094,6780,4545,12241,6780,2584,6518,13298,6518,13298
˽ֵ´,SaKeSaKeJieDaoBanShiChu,652923002,13026,1557,9177,6541,15945,9176,3573,8974,18150,8979,18156
³ǽֵ´,XinChengJieDaoBanShiChu,652923003,32781,2958,21217,16781,29621,20961,8445,21181,42142,22967,44184
ǽֵ´,DongChengJieDaoBanShiChu,652923004,21989,929,12631,8871,10232,10463,4196,11714,22177,14483,27114
ǡ,WuQiaZhen,652923101,30697,1763,20441,11417,32984,20436,9097,21112,41548,21116,41557
,ALaHaGeZhen,652923102,26211,2513,18447,9693,37058,18436,9473,19739,38175,19750,38197
,QiManZhen,652923103,25012,2230,17328,9229,35148,17324,8629,18500,35824,18543,35871
̹,DunKuoTanZhen,652923104,12500,1096,8544,4512,16615,8336,4369,9021,17357,9421,17965
,YaHaZhen,652923105,22444,1754,15498,8050,30556,15498,7658,16358,31856,16358,31856
,WuZunZhen,652923106,20356,1549,14188,7225,27586,14176,7338,15037,29213,15055,29243
,YiXiHaLaZhen,652923107,23387,1421,15671,7940,26221,15453,7324,15843,31296,16461,32132
ſ,YaKeLaZhen,652923108,835,44,361,173,533,305,150,339,644,668,1029
˹,YuQiWuSiTangXiang,652923201,19239,1855,13135,7310,26353,13125,6261,14185,27310,14220,27355
͸,BiXiBaGeXiang,652923202,18229,1634,12732,6660,25370,12732,6268,13399,26131,13399,26131
ῦľ,HaNiKaTaMuXiang,652923203,24802,1927,17292,8891,34672,17292,8701,18135,35427,18138,35430
˹,AKeWuSiTangXiang,652923204,10965,1026,7866,4398,15075,7830,4036,8125,15955,8161,16027
,AGeXiang,652923205,5935,200,2317,1712,3502,2152,825,2725,4877,4643,6960
ľ,TaLiMuXiang,652923206,3305,108,1270,680,1850,1066,464,1158,2224,2607,3877
ˮ,ShuiDianErChu,652923400,1403,660,1127,1102,2137,1127,197,1133,2260,1133,2260
̨ũ,ErBaTaiNongChang,652923401,3207,335,2098,1267,4059,2060,871,2196,4256,2315,4413
ַ,LiangZhongFanYuChang,652923402,2010,156,1276,798,2452,1276,512,1402,2678,1402,2678
,KuZiWengMuChang,652923403,1371,23,425,354,367,390,157,490,880,1126,1551
ݺ,CaoHuMuChang,652923404,823,62,561,310,979,561,251,571,1132,575,1136
⳵,KuCheZhongYangChang,652923405,2195,270,1440,948,2372,1437,543,1549,2986,1568,3008
,XuNiDiQu,652923406,308,15,147,167,176,139,37,158,297,213,360
ũ,KeQiLiKeNongChang,652923407,604,16,374,230,509,371,180,405,776,426,800
ɳ,ShaYaZhen,652924100,38995,3236,25171,19865,39796,23297,9575,24743,48040,26635,51806
յ,TuoYiBaoLeDiZhen,652924101,30386,2296,19935,10311,39806,19852,9545,22156,42008,22292,42227
,HongQiZhen,652924102,22435,2033,15389,7360,27969,15382,7268,16341,31723,16347,31736
Ӣ,YingMaiLiZhen,652924103,29119,2480,21034,10548,37168,21034,11552,22116,43150,22117,43151
հ͸,GuLeBaGeXiang,652924200,21261,1652,13893,7777,25097,13719,5882,14663,28382,14902,28795
¥,HaiLouXiang,652924204,15949,1645,11251,6650,20732,11125,5604,11854,22979,11947,23198
Ŭ͸,NuErBaGeXiang,652924205,7425,882,5446,2975,9957,5284,2645,5345,10629,5506,10952
ľ,TaLiMuXiang,652924206,5184,341,3098,1627,5385,2997,1415,3257,6254,3842,6940
οľ,GaiZiKuMuXiang,652924207,6668,225,4217,2490,4747,4148,1934,4520,8668,4610,8827
¿ũ,XinKenNongChang,652924400,1331,21,787,571,1284,772,332,884,1656,897,1684
һ,YiMuChang,652924401,1405,88,916,479,1635,865,356,893,1758,933,1849
,ErMuChang,652924402,1103,90,713,479,1247,713,335,748,1461,815,1528
,XuNiDiQu,652924403,3803,388,969,826,2909,947,238,943,1890,3460,4429
ɳعҵ,ShaYaXianGongYeJiZhongQu,652924404,304,13,131,48,297,108,63,110,218,249,380
º,XinHeZhen,652925100,19595,1429,13991,8971,20891,13933,6430,13285,27218,13463,27454
³˹͸,YouLuDouSiBaGeZhen,652925101,14423,1487,10175,5958,17724,10124,5200,10827,20951,10935,21110
䰬տ,YiQiAiRiKeXiang,652925200,24724,1984,17083,10467,28249,16997,8861,18172,35169,18486,35569
Ȱݰ,PaiXianBaiBaZhaXiang,652925201,12018,1162,8606,5056,14936,8593,4658,9198,17791,9232,17838
ʲտ,TaShenAiRiKeXiang,652925202,11729,1079,8354,5153,13956,8351,4438,8879,17230,8892,17246
μ,WeiGanXiang,652925203,13139,1376,9654,4998,16715,9586,5266,9984,19570,10127,19781
濦,YuQiKaTeXiang,652925204,14708,1475,10536,5668,19030,10513,5617,11207,21720,11264,21800
ľи,TaMuTuoGeLaKeXiang,652925205,6244,553,4508,2712,7650,4500,2676,4950,9450,4965,9473
ɣľũ,SangTaMuNongChang,652925400,1433,21,764,645,544,712,339,881,1593,1029,1793
ݳ,BaiChengZhen,652926100,36924,2571,24949,13585,37563,21548,9712,20964,42512,24258,49207
ȿ,TieReKeZhen,652926101,5495,176,2583,2569,3470,2572,808,3179,5751,3896,6479
,ChaErQiZhen,652926102,13629,875,8813,4465,16201,8397,3981,8662,17059,9672,18485
ľ,SaiLiMuZhen,652926103,10765,881,7345,4033,14540,7242,3496,7683,14925,7797,15142
Ӣɽ,HeiYingShanXiang,652926200,9158,814,5911,3353,12021,5770,2566,6342,12112,6627,12538
ζ,KeZiErXiang,652926201,6124,497,4114,2124,7747,3788,1895,4014,7802,4402,8516
пѷ,TuoKeXunXiang,652926203,10477,850,7052,3547,14218,6691,3203,7113,13804,7478,14530
¶,YaTuErXiang,652926204,12336,988,8073,4235,16320,7746,3546,8393,16139,8797,16870
,KangQiXiang,652926205,12493,967,8485,4232,15131,7761,3830,8139,15900,8805,17290
¡,BuLongXiang,652926206,6721,674,4542,2171,8959,4077,1995,4427,8504,4848,9390
׼,MiJiKeXiang,652926207,10732,765,7031,3615,13107,6455,3259,6986,13441,7725,14756
°ʲ,WenBaShenXiang,652926208,11406,821,7596,3757,14957,7021,3386,7332,14353,8017,15613
,DaQiaoXiang,652926209,7235,438,4816,2493,8609,4587,2290,4670,9257,5147,9963
ϻ̨,LaoHuTaiXiang,652926210,8840,592,5792,2705,11418,5484,2565,5835,11319,6205,11997
ũ,DaWanQiNongChang,652926400,4812,364,3106,2039,5804,3003,1339,3319,6322,3409,6515
,ZhongYangChang,652926401,1549,92,915,476,1856,792,320,866,1658,1046,1961
ʲ,WuShenZhen,652927100,20011,1215,13971,7680,24710,13721,6610,13257,26978,13865,27836
к,AKeTuoHaiXiang,652927200,15375,985,10815,5251,22198,10700,6510,11759,22459,12055,22870
ǿ,YaKeRuiKeXiang,652927201,11103,830,8322,4032,16591,8322,5090,8701,17023,8701,17023
ǡ,AQiaTaGeXiang,652927202,11704,842,8552,4375,16773,8503,5115,8919,17422,9109,17661
,AHeYaXiang,652927203,22314,1316,16907,8118,33794,16793,10958,17518,34311,17681,34588
ľ,YiMaMuXiang,652927204,14874,1044,10842,5697,20909,10838,6751,11822,22660,11827,22669
Ӣ,YingAWaTiXiang,652927205,12423,771,8378,4643,17143,8349,4420,9020,17369,9236,17614
տ¶,YaManSuKeErKeZiZuXiang,652927206,5964,388,4008,2376,8051,4002,2202,4542,8544,4546,8554
رϣ,AoTeBeiXiXiang,652927207,16081,987,11033,5220,22723,10998,6215,12160,23158,12250,23283
,BingTuanSiTuan,652927500,4320,673,2908,2293,5131,2891,899,2955,5846,2984,5892
,AWaTiZhen,652928100,25136,1640,16596,12927,27384,16502,7366,17285,33787,17546,34142
³ȴ,WuLuQueLeZhen,652928101,27650,2085,20008,10617,36639,19999,11947,21646,41645,21674,41682
ʲտ,BaiShenAiRiKeZhen,652928102,25123,1700,18065,9114,34230,18043,10159,18852,36895,18917,36982
͸,AYiBaGeXiang,652928200,19653,1368,14119,7250,24827,14119,7709,14611,28730,14611,28730
ľи,TaMuTuoGeLaKeXiang,652928201,13040,1046,9632,5025,18347,9591,5419,9852,19443,9873,19505
Ӣտ,YingAiRiKeXiang,652928202,20959,1364,15106,7759,28017,15104,8886,16102,31206,16103,31209
,DuoLangXiang,652928203,6168,394,4204,2490,7041,4180,2178,4492,8672,4536,8740
͸и,BaGeTuoGeLaKeXiang,652928204,2600,178,1802,964,2812,1727,939,1836,3563,1915,3717
ҵι˾,TianFengZhongYeYouXianZeRenGongSi,652928400,1789,41,1152,700,1254,1142,544,1202,2344,1222,2374
½ںι˾,XinJiangHuaFuHengFengYouXianZeRenGongSi,652928401,4762,248,3005,1869,4857,2991,1321,3307,6298,3326,6331
½³̩ҵι˾,XinJiangLuTaiMianYeYouXianZeRenGongSi,652928402,5370,236,3347,1982,5138,3268,1419,3619,6887,3678,7025
˹̹,BoSiTanMuChang,652928404,329,16,206,131,369,202,123,256,458,262,468
,XuNiDiQu,652928405,2931,44,342,286,442,330,118,339,669,2751,3093
,BingTuanSanTuan,652928503,10546,909,6561,4820,10561,6417,2109,6807,13224,7003,13564
ƺ,KePingZhen,652929100,5677,305,3924,2191,6280,3706,2049,3760,7466,4107,8031
,GaiZiLiKeXiang,652929200,8176,685,6220,2797,11935,6220,3825,6453,12673,6466,12686
,YuErQiXiang,652929201,7152,699,5431,2273,10142,5431,3234,5648,11079,5654,11085
ǡ,AQiaLeXiang,652929202,4712,401,3484,1683,6646,3451,2196,3719,7170,3825,7309
,QiLangXiang,652929203,3269,64,2493,1287,4229,2489,1817,2653,5142,2657,5150
Ҹ·ֵ´,XingFuLuJieDaoBanShiChu,653001001,15928,783,11135,6058,16052,9919,5075,9746,19665,10651,21786
·ֵ´,GuangMingLuJieDaoBanShiChu,653001002,26535,1305,18124,10796,30680,17275,8476,17021,34296,18192,36316
,SongTaKeXiang,653001200,23892,1572,18189,6963,32269,18169,11385,18604,36773,18660,36849
,AZhaKeXiang,653001201,25468,1808,18775,7414,36582,18759,11298,19533,38292,19799,38574
,AHuXiang,653001202,11036,901,7924,3603,15487,7924,4252,8264,16188,8265,16189
ϰͼʲ,ShangATuShenXiang,653001203,31464,2430,22281,10308,43137,22139,11953,23199,45338,23566,45847
,GeDaLiangXiang,653001204,10459,933,8024,3318,15458,8019,4856,8220,16239,8224,16248
,HaLaJunXiang,653001205,10785,909,7847,3600,15358,7811,4237,7870,15681,8084,15931
¹,TuGuMaiTiXiang,653001206,6118,413,4484,1960,8933,4472,2478,4500,8972,4525,9009
ũʦũ,BingTuanNongSanShiHongQiNongChang,653001500,2391,169,1803,914,3288,1795,1059,1804,3599,1816,3619
,AKeTaoZhen,653022100,25633,1239,18310,9580,31477,17568,9398,17539,35107,17960,36270
,AoYiTaKeZhen,653022101,3086,255,2106,1199,4274,2086,1179,2277,4363,2414,4520
,YuMaiXiang,653022200,16886,1250,12667,6334,24331,12645,7696,13121,25766,13165,25832
Ƥ,PiLaLiXiang,653022201,27873,1946,21295,9664,40667,21282,13409,21923,43205,21933,43228
,BaRenXiang,653022202,19714,1264,16035,6917,31366,16033,11931,16871,32904,16874,32909
ȿ,KaReKeQiKeXiang,653022203,3502,205,2556,1230,4912,2556,1592,2743,5299,2743,5299
,JiaMaTieLiKeXiang,653022204,6694,586,5059,2331,9784,5037,3031,5227,10264,5252,10311
ľ,MuJiXiang,653022205,2513,183,1897,889,3714,1897,1196,1995,3892,1995,3892
׿,BuLunKouXiang,653022206,4718,286,3179,1562,6416,3164,1918,3403,6567,3743,6922
,KeZiLeTaoXiang,653022207,6091,521,4451,2068,8514,4368,2647,4436,8804,4808,9259
ǡ¡,QiaErLongXiang,653022208,3105,293,2368,1157,4722,2368,1425,2455,4823,2455,4823
˹,KuSiLaFuXiang,653022209,2275,187,1757,1008,3464,1756,1080,1772,3528,1785,3542
,TaErXiang,653022210,3275,325,2445,1163,4740,2428,1459,2463,4891,2614,5059
жũ,TuoErTaYiNongChang,653022400,2494,239,1866,935,3431,1853,1094,1934,3787,1961,3827
˴,AKeDaLaMuChang,653022401,1715,137,1223,599,2462,1223,675,1303,2526,1304,2527
ԭֳ,YuanZhongChang,653022402,400,29,291,143,565,291,173,311,602,311,602
տ¶,KeZiLeSuKeEr,653022403,27,0,18,14,19,18,9,18,36,18,36
,MiaoPu,653022404,153,10,104,68,186,104,44,103,207,103,207
,AHeQiZhen,653023100,8488,505,5877,3673,9721,5783,2917,5742,11525,6033,11910
տ,KuLanSaRiKeXiang,653023200,3310,198,2013,1045,4007,1978,990,2053,4031,2485,4498
ɫ,SePaBaYiXiang,653023201,2100,155,1463,836,2929,1432,749,1523,2955,1541,3004
ľʲ,SuMuTaShenXiang,653023202,2799,214,2012,982,4051,2012,1080,2081,4093,2081,4093
,HaLaQiXiang,653023203,5533,415,3997,1812,7815,3962,2062,3980,7942,4013,8010
,HaLaBuLaKeXiang,653023204,4944,361,3642,1907,7272,3642,2056,3718,7360,3719,7361
ǡ,WuQiaZhen,653024100,7423,282,4669,3177,9129,4644,2294,4746,9390,5330,9999
,KangSuZhen,653024101,1075,47,779,601,1555,779,463,791,1570,806,1585
³ǡ,WuLuKeQiaTiXiang,653024200,2767,258,1949,957,3855,1942,926,1926,3868,2002,3951
ɳ³,WuHeShaLuXiang,653024201,721,74,495,301,1006,494,234,521,1015,534,1029
,BiaoErTuoKuoYiXiang,653024202,4833,392,3477,1796,6840,3467,2045,3779,7246,3793,7270
Τ,HeiZiWeiXiang,653024203,3881,315,2659,1660,4837,2657,1209,2722,5379,2746,5405
,TuoYunXiang,653024204,1281,128,864,571,1803,864,401,946,1810,946,1810
п,TieLieKeXiang,653024205,2171,198,1518,813,3076,1508,760,1589,3097,1611,3129
³,BaYinKuLuTiXiang,653024206,1662,127,1027,658,2082,1016,436,1049,2065,1198,2225
˹̹п,BoSiTanTieLieKeXiang,653024207,5490,442,3879,2189,7662,3870,2021,4061,7931,4074,7953
,JiGenXiang,653024208,1485,124,974,527,2070,968,481,1014,1982,1116,2090
,BingTuanTuoYunMuChang,653024501,581,40,403,240,723,401,194,404,805,412,815
ǡֵ´,QiaSaJieDaoBanShiChu,653101001,67557,5175,46132,23788,70528,37480,15808,36983,74463,42408,88540
߸ֵ´,YaWaGeJieDaoBanShiChu,653101002,18782,1670,13623,7635,18195,13461,6165,12873,26334,12994,26617
˹ֵ,WuSiTangBoYiJieDao,653101003,37631,3104,25566,15212,41029,24077,9845,23888,47965,25014,50580
ľ¶ֵ,KuMuDeErWaZhaJieDao,653101004,39436,3576,26181,15172,40866,22233,7849,21660,43893,24680,50861
͸,NaiZeErBaGeZhen,653101100,41590,2259,30175,13243,47365,30084,17247,29747,59831,30921,61096
հ͸,XiaMaLeBaGeZhen,653101101,44627,1729,28571,18393,32770,28314,13413,30556,58870,31198,59769
ذ͸,DuoLaiTeBaGeXiang,653101202,37671,1935,27746,13962,36077,27625,16397,28099,55724,28257,56003
ƺ,HaoHanXiang,653101203,22268,1265,16505,7196,25652,16362,9943,16689,33051,16971,33476
ɫ,SeManXiang,653101204,13026,811,9135,4180,17425,9092,5014,9352,18444,9716,18851
ĵ,HuangDiXiang,653101205,7527,472,5462,2537,10587,5462,3210,5747,11209,5747,11209
̫,PaHaTaiKeLiXiang,653101206,9033,547,6703,3077,12463,6682,4042,6866,13548,6919,13622
ʲȻľ,BoShenKeRanMuXiang,653101207,23106,1538,17759,7690,32298,17759,11372,18241,36000,18257,36016
п,TuoKeZhaKeZhen,653121100,24531,1373,17329,8656,27261,15467,8106,15514,30981,16681,34010
,WuPaErXiang,653121200,23596,1411,16436,8321,33533,16426,9143,17696,34122,17714,34150
ʲ,TaShenMiLiKeXiang,653121201,18690,1249,13393,6566,27251,13387,8050,14592,27979,14596,27989
ľ,TieRiMuXiang,653121202,3399,215,2465,1292,5003,2461,1503,2649,5110,2652,5117
,BuLaKeSuXiang,653121203,25827,1441,18715,8438,37038,18710,11059,19604,38314,19612,38327
͸,SaYiBaGeXiang,653121204,15533,804,11258,5185,21891,11258,6490,11569,22827,11569,22827
վ,ZhanMinXiang,653121205,15493,1016,10980,5595,21843,10980,6030,11559,22539,11559,22539
,WuKuSaKeXiang,653121206,10090,684,7251,3769,13430,7233,4021,7511,14744,7544,14795
,LanGanXiang,653121210,12889,844,9159,4633,17935,9144,5052,9602,18746,9626,18785
ľʲ,MuShenXiang,653121211,9927,789,7153,3332,14162,7144,3955,7502,14646,7518,14671
,AWaTiXiang,653121213,19760,1538,14822,6496,28957,14820,9037,15501,30321,15513,30335
Ӣ˹,YingWuSiTangXiang,653121214,23420,2047,17401,8164,34633,17394,10280,18345,35739,18346,35747
˿ʲ,AKeKaShiXiang,653121215,7376,509,5513,2470,10758,5509,3428,5800,11309,5800,11313
,XianZhongChuChang,653121400,140,12,87,70,14,87,11,76,163,76,163
԰ճ,XianYuanYiChang,653121401,304,13,225,115,458,225,155,247,472,247,472
ֳ,XianLinChang,653121402,301,6,188,98,359,188,101,220,408,220,408
ֳ,XianLiangZhongChang,653121403,143,9,94,72,191,94,45,103,197,103,197
Ӣ˴,XianYingAiLiKeDaChuChang,653121404,66,8,56,29,98,56,41,59,115,59,115
,ShuLeZhen,653122100,30034,1812,20932,11698,29774,19184,8600,18382,37566,19514,40446
,HanNanLiKeZhen,653122101,16531,1158,12098,5179,23819,12097,6792,12383,24480,12383,24481
Ȫ,YaFuQuanZhen,653122102,16986,1255,12307,5797,24839,12306,6840,12773,25079,12774,25081
,BaRenXiang,653122200,22271,1559,16064,7131,31141,16063,8385,16140,32203,16151,32215
,YangDaManXiang,653122201,11307,1105,8630,3987,16551,8630,4832,8614,17244,8614,17244
,YaManYaXiang,653122202,10028,966,7676,3833,15302,7666,4548,7853,15519,7866,15542
ͺ,BaHeQiXiang,653122203,14949,1124,10756,5304,21507,10753,5792,11104,21857,11109,21865
κ,TaZiHongXiang,653122204,18505,1422,13354,6434,26381,13352,7466,14035,27387,14039,27393
Ӣ,YingErLiKeXiang,653122205,13038,1058,9972,4554,20017,9972,6316,10440,20412,10440,20412
ľ,KuMuXiLiKeXiang,653122206,13798,1156,9884,4573,20233,9867,5401,10457,20324,10471,20355
,TaHeQiXiang,653122207,6071,470,4573,2072,8913,4568,2727,4693,9261,4695,9268
ľ,AiErMuDongXiang,653122208,8352,704,6038,3038,12329,6038,3337,6355,12393,6355,12393
,ALaLiXiang,653122209,7162,624,5444,2620,10725,5444,3384,5726,11170,5726,11170
,ALaFuXiang,653122210,12037,1120,9093,4359,16840,9086,5591,9644,18730,9655,18748
Ӣ,YingAWaTiXiang,653122211,6545,483,4908,2252,9489,4908,2908,5028,9936,5028,9936
ʮһ,BingTuanSiShiYiTuan,653122501,4219,561,2881,2007,4598,2860,1126,2918,5778,3025,5906
,ChengZhen,653123100,22259,1274,15498,7953,25698,14615,7580,14346,28961,15615,31113
ǹ,ChengGuanXiang,653123200,9285,610,6301,3057,12595,6298,3163,6744,13042,6757,13058
,QiaoLePanXiang,653123201,7985,643,5793,2824,11620,5793,3220,6055,11848,6055,11848
,LongFuXiang,653123202,4656,386,3256,1726,6707,3239,1840,3587,6826,3626,6882
â,MangXinXiang,653123203,17604,1164,12736,5706,24547,12653,6978,12916,25569,13010,25746
ɫ,SeTiLiXiang,653123204,7084,597,5085,2548,10329,5043,2743,5301,10344,5339,10424
,SaHanXiang,653123205,17975,1736,14481,6127,29098,14319,10318,15384,29703,15548,30029
ӢҲ,YingYeErXiang,653123206,8254,728,6007,2945,12561,6007,3611,6582,12589,6586,12593
,KeZiLeXiang,653123207,16248,877,12132,5612,24092,12132,7647,12640,24772,12640,24772
³,TuoPuLuKeXiang,653123208,9477,366,6632,3437,13553,6610,4017,7205,13815,7228,13860
ո,SuGaiTiXiang,653123209,16540,751,11242,5575,22188,11214,5989,11989,23203,12038,23280
ǡ,WuQiaXiang,653123210,29454,1734,20558,9653,41682,19729,11197,21114,40843,21827,42385
˹,AiGuSiXiang,653123211,6473,378,4484,2408,9260,4483,2520,4883,9366,4887,9371
Ҳ,YiGeZiYeErXiang,653123212,3407,224,2438,1270,5001,2438,1483,2656,5094,2676,5114
Ŷũ,BingTuanDongFengNongChang,653123500,1133,105,788,533,1438,780,354,783,1563,804,1592
,ZePuZhen,653124100,24270,1086,16079,8759,26072,14485,6309,14319,28804,15586,31665
͸,KuiYiBaGeZhen,653124101,8024,294,5076,3189,8005,5065,2235,5475,10540,5477,10553
ľ﹫˾,TaLiMuYouTianGongSi,653124102,14127,912,8777,7149,16507,8704,3134,9300,18004,9396,18173
˹ľ,BoSiKaMuXiang,653124200,14463,800,9743,5493,19450,9742,4763,10268,20010,10283,20026
,ZePuXianYiMaXiang,653124201,13759,914,9675,4724,19459,9674,4955,9911,19585,9953,19628
հ͸,GuLeBaGeXiang,653124202,12747,1127,9410,4529,17756,9410,4697,9161,18571,9161,18571
,SaiLiXiang,653124203,11900,716,8311,3852,16100,8199,4105,8292,16491,8410,16721
,YiKenSuXiang,653124204,13523,974,9606,4647,18419,9599,4843,9715,19314,9734,19340
ͼ,TuHuQiXiang,653124205,7201,479,5155,2450,9999,5109,2679,5124,10233,5204,10359
͸,KuiYiBaGeXiang,653124206,8911,566,6189,3484,11657,6189,3236,6523,12712,6524,12713
ľ,AKeTaMuXiang,653124207,4730,277,3269,1563,6255,3180,1645,3288,6468,3383,6652
,AYiKuLeXiang,653124208,8330,495,5921,2799,11113,5792,2903,5655,11447,5807,11728
³,BuYiLuKeTaJiKeZuXiang,653124209,2659,144,1722,999,3362,1717,761,1831,3548,1842,3564
ũ,NongChangChangBu,653124400,2592,195,1858,953,3242,1851,989,1910,3761,1918,3776
ֳ,ZePuXianLiangZhongChang,653124401,1292,79,969,416,1790,962,502,896,1858,904,1873
԰ճ,YuanYiChang,653124402,1038,38,649,324,1275,649,238,665,1314,665,1314
Ӫֳ,GuoYingLinChang,653124403,191,10,130,78,251,130,79,150,280,150,280
ɯ,ShaCheZhen,653125100,93434,4420,63504,32249,104681,59323,30291,57825,117148,64641,128145
ǡȿ,QiaReKeZhen,653125101,19672,1454,14708,7409,29481,14693,8820,15226,29919,15238,29946
,AiLiXiHuZhen,653125102,23978,1794,17877,8340,36224,17877,11021,18915,36792,18916,36793
ĵ,HuangDiZhen,653125103,22903,1707,17369,7907,31620,17369,10048,17289,34658,17289,34658
,AWaTiZhen,653125104,16589,1433,12375,5839,23904,12341,7097,12685,25026,12744,25119
ʲ,BoShenKanTeZhen,653125105,25711,2279,19579,8851,38020,19562,11253,19642,39204,19664,39243
Ƕ,YiGaiErQiZhen,653125106,16750,1588,13460,6179,26219,13456,8700,13566,27022,13578,27038
հ͸,GuLeBaGeXiang,653125200,14916,855,11022,5173,18524,11018,6484,11230,22248,11233,22255
,AReLeXiang,653125201,11321,903,8514,4019,16475,8512,5174,8884,17396,8884,17398
ǡ͸,QiaErBaGeXiang,653125202,8703,666,6372,2982,12813,6372,3603,6600,12972,6600,12972
ľ˹,TuoMuWuSiTangXiang,653125203,19604,1296,14496,6310,29033,14495,8679,15081,29576,15083,29579
Ӣ˹,YingWuSiTangXiang,653125204,7048,524,5193,2469,9855,5193,3010,5389,10582,5389,10582
,WuDaLiKeXiang,653125205,20927,1622,15632,7221,30565,15583,8976,15808,31391,15893,31525
˹͸,AErSiLanBaGeXiang,653125206,13334,975,9871,4415,19693,9871,5709,10147,20018,10147,20018
ȸ,ZiReFuPuXiaTiXiang,653125207,7149,478,5097,2628,9674,5070,2877,5364,10434,5407,10504
ǿտ,YaKaAiRiKeXiang,653125208,6932,432,4897,2378,9824,4861,2840,5280,10141,5307,10204
Ⱥ,KaQunXiang,653125209,12414,876,9277,4420,18532,9274,5459,9462,18736,9472,18749
޽ʲ,HuoShenLaFuXiang,653125210,10844,776,8425,3939,16847,8424,5731,8922,17346,8926,17351
ľ˹,DaMuSiXiang,653125211,6258,439,4639,2124,9373,4619,2981,4763,9382,5039,9678
,MiXiaXiang,653125212,21911,1353,15856,7287,31878,15856,9155,16562,32418,16563,32419
ʲ,YiShenKuLiXiang,653125213,19929,1405,14573,6539,29487,14560,8596,15340,29900,15357,29930
Ŀ,PaiKeQiXiang,653125214,12893,915,9626,4544,19672,9614,6001,10173,19787,10183,19809
ض,TaGaErQiXiang,653125215,23532,1294,16859,8064,34171,16853,9728,17684,34537,17695,34554
ʲտ,KuoShenAiRiKeXiang,653125216,11005,649,7954,3887,15909,7954,4759,8459,16413,8459,16413
հ͸,DunBaGeXiang,653125217,11429,978,8817,3751,16519,8805,5172,8757,17562,8762,17579
,ALaMaiTiXiang,653125218,15469,1698,11630,5589,23127,11614,6416,11912,23526,11953,23583
͸,AZhaTiBaGeXiang,653125219,10710,783,7877,3709,15770,7876,4353,7969,15845,7969,15846
͸,BaGeAWaTiXiang,653125220,10903,1079,8307,3803,16359,8307,4969,8644,16951,8644,16951
,KaLaSuXiang,653125221,9535,826,7313,3606,14093,7313,4395,7443,14756,7443,14756
,XuNiDiQu,653125401,4787,234,1698,936,2610,1143,485,1167,2310,3808,5506
ֳ,XianLiangZhongChang,653125402,1392,86,981,550,1619,981,510,1007,1988,1007,1988
ʹľ,YouZhiGuoShuMiaoMuFan,653125403,188,10,127,87,231,127,72,143,270,143,270
Ӫֳ,GuoYingErLinChang,653125404,148,6,104,58,209,104,70,120,224,120,224
԰ճ,YuanYiChang,653125405,133,6,89,41,186,89,47,97,186,97,186
ֳ,CanZhongChang,653125406,220,8,144,95,169,144,56,140,284,140,284
糡,YuMiaoChang,653125407,26,0,12,10,0,12,4,18,30,18,30
ũԺɯũҵ,NongKeYuanShaCheNongYe,653125408,223,17,144,87,183,144,60,149,293,156,300
տ,KaGeLeKeZhen,653126100,54297,2614,38190,20644,56129,37814,18819,36691,74505,37540,75730
ǡ͸,QiaErBaGeZhen,653126101,14499,871,10592,4487,19777,10576,5819,10448,21024,10597,21189
Ŀ˰ʲ,WuXiaKeBaShenZhen,653126102,15269,822,10355,4517,18811,10141,5491,10638,20779,11227,21582
,LuoKeXiang,653126200,13325,852,10070,4097,17036,10067,6435,10541,20608,10542,20612
ȿ,BoXiReKeXiang,653126201,21953,1265,16252,6210,26694,16252,10268,17234,33486,17234,33486
,TieTiXiang,653126202,10751,702,7771,3243,14449,7770,4203,7885,15655,7885,15656
ǡ,QiaSaMeiQiTeXiang,653126203,12233,533,8729,3929,11420,8729,4749,8786,17515,8786,17515
¹,TuGuQiXiang,653126204,13753,690,10146,4373,17615,10143,6033,10329,20472,10330,20476
˹,JiangGeLeSiXiang,653126205,12099,982,9369,4107,15178,9369,5763,9475,18844,9475,18844
տ,JiaYiTiLeKeXiang,653126206,15559,1089,11753,5026,19720,11750,6726,11612,23362,11621,23374
,BaRenXiang,653126207,6797,530,5018,2347,8984,5014,2812,5115,10129,5121,10139
ڼȿ,WuJiReKeXiang,653126208,14102,954,10212,4942,17948,10212,5707,10551,20763,10551,20763
ĺϸ,XiaHeFuXiang,653126209,12536,965,9229,4468,17143,9223,5233,9503,18726,9505,18734
,YiLiKeQiXiang,653126210,9880,723,7337,3662,12919,7337,4266,7532,14869,7532,14869
ľ,YiTiMuKongXiang,653126211,25028,1391,17898,7750,30319,17898,9633,18154,36052,18154,36052
,ZongLangXiang,653126212,4222,245,3033,1473,5675,3033,1780,3214,6247,3214,6247
¿,KeKeYaXiang,653126213,12912,873,9560,4912,16807,9560,5666,9890,19450,9891,19451
,XiHeXiuXiang,653126214,3508,345,2719,1267,4970,2701,1682,2667,5368,2816,5535
,QiPanXiang,653126215,10380,694,7897,3763,14172,7897,5150,8322,16219,8327,16224
͸,SaYiBaGeXiang,653126216,14925,962,11313,4974,19551,11308,6638,11208,22516,11212,22525
ũ,GongAnNongChang,653126401,303,35,207,139,391,206,87,217,423,218,425
ʲũ,AKeTaShenNongChang,653126402,373,21,241,142,0,241,151,304,545,304,545
ֳ,LiangZhongChang,653126403,1303,76,940,468,1408,940,482,921,1861,921,1861
԰ճ,YuanYiChang,653126404,1004,72,665,337,1241,665,302,713,1378,713,1378
ֳ,LinChang,653126405,812,46,597,242,918,597,290,551,1148,551,1148
,PuSaMuChang,653126406,696,61,518,249,751,518,319,558,1076,558,1076
,ZhongChuChang,653126407,233,7,166,95,229,166,108,182,348,182,348
ǡľ,QiaQiKuMuGuanLiQu,653126408,4727,381,3860,1733,5399,3853,2454,3700,7553,3702,7562
Ҷ,BingTuanYeChengMuChang,653126500,683,44,441,305,884,440,255,513,953,541,982
,MaiGaiTiZhen,653127100,30240,2263,20757,13428,31647,20069,8423,19256,39325,20169,40926
,BaZhaJieMiXiang,653127200,16955,1056,11637,7009,21428,11590,5297,11634,23224,11671,23308
ϣ,XiYiTiDunXiang,653127201,9487,715,6676,3145,11751,6211,3444,6507,12718,6970,13646
,YangTaKeXiang,653127202,22395,1544,15835,7263,27803,14251,7838,14473,28724,15942,31777
,TuManTaLeXiang,653127203,17306,1276,12230,6367,22909,12054,6017,12187,24241,12369,24599
ο,GaZiKuLeXiang,653127204,18612,1281,13422,6140,24068,12004,6332,12124,24128,12803,26225
հ,KeZiLeAWaTiXiang,653127205,18037,1226,12827,6549,23942,12740,6578,12869,25609,13014,25841
ľ,KuMuKuSaErXiang,653127206,9989,725,6962,4076,12506,6937,3159,6880,13817,6911,13873
տ,AngGeTeLeKeXiang,653127207,3916,306,2830,1522,4928,2830,1362,2753,5583,2754,5584
,KuErMaXiang,653127208,10399,634,7096,3814,13243,6838,3377,7075,13913,7314,14410
ֳ,HuYangLinChang,653127400,203,1,112,73,0,107,43,120,227,135,247
԰ճ,YuanYiChang,653127401,579,42,367,209,741,367,144,398,765,398,765
һֳ,WuYiLinChang,653127402,1013,83,692,396,1244,675,279,672,1347,683,1375
ũʦǰ,BingTuanNongSanShiQianJin,653127500,235,42,161,130,258,161,45,159,320,161,322
ʮ,BingTuanSiShiWuTuan,653127505,24065,1689,14391,8177,25481,12366,5191,13281,25647,16554,30945
ʮ,BingTuanSiShiLiuTuan,653127506,4189,184,2402,1729,4161,2350,762,2585,4935,2733,5135
պ,YuePuHuZhen,653128100,15944,1047,11008,6931,19975,10955,5101,10947,21902,11084,22092
,AiXiManZhen,653128101,9961,1107,7390,3644,14466,7385,3735,7410,14795,7413,14803
պ,YuePuHuXiang,653128200,9222,1084,6817,3445,13204,6817,3155,6644,13461,6644,13461
ҲȰݰ,YeKeXianBaiBaZhaXiang,653128201,12572,1497,9460,4177,18517,9439,4702,9290,18729,9311,18771
,AQiKeXiang,653128203,14171,1582,10871,4900,20572,10870,5830,10712,21582,10712,21583
ɫҲ,SeYeKeXiang,653128204,12719,1195,8883,4657,17668,8883,4150,9181,18064,9181,18064
ľ,TieReMuXiang,653128205,13318,1195,9417,4578,18280,9417,4458,9552,18969,9554,18971
,BaYiAWaTiXiang,653128206,7173,649,5133,2389,9981,5130,2638,5326,10456,5327,10460
³ľ,AHongLuKuMuXiang,653128207,1764,156,1224,660,2501,1222,604,1294,2516,1300,2524
պũ,YuePuHuXianNongChang,653128400,803,49,547,327,1103,547,285,590,1137,590,1137
պֳ,YuePuHuXianLinChang,653128401,303,22,217,89,408,217,92,200,417,200,417
պţ,YuePuHuXianNaiNiuChang,653128402,352,30,221,168,303,221,87,248,469,248,469
պֳ,YuePuHuXianLiangZhongChang,653128403,528,68,398,238,798,398,228,426,824,426,824
պش,YuePuHuXianDaChuChang,653128404,310,48,249,130,430,249,128,237,486,237,486
ʮ,BingTuanSiShiErTuan,653128502,2763,232,1757,1377,3180,1752,631,1840,3592,1869,3626
,BaRenZhen,653129100,25275,1420,17270,10573,30100,16789,7276,16236,33025,16701,33971
˶,XiKeErKuLeZhen,653129101,1334,34,586,272,837,467,245,452,919,1027,1613
ľ,TieRiMuXiang,653129200,9996,1003,7571,3575,14452,7571,4172,7600,15171,7600,15171
Ӣ,YingMaiLiXiang,653129201,20322,1898,14926,7227,29624,14924,7915,15201,30125,15209,30135
,JiangBaZiXiang,653129202,21464,1847,16086,7534,31673,16044,9393,16471,32515,16618,32704
и,WoLiTuoGeLaKeXiang,653129203,26254,1951,20175,9371,39901,20175,12758,20788,40963,20788,40963
ղ,KeZiLeBoYiXiang,653129204,25907,2249,19904,8952,38735,19883,12072,20288,40171,20324,40228
,MiXiaXiang,653129205,16437,1602,13448,5952,25589,13405,8961,13516,26921,13552,27000
,XiaPuTuLeXiang,653129206,18935,1666,14359,7220,27686,14350,8343,14558,28908,14585,28944
İ,HeXiaAWaTiXiang,653129207,28375,2787,22146,10700,43249,22111,13885,22877,44988,22901,45047
,KeZiLeSuXiang,653129208,23417,2007,17866,8014,35353,17850,10616,18161,36011,18174,36040
³,GuLeLuKeXiang,653129209,14473,1140,10905,5054,21786,10868,6580,11253,22121,11288,22193
,YuDaiKeLiKeXiang,653129210,10072,782,7479,3545,15133,7469,4506,7872,15341,7881,15360
٤ʦܳ,BingTuanGaShiZongChang,653129500,8340,833,6116,3429,11306,6106,3225,6261,12367,6282,12398
ͳ,BaChuZhen,653130100,34805,1860,23867,13032,37674,22960,11039,22346,45306,23837,47704
ɫ,SeLiBuYaZhen,653130101,30968,2239,21848,9766,42868,21761,11435,22594,44355,22794,44642
,AWaTiZhen,653130102,15313,1346,11120,5990,21181,11095,5573,11090,22185,11112,22232
,SanChaKouZhen,653130103,591,12,313,240,218,302,134,382,684,424,737
ǡ͸,QiaErBaGeXiang,653130200,20402,1175,12425,6205,24570,12408,6239,13080,25488,15391,27816
͸,DuoLaiTiBaGeXiang,653130201,19538,1338,14008,6435,26363,14006,7282,14147,28153,14150,28158
ɿ,ANaKuLeXiang,653130202,19139,1041,12850,6042,24278,12803,6228,13499,26302,13558,26408
,XiaMaLeXiang,653130203,7103,425,4933,2593,9047,4926,2646,5221,10147,5241,10174
,AKeSaKeMaReLe,653130204,21575,1681,14956,6833,30815,14950,7602,15884,30834,15902,30858
,ALaGenXiang,653130205,20285,1522,14495,7153,28458,14492,7605,14909,29401,14917,29412
ǡ,QiongKuQiaKeXiang,653130206,26127,2009,18345,10706,36458,18338,9061,18843,37181,18852,37197
Ӣ˹̹,YingWuSiTanXiang,653130207,17186,1442,12098,6238,23672,12024,5852,12264,24288,12382,24480
ʮ,BingTuanSiShiBaTuan,653130508,4969,450,3133,1986,5354,3073,1037,3163,6236,3323,6456
ʲ,TaShenKuErGanZhen,653131100,6683,205,4195,2138,6070,3537,2031,3612,7149,4724,8919
˰,TaJiKeABaTiZhen,653131101,1997,120,1452,698,2927,1452,928,1593,3045,1593,3045
ʲ,TaShenKuErGanXiang,653131200,3598,279,2651,970,5257,2643,1468,2669,5312,2694,5345
,TaHeManXiang,653131201,1892,164,1400,509,2872,1400,848,1504,2904,1504,2904
ƿǶ¶,KeKeYaErKeErKe,653131202,638,49,475,232,921,473,271,481,954,483,958
Ǹ,TiZiNaFuXiang,653131203,1896,123,1414,507,2855,1414,850,1455,2869,1455,2869
ﲼ,DaBuDaErXiang,653131204,1800,135,1344,576,2635,1336,783,1347,2683,1374,2718
,MaErYangXiang,653131205,1239,132,919,356,1840,907,557,963,1870,1009,1928
ǡ,WaQiaXiang,653131206,1914,177,1342,512,2685,1342,656,1405,2747,1405,2747
϶,BanDiErXiang,653131207,1108,92,755,272,1457,731,389,735,1466,834,1589
³,KuKeXiLuGeXiang,653131208,1239,122,897,407,1809,896,512,958,1854,976,1873
ͬ,DaTongXiang,653131210,1324,147,1005,419,1949,1004,511,968,1972,977,1982
,MaZhaErZhongYangChang,653131400,397,37,300,126,620,300,195,329,629,329,629
ʲֳ,BaZhaDaShenMuLinChang,653131401,234,11,159,89,327,159,92,178,337,178,337
ū͸ֵ´,NuErBaGeJieDaoBanShiChu,653201001,18473,1105,11906,8633,16986,11818,4556,12085,23903,12228,24134
Ž͸ֵ´,GuJiangBaGeJieDaoBanShiChu,653201002,25419,1497,16855,10335,23252,16779,7651,16559,33338,17712,34567
հ͸ֵ´,GuLeBaGeJieDaoBanShiChu,653201003,22106,870,13203,7389,20507,11268,4943,10758,22026,14716,27919
ɶ͸ֵ´,NaErBaGeJieDaoBanShiChu,653201004,26302,1307,18760,10206,22853,18697,9729,18476,37173,18578,37338
˹,LaSiKuiZhen,653201100,16952,1030,12264,5876,20056,12254,7249,12797,25051,12967,25231
ʲ,YuLongKaShiZhen,653201101,15769,924,11121,5614,18328,10826,5921,11212,22038,11493,22614
Ф͸,XiaoErBaGeXiang,653201200,27827,1297,20042,9875,27755,19018,10207,18646,37664,19289,39331
,YiLiQiXiang,653201201,15113,867,11086,6380,15217,11072,6666,11546,22618,11560,22646
Ž͸,GuJiangBaGeXiang,653201202,9714,419,6698,3776,10147,6519,3547,6521,13040,6982,13680
ɳ,TuShaLaXiang,653201203,32664,1854,23782,10976,42779,23761,13950,24596,48357,24686,48468
,JiYaXiang,653201204,14766,871,10550,5313,19190,10494,6434,11391,21885,11521,22071
ǡ,AHeQiaGuanLiQu,653201400,2743,149,2083,991,3112,2083,1409,2218,4301,2218,4301
͸,BaGeQiZhen,653221100,38381,2561,28175,13092,54271,28175,16211,28978,57153,28978,57153
տ,HanAiRiKeXiang,653221201,28932,1858,21388,9698,41582,21368,12961,22318,43686,22363,43751
Ӣ,YingAWaTiXiang,653221202,15916,963,11812,5621,23418,11812,6745,11812,23624,11812,23624
Ӣտ,YingAiRiKeXiang,653221203,6627,460,5011,2179,10185,5011,3166,5242,10253,5242,10253
,BuZhaKeXiang,653221204,18907,1342,13276,6693,26865,13276,6888,13861,27137,13861,27137
,LaYiKaXiang,653221205,19851,1261,14267,7498,28810,14267,7920,14765,29032,14765,29032
,LangRuXiang,653221206,11296,696,8178,4435,16423,8178,4513,8327,16505,8327,16505
߿,TaWaKuLeXiang,653221207,17554,915,13235,6229,25721,13235,8514,13748,26983,13748,26983
˹ľ,YiSiLaMuAWaTi,653221208,13208,752,9753,4646,19673,9753,5868,10075,19828,10075,19828
ɫο,SeGeZiKuLeXiang,653221209,6001,432,4675,2241,9172,4675,3143,4901,9576,4901,9576
ʲʲ,KaShiTaShenXiang,653221210,4174,276,3085,1854,5987,3085,1649,3014,6099,3014,6099
ʲ,KaLaKaShiZhen,653222100,21984,1448,15114,10484,29725,15113,7900,16217,31330,16218,31332
,KaErSaiXiang,653222200,27731,1867,20003,11522,40489,19999,11294,20886,40885,20889,40892
,KuiYaXiang,653222201,28767,1771,21569,8962,43118,21569,12674,21643,43212,21643,43212
,ZhaWaXiang,653222202,34911,1690,25516,12854,51657,25483,15564,26603,52086,26649,52165
,AKeSaLaYiXiang,653222203,18435,1257,13329,7489,26831,13319,7660,14011,27330,14023,27352
ڶ,WuErQiXiang,653222204,10785,998,7937,3936,15967,7935,4617,8461,16396,8463,16400
к,TuoHuLaXiang,653222205,13015,751,9258,4751,18383,9258,5034,9542,18800,9542,18800
͸,SaYiBaGeXiang,653222206,21752,1213,15827,8428,32252,15792,9390,16485,32277,16528,32355
Ӻ͸,JiaHanBaGeXiang,653222207,16408,990,12106,6312,23542,12106,7126,12416,24522,12418,24524
ǡ,PuQiaKeQiXiang,653222208,23227,1438,17071,8816,33316,17071,10477,18071,35142,18071,35142
â,MangLaiXiang,653222209,15862,872,11407,5489,22831,11406,6674,12000,23406,12001,23408
,KuoYiQiXiang,653222210,18593,1074,12754,6525,25803,12750,6679,13588,26338,13592,26346
,YaWaXiang,653222211,22931,1578,16343,9736,32901,16318,9440,17570,33888,17606,33949
,TuWaiTeXiang,653222212,17091,1057,12072,6305,24417,12072,6537,12613,24685,12613,24685
ӢҲ,YingYeErXiang,653222213,8067,470,5561,2914,11227,5552,2948,5913,11465,5924,11485
߿,KaWaKeXiang,653222214,7268,501,5251,2717,10880,5249,3223,5731,10980,5741,10992
͸ֵ´,QiNiBaGeJieDaoBanShiChu,653222215,9567,519,6871,4434,5093,6862,3724,6916,13778,6939,13810
˹ֵ̹´,BoSiTanJieDaoBanShiChu,653222216,8679,500,5620,4532,4453,5574,2698,6008,11582,6257,11877
˹νֵ´,SiZiJieDaoBanShiChu,653222217,6754,401,4580,3104,3364,4459,2367,4784,9243,4942,9522
ʮ,BingTuanSiShiQiTuan,653222500,2588,373,1775,1359,3336,1762,738,1879,3641,1924,3699
Ŷ,BingTuanErErSiTuan,653222501,6112,53,3556,2440,2614,3493,2002,4334,7827,4611,8167
ֵ´,JieDaoBanShiChu,653223001,13407,918,9429,5216,17476,8625,4099,8280,16905,8995,18424
,GuMaZhen,653223100,19992,1321,14102,7165,26537,13809,6850,13930,27739,14061,28163
,DuWaZhen,653223101,6073,379,4176,2701,7403,4167,2179,4440,8607,4455,8631
ֱϽ,XianZhiXiaCunZhen,653223198,851,67,535,342,1048,531,281,637,1168,664,1199
ʲ,KuoShenTaGeXiang,653223200,10689,842,7455,4405,15087,7436,3669,7736,15172,7745,15200
,KeLiYangXiang,653223201,4488,374,3133,1745,6361,3121,1552,3259,6380,3281,6414
ƿȿ,KeKeTieReKeXiang,653223202,24849,1575,17355,8254,34916,17354,8990,18055,35409,18059,35414
ɣ,SangZhuXiang,653223203,21409,1870,15023,8674,30451,15013,7627,15849,30862,15883,30906
ľ,MuJiXiang,653223204,16124,981,11457,6203,22873,11436,6168,11758,23194,11816,23273
Ǵ,QiaoDaXiang,653223205,8573,636,6103,3411,12305,6103,3241,6345,12448,6347,12450
ľ,MuKuiLaXiang,653223206,13774,1107,9664,5023,19180,9612,4710,9878,19490,9927,19591
ع,CangGuiXiang,653223207,9885,647,6643,4038,13554,6623,3195,7039,13662,7084,13727
Ƥ,PiYaLeMaXiang,653223208,4223,340,3055,1777,6016,3037,1531,3026,6063,3039,6094
Ƥ,PiXiNaXiang,653223209,4960,534,3660,2222,7449,3645,2002,3810,7455,3836,7496
ʲ,BaShenLanGanXiang,653223210,3231,297,2334,1347,4745,2331,1334,2511,4842,2528,4862
觰,NaoABaTiTaJiKe,653223211,683,50,442,277,919,442,199,483,925,490,932
˶¶,KangKeErKeErKeZi,653223212,1304,114,907,572,1761,902,484,967,1869,995,1902
Ӫ,GuoYingMuChang,653223400,714,37,495,298,889,495,254,510,1005,510,1005
Ƥɽũ,BingTuanPiShanNongChang,653223500,14331,1133,11286,6038,20002,11245,7063,11170,22415,11241,22527
ֵ´,ChengQuJieDaoBanShiChu,653224001,13731,885,9915,5844,16308,9890,5033,9698,19588,9734,19649
,LuoPuZhen,653224100,12436,878,8949,4910,16752,8949,4813,9178,18127,9178,18127
,BuYaXiang,653224201,21046,1198,14837,7432,28665,14837,8013,15419,30256,15420,30257
ɽ³,ShanPuLuXiang,653224202,19937,1261,14416,7434,26215,14416,8311,15093,29509,15093,29509
ǡ͸,QiaErBaGeXiang,653224203,28887,2009,20488,11165,39077,20426,10814,21118,41544,21222,41710
,HangGuiXiang,653224204,28332,1933,19489,11496,38753,19478,10231,20990,40468,21007,40496
³,DuoLuXiang,653224205,22550,1602,15749,8785,30140,15735,8247,16629,32364,16650,32399
,NaWaXiang,653224206,8771,577,6346,3464,12375,6335,3613,6588,12923,6615,12961
ʲи,BaiShenTuoGeLaKeXiang,653224207,4173,333,2945,1814,5762,2934,1613,3156,6090,3174,6119
˹,AQiKeGuanLiQu,653224400,979,76,719,429,1399,719,431,767,1486,767,1486
ֳ,LiangZhongChang,653224401,157,9,97,79,158,97,37,106,203,106,203
,CeLeZhen,653225100,10429,807,7160,4343,13232,7159,3326,7390,14549,7402,14562
,CeLeXiang,653225200,21717,1529,15104,8751,30214,15062,7877,15992,31054,16019,31123
,GuLaHaMaXiang,653225201,18840,1556,13100,7588,26457,13094,6225,13513,26607,13521,26621
깵,DaMaGouXiang,653225202,13906,904,9550,5432,19203,9542,4440,9688,19230,9700,19250
ǡ,QiaHaXiang,653225203,10660,827,7223,4916,14951,7223,3523,7784,15007,7787,15010
³,WuLuKeSaYiXiang,653225204,3347,242,2284,1517,4544,2284,998,2303,4587,2303,4587
ū,NuErXiang,653225205,8216,673,5598,3872,11288,5593,2692,5976,11569,5983,11581
˹̹,BoSiTanXiang,653225206,4769,316,3197,2123,6479,3178,1541,3395,6573,3429,6626
ɫտ˽ֵ´,SeRiKeJieDaoBanShiChu,653225207,11985,840,8064,5719,14551,7494,2859,7329,14823,7620,15684
һ,BingTuanYiMuChang,653225500,1495,175,969,794,1872,969,336,1035,2004,1037,2006
ľ,MuGaLaZhen,653226100,21509,1202,14909,7365,28288,14896,7468,15232,30128,15270,30179
Ȱݰ,XianBaiBaZhaZhen,653226101,13869,717,9773,5502,19485,9770,5210,10023,19793,10023,19796
,JiaYiXiang,653226200,12678,659,8744,4490,17009,8744,4275,8868,17612,8868,17612
ƿ,KeKeYaXiang,653226201,13350,630,9035,4807,18376,9035,4602,9547,18582,9547,18582
,AReLeXiang,653226202,12722,606,8801,4725,17695,8801,4613,9140,17941,9140,17941
ϣ,ARiXiXiang,653226203,5423,313,3785,2188,7564,3777,1928,3869,7646,3879,7664
,LanGanXiang,653226204,13929,572,9580,5300,19101,9564,5023,9940,19504,9944,19524
˹Ҳ,SiYeKeXiang,653226205,15176,748,10655,5666,21604,10644,5938,11196,21840,11207,21862
и,TuoGeRiGaZiXiang,653226206,10454,555,7069,4125,13641,7060,3564,7484,14544,7504,14573
˶,KaLaKeErXiang,653226207,10265,569,7117,3914,13993,7116,3460,7177,14293,7177,14294
и,AoYiTuoGeLaKeXiang,653226208,12862,750,8815,4527,17889,8793,4659,9404,18197,9456,18271
Ǽ,AQiangXiang,653226209,5954,481,4120,2503,8247,4109,2059,4353,8462,4374,8494
Ӣ͸,YingBaGeXiang,653226210,6296,447,4369,2522,8815,4362,2327,4699,9061,4701,9070
ϣ,XiWuLeXiang,653226211,3060,207,2054,1349,4228,2054,1045,2258,4312,2258,4312
ǲ,DaLiYaBoYiXiang,653226212,893,49,583,290,1270,583,339,698,1281,698,1281
ֳ,LaYiSuLiangZhongChang,653226400,1803,128,1199,796,2474,1199,558,1290,2489,1290,2489
Ӫأ,GuoYingKunLunZhong,653226401,1160,124,657,680,1538,657,296,923,1580,923,1580
³ֵ´,XinChengQuJieDaoBanShiChu,653226501,10411,696,5768,5465,10361,5729,2580,6592,12321,7919,13687
ϳֵ´,LaoChengQuJieDaoBanShiChu,653226502,4593,419,3077,2597,5120,3077,1147,3081,6158,3082,6159
ɲũ,LanGanBoZiYaNongChang,653226503,1741,77,1205,667,2455,1205,711,1324,2529,1324,2529
,NiYaZhen,653227100,2654,144,1736,1090,3373,1736,688,1749,3485,1750,3486
,NiYaXiang,653227200,4694,299,3117,2105,6310,3115,1380,3253,6368,3256,6373
,RuoKeYaXiang,653227201,5057,233,3359,2129,6783,3359,1605,3523,6882,3536,6895
,SaLeWuZeKeXiang,653227202,3046,166,2025,1379,4143,2025,983,2169,4194,2170,4195
Ҷ,YeYiKeXiang,653227203,2718,239,1845,1226,3678,1832,794,1894,3726,1906,3751
϶,AnDiErXiang,653227204,268,13,162,126,315,162,62,174,336,181,343
϶,AnDiErMuChang,653227400,1648,92,1036,763,2161,1036,425,1129,2165,1129,2165
ֵ´,ChengZhenJieDaoBanShiChu,653227500,4955,195,3313,2404,6053,3299,1574,3367,6666,3411,6724
ֵ´,SaYiBuYiJieDaoBanShiChu,654002001,42665,6550,29228,22227,46066,28877,8491,27881,56758,28478,57706
ֵ´,DunMaiLiJieDaoBanShiChu,654002002,21714,2235,15816,8853,21074,13222,5140,12508,25730,13273,29089
·ֵ´,YiLiHeLuJieDaoBanShiChu,654002003,15567,1428,11052,7188,16273,11025,4697,10605,21630,10640,21692
ֵ´,KaZanQiJieDaoBanShiChu,654002004,20036,2112,14603,8926,22036,14276,6030,13397,27673,13575,28178
͸ֵ´,DouLaiTiBaGeJieDaoBanShiChu,654002005,15126,1433,10922,5887,14453,10085,4784,9564,19649,10421,21343
˽ֵ´,QiongKeRuiKeJieDaoBanShiChu,654002006,30291,2781,21597,12224,27939,21359,10500,20446,41805,21975,43572
ľ͸ֵ´,AiLanMuBaGeJieDaoBanShiChu,654002007,50252,4118,33722,21051,39566,29927,11758,29415,59342,32406,66128
·ֵ´,JieFangLuJieDaoBanShiChu,654002008,33523,2856,22041,14558,24558,17741,5762,17762,35503,20100,42141
б߾,YiNingShiBianJingJingJi,654002009,29579,2475,19171,13952,23496,17404,6086,17294,34698,18969,38140
,BaYanDaiZhen,654002100,23102,2842,15345,10511,26559,15296,7187,16273,31569,17786,33131
ӢҲ,YingYeErXiang,654002200,11307,702,7694,3715,14469,7678,4029,8281,15959,8344,16038
,HanBinXiang,654002201,7300,552,5032,3230,8044,5029,2555,5347,10376,5375,10407
ʲ,TaShenKeRuiKeXiang,654002202,11819,886,8498,4745,13252,8495,4310,8513,17008,8517,17015
,KaErDunXiang,654002203,7069,391,5075,2642,7692,5074,2772,5146,10220,5157,10232
и,TuoGeLaKeXiang,654002204,5653,413,3855,2441,6894,3826,2020,4183,8009,4231,8086
˲,KeBoKeWeiZiXiang,654002205,4651,329,3416,1645,5893,3376,1992,3525,6901,3556,6972
ľͼ,DaDaMuTuXiang,654002206,26668,1671,16467,9518,25527,16387,8233,18046,34433,20105,36572
˽,PanJinXiang,654002207,17265,1137,12377,6340,22646,12376,6905,12928,25304,12930,25307
ũҵ,YiLiZhouNongYeLiangZhong,654002400,1337,124,1012,465,1682,1012,550,999,2011,999,2011
԰ճ,YiNingShiYuanYiChang,654002401,951,137,644,533,1140,643,234,677,1320,678,1322
Ž·ֵ,TuanJieLuJieDaoBan,654003001,21771,4132,14852,11239,22023,14660,4109,13838,28498,15160,30012
ڶ·ֵ,WuDongLuJieDaoBan,654003002,15040,2166,9515,7600,9989,9348,2804,9637,18985,10495,20010
·ֵ´,BeiJingLuJieDaoBanShiChu,654003003,36502,4464,24883,16464,29285,21327,6610,20433,41760,22693,47576
³ľ·ֵ,WuLuMuQiXiLuJieDao,654003004,6683,1024,4295,3417,4138,4226,1284,4398,8624,4696,8991
վֵ,HuoCheZhanJieDaoBan,654003005,6153,454,3704,3000,3588,3586,1099,3614,7200,4002,7706
,KaiGanQiXiang,654003201,1202,28,753,468,1317,748,361,754,1502,838,1591
һһ,BingTuanYiSanYiTuan,654003508,18541,2306,11252,8542,15282,11170,3307,11960,23130,12902,24154
챱,TianBeiXinQu,654003510,19451,2476,13028,9713,17153,12978,4294,12986,25964,13193,26221
,JiLiYuZiZhen,654021100,26882,2149,18069,10952,31942,17304,8207,18116,35420,19169,37238
,DunMaZhaZhen,654021101,8434,571,5689,3274,10153,5684,2927,6225,11909,6243,11932
,HuDiYuZiXiang,654021200,12589,992,9067,4578,16712,9055,4956,9452,18507,9470,18537
³,TuLuFanYuZiXiang,654021201,9335,630,6402,3406,12361,6402,3600,7163,13565,7163,13565
,KaLaYaGaQiXiang,654021202,8375,475,5442,2886,10660,5321,2916,5954,11275,6324,11766
书,WuGongXiang,654021203,5676,470,3815,2193,7221,3815,1976,4307,8122,4307,8122
ؿ,SaDiKeYuZiXiang,654021204,3723,315,2453,1485,4986,2453,1191,2776,5229,2776,5229
Ⱥ̻,YuQunWengHuiZuXiang,654021205,33190,2629,22610,10962,44441,22539,10940,24063,46602,24149,46759
˹,AReWuSiTangXiang,654021206,14156,1060,9595,5638,18581,9541,4770,10302,19843,10391,19986
Ӣľ,YingTaMuXiang,654021207,17466,1047,12052,6886,23996,12051,6248,12708,24759,12709,24761
к,BaYiTuoHaiXiang,654021208,13383,846,9346,4913,17936,9336,4988,9864,19200,9871,19217
ά,WeiWuErYuQiWenXiang,654021209,13557,1011,9065,5245,17265,9065,4101,9604,18669,9604,18669
ľ,SaMuYuZiXiang,654021210,14117,1096,9561,5062,19141,9557,4408,10059,19616,10060,19621
ʲ,KaShiXiang,654021211,16426,1160,11376,5867,22559,11376,5957,12167,23543,12167,23543
,MaZhaXiang,654021212,8464,567,6016,3370,11553,6016,3038,6053,12069,6053,12069
Ƕ,WenYaErXiang,654021213,18305,1115,12861,6096,25466,12861,6902,13461,26322,13461,26322
,AWuLiYaXiang,654021214,11196,680,7502,4156,14886,7502,3551,7925,15427,7925,15427
³,QuLuHaiXiang,654021215,7478,536,5064,2529,9912,5061,2433,5381,10442,5383,10447
ũ,QingNianNongChang,654021400,6454,429,4289,2079,7621,4054,2068,4191,8245,4662,8951
ũ,DuoLangNongChang,654021401,5457,390,3886,2019,7536,3883,2058,4019,7902,4019,7905
ʮ,BingTuanQiShiTuanZhongXin,654021501,8890,2111,6162,5266,11464,6119,1523,6246,12365,6362,12524
첼,ChaBuChaErZhen,654022100,16772,1290,10825,6978,17839,10804,4049,10836,21640,11286,22111
,AiXinSheLiZhen,654022101,5991,498,3880,2632,7724,3711,1643,4103,7814,4252,8132
ţ¼,DuiYiQiNiuLuXiang,654022200,5919,446,4014,2137,7572,4008,1864,4199,8207,4215,8229
ţ¼,SunZhaQiNiuLuXiang,654022201,7165,497,4636,2776,8219,4627,1765,4763,9390,4791,9427
»,ChaoHuoErXiang,654022202,5336,285,3395,1934,5804,3395,1363,3589,6984,3589,6984
ɴţ¼,NaDaQiNiuLuXiang,654022203,3889,334,2527,1746,3534,2527,965,2661,5188,2661,5188
ţ¼,ZhaKuQiNiuLuXiang,654022204,10232,722,6776,4027,12783,6776,2887,7065,13841,7065,13841
Ȫ,MiLiangQuanHuiZuMinZu,654022205,3432,244,2384,1338,4320,2384,1120,2412,4796,2412,4796
,KanXiang,654022206,8585,406,5492,2656,10633,5430,2959,5890,11320,6458,11950
,KuoHongQiXiang,654022207,5419,272,3930,1913,7397,3930,2105,3866,7796,3866,7796
Ŭ,HaiNuKeXiang,654022208,9793,599,6909,3690,13894,6909,3748,7231,14140,7231,14140
˹̨,JiaGaSiTaiXiang,654022209,9478,563,6667,3617,12744,6633,3520,6728,13361,6894,13561
�,QiongBoLaXiang,654022210,6345,343,4009,2516,8006,3960,1910,4302,8262,4589,8598
в,TuoBuZhongXin,654022400,4864,413,3095,2374,5778,3087,1281,3428,6515,3463,6558
,LiangFanChang,654022401,1667,124,1056,856,1680,1056,417,1152,2208,1152,2208
ţ,YiLiZhouNaiNiuChang,654022402,8477,852,5766,3857,8751,5747,2334,5850,11597,5897,11663
ƽԭֳ,YiLiZhouPingYuanLinChang,654022403,178,13,98,69,134,80,18,90,170,111,209
ɽֳ,ShanQuLinChang,654022404,541,49,354,199,568,354,112,348,702,348,702
ڰ,DouLaTaKouAn,654022408,305,0,29,9,90,6,1,10,16,277,306
ʮ,BingTuanLiuShiQiTuan,654022502,6087,735,3916,2868,7549,3894,1539,4415,8309,4445,8361
ʮ,BingTuanLiuShiBaTuan,654022503,6602,1387,4291,3806,7698,4270,1099,4760,9030,4797,9088
ʮ,BingTuanLiuShiJiuTuan,654022504,4066,1094,2829,2649,5361,2805,736,3039,5844,3067,5896
ˮ,ShuiDingZhen,654023100,20166,2250,13765,7348,24807,11450,5286,11520,22970,13937,27702
ˮ,QingShuiHeZhen,654023101,34794,2501,22497,15256,37124,21861,9491,23637,45498,24289,46786
«ݹ,LuCaoGouZhen,654023102,26009,2166,16977,9535,33332,15966,7219,17586,33552,18417,35394
Զ,HuiYuanZhen,654023103,15176,1356,10297,6196,18865,10121,4839,10978,21099,11074,21371
,SaErBuLaKeZhen,654023104,20484,1927,13323,7970,26774,13095,5850,14782,27877,14938,28261
,LanGanXiang,654023200,22157,1520,15341,7639,22859,15073,7443,15295,30368,15779,31120
,SanDaoHeXiang,654023201,6499,590,4482,2658,8296,4481,2185,4791,9272,4792,9274
,YiCheGaShanXiang,654023203,8231,863,5094,3731,9896,4978,1795,5640,10618,5795,10889
,SanGongXiang,654023204,10623,865,7309,3536,13754,6662,3410,7150,13812,7589,14898
,DaXiGouXiang,654023205,7635,655,5229,2968,9880,5227,2499,5543,10770,5560,10789
ɹ,GeGanGouMuChang,654023400,3748,327,2575,1532,4776,2518,1132,2582,5100,2632,5207
Ī,MoHuErMuChang,654023401,4179,346,2826,1635,5075,2751,1263,2883,5634,2962,5788
ӹ,GuoZiGouMuChang,654023402,5503,433,3756,2049,6842,3607,1598,3631,7238,3778,7534
ַ,LiangZhongFanYuZhongXin,654023403,1966,223,1333,880,2427,1333,557,1411,2744,1413,2746
˹ڰ,HuoErGuoSiKouAn,654023404,3258,52,1777,1324,1660,1546,617,1601,3147,2150,3927
ú̿,MeiTanJu,654023411,2082,170,1246,1077,1633,1219,356,1268,2487,1362,2608
ʮһ,BingTuanLiuShiYiTuan,654023505,8417,1565,5911,4333,11101,5892,2187,6225,12117,6258,12169
ʮ,BingTuanLiuShiErTuan,654023506,13464,2222,9077,6706,14847,8779,3003,9327,18106,9612,18689
ʮ,BingTuanLiuShiSanTuan,654023507,6179,1312,4303,3437,8242,4295,1302,4471,8766,4490,8793
ʮ,BingTuanLiuShiSiTuan,654023508,16801,2381,11737,7457,22084,10810,4404,10953,21763,11849,23586
ʮţ,BingTuanLiuShiLiuTuan,654023509,17945,3775,12507,9706,21840,12211,3438,12315,24526,12651,25158
,GongLiuZhen,654024100,18451,1209,12442,7169,19693,11260,5085,11157,22417,12303,24745
Ī,MoHuErXiang,654024200,7014,492,4718,2800,9313,4718,2231,5019,9737,5019,9737
,JiErGeLangXiang,654024201,4652,294,3213,1903,6433,3213,1651,3384,6597,3384,6597
ضɭ,AGaErSenXiang,654024202,15166,1003,10399,5378,20580,10383,5339,11091,21474,11109,21508
,DongMaiLiXiang,654024203,18998,1381,12856,7166,25223,12856,6538,14061,26917,14061,26917
˹б,TaSiTuoBieXiang,654024204,16228,1035,11399,5991,19229,11382,6062,11896,23278,11926,23325
˰ȿ,TiKeAReKeXiang,654024205,9619,663,6548,3961,11968,6548,3488,7222,13770,7222,13770
ͼ,AKeTuBieKeXiang,654024206,6774,395,4557,2676,8952,4557,2528,5140,9697,5140,9697
ۺũ,ZongHeNongChang,654024400,2073,205,1437,889,2428,1428,634,1460,2888,1475,2912
ʲʲ,KuoShenAGaShenYangChang,654024401,3124,218,2197,1321,4237,2197,1147,2292,4489,2292,4489
ţ,NiuChang,654024402,5647,372,3773,2394,7523,3637,1933,4078,7715,4179,7952
,LiangFanChang,654024403,3257,211,2076,1362,3362,2076,984,2376,4452,2376,4452
ֳ,LinChang,654024405,770,150,511,508,780,483,174,546,1029,583,1094
Īũ,MoHuErNongChang,654024406,347,53,242,196,476,242,110,268,510,268,510
ʮ,BingTuanQiShiSanTuan,654024510,5049,869,3548,2743,6503,3530,1237,3549,7079,3607,7155
Դ,XinYuanZhen,654025100,39159,2378,26057,14706,34686,22788,9651,22921,45709,25131,51188
̨,ZeKeTaiZhen,654025101,18892,1019,11640,7265,18927,10804,4734,11720,22524,13005,24645
б,AReLeTuoBieZhen,654025102,19877,1145,12999,6867,26156,12999,6015,14038,27037,14038,27037
յ,TaLeDeZhen,654025103,17393,960,11103,6377,21759,11096,5079,12281,23377,12329,23432
,NaLaTiZhen,654025104,19938,1107,12986,8034,25223,12930,6527,14453,27383,14586,27572
Ф,XiaoErBuLaKeZhen,654025105,7059,621,4422,3520,8702,4409,1658,4899,9308,4916,9338
˹б,BieSiTuoBieXiang,654025200,21643,1281,13883,8197,24795,13878,5972,14995,28873,15013,28896
,KanSuXiang,654025201,7898,474,5085,3178,10403,5085,2530,5817,10902,5817,10902
,KaLaBuLaXiang,654025202,14863,926,9872,5894,19292,9872,4833,10744,20616,10750,20622
,ALeMaLeXiang,654025203,11491,979,7540,4821,15272,7536,3502,8410,15946,8432,15972
¶,TuErGenXiang,654025204,8274,705,5446,3803,10737,5433,2502,6012,11445,6035,11481
,ZhongYangChang,654025400,5561,561,3738,2547,7470,3737,1762,4134,7871,4146,7884
ũ,GongAnNongChang,654025403,3065,103,336,343,412,310,61,366,676,2893,3229
ʮһ,BingTuanQiShiYiTuan,654025511,7859,1755,5346,4362,9350,5219,1347,5399,10618,5615,10961
ʮ,BingTuanQiShiErTuan,654025512,6465,1895,4645,4341,8738,4639,1199,4898,9537,4914,9559
,ZhaoSuZhen,654026100,21480,1045,13955,9543,22513,13310,5371,13443,26753,13941,27896
ɺ,HongNaHaiXiang,654026200,7204,308,4214,3319,8364,4008,1679,4683,8691,4977,9191
,WuZunBuLaKeXiang,654026201,5697,289,3726,2151,7101,3726,1734,3994,7720,3994,7720
˴,AKeDaLaXiang,654026202,6616,428,4189,3060,8670,4175,2011,4836,9011,4866,9055
,SaErKuoBuXiang,654026203,8556,321,5730,2680,11695,5723,3080,6204,11927,6227,11957
ļӶ,KaXiaJiaErXiang,654026204,6704,236,4393,2554,8922,4256,2243,4537,8793,4790,9183
,KaLaSuXiang,654026205,8225,455,5796,3362,11422,5740,3064,5871,11611,5948,11744
캹ɹ,ChaHanWuSuMengGuMinZuXiang,654026206,7368,330,4470,3258,9640,4458,2117,5331,9789,5345,9815
ؿ¶,XiaTeKeErKeZiMinZuXiang,654026207,8009,349,5270,3154,10989,5254,2737,5794,11048,5825,11095
ͼѷɹ,HuSongTuHaErXunMengGuMinZuXiang,654026208,6253,271,4013,2251,8088,3870,1791,4156,8026,4302,8315
�,ZhongMaChang,654026402,3817,264,2629,1541,4909,2611,1219,2639,5250,2671,5300
ɽҵֳ,TianShanXiBuLinYeJuZhaoSuLinChang,654026403,538,34,351,262,633,349,180,398,747,401,752
�,ZhaoSuMaChang,654026404,3950,312,2688,2068,4980,2688,1190,2764,5452,2764,5452
ʮ,BingTuanQiShiSiTuan,654026513,2020,243,1314,1023,2364,1303,496,1393,2696,1445,2759
ʮ,BingTuanQiShiWuTuan,654026514,2196,175,1340,1138,2435,1318,418,1399,2717,1449,2789
ʮ,BingTuanQiShiLiuTuan,654026515,6371,610,4203,3169,8364,4186,1775,4545,8731,4553,8756
ʮ,BingTuanQiShiQiTuan,654026516,4628,593,3132,2181,6214,3114,1187,3248,6362,3276,6408
ؿ˹,TeKeSiZhen,654027100,25770,1513,16403,10202,29690,15125,6457,15913,31038,17337,33740
�ɹ,HuJiErTeMengGuMinZuXiang,654027200,5063,285,3005,2260,5627,2993,1203,3484,6477,3546,6551
,KuoKeSuXiang,654027201,1383,121,878,570,1801,877,408,1028,1905,1034,1912
,QiLeWuZeKeXiang,654027202,12158,517,7936,4288,16722,7867,4329,9002,16869,9068,17004
ȿ˿¶,KuoKeTieReKeKeErKeZiMinZuXiang,654027203,9855,641,6692,3667,14101,6683,3741,7535,14218,7545,14237
ȿ,QiaoLaKeTieReKeZhen,654027204,20781,1142,13948,7702,28872,13871,7412,15314,29185,15387,29335
,KaLaDaLaXiang,654027205,12444,779,8473,4521,17317,8439,4561,9272,17711,9311,17784
к,KaLaTuoHaiXiang,654027206,8446,483,5593,2921,11594,5569,2967,6154,11723,6303,11896
ؿ˹�,TeKeSiJunMaChang,654027404,3598,268,1994,1437,3632,1931,937,2069,4000,2809,4803
ƿֳ,KeKeSuLinChang,654027405,424,25,264,196,439,263,98,279,542,283,547
ʮ,BingTuanQiShiBaTuan,654027517,3500,424,2444,1816,4535,2441,985,2455,4896,2465,4909
տ,NiLeKeZhen,654028100,23357,1923,15618,9501,25037,15014,6627,15448,30462,16289,31907
ղ̨,SuBuTaiXiang,654028200,4819,340,3269,1859,6313,3263,1751,3625,6888,3641,6910
,KaLaSuXiang,654028201,9549,569,6303,3708,12821,6303,3350,7165,13468,7165,13468
ӹ˹̨,JiaHaWuLaSiTaiXiang,654028202,6170,422,3943,2750,7903,3943,1944,4593,8536,4593,8536
տ,NiLeKeWuZanXiang,654028203,12135,751,6972,4308,14198,6961,3417,7796,14757,9331,16303
ƿ˺غƶ,KeKeHaoTeHaoErMeng,654028204,10703,952,6764,4949,13237,6764,2991,7882,14646,7882,14646
˹̨,WuLaSiTaiXiang,654028205,7115,434,4533,3321,9133,4533,2272,5284,9817,5288,9821
,KeLingXiang,654028206,8029,465,5287,3155,10983,5287,2668,5875,11162,5875,11162
б,KaLaTuoBieXiang,654028207,6879,431,4128,3220,8900,4128,1791,4973,9101,4973,9101
̨,HuJiErTaiXiang,654028208,7507,501,4801,3265,9710,4801,2306,5512,10313,5513,10314
ľ˹,MuSiXiang,654028209,9418,327,6317,3199,10752,6317,3318,6744,13061,6746,13063
ַ䳡,ZhongFengChang,654028400,2660,157,1785,1068,3169,1785,865,1897,3682,1897,3682
տ�,NiLeKeMaChang,654028402,2919,290,1946,1409,3796,1946,933,2116,4062,2196,4142
ʮ,BingTuanQiShiJiuTuan,654028518,3263,590,2218,1989,4124,2206,835,2445,4651,2470,4688
ƽֵ´,HePingJieDaoBanShiChu,654201001,17326,1865,11489,7765,15397,10419,3684,9781,20200,11386,22875
ű˽ֵ´,DuBieKeJieDaoBanShiChu,654201002,20162,2386,13413,10843,19963,12195,3754,12281,24476,12889,26302
³ǽֵ´,XinChengJieDaoBanShiChu,654201003,15225,1584,9834,8602,14343,9362,3327,9999,19361,10302,20136
,ErGongZhen,654201100,17399,1906,10424,9196,15726,10367,3361,12122,22489,12242,22666
Ϳ,KaLaHaBaKeXiang,654201200,7059,783,4498,3346,8811,4477,1650,4972,9449,4994,9492
ǡ,QiaXiaXiang,654201201,7677,687,4862,3053,9681,4843,1811,5287,10130,5313,10175
Ӷ,AXiErDaWoErMinZuXiang,654201202,6080,600,3620,2694,7549,3591,1153,4173,7764,4213,7833
,ABuDouLaXiang,654201203,5014,528,3175,2468,6430,3170,1301,3652,6822,3668,6843
Ҳ,YeMenLeXiang,654201204,5656,561,3567,2661,6981,3563,1415,4065,7628,4065,7632
ǡϼ,QiaHeJiMuChang,654201403,1650,139,1036,849,2076,1031,448,1187,2218,1201,2237
δũ,BoZiDaKeNongChang,654201404,3297,429,2043,1794,4041,2042,721,2403,4445,2404,4447
,WoYiJiaYiLaoMuChang,654201405,3022,182,1903,1452,3782,1903,840,2141,4044,2141,4044
ţ,DiQuZhongNiuChang,654201406,1451,98,908,703,1657,906,367,1001,1907,1008,1916
ũʦһ,BingTuanNongJiuShiYiLiuSanTuan,654201503,6025,1535,3932,4100,7765,3888,1054,4571,8459,4682,8614
ũʦһ,BingTuanNongJiuShiYiLiuSiTuan,654201504,4024,1050,2640,2613,5199,2608,751,3058,5666,3185,5825
Էֵ,NanYuanJieDao,654202002,27526,2835,17506,14495,23227,16485,5613,17396,33881,18468,35974
ֵ,XiChengQuJieDao,654202003,10393,263,2399,1841,1813,2217,938,2441,4658,9195,11594
Žֵ,HongQiaoJieDao,654202004,18743,2240,12429,10571,19287,12074,4036,12363,24437,12590,25019
,BaiYangGouZhen,654202100,2690,142,1636,1366,2529,1628,674,1844,3472,1870,3506
ͼ,HaTuBuHuZhen,654202101,11561,1070,7574,5211,13035,7508,3196,8182,15690,8253,15827
ʹ,HuangGongZhen,654202102,7653,637,4980,3045,9845,4764,2020,5132,9896,5330,10310
,ChePaiZiZhen,654202103,4405,343,2637,2276,5373,2614,1086,3167,5781,3197,5834
ʺ,GanHeZiZhen,654202104,6934,575,4274,3083,7977,4245,1563,4740,8985,4798,9072
Ȫ,BaiQuanZhen,654202105,6576,494,4082,3030,7149,4021,1415,4315,8336,4403,8485
Ŀ,SiKeShuZhen,654202106,7905,661,5070,3249,9698,5064,2105,5587,10651,5601,10671
Ŷͼ,GuErTuZhen,654202107,8050,487,5145,3357,9736,5110,2081,5416,10526,5473,10618
,XiHuZhen,654202108,5580,619,3579,2621,6743,3561,1259,3845,7406,3879,7458
,XiDaGouZhen,654202109,5909,576,3748,2669,7320,3748,1342,4072,7820,4079,7827
ʮĻ,BaShiSiHuXiang,654202200,10256,952,6476,4684,10930,6476,2286,7018,13494,7018,13494
к,JiaHeZiXiang,654202201,2371,296,1568,1082,2849,1566,595,1693,3259,1694,3262
ż¥,JiuJianLouXiang,654202202,4277,380,2802,1750,5525,2800,1092,2945,5745,2947,5749
ʯ,ShiQiaoXiang,654202203,4113,272,2556,1725,5034,2554,1029,2845,5399,2858,5414
ͷ̨,TouTaiXiang,654202204,3262,318,2176,1544,3934,2130,855,2219,4349,2259,4435
ع,JiErGeLeTeGuoLeng,654202205,3860,350,2609,1390,4843,2366,1093,2431,4797,2694,5303
պɹ,TaBuLeHeTeMengGuMinZuXiang,654202206,1490,125,926,647,1843,925,368,1039,1964,1057,1983
ʼҺ,GanJiaHuMuChang,654202400,2581,157,1636,1127,3264,1601,734,1778,3379,1836,3472
,BaYinGouMuChang,654202401,1846,100,1205,716,2320,1205,540,1281,2486,1281,2486
,SaiLiKeTiMuChang,654202402,1090,83,686,444,1227,673,251,731,1404,738,1424
,XuNiDiQu,654202403,169,14,105,76,135,100,16,86,186,94,199
һ,BingTuanYiErSanTuan,654202500,13702,2014,9152,6709,14961,8962,2826,9049,18011,9390,18542
һ,BingTuanYiErSiTuan,654202501,13019,2449,8729,7274,14710,8700,2294,8983,17683,9033,17762
һ,BingTuanYiErWuTuan,654202502,13198,2285,8497,6533,15826,8145,2016,8603,16748,9002,17499
һ,BingTuanYiErLiuTuan,654202503,9363,1671,6121,4964,11208,6086,1605,6430,12516,6518,12639
һ,BingTuanYiErQiTuan,654202504,8772,1714,5870,4847,10892,5814,1458,5956,11770,6074,11944
һ,BingTuanYiErBaTuan,654202505,7858,1424,5318,4217,9318,5267,1476,5271,10538,5440,10758
һ,BingTuanYiSanLingTuan,654202507,273,22,168,92,304,132,52,137,269,179,347
,EMinZhen,654221100,42245,4697,29058,20306,39371,28569,10840,28045,56614,28724,57782
,JiaoQuXiang,654221200,12934,972,7484,6632,12314,7480,2884,9284,16764,9306,16790
ϻ,ShangHuXiang,654221201,7633,484,4703,3345,9074,4703,1976,5390,10093,5390,10093
չɹ,EMaLeGuoLengMengGuMinZuXiang,654221202,3004,263,1644,1883,3572,1644,587,2210,3854,2210,3854
ʲ,YuShenKaLaSuXiang,654221203,6188,366,3513,3463,7147,3513,1507,4548,8061,4548,8061
հʲ,JieLeAGaShenXiang,654221204,6662,415,3962,3376,7892,3962,1680,4795,8757,4795,8757
,MaReLeSuXiang,654221205,8332,520,4548,4550,9462,4548,1572,5876,10424,5876,10424
Ҳľ,KaLaYeMuLeXiang,654221206,5644,232,3282,2751,7043,3266,1541,4102,7368,4135,7417
,LaMaZhaoXiang,654221207,1318,51,817,615,1727,817,376,928,1745,928,1745
�ɹ,HuoJiErTeMengGuMinZuXiang,654221208,2748,207,1556,1567,3100,1556,572,1971,3527,1971,3527
,ErDaoQiaoXiang,654221209,1718,85,1073,868,2067,1073,496,1226,2299,1226,2299
֧,ErZhiHeMuChang,654221400,3815,273,2427,2202,4801,2424,1060,2710,5134,2721,5148
Ӷũ,JiaErBuLaKeNongChang,654221401,2044,293,1246,1381,2612,1246,452,1536,2782,1543,2789
ʲȿֳ,KuoShenBiKeLiangZhongChang,654221402,1860,128,1050,1061,2108,1050,389,1327,2377,1327,2377
Ҳľ,SaErYeMuLeMuChang,654221403,3245,188,1972,1545,4039,1972,921,2380,4352,2382,4354
Ҳľ,YeMuLeMuChang,654221404,4826,367,2720,2940,6037,2720,1175,3648,6368,3648,6368
ǵ,TaChengDiQuZhongYangChang,654221405,3570,330,2237,1950,4627,2230,947,2609,4839,2610,4847
ڲ,WuZongBuLaKeMuChang,654221406,980,41,652,452,1344,652,379,748,1400,748,1400
ũʦһ,BingTuanNongJiuShiYiLiuWuTuan,654221505,3855,956,2387,2824,5151,2374,699,3112,5486,3123,5510
ũʦһ,BingTuanNongJiuShiYiLiuLiuTuan,654221506,5150,1242,3147,3695,6909,3118,892,4080,7198,4137,7284
ũʦһ,BingTuanNongJiuShiYiLiuQiTuan,654221507,3634,833,2494,2151,4713,2477,706,2659,5136,2679,5173
ũʦһ,BingTuanNongJiuShiYiLiuBaTuan,654221508,5792,1366,3980,3633,7489,3957,1161,4292,8249,4339,8319
ũʦŽũ,BingTuanNongJiuShiTuanJieNongChang,654221511,2088,327,1266,1212,2384,1259,379,1499,2758,1528,2794
,SanDaoHeZiZhen,654223100,46860,3930,27800,18771,35140,25383,9339,25137,50520,32329,60129
ĵ,SiDaoHeZiZhen,654223101,10532,1143,6377,5668,12639,6319,2202,7408,13727,7500,13877
ɳ,LaoShaWanZhen,654223102,8063,1031,5021,3873,10118,4978,1652,5655,10633,5725,10746
,WuLanWuSuZhen,654223103,10535,1413,6832,5064,13674,6721,2448,7436,14157,7564,14396
,AnJiHaiZhen,654223104,11450,1236,7586,5204,13925,7472,3030,8044,15516,8130,15716
,DongWanZhen,654223105,7593,724,4564,3469,8269,4511,1742,5070,9581,5495,10059
,XiGeBiZhen,654223106,6963,525,4374,3047,8920,4340,1852,4919,9259,4966,9340
ë,LiuMaoWanZhen,654223107,5693,583,3406,2750,6506,3330,1109,3878,7208,3979,7385
𹵺,JinGouHeZhen,654223108,8861,878,5730,4145,10996,5719,2415,6391,12110,6424,12154
̻,ShangHuDiXiang,654223200,13860,2494,8980,7202,16354,8908,2590,9804,18712,9964,18944
Ȫ,DaQuanXiang,654223201,9623,883,6248,4519,9911,6210,2569,6788,12998,6827,13075
ͨ,BoErTongGuXiang,654223202,6040,391,3984,2440,7874,3912,1890,4245,8157,4337,8321
ţȦ,NiuJuanZiMuChang,654223400,1858,139,1178,771,2373,1178,529,1348,2526,1348,2526
ͨ,BoErTongGuMuChang,654223401,2305,146,1596,931,3147,1592,826,1676,3268,1681,3277
ֳ,LiangZhongChang,654223402,816,109,498,431,962,498,175,602,1100,602,1100
һһ,BingTuanYiErYiTuan,654223503,28006,5994,17515,18968,33545,17194,4320,20338,37532,20805,38320
һ,BingTuanYiSanSanTuan,654223506,15215,2082,9532,7559,16474,9115,2622,9917,19032,10387,19919
һ,BingTuanYiSanSiTuan,654223507,14027,2129,8712,8063,14848,8597,2645,9827,18424,10089,18801
һһ,BingTuanYiSiYiTuan,654223509,7346,1289,4683,4326,8098,4525,1388,5153,9678,5340,10023
һĶ,BingTuanYiSiErTuan,654223510,20159,4640,12446,13362,23339,11677,2789,14200,25877,15142,27588
һ,BingTuanYiSiSanTuan,654223511,27316,5926,17842,17450,31363,17527,4660,19432,36959,20060,37902
һ,BingTuanYiSiSiTuan,654223512,8592,1490,5249,5464,9574,5120,1516,6201,11321,6349,11598
,TuoLiZhen,654224100,20526,1714,14372,9141,21850,14320,6138,13806,28126,14006,28378
�,TieChangGouZhen,654224101,8825,509,5279,3670,8619,5103,2088,5327,10430,6143,11422
,MiaoErGouZhen,654224102,4484,179,2740,1584,4898,2649,1302,2663,5312,3225,5965
,DuoLaTeXiang,654224200,8600,441,5604,3777,11339,5580,2568,5952,11532,6005,11609
ѩ,WuXueTeXiang,654224201,8010,422,5292,3273,9914,5291,2377,5491,10782,5517,10809
,KuPuXiang,654224202,10300,583,6907,4475,14172,6905,3678,7654,14559,7654,14561
˱ﶷ,AKeBieLiDouXiang,654224203,5580,265,3623,2344,7344,3623,1805,4027,7650,4027,7650
ֳ,BaiYangHeLinChang,654224401,5,0,4,2,7,4,2,3,7,3,7
Ϸֳ,LaoFengKouLinChang,654224402,32,3,20,9,41,20,6,21,41,21,41
Ͷ³ɽ˹ֳ,BaErLuKeShanTaSiTeLinChang,654224403,1,0,0,1,1,0,0,1,1,1,1
һ,BingTuanYiQiLingTuan,654224510,1901,219,1322,909,1985,1300,535,1307,2607,1333,2655
,HaLaBuLaZhen,654225100,11554,1107,7217,6041,10911,7141,2643,7696,14837,8087,15304
,HaLaBuLaXiang,654225200,5227,489,3036,2747,5574,3036,958,3638,6674,3638,6674
µ,XinDiXiang,654225201,3737,272,2247,1810,4545,2247,825,2586,4833,2587,4834
Ҳľ,ALeTengYeMuLeXiang,654225202,3960,272,2520,1869,5130,2518,1139,2848,5366,2851,5371
Ҳ,JiYeKeXiang,654225203,5060,358,2831,2689,5970,2831,1015,3602,6433,3602,6433
˹,JiangGeSiXiang,654225204,3284,245,2001,1559,4102,2001,764,2292,4293,2292,4293
캹к,ChaHanTuoHaiMuChang,654225400,2306,207,1469,1238,2995,1469,598,1642,3111,1642,3111
ũʦһһ,BingTuanNongJiuShiYiLiuYiTuan,654225501,4106,835,2901,2296,4179,2850,958,2859,5709,2998,5899
Ͳ,HeBuKeSaiErZhen,654226100,10548,593,6976,4313,9509,6554,2851,6348,12902,7016,13992
ʲ,HeShenTuoLuoGaiZhen,654226101,10346,639,5998,4108,9845,5535,2001,5941,11476,6988,12986
θ,XiaZiGaiXiang,654226200,2442,196,1464,874,2598,1219,455,1263,2482,1629,3093
ɢ,TieBuKenWuSanXiang,654226201,2566,135,1540,869,3245,1321,591,1479,2800,1752,3292
ɿ,ChaGanKuLeXiang,654226202,2761,169,1747,997,3531,1505,651,1591,3096,1834,3581
,BaYinAoWaXiang,654226203,1482,84,980,470,1870,801,411,826,1627,997,1977
Īظ,MoTeGeXiang,654226204,1936,114,1229,616,2063,976,492,1028,2004,1313,2542
ͼ,YiKeWuTuBuLaGe,654226400,2188,114,1345,920,2824,1320,555,1467,2787,1512,2857
ʺͲ,NaRenHeBuKeMuChang,654226401,2205,177,1229,1006,2734,1130,377,1349,2479,1530,2759
ͼ,BaGaWuTuBuLaGe,654226402,802,47,443,377,952,420,161,537,957,567,1010
˹͸,BuSiTunGeMuChang,654226403,1482,74,990,590,1927,954,484,997,1951,1050,2040
ֵ¸,CangDeGeKuangQu,654226404,1303,7,221,184,6,165,26,220,385,1115,1336
̬ũҵ,ChaHeTeShengTaiNongYeQu,654226405,564,4,280,280,0,273,121,401,674,409,689
һ,BingTuanYiBaSiTuan,654226500,4967,367,3205,1951,4480,2808,1043,2942,5750,3172,6377
½Դ޹˾,XinJiangTunXinNengYuanKaiFaYouXianGongSi,654226501,2718,387,1647,1518,2571,1634,464,1851,3485,1922,3569
ɽ·´,JinShanLuBanShiChu,654301001,17040,1924,11208,7363,18931,10319,3485,9940,20259,11241,22449
·´,JieFangLuBanShiChu,654301002,14363,1925,9731,6831,15713,9318,2874,9050,18368,9431,19162
Ž·´,TuanJieLuBanShiChu,654301003,14752,1781,9876,7013,16685,9760,2971,9443,19203,9628,19504
,BeiTunZhen,654301100,28030,4700,19292,13722,22219,18164,5766,18226,36390,19204,38496
έ̲,AWeiTanZhen,654301101,6914,513,4718,2580,8949,4718,2195,4904,9622,4904,9622
,HongDunZhen,654301102,8577,659,5559,3502,10825,5529,2353,5898,11427,6030,11589
ľп,QieMuErQieKeXiang,654301200,9288,627,6348,3210,12199,6348,3034,6601,12949,6601,12949
,ALaHaKeXiang,654301201,7009,414,4922,2287,9531,4922,2494,4995,9917,4995,9917
ɹ,HanDeGaTeMengGuZu,654301202,2665,205,1682,1022,3413,1671,708,1760,3431,1896,3578
˹,LaSiTeXiang,654301203,3354,299,1928,1748,3807,1928,616,2341,4269,2341,4269
ϣ,KaLaXiLiKeXiang,654301204,3777,220,2389,1524,4948,2389,1038,2646,5035,2646,5035
,SaErHuSongXiang,654301205,3601,190,2549,1317,4864,2549,1398,2640,5189,2640,5189
͸,BaLiBaGaiXiang,654301206,3112,220,2052,1347,3978,2052,876,2156,4208,2156,4208
ж,QieErKeQiXiang,654301207,3638,283,2360,1641,4945,2358,1143,2704,5062,2704,5064
ʲ,KaLaGaShenMuChang,654301400,2284,386,1464,1372,2572,1464,436,1642,3106,1642,3106
ľ˹,AKeTuMuSiKeMuChang,654301401,3765,430,2218,1872,4452,2155,870,2575,4730,2847,5065
һһ,BingTuanYiBaYiTuan,654301500,7497,2186,4784,5671,9781,4772,1179,6046,10818,6078,10862
,BuErJinZhen,654321100,15382,1502,10066,6850,15622,9629,3321,9492,19121,10139,20205
Ī,WoYiMoKeXiang,654321200,11068,755,7353,4383,14434,7315,3364,7745,15060,7834,15187
,DuLaiTiXiang,654321201,5925,441,3929,2749,7834,3926,1767,4201,8127,4204,8133
˹ؿ,KuoSiTeKeXiang,654321202,3210,264,1995,1710,4020,1995,850,2329,4324,2329,4324
,ChongHuErXiang,654321203,8529,620,5545,4259,11227,5533,2701,6299,11832,6305,11850
Ҳб,YeGeZiTuoBieXiang,654321204,3666,208,2417,1790,4744,2417,1086,2543,4960,2543,4960
ľ˹ɹ,HeMuHaNaSiMengGuMinZuXiang,654321205,1517,69,992,725,1942,984,513,1092,2076,1107,2099
˹,KuEErQiSiZhen,654322100,15542,1016,9349,6326,17400,9220,3214,9498,18718,10423,19772
ɿк,KeKeTuoHaiZhen,654322101,3784,317,2579,1822,4234,2579,1019,2541,5120,2541,5120
ǡͼ,QiaKuErTuZhen,654322102,1860,66,1243,734,2012,1223,641,1277,2500,1324,2567
¶,TuErHongXiang,654322200,10045,577,6893,3710,13498,6889,3521,7246,14135,7250,14143
,DuReXiang,654322201,10752,586,7407,4098,13805,7407,3915,7846,15253,7846,15253
,KuErTeXiang,654322202,7180,375,4910,2704,9762,4910,2538,5183,10093,5183,10093
ϣ,KeZiLeXiLiKeXiang,654322203,8333,339,5055,3241,9856,4926,2405,5449,10375,6022,11077
,TieMaiKeXiang,654322204,3475,239,2116,1588,4349,2116,886,2484,4600,2484,4600
ո,KaLaBuLeGenXiang,654322205,3768,228,2547,1458,5070,2541,1265,2708,5249,2714,5261
,FuHaiZhen,654323100,15400,1416,9106,6398,17286,9064,3097,9091,18155,10807,19913
ذ,JieTeAReLeXiang,654323200,7886,475,5013,3053,9683,5010,2066,5397,10407,5414,10427
˰ʲ,KuoKeAGaShenXiang,654323201,4937,308,3352,1933,6667,3352,1570,3462,6814,3463,6815
ɼ,QiGanJiDieXiang,654323202,2762,143,1805,932,3724,1805,896,1987,3792,1996,3801
,KaLaMaGaiXiang,654323203,6391,357,4327,2319,8640,4317,2100,4507,8824,4521,8848
,AErDaXiang,654323204,2327,100,1185,1088,2359,1174,274,1482,2656,1516,2701
һũ,DiQuYiNongChang,654323400,1994,333,1198,1245,2118,1191,367,1484,2675,1496,2694
,XuNiDiQu,654323401,1253,258,758,791,1557,755,244,946,1701,997,1755
һ˶,BingTuanYiBaErTuan,654323500,3996,595,2480,2223,4525,2452,907,2982,5434,3018,5498
һ,BingTuanYiBaSanTuan,654323501,5207,605,3126,2732,5885,3108,1198,3774,6882,3884,7010
һ,BingTuanYiBaQiTuan,654323502,4425,700,2567,2819,5275,2548,805,3319,5867,3363,5930
һ˰,BingTuanYiBaBaTuan,654323503,4856,698,2903,2599,5501,2894,899,3458,6352,3550,6453
,AKeQiZhen,654324100,14565,1086,9436,6573,15280,9150,3719,9249,18399,9934,19370
ľ,SaErTaMuXiang,654324200,8091,538,5362,3383,10347,5362,2518,5784,11146,5785,11147
,JiaYiLeMaXiang,654324201,8413,657,5110,4060,10345,5075,2304,6046,11121,6264,11374
հ,KuLeBaiXiang,654324202,10959,671,6995,4365,13012,6905,3556,7491,14396,8191,15186
,SaErBuLaKeXiang,654324203,8828,547,6082,3680,11639,6068,3420,6536,12604,6713,12795
ȿ,TieReKeTiXiang,654324204,1610,76,1167,595,2349,1167,676,1193,2360,1195,2362
Ͷ,QiBaErXiang,654324205,5013,322,3416,2004,6756,3413,1963,3793,7206,3882,7298
һ,BingTuanYiBaWuTuan,654324500,2117,416,1380,1231,2614,1363,442,1515,2878,1595,2975
,QingHeZhen,654325100,11916,826,7972,5212,12336,7716,3356,7696,15412,8126,16098
ʲ,TaKeShenKenZhen,654325101,2692,166,1904,976,3166,1859,1009,1902,3761,1963,3867
,AReLeXiang,654325200,9236,582,5946,4067,10776,5946,2823,6691,12637,6695,12641
б,AReLeTuoBieXiang,654325201,6967,419,4584,2663,8647,4538,2444,5056,9594,5246,9830
к,SaErTuoHaiXiang,654325202,3596,190,2428,1491,4647,2422,1352,2663,5085,2710,5138
ɹ,ChaGanGuoLeXiang,654325203,4700,294,3158,1865,5320,3131,1555,3363,6494,3391,6549
ʲ,AGaShenAoBaoXiang,654325204,3338,203,2196,1497,3955,2169,1194,2510,4679,2539,4735
ȿ,TuoPuTieReKeZhen,654326100,7780,589,5052,3519,7253,4960,1863,4765,9725,5180,10232
ľ,JiMuNaiZhen,654326101,1717,102,1215,918,2230,1207,599,1186,2393,1203,2418
ȿ,TuoPuTieReKeXiang,654326200,4727,280,3091,2306,4868,3091,1340,3245,6336,3256,6347
˹,TuoSiTeXiang,654326201,3283,236,2149,2102,4339,2146,1005,2373,4519,2375,4524
ǡʲ,QiaLeShenHaiXiang,654326202,882,65,516,571,1055,500,202,615,1115,633,1149
,KaErJiaoXiang,654326203,3672,224,2463,2091,4212,2459,1179,2568,5027,2612,5075
˹ȿ,BieSiTieReKeXiang,654326204,2348,130,1503,1461,3046,1502,725,1694,3196,1700,3203
һ,BingTuanYiBaLiuTuan,654326500,1843,195,1146,871,1859,1109,379,1187,2296,1271,2417
³ǽֵ´,XinChengJieDaoBanShiChu,659001001,35345,8390,24237,18737,32107,22588,5652,22132,44720,25150,49387
ֵ´,XiangYangJieDaoBanShiChu,659001002,50004,7103,30154,19163,39313,24681,7328,24659,49340,34281,64435
ɽֵ´,HongShanJieDaoBanShiChu,659001003,48828,9245,34096,22974,40990,29951,8705,28938,58889,32682,66778
Ͻֵֽ´,LaoJieJieDaoBanShiChu,659001004,51865,10560,36404,27473,50598,34819,9456,34048,68867,35477,71881
ǽֵ´,DongChengJieDaoBanShiChu,659001005,43751,3841,26651,15612,20981,20394,5919,19861,40255,26860,53511
Ȫ,BeiQuanZhen,659001100,28675,5031,18933,14411,24970,18725,5925,19808,38533,20698,39631
ʯ,ShiHeZiXiang,659001200,24081,1638,14451,11183,13868,14253,5583,16011,30264,16851,31302
һ,BingTuanYiWuErTuan,659001500,2415,263,1491,1173,1139,1426,527,1536,2962,1714,3205
·ֵ´,JinYinChuanLuJieDaoBanShiChu,659002001,6095,612,3963,2945,5422,3863,1332,3948,7811,4076,8039
Ҹ·ֵ´,XingFuLuJieDaoBanShiChu,659002002,19821,514,10775,3422,8561,4338,1607,4101,8439,11167,21942
·ֵ´,QingSongLuJieDaoBanShiChu,659002003,3676,260,2039,1396,2222,1755,660,1866,3621,2557,4596
Ͽڽֵ´,NanKouJieDaoBanShiChu,659002004,4650,743,3302,2539,4557,3302,1263,3334,6636,3354,6656
п,TuoKaYiXiang,659002200,2530,192,1832,1054,3433,1832,1006,1896,3728,1896,3728
,BingTuanQiTuan,659002500,8785,671,5458,3561,7473,5053,1804,5249,10302,5802,11260
Ű,BingTuanBaTuan,659002501,7855,571,4404,3244,6459,4335,1496,4373,8708,5518,9922
ʮ,BingTuanShiTuan,659002503,12438,871,7746,5135,12341,7433,2389,7704,15137,7952,15698
ʮһ,BingTuanShiYiTuan,659002504,7971,408,4168,2923,6880,4045,1536,4137,8182,5747,9915
ʮ,BingTuanShiErTuan,659002505,10863,239,4321,2925,8568,4309,1727,4593,8902,8508,12829
ʮ,BingTuanShiSanTuan,659002506,14450,1072,8211,6043,13911,8189,2900,8328,16517,10211,18422
ʮ,BingTuanShiSiTuan,659002507,6104,397,3727,2706,5887,3664,1248,3751,7415,4022,7749
ʮ,BingTuanShiLiuTuan,659002509,10199,777,5963,4218,8155,5786,2182,6017,11803,7195,13158
ũһʦˮ,BingTuanNongYiShiShuiLi,659002511,2049,104,1201,950,1739,1189,391,1313,2502,1343,2544
ũһʦ,BingTuanNongYiShiTaLi,659002512,4285,173,2695,1905,3004,2689,1248,2988,5677,3011,5706
ũ,ALaErNongChang,659002513,5052,245,3058,2302,5283,3056,1132,3348,6404,3371,6429
ǰֵ´,QianHaiJieDaoBanShiChu,659003002,3535,121,2160,1181,819,1640,769,1655,3295,2265,4425
ӽֵ´,YongAnBaJieDaoBanShiChu,659003003,2092,76,479,362,1428,408,153,461,869,1842,2321
ʮ,BingTuanSiShiSiTuan,659003504,19004,1124,12149,6631,22557,12117,6383,12455,24572,14362,26511
ʮ,BingTuanSiShiJiuTuan,659003509,11074,647,6376,3857,11595,6324,2966,6686,13010,8311,14687
ʮ,BingTuanWuShiTuan,659003510,13085,807,8136,4433,14855,7880,4463,8346,16226,10219,18355
ʮһ,BingTuanWuShiYiTuan,659003511,27809,1645,21399,9634,36565,21185,14282,20942,42127,22337,43736
ʮ,BingTuanWuShiSanTuan,659003513,14915,816,9813,5068,19181,9803,5692,10095,19898,11610,21423
ͼľп,BingTuanTuMuShuKeShiKaLaBaiLeZhen,659003514,2557,368,1632,1345,2531,1609,531,1678,3287,1824,3456
ͼľ,BingTuanTuMuShuKeShiYongAnBa,659003515,592,38,399,254,698,391,183,408,799,414,813
·ֵ´,JunKenLuJieDaoBanShiChu,659004001,20476,4523,13595,11957,22505,13248,3385,13388,26636,14789,28384
·ֵ´,QingHuLuJieDaoBanShiChu,659004002,10346,2171,7101,5606,9641,6858,1867,6982,13840,7283,14384
·ֵ´,RenMinLuJieDaoBanShiChu,659004003,12581,1371,7047,4025,6847,4272,1098,4522,8794,8003,15050
һһ,BingTuanYiLingYiTuan,659004500,6022,662,3520,3159,5243,3455,1151,4201,7656,4315,7835
һ,BingTuanYiLingErTuan,659004501,13772,2068,6883,5548,10897,6367,1715,7047,13414,10672,17555
һ,BingTuanYiLingSanTuan,659004502,9451,2046,6199,6076,11100,6170,1731,6988,13158,7029,13228
